chromosome,position,rsr,t_read,c_read,total_reads,strand
chr1,565306,0.4941720832874297,1868,1251,3119,+
chr1,565307,1.4473036473484,692,653,1345,+
chr1,565308,0.4941720832874297,1868,1251,3119,+
chr1,565309,0.5409842435501168,1236,886,2122,+
chr1,565312,0.6482142857142856,890,839,1729,+
chr1,565313,1.7085578964559855,853,627,1480,+
chr1,566690,1.9358302297886594,2594,1395,3989,+
chr1,566691,1.913921360255048,1800,940,2740,+
chr1,566694,1.7040560597581451,2000,1125,3125,+
chr1,566695,1.7453204764605785,3076,1762,4838,+
chr1,566697,1.6760147123864217,4063,2448,6511,+
chr1,566698,1.642521119783481,2975,2054,5029,+
chr1,566706,1.332181463760411,1239,1025,2264,+
chr1,566709,1.4451297989992724,3129,2264,5393,+
chr1,566723,1.305053337955431,3218,2490,5708,+
chr1,566741,1.5531724600933643,6802,5641,12443,+
chr1,566742,2.0092556165234496,4218,3714,7932,+
chr1,566864,0.3395079558773229,1316,1133,2449,+
chr1,566865,0.40137325535668733,1900,1469,3369,+
chr1,566877,1.9586276741275093,1546,1131,2677,+
chr1,566880,1.5009325611072937,1111,667,1778,+
chr1,566883,1.6875353148792736,6263,5003,11266,+
chr1,566884,1.6875353148792736,6263,5003,11266,+
chr1,566885,1.6875353148792736,6263,5003,11266,+
chr1,569297,1.0218865143699336,848,589,1437,+
chr1,569298,1.0218865143699336,848,589,1437,+
chr1,569301,1.0072626036434065,1512,805,2317,+
chr1,569303,1.0072626036434065,1512,805,2317,+
chr1,569305,2.0341311673723323,1595,651,2246,+
chr1,569306,1.0550389273356402,1773,1087,2860,+
chr1,569307,2.0341311673723323,1595,651,2246,+
chr1,569308,1.0550389273356402,1773,1087,2860,+
chr1,569310,2.056411114830934,944,411,1355,+
chr1,569317,1.38285580633844,1136,502,1638,+
chr1,569318,1.5810562992847972,1202,797,1999,+
chr1,569335,1.574416264090177,1818,827,2645,+
chr1,569343,1.601289134438306,2208,1085,3293,+
chr1,569345,1.5064061756067813,2902,1746,4648,+
chr1,569347,1.6431577474656192,4827,3133,7960,+
chr1,569350,1.404054192855794,3560,2202,5762,+
chr1,569353,1.300333140208575,3191,1725,4916,+
chr1,569357,1.4366478797638214,4253,2759,7012,+
chr1,569360,1.264959753133142,4543,2986,7529,+
chr1,569365,1.456755889671211,9775,6133,15908,+
chr1,569370,0.7924347158218126,4126,3143,7269,+
chr1,569371,1.4298024444479192,20234,15336,35570,+
chr1,569372,1.3845361297983234,26282,19041,45323,+
chr1,569373,1.4298024444479192,20234,15336,35570,+
chr1,1246416,0.6728436006571069,4699,2077,6776,+
chr1,1246417,0.7626902099181628,3524,1537,5061,+
chr1,1246418,0.7957975462276937,1987,942,2929,+
chr1,1246426,2.5301264500971143,1737,764,2501,+
chr1,1246442,1.7805258551805487,1417,640,2057,+
chr1,2106669,3.1933871777354543,664,458,1122,+
chr1,2327286,1.2645392761268437,1373,1042,2415,+
chr1,2328636,1.8609467455621305,628,389,1017,+
chr1,2330872,2.222328931572629,711,489,1200,+
chr1,2332315,1.7696629213483146,566,444,1010,+
chr1,2332360,2.0615202602780243,819,587,1406,+
chr1,2332362,2.0615202602780243,819,587,1406,+
chr1,2332368,1.7209834190966269,644,476,1120,+
chr1,2333689,2.486737400530504,599,463,1062,+
chr1,2335037,2.7213749674270082,766,554,1320,+
chr1,6693396,2.5064649724986445,1598,1020,2618,+
chr1,6693397,2.972614107883817,596,481,1077,+
chr1,6693398,0.9475890985324948,677,370,1047,+
chr1,6845606,2.423785112133824,827,857,1684,+
chr1,6845607,2.423785112133824,827,857,1684,+
chr1,6845608,2.190301843322545,1067,1155,2222,+
chr1,6885197,0.5013565891472869,596,429,1025,+
chr1,8021770,0.5935000264872596,678,438,1116,+
chr1,8021774,1.6482645875251514,770,496,1266,+
chr1,8021775,1.5,623,415,1038,+
chr1,8022825,1.4022969234638276,1393,905,2298,+
chr1,8022827,1.0904740132245325,1832,1571,3403,+
chr1,8022833,1.4518709677419357,1745,1124,2869,+
chr1,8022840,1.4025553060032412,2053,1306,3359,+
chr1,8022843,1.2862841354917518,4130,3081,7211,+
chr1,8025414,1.6406310552707568,2947,2389,5336,+
chr1,8025469,1.5254299965600275,1992,1709,3701,+
chr1,8029450,1.3549398054957333,4010,3100,7110,+
chr1,8029455,1.465562210758347,2098,1698,3796,+
chr1,8030951,1.2355920220145444,3736,2947,6683,+
chr1,8030952,1.2097088102863593,3872,3087,6959,+
chr1,8030953,1.8787733857077664,5886,4802,10688,+
chr1,8031017,1.4723291878971119,3799,2680,6479,+
chr1,10231334,2.718852500271433,752,422,1174,+
chr1,10459148,1.8926699614410525,1754,1071,2825,+
chr1,10459723,1.4240478949909734,1299,1094,2393,+
chr1,10459725,1.2510378510378508,871,818,1689,+
chr1,10460460,1.7916255463132664,1058,691,1749,+
chr1,10460560,1.5083580510910304,1024,762,1786,+
chr1,10460623,2.061431882858324,2033,1478,3511,+
chr1,10468132,0.6386835508131388,827,661,1488,+
chr1,10471479,2.335925668462265,1848,1345,3193,+
chr1,10471488,8.117291665172248,2708,2469,5177,+
chr1,10471504,0.6067821067821069,550,626,1176,+
chr1,10471550,0.6881831610740324,1263,1119,2382,+
chr1,10471557,0.40040650406504075,787,655,1442,+
chr1,10471559,2.117063960349304,689,668,1357,+
chr1,10471566,0.2916784203102961,751,708,1459,+
chr1,10471568,1.1156841363074759,2145,1521,3666,+
chr1,10471585,1.860517435320585,826,634,1460,+
chr1,10473164,1.251921075751397,2867,2340,5207,+
chr1,10473256,1.8864965443912807,754,626,1380,+
chr1,10473272,2.354740550928892,753,445,1198,+
chr1,10473278,0.5072015076053304,627,436,1063,+
chr1,10477102,0.6603348176540217,1703,1255,2958,+
chr1,10477120,1.6119229330858624,1491,988,2479,+
chr1,10477144,2.4495912806539506,1673,1100,2773,+
chr1,10477145,1.4287652645861597,2053,1473,3526,+
chr1,10477515,0.5657894736842105,1160,683,1843,+
chr1,10477517,2.123705057891529,696,546,1242,+
chr1,10478884,2.173806609547124,665,515,1180,+
chr1,10478895,0.4795646456256921,1204,902,2106,+
chr1,10478897,0.4816666666666666,764,599,1363,+
chr1,10478902,0.4008288571026214,1171,788,1959,+
chr1,10478917,1.7268722466960351,1311,907,2218,+
chr1,10479514,2.1440761761078586,1231,819,2050,+
chr1,10479521,1.9028416977134928,813,506,1319,+
chr1,10479529,1.650573531929464,621,530,1151,+
chr1,10479561,0.6945698953296849,746,637,1383,+
chr1,10479741,1.9830769230769238,1288,948,2236,+
chr1,10479742,2.0233409177095183,1957,1464,3421,+
chr1,10479744,2.005988023952096,1319,1001,2320,+
chr1,10479884,0.6370808678500987,1291,1013,2304,+
chr1,10479892,0.6750480355131517,2981,2235,5216,+
chr1,10479893,0.6750480355131517,2981,2235,5216,+
chr1,10480031,1.7277117743649184,576,492,1068,+
chr1,10480047,0.616183615345954,612,507,1119,+
chr1,10480094,1.6078431372549022,819,509,1328,+
chr1,10480113,1.7984916021131465,1332,1045,2377,+
chr1,10480126,1.1421054641637183,1345,1024,2369,+
chr1,10500425,2.6634382566585955,703,412,1115,+
chr1,10500426,2.6634382566585955,703,412,1115,+
chr1,10502328,1.7991952099061637,2399,1825,4224,+
chr1,10690711,2.0308179723502304,640,433,1073,+
chr1,10690712,1.7106876977731618,908,628,1536,+
chr1,10690715,1.3177227448810185,885,555,1440,+
chr1,10690717,1.5264144397268724,1285,871,2156,+
chr1,10690720,1.2439695787793723,2564,1891,4455,+
chr1,10690721,1.2654523565854097,3204,2336,5540,+
chr1,11076951,1.961259079903148,599,412,1011,+
chr1,11076963,1.8075587334014305,631,444,1075,+
chr1,11077029,0.4413484090033955,787,582,1369,+
chr1,11078792,2.719894424282415,686,432,1118,+
chr1,11080533,2.380120184518705,658,520,1178,+
chr1,11082364,3.9442403013976253,2241,1355,3596,+
chr1,11082365,4.339796786358581,1616,1038,2654,+
chr1,11082395,8.266055221579256,2345,2014,4359,+
chr1,11082396,8.266055221579258,2345,2014,4359,+
chr1,11082664,2.217136352446695,647,355,1002,+
chr1,11082730,11.430680619765841,1112,811,1923,+
chr1,11082734,2.7250744921675105,2082,1552,3634,+
chr1,11082747,4.962400078043699,2755,2445,5200,+
chr1,11082748,4.928824401247508,3204,2772,5976,+
chr1,11083543,2.116117850953206,956,576,1532,+
chr1,11083544,2.242758129025968,1346,841,2187,+
chr1,11796282,0.7001668099504355,720,472,1192,+
chr1,11807505,2.2047261246533085,971,774,1745,+
chr1,11807507,2.194444444444444,710,557,1267,+
chr1,12008032,0.9919749363147319,649,540,1189,+
chr1,12008109,1.9917293949431505,838,638,1476,+
chr1,12009860,1.863810410746666,1137,769,1906,+
chr1,12009868,2.1851494455881317,1875,1469,3344,+
chr1,12009886,3.0577239353333123,909,708,1617,+
chr1,12012756,5.123887748117728,590,486,1076,+
chr1,12012757,5.123887748117728,590,486,1076,+
chr1,12017902,4.018487390215088,696,474,1170,+
chr1,12017907,3.0988044543068467,743,587,1330,+
chr1,12018677,2.553683385579937,930,579,1509,+
chr1,12018678,2.553683385579937,930,579,1509,+
chr1,12025607,1.4850187925750056,651,521,1172,+
chr1,12027074,1.7815121351270427,1403,862,2265,+
chr1,12027093,6.678571428571427,967,615,1582,+
chr1,12027095,6.678571428571427,967,615,1582,+
chr1,12027106,2.330110497237569,722,361,1083,+
chr1,12027111,1.8106235565819866,783,432,1215,+
chr1,12027140,2.9166368515205723,1018,558,1576,+
chr1,12030739,2.0838099595820943,1092,845,1937,+
chr1,12034714,21.763894862461726,1516,955,2471,+
chr1,12034715,17.373982756838263,2223,1507,3730,+
chr1,12035150,2.117246802483023,900,624,1524,+
chr1,12035387,1.616494918832371,869,621,1490,+
chr1,12049267,0.9562146892655368,676,353,1029,+
chr1,12049268,1.311461193814135,1046,560,1606,+
chr1,12049269,1.9850618131868125,1050,447,1497,+
chr1,12049270,2.161729958810788,1761,836,2597,+
chr1,12052707,4.418513677448865,719,621,1340,+
chr1,12058835,3.165964128383657,1050,629,1679,+
chr1,12058869,0.141179128077705,624,465,1089,+
chr1,12058886,1.956726206674279,2737,1858,4595,+
chr1,12058888,1.956726206674279,2737,1858,4595,+
chr1,12058891,2.325674325674325,581,428,1009,+
chr1,12072303,4.819833976467746,658,634,1292,+
chr1,12072304,4.639045376196069,751,775,1526,+
chr1,15736424,1.85246776957342,1197,737,1934,+
chr1,15736425,1.85246776957342,1197,737,1934,+
chr1,15736583,2.7599259487679624,2208,1595,3803,+
chr1,15736584,2.6889481392466856,917,858,1775,+
chr1,15736585,2.8915296571378595,1356,1125,2481,+
chr1,15736634,0.5185338579416029,625,438,1063,+
chr1,15736660,1.9408602150537635,683,495,1178,+
chr1,15736661,0.3790565723781333,2189,1408,3597,+
chr1,15736662,0.3651063829787234,1130,724,1854,+
chr1,15736678,0.6145151391162029,800,415,1215,+
chr1,15736681,0.5664945700551897,1891,901,2792,+
chr1,15736683,0.6117795389048991,2996,1387,4383,+
chr1,15736684,0.6631262021291408,4812,2572,7384,+
chr1,15736701,1.4919198448610214,2307,1364,3671,+
chr1,15736704,1.6690042075736329,1665,712,2377,+
chr1,15736705,1.4763005152032085,5440,3200,8640,+
chr1,15736744,1.7648838932806323,1393,1011,2404,+
chr1,15752407,1.5917704087253497,1627,1251,2878,+
chr1,15752410,1.3974585886090312,1742,1016,2758,+
chr1,15752455,1.5495305977010554,4774,3041,7815,+
chr1,15752457,1.456740006197707,3241,1843,5084,+
chr1,15752458,1.0046669969792383,3643,2811,6454,+
chr1,15752460,1.0046669969792383,3643,2811,6454,+
chr1,15753652,1.9144483880508725,1522,965,2487,+
chr1,15753658,0.7000633541496968,1546,956,2502,+
chr1,15753685,1.418910802694587,2131,1368,3499,+
chr1,15753688,1.7030099930711398,5426,3306,8732,+
chr1,15753723,1.5455164403860788,1815,1188,3003,+
chr1,15753724,1.4584862898354007,3998,2303,6301,+
chr1,15753732,1.4860804952404958,4339,2552,6891,+
chr1,15753736,2.218297572770959,1541,882,2423,+
chr1,15753756,0.754036359601265,2470,1555,4025,+
chr1,15753759,1.035848604742826,7179,4651,11830,+
chr1,15753762,1.35028506721462,8222,5413,13635,+
chr1,15753765,1.3992869875222818,2354,1550,3904,+
chr1,15753766,1.5992080662956782,8354,5571,13925,+
chr1,15755292,1.5033968880122723,839,701,1540,+
chr1,15755293,1.6651658999706374,962,600,1562,+
chr1,15755488,1.8334410434052288,982,675,1657,+
chr1,15755681,1.0580975994590331,568,466,1034,+
chr1,15755683,1.5476796277874594,1491,1111,2602,+
chr1,15755684,2.7089947089947093,575,485,1060,+
chr1,15755686,1.1659252572120151,1435,987,2422,+
chr1,15755688,1.9619783306581056,953,622,1575,+
chr1,15755726,1.2858218231004224,2694,1942,4636,+
chr1,15755727,0.977115916406002,2292,1633,3925,+
chr1,15755790,1.503761203585147,873,567,1440,+
chr1,15755838,11.20452872820093,1841,1282,3123,+
chr1,15755960,2.1977331875568584,1027,589,1616,+
chr1,15756006,1.879639175257732,662,581,1243,+
chr1,15756019,0.6616915422885572,797,602,1399,+
chr1,15756062,7.537762095190892,2082,1811,3893,+
chr1,15756063,6.315586768679452,3528,3090,6618,+
chr1,15756066,1.1287842569541429,7684,7849,15533,+
chr1,15756067,0.9409360767333554,6981,7272,14253,+
chr1,15756068,0.9756626953089708,9471,9352,18823,+
chr1,15756069,0.6269916502346721,5242,4802,10044,+
chr1,15756300,1.701184668989547,717,573,1290,+
chr1,15756303,1.1053755140818804,1351,872,2223,+
chr1,15756348,1.5687182903705217,1843,1234,3077,+
chr1,15756349,1.5687182903705217,1843,1234,3077,+
chr1,15756356,1.901433691756272,1060,827,1887,+
chr1,15756359,1.9387964674471143,943,540,1483,+
chr1,15756483,1.417449913430621,1697,1243,2940,+
chr1,15756589,1.4339253646896752,1596,1377,2973,+
chr1,15897801,2.8155041814218458,630,407,1037,+
chr1,16721890,16.269258519258518,1281,204,1485,+
chr1,16721892,17.524029077719888,1388,199,1587,+
chr1,16721893,17.166666666666668,990,165,1155,+
chr1,16721897,14.355029083890225,971,215,1186,+
chr1,16721898,7.862068965517242,881,146,1027,+
chr1,16721908,37.253622943632955,2659,2158,4817,+
chr1,16721909,23.234722154375433,3553,3375,6928,+
chr1,16721910,18.535511166542356,4275,4332,8607,+
chr1,16721911,17.20560184817594,3393,3906,7299,+
chr1,16721912,12.300715335347892,2150,2544,4694,+
chr1,16722548,2.991979093419517,825,664,1489,+
chr1,16722550,2.5977229601518026,739,679,1418,+
chr1,16722551,1.8174659997163014,1065,1016,2081,+
chr1,16722553,2.0953406370159864,1089,1057,2146,+
chr1,16722554,2.1098706176961604,553,598,1151,+
chr1,16722765,2.1130414790207968,570,457,1027,+
chr1,16722800,3.5871114853577684,547,479,1026,+
chr1,16723881,87.99846743295019,856,260,1116,+
chr1,16723882,92.86007135899014,1321,588,1909,+
chr1,16723883,82.74082956214598,1474,724,2198,+
chr1,16723931,8.117246069138737,1490,1980,3470,+
chr1,16723932,8.978823814455424,1979,2474,4453,+
chr1,16723933,8.978823814455424,1979,2474,4453,+
chr1,17053775,1.1847138047138048,963,809,1772,+
chr1,17053835,0.8913103150795051,3081,2267,5348,+
chr1,19583975,13.010108802339913,1516,1328,2844,+
chr1,19583976,11.398455071503813,1394,1195,2589,+
chr1,19585264,1.8240771450609576,654,474,1128,+
chr1,19585308,3.3739184690606367,770,463,1233,+
chr1,19585830,28.885104493592664,1182,618,1800,+
chr1,19923534,4.127599677205722,4857,5664,10521,+
chr1,19923535,4.127599677205722,4857,5664,10521,+
chr1,19923536,4.127599677205722,4857,5664,10521,+
chr1,19923539,0.44728514116269213,717,1028,1745,+
chr1,19935062,0.6754228422777475,1568,990,2558,+
chr1,19935064,0.6754228422777475,1568,990,2558,+
chr1,19935072,0.6674969240464544,2300,1417,3717,+
chr1,19935073,0.6674969240464544,2300,1417,3717,+
chr1,19948611,0.4993217676875848,537,482,1019,+
chr1,19949969,0.5401669758812616,646,538,1184,+
chr1,19950016,2.1347178427748177,676,540,1216,+
chr1,19952904,1.618264811031665,1178,711,1889,+
chr1,19981586,2.4102857142857146,1025,629,1654,+
chr1,19981587,2.4102857142857146,1025,629,1654,+
chr1,19981592,1.5043142968820555,1004,731,1735,+
chr1,19981608,2.3289042132705404,1085,1080,2165,+
chr1,19981609,2.318451308910717,1688,1740,3428,+
chr1,19981611,2.1601272455954157,1907,1805,3712,+
chr1,19981686,2.9833074906628183,632,435,1067,+
chr1,19983709,0.5233065624135654,1184,648,1832,+
chr1,19983710,0.6078842972056644,1126,547,1673,+
chr1,19983727,0.4072174390914087,740,308,1048,+
chr1,20975521,2.786072839452121,724,405,1129,+
chr1,20977573,1.521805641745223,571,486,1057,+
chr1,22404922,1.9258090621836095,957,529,1486,+
chr1,22412963,2.502245853980178,1287,779,2066,+
chr1,22412965,2.502245853980178,1287,779,2066,+
chr1,22412995,1.583349695660711,755,462,1217,+
chr1,22413329,1.9893005750833066,949,823,1772,+
chr1,22418680,0.4030436357687321,928,630,1558,+
chr1,22418854,2.048690165757678,1034,703,1737,+
chr1,22419100,101.22843991191733,1269,80,1349,+
chr1,22419101,86.38659945873596,1508,99,1607,+
chr1,22419102,158.63636363636363,1046,65,1111,+
chr1,22419103,10.461658841940531,954,70,1024,+
chr1,22419104,25.912203834312418,1739,191,1930,+
chr1,22419105,29.645768025078368,1224,318,1542,+
chr1,22419106,11.746360595771048,2889,1793,4682,+
chr1,22419107,9.881755963003405,2717,2235,4952,+
chr1,22419108,7.2526983887858645,2987,2964,5951,+
chr1,22419110,2.637125699059205,990,1468,2458,+
chr1,22419115,0.19780155081100262,523,744,1267,+
chr1,22419128,8.393344252099181,2126,3322,5448,+
chr1,22419129,9.083203738803793,1934,2927,4861,+
chr1,22419140,3.742952903564686,613,1607,2220,+
chr1,22419141,4.3916233357503,1284,2307,3591,+
chr1,22419148,0.4288682231895528,1019,1443,2462,+
chr1,22419150,0.3733463825574015,1295,2114,3409,+
chr1,23357104,3.323439532835611,662,401,1063,+
chr1,23377001,2.193877551020408,644,440,1084,+
chr1,23380270,1.659528907922912,619,466,1085,+
chr1,23380278,1.7354166666666666,734,479,1213,+
chr1,23385599,0.5386640798226164,597,450,1047,+
chr1,23395050,1.7200179188531934,866,600,1466,+
chr1,23406059,1.2413055202790302,673,535,1208,+
chr1,23406145,3.290627102718771,982,664,1646,+
chr1,23409714,2.0080720197119337,1068,735,1803,+
chr1,23409767,1.2911440971788022,817,593,1410,+
chr1,23410016,1.828978622327791,594,420,1014,+
chr1,24018293,1.1356410930110352,1016,681,1697,+
chr1,24018295,0.8770076060862324,5385,2432,7817,+
chr1,24018296,0.8635158394194539,4884,1742,6626,+
chr1,24018297,0.9081155442601416,6302,2273,8575,+
chr1,24018298,1.4411570982194437,8063,3373,11436,+
chr1,24018299,1.296275634812777,6162,2401,8563,+
chr1,24018300,1.813282568172198,5582,2486,8068,+
chr1,24018304,1.6588284033782792,6805,3422,10227,+
chr1,24018305,1.6588284033782792,6805,3422,10227,+
chr1,24018306,1.4427918038718714,10934,5869,16803,+
chr1,24018307,1.042880491503062,3438,2361,5799,+
chr1,24018308,1.4413477967823205,10000,5884,15884,+
chr1,24018310,1.4150362442801578,9608,5547,15155,+
chr1,24018311,1.4500189626663025,4926,2554,7480,+
chr1,24019099,1.2424434274003002,6480,3621,10101,+
chr1,24019100,1.3328142563376775,18228,12133,30361,+
chr1,24019102,1.4205202562526227,17015,12195,29210,+
chr1,24019103,1.560685403090932,5133,4197,9330,+
chr1,24019109,1.1824380715109395,5634,4176,9810,+
chr1,24019111,1.190549523382522,4211,3578,7789,+
chr1,24019114,1.2123493503478824,4830,4086,8916,+
chr1,24019117,1.270508346964036,16256,10936,27192,+
chr1,24019132,1.4883642707965936,9850,6043,15893,+
chr1,24019165,1.163364495077274,12039,7813,19852,+
chr1,24019181,0.8659195990336938,9866,7632,17498,+
chr1,24019221,1.2141705553648736,31364,21938,53302,+
chr1,24019228,1.5219378245143325,22394,15003,37397,+
chr1,24020298,1.2826018349933956,14777,9336,24113,+
chr1,24020386,1.228920654650922,11863,9653,21516,+
chr1,24021229,1.1569345469108785,13147,10908,24055,+
chr1,24021236,1.3428634325457895,18074,12030,30104,+
chr1,24021261,1.2203534350969125,32927,23597,56524,+
chr1,24087096,2.9511735480555084,637,448,1085,+
chr1,24087098,2.9511735480555084,637,448,1085,+
chr1,24121632,0.7582389429267552,660,420,1080,+
chr1,24287606,2.906504012295444,682,521,1203,+
chr1,24288393,2.301902592234817,680,424,1104,+
chr1,24996761,3.175361741669985,1195,836,2031,+
chr1,24996762,3.0377773460706488,1479,984,2463,+
chr1,24996763,3.175361741669985,1195,836,2031,+
chr1,24998692,2.5581159850555415,859,505,1364,+
chr1,25124311,0.5742073930499793,552,465,1017,+
chr1,25140654,1.9958071278825997,679,529,1208,+
chr1,25166429,1.9068621677265944,1403,1092,2495,+
chr1,25167271,1.9425019425019423,624,428,1052,+
chr1,25167289,1.9226452905811622,737,498,1235,+
chr1,25167615,2.0778816199376946,666,427,1093,+
chr1,25167857,1.779313942872049,1076,696,1772,+
chr1,25168059,1.7962906658558833,843,505,1348,+
chr1,25168086,2.0762929649855444,833,565,1398,+
chr1,25168164,0.4821247892074199,952,592,1544,+
chr1,25168473,2.1027088036117383,620,442,1062,+
chr1,25168629,0.9478227889373949,1614,1219,2833,+
chr1,25168952,2.014438635797859,951,617,1568,+
chr1,25168965,1.4355492196878752,1082,713,1795,+
chr1,25169417,1.122591151026518,1415,978,2393,+
chr1,25169482,9.413220898165612,5030,3847,8877,+
chr1,25169483,8.008257842563713,5563,4369,9932,+
chr1,25169485,4.832876107589948,1056,1022,2078,+
chr1,25169672,2.346045197740113,754,589,1343,+
chr1,25169712,1.6859035004730367,890,603,1493,+
chr1,25169783,4.041033925686591,757,618,1375,+
chr1,25169810,1.916841579210395,891,666,1557,+
chr1,25169906,2.124811463046757,965,611,1576,+
chr1,25170467,1.711549295774648,587,425,1012,+
chr1,25170535,1.9351083591331268,600,474,1074,+
chr1,25679419,0.3758415619389587,608,556,1164,+
chr1,25679420,0.3758415619389587,608,556,1164,+
chr1,25687204,0.3959841219795361,840,561,1401,+
chr1,25687368,0.6764069264069263,999,703,1702,+
chr1,26586287,1.5418828762045962,649,354,1003,+
chr1,26799089,3.012687044057169,616,488,1104,+
chr1,26799109,2.5605092384209667,753,628,1381,+
chr1,26799111,2.1610225217549286,750,600,1350,+
chr1,26799994,1.7474226804123711,677,484,1161,+
chr1,26801119,1.8358516483516487,791,415,1206,+
chr1,26801122,1.8695596518177164,634,433,1067,+
chr1,26801131,1.6674639104809088,722,508,1230,+
chr1,26801133,2.030155890621007,992,558,1550,+
chr1,26801750,0.6053287981859411,842,539,1381,+
chr1,27189639,0.7798261923483665,2509,1318,3827,+
chr1,27189641,0.7955568804694345,2150,1088,3238,+
chr1,27189715,0.44121405859379303,690,462,1152,+
chr1,27189719,2.25169755171605,875,551,1426,+
chr1,27189776,0.851037851037851,696,524,1220,+
chr1,27189778,1.4234789418871452,1838,1383,3221,+
chr1,27189779,0.9838441793749056,723,536,1259,+
chr1,27190064,3.2236923629108523,746,479,1225,+
chr1,27190291,0.49056603773584906,731,365,1096,+
chr1,27190317,1.519416153804259,753,426,1179,+
chr1,27190872,1.4179549570278402,721,544,1265,+
chr1,27268004,2.414814814814815,651,431,1082,+
chr1,27268035,1.5975090483287204,697,426,1123,+
chr1,27268042,0.5940000000000001,890,624,1514,+
chr1,27268050,9.42135231316726,853,561,1414,+
chr1,27268256,3.3416927899686524,883,492,1375,+
chr1,27268257,2.145566083224305,1381,911,2292,+
chr1,27269448,2.4130941141475906,592,435,1027,+
chr1,27269454,4.704746283775825,621,501,1122,+
chr1,27271929,1.8016132128336615,1685,1329,3014,+
chr1,27271931,1.8016132128336615,1685,1329,3014,+
chr1,27272666,1.764262325649164,1219,822,2041,+
chr1,28165268,2.089130292520123,1387,825,2212,+
chr1,28165270,2.089130292520123,1387,825,2212,+
chr1,28165275,1.5658102321388323,793,492,1285,+
chr1,28177014,17.792117063855002,1333,1361,2694,+
chr1,28177015,17.442381936761503,1520,1710,3230,+
chr1,28177016,17.442381936761507,1520,1710,3230,+
chr1,28177020,0.36566980796663157,465,639,1104,+
chr1,28177093,0.41873571046543406,458,552,1010,+
chr1,28562641,2.1601284729899692,700,351,1051,+
chr1,28562645,3.6870917955083438,884,518,1402,+
chr1,28562664,1.4266207106824633,819,629,1448,+
chr1,28562681,1.5548851813088715,573,438,1011,+
chr1,28562687,1.9762769100886453,866,514,1380,+
chr1,28562692,4.726822157434402,522,489,1011,+
chr1,28562775,2.028322440087146,664,509,1173,+
chr1,28562875,1.911764705882353,634,507,1141,+
chr1,28562925,1.556844020009095,1168,732,1900,+
chr1,28562945,1.4163985068863432,1178,913,2091,+
chr1,28562953,1.6003225322532255,1802,1211,3013,+
chr1,28564359,1.8163398692810455,1587,1274,2861,+
chr1,28564376,1.3649663775864391,2557,1820,4377,+
chr1,28564379,1.3740321788722287,2552,1825,4377,+
chr1,28564411,1.7282217445702737,2321,2134,4455,+
chr1,28564418,1.6296846011131725,2195,2134,4329,+
chr1,28598948,4.039975247524752,1052,504,1556,+
chr1,28598949,4.232007421582494,1384,741,2125,+
chr1,28598950,4.039975247524752,1052,504,1556,+
chr1,28832555,1.6829525580313787,597,655,1252,+
chr1,28832556,2.6030539326324207,573,459,1032,+
chr1,28832562,1.2833083148505782,868,633,1501,+
chr1,28832567,1.408965233585065,1826,1198,3024,+
chr1,28832568,1.408965233585065,1826,1198,3024,+
chr1,28834041,1.5429040625617727,693,636,1329,+
chr1,28834042,0.7076918391277202,627,412,1039,+
chr1,28834043,1.0505904888928206,970,846,1816,+
chr1,28834044,0.9800202951017498,802,707,1509,+
chr1,28834045,0.6564744467970274,1374,867,2241,+
chr1,28834643,1.5613490585557626,538,536,1074,+
chr1,28835233,0.8619908479644767,1503,992,2495,+
chr1,28835234,0.8619908479644767,1503,992,2495,+
chr1,28835235,0.8619908479644767,1503,992,2495,+
chr1,28835343,0.3090185676392573,698,521,1219,+
chr1,28835356,0.748153073286052,778,575,1353,+
chr1,28835531,0.3186277873070326,773,582,1355,+
chr1,28835588,2.113256556574402,1168,956,2124,+
chr1,28835594,1.655013192612137,964,757,1721,+
chr1,28835595,2.348314491413391,933,731,1664,+
chr1,28835617,0.6749317881353548,1296,973,2269,+
chr1,28835625,1.4233646652599272,1589,1202,2791,+
chr1,28835822,2.280745341614907,611,459,1070,+
chr1,28835856,0.6862687031941509,1782,1454,3236,+
chr1,28835857,0.9750072653298459,609,443,1052,+
chr1,28835858,0.5649112925936355,943,847,1790,+
chr1,28835923,1.7318122555410689,717,589,1306,+
chr1,28836006,1.707598421559634,2189,1609,3798,+
chr1,28836014,0.7398288770053476,1133,849,1982,+
chr1,28836018,0.4146861486823604,6304,3956,10260,+
chr1,28836019,0.4392367386999361,8022,4829,12851,+
chr1,28836020,0.5162202600857101,3070,1615,4685,+
chr1,28836021,0.588646027835747,2500,1261,3761,+
chr1,28862412,2.459496442255063,835,521,1356,+
chr1,28862414,2.459496442255063,835,521,1356,+
chr1,28864372,2.659047619047619,697,419,1116,+
chr1,28864373,2.659047619047619,697,419,1116,+
chr1,28864432,0.3774065562651204,580,472,1052,+
chr1,28864590,1.4665094263604432,665,447,1112,+
chr1,28864736,7.337579168920782,3947,2890,6837,+
chr1,28864737,7.337579168920782,3947,2890,6837,+
chr1,28864738,7.337579168920782,3947,2890,6837,+
chr1,28864899,2.0303518613846605,611,497,1108,+
chr1,28865271,7.878603111270306,1381,217,1598,+
chr1,28865273,9.28134758067746,989,118,1107,+
chr1,28865276,10.774391238011262,1391,249,1640,+
chr1,28865277,10.774391238011262,1391,249,1640,+
chr1,28865280,5.967693234895118,1211,268,1479,+
chr1,28865282,6.973995271867612,1179,281,1460,+
chr1,28865283,8.215481789008553,2026,638,2664,+
chr1,28865284,8.065343355243694,1956,675,2631,+
chr1,28865325,8.708758563651786,3894,1220,5114,+
chr1,28865326,9.536562661971937,4449,1502,5951,+
chr1,28865327,8.899315029722189,5138,1722,6860,+
chr1,28865328,11.239130800140208,1882,883,2765,+
chr1,28865329,5.393632677087764,1595,530,2125,+
chr1,28865334,9.525316455696204,902,236,1138,+
chr1,28865335,8.61116020072179,1761,658,2419,+
chr1,28865338,20.295826878119012,2624,1817,4441,+
chr1,28865339,20.295826878119016,2624,1817,4441,+
chr1,28865354,10.789165931435988,2406,2819,5225,+
chr1,28865355,10.789165931435988,2406,2819,5225,+
chr1,28975176,1.7821311066689287,968,607,1575,+
chr1,29096140,4.812425328554362,1367,836,2203,+
chr1,29096141,4.812425328554362,1367,836,2203,+
chr1,29096142,3.698462797377595,2759,1708,4467,+
chr1,29096144,4.543408360128617,941,621,1562,+
chr1,29096196,1.7120390455531451,615,460,1075,+
chr1,29096209,2.452050919377652,984,706,1690,+
chr1,29096211,2.452050919377652,984,706,1690,+
chr1,29096228,5.547169811320755,587,529,1116,+
chr1,31769878,0.8429868509538636,1055,620,1675,+
chr1,31821793,1.7078375746284455,1406,1242,2648,+
chr1,31821794,1.7078375746284455,1406,1242,2648,+
chr1,32495906,1.1145526183426815,593,472,1065,+
chr1,32495913,2.474164133738602,659,469,1128,+
chr1,32495914,2.474164133738602,659,469,1128,+
chr1,32497189,1.9362586028598936,2048,1933,3981,+
chr1,32497190,2.3585576729978546,3153,3101,6254,+
chr1,32497192,1.9653252996413098,5101,4920,10021,+
chr1,32497194,2.3162029366394328,3464,3804,7268,+
chr1,32497196,2.1369303530083066,3592,4104,7696,+
chr1,32497197,1.608899568098186,5184,5579,10763,+
chr1,32497203,1.3187962967703328,4354,4783,9137,+
chr1,32498844,0.5107156525066974,627,401,1028,+
chr1,32504175,1.905940594059406,629,403,1032,+
chr1,32508223,0.5662613981762918,620,469,1089,+
chr1,32508577,2.6133540372670807,560,505,1065,+
chr1,32508579,2.6133540372670807,560,505,1065,+
chr1,32508848,1.8567195767195763,848,566,1414,+
chr1,32508892,2.1507773540627757,610,486,1096,+
chr1,32508893,2.1507773540627757,610,486,1096,+
chr1,32509019,12.094335103963548,2190,1162,3352,+
chr1,32509021,8.463319456531114,1614,846,2460,+
chr1,32509024,12.184872732193945,3950,3395,7345,+
chr1,32509025,12.184872732193945,3950,3395,7345,+
chr1,32509041,0.5146045996802361,796,691,1487,+
chr1,32509317,2.881763527054108,718,498,1216,+
chr1,32620224,4.682980010095552,518,632,1150,+
chr1,32655694,0.301469805091064,628,457,1085,+
chr1,32655695,1.3272153921854102,1235,786,2021,+
chr1,32655697,2.326164115060656,696,438,1134,+
chr1,32655698,1.6402361635808949,730,460,1190,+
chr1,32658842,1.5375538388141434,998,732,1730,+
chr1,32658844,2.184482184482184,614,428,1042,+
chr1,32663255,1.9233443005175084,554,468,1022,+
chr1,32688171,2.357293868921776,668,472,1140,+
chr1,32688179,1.539718927290959,1245,955,2200,+
chr1,32688187,2.328756674294432,638,620,1258,+
chr1,32689680,2.28511572226656,880,715,1595,+
chr1,32691791,1.4934121980590778,936,742,1678,+
chr1,32691796,0.6670274658368286,1019,777,1796,+
chr1,32692117,1.5027077497665733,1237,764,2001,+
chr1,32694196,1.6880316518298717,1448,1010,2458,+
chr1,32694395,1.6259259259259258,1316,1124,2440,+
chr1,32694406,1.469599749598967,1472,837,2309,+
chr1,32694407,2.307361002349256,1410,1276,2686,+
chr1,32694754,1.139566454685524,8431,6622,15053,+
chr1,32694756,1.0704929135551797,7418,5811,13229,+
chr1,32694786,1.6231566423494783,8463,6723,15186,+
chr1,32694787,1.7079042993058011,11453,9216,20669,+
chr1,32694788,1.7079042993058011,11453,9216,20669,+
chr1,32694789,1.7267523910924856,8728,7105,15833,+
chr1,32694793,1.927093811689984,6593,6099,12692,+
chr1,32694795,1.6329690106572476,17138,15053,32191,+
chr1,32694796,1.4644000392896797,18836,16122,34958,+
chr1,32696768,0.4788066616579013,804,725,1529,+
chr1,32696795,1.5983717774762551,867,736,1603,+
chr1,32696854,1.4610945954706323,2305,1663,3968,+
chr1,32696997,0.3357120695004654,1081,585,1666,+
chr1,32696999,0.4874588815789474,2370,1215,3585,+
chr1,32697000,0.5408114026947775,1859,928,2787,+
chr1,32697001,0.5538269505314162,2288,1294,3582,+
chr1,32697103,1.0054489973844811,1976,1479,3455,+
chr1,32697105,1.0054489973844811,1976,1479,3455,+
chr1,32697119,0.5302864725626414,646,556,1202,+
chr1,32794700,3.150776903894111,656,400,1056,+
chr1,32794702,3.150776903894111,656,400,1056,+
chr1,32797759,57.274273085236,1988,1601,3589,+
chr1,32797760,57.274273085236,1988,1601,3589,+
chr1,32798852,3.009174569395513,577,454,1031,+
chr1,32798898,2.0605322338830585,732,463,1195,+
chr1,32798900,1.5033475235006675,1106,750,1856,+
chr1,32799131,2.043475392531996,884,582,1466,+
chr1,32799132,2.40942064819847,1143,802,1945,+
chr1,33133891,6.564962476547843,902,532,1434,+
chr1,33133892,3.910639530529037,2005,1354,3359,+
chr1,33133918,1.971639471639472,608,428,1036,+
chr1,33133977,0.9279250161603104,1043,713,1756,+
chr1,33133979,0.9279250161603104,1043,713,1756,+
chr1,33134682,1.2559177454475958,1081,875,1956,+
chr1,33145486,1.9681748774411318,789,540,1329,+
chr1,33151663,3.1160572337042924,489,628,1117,+
chr1,33151664,3.1160572337042924,489,628,1117,+
chr1,33240320,5.548975649529064,618,491,1109,+
chr1,35824685,5.982870842725315,610,406,1016,+
chr1,35885640,3.443877551020408,599,447,1046,+
chr1,35885642,3.443877551020408,599,447,1046,+
chr1,36557665,0.9736024844720498,593,413,1006,+
chr1,36557666,0.9736024844720498,593,413,1006,+
chr1,36644564,3.4626511088597787,706,377,1083,+
chr1,36644578,1.8776119587424704,1577,976,2553,+
chr1,36644585,2.031884637224707,1539,1173,2712,+
chr1,36762217,1.8138888888888889,652,377,1029,+
chr1,36762225,2.358974358974359,703,428,1131,+
chr1,36762226,2.160921270510312,956,510,1466,+
chr1,36762228,2.160921270510312,956,510,1466,+
chr1,36762324,2.4552518756698825,1308,932,2240,+
chr1,36766529,1.5048199905727295,1114,866,1980,+
chr1,36766537,2.013980220576814,747,622,1369,+
chr1,36769895,39.51892511462048,1134,74,1208,+
chr1,36769897,29.083462547419135,2167,146,2313,+
chr1,36769898,21.813311358466397,1811,124,1935,+
chr1,36769901,13.023006386114295,1455,121,1576,+
chr1,36769902,11.836808012258574,1501,126,1627,+
chr1,36769903,11.836808012258574,1501,126,1627,+
chr1,36769912,19.492910119654077,988,1284,2272,+
chr1,36769942,0.25160638423174514,354,685,1039,+
chr1,36770229,2.3103738224412145,557,457,1014,+
chr1,38274821,0.5976926295657449,969,684,1653,+
chr1,38274899,0.23913536128207774,550,476,1026,+
chr1,38484179,0.5733825670896608,734,417,1151,+
chr1,38484745,2.6015625,554,479,1033,+
chr1,38489226,1.6636363636363636,792,494,1286,+
chr1,38489377,2.1739130434782608,699,459,1158,+
chr1,39469054,2.3960776462933184,594,407,1001,+
chr1,39491996,0.8021677273110008,1448,487,1935,+
chr1,39491998,0.7875280059746079,1025,308,1333,+
chr1,39492009,1.4091061540718353,1372,561,1933,+
chr1,39492017,1.3057600300865602,4975,3465,8440,+
chr1,39492020,1.3333650642551165,1287,954,2241,+
chr1,39492021,0.7506995143601454,2469,2107,4576,+
chr1,39492030,0.7819964038792121,9984,7840,17824,+
chr1,39492031,0.8876434185062975,12477,9109,21586,+
chr1,39492032,0.7819964038792121,9984,7840,17824,+
chr1,39492042,0.7631849579831453,16815,10585,27400,+
chr1,39492043,0.7243075708360444,15433,10630,26063,+
chr1,39492044,1.0508861013158193,5436,3384,8820,+
chr1,39492045,0.8203781855926576,20710,13824,34534,+
chr1,39492046,0.9862423612008082,35213,20294,55507,+
chr1,39492047,1.2585400295641789,15747,7405,23152,+
chr1,39492048,0.9480162269914911,37583,21501,59084,+
chr1,39492049,0.7625229547148348,20068,13174,33242,+
chr1,39492062,1.2739983998345408,5830,4108,9938,+
chr1,39492065,0.8587380269025877,30697,17958,48655,+
chr1,39494396,1.079626128938015,20610,13226,33836,+
chr1,39494450,1.6010984848484848,1965,1599,3564,+
chr1,39494477,1.3512064209737278,6538,4690,11228,+
chr1,39500196,1.675324675324675,1031,769,1800,+
chr1,39913190,2.8185483870967745,698,495,1193,+
chr1,39913191,2.2167491216288555,911,642,1553,+
chr1,39926367,2.3272611566303394,1271,966,2237,+
chr1,39926368,1.5703446855259544,1736,1323,3059,+
chr1,39926369,1.5703446855259544,1736,1323,3059,+
chr1,39926370,1.4077903091060984,1325,1025,2350,+
chr1,39929293,1.8877980364656384,672,433,1105,+
chr1,40205859,1.8148774660451377,641,443,1084,+
chr1,40205860,0.48650841955771956,871,635,1506,+
chr1,40205861,0.48650841955771956,871,635,1506,+
chr1,40205864,1.3580108860860718,750,599,1349,+
chr1,40208944,0.3511399787910922,882,655,1537,+
chr1,40211061,1.911431406355522,1916,1468,3384,+
chr1,40211062,1.3678979097189599,1655,1151,2806,+
chr1,40214601,0.3628636601779692,785,559,1344,+
chr1,40218584,2.2007394957983197,743,594,1337,+
chr1,40218585,2.3218350526327174,1168,945,2113,+
chr1,40218989,2.9026720360959493,879,633,1512,+
chr1,40219068,1.8603826071910525,780,614,1394,+
chr1,40506424,2.0052504908855737,721,474,1195,+
chr1,40506431,0.7225502876343953,1558,921,2479,+
chr1,40506439,1.7196473347892909,1062,633,1695,+
chr1,40525015,3.50451467268623,689,442,1131,+
chr1,40525044,1.6692028985507248,812,551,1363,+
chr1,40525045,1.0248318375606016,1849,1110,2959,+
chr1,40525084,1.9793454545454543,1133,624,1757,+
chr1,40525116,1.7244210977701544,1576,879,2455,+
chr1,40525123,1.3968819599109132,1455,897,2352,+
chr1,40525753,1.2768852413943557,6827,4400,11227,+
chr1,40525763,1.4746512465730504,11085,7819,18904,+
chr1,40525764,1.565702723173874,7787,5593,13380,+
chr1,40525765,1.4029746455383976,12968,8814,21782,+
chr1,40527408,0.5553135888501742,560,450,1010,+
chr1,40527430,2.154882154882155,759,593,1352,+
chr1,40527468,1.7524409871244633,2134,1863,3997,+
chr1,40527470,1.8703750794659886,3268,2903,6171,+
chr1,40527471,1.7670843311666098,3414,3159,6573,+
chr1,40527473,2.1039050161759723,3715,3151,6866,+
chr1,40530012,1.1512953404918165,1552,1139,2691,+
chr1,40530170,2.0738378614608615,1961,1337,3298,+
chr1,40530172,2.3537932283179432,1039,788,1827,+
chr1,40530173,2.225078369905956,1013,637,1650,+
chr1,40535830,0.48808720958664037,1124,768,1892,+
chr1,40535837,2.697812699086855,793,553,1346,+
chr1,40535894,2.230238095238095,645,524,1169,+
chr1,40536155,2.020981641064069,557,470,1027,+
chr1,40536163,1.8093000247341084,835,621,1456,+
chr1,40536559,2.2684740882917467,914,520,1434,+
chr1,40537166,2.4075460829493087,642,495,1137,+
chr1,40537277,0.4186046511627906,557,464,1021,+
chr1,40537347,0.33923603054992646,930,504,1434,+
chr1,40537403,1.7444866920152091,1146,525,1671,+
chr1,40537422,2.023656803917511,792,536,1328,+
chr1,40537459,1.533961676273563,1256,785,2041,+
chr1,40537484,1.4047975806837851,2598,1418,4016,+
chr1,40537506,0.6954027539457741,10348,6056,16404,+
chr1,40537518,1.603319166160696,3028,2195,5223,+
chr1,40537615,1.7645089285714286,917,575,1492,+
chr1,40537697,1.545961369622476,818,669,1487,+
chr1,40537699,2.431936371979199,635,466,1101,+
chr1,40537733,1.4978881904951944,1125,770,1895,+
chr1,40538060,0.6356102003642987,996,731,1727,+
chr1,40538122,1.6285385221555433,1413,1052,2465,+
chr1,40538129,0.5292078203220133,1078,777,1855,+
chr1,40724031,2.344413568113707,694,541,1235,+
chr1,40747019,1.4499312109287439,1025,653,1678,+
chr1,40751599,0.813710963052545,572,448,1020,+
chr1,40758360,3.0042657076561183,674,494,1168,+
chr1,41461652,4.519739765405249,695,511,1206,+
chr1,41466705,1.5739930556427566,1160,844,2004,+
chr1,41473183,2.9687880039175205,574,455,1029,+
chr1,41477737,3.213019494017478,625,431,1056,+
chr1,41477999,3.533785317469939,818,580,1398,+
chr1,42922991,1.8458258567697687,1331,730,2061,+
chr1,42922992,1.8458258567697687,1331,730,2061,+
chr1,42925279,2.154102564102564,812,467,1279,+
chr1,42925282,1.825717408022018,1073,796,1869,+
chr1,42925293,2.0771341463414634,756,409,1165,+
chr1,42925311,2.148521803399852,1236,819,2055,+
chr1,42925316,1.7527617043661232,2736,1900,4636,+
chr1,42925317,1.6871667948075315,3927,2596,6523,+
chr1,42925341,0.5913312693498451,1718,968,2686,+
chr1,42925342,1.7335509138381202,1896,1531,3427,+
chr1,42925346,1.8851555555555557,1927,1124,3051,+
chr1,43124130,0.4516691876949686,1251,671,1922,+
chr1,43124154,3.2649034424853065,706,396,1102,+
chr1,43131687,0.8095895760745916,975,566,1541,+
chr1,43131688,0.8653295571087266,796,489,1285,+
chr1,43148169,1.4441404534940692,1464,1116,2580,+
chr1,43148392,1.5413201663201663,658,415,1073,+
chr1,43149075,1.1494938002853428,1694,1124,2818,+
chr1,43149096,0.6666255474002345,771,522,1293,+
chr1,43149111,1.7696307300509335,980,607,1587,+
chr1,43159179,1.3264499171475914,2830,1590,4420,+
chr1,43161952,1.2652617267165194,2584,1470,4054,+
chr1,43162353,1.3145902246856838,3575,2634,6209,+
chr1,43162388,1.0462816414048803,6873,5163,12036,+
chr1,43162404,1.2795308143447746,4073,3466,7539,+
chr1,43162539,2.921790457452041,1055,427,1482,+
chr1,43162540,2.514181347729792,1072,522,1594,+
chr1,43162541,2.705891329373904,1340,726,2066,+
chr1,43162901,3.1585623678646937,663,472,1135,+
chr1,43166538,1.66132645728537,913,576,1489,+
chr1,43166566,2.1736672051696284,758,618,1376,+
chr1,43166643,1.4631851649850014,2554,1543,4097,+
chr1,43167705,1.5324130879345603,2140,1629,3769,+
chr1,43825213,1.7608230499595239,754,435,1189,+
chr1,43825214,2.1890528986562696,1224,707,1931,+
chr1,43825727,1.6211449388021812,1188,759,1947,+
chr1,43825990,1.2104861044790374,844,565,1409,+
chr1,43825991,1.4746489308087938,1203,824,2027,+
chr1,43826247,1.4249883857568386,760,515,1275,+
chr1,43826510,0.9828571428571429,687,419,1106,+
chr1,43826511,0.9828571428571429,687,419,1106,+
chr1,43826597,2.7569075592777827,595,464,1059,+
chr1,43827890,1.3918596517062862,656,512,1168,+
chr1,44088016,7.865486725663716,807,564,1371,+
chr1,44088017,19.053656465041076,1467,1087,2554,+
chr1,44088018,7.865486725663716,807,564,1371,+
chr1,44088029,2.0001507138476926,995,830,1825,+
chr1,44088030,2.0001507138476926,995,830,1825,+
chr1,44088393,14.049956378381392,1445,1101,2546,+
chr1,44088394,14.731602467232257,2566,2261,4827,+
chr1,44088395,14.67015161588969,2420,2170,4590,+
chr1,44089094,14.362037747735922,727,476,1203,+
chr1,44089095,12.373601597104564,977,805,1782,+
chr1,44438755,3.083569016845268,870,648,1518,+
chr1,45116714,6.576457457889305,997,97,1094,+
chr1,45116715,6.578589758672874,1201,121,1322,+
chr1,45116720,8.765368283459921,1847,270,2117,+
chr1,45116721,7.782404750895534,2268,356,2624,+
chr1,45116722,8.880591791526346,1587,246,1833,+
chr1,45116723,9.774589360355785,1443,279,1722,+
chr1,45116724,9.433925491756815,1034,211,1245,+
chr1,45116727,3.6659532173421447,2234,801,3035,+
chr1,45116728,3.6981566352139312,2811,1077,3888,+
chr1,45116729,3.6981566352139312,2811,1077,3888,+
chr1,45116730,3.6295144188754693,1653,714,2367,+
chr1,45116739,62.31126156280631,1786,1142,2928,+
chr1,45116740,62.31126156280632,1786,1142,2928,+
chr1,45206651,4.131815381422707,669,469,1138,+
chr1,45218813,1.3346812001875294,910,473,1383,+
chr1,45218814,1.6604631180690375,1207,710,1917,+
chr1,45218817,4.931861307572882,952,526,1478,+
chr1,45218819,2.4949232144524944,1507,902,2409,+
chr1,45218821,2.272527472527473,1033,649,1682,+
chr1,45218822,0.4153587443946189,626,445,1071,+
chr1,45218829,1.7932133149678604,3612,2513,6125,+
chr1,45218831,1.6390416668260002,4117,2858,6975,+
chr1,45225964,2.366810075526909,538,463,1001,+
chr1,45228120,0.3646042256202102,1011,712,1723,+
chr1,45228247,1.6366033755274263,641,473,1114,+
chr1,45228250,3.092369477911647,559,497,1056,+
chr1,45232823,1.6955089851854739,572,483,1055,+
chr1,45233012,8.286379622926912,1036,723,1759,+
chr1,45241232,1.307888351739914,921,530,1451,+
chr1,45241234,1.2118020827204803,957,738,1695,+
chr1,45241236,1.2099999527428427,2123,1492,3615,+
chr1,45241244,0.6184526803410125,4864,1995,6859,+
chr1,45241245,0.6809587219838864,11742,5055,16797,+
chr1,45241247,0.7753561979136387,13006,4532,17538,+
chr1,45241248,1.3556270904761574,4527,3046,7573,+
chr1,45241249,1.232719827408948,26697,13485,40182,+
chr1,45241250,1.421330707893765,22253,11984,34237,+
chr1,45241264,1.5310682370145898,13216,7864,21080,+
chr1,45241265,1.4238749674437967,7089,5340,12429,+
chr1,45241266,1.3914251823558172,15918,11985,27903,+
chr1,45241267,1.483590447229845,6704,2909,9613,+
chr1,45241268,1.457842101728981,14145,10878,25023,+
chr1,45241269,1.563681678261659,5627,4562,10189,+
chr1,45241709,1.540570495327098,19678,10598,30276,+
chr1,45241711,1.43890308373164,23117,12618,35735,+
chr1,45241716,1.380438944682658,9840,7992,17832,+
chr1,45241717,1.53405419780443,29168,18014,47182,+
chr1,45241719,1.6273852776568132,19328,10022,29350,+
chr1,45241725,1.881415773625344,12327,10857,23184,+
chr1,45241726,1.8429036887135493,18393,16400,34793,+
chr1,45241752,1.1904420701913399,21703,14521,36224,+
chr1,45241803,1.2057525332825496,10808,7887,18695,+
chr1,45241809,1.0258948793819327,21275,14258,35533,+
chr1,45242384,1.642800466230317,20981,16359,37340,+
chr1,45242394,1.1721216419968714,33553,21133,54686,+
chr1,45242395,1.2253066747156665,45813,30468,76281,+
chr1,45243298,1.5214509516498056,13917,9889,23806,+
chr1,45243332,0.9353851835751567,65356,50014,115370,+
chr1,45243420,1.3799567618273445,19783,10737,30520,+
chr1,45243443,1.3866611466140177,54586,37588,92174,+
chr1,45244326,1.0069471799261445,30090,22992,53082,+
chr1,45478682,0.34987934722582464,734,567,1301,+
chr1,45479593,0.875912408759124,743,410,1153,+
chr1,45479594,0.875912408759124,743,410,1153,+
chr1,45479655,3.4417572110699663,860,606,1466,+
chr1,45480429,2.029448153274677,625,466,1091,+
chr1,45480496,0.9810853950518756,646,357,1003,+
chr1,45480497,1.630656809215032,1635,846,2481,+
chr1,45480627,1.8745800541818751,1111,573,1684,+
chr1,45480632,2.1132965263400045,966,620,1586,+
chr1,45480633,2.1132965263400045,966,620,1586,+
chr1,45480636,2.5767341927562923,729,361,1090,+
chr1,45480645,1.6105486399033175,2113,1286,3399,+
chr1,45480646,2.1797063555913114,1274,903,2177,+
chr1,45481086,0.3317233007276044,659,483,1142,+
chr1,45481171,3.266297553134488,507,508,1015,+
chr1,45481173,3.266297553134488,507,508,1015,+
chr1,45792977,4.204353172628366,702,401,1103,+
chr1,45793613,2.179390094036974,681,464,1145,+
chr1,45793795,1.6543587932146144,640,562,1202,+
chr1,45794055,0.988663967611336,887,759,1646,+
chr1,45794056,0.988663967611336,887,759,1646,+
chr1,46016741,0.3039307880383675,605,408,1013,+
chr1,46016742,0.3039307880383675,605,408,1013,+
chr1,46016748,2.332613390928726,539,462,1001,+
chr1,46016749,2.332613390928726,539,462,1001,+
chr1,46032251,1.6706586826347305,674,500,1174,+
chr1,46032283,0.3765190972222222,693,511,1204,+
chr1,46033676,0.5891625615763546,597,463,1060,+
chr1,46034182,2.166256058003163,615,468,1083,+
chr1,46034266,1.6803469430928706,610,488,1098,+
chr1,46034317,1.8956427015250548,790,679,1469,+
chr1,46034318,1.8956427015250548,790,679,1469,+
chr1,46034349,0.6107843137254902,622,407,1029,+
chr1,46034660,2.6550976138828637,662,460,1122,+
chr1,46034870,1.789865178986518,615,477,1092,+
chr1,46049728,2.311934897963829,601,461,1062,+
chr1,46067991,1.6232764073371284,801,526,1327,+
chr1,46072206,1.7947493298000186,2117,1563,3680,+
chr1,46072207,1.7947493298000186,2117,1563,3680,+
chr1,46072214,0.9821596244131455,4183,4259,8442,+
chr1,46072215,1.6641304248230124,5208,4280,9488,+
chr1,46072216,1.211336064304462,7085,6680,13765,+
chr1,46072222,2.104111228329843,3219,3097,6316,+
chr1,46072223,1.1946064753204606,5392,4753,10145,+
chr1,46072224,1.3179857336801697,13121,12286,25407,+
chr1,46072225,1.3453885443926998,8795,8130,16925,+
chr1,46072228,1.027005676968512,5091,4977,10068,+
chr1,46072229,1.6200607444587638,2086,1922,4008,+
chr1,46078910,1.8290805262928678,2870,2039,4909,+
chr1,46079967,2.201514701514702,592,480,1072,+
chr1,46080804,2.270300657557095,1804,1279,3083,+
chr1,46080839,0.3354010695187165,587,424,1011,+
chr1,46080848,1.3799264938328346,2185,1567,3752,+
chr1,46081026,1.968461486623088,1269,780,2049,+
chr1,46081027,1.968461486623088,1269,780,2049,+
chr1,46081030,2.026813590449954,711,494,1205,+
chr1,46081032,1.80798510323676,916,588,1504,+
chr1,46081033,4.028981039001079,725,498,1223,+
chr1,46082303,2.1194105099864258,1476,1145,2621,+
chr1,46082305,2.1194105099864258,1476,1145,2621,+
chr1,46082315,1.4643373058866016,992,638,1630,+
chr1,46083781,13.686739252072147,1658,1142,2800,+
chr1,46083783,3.4175614194722472,1057,784,1841,+
chr1,46083785,2.8211502222429963,1019,777,1796,+
chr1,46156713,1.682320286225033,704,495,1199,+
chr1,46769340,0.8458028806789892,1222,805,2027,+
chr1,46769341,0.977989823617281,1624,1338,2962,+
chr1,46769342,1.0685397077149654,647,678,1325,+
chr1,46769361,2.178903721682848,694,411,1105,+
chr1,46769362,0.7677800960084353,4154,3066,7220,+
chr1,46769364,0.7677800960084353,4154,3066,7220,+
chr1,46769368,1.1846204443951716,9176,6289,15465,+
chr1,46769370,1.031757419671327,3912,2879,6791,+
chr1,46769374,1.435900944561066,8780,6146,14926,+
chr1,46769380,1.0556819937323447,4582,3071,7653,+
chr1,46769382,1.0556819937323447,4582,3071,7653,+
chr1,46769415,0.7804551446288663,3264,2291,5555,+
chr1,46769471,1.4031089294062646,2400,1425,3825,+
chr1,46769479,1.8669580595503945,3937,2628,6565,+
chr1,46775865,1.4050107297169856,3280,2210,5490,+
chr1,46775866,1.3648928498245165,5879,3653,9532,+
chr1,46775867,0.7659789732987287,4748,3579,8327,+
chr1,46775868,0.7659789732987287,4748,3579,8327,+
chr1,46775870,1.7488157004286038,3100,1715,4815,+
chr1,46775873,1.4159169599971553,5495,3428,8923,+
chr1,46775939,1.5062726130174808,2272,1704,3976,+
chr1,47834140,1.8559584590212104,1210,809,2019,+
chr1,47834142,2.3361629881154498,863,588,1451,+
chr1,47834144,2.255151098901099,596,415,1011,+
chr1,47834169,3.9827426810477657,717,589,1306,+
chr1,47834171,3.9827426810477657,717,589,1306,+
chr1,47838651,2.2619494494494496,1032,665,1697,+
chr1,47840915,1.8084444444444443,625,499,1124,+
chr1,47842745,1.5851212686567167,970,669,1639,+
chr1,47843254,1.773497997329773,856,534,1390,+
chr1,47843589,2.455798106006337,847,618,1465,+
chr1,47844078,0.5056326451675289,746,480,1226,+
chr1,52237791,1.1534582983075932,680,546,1226,+
chr1,52253412,1.7460937499999996,744,479,1223,+
chr1,52253417,2.155545112781955,1111,607,1718,+
chr1,52253516,3.058599668713452,766,586,1352,+
chr1,52253634,3.028037916092061,542,459,1001,+
chr1,52522007,1.4078828567823214,822,549,1371,+
chr1,52551791,2.402529363141204,630,460,1090,+
chr1,52552413,1.8606393606393603,744,538,1282,+
chr1,52552469,2.249240121580547,739,516,1255,+
chr1,52552721,1.495089477381253,619,421,1040,+
chr1,52553883,2.849390919158361,663,515,1178,+
chr1,52553884,2.849390919158361,663,515,1178,+
chr1,52880313,1.4149468417761102,723,491,1214,+
chr1,52880446,2.005751132798885,676,452,1128,+
chr1,52880448,2.005751132798885,676,452,1128,+
chr1,52880449,1.840782122905028,658,357,1015,+
chr1,52881010,2.0318979266347688,636,455,1091,+
chr1,52881019,1.7594053441329192,4120,2699,6819,+
chr1,52881020,1.7273396200840383,1877,1200,3077,+
chr1,52883372,1.3293524336727411,935,455,1390,+
chr1,53480618,0.9753688041799322,1409,1116,2525,+
chr1,53480619,0.7975920831422143,2374,1833,4207,+
chr1,53493643,2.007606263982103,640,446,1086,+
chr1,53493657,1.7866004962779158,819,532,1351,+
chr1,53493683,2.38416500332668,1747,1335,3082,+
chr1,53493685,2.38416500332668,1747,1335,3082,+
chr1,53516723,1.7126404094980803,729,540,1269,+
chr1,54433626,5.711016524299084,613,477,1090,+
chr1,54433718,2.7217528498584964,682,619,1301,+
chr1,54665856,1.3422672549980934,783,632,1415,+
chr1,54665859,0.46296875475662613,1995,1068,3063,+
chr1,54665866,0.6736180072823569,2034,1006,3040,+
chr1,54665868,1.421931735657226,2224,2039,4263,+
chr1,54665869,1.248515650235041,8493,6091,14584,+
chr1,54665871,1.265180496232159,14091,9370,23461,+
chr1,54665872,1.3049233883476623,7124,5237,12361,+
chr1,54665908,1.9983397956722888,646,412,1058,+
chr1,54666210,0.962827629822219,883,748,1631,+
chr1,54666211,0.962827629822219,883,748,1631,+
chr1,54666228,2.447552447552448,594,428,1022,+
chr1,54670716,0.4374801951961468,530,508,1038,+
chr1,54670726,1.743466223698782,850,601,1451,+
chr1,54670819,1.6620137725665367,892,596,1488,+
chr1,54670987,0.4966981598733676,1384,1063,2447,+
chr1,54670988,0.8948019362211231,1985,1537,3522,+
chr1,54671044,1.6191664809449522,885,640,1525,+
chr1,54675665,2.129586260733802,743,548,1291,+
chr1,54678278,1.9680434297574965,1216,986,2202,+
chr1,54678326,3.900949796472185,749,401,1150,+
chr1,54681814,2.794582632989939,969,831,1800,+
chr1,54681823,1.9684512428298278,567,522,1089,+
chr1,54681895,1.6836388323150033,743,490,1233,+
chr1,54681896,0.5486914181375533,600,423,1023,+
chr1,54681906,1.3679687321432652,949,652,1601,+
chr1,54681933,0.5117256637168142,770,564,1334,+
chr1,54681976,3.011727078891258,564,468,1032,+
chr1,54683900,1.587114337568058,847,607,1454,+
chr1,55509636,2.0431859820298803,676,536,1212,+
chr1,55509645,0.4571410680606781,887,673,1560,+
chr1,55509702,3.8121065375302665,655,412,1067,+
chr1,55512217,2.022076288947883,602,420,1022,+
chr1,55512303,0.9720543583400479,1188,815,2003,+
chr1,55517978,1.9793814432989687,1055,678,1733,+
chr1,55517980,1.9806653841983297,1530,1037,2567,+
chr1,55518010,0.5829177057356609,659,400,1059,+
chr1,55518047,2.6684819605173584,559,451,1010,+
chr1,55523024,1.0253505169239483,904,613,1517,+
chr1,55523025,1.0253505169239483,904,613,1517,+
chr1,55523088,1.8052217609788068,660,397,1057,+
chr1,55523720,2.185741791320139,786,577,1363,+
chr1,55524253,1.2136040112709392,747,485,1232,+
chr1,55527200,2.650554779418394,660,518,1178,+
chr1,55529210,2.571725788206178,570,451,1021,+
chr1,55529301,11.748829401214083,3777,2861,6638,+
chr1,55529302,11.748829401214083,3777,2861,6638,+
chr1,55529303,11.748829401214083,3777,2861,6638,+
chr1,55529311,0.7980845170844527,1449,1149,2598,+
chr1,55529312,1.0367372353673725,998,802,1800,+
chr1,55529432,2.8208239644035986,681,564,1245,+
chr1,55529546,2.603890362511052,588,521,1109,+
chr1,55529582,2.6992199071788288,780,532,1312,+
chr1,55529673,8.89751552795031,1145,321,1466,+
chr1,55529675,8.69135802469136,1119,314,1433,+
chr1,55529677,9.801227232386047,3569,1264,4833,+
chr1,55529678,9.398271120593241,3562,1292,4854,+
chr1,55529679,6.922235292318797,2123,770,2893,+
chr1,55529680,6.655023547880691,1093,363,1456,+
chr1,55529683,3.130813953488372,717,300,1017,+
chr1,55529685,3.1671826625387,1115,509,1624,+
chr1,55529686,3.400429939101545,2863,1754,4617,+
chr1,55529687,2.982346676895186,4045,2335,6380,+
chr1,55529688,3.4276718147947003,2337,1402,3739,+
chr1,55529689,1.6611742424242426,1252,659,1911,+
chr1,55529690,1.0995565410199557,854,450,1304,+
chr1,55529702,12.08891707937003,3153,3184,6337,+
chr1,55529703,10.21961401098062,5428,5574,11002,+
chr1,55529704,10.219614010980619,5428,5574,11002,+
chr1,55529705,13.401917338343953,4377,4699,9076,+
chr1,55529743,0.46745152354570635,674,721,1395,+
chr1,55529774,0.4279569892473118,795,743,1538,+
chr1,55530050,2.2553122465531223,631,410,1041,+
chr1,55530094,3.104291497975708,660,474,1134,+
chr1,55530101,1.7384390404659298,1388,1082,2470,+
chr1,55530131,0.5768172888015717,733,508,1241,+
chr1,55530134,1.7937508757180889,691,548,1239,+
chr1,55530188,2.8767197821837636,1331,1048,2379,+
chr1,55530222,1.748554628246404,1032,714,1746,+
chr1,55530325,2.025847889089058,1271,750,2021,+
chr1,55530326,2.025847889089058,1271,750,2021,+
chr1,55530356,0.678958980593453,886,672,1558,+
chr1,55530357,1.6322778345250255,815,533,1348,+
chr1,55530367,2.548828125,584,511,1095,+
chr1,55530376,1.6297791335061125,934,738,1672,+
chr1,55530400,2.784371995454943,723,672,1395,+
chr1,57111058,2.402299535035484,681,359,1040,+
chr1,62910663,0.4855371900826446,704,560,1264,+
chr1,63329709,1.790175769457582,1040,553,1593,+
chr1,63329743,1.516107692717025,1938,1136,3074,+
chr1,64059121,2.8843549227296403,790,442,1232,+
chr1,64059122,2.8843549227296403,790,442,1232,+
chr1,64059148,2.809234214257379,1138,567,1705,+
chr1,64095106,1.076026977314531,701,465,1166,+
chr1,64095108,0.9023386887589999,931,657,1588,+
chr1,64097426,2.904458598726115,683,470,1153,+
chr1,64101908,3.1160232112687756,930,697,1627,+
chr1,64104380,1.4464386720459195,1007,807,1814,+
chr1,64104381,0.9270270270270271,685,517,1202,+
chr1,64114205,0.37202918666098334,717,557,1274,+
chr1,64114284,2.0175777511105406,841,608,1449,+
chr1,64117401,1.1411079919565992,884,714,1598,+
chr1,64117441,2.905024589121618,987,690,1677,+
chr1,64125344,4.03888381963678,738,520,1258,+
chr1,64125531,2.625984251968504,666,380,1046,+
chr1,64125789,3.0860033726812817,914,592,1506,+
chr1,65897645,0.5189408371532201,1349,879,2228,+
chr1,70687409,11.92284703741705,902,1079,1981,+
chr1,70687410,14.05447827408891,1387,1604,2991,+
chr1,70687411,14.718526252887079,1249,1500,2749,+
chr1,70687416,0.3283502168619346,782,1237,2019,+
chr1,70687417,0.851592801582639,752,1198,1950,+
chr1,70687418,0.2562878394741394,462,614,1076,+
chr1,70687419,0.8552453239360259,630,1053,1683,+
chr1,70687420,0.6124212169455944,1013,1435,2448,+
chr1,70687432,0.31517665040999854,1055,1400,2455,+
chr1,70687433,0.2993371630503437,1314,1752,3066,+
chr1,70703140,1.5226864791246901,2254,1481,3735,+
chr1,70703144,1.3471194075296065,3426,2472,5898,+
chr1,70703145,1.5161916293249298,4674,3457,8131,+
chr1,70703146,1.5161916293249298,4674,3457,8131,+
chr1,70703147,1.4786331657647938,6612,4731,11343,+
chr1,70703197,1.2994925193990252,2306,1257,3563,+
chr1,70705150,1.5613434955690253,1560,876,2436,+
chr1,70705155,1.2798729164273035,4910,2955,7865,+
chr1,70710379,1.640989295597644,2937,2113,5050,+
chr1,70710396,1.5344999181837853,2982,1938,4920,+
chr1,70710397,1.3732630635280694,2221,1773,3994,+
chr1,70710402,0.7044637936735368,1681,1054,2735,+
chr1,70710403,1.4783582581197705,1979,1411,3390,+
chr1,70710406,2.177556041552761,1968,1297,3265,+
chr1,70710424,3.5002840909090907,2552,2023,4575,+
chr1,70710427,1.5615694343174076,9293,7648,16941,+
chr1,70712551,1.6445153287258547,639,512,1151,+
chr1,70715674,1.2614325691410708,1751,1237,2988,+
chr1,70715676,1.2191336002993864,1650,1185,2835,+
chr1,70716357,1.58125,758,495,1253,+
chr1,70716579,0.1852215459126906,565,462,1027,+
chr1,70716716,0.6130610743193525,876,603,1479,+
chr1,70718114,36.738144329896905,648,484,1132,+
chr1,70718115,29.246413290446338,657,1058,1715,+
chr1,70877258,1.43777849217222,1031,745,1776,+
chr1,70883668,1.8759861893830827,1037,759,1796,+
chr1,70883671,1.9402506194884155,1419,1047,2466,+
chr1,70889988,2.26630998337714,858,673,1531,+
chr1,70890072,1.2719841291291494,1343,948,2291,+
chr1,70895517,0.4511278195488721,739,517,1256,+
chr1,70895527,2.421314411359577,1044,669,1713,+
chr1,70897908,0.5841666666666666,700,509,1209,+
chr1,70904442,1.651560926485398,901,661,1562,+
chr1,76190439,0.4989579212169328,630,423,1053,+
chr1,76228715,0.612476370510397,791,505,1296,+
chr1,76228758,1.94,1163,674,1837,+
chr1,76228765,1.7132363648403997,2076,1328,3404,+
chr1,76228766,1.1820466786355477,822,556,1378,+
chr1,76228775,2.9769950218735857,1360,946,2306,+
chr1,76228814,1.584402413670706,918,532,1450,+
chr1,76228832,1.623199819981998,1373,807,2180,+
chr1,76228842,1.6557734204793029,1519,917,2436,+
chr1,76228845,1.5892412527846937,734,586,1320,+
chr1,76228848,1.7414285714285715,827,699,1526,+
chr1,76228851,0.9953122447084913,2874,1998,4872,+
chr1,76253249,0.9364003605648847,1752,1166,2918,+
chr1,76253250,0.9364003605648847,1752,1166,2918,+
chr1,76253254,1.4587962962962966,958,671,1629,+
chr1,76254954,1.6207584830339323,783,500,1283,+
chr1,76255693,2.5849406124005667,817,482,1299,+
chr1,76257202,2.2081159420289858,585,459,1044,+
chr1,76257869,0.4100996246132814,1306,1035,2341,+
chr1,76259770,2.0247011952191234,725,501,1226,+
chr1,76259814,0.4459319577668898,717,673,1390,+
chr1,78470659,2.30801169053534,874,664,1538,+
chr1,78479056,2.6080274762057223,1178,798,1976,+
chr1,78479057,2.8337394179447717,1787,1071,2858,+
chr1,78479058,2.0880001757644044,1550,1033,2583,+
chr1,78479060,1.7733447087402037,3241,1717,4958,+
chr1,78479061,2.8181818181818183,1425,1176,2601,+
chr1,78479062,2.184300058402503,5428,3313,8741,+
chr1,78479063,2.5238397173881046,2940,1989,4929,+
chr1,78479194,1.4303052669831087,672,490,1162,+
chr1,84946657,1.6361134446785885,592,446,1038,+
chr1,84955357,0.5922114608555287,586,471,1057,+
chr1,84956036,1.8994376146118295,1504,1208,2712,+
chr1,84956043,2.035567715458276,619,429,1048,+
chr1,84956054,0.4270416087631815,1305,940,2245,+
chr1,84956085,1.745563616632167,3755,2926,6681,+
chr1,84956086,1.745563616632167,3755,2926,6681,+
chr1,84956087,1.745563616632167,3755,2926,6681,+
chr1,84961101,2.661345103553717,1071,694,1765,+
chr1,86047257,1.7518486298390603,536,483,1019,+
chr1,86047788,1.845247446975648,608,468,1076,+
chr1,86047856,2.4130179740559417,730,624,1354,+
chr1,86047874,2.3060877722316726,917,718,1635,+
chr1,86047882,3.014020104126105,914,680,1594,+
chr1,86047938,0.4702690182323549,835,642,1477,+
chr1,86048428,1.7228220858895704,738,651,1389,+
chr1,86048440,0.6582580743915505,826,694,1520,+
chr1,86048512,1.9780344249324375,2796,2036,4832,+
chr1,86048513,1.8799420049710025,2202,1699,3901,+
chr1,86048516,2.2155924570785253,655,373,1028,+
chr1,86048555,2.0386460230353576,2383,1579,3962,+
chr1,86048556,2.6584607543323138,1212,653,1865,+
chr1,86048638,1.8970180527861211,1608,1205,2813,+
chr1,86048666,2.654385342638255,1171,885,2056,+
chr1,86048809,6.951561951561952,1164,258,1422,+
chr1,86048810,7.307650920682596,2392,481,2873,+
chr1,86048812,10.781199925740276,1363,212,1575,+
chr1,86048814,11.07034451264663,2260,417,2677,+
chr1,86048815,76.00947119179163,925,361,1286,+
chr1,86048816,28.024951238978588,6896,4019,10915,+
chr1,86048817,26.075048686533815,5960,3845,9805,+
chr1,86048818,24.507067841482314,5650,3791,9441,+
chr1,86048824,5.797022798079324,4033,6351,10384,+
chr1,86048825,5.797022798079323,4033,6351,10384,+
chr1,86048833,0.3380607737746794,769,1633,2402,+
chr1,86048834,0.3570739135116676,2703,4721,7424,+
chr1,86049135,1.587547356283973,1263,933,2196,+
chr1,86049285,4.630544971112097,4738,3521,8259,+
chr1,86049286,4.381606434336714,6566,4829,11395,+
chr1,87538637,1.007640232108317,905,516,1421,+
chr1,87538638,1.007640232108317,905,516,1421,+
chr1,87538660,2.374893977947413,671,392,1063,+
chr1,87797906,2.3737937769417803,672,479,1151,+
chr1,87805220,2.3935029114311983,1703,1003,2706,+
chr1,87805221,2.563707039513521,2243,1291,3534,+
chr1,87805226,1.894386078585644,1894,1270,3164,+
chr1,87805227,1.894386078585644,1894,1270,3164,+
chr1,87805282,1.8631163390267484,924,427,1351,+
chr1,87805311,0.4692482915717539,617,438,1055,+
chr1,87810769,12.810660851652614,1322,1453,2775,+
chr1,87810770,12.810660851652614,1322,1453,2775,+
chr1,87810786,0.3027660324171952,490,527,1017,+
chr1,87810788,0.28623255152135857,1330,1631,2961,+
chr1,87810790,0.3486068684624641,537,553,1090,+
chr1,87810823,0.3474399164054336,569,695,1264,+
chr1,87810824,0.3474399164054336,569,695,1264,+
chr1,89206803,2.2748493945982773,652,458,1110,+
chr1,89225920,2.3782745371987426,618,408,1026,+
chr1,89299642,2.8992536115569827,602,448,1050,+
chr1,89300851,3.9448286840517066,672,465,1137,+
chr1,89300853,4.820812252290646,735,515,1250,+
chr1,91973427,4.616976028228281,713,554,1267,+
chr1,93297593,0.9728453662619242,7336,4915,12251,+
chr1,93297594,0.9481321361637043,20230,14040,34270,+
chr1,93297595,0.9420348518446506,37219,26840,64059,+
chr1,93297596,1.0174800859764253,44333,30848,75181,+
chr1,93297597,0.8462744565899919,46183,33166,79349,+
chr1,93297598,0.9406353527136233,35942,25476,61418,+
chr1,93297629,1.1767832803071012,14936,10589,25525,+
chr1,93297660,1.4265222359175302,15118,10370,25488,+
chr1,93298963,1.223888322573338,7477,5449,12926,+
chr1,93299100,0.39797527852790904,948,694,1642,+
chr1,93300333,0.9482820976491864,923,769,1692,+
chr1,93300334,0.8672597866644112,1476,1201,2677,+
chr1,93300382,0.4976302368927011,14602,9210,23812,+
chr1,93300419,1.595862359122807,68978,40647,109625,+
chr1,93300421,1.38165487818242,179539,104495,284034,+
chr1,93300422,1.319198113408237,184311,106642,290953,+
chr1,93300423,1.3451491858914988,130868,79315,210183,+
chr1,93300424,1.378944725788931,89940,51279,141219,+
chr1,93300430,1.0996843478761689,68022,40034,108056,+
chr1,93301777,0.8370673450748226,10468,7671,18139,+
chr1,93301854,0.5912650476830469,13760,7746,21506,+
chr1,93301878,0.8511895224562781,17110,8072,25182,+
chr1,93301881,0.7364173344651219,31574,14690,46264,+
chr1,93301884,0.7895603355831704,18964,8299,27263,+
chr1,93301895,1.1287678156508636,23191,9774,32965,+
chr1,93301932,0.9092879739797611,82044,46067,128111,+
chr1,93303011,0.4992367822741391,619,462,1081,+
chr1,93306122,1.2587863241882102,12881,7338,20219,+
chr1,93306147,1.4545307804134455,14711,9797,24508,+
chr1,93306148,1.4545307804134455,14711,9797,24508,+
chr1,93812228,2.898618353271053,984,724,1708,+
chr1,93826262,2.1434220272359514,640,430,1070,+
chr1,93826643,7.004764317740661,1011,764,1775,+
chr1,93965088,0.16211985030165454,612,398,1010,+
chr1,95710065,2.8428809272488973,746,450,1196,+
chr1,95710068,3.339881188118812,726,504,1230,+
chr1,95710070,2.4334063031763478,1380,975,2355,+
chr1,95710071,2.8474520905923346,757,573,1330,+
chr1,99203819,2.72579923970173,789,572,1361,+
chr1,100503804,1.8702139909797522,638,612,1250,+
chr1,100503806,1.8141856160761505,997,991,1988,+
chr1,100503807,1.7007887323943662,693,709,1402,+
chr1,100503845,2.2889983579638757,696,521,1217,+
chr1,100503846,2.2889983579638757,696,521,1217,+
chr1,100535203,1.348065748387889,691,545,1236,+
chr1,100544037,0.9722814498933902,607,401,1008,+
chr1,100544039,0.9722814498933902,607,401,1008,+
chr1,100548423,1.4201215876155149,674,440,1114,+
chr1,100740382,1.334158878504673,920,534,1454,+
chr1,100740383,1.088274932614555,645,370,1015,+
chr1,100752707,2.853232382061736,1135,807,1942,+
chr1,100752708,2.853232382061736,1135,807,1942,+
chr1,100752723,1.8854944029850744,538,535,1073,+
chr1,100752734,1.5611464968152868,911,784,1695,+
chr1,109181510,2.446540571573188,630,407,1037,+
chr1,109238720,0.7847317580274601,643,440,1083,+
chr1,109239235,0.9279863914443205,934,655,1589,+
chr1,109242401,1.0926989335520918,665,423,1088,+
chr1,109242402,1.7820975614205319,902,627,1529,+
chr1,109351593,2.1074643192576494,640,456,1096,+
chr1,109444517,2.3004518424334117,1336,1160,2496,+
chr1,109444518,2.3003609403968124,1737,1522,3259,+
chr1,109444521,1.8607604227563344,1284,1281,2565,+
chr1,109444527,5.979400749063672,514,533,1047,+
chr1,109444531,2.0666097717447096,2574,3244,5818,+
chr1,109444532,2.0666097717447096,2574,3244,5818,+
chr1,109444533,2.434048798610313,1889,2479,4368,+
chr1,109461391,3.28476821192053,743,452,1195,+
chr1,109461392,3.28476821192053,743,452,1195,+
chr1,109466670,0.3445115980086438,809,545,1354,+
chr1,109472329,3.939240506329115,777,394,1171,+
chr1,109472330,3.939240506329115,777,394,1171,+
chr1,109472387,0.5046457607433217,710,377,1087,+
chr1,109472406,2.6074398249452955,661,456,1117,+
chr1,109472408,1.9577218728162122,861,476,1337,+
chr1,109637594,12.93365166252752,415,1162,1577,+
chr1,109756628,0.7050430896903926,596,481,1077,+
chr1,109756643,2.043957219251337,658,549,1207,+
chr1,109756684,1.863487738419619,976,733,1709,+
chr1,109756695,1.9209395099785604,2069,1588,3657,+
chr1,109756696,1.9209395099785604,2069,1588,3657,+
chr1,109757604,2.3392188427927683,619,393,1012,+
chr1,109757605,2.3392188427927683,619,393,1012,+
chr1,109766601,0.6925675675675675,819,591,1410,+
chr1,109766659,1.5103370786516852,1221,889,2110,+
chr1,109773631,1.7879181236714756,1216,844,2060,+
chr1,109774271,2.0050125313283207,699,587,1286,+
chr1,109777880,0.6639692701664534,925,780,1705,+
chr1,109777960,1.7230014025245444,727,367,1094,+
chr1,109777964,1.726700971983991,603,476,1079,+
chr1,109778047,2.456400181351065,601,508,1109,+
chr1,109778634,1.5422681303483448,914,502,1416,+
chr1,109778643,2.6389656854773134,600,472,1072,+
chr1,109779100,1.6007252915598873,1641,1299,2940,+
chr1,109779110,2.102425876010782,1208,741,1949,+
chr1,109779904,2.413523548954465,949,730,1679,+
chr1,109779947,0.5968992248062016,951,687,1638,+
chr1,109780364,1.7321985815602836,851,704,1555,+
chr1,109780470,1.2234593262029994,3499,2366,5865,+
chr1,109780471,0.9967068105071272,2137,1534,3671,+
chr1,109780618,1.6293438454652385,1466,1014,2480,+
chr1,109780647,2.0047700587084147,885,583,1468,+
chr1,109780654,1.6858006042296072,836,661,1497,+
chr1,109780658,0.5329635546980979,883,676,1559,+
chr1,110091422,1.5092245378222908,632,524,1156,+
chr1,110091423,3.0485749947992518,552,505,1057,+
chr1,110121864,4.127862595419847,617,392,1009,+
chr1,110125079,1.634234501881561,942,611,1553,+
chr1,110129438,0.267062517062517,558,443,1001,+
chr1,110134676,2.5384615384615383,626,493,1119,+
chr1,110134719,0.6013165667988859,749,577,1326,+
chr1,110134748,1.5312441726008024,1766,1084,2850,+
chr1,110135056,1.906730769230769,660,415,1075,+
chr1,110135419,2.160231450521575,1355,958,2313,+
chr1,110135436,2.3005102040816325,667,489,1156,+
chr1,110135762,1.9253224711473185,708,490,1198,+
chr1,110135890,1.2055764484256328,911,793,1704,+
chr1,110527573,16.060192317967633,1544,449,1993,+
chr1,110527574,16.060192317967633,1544,449,1993,+
chr1,110527624,4.0689516390845,1341,474,1815,+
chr1,110527625,4.13023226509633,1777,694,2471,+
chr1,110527626,3.556732663084984,2060,895,2955,+
chr1,110527627,3.321954680012724,1947,933,2880,+
chr1,110527628,3.2412618980297125,1557,790,2347,+
chr1,110527629,3.4563492063492065,736,395,1131,+
chr1,110527637,10.870107948158733,1923,1319,3242,+
chr1,110527638,12.323867887214462,2567,1899,4466,+
chr1,110527639,8.423799500997868,2806,2132,4938,+
chr1,110527640,8.955266003629585,2169,1763,3932,+
chr1,110527641,5.084366166557946,697,656,1353,+
chr1,110527646,6.215663328972174,1873,2160,4033,+
chr1,110527647,6.215663328972174,1873,2160,4033,+
chr1,110527651,0.34233288919057814,1095,1676,2771,+
chr1,110527652,0.6602269819896294,960,1270,2230,+
chr1,110527658,0.28906588674678707,661,836,1497,+
chr1,110527667,0.9496772141595458,807,982,1789,+
chr1,110527670,1.2742762683900006,2508,3356,5864,+
chr1,110527672,1.4972238541556804,7485,10170,17655,+
chr1,110527673,1.5764477429769959,6369,8726,15095,+
chr1,110527674,1.6087656881219807,4660,7042,11702,+
chr1,110527677,0.47652447973179424,5207,7626,12833,+
chr1,110527678,0.5842099425432434,5940,7883,13823,+
chr1,110527679,0.5221708381341322,9691,12734,22425,+
chr1,110527680,0.5202907684104771,5630,7954,13584,+
chr1,110527690,0.49498704152756473,2070,2330,4400,+
chr1,110527750,1.020640461375019,537,598,1135,+
chr1,110527752,1.020640461375019,537,598,1135,+
chr1,110527788,1.1417624521072796,1042,637,1679,+
chr1,110527789,1.1417624521072796,1042,637,1679,+
chr1,110551692,1.7315964240102173,891,724,1615,+
chr1,110551721,1.409677419354839,873,699,1572,+
chr1,110551737,1.2984831889541637,1261,995,2256,+
chr1,110553848,1.8189886911383017,1480,898,2378,+
chr1,110553892,1.7655034309235298,4571,3104,7675,+
chr1,110553894,1.5292890890299715,3068,2083,5151,+
chr1,110553924,0.6281553398058253,1293,1029,2322,+
chr1,110554995,1.9439882697947215,946,681,1627,+
chr1,110555046,1.9630720000000002,828,624,1452,+
chr1,110555522,1.6187865497076024,823,575,1398,+
chr1,110555569,1.8186646433990896,845,658,1503,+
chr1,110555588,0.6779366842543738,650,553,1203,+
chr1,110557437,1.5138879979472704,1415,916,2331,+
chr1,110557473,1.239788219321308,2736,1862,4598,+
chr1,110557476,1.8410082705269477,4897,3525,8422,+
chr1,110558053,0.6314445589601938,3513,2321,5834,+
chr1,110558060,1.455026455026455,5719,4276,9995,+
chr1,110558061,1.3617902945621454,8809,6676,15485,+
chr1,110558063,1.0748407181368578,20266,15151,35417,+
chr1,110558064,1.0923087075846742,14869,11339,26208,+
chr1,110558065,1.0923087075846742,14869,11339,26208,+
chr1,110559323,1.7746260387811634,615,474,1089,+
chr1,110559342,8.803058103975534,777,653,1430,+
chr1,110560141,2.1095864661654136,773,559,1332,+
chr1,110560151,1.6399715504978662,853,759,1612,+
chr1,110560154,1.6604153555695407,775,680,1455,+
chr1,110560165,1.4374375802539592,929,977,1906,+
chr1,110560170,1.964807242990654,974,1069,2043,+
chr1,110560173,1.65612664644534,1021,1173,2194,+
chr1,110560584,1.8797901503518666,3654,4532,8186,+
chr1,110560585,1.873387031872674,5381,6096,11477,+
chr1,110560587,2.035152983391533,2418,2778,5196,+
chr1,110560588,0.3903880266075388,1530,2254,3784,+
chr1,110560590,1.3355590873697347,1317,1588,2905,+
chr1,110560593,0.773850419590715,4204,5821,10025,+
chr1,110560594,0.773850419590715,4204,5821,10025,+
chr1,110560596,1.2561070536895904,6145,7952,14097,+
chr1,110560597,1.3838254677659694,9652,12736,22388,+
chr1,110560599,1.395044883204556,15198,20614,35812,+
chr1,110560600,1.490024570767296,7131,9836,16967,+
chr1,110561078,1.454485488126649,1469,1136,2605,+
chr1,110561208,2.084442518417631,909,556,1465,+
chr1,110561732,1.5450567644276252,669,603,1272,+
chr1,110562190,0.5973296848842701,1806,1307,3113,+
chr1,110562191,1.4237406716417909,998,803,1801,+
chr1,110562242,2.024078118977258,1078,904,1982,+
chr1,110564438,3.1015943877551018,1130,783,1913,+
chr1,110564606,1.358850864328518,1952,1283,3235,+
chr1,110564754,1.6525357566672911,1734,1185,2919,+
chr1,110564771,1.5961409152636228,3724,2077,5801,+
chr1,110564773,1.5198390350336526,7890,4752,12642,+
chr1,110564774,1.5276286353467559,3901,2234,6135,+
chr1,110564783,1.0753586502278938,7099,4698,11797,+
chr1,110564820,1.063625516259324,7792,5417,13209,+
chr1,110565007,0.4156548984501762,873,585,1458,+
chr1,110565021,0.5949861354762039,750,430,1180,+
chr1,110565024,1.8644428994129483,1206,758,1964,+
chr1,110565039,1.704353657855027,952,616,1568,+
chr1,110565042,1.7262063449746734,1049,681,1730,+
chr1,110565050,1.965654746591201,825,675,1500,+
chr1,110565052,2.270014347202296,878,696,1574,+
chr1,110565223,0.6939087546239212,1278,810,2088,+
chr1,110565378,6.14265378181417,15139,9371,24510,+
chr1,110565379,9.247832403582137,11662,8801,20463,+
chr1,110565380,9.4539561443876,21516,17277,38793,+
chr1,110565381,11.978898747140164,15566,14261,29827,+
chr1,110565384,0.6073804585500681,3825,4523,8348,+
chr1,110565387,0.5127905086949456,1971,2636,4607,+
chr1,110565401,0.9104107661444111,12684,16370,29054,+
chr1,110565402,0.7430024357392425,21782,25534,47316,+
chr1,110565403,0.5590407416669433,16999,18762,35761,+
chr1,110565404,0.4480893875154803,14514,15626,30140,+
chr1,110565413,0.6525629294471463,9910,9272,19182,+
chr1,110565422,0.4213739647483542,7936,9417,17353,+
chr1,110565423,0.4213739647483542,7936,9417,17353,+
chr1,110565437,0.6681058439524239,11349,11641,22990,+
chr1,110565439,0.6681058439524239,11349,11641,22990,+
chr1,110566020,0.6440520446096655,1187,806,1993,+
chr1,110566099,1.5433148734177211,866,631,1497,+
chr1,110566100,3.9682539682539675,549,538,1087,+
chr1,110566139,0.626953125,1283,1023,2306,+
chr1,110566219,1.605659863945578,921,749,1670,+
chr1,110566220,1.5817643712813165,1745,1357,3102,+
chr1,110566234,2.0546845124282984,596,522,1118,+
chr1,110884158,2.0951627445407377,695,467,1162,+
chr1,111690264,8.068426901589632,684,751,1435,+
chr1,111725486,1.5836512361203867,915,638,1553,+
chr1,111992090,1.0707975595616044,1014,813,1827,+
chr1,111992105,0.7865554601124997,1025,716,1741,+
chr1,111992136,1.7161172161172162,936,727,1663,+
chr1,111996844,2.053420115436571,726,478,1204,+
chr1,111996883,2.0372230428360414,861,676,1537,+
chr1,111996909,1.644675925925926,1014,809,1823,+
chr1,111996955,1.3139288717416036,2578,1757,4335,+
chr1,112002127,0.371203222017117,1105,807,1912,+
chr1,112002139,1.5348642188173516,2922,1689,4611,+
chr1,112002140,1.5348642188173516,2922,1689,4611,+
chr1,112002141,1.8612673415823024,1532,1142,2674,+
chr1,112002144,0.7517482517482518,1719,1253,2972,+
chr1,112002145,1.0814143998563606,3322,2527,5849,+
chr1,112002146,1.1884834032299065,4277,3227,7504,+
chr1,112003586,1.4402197364490323,1770,1281,3051,+
chr1,112003624,1.4640060426686397,3902,2447,6349,+
chr1,112003773,1.308002461848616,2346,1858,4204,+
chr1,112003775,1.6859944903581263,1318,824,2142,+
chr1,113162453,0.999380754352318,3498,2166,5664,+
chr1,113162454,0.999380754352318,3498,2166,5664,+
chr1,113192070,2.108621685818836,1492,841,2333,+
chr1,113196230,1.7969281648487931,1661,1065,2726,+
chr1,113196235,1.859903381642512,1814,1241,3055,+
chr1,113197198,2.285004893107964,2286,1506,3792,+
chr1,113197261,3.1738684446723937,1337,708,2045,+
chr1,113212652,1.8661528782636048,790,577,1367,+
chr1,113212681,1.8756699947451392,1321,864,2185,+
chr1,113213023,2.0013976240391336,715,476,1191,+
chr1,113213220,1.5533980582524274,959,720,1679,+
chr1,113213367,1.83893070835746,1029,627,1656,+
chr1,113213371,1.4680212422073424,1155,709,1864,+
chr1,113213417,1.4501125281320328,1932,1332,3264,+
chr1,113213419,1.5746457445987088,2089,1722,3811,+
chr1,113213451,0.7644532853399009,2045,1376,3421,+
chr1,113213872,2.074940852995716,1297,801,2098,+
chr1,113213878,1.918858307849133,723,544,1267,+
chr1,113213982,0.6020408163265306,1061,783,1844,+
chr1,113213985,0.4635031879364435,1592,963,2555,+
chr1,113214033,2.2351502048247616,872,675,1547,+
chr1,114497385,0.4828365105025099,905,544,1449,+
chr1,114498191,2.094414893617021,674,375,1049,+
chr1,114499250,1.4930644106441942,654,380,1034,+
chr1,116916063,2.2036417856497375,560,446,1006,+
chr1,116926670,1.5878344013833792,891,677,1568,+
chr1,116926683,2.208791208791209,803,675,1478,+
chr1,116930029,1.3700220116597712,2542,1783,4325,+
chr1,116930102,2.4973319103521883,1079,936,2015,+
chr1,116930109,1.5721362171983204,3023,2259,5282,+
chr1,116931332,1.524438312968072,909,707,1616,+
chr1,116931379,1.510102413097024,2233,1755,3988,+
chr1,116931381,1.4259127545494805,4059,2900,6959,+
chr1,116931552,1.434874215161603,2002,1248,3250,+
chr1,116932109,1.6950240770465492,767,622,1389,+
chr1,116932845,1.5904761904761906,834,599,1433,+
chr1,116932936,0.3426956368132838,969,776,1745,+
chr1,116933003,1.5097831704855895,1135,990,2125,+
chr1,116933503,3.627478228645544,954,770,1724,+
chr1,116935559,1.8429070996774102,1332,996,2328,+
chr1,116936217,1.6006974716652136,611,517,1128,+
chr1,116936300,2.0587385732912695,1137,942,2079,+
chr1,116936331,1.6273652647290795,1779,1303,3082,+
chr1,116939346,1.841220556745182,592,466,1058,+
chr1,116940527,1.6147368421052632,766,645,1411,+
chr1,116940545,0.7177072339043599,1039,677,1716,+
chr1,116940576,1.8196022727272727,914,639,1553,+
chr1,116940583,2.3654208273894435,986,700,1686,+
chr1,116940594,1.8593375299760195,1153,833,1986,+
chr1,116941293,1.5900532132623826,1827,1395,3222,+
chr1,116941294,1.681631123644015,3475,2419,5894,+
chr1,116941565,2.9845020325203246,1381,1311,2692,+
chr1,116942103,1.4827019713954388,1144,994,2138,+
chr1,116943763,1.361873489885245,1599,1204,2803,+
chr1,116943776,1.3779443177589044,1606,1288,2894,+
chr1,116943855,1.2211811092560179,2199,1468,3667,+
chr1,116944186,1.273630262762512,1556,981,2537,+
chr1,116946566,1.7089014521671657,751,581,1332,+
chr1,116947058,1.9197651663405089,653,510,1163,+
chr1,116947228,1.4524046429583382,1124,337,1461,+
chr1,116947239,3.994750656167979,760,253,1013,+
chr1,116947240,3.994750656167979,760,253,1013,+
chr1,116947243,5.640161220982758,1865,646,2511,+
chr1,116947245,19.40278699402787,1719,1506,3225,+
chr1,116947246,22.737526099298844,4164,4064,8228,+
chr1,116947247,22.737526099298844,4164,4064,8228,+
chr1,116947260,0.35158543746330007,478,523,1001,+
chr1,116947268,0.46884310912763344,2300,3252,5552,+
chr1,116947270,0.57014010211685,3987,5416,9403,+
chr1,116947271,0.5420034717133538,2380,2758,5138,+
chr1,116947272,0.6076606931351404,2348,2949,5297,+
chr1,116947273,0.5417687441109167,1547,1563,3110,+
chr1,116947306,0.3571871480455058,1282,1112,2394,+
chr1,117527336,2.4198564593301435,866,626,1492,+
chr1,117532719,2.090175585798985,1270,765,2035,+
chr1,117532720,1.899827734711456,958,539,1497,+
chr1,118477264,2.3599264885689752,702,476,1178,+
chr1,118479422,7.576221735959154,610,456,1066,+
chr1,118479424,7.576221735959154,610,456,1066,+
chr1,118482115,0.4423669504360997,604,466,1070,+
chr1,118482117,0.4423669504360997,604,466,1070,+
chr1,118496680,4.312193202170521,630,439,1069,+
chr1,118502124,2.525408368815667,1362,1296,2658,+
chr1,118502127,2.8872740163062747,542,650,1192,+
chr1,120254547,1.020404079155269,3749,3284,7033,+
chr1,120254548,1.020404079155269,3749,3284,7033,+
chr1,120254557,0.8596819625238136,7824,5686,13510,+
chr1,120254558,0.908444505454126,10025,7540,17565,+
chr1,120254656,1.3749300641764026,3152,2059,5211,+
chr1,120254712,1.39572192513369,1964,1440,3404,+
chr1,120254715,1.493492468917853,2304,1347,3651,+
chr1,120263897,0.5580908793723439,1066,804,1870,+
chr1,120263917,1.9439446366782007,1165,934,2099,+
chr1,120263934,1.1107779423478363,2939,2399,5338,+
chr1,120266028,1.463472113118618,1655,1367,3022,+
chr1,120266045,1.334924965893588,1956,1465,3421,+
chr1,120269475,1.5110676435023829,1948,1653,3601,+
chr1,120269510,1.5788954635108479,1600,1364,2964,+
chr1,120279764,1.712041884816754,980,572,1552,+
chr1,120279767,1.7910986729258824,991,582,1573,+
chr1,120279808,1.6520740014970294,2486,1933,4419,+
chr1,120279833,1.712774519949408,1063,891,1954,+
chr1,120279870,1.4938366826066838,1613,1168,2781,+
chr1,120283126,1.792436419302091,1119,736,1855,+
chr1,120283129,1.9959396751740135,1828,1723,3551,+
chr1,120283131,1.9959396751740135,1828,1723,3551,+
chr1,120283133,1.972805063884656,1319,897,2216,+
chr1,120284446,1.3966363385718223,1582,1208,2790,+
chr1,120284449,1.4495495495495494,1608,1294,2902,+
chr1,120285511,1.895204262877442,1066,562,1628,+
chr1,120285540,1.5858709677419356,1045,774,1819,+
chr1,120285562,2.124844598573578,1248,898,2146,+
chr1,120285565,1.6705336426914157,1439,861,2300,+
chr1,120285617,1.0533113978436144,2439,2211,4650,+
chr1,120285618,1.4637711379321625,4052,3095,7147,+
chr1,120285619,1.3088054762057495,8271,6957,15228,+
chr1,120285660,1.40858658948384,1751,1381,3132,+
chr1,120286624,2.4272189349112425,1171,844,2015,+
chr1,120286655,1.559233449477352,1789,1147,2936,+
chr1,120286660,1.63250707270855,3014,2542,5556,+
chr1,145103943,2.7780976508521413,964,667,1631,+
chr1,145103944,2.7780976508521413,964,667,1631,+
chr1,145103958,0.6124686716791979,679,531,1210,+
chr1,145112384,3.35064935064935,809,692,1501,+
chr1,145115794,1.9045587485858564,1517,1091,2608,+
chr1,145115916,1.8694214876033055,782,494,1276,+
chr1,145115923,1.1539119492170862,1482,1084,2566,+
chr1,145116365,0.7241233192418062,1025,838,1863,+
chr1,145116366,0.8510918179426468,646,542,1188,+
chr1,145116381,0.5223214285714285,584,447,1031,+
chr1,145116431,1.808072059587736,613,501,1114,+
chr1,145438489,0.6757517436504804,7750,5609,13359,+
chr1,145438490,0.7647663329488565,32835,30245,63080,+
chr1,145438491,0.7492095373545001,40585,35854,76439,+
chr1,145438753,1.3515759312320916,2119,1395,3514,+
chr1,145438775,1.7343776604801635,925,838,1763,+
chr1,145438911,1.8456655229332508,1324,981,2305,+
chr1,145439627,1.4789545244156446,1622,1191,2813,+
chr1,145439639,2.187631514224032,1905,1590,3495,+
chr1,145439640,2.187631514224032,1905,1590,3495,+
chr1,145439872,1.0868255693092697,1672,1113,2785,+
chr1,145439873,1.2975985130974594,2457,1779,4236,+
chr1,145440351,1.8604339557399725,1000,722,1722,+
chr1,145440388,1.6517116066221005,994,718,1712,+
chr1,145440418,2.0792232044399492,1938,1291,3229,+
chr1,145440424,2.1494848901098904,1180,909,2089,+
chr1,145440510,1.8249472202674173,942,587,1529,+
chr1,145440635,1.4173629242819843,1033,765,1798,+
chr1,145440759,1.8065445564931053,1462,1242,2704,+
chr1,145440762,1.6292779330955367,1185,1011,2196,+
chr1,145440765,0.7420141969831411,1337,1126,2463,+
chr1,145440774,1.7963488124778448,6080,5732,11812,+
chr1,145440775,1.7963488124778448,6080,5732,11812,+
chr1,145440776,1.7963488124778448,6080,5732,11812,+
chr1,145441044,1.6889291374235909,745,630,1375,+
chr1,145441298,1.820401916422678,828,577,1405,+
chr1,145441345,2.160212828850133,608,397,1005,+
chr1,145441461,1.5920303605313089,838,526,1364,+
chr1,145441537,1.6443013250277148,1197,996,2193,+
chr1,145441757,1.7766815119333104,1143,972,2115,+
chr1,145441896,1.5859018011990091,1899,1397,3296,+
chr1,145442059,1.6503517895380853,1078,933,2011,+
chr1,145442246,1.6355401476179827,974,788,1762,+
chr1,145442357,1.8567774936061383,967,689,1656,+
chr1,145442415,1.8013711977607314,1613,1200,2813,+
chr1,145442464,1.5912530451890694,2011,1651,3662,+
chr1,145507664,1.9776785714285714,442,639,1081,+
chr1,145507685,3.414938229627111,654,518,1172,+
chr1,145507686,1.8643533654876698,1249,1332,2581,+
chr1,145508036,0.5052070025518381,1284,971,2255,+
chr1,145508264,3.6878957290155707,718,481,1199,+
chr1,147760483,0.36489970439703323,600,428,1028,+
chr1,150266280,1.4623288066189524,1720,1000,2720,+
chr1,150266281,1.7376012257279216,1530,972,2502,+
chr1,150266282,1.5506687248607611,2222,1314,3536,+
chr1,150266300,1.0506084776410811,1456,826,2282,+
chr1,150266301,1.3126560596032024,2633,1687,4320,+
chr1,150266800,0.6399048077905771,1068,866,1934,+
chr1,150280488,1.5828532700779396,1383,907,2290,+
chr1,150280567,1.7031296986263016,2110,1513,3623,+
chr1,150280568,1.8069468432162732,855,578,1433,+
chr1,150280588,0.9744622110893674,2147,1402,3549,+
chr1,150280597,1.1483641378807312,3646,2649,6295,+
chr1,150280675,3.4217093044001112,5406,4564,9970,+
chr1,150280676,3.2614649726466505,6642,5339,11981,+
chr1,150300806,2.6164981607021924,761,440,1201,+
chr1,150325342,2.592410052941915,632,419,1051,+
chr1,150464893,2.1655867608604997,708,605,1313,+
chr1,151139484,2.920255533908882,809,610,1419,+
chr1,151140796,2.097264907085264,759,616,1375,+
chr1,151171510,2.6876460269052056,784,471,1255,+
chr1,151199822,1.3070635275577134,644,474,1118,+
chr1,151205048,1.4907875223392524,784,492,1276,+
chr1,151206682,1.4983388455856188,1755,1563,3318,+
chr1,151206697,1.5654084397986836,1138,1147,2285,+
chr1,151206706,0.6242066039081443,1428,1367,2795,+
chr1,151206712,2.350887102986109,1307,1342,2649,+
chr1,151206798,1.4408100836639388,612,415,1027,+
chr1,151206930,2.325121654501217,694,410,1104,+
chr1,151209039,2.634335154826958,1334,731,2065,+
chr1,151209040,2.5015183509301155,2055,1169,3224,+
chr1,151209042,2.1517718068535827,2138,1283,3421,+
chr1,151209043,2.1311736958934517,1462,900,2362,+
chr1,151209045,0.4401179941002949,745,338,1083,+
chr1,151209046,1.9276102800153434,1663,1184,2847,+
chr1,151209048,1.9887991107690992,3488,2598,6086,+
chr1,151209049,1.9214521018703965,2700,2060,4760,+
chr1,151209050,1.7735821751658398,4047,2850,6897,+
chr1,151209054,1.3036493311799573,2578,1745,4323,+
chr1,151220756,0.5553531000101745,1220,754,1974,+
chr1,151220784,0.6339452978643687,845,470,1315,+
chr1,151220830,2.9485849755519338,795,396,1191,+
chr1,151221036,4.129232321562152,940,647,1587,+
chr1,151221560,4.441048711070109,528,487,1015,+
chr1,151221627,2.2486486486486488,779,554,1333,+
chr1,151221628,1.7025113933810898,1119,800,1919,+
chr1,151221855,8.704326828949945,1475,117,1592,+
chr1,151221856,19.544407662054724,1886,154,2040,+
chr1,151221857,47.77995215384337,2339,290,2629,+
chr1,151221858,42.90679819902499,4540,475,5015,+
chr1,151221859,36.64812752358902,4855,627,5482,+
chr1,151221861,43.87105483868708,3949,1005,4954,+
chr1,151221862,39.5873511671834,4240,1038,5278,+
chr1,151221863,32.63198876253074,5198,1329,6527,+
chr1,151221865,11.494878567297018,2895,870,3765,+
chr1,151221867,11.646157068534903,4247,1675,5922,+
chr1,151221868,11.623296387621973,3289,1384,4673,+
chr1,151221871,6.432338106751028,1686,1029,2715,+
chr1,151221874,5.015543426672995,1030,1203,2233,+
chr1,151221875,12.855518567449895,3818,3355,7173,+
chr1,151221876,12.855518567449895,3818,3355,7173,+
chr1,151221886,15.832185558837098,5331,8064,13395,+
chr1,151221887,15.832185558837098,5331,8064,13395,+
chr1,151221888,15.832185558837098,5331,8064,13395,+
chr1,151234646,2.1188699360341148,635,468,1103,+
chr1,151234746,0.534965034965035,917,571,1488,+
chr1,151236468,1.577581387465671,1267,787,2054,+
chr1,151237315,1.1659039848689003,1427,932,2359,+
chr1,151237332,0.5027805864509606,1546,1287,2833,+
chr1,151237333,0.5027805864509606,1546,1287,2833,+
chr1,151237961,2.5595984943538266,1495,796,2291,+
chr1,151237962,2.374135168243086,2034,1195,3229,+
chr1,151238053,1.8693232913669064,1262,1111,2373,+
chr1,151238054,1.8693232913669064,1262,1111,2373,+
chr1,151238803,0.5809426229508197,566,487,1053,+
chr1,151238822,1.6585365853658538,951,573,1524,+
chr1,151238825,1.5339178587909552,830,590,1420,+
chr1,151238853,2.125651465798046,790,613,1403,+
chr1,151239021,0.6216216216216217,919,739,1658,+
chr1,151239655,2.1,657,469,1126,+
chr1,151239656,1.5277224736048263,1150,649,1799,+
chr1,151239726,0.4861388223416134,2079,1625,3704,+
chr1,151239727,0.536620982703932,1400,1084,2484,+
chr1,151239729,1.734830490174908,617,420,1037,+
chr1,151239743,1.6872169975618252,691,521,1212,+
chr1,151239811,1.72856221792392,765,516,1281,+
chr1,151239865,2.39506202584782,3139,2559,5698,+
chr1,151372040,1.7289881126158022,2412,1199,3611,+
chr1,151372041,1.9076843519641093,3785,1889,5674,+
chr1,151372042,1.8282763283672565,2992,1478,4470,+
chr1,151372043,1.7515890794816789,2304,1158,3462,+
chr1,151372057,2.032988108937476,1059,631,1690,+
chr1,151372121,1.460170759616231,2816,1622,4438,+
chr1,151372123,1.574583960631682,6264,4038,10302,+
chr1,151372124,1.6062968111220137,4891,3253,8144,+
chr1,151372489,2.122200895713372,748,520,1268,+
chr1,151372493,1.444382148463781,1170,727,1897,+
chr1,151372494,1.549121405750799,861,625,1486,+
chr1,151372512,1.5011623055373426,1094,882,1976,+
chr1,151372524,1.362854013456423,1473,912,2385,+
chr1,151372563,1.6112617875323376,1308,1041,2349,+
chr1,151372573,0.6446700507614214,1269,984,2253,+
chr1,151372589,1.4205642015357451,1257,993,2250,+
chr1,151372953,2.5553520553520555,1298,1091,2389,+
chr1,151373012,1.886146617188742,2694,1782,4476,+
chr1,151373274,1.6152510683760684,1229,935,2164,+
chr1,151373809,1.528447227352583,1884,1123,3007,+
chr1,151374021,1.2562347621370364,5747,4470,10217,+
chr1,153610789,1.7489375612945406,534,482,1016,+
chr1,153610855,0.5132763532763532,562,449,1011,+
chr1,153614748,2.029308659353043,659,562,1221,+
chr1,153614817,0.2977341676147137,570,585,1155,+
chr1,153614819,0.3356566397652237,609,579,1188,+
chr1,153617547,4.007247944521759,893,339,1232,+
chr1,153617548,4.50443614777694,1160,422,1582,+
chr1,153617568,6.744781827985759,2410,1957,4367,+
chr1,153617569,6.744781827985759,2410,1957,4367,+
chr1,153617570,6.688062762039082,2601,2159,4760,+
chr1,153617723,0.6036585365853658,626,409,1035,+
chr1,153617986,10.489082310254332,843,652,1495,+
chr1,153633789,0.6307759182786351,690,534,1224,+
chr1,153633809,2.8344,1180,949,2129,+
chr1,153633810,2.2492634711987125,2196,1696,3892,+
chr1,153701210,4.600114744693059,632,580,1212,+
chr1,153701212,3.6450043363950626,705,639,1344,+
chr1,153701215,2.3699795382711057,1021,1080,2101,+
chr1,153701217,1.695724880034899,561,528,1089,+
chr1,153701220,0.4502343534601599,709,584,1293,+
chr1,153701221,0.39614736239782633,851,705,1556,+
chr1,153737184,1.9131234265319423,665,488,1153,+
chr1,153740183,3.8359680775451324,669,400,1069,+
chr1,153744428,2.2449059751980402,1157,592,1749,+
chr1,153746279,2.3071479614974093,604,439,1043,+
chr1,153941610,0.4874247228869763,817,595,1412,+
chr1,153963238,1.3391511620418937,4680,4327,9007,+
chr1,153963250,0.6848455261873213,4909,4411,9320,+
chr1,153963251,0.7119765821253409,7677,7204,14881,+
chr1,153963254,0.7068055736685293,2762,2401,5163,+
chr1,153963255,1.3004357379613425,3080,2440,5520,+
chr1,153963258,0.8371276101858985,3406,2871,6277,+
chr1,153963266,1.223862042373839,4865,3856,8721,+
chr1,153963454,2.1743145663932215,634,474,1108,+
chr1,153963604,0.5660019775873435,6868,5475,12343,+
chr1,153963632,1.0395744468232158,18011,11958,29969,+
chr1,153963641,1.263885435831137,9584,5966,15550,+
chr1,153963645,1.1584547314618867,10554,5960,16514,+
chr1,153964039,1.0128504721606755,839,775,1614,+
chr1,153964050,1.5829289822990684,48519,32756,81275,+
chr1,153964062,1.5467398875896599,55630,39935,95565,+
chr1,154197559,0.7107934754906126,682,595,1277,+
chr1,154197565,1.5624983270805701,1239,1054,2293,+
chr1,154197569,1.7521853146853148,632,527,1159,+
chr1,154199767,2.869672557172557,630,480,1110,+
chr1,154199768,2.869672557172557,630,480,1110,+
chr1,154199804,1.9895652173913043,571,459,1030,+
chr1,154207152,2.346232179226069,575,490,1065,+
chr1,154223694,4.719490083951734,689,438,1127,+
chr1,154223768,2.3067604326119895,792,577,1369,+
chr1,154224102,2.115732368896926,539,473,1012,+
chr1,154224103,2.115732368896926,539,473,1012,+
chr1,154228201,1.3374629382341623,778,578,1356,+
chr1,154233528,2.5668951199473424,916,511,1427,+
chr1,154233530,3.3666666666666667,706,349,1055,+
chr1,154233555,2.520383275261324,628,409,1037,+
chr1,154233556,2.520383275261324,628,409,1037,+
chr1,154235668,1.4807814312363234,584,489,1073,+
chr1,154245116,0.6336159377086442,2172,917,3089,+
chr1,154245124,1.988907413452377,2650,1290,3940,+
chr1,154245138,2.462678435218481,903,436,1339,+
chr1,154245153,1.8598382749326143,719,423,1142,+
chr1,154245189,2.0962115447455436,1320,885,2205,+
chr1,154245190,1.4944177180720706,783,478,1261,+
chr1,154245198,1.788617886178862,799,491,1290,+
chr1,154245226,1.9744031934227357,1716,1113,2829,+
chr1,154245933,1.5958466453674125,998,625,1623,+
chr1,154245934,1.6019753086419755,810,599,1409,+
chr1,154245978,1.0587050102418152,1667,1204,2871,+
chr1,154245986,1.5023590429981597,1068,694,1762,+
chr1,154246324,1.543752936231239,1177,792,1969,+
chr1,154246379,1.6951510333863276,852,628,1480,+
chr1,154247633,2.125515818431912,882,726,1608,+
chr1,154247932,0.5836800000000001,911,624,1535,+
chr1,154247941,0.5867033430200315,1101,738,1839,+
chr1,154248201,1.55666171051781,687,498,1185,+
chr1,154947167,0.9805400942388998,1439,1058,2497,+
chr1,154947168,1.0398081613278116,1616,1392,3008,+
chr1,154947169,0.9525707462495654,4131,3093,7224,+
chr1,154947196,2.0514735199876677,3569,2921,6490,+
chr1,154947205,1.5436467319783596,1448,976,2424,+
chr1,154950526,1.4849692140528792,999,501,1500,+
chr1,154950575,2.457294429708223,1157,753,1910,+
chr1,154951561,1.762222222222222,792,431,1223,+
chr1,154951568,1.6273653566229984,773,686,1459,+
chr1,154951574,1.5381200375650987,1125,662,1787,+
chr1,154951578,1.6217345872518287,872,593,1465,+
chr1,154951579,2.141681079211345,1345,825,2170,+
chr1,154951594,2.56937401643644,1108,816,1924,+
chr1,154956480,0.8628841607565012,729,469,1198,+
chr1,154956482,0.8628841607565012,729,469,1198,+
chr1,154961017,2.2852380916284347,974,791,1765,+
chr1,155025168,0.4428967140406434,597,477,1074,+
chr1,155026820,1.8,629,384,1013,+
chr1,155026927,2.422170522343218,1116,739,1855,+
chr1,155026928,2.810091971165797,594,446,1040,+
chr1,155028437,2.964984939759036,874,746,1620,+
chr1,155028438,2.0085406958758107,1863,1480,3343,+
chr1,155028439,2.964984939759036,874,746,1620,+
chr1,155028693,2.0246411681738983,1060,708,1768,+
chr1,155028694,2.0246411681738983,1060,708,1768,+
chr1,155028914,0.8989098594539484,1503,1091,2594,+
chr1,155029437,2.897117962466488,664,372,1036,+
chr1,155029473,2.7492399053258243,710,547,1257,+
chr1,155029756,0.2703862660944206,593,465,1058,+
chr1,155029758,0.2703862660944206,593,465,1058,+
chr1,155029789,1.4575970529244924,2248,1565,3813,+
chr1,155029790,1.1700928084648494,1656,1087,2743,+
chr1,155030381,2.969781728456848,885,627,1512,+
chr1,155030558,0.3132642005881442,758,496,1254,+
chr1,155030559,1.4085222149680392,841,640,1481,+
chr1,155030751,1.931290622098421,727,358,1085,+
chr1,155030758,1.3158283211465576,1067,663,1730,+
chr1,155034798,3.9096570543170643,678,354,1032,+
chr1,155034818,4.1414585795559775,685,383,1068,+
chr1,155035166,5.329044117647059,1114,169,1283,+
chr1,155035168,6.054542714394016,934,142,1076,+
chr1,155035174,20.843540183121565,2355,1216,3571,+
chr1,155035175,18.566614648721956,3578,2391,5969,+
chr1,155035176,18.566614648721956,3578,2391,5969,+
chr1,155035177,16.37753892909695,2807,2235,5042,+
chr1,155035185,3.507764025225361,1056,1136,2192,+
chr1,155035186,3.046698842615017,1248,1250,2498,+
chr1,155035193,2.5675550766171726,485,654,1139,+
chr1,155035197,3.6715424616149117,1178,1635,2813,+
chr1,155100506,2.739304812834225,682,339,1021,+
chr1,155100530,2.276143790849673,1392,815,2207,+
chr1,155100531,2.276143790849673,1392,815,2207,+
chr1,155100536,0.477461303314086,655,556,1211,+
chr1,155103920,0.3376494023904383,564,501,1065,+
chr1,155103927,3.573598130841121,664,427,1091,+
chr1,155103999,1.1328369161216831,1047,680,1727,+
chr1,155104013,2.0661824051654563,1279,884,2163,+
chr1,155104014,2.0095053129659135,1965,1364,3329,+
chr1,155104040,1.708780043444748,1917,1490,3407,+
chr1,155104041,1.6012671881825515,3161,2479,5640,+
chr1,155104083,1.5192866316910365,1595,1228,2823,+
chr1,155106769,2.8045343137254903,596,407,1003,+
chr1,155106770,1.1122120087192326,1442,1053,2495,+
chr1,155106774,2.2886847271391453,1318,934,2252,+
chr1,155106819,2.4848790322580645,679,495,1174,+
chr1,155106903,2.1323076923076925,692,424,1116,+
chr1,155106937,0.6311576354679802,1024,783,1807,+
chr1,155106961,2.1377536836252435,1182,871,2053,+
chr1,155106962,2.1377536836252435,1182,871,2053,+
chr1,155107028,2.5041942604856517,708,452,1160,+
chr1,155107196,0.6150743801652893,885,604,1489,+
chr1,155107237,1.7564209274673008,952,579,1531,+
chr1,155108368,3.0498448932137188,750,495,1245,+
chr1,155108384,0.3396699398402176,671,584,1255,+
chr1,155108788,1.1650216992399745,863,646,1509,+
chr1,155108796,1.079837484948377,981,736,1717,+
chr1,155109410,1.9067876133875508,761,555,1316,+
chr1,155110050,0.383971892253639,764,555,1319,+
chr1,155110471,0.5612096811947006,665,520,1185,+
chr1,155110557,2.9142541028950766,877,637,1514,+
chr1,155110558,0.4091911764705882,635,543,1178,+
chr1,155110886,2.194029850746269,685,468,1153,+
chr1,155111075,2.786666666666666,816,644,1460,+
chr1,155111077,2.786666666666666,816,644,1460,+
chr1,155111233,2.0332877336981303,636,386,1022,+
chr1,155111235,2.111131794489948,1030,631,1661,+
chr1,155111236,2.2089822576641924,1725,1065,2790,+
chr1,155179106,3.0782351916783415,578,504,1082,+
chr1,155180380,1.5744654806593763,820,556,1376,+
chr1,155278649,1.230765161522574,1404,915,2319,+
chr1,155278651,1.0234009360374416,983,640,1623,+
chr1,155278657,0.8634415743933619,1299,838,2137,+
chr1,155278658,1.538670257583107,1169,832,2001,+
chr1,155278659,0.756123750893194,2801,1854,4655,+
chr1,155278660,0.6650442477876106,1502,1016,2518,+
chr1,155278663,2.2722812097812097,688,517,1205,+
chr1,155278672,1.508545135845749,917,651,1568,+
chr1,155278704,0.6837701612903225,968,743,1711,+
chr1,155278706,1.8628158844765341,1203,830,2033,+
chr1,155278717,1.4905245074354432,2523,1773,4296,+
chr1,155278718,1.639962499609407,4867,3361,8228,+
chr1,155278726,1.291784702549575,1367,1058,2425,+
chr1,155278734,1.054727670933634,8139,6167,14306,+
chr1,155278735,1.5344864064318209,1731,1095,2826,+
chr1,155278736,1.0904901372207125,10329,7728,18057,+
chr1,155279852,1.3899705637762847,1619,1066,2685,+
chr1,155279853,0.5970214956687832,1632,1326,2958,+
chr1,155279855,1.6946381865736706,3109,2071,5180,+
chr1,155279868,0.7232082620950974,3226,2277,5503,+
chr1,155279869,0.6583237992051972,3786,2485,6271,+
chr1,155279875,1.579034106228094,4661,3708,8369,+
chr1,155279880,0.624406926864574,10516,7688,18204,+
chr1,155282143,1.5163888425158,3644,3000,6644,+
chr1,155287798,0.6827144686299615,2364,1774,4138,+
chr1,155288014,1.4393703599765288,2452,2062,4514,+
chr1,155288048,1.4164658223449076,10941,9285,20226,+
chr1,155288049,1.6143171569113637,8792,7447,16239,+
chr1,155288050,1.6143171569113637,8792,7447,16239,+
chr1,155288053,1.586353547964035,3204,2936,6140,+
chr1,155288056,1.3167950397542227,13499,11163,24662,+
chr1,155288057,0.9604316878654996,6378,5251,11629,+
chr1,155288059,1.568219612767474,3810,3801,7611,+
chr1,155288062,1.520710651343125,11782,9921,21703,+
chr1,155288527,1.3618965065247517,4992,3835,8827,+
chr1,155288710,1.5688643142168412,2678,2180,4858,+
chr1,155288711,1.344120469476637,3371,2621,5992,+
chr1,155289697,1.5501745085813263,5140,3623,8763,+
chr1,155289702,1.5200941720705468,1936,1561,3497,+
chr1,155289708,1.3570574162679423,2268,1405,3673,+
chr1,155290201,0.4663721158566519,1774,1490,3264,+
chr1,155658942,0.9486652977412732,545,486,1031,+
chr1,155658943,1.1526639344262295,674,548,1222,+
chr1,155658944,1.0593116954461184,1219,1034,2253,+
chr1,155679570,3.692660550458716,804,435,1239,+
chr1,155686859,2.015714285714286,580,489,1069,+
chr1,155691371,0.6285860655737705,817,487,1304,+
chr1,155695237,1.5910739832413654,1020,931,1951,+
chr1,155695798,2.7454483580057856,921,652,1573,+
chr1,155697405,1.7941747089841806,1360,873,2233,+
chr1,155697445,1.489963167587477,1470,1085,2555,+
chr1,155699030,1.6206831119544594,948,679,1627,+
chr1,155699063,2.0944558521560577,679,486,1165,+
chr1,155699124,2.722025216706068,673,563,1236,+
chr1,155706786,1.0696530774018815,2138,1574,3712,+
chr1,155706848,1.659941520467836,810,683,1493,+
chr1,155707984,1.7329490874159463,1065,693,1758,+
chr1,155708071,1.9408163265306122,633,587,1220,+
chr1,155708184,1.4753623188405798,1017,689,1706,+
chr1,155720884,3.087378640776699,794,411,1205,+
chr1,155720885,3.6564625850340136,824,461,1285,+
chr1,155720887,3.163227608578122,1150,715,1865,+
chr1,155720888,2.5386781894291834,1052,709,1761,+
chr1,155720889,3.0395017793594308,875,561,1436,+
chr1,156024629,1.8412002258151963,609,392,1001,+
chr1,156084501,0.8171882565071402,825,328,1153,+
chr1,156084522,2.0915290343451662,1533,796,2329,+
chr1,156084524,2.0915290343451662,1533,796,2329,+
chr1,156084568,1.4485777768370762,811,680,1491,+
chr1,156084757,2.205820476858345,698,371,1069,+
chr1,156084800,2.2713122605363987,812,695,1507,+
chr1,156084802,2.2713122605363987,812,695,1507,+
chr1,156084841,1.5936904005085823,572,483,1055,+
chr1,156084865,0.5971345727443289,777,571,1348,+
chr1,156084940,0.5620578778135048,1103,621,1724,+
chr1,156084950,1.6121708240018533,613,562,1175,+
chr1,156084985,1.6743460938853283,715,501,1216,+
chr1,156084990,1.9011781255494988,635,516,1151,+
chr1,156085031,1.8639402718965896,777,640,1417,+
chr1,156100507,1.7946452272752185,1859,1248,3107,+
chr1,156100545,0.5708705357142857,774,639,1413,+
chr1,156104217,1.506967763466262,2096,1461,3557,+
chr1,156104224,1.86109080274894,1590,976,2566,+
chr1,156104260,1.7481113264245791,1054,912,1966,+
chr1,156104662,2.0079240487403758,789,636,1425,+
chr1,156104733,1.35101245446073,1427,956,2383,+
chr1,156105095,1.7881394296061566,1105,657,1762,+
chr1,156105785,1.815418717361085,1238,618,1856,+
chr1,156105845,1.7670280789546846,907,653,1560,+
chr1,156105869,1.5526588535438093,949,677,1626,+
chr1,156106025,0.368389780154486,619,494,1113,+
chr1,156106030,1.842531272994849,625,452,1077,+
chr1,156106094,1.8606403013182675,623,530,1153,+
chr1,156106097,1.5074602122015917,1298,753,2051,+
chr1,156106195,1.625764993880049,1264,759,2023,+
chr1,156106221,0.6085351382235309,988,745,1733,+
chr1,156106755,1.6301216064496058,1853,1252,3105,+
chr1,156106962,1.8089319265789856,1042,628,1670,+
chr1,156107002,2.145244565217391,2492,1471,3963,+
chr1,156107003,2.145244565217391,2492,1471,3963,+
chr1,156107445,1.8498926332074688,1682,1140,2822,+
chr1,156107600,1.7759330253566767,1055,731,1786,+
chr1,156108493,6.501386481791608,1034,808,1842,+
chr1,156108494,7.065202864877552,1960,1479,3439,+
chr1,156108495,7.065202864877552,1960,1479,3439,+
chr1,156108987,4.889467027446914,1122,920,2042,+
chr1,156109102,2.1068198702380303,1236,863,2099,+
chr1,156109103,1.893231776104251,1416,1011,2427,+
chr1,156109118,1.6324468085106385,557,469,1026,+
chr1,156109121,1.288660253815966,979,790,1769,+
chr1,156109127,1.7703296703296703,715,636,1351,+
chr1,156109538,0.4323834520684914,628,380,1008,+
chr1,156109586,12.930164569938066,2166,1250,3416,+
chr1,156109589,3.594963755837769,2182,1407,3589,+
chr1,156109596,5.720560637905183,2975,2278,5253,+
chr1,156109597,5.067862833205407,3695,2739,6434,+
chr1,156109698,3.8194895056391953,1348,520,1868,+
chr1,156109704,10.849160615594217,1734,821,2555,+
chr1,156109719,5.466284987277354,660,523,1183,+
chr1,156109720,4.153373645941791,1808,1197,3005,+
chr1,156109721,3.307562073112929,2390,1540,3930,+
chr1,156109723,1.7638551288283908,630,373,1003,+
chr1,156109771,12.887072236610502,3183,1914,5097,+
chr1,156109772,11.997813103682976,3492,2091,5583,+
chr1,156109773,11.997813103682976,3492,2091,5583,+
chr1,156109774,7.2980373535929095,940,485,1425,+
chr1,156109777,7.440094197599897,1048,761,1809,+
chr1,156109778,7.6705737027749805,1586,1301,2887,+
chr1,156109784,3.8003886015552073,557,498,1055,+
chr1,156182803,3.0161445594661753,757,404,1161,+
chr1,156202145,2.110764199197581,810,556,1366,+
chr1,156206233,8.828305864186264,600,518,1118,+
chr1,156561697,0.47599142673757566,852,492,1344,+
chr1,156561738,2.6695972704135813,1103,758,1861,+
chr1,156561774,2.4491642422442483,684,549,1233,+
chr1,156562216,1.0054285714285711,781,699,1480,+
chr1,156562217,1.0054285714285711,781,699,1480,+
chr1,156562367,1.4741146045560933,2120,1564,3684,+
chr1,156562387,1.8571950328707083,1242,813,2055,+
chr1,156562448,1.2205506773757817,1984,1396,3380,+
chr1,156563245,1.8291877613911516,830,648,1478,+
chr1,156563685,1.3404239267543179,1807,1254,3061,+
chr1,156563743,0.45334561080417424,843,542,1385,+
chr1,156563757,1.4990192873488069,1018,643,1661,+
chr1,156563890,22.528372588973436,3310,2836,6146,+
chr1,156563891,22.52837258897343,3310,2836,6146,+
chr1,156737896,4.640179501652639,580,514,1094,+
chr1,156752103,2.55125284738041,699,438,1137,+
chr1,156752104,2.55125284738041,699,438,1137,+
chr1,156756616,4.023770143041019,715,536,1251,+
chr1,156764575,1.198467488797786,595,483,1078,+
chr1,156770323,6.547065337763012,738,386,1124,+
chr1,158979799,0.6869682710973215,1145,744,1889,+
chr1,158988327,5.44774011299435,550,471,1021,+
chr1,158988363,1.780952380952381,1138,803,1941,+
chr1,158988364,1.780952380952381,1138,803,1941,+
chr1,158988366,0.5331771399882855,707,628,1335,+
chr1,158988407,1.8572560975609755,780,655,1435,+
chr1,158988408,0.4113565022421525,1358,1114,2472,+
chr1,158988411,0.6345514950166112,1527,1203,2730,+
chr1,159023428,4.706142034548944,742,520,1262,+
chr1,159023429,4.706142034548944,742,520,1262,+
chr1,159752213,2.67260579064588,599,448,1047,+
chr1,159752214,2.67260579064588,599,448,1047,+
chr1,160313232,5.050313640049919,1001,799,1800,+
chr1,160314559,1.0387453874538746,562,541,1103,+
chr1,160314560,1.0387453874538746,562,541,1103,+
chr1,160318903,1.893412743641808,1151,886,2037,+
chr1,160319936,0.9187332259796028,777,620,1397,+
chr1,160319937,0.9187332259796028,777,620,1397,+
chr1,160321555,1.0634355504854613,745,554,1299,+
chr1,160321901,2.8340852130325813,770,398,1168,+
chr1,160321902,2.8340852130325813,770,398,1168,+
chr1,160322966,1.8060046189376444,645,432,1077,+
chr1,160326402,4.141771204646213,605,404,1009,+
chr1,160326406,2.2677943760984185,557,568,1125,+
chr1,160326407,2.2677943760984185,557,568,1125,+
chr1,160326832,0.44376040363202274,962,724,1686,+
chr1,160326912,1.143018018018018,909,591,1500,+
chr1,160326913,1.143018018018018,909,591,1500,+
chr1,160327975,1.097562541300859,749,535,1284,+
chr1,160328603,10.790687804317106,2338,2739,5077,+
chr1,160328604,10.790687804317106,2338,2739,5077,+
chr1,161127051,1.0456001058755338,1001,725,1726,+
chr1,161127463,2.694877505567929,725,448,1173,+
chr1,161127473,2.2087471352177235,770,475,1245,+
chr1,161128284,1.884449244060475,697,462,1159,+
chr1,161128334,0.59392575928009,659,507,1166,+
chr1,161128355,1.7896103896103897,635,439,1074,+
chr1,161128364,1.7970990804519176,1090,847,1937,+
chr1,161172172,0.9955486235498592,734,528,1262,+
chr1,161172242,1.0902466671697442,1137,722,1859,+
chr1,161172248,1.2604715945194136,1356,891,2247,+
chr1,161172255,1.4813282865727555,998,522,1520,+
chr1,161173298,0.5956323644933229,676,474,1150,+
chr1,161176320,2.294117647058824,727,475,1202,+
chr1,161176361,1.7211802048766411,722,477,1199,+
chr1,161176363,2.023813205504871,817,668,1485,+
chr1,161176365,1.2417399424259548,3277,2556,5833,+
chr1,161176366,1.0602409638554215,1407,995,2402,+
chr1,161176367,1.249302325581395,1342,1074,2416,+
chr1,161176368,1.0181818181818183,923,725,1648,+
chr1,161176370,2.098075552387741,891,609,1500,+
chr1,161179372,1.7867537867537873,751,480,1231,+
chr1,161179380,2.954622132253711,564,455,1019,+
chr1,161180118,0.990543437145379,1963,1441,3404,+
chr1,161180119,0.990543437145379,1963,1441,3404,+
chr1,161180154,1.964131994261119,776,696,1472,+
chr1,161180493,1.7648984937786512,846,508,1354,+
chr1,161182196,2.120817384862329,1040,622,1662,+
chr1,161182198,3.1092515109251515,879,716,1595,+
chr1,161182202,2.264705882352941,615,509,1124,+
chr1,161183221,1.938738738738739,1075,665,1740,+
chr1,161183442,1.2471786536533147,2107,1360,3467,+
chr1,161183454,0.6599789731908183,1457,877,2334,+
chr1,161183493,1.6302760332992552,949,667,1616,+
chr1,161183498,1.6382058650907618,2666,1518,4184,+
chr1,161183507,0.5601130582249859,1076,724,1800,+
chr1,161183663,1.6096416847659003,2950,1652,4602,+
chr1,161183665,1.6096416847659003,2950,1652,4602,+
chr1,161183679,0.8238274789365415,7097,3920,11017,+
chr1,161183681,0.8238274789365415,7097,3920,11017,+
chr1,161183999,2.211007727487778,700,372,1072,+
chr1,161284180,1.9101281863053452,958,624,1582,+
chr1,161293455,1.3940087338998277,1341,936,2277,+
chr1,161298233,0.5443205443205443,719,428,1147,+
chr1,161298245,1.7648351648351648,802,454,1256,+
chr1,161298271,2.2170680459026992,945,537,1482,+
chr1,161326475,1.8404452690166975,639,538,1177,+
chr1,161326573,2.58275645059786,607,453,1060,+
chr1,161332608,18.19870136441898,4840,901,5741,+
chr1,161332609,17.38015876017136,5472,1064,6536,+
chr1,161332610,17.380158760171355,5472,1064,6536,+
chr1,161332611,9.990009704863033,2192,525,2717,+
chr1,161332613,9.0265340675117,3735,950,4685,+
chr1,161332614,13.489945823457633,4900,1529,6429,+
chr1,161332615,12.699982940784516,5757,1796,7553,+
chr1,161332616,14.609646029693636,4513,1513,6026,+
chr1,161332623,13.732357657942597,2994,1764,4758,+
chr1,161332624,12.565385761096215,1047,745,1792,+
chr1,161332625,13.86820947715711,4670,3566,8236,+
chr1,161332627,18.65195088434152,3146,2822,5968,+
chr1,161332631,7.007389534584505,2494,2985,5479,+
chr1,161332632,7.427096773863188,2772,3312,6084,+
chr1,161332636,0.1133826301290416,390,626,1016,+
chr1,161332742,3.6859045504994454,778,1937,2715,+
chr1,161332743,2.834842152552219,1645,4113,5758,+
chr1,161332744,3.0079700197972974,1207,3036,4243,+
chr1,161332745,2.052309273352785,737,1950,2687,+
chr1,161332747,0.1963763767964359,704,1601,2305,+
chr1,161332748,0.1796573694121184,734,1422,2156,+
chr1,161332769,0.22453704397708912,1299,2670,3969,+
chr1,161332773,0.25665237595078155,657,982,1639,+
chr1,161332779,0.9571118349619978,816,920,1736,+
chr1,161332781,0.7233942627378047,1199,1587,2786,+
chr1,161332782,0.45180647896869663,994,2038,3032,+
chr1,161332785,0.49831929283337345,2013,2393,4406,+
chr1,161332786,0.4828493265915997,3131,4630,7761,+
chr1,161332818,0.5561434450323339,1117,1052,2169,+
chr1,161721685,1.493063549995821,750,505,1255,+
chr1,161721686,1.725,623,415,1038,+
chr1,161721687,1.5991528402611996,1097,785,1882,+
chr1,161929140,15.744564906760363,548,1480,2028,+
chr1,161929141,16.53451955720543,640,1615,2255,+
chr1,161929142,15.744564906760363,548,1480,2028,+
chr1,162535858,2.7688483273278592,693,495,1188,+
chr1,162557346,2.4030985915492957,897,567,1464,+
chr1,162557347,2.4030985915492957,897,567,1464,+
chr1,162569069,1.7302304964539008,672,469,1141,+
chr1,162569414,0.6329218106995884,768,539,1307,+
chr1,162748502,0.4420289855072463,609,482,1091,+
chr1,162748503,1.1074074074074074,597,449,1046,+
chr1,162748504,0.4420289855072463,609,482,1091,+
chr1,162748505,1.1074074074074074,597,449,1046,+
chr1,162749922,2.590943333054323,1205,918,2123,+
chr1,162749924,2.590943333054323,1205,918,2123,+
chr1,162749929,1.8243335054488137,1369,1186,2555,+
chr1,162749931,1.8243335054488137,1369,1186,2555,+
chr1,162749933,0.7017045454545455,987,671,1658,+
chr1,162750698,2.632809170928212,618,434,1052,+
chr1,162750830,2.928345580325658,682,491,1173,+
chr1,162752044,0.3803242921604601,766,468,1234,+
chr1,162752061,1.9711566968101895,2097,1219,3316,+
chr1,162752066,2.4518853695324285,1015,662,1677,+
chr1,162752089,1.9686940966010733,1704,1117,2821,+
chr1,162752100,0.662377337530087,1589,981,2570,+
chr1,162752115,2.237638159345821,5827,4505,10332,+
chr1,162752117,1.885572080375394,9141,6785,15926,+
chr1,162752491,2.7839390054557254,703,481,1184,+
chr1,162754059,2.6340943501191054,629,440,1069,+
chr1,162754109,4.311835161106275,643,445,1088,+
chr1,162754720,1.7404761904761905,644,503,1147,+
chr1,162755304,1.8810438534333545,983,537,1520,+
chr1,162755308,3.158204562178072,927,603,1530,+
chr1,162755310,2.836986301369863,1416,948,2364,+
chr1,162755311,2.556256950932424,1262,828,2090,+
chr1,162755320,2.2235332677810558,847,564,1411,+
chr1,162755322,1.436538629100728,2109,1632,3741,+
chr1,162755324,0.9599508886810104,1262,1068,2330,+
chr1,162755355,0.5044285714285714,641,399,1040,+
chr1,163295827,1.1754203243564945,631,516,1147,+
chr1,163295829,1.1754203243564945,631,516,1147,+
chr1,163298082,2.943851088091982,865,623,1488,+
chr1,163309173,3.071812133635416,617,418,1035,+
chr1,163317614,0.4596333448633691,603,412,1015,+
chr1,165600492,2.332075471698113,720,370,1090,+
chr1,165600493,0.7367788770304919,2648,2090,4738,+
chr1,165600498,1.716164177934235,2134,1480,3614,+
chr1,165600509,1.550593720405041,1289,1035,2324,+
chr1,165600512,0.7210570285362529,1425,1082,2507,+
chr1,165600522,1.4581909576485383,5066,3758,8824,+
chr1,165619081,1.5520448533370788,3922,2454,6376,+
chr1,165619082,1.4966297492044607,5835,4026,9861,+
chr1,165621240,1.2053594252951518,2766,1945,4711,+
chr1,165624692,1.7394532817880306,1360,1017,2377,+
chr1,165624699,1.7876139385699308,4126,3362,7488,+
chr1,165624700,1.791391660600478,4375,3359,7734,+
chr1,165797142,0.3313170731707316,848,614,1462,+
chr1,165797143,0.3313170731707316,848,614,1462,+
chr1,165859523,4.261828901677538,557,445,1002,+
chr1,165865449,1.8408339447528381,668,493,1161,+
chr1,165865470,2.4376169811431847,1295,793,2088,+
chr1,165865471,2.5031021897810217,945,547,1492,+
chr1,165865538,0.5147733405288721,586,435,1021,+
chr1,165872452,0.653774418376362,739,500,1239,+
chr1,165872468,1.6998920017787942,786,582,1368,+
chr1,165877228,3.641231593038822,543,497,1040,+
chr1,165877258,1.5759258231081006,886,580,1466,+
chr1,166822742,26.77997592244808,601,630,1231,+
chr1,166822743,18.48754973031221,1030,1152,2182,+
chr1,167757185,2.0551582371812755,669,518,1187,+
chr1,167757265,1.8954640582049112,589,454,1043,+
chr1,167758556,1.236046336693245,631,390,1021,+
chr1,167758558,1.236046336693245,631,390,1021,+
chr1,167758631,8.739137852550504,1102,715,1817,+
chr1,167758632,9.301680913158618,958,599,1557,+
chr1,167759228,1.3424790227946637,644,410,1054,+
chr1,167971757,1.8013245033112584,1223,905,2128,+
chr1,167971766,1.8221110100090991,1334,1098,2432,+
chr1,168032903,1.0533457414493266,714,587,1301,+
chr1,168037633,0.3462917011304108,627,464,1091,+
chr1,168037670,3.9749608763693267,761,638,1399,+
chr1,168153147,2.2274964296361675,740,549,1289,+
chr1,168154068,2.324300211888034,612,426,1038,+
chr1,168154080,2.249263290243998,986,820,1806,+
chr1,168165803,1.74102904879438,654,457,1111,+
chr1,168169298,2.8181818181818183,867,538,1405,+
chr1,168169317,2.0570880147788837,2792,1947,4739,+
chr1,168169318,1.9212735624901,1865,1283,3148,+
chr1,168169325,2.3043893129771,804,523,1327,+
chr1,168169337,1.6578456373588732,2047,1546,3593,+
chr1,168169364,0.3893981321342096,1184,825,2009,+
chr1,168169365,1.4239491150442478,1625,1355,2980,+
chr1,168169368,1.3919105050501923,3916,3136,7052,+
chr1,168169373,0.7019784970073155,1550,1040,2590,+
chr1,168169374,1.4198855507868386,1984,1863,3847,+
chr1,168169379,1.6147663910786385,2171,2228,4399,+
chr1,168169380,2.1457754025202447,1952,1390,3342,+
chr1,168170201,5.951458784736641,850,663,1513,+
chr1,169080625,2.0457375636288995,760,538,1298,+
chr1,169080633,2.076898272474213,881,651,1532,+
chr1,169080701,2.5795250896057347,979,743,1722,+
chr1,169080702,2.5795250896057347,979,743,1722,+
chr1,169080708,2.078017746526034,1069,904,1973,+
chr1,169080710,2.078017746526034,1069,904,1973,+
chr1,169096567,2.29392446633826,634,405,1039,+
chr1,169100773,1.8108050697443887,672,486,1158,+
chr1,169100906,0.5182932623776489,908,618,1526,+
chr1,169101409,23.10328026182929,1455,1594,3049,+
chr1,169101410,21.08221648567499,1656,1935,3591,+
chr1,169101411,21.08221648567499,1656,1935,3591,+
chr1,169101423,0.3712526113025313,621,898,1519,+
chr1,169101424,0.3796469487958849,432,610,1042,+
chr1,169101428,0.2821833112220127,668,1380,2048,+
chr1,169101429,0.2821833112220127,668,1380,2048,+
chr1,169101449,0.4502787068004459,576,689,1265,+
chr1,169101450,0.2292993630573248,431,941,1372,+
chr1,169101451,0.3876716418794533,1083,1437,2520,+
chr1,169101452,0.2292993630573248,431,941,1372,+
chr1,171496952,3.5157097933196515,799,476,1275,+
chr1,171502045,2.829422739470825,761,490,1251,+
chr1,171509162,1.4533458057779327,660,380,1040,+
chr1,171510700,2.1462668956070234,701,566,1267,+
chr1,171510716,2.1778967495219885,677,522,1199,+
chr1,171510717,1.370255872677094,1241,962,2203,+
chr1,171561035,0.2415803438701174,472,805,1277,+
chr1,171561036,0.2623211446740858,417,645,1062,+
chr1,171561037,0.2623211446740858,417,645,1062,+
chr1,171561062,0.13116462266802126,344,692,1036,+
chr1,171561071,0.322187306784518,476,679,1155,+
chr1,171753027,2.2752313493044074,1006,759,1765,+
chr1,171753029,2.00210101010101,651,494,1145,+
chr1,173446473,0.9875021400445128,617,530,1147,+
chr1,173446475,0.9875021400445128,617,530,1147,+
chr1,173446479,1.9390059786218974,697,570,1267,+
chr1,173446524,1.2173605038575208,1169,945,2114,+
chr1,173446550,1.4148788883384777,1887,1140,3027,+
chr1,173446572,1.5088580838184165,2910,2201,5111,+
chr1,173446584,1.3899312384306937,3729,2499,6228,+
chr1,173450496,1.4177376354770346,4268,2797,7065,+
chr1,173450513,1.2864381999612018,2384,1938,4322,+
chr1,173450525,1.6611012826183105,1990,1462,3452,+
chr1,173450546,1.4009070040113005,6311,4223,10534,+
chr1,173450562,1.267351069982649,3505,2469,5974,+
chr1,173454616,1.3500814479638008,3662,2124,5786,+
chr1,173454617,1.4159596422838796,2374,1959,4333,+
chr1,173457262,2.1555607634588823,1769,1238,3007,+
chr1,173457393,1.875540197606599,1503,1091,2594,+
chr1,173457431,2.255291005291005,824,566,1390,+
chr1,173457465,1.7062399596812294,1775,1197,2972,+
chr1,173457467,0.5530487804878049,906,614,1520,+
chr1,173457556,1.3779472233932706,2373,1838,4211,+
chr1,173457562,1.3951190834308342,5349,3864,9213,+
chr1,173457611,1.5217325227963523,1177,986,2163,+
chr1,173457747,1.5416847847570856,999,616,1615,+
chr1,173800701,0.344911879425122,586,425,1011,+
chr1,173822698,1.432727562569743,718,368,1086,+
chr1,173822699,1.8524468718096083,879,473,1352,+
chr1,173822700,1.432727562569743,718,368,1086,+
chr1,173826911,2.3169077443967145,683,397,1080,+
chr1,174969256,1.755917627088388,1219,844,2063,+
chr1,174969260,1.872839861751152,764,433,1197,+
chr1,174969280,0.6819438418521918,2790,1762,4552,+
chr1,174969282,0.6933020668850605,1680,1123,2803,+
chr1,174969286,1.7125965250965252,1358,776,2134,+
chr1,174973757,0.4124107633168589,750,606,1356,+
chr1,174973786,0.6083175117266026,1244,967,2211,+
chr1,174975913,1.5131300491936428,3480,2568,6048,+
chr1,174975915,1.473785892870672,2760,2166,4926,+
chr1,174975923,1.7809973045822107,880,529,1409,+
chr1,174975929,1.5118361153262518,971,658,1629,+
chr1,174975949,1.5465899645913985,5358,4035,9393,+
chr1,174975958,1.8414399111488584,1657,1330,2987,+
chr1,174975964,1.9708290805851785,1876,1721,3597,+
chr1,174977800,2.657388456815391,1081,697,1778,+
chr1,174979332,1.554229554229554,860,538,1398,+
chr1,174979624,1.133053942136554,705,543,1248,+
chr1,179043164,2.525393278841214,638,413,1051,+
chr1,179043333,2.2263740316675324,727,439,1166,+
chr1,179043662,2.816276580875925,892,548,1440,+
chr1,179043664,3.2835257515518608,848,585,1433,+
chr1,179054861,0.6678775253836501,884,603,1487,+
chr1,179054966,3.5633829296303303,795,581,1376,+
chr1,179064516,2.2275906659185702,563,490,1053,+
chr1,179065049,4.591900891328329,649,414,1063,+
chr1,179065069,45.48933901639418,1004,1003,2007,+
chr1,179065070,30.19738536816588,2198,1901,4099,+
chr1,179065071,30.19738536816588,2198,1901,4099,+
chr1,179304770,4.441860465116279,763,515,1278,+
chr1,179304771,3.6331547068127237,949,639,1588,+
chr1,179304772,4.441860465116279,763,515,1278,+
chr1,179323002,12.115107922468772,779,1052,1831,+
chr1,179323003,10.427352560475914,1169,2151,3320,+
chr1,179323005,5.314779270633397,324,1041,1365,+
chr1,179323024,0.29455030258958687,531,945,1476,+
chr1,179323171,2.8328277176356003,663,473,1136,+
chr1,179888338,0.24532578140616998,1033,558,1591,+
chr1,180166741,29.86040839983543,1069,827,1896,+
chr1,180166742,28.39951594729595,1182,956,2138,+
chr1,180166864,3.618703119096359,592,445,1037,+
chr1,180794447,1.943483983522084,708,463,1171,+
chr1,180853307,2.790337941085753,634,517,1151,+
chr1,180853774,9.560810810810812,1131,147,1278,+
chr1,180853775,10.364640883977902,1406,180,1586,+
chr1,180853776,11.74522240285894,1855,214,2069,+
chr1,180853777,13.903982243758259,1569,177,1746,+
chr1,180853784,20.680969617416785,1199,107,1306,+
chr1,180853786,27.184736592247425,1596,146,1742,+
chr1,180853787,21.8955786099865,1373,147,1520,+
chr1,180853789,53.1186046511628,1003,343,1346,+
chr1,180853790,50.11564539552304,1381,517,1898,+
chr1,180853791,51.86178228108368,1444,702,2146,+
chr1,180854914,0.42207049618559767,2135,1344,3479,+
chr1,180854915,0.6096159719041074,778,471,1249,+
chr1,180854916,0.2205530489472245,889,551,1440,+
chr1,182808562,1.9268680445151036,605,406,1011,+
chr1,182822539,5.82070017474209,750,586,1336,+
chr1,182823278,3.939248601119105,671,416,1087,+
chr1,182827742,2.1666666666666665,623,383,1006,+
chr1,182829309,0.45005633989527394,678,641,1319,+
chr1,182835585,0.40462074978204016,713,619,1332,+
chr1,182845211,0.5860719874804382,641,425,1066,+
chr1,182845267,6.952208106473079,675,550,1225,+
chr1,182846007,1.8727128082736677,641,418,1059,+
chr1,182848491,2.251195132551065,1294,766,2060,+
chr1,182848493,2.251195132551065,1294,766,2060,+
chr1,182850451,2.5576354679802957,648,434,1082,+
chr1,182850454,6.954666666666667,651,449,1100,+
chr1,182850478,0.3497135966234548,579,534,1113,+
chr1,182850737,0.5945822102425876,816,741,1557,+
chr1,182852384,3.1880466472303204,728,391,1119,+
chr1,182852741,1.0891692329288316,765,598,1363,+
chr1,182856516,7.304709389795822,1729,1119,2848,+
chr1,182856517,6.400448340669995,2377,1647,4024,+
chr1,182856518,6.8060019719463,1965,1369,3334,+
chr1,182856519,5.54594616572247,1759,1283,3042,+
chr1,182856526,1.967541229385307,672,459,1131,+
chr1,182856527,1.967541229385307,672,459,1131,+
chr1,182856562,4.6573369223805665,1805,1882,3687,+
chr1,182856564,0.7978935207944156,1138,1452,2590,+
chr1,182856566,0.5200789993416721,789,991,1780,+
chr1,182856609,0.7879969992498125,1312,1332,2644,+
chr1,182856610,0.7879969992498125,1312,1332,2644,+
chr1,182856769,1.920481220657277,747,425,1172,+
chr1,183072591,1.5422543182511352,606,410,1016,+
chr1,183086817,0.36649358656422415,642,531,1173,+
chr1,183101554,3.171428571428572,702,379,1081,+
chr1,183101569,1.7009400705052873,964,551,1515,+
chr1,183101571,2.2038217998105147,1849,1165,3014,+
chr1,183101600,1.6842380048325851,4265,2896,7161,+
chr1,183101601,1.6842380048325851,4265,2896,7161,+
chr1,183101602,1.6842380048325851,4265,2896,7161,+
chr1,183106921,1.6567182565180714,764,467,1231,+
chr1,183109567,5.9281115879828326,662,465,1127,+
chr1,183109570,6.666666666666667,761,380,1141,+
chr1,183109574,1.3517815287580799,2340,1647,3987,+
chr1,183109575,1.695531545273747,3418,2196,5614,+
chr1,183109576,1.7477897085483196,1898,1009,2907,+
chr1,183113363,10.762497556526652,1311,1029,2340,+
chr1,183113364,10.762497556526652,1311,1029,2340,+
chr1,183515315,1.439058754886389,930,685,1615,+
chr1,183515317,0.519995780918111,791,548,1339,+
chr1,183519950,2.564146972989299,766,506,1272,+
chr1,183519952,1.1235424872893855,774,526,1300,+
chr1,183519964,0.9409185910179948,838,502,1340,+
chr1,183519965,0.9409185910179948,838,502,1340,+
chr1,184042051,0.3641456582633053,649,458,1107,+
chr1,184042058,1.81981981981982,605,406,1011,+
chr1,184043015,0.3541185527328714,574,432,1006,+
chr1,184043244,2.830618892508143,868,613,1481,+
chr1,184043245,2.830618892508143,868,613,1481,+
chr1,186357619,1.6024904214559388,1016,568,1584,+
chr1,186358719,1.1767904303246854,908,470,1378,+
chr1,186358721,1.412441108006707,1212,689,1901,+
chr1,186360857,2.48018648018648,645,428,1073,+
chr1,186360859,2.48018648018648,645,428,1073,+
chr1,186375293,3.0850534735392077,585,444,1029,+
chr1,186389480,2.7432120727914797,781,593,1374,+
chr1,186389498,2.8216602674434,665,580,1245,+
chr1,186389499,0.3203539823008849,904,564,1468,+
chr1,186389501,0.3203539823008849,904,564,1468,+
chr1,186389504,2.1167200478062114,2383,1730,4113,+
chr1,186389507,2.5206896551724136,1189,811,2000,+
chr1,186389508,2.5206896551724136,1189,811,2000,+
chr1,186389519,2.120762890066448,1753,1320,3073,+
chr1,186389520,2.120762890066448,1753,1320,3073,+
chr1,186389527,2.1264473907493793,1950,1527,3477,+
chr1,186390056,2.1438369823088563,945,638,1583,+
chr1,186390091,3.075884418039428,669,528,1197,+
chr1,186798114,0.6868044515103339,647,554,1201,+
chr1,186823418,1.7152742898599254,903,542,1445,+
chr1,186823439,0.6564717504374011,4342,2809,7151,+
chr1,186823440,0.6564717504374011,4342,2809,7151,+
chr1,186823441,0.7915384674907547,7071,4401,11472,+
chr1,186823443,1.015065913370998,2729,1592,4321,+
chr1,186823445,1.7329899078879334,2010,1321,3331,+
chr1,186823446,1.2512315440095652,3865,2424,6289,+
chr1,186862216,2.413968866235019,648,426,1074,+
chr1,186880470,1.007794699604269,763,537,1300,+
chr1,186880471,1.007794699604269,763,537,1300,+
chr1,186901970,2.7934911417950006,1011,733,1744,+
chr1,186909111,1.4657786728742292,861,590,1451,+
chr1,186909115,2.089962125078695,1554,1109,2663,+
chr1,186909146,1.96186117467582,642,436,1078,+
chr1,186925399,2.3087680113022464,1071,746,1817,+
chr1,186934591,2.517593338705345,720,437,1157,+
chr1,186934672,2.2642487046632125,683,385,1068,+
chr1,186946788,2.11231884057971,635,413,1048,+
chr1,186946795,2.2324693491399494,875,675,1550,+
chr1,186957551,0.4727272727272727,581,484,1065,+
chr1,186957733,3.308815379878904,707,564,1271,+
chr1,186957987,1.9833333333333334,730,515,1245,+
chr1,192685741,2.342068600358443,643,426,1069,+
chr1,192685756,2.280067111378553,1422,1000,2422,+
chr1,192778227,3.061855670103093,1052,581,1633,+
chr1,192778229,3.061855670103093,1052,581,1633,+
chr1,192778240,1.773516414141414,660,383,1043,+
chr1,192778252,1.6934088875633764,834,478,1312,+
chr1,192778271,2.709634698156936,1115,696,1811,+
chr1,192778280,2.989857456140351,838,455,1293,+
chr1,192779369,1.8642105652531122,1071,860,1931,+
chr1,192779370,0.7303026049266835,803,612,1415,+
chr1,192779371,2.297096920258685,672,552,1224,+
chr1,192780830,0.3252556554074992,655,460,1115,+
chr1,192780832,0.3252556554074992,655,460,1115,+
chr1,198248104,5.522418478260869,738,367,1105,+
chr1,198248105,5.522418478260869,738,367,1105,+
chr1,198248106,5.522418478260869,738,367,1105,+
chr1,198288573,1.6671806167400878,840,453,1293,+
chr1,198288579,0.6656580937972768,909,660,1569,+
chr1,198288581,2.4459358687546606,655,446,1101,+
chr1,198288604,1.6396215596330277,1633,871,2504,+
chr1,198288605,1.8485084306095976,1017,770,1787,+
chr1,198288615,1.648694377079691,1885,1042,2927,+
chr1,198288622,2.2105745021744108,2194,1284,3478,+
chr1,200821748,4.2004766070425195,616,416,1032,+
chr1,201835932,0.34174693861641986,889,615,1504,+
chr1,201836075,2.343092089992224,645,474,1119,+
chr1,201837859,3.38271491739573,620,449,1069,+
chr1,201839921,1.5694004269919042,707,488,1195,+
chr1,201840369,1.1720822011988783,641,537,1178,+
chr1,201844010,10.968319654633936,1332,850,2182,+
chr1,201844012,8.625915001567378,1409,926,2335,+
chr1,201844013,10.903292231820581,1608,1198,2806,+
chr1,201844015,4.992306606437042,812,615,1427,+
chr1,201844017,4.593966502876431,1077,1021,2098,+
chr1,201844031,0.3898295131463773,622,709,1331,+
chr1,201924639,1.36839109553867,701,499,1200,+
chr1,201926640,3.0274146695715323,574,458,1032,+
chr1,201932775,2.3240058910162,1051,678,1729,+
chr1,201932867,0.4633641674780915,1268,1039,2307,+
chr1,201932868,0.4633641674780915,1268,1039,2307,+
chr1,201934609,2.072345700876649,806,490,1296,+
chr1,201938602,1.7780830280830282,1164,818,1982,+
chr1,201938611,1.607728337236534,1372,1035,2407,+
chr1,201938676,0.6560395490201024,1444,966,2410,+
chr1,201938677,0.7876793613118998,3128,2092,5220,+
chr1,201938694,1.2450145172168614,15033,9671,24704,+
chr1,201938695,1.2450145172168614,15033,9671,24704,+
chr1,201938696,1.856286569521127,6161,4555,10716,+
chr1,201938914,1.5401287318689243,1802,1197,2999,+
chr1,201958116,2.7263359373313603,653,485,1138,+
chr1,201958147,0.2930743243243243,693,591,1284,+
chr1,201958149,0.2930743243243243,693,591,1284,+
chr1,201965300,1.2372538462347524,594,483,1077,+
chr1,201973520,1.145537662713191,1252,1048,2300,+
chr1,201973521,0.8389260903658498,1502,1136,2638,+
chr1,201974746,1.6370390877997267,2523,1507,4030,+
chr1,201974748,1.9454984477406003,1409,891,2300,+
chr1,201974778,0.9634009073233695,2770,1405,4175,+
chr1,201974897,3.169144824980248,787,567,1354,+
chr1,201974909,1.8201846657737935,1650,1440,3090,+
chr1,201974910,1.0444726810673444,821,786,1607,+
chr1,201974983,2.816510172143975,625,425,1050,+
chr1,201975120,1.7022508142012789,694,481,1175,+
chr1,201980285,1.7150209790209792,1436,974,2410,+
chr1,201980286,1.7150209790209792,1436,974,2410,+
chr1,202976911,2.594019847054688,1013,648,1661,+
chr1,202976912,2.5540095449351345,825,512,1337,+
chr1,202976913,2.5540095449351345,825,512,1337,+
chr1,202976918,2.890432913203644,662,456,1118,+
chr1,202992323,1.3253171382156441,621,396,1017,+
chr1,203765608,2.365139176324311,1011,825,1836,+
chr1,203787737,3.0454153977254395,886,672,1558,+
chr1,203798701,3.5714484776057582,779,517,1296,+
chr1,203798705,0.8739402288828034,611,466,1077,+
chr1,203802919,1.692868395831138,647,478,1125,+
chr1,203816806,0.9930069930069928,638,428,1066,+
chr1,203816808,0.9930069930069928,638,428,1066,+
chr1,203818933,1.0112866817155757,643,442,1085,+
chr1,203818934,1.0112866817155757,643,442,1085,+
chr1,203819137,2.685308245873359,570,467,1037,+
chr1,203821417,1.5954657419083647,838,632,1470,+
chr1,203821984,3.0439024390243903,623,409,1032,+
chr1,203821986,3.0439024390243903,623,409,1032,+
chr1,203822372,2.2766013071895426,621,424,1045,+
chr1,203822854,2.6144541417853318,682,621,1303,+
chr1,203822855,2.6144541417853318,682,621,1303,+
chr1,203822858,2.001246356503867,755,625,1380,+
chr1,203822986,1.6238244514106583,811,637,1448,+
chr1,203830725,0.6007258703141479,981,518,1499,+
chr1,203830726,0.575846396715441,760,384,1144,+
chr1,203830729,2.5503442899831104,754,357,1111,+
chr1,203830730,2.5503442899831104,754,357,1111,+
chr1,203830735,1.238735027568287,1010,508,1518,+
chr1,203830736,1.7001207613348845,2109,1228,3337,+
chr1,203830772,0.6445707070707071,1020,671,1691,+
chr1,203830774,0.714175506268081,1586,1219,2805,+
chr1,203830778,0.6690556259992282,1639,934,2573,+
chr1,205499824,1.4213092986486764,597,406,1003,+
chr1,205500491,2.662894248608534,1388,979,2367,+
chr1,205500492,2.662894248608534,1388,979,2367,+
chr1,205500501,1.5569845731081944,1474,951,2425,+
chr1,206858695,4.044530367189637,613,502,1115,+
chr1,206905256,2.242654028436019,675,421,1096,+
chr1,206905257,2.242654028436019,675,421,1096,+
chr1,206905923,2.0482208979303986,916,613,1529,+
chr1,206905926,1.4906300034389226,1052,671,1723,+
chr1,206905930,2.4208355746817287,586,428,1014,+
chr1,206905942,2.3142733619419715,1430,1200,2630,+
chr1,206905943,2.342894171857761,2209,1765,3974,+
chr1,206905945,2.137337662337662,680,439,1119,+
chr1,207495017,1.0232560969698024,2318,1675,3993,+
chr1,207495018,0.9810208454876997,3977,2766,6743,+
chr1,207495019,0.5948660714285714,1065,923,1988,+
chr1,207495020,0.6960263248943965,4764,3148,7912,+
chr1,207495021,0.6284197654594059,4821,3308,8129,+
chr1,207495023,0.5994265626466843,2689,2149,4838,+
chr1,207495024,0.615067306863997,2977,1675,4652,+
chr1,207495027,0.9366051581310996,4414,2930,7344,+
chr1,207495028,0.7878865011721957,9845,6224,16069,+
chr1,207495091,1.3667983996702944,6195,4427,10622,+
chr1,207495110,1.4957737141594387,1804,786,2590,+
chr1,207495186,1.4452525891374814,3800,2918,6718,+
chr1,207495745,1.2945460522082408,5059,4068,9127,+
chr1,207495748,1.4160751282391668,6124,4737,10861,+
chr1,207495754,0.9187501246592894,20334,14809,35143,+
chr1,207495755,0.8232671930704253,15323,11431,26754,+
chr1,207498064,1.42125078884261,13017,10007,23024,+
chr1,207504451,0.8592007225107249,1794,823,2617,+
chr1,207504488,1.2658483636122937,35298,23070,58368,+
chr1,207504491,0.7730947153193605,72475,46844,119319,+
chr1,207504492,1.0425046450078574,85984,54719,140703,+
chr1,207504512,1.841790641029979,55282,39322,94604,+
chr1,207510671,1.1637970188694826,828,758,1586,+
chr1,207510672,1.2642335777537002,1477,1373,2850,+
chr1,207513815,0.3804220826639404,905,667,1572,+
chr1,207513816,0.3804220826639404,905,667,1572,+
chr1,207532930,1.2346766042160986,29743,21666,51409,+
chr1,207533115,1.0429629283984352,27750,21314,49064,+
chr1,207533116,0.9172211143284142,56570,42108,98678,+
chr1,207533387,1.2879356149679124,36224,25150,61374,+
chr1,207533530,1.1886868856121535,7738,4991,12729,+
chr1,207533734,1.4936046602917394,5695,3265,8960,+
chr1,207925434,3.001142631614276,688,470,1158,+
chr1,207925452,1.2957010847730013,773,523,1296,+
chr1,207925471,2.161619718309859,876,567,1443,+
chr1,207925531,1.358989310009718,1287,1028,2315,+
chr1,207925590,2.482611548556431,1080,761,1841,+
chr1,207930380,1.4790462775726538,3047,2405,5452,+
chr1,207930390,1.621514545523148,1909,1558,3467,+
chr1,207930404,1.7560770283068503,2085,1461,3546,+
chr1,207930410,0.7061025062547334,4497,3623,8120,+
chr1,207930914,1.55546010021985,4946,3481,8427,+
chr1,207930915,1.493902577731794,7208,5293,12501,+
chr1,207930936,1.4551327249068386,5136,3433,8569,+
chr1,207934662,0.9849221931727679,5820,4541,10361,+
chr1,207934668,1.395288497800126,7613,4624,12237,+
chr1,207934669,1.3716623032826682,10932,7277,18209,+
chr1,207940385,1.5695981870478517,2250,1787,4037,+
chr1,207943676,1.440510011205306,2736,1666,4402,+
chr1,207963654,1.875677830940989,1093,835,1928,+
chr1,207967186,1.3328613569321537,2823,1649,4472,+
chr1,207967300,1.6536807487983811,2178,1356,3534,+
chr1,207967522,2.02255460588794,2433,1871,4304,+
chr1,207967543,1.3645231970153002,2572,2008,4580,+
chr1,207967819,2.9437799043062203,2069,1671,3740,+
chr1,207967896,1.309173317705717,3042,2336,5378,+
chr1,207967934,1.3913750868896098,3227,2476,5703,+
chr1,207967959,0.6905532153695763,8816,6504,15320,+
chr1,207968050,1.190378091693881,5152,3761,8913,+
chr1,207968220,1.3543901167338879,5860,4354,10214,+
chr1,207968568,1.4484678310648098,4481,2903,7384,+
chr1,207968697,1.4536559245149834,5262,3572,8834,+
chr1,210004377,2.318359375,1186,895,2081,+
chr1,210004378,2.318359375,1186,895,2081,+
chr1,212216344,1.9545971272356597,953,672,1625,+
chr1,212216345,1.3931609674728942,782,544,1326,+
chr1,212216346,1.3931609674728942,782,544,1326,+
chr1,212241986,2.051127819548872,619,474,1093,+
chr1,212241988,2.051127819548872,619,474,1093,+
chr1,212274349,1.4675169204732212,1655,1083,2738,+
chr1,212274351,2.02995308552869,674,488,1162,+
chr1,212515607,2.283990519284637,1199,713,1912,+
chr1,212515608,2.283990519284637,1199,713,1912,+
chr1,212606423,1.7637265534486044,821,579,1400,+
chr1,212615921,1.568746355685131,1061,734,1795,+
chr1,212615922,1.568746355685131,1061,734,1795,+
chr1,212617682,2.8208405425015353,990,778,1768,+
chr1,212617684,2.8208405425015353,990,778,1768,+
chr1,212619234,1.0252439650744736,1923,1319,3242,+
chr1,212619236,1.182417143839524,2484,1787,4271,+
chr1,212619309,0.43828111624721794,639,648,1287,+
chr1,212619321,0.47728674203494353,773,694,1467,+
chr1,212619330,0.5584594222833562,869,726,1595,+
chr1,212619345,1.7543980580253176,4455,3134,7589,+
chr1,212619347,1.808018617804749,1963,1542,3505,+
chr1,212619348,1.741612694300518,1378,964,2342,+
chr1,212619411,1.685325516448852,1257,905,2162,+
chr1,212791571,2.3274188148644126,868,617,1485,+
chr1,212791573,2.3274188148644126,868,617,1485,+
chr1,212793268,58.118993505820725,980,1172,2152,+
chr1,212793269,58.118993505820725,980,1172,2152,+
chr1,212793893,1.5835923980899391,725,561,1286,+
chr1,212976079,2.700991253644315,1006,685,1691,+
chr1,212976080,2.605062875336942,1368,946,2314,+
chr1,212977666,1.9795742945975192,1853,1365,3218,+
chr1,212977668,1.9526406248594064,2078,1590,3668,+
chr1,212977669,2.391418703506908,1168,940,2108,+
chr1,214505523,0.9796910862461813,878,535,1413,+
chr1,214507619,0.9815770081061164,665,353,1018,+
chr1,214507621,0.9815770081061164,665,353,1018,+
chr1,214507637,1.1299620830970334,699,529,1228,+
chr1,214510103,0.4723777689610735,967,574,1541,+
chr1,214818492,2.591710438393073,1091,593,1684,+
chr1,214818517,2.0696895146450265,1099,693,1792,+
chr1,214818524,2.4280107047279214,877,589,1466,+
chr1,214818534,2.7169744318181817,1092,615,1707,+
chr1,214818535,2.1342405559717776,2919,1770,4689,+
chr1,214818561,2.394782608695652,764,499,1263,+
chr1,214818562,1.5399543378995433,1348,802,2150,+
chr1,214818578,1.761689291101056,1751,1070,2821,+
chr1,214820416,3.1306220095693784,726,417,1143,+
chr1,214820417,3.1306220095693784,726,417,1143,+
chr1,214820496,1.6203522504892367,620,510,1130,+
chr1,214820502,2.4942612687813024,682,598,1280,+
chr1,214822115,1.7212337758557106,1125,754,1879,+
chr1,214826234,1.2862237660211209,802,525,1327,+
chr1,214830654,1.937640845755357,586,544,1130,+
chr1,214837244,0.8895750456626103,2081,1743,3824,+
chr1,214837246,0.6064775182422241,1622,1442,3064,+
chr1,215775234,3.052472468149428,588,420,1008,+
chr1,215777534,3.2374160658791293,661,532,1193,+
chr1,215777588,2.0309302761353556,1000,595,1595,+
chr1,215793558,2.595035551041138,996,715,1711,+
chr1,215793567,1.7589422585590189,2247,1647,3894,+
chr1,215793569,1.7589422585590189,2247,1647,3894,+
chr1,215793577,1.870882241575161,1280,972,2252,+
chr1,215793590,1.9653585457485374,3757,2557,6314,+
chr1,215793592,1.969160768452983,2336,1379,3715,+
chr1,215793621,2.440388349514563,1570,1029,2599,+
chr1,215793624,0.7860902255639098,2459,1823,4282,+
chr1,215793626,1.6293617080932552,1815,1208,3023,+
chr1,215793627,1.0695301853326817,3272,2030,5302,+
chr1,215793633,1.8001564064922415,4311,3168,7479,+
chr1,215793635,1.881399018232819,6603,4967,11570,+
chr1,215793636,2.0238361700781424,4508,3463,7971,+
chr1,215793640,0.7736279926335176,3826,2714,6540,+
chr1,215793700,0.667741935483871,735,495,1230,+
chr1,215794073,1.9946666666666668,560,449,1009,+
chr1,215794083,0.6657458563535912,722,542,1264,+
chr1,215794086,0.3262043876088634,806,578,1384,+
chr1,215794096,0.6075978959672707,1129,724,1853,+
chr1,215794128,1.558151093439364,1099,1005,2104,+
chr1,215794806,2.2257242557737342,892,559,1451,+
chr1,218458654,2.0540437414122494,659,401,1060,+
chr1,218518699,0.4366952789699571,554,465,1019,+
chr1,218518746,2.8699261992619927,548,541,1089,+
chr1,218520271,3.5617323852617973,579,441,1020,+
chr1,218520272,3.5617323852617973,579,441,1020,+
chr1,220273940,2.7505617977528094,611,444,1055,+
chr1,220273948,2.03616334705686,630,472,1102,+
chr1,220276103,2.564459930313589,689,573,1262,+
chr1,220284171,1.5155555555555555,1022,674,1696,+
chr1,220284260,0.5337003422109805,843,610,1453,+
chr1,220300146,1.773219814241486,631,543,1174,+
chr1,220307747,2.13939393939394,705,494,1199,+
chr1,220307749,1.930841924398625,724,581,1305,+
chr1,220307752,1.53175916496945,586,490,1076,+
chr1,220307764,0.5770887166236004,1339,1031,2370,+
chr1,220307766,1.4097955879376645,1200,914,2114,+
chr1,220311333,0.4858645627876397,738,467,1205,+
chr1,220311371,0.3650724637681159,686,574,1260,+
chr1,220315158,2.273684210526316,623,493,1116,+
chr1,220316437,4.499716553287982,634,440,1074,+
chr1,220316445,1.57529296875,848,639,1487,+
chr1,220318862,0.5734580734580735,661,480,1141,+
chr1,220320914,1.7033482142857144,586,447,1033,+
chr1,220320971,1.668897737863255,937,637,1574,+
chr1,220321089,1.8028169014084507,1087,709,1796,+
chr1,220321231,1.8592407869215848,670,400,1070,+
chr1,220427233,2.6777964763518773,1492,1077,2569,+
chr1,220960482,0.9578061740890688,720,415,1135,+
chr1,220960484,1.3425560186776688,897,554,1451,+
chr1,220970040,0.5002439269271604,767,487,1254,+
chr1,220970091,2.959494773519164,754,491,1245,+
chr1,220971308,1.690590111642743,1059,721,1780,+
chr1,220978432,1.95497791369351,932,653,1585,+
chr1,220986755,0.6025711662075298,771,483,1254,+
chr1,220986785,1.7250702247191012,866,533,1399,+
chr1,220986883,1.8875143184421537,1176,872,2048,+
chr1,220987148,0.41395623891188643,699,622,1321,+
chr1,220987203,1.5361241995892232,861,533,1394,+
chr1,220987240,0.5639946018893387,652,474,1126,+
chr1,220987268,1.6670807453416148,670,489,1159,+
chr1,220987270,1.8058958401572223,1020,709,1729,+
chr1,220987437,2.273678702250131,868,545,1413,+
chr1,220987463,1.7959475481787466,1200,824,2024,+
chr1,220987477,1.794397463002114,678,472,1150,+
chr1,220987578,1.7268773278865794,1381,1014,2395,+
chr1,223933044,4.155881930837834,926,692,1618,+
chr1,223943248,9.5885671682381,771,618,1389,+
chr1,223943249,7.952111348016547,1033,790,1823,+
chr1,223943250,7.407130907641206,1286,999,2285,+
chr1,223943259,3.662702428752526,558,572,1130,+
chr1,223949295,3.2548757170172085,586,522,1108,+
chr1,223949296,3.2548757170172085,586,522,1108,+
chr1,223959885,2.369348659003831,772,521,1293,+
chr1,223959887,2.369348659003831,772,521,1293,+
chr1,223963065,0.3897764522949183,575,502,1077,+
chr1,223963273,3.0294970986460346,894,516,1410,+
chr1,223963274,3.0294970986460346,894,516,1410,+
chr1,224377312,2.8917770014365933,727,508,1235,+
chr1,224380333,2.424812030075188,1124,797,1921,+
chr1,224380335,2.424812030075188,1124,797,1921,+
chr1,224380748,4.337015168482133,612,469,1081,+
chr1,224544591,11.237731288639237,697,388,1085,+
chr1,224544623,5.1325942333795735,698,436,1134,+
chr1,224544626,4.84303073660501,1720,987,2707,+
chr1,224544636,9.203938043184705,1857,1259,3116,+
chr1,224544638,8.678603603603603,1242,839,2081,+
chr1,224544639,11.104502040512466,1973,2119,4092,+
chr1,224544649,0.3948521358159912,411,663,1074,+
chr1,224544660,0.5956553678245357,472,732,1204,+
chr1,224548229,0.5221374045801527,835,654,1489,+
chr1,224559029,0.5447470817120623,615,513,1128,+
chr1,224563514,1.9762717373638883,759,585,1344,+
chr1,224563602,1.8811252268602539,690,579,1269,+
chr1,225965707,0.9668943772990016,1149,1037,2186,+
chr1,225965709,0.9668943772990016,1149,1037,2186,+
chr1,225977106,1.818253968253968,868,494,1362,+
chr1,225977108,1.5502722601426489,1122,766,1888,+
chr1,225977118,1.6094420600858368,649,465,1114,+
chr1,225977518,1.3869294605809126,1336,963,2299,+
chr1,225977846,1.7825159914712154,626,468,1094,+
chr1,225977850,1.2649248149736212,912,668,1580,+
chr1,225977902,1.9517795637198625,1325,870,2195,+
chr1,225977904,0.7101828301265748,2045,1452,3497,+
chr1,225978022,0.6180485241531344,2537,1803,4340,+
chr1,225978023,0.6180485241531344,2537,1803,4340,+
chr1,225978067,2.532230339492909,2356,1968,4324,+
chr1,225978072,1.8688306939592272,5532,4314,9846,+
chr1,226019606,1.9949110765343736,582,432,1014,+
chr1,226250421,0.8039601365239405,1561,555,2116,+
chr1,226250425,0.5971023973720747,2032,668,2700,+
chr1,228270417,0.5824652777777778,670,351,1021,+
chr1,228270421,1.3129888942539838,926,544,1470,+
chr1,228284828,1.0940484473296328,2702,2057,4759,+
chr1,228284840,1.6614420062695925,1059,869,1928,+
chr1,228284915,1.7317073170731705,1039,819,1858,+
chr1,228284947,1.5062386980108502,1850,1105,2955,+
chr1,228285066,2.141300646918624,1323,1067,2390,+
chr1,228285068,0.5884995507637018,1309,1112,2421,+
chr1,228285134,2.046034917050291,905,793,1698,+
chr1,228285141,1.637556352410801,3106,1985,5091,+
chr1,228285143,1.637556352410801,3106,1985,5091,+
chr1,228285148,1.7611201445347784,1597,1106,2703,+
chr1,228285294,2.3071428571428574,1155,1019,2174,+
chr1,228285300,1.6332791477881925,1165,996,2161,+
chr1,228285375,3.381048387096774,902,650,1552,+
chr1,228285399,1.5669919634385014,2255,1551,3806,+
chr1,228285407,1.5580779832697862,2190,1553,3743,+
chr1,228285410,1.4361900629203732,1438,837,2275,+
chr1,228285667,0.6476354070319162,1314,1002,2316,+
chr1,228285706,2.026911012831767,1660,1249,2909,+
chr1,228285709,2.0823899371069183,923,635,1558,+
chr1,228285733,2.3627564847077043,1794,1259,3053,+
chr1,228285734,2.3627564847077043,1794,1259,3053,+
chr1,228285754,1.5508939612530916,1796,1212,3008,+
chr1,228285761,1.8331573389651528,1208,946,2154,+
chr1,228285795,1.5450861195542045,1224,986,2210,+
chr1,228285843,0.6520157281026845,1341,1195,2536,+
chr1,228285845,1.4956149732620323,2127,1274,3401,+
chr1,228285905,1.488318105339382,2085,1268,3353,+
chr1,228285912,1.8101335187355405,8487,6503,14990,+
chr1,228286065,1.6953872053872054,1170,824,1994,+
chr1,228286075,1.7140856576029877,1223,901,2124,+
chr1,228286077,1.5892931085477668,2004,1224,3228,+
chr1,228286098,1.7085400090185754,1608,1402,3010,+
chr1,228286242,2.4262766096382395,1326,740,2066,+
chr1,228286263,1.6329012274865204,1293,757,2050,+
chr1,228286296,1.6802067876210667,2483,1814,4297,+
chr1,228286408,0.5937427173153111,1421,1225,2646,+
chr1,228286410,0.6087876524769729,2189,1853,4042,+
chr1,228286411,0.9391502403800798,3079,2288,5367,+
chr1,228286425,1.765004512635379,1042,553,1595,+
chr1,228286468,0.6035398230088496,758,564,1322,+
chr1,228286496,2.74277660324172,833,472,1305,+
chr1,228286592,1.7995633187772928,633,457,1090,+
chr1,228286595,2.30560214693056,947,541,1488,+
chr1,228286603,2.5303030303030303,667,527,1194,+
chr1,228286623,1.581195164845847,1999,1265,3264,+
chr1,228286634,2.22075141132957,1425,933,2358,+
chr1,228286640,1.5232070153460695,1543,1029,2572,+
chr1,228286746,2.273972602739726,1493,1313,2806,+
chr1,228333212,0.5130568356374808,834,557,1391,+
chr1,228333213,1.1868481163938331,2211,1201,3412,+
chr1,228333218,1.672683712668842,1190,562,1752,+
chr1,228676661,0.8291265205569024,862,529,1391,+
chr1,228676663,0.9672022892361876,675,412,1087,+
chr1,228676676,3.9501064251957136,619,427,1046,+
chr1,228676680,1.6612234950036555,638,372,1010,+
chr1,228676687,1.440376569037657,674,477,1151,+
chr1,228676691,1.6333575581395352,898,515,1413,+
chr1,228676693,1.8215962441314557,1639,1229,2868,+
chr1,228676694,1.8215962441314557,1639,1229,2868,+
chr1,228676697,2.231299040976461,897,739,1636,+
chr1,228676698,0.5866209262435678,873,582,1455,+
chr1,228682016,1.2368209928940592,733,520,1253,+
chr1,228682303,2.377233518176217,758,540,1298,+
chr1,228682304,2.3415177993781584,1020,773,1793,+
chr1,228682305,2.377233518176217,758,540,1298,+
chr1,229431645,2.313290163428924,725,422,1147,+
chr1,229431647,2.313290163428924,725,422,1147,+
chr1,229433287,1.867977528089888,854,533,1387,+
chr1,229433296,2.115863163042861,3123,2065,5188,+
chr1,229439596,1.4141156772384211,759,683,1442,+
chr1,229439714,2.2030236214321777,682,430,1112,+
chr1,230202990,2.905809683314804,681,356,1037,+
chr1,230203147,1.7218818633683963,783,421,1204,+
chr1,230313964,1.892966128934733,1681,1049,2730,+
chr1,230313970,1.8011968697253338,875,664,1539,+
chr1,230313971,0.4833266335424812,2611,1824,4435,+
chr1,230313972,0.38287278606599556,1602,1236,2838,+
chr1,230313973,1.932002889651436,1944,1581,3525,+
chr1,230313974,1.665275205842043,3060,2531,5591,+
chr1,230313976,1.4923872554025148,3110,2545,5655,+
chr1,230338929,1.4935195266272188,2160,1624,3784,+
chr1,230338969,1.3664237755065534,1487,1180,2667,+
chr1,230371789,1.9112837061751355,1091,777,1868,+
chr1,230371818,1.77689594356261,805,647,1452,+
chr1,230371822,1.6442840333690292,1828,1326,3154,+
chr1,230372105,1.4447756490223629,1617,988,2605,+
chr1,230372125,0.7544102737411288,2125,1613,3738,+
chr1,230372142,1.698316177618272,3381,2489,5870,+
chr1,230372160,1.6800900249176112,4478,2870,7348,+
chr1,230372161,1.7184447537848964,5638,3863,9501,+
chr1,230379128,1.5389076024389206,1288,997,2285,+
chr1,230384933,1.6497187939384472,2372,1729,4101,+
chr1,230385013,0.7419875206760453,2293,1707,4000,+
chr1,230386210,1.5154619192461385,1516,1241,2757,+
chr1,230391070,1.5078245809364756,1282,950,2232,+
chr1,230398318,0.6206166468175202,937,686,1623,+
chr1,230398319,1.76412876852325,1643,1029,2672,+
chr1,230398338,1.6833979033728348,1322,1096,2418,+
chr1,230398344,1.5196945337620578,1193,932,2125,+
chr1,230398368,1.3184769840418644,3802,3048,6850,+
chr1,230398391,1.328094968908988,2763,1829,4592,+
chr1,230401084,1.6023100972672537,2538,2031,4569,+
chr1,230410241,1.7104511656309491,4821,2715,7536,+
chr1,230410264,1.330655812077831,6626,3814,10440,+
chr1,230410267,1.4345896852456401,37653,24051,61704,+
chr1,230410268,1.420708104707004,54720,35357,90077,+
chr1,230410269,1.47189199241804,50055,34808,84863,+
chr1,230410270,1.4669083406808363,76725,52130,128855,+
chr1,230410271,1.6165293296017837,52002,36106,88108,+
chr1,230410272,1.7587965487990271,26697,20072,46769,+
chr1,230415123,0.6077675888109733,955,682,1637,+
chr1,230415178,1.6502475561756174,2070,1400,3470,+
chr1,230415199,2.17231548938866,1396,846,2242,+
chr1,230415230,0.952380960896507,3535,2556,6091,+
chr1,230415234,1.632622139764997,1426,979,2405,+
chr1,230415258,1.3686405337781484,1640,1198,2838,+
chr1,230415458,1.812450748620961,574,563,1137,+
chr1,230415527,0.6101973684210525,1112,797,1909,+
chr1,230415570,1.9979741417506875,2299,1219,3518,+
chr1,230415573,3.9998722088909804,2128,1046,3174,+
chr1,230415577,6.339432984812368,6425,4297,10722,+
chr1,230415579,6.339432984812368,6425,4297,10722,+
chr1,230415582,2.1355592654424043,614,598,1212,+
chr1,230415594,3.611522004440589,2192,1446,3638,+
chr1,230415596,3.215216181799167,4524,3452,7976,+
chr1,230415602,0.4373296158612143,742,806,1548,+
chr1,230415603,2.493115058524126,2256,1890,4146,+
chr1,230415619,0.7421526304236481,965,1037,2002,+
chr1,230415655,2.0085666969655462,1697,1638,3335,+
chr1,230415869,1.2840851495184995,2814,1972,4786,+
chr1,230415931,1.545009608455441,1254,723,1977,+
chr1,230415957,2.276985743380856,601,490,1091,+
chr1,230416017,1.6287349014621744,731,483,1214,+
chr1,230416026,5.251834978486459,829,438,1267,+
chr1,230416050,1.6746917204932477,735,523,1258,+
chr1,230416066,1.6841249682499364,895,634,1529,+
chr1,230416094,1.0953282006509837,2725,1922,4647,+
chr1,230416135,0.6016476388168137,2649,1926,4575,+
chr1,230416286,1.58388690172032,1640,1235,2875,+
chr1,230416287,1.765817901234568,1193,863,2056,+
chr1,230416303,2.883997331877993,1159,716,1875,+
chr1,230416331,0.6117154811715482,1529,1194,2723,+
chr1,230416453,0.558044250204862,680,522,1202,+
chr1,230416457,2.601409978308026,737,460,1197,+
chr1,230416478,1.5762980276181162,2776,1822,4598,+
chr1,230416479,1.5762980276181162,2776,1822,4598,+
chr1,230416480,1.5579811109058739,3577,2452,6029,+
chr1,230416508,1.5987311657414751,671,581,1252,+
chr1,230416509,0.7218821757215765,3279,2140,5419,+
chr1,230416510,0.7218821757215765,3279,2140,5419,+
chr1,230416525,1.3375829015421379,3142,2491,5633,+
chr1,230416591,0.3193247758044663,1815,1209,3024,+
chr1,230416765,2.053390895677359,834,630,1464,+
chr1,230416793,1.4064813365240534,1122,732,1854,+
chr1,230416794,1.759162303664921,959,763,1722,+
chr1,230417011,0.6368172355681856,802,570,1372,+
chr1,230417083,1.5917501391207571,933,598,1531,+
chr1,230417102,3.3194233687405155,874,658,1532,+
chr1,230417134,1.6375109833053756,819,641,1460,+
chr1,230417138,1.8632806732614795,630,520,1150,+
chr1,230417180,0.4793941340184114,688,518,1206,+
chr1,230417203,2.6993464052287583,648,494,1142,+
chr1,230417223,2.342244044371704,735,610,1345,+
chr1,230417288,1.8259109311740886,1352,1169,2521,+
chr1,230417462,0.3324014723976287,1411,389,1800,+
chr1,230417471,6.604413745870728,2987,478,3465,+
chr1,230417473,7.207031219868307,4451,727,5178,+
chr1,230417474,5.931996505499185,4859,797,5656,+
chr1,230417476,7.57234447007186,4444,753,5197,+
chr1,230417477,13.048868760292253,3890,643,4533,+
chr1,230417479,6.334269662921348,2254,355,2609,+
chr1,230417480,5.32469817520359,4601,897,5498,+
chr1,230417481,7.233761761851934,8751,1768,10519,+
chr1,230417482,7.100114361029043,8906,1820,10726,+
chr1,230417483,6.341141395110668,7417,1737,9154,+
chr1,230417484,16.629161184210528,2896,1215,4111,+
chr1,230417485,13.05341853794921,10799,10164,20963,+
chr1,230417486,7.645073660630592,11957,15458,27415,+
chr1,230417487,6.747138082749035,12281,16930,29211,+
chr1,230417488,6.546484704369762,9629,16247,25876,+
chr1,230417489,2.3073085144825,2895,4388,7283,+
chr1,230417498,0.5346499526963102,1232,1811,3043,+
chr1,230417500,0.2965031568722681,813,1845,2658,+
chr1,230417504,0.4657918071325112,10139,16418,26557,+
chr1,230417505,0.46174169470829274,11897,18669,30566,+
chr1,230417506,0.4986058769995663,6465,8616,15081,+
chr1,230417507,0.5169398824585364,5001,6580,11581,+
chr1,230417510,0.5070443668233497,6262,9874,16136,+
chr1,230417512,0.3492044997140012,1781,3630,5411,+
chr1,230825868,1.7912543648583223,633,414,1047,+
chr1,230825887,1.7399267399267395,664,454,1118,+
chr1,230825895,2.1567567567567565,1044,924,1968,+
chr1,230825896,2.1567567567567565,1044,924,1968,+
chr1,230827131,1.8617148761289226,2437,1862,4299,+
chr1,230829385,0.6144799201959013,858,592,1450,+
chr1,231132927,1.9199057831688162,1001,707,1708,+
chr1,231132928,0.4742460317460317,628,419,1047,+
chr1,231401527,1.491840593757755,990,721,1711,+
chr1,231401787,1.794276875483372,579,430,1009,+
chr1,231401794,2.5511510901051992,1153,936,2089,+
chr1,231401796,2.5511510901051992,1153,936,2089,+
chr1,231401799,1.267618364948526,1847,1390,3237,+
chr1,231406504,1.479812295292858,968,687,1655,+
chr1,231409783,3.401822173567388,967,776,1743,+
chr1,231700498,1.8941922418286012,2537,2073,4610,+
chr1,231700499,2.1000934035779384,2205,1797,4002,+
chr1,231700538,0.6994480632489681,1152,1182,2334,+
chr1,231700541,1.9797932330827068,765,607,1372,+
chr1,231701932,3.6861001317523057,721,505,1226,+
chr1,233807826,3.089715552018289,629,385,1014,+
chr1,234509263,1.8947599691102706,774,528,1302,+
chr1,234509987,1.2017543859649122,547,455,1002,+
chr1,234509988,1.2017543859649122,547,455,1002,+
chr1,234510006,0.9176029962546816,734,533,1267,+
chr1,234510007,0.9176029962546816,734,533,1267,+
chr1,234510063,1.7248803827751196,720,493,1213,+
chr1,234510111,1.936842105263158,666,434,1100,+
chr1,234510116,0.6282051282051283,1175,818,1993,+
chr1,234519485,2.1295546558704457,788,493,1281,+
chr1,234519548,2.1259716506630086,1093,647,1740,+
chr1,234519555,1.3294658572506195,2027,1147,3174,+
chr1,234519633,1.396910762939675,4472,2971,7443,+
chr1,234519637,1.1373113997595603,4849,3213,8062,+
chr1,234519661,1.8213654891304343,3697,2943,6640,+
chr1,235582846,0.6215903145983348,817,566,1383,+
chr1,242023967,2.2201892744479497,764,633,1397,+
chr1,242023970,2.073912905751061,1326,1049,2375,+
chr1,242023982,0.6494377886352988,1048,891,1939,+
chr1,242023985,2.582526315789474,1691,999,2690,+
chr1,242023987,2.582526315789474,1691,999,2690,+
chr1,242024709,1.686378187027201,1723,1094,2817,+
chr1,242024733,1.7944129489073324,3306,2490,5796,+
chr1,243468036,0.7348317981577893,698,453,1151,+
chr1,243468037,0.7348317981577893,698,453,1151,+
chr1,243468038,0.7348317981577893,698,453,1151,+
chr1,244869368,1.7175438613645972,615,414,1029,+
chr1,244869462,1.1059420726537241,596,413,1009,+
chr1,246887870,3.981845238095238,786,279,1065,+
chr1,246887871,3.981845238095238,786,279,1065,+
chr1,246887872,2.789197807468431,680,476,1156,+
chr1,246890200,2.262060413708168,679,554,1233,+
chr1,246890212,2.5583756345177666,647,393,1040,+
chr1,246890220,1.7922775139376417,743,500,1243,+
chr1,246890242,1.834768295771081,1010,717,1727,+
chr1,246899290,2.0813292294851062,1022,660,1682,+
chr1,246903528,1.7583207642031173,852,764,1616,+
chr1,246903594,1.704723268617792,953,713,1666,+
chr1,246903597,2.137378221728943,618,476,1094,+
chr1,246907408,2.778952991452991,702,584,1286,+
chr1,246921619,2.0156185778873814,1225,810,2035,+
chr1,246921644,2.164626682986536,1178,816,1994,+
chr1,246923519,1.5472406181015452,977,754,1731,+
chr1,246927609,0.609789698605488,942,683,1625,+
chr1,880007,0.785100043261951,519,483,1002,-
chr1,881570,0.6472622243160628,1112,656,1768,-
chr1,881571,0.7204563769925172,1089,665,1754,-
chr1,892332,5.105360927453109,2502,2286,4788,-
chr1,892333,5.658849311297927,2049,1929,3978,-
chr1,892334,5.781499202551834,749,683,1432,-
chr1,892367,3.549897933790335,1682,1150,2832,-
chr1,892369,3.549897933790336,1682,1150,2832,-
chr1,1152415,3.46136061094348,1739,1264,3003,-
chr1,1152493,2.1345291479820627,951,668,1619,-
chr1,1152519,0.4896405919661733,578,439,1017,-
chr1,1152609,0.3889028444452947,986,655,1641,-
chr1,1152637,1.0671542553191489,641,563,1204,-
chr1,1152638,1.0671542553191489,641,563,1204,-
chr1,1152639,1.0671542553191489,641,563,1204,-
chr1,1152651,2.39855459449083,1045,613,1658,-
chr1,1152653,3.207302660156503,1390,775,2165,-
chr1,1152654,3.8765306122448977,1047,489,1536,-
chr1,1152656,4.640461215932914,698,317,1015,-
chr1,1152958,1.836616635397123,690,532,1222,-
chr1,1153018,1.223589643470505,2311,1742,4053,-
chr1,1153040,1.9237588652482267,650,469,1119,-
chr1,1153895,1.8155729056763033,955,676,1631,-
chr1,1153903,2.187808896210873,912,606,1518,-
chr1,1153909,2.17059891107078,1011,835,1846,-
chr1,1153910,2.17059891107078,1011,835,1846,-
chr1,1153949,1.9890111844969278,1171,790,1961,-
chr1,1153998,1.0997505502567864,913,724,1637,-
chr1,1154000,1.3698559688327505,1631,1168,2799,-
chr1,1158650,1.7077866861030129,906,587,1493,-
chr1,1158691,2.5216535433070866,548,507,1055,-
chr1,1159228,2.3645244215938304,656,388,1044,-
chr1,1159324,1.420531748061147,2736,1756,4492,-
chr1,1159325,1.5631877766844682,4712,3512,8224,-
chr1,1159326,0.987879548020022,1082,1138,2220,-
chr1,1159327,1.799043239635096,1883,1111,2994,-
chr1,1163865,0.5706356407108929,593,456,1049,-
chr1,1164036,1.1461386900497774,746,624,1370,-
chr1,1164068,3.718390804597701,646,521,1167,-
chr1,1164070,3.718390804597701,646,521,1167,-
chr1,1192605,0.3492242111596816,1341,873,2214,-
chr1,1248439,2.4479967906256914,979,716,1695,-
chr1,1309183,0.5523024054982818,573,484,1057,-
chr1,1309202,2.3520000000000003,839,499,1338,-
chr1,1309233,0.5062127236580517,678,502,1180,-
chr1,1309271,2.130393996247655,756,532,1288,-
chr1,1309278,0.4802296650717703,737,474,1211,-
chr1,1309435,0.4852368963149462,953,770,1723,-
chr1,1309452,1.7959472521730444,1695,1345,3040,-
chr1,1309453,1.6356011183597392,674,554,1228,-
chr1,1309483,2.733663366336634,1003,605,1608,-
chr1,1309495,2.2861736334405145,1026,621,1647,-
chr1,1309506,0.351245704467354,628,484,1112,-
chr1,1309582,2.533070644525753,719,417,1136,-
chr1,1309621,0.4541104299121854,781,613,1394,-
chr1,1309675,1.8725182863113896,727,428,1155,-
chr1,1310507,7.746242965798685,640,422,1062,-
chr1,1337387,1.8203787184717644,1075,776,1851,-
chr1,1337489,1.7438271604938271,564,503,1067,-
chr1,1337505,1.0282013541360024,943,789,1732,-
chr1,1337506,0.792795356437011,1441,1112,2553,-
chr1,1342307,1.232198551901018,789,567,1356,-
chr1,1342386,1.2274089096531973,727,530,1257,-
chr1,1342545,1.8430276256538798,616,418,1034,-
chr1,1477113,1.3664721400004725,679,520,1199,-
chr1,1477316,1.6945043103448274,934,637,1571,-
chr1,1477372,1.8313333017122797,989,726,1715,-
chr1,1479261,1.256103533972374,7445,5733,13178,-
chr1,1479264,2.0407304043120975,4430,3243,7673,-
chr1,1479270,1.961623908153307,5976,4034,10010,-
chr1,1479271,1.834988006512238,5840,4251,10091,-
chr1,1479273,1.6283613281608842,5528,3558,9086,-
chr1,1479275,0.7385265122495381,4826,3267,8093,-
chr1,1479276,0.7552431306576944,4098,2735,6833,-
chr1,1479303,1.7191011235955054,1070,711,1781,-
chr1,1479306,1.966883116883117,931,439,1370,-
chr1,1479362,0.5875586401902192,891,531,1422,-
chr1,1480317,1.5850914205344584,783,631,1414,-
chr1,1500211,1.7232475679607238,971,646,1617,-
chr1,1500227,2.0210128788612374,772,448,1220,-
chr1,1650837,1.6099558916194077,729,528,1257,-
chr1,1653059,1.0595287285612294,637,440,1077,-
chr1,1683192,2.6688729340144386,1455,938,2393,-
chr1,1683214,0.3761531129155629,818,449,1267,-
chr1,1683228,1.0929915048543688,654,411,1065,-
chr1,1683230,1.245521000605336,1158,687,1845,-
chr1,1716961,1.190891641947304,818,520,1338,-
chr1,1716962,1.5824072989585798,1583,1028,2611,-
chr1,1716964,2.353734939759036,791,497,1288,-
chr1,1717176,9.121196706950002,1387,1893,3280,-
chr1,1717177,9.121196706950004,1387,1893,3280,-
chr1,1717182,19.46285890621038,1536,1176,2712,-
chr1,1717183,19.46285890621038,1536,1176,2712,-
chr1,1717184,29.462547232718386,788,408,1196,-
chr1,1717186,20.379024853672167,1233,386,1619,-
chr1,1717377,1.8954996186117465,780,626,1406,-
chr1,1717389,2.0260375709917,681,544,1225,-
chr1,1717391,1.7538126361655775,827,611,1438,-
chr1,1717463,1.846560846560846,697,449,1146,-
chr1,1717496,2.7849056603773588,737,423,1160,-
chr1,1717707,3.690659046258261,737,508,1245,-
chr1,1717709,3.690659046258261,737,508,1245,-
chr1,1717751,5.1363231273823065,666,505,1171,-
chr1,1717936,2.565217391304348,589,505,1094,-
chr1,1718351,2.575044563279857,698,560,1258,-
chr1,1718363,0.3728578045391384,643,507,1150,-
chr1,1718386,2.747967479674797,727,491,1218,-
chr1,1718421,0.6122149564050973,634,496,1130,-
chr1,1718457,1.6592307692307695,718,467,1185,-
chr1,1718468,0.5226480127240664,998,729,1727,-
chr1,1718794,2.7634248641500863,1692,1240,2932,-
chr1,1718795,2.7634248641500863,1692,1240,2932,-
chr1,1718824,0.7028496437945257,651,507,1158,-
chr1,1718825,1.69671974522293,1238,784,2022,-
chr1,1718826,1.69671974522293,1238,784,2022,-
chr1,1721920,4.29165782084967,758,610,1368,-
chr1,1735867,2.2771661931818183,674,351,1025,-
chr1,1735929,2.2801339285714284,680,447,1127,-
chr1,1735975,1.9592336161978325,1011,684,1695,-
chr1,1737918,2.2164613081767692,677,560,1237,-
chr1,1747227,2.0222885056533904,1466,885,2351,-
chr1,1747229,2.0872927591503787,1158,608,1766,-
chr1,1747295,1.8631489841986453,638,442,1080,-
chr1,1756849,2.076381500719694,908,840,1748,-
chr1,1756938,0.4572913709086407,535,512,1047,-
chr1,1770634,0.7145737590163435,4173,2986,7159,-
chr1,1770635,1.4317556336093664,12216,10080,22296,-
chr1,1770636,1.7709447093979274,8043,7094,15137,-
chr1,1770647,1.2837475133411222,3524,2878,6402,-
chr1,1770655,1.4404275751751319,6722,5037,11759,-
chr1,1770665,1.3912675643970152,7170,5468,12638,-
chr1,1770666,1.47325562157721,4236,3141,7377,-
chr1,1770668,1.4198405806091432,6781,4311,11092,-
chr1,1770669,1.4650267117522473,12347,8014,20361,-
chr1,1770670,1.4475669294667408,13940,9083,23023,-
chr1,1770671,1.3902668431686755,8282,5092,13374,-
chr1,1770672,1.4177832510978783,4055,2814,6869,-
chr1,1770673,1.0213157091668392,7314,5085,12399,-
chr1,1770674,0.7107326793229487,3424,2755,6179,-
chr1,1770676,1.3731651231651232,1644,961,2605,-
chr1,1770677,1.3402569031391298,2076,1221,3297,-
chr1,1822260,1.3970157287243583,1610,1453,3063,-
chr1,1822264,1.6095734150346175,4509,3300,7809,-
chr1,1822279,1.621857923497268,1059,599,1658,-
chr1,1822291,1.7632408575031524,657,487,1144,-
chr1,1822301,1.8747318747318749,919,503,1422,-
chr1,1822303,1.719395653172488,1566,883,2449,-
chr1,1822304,1.966942148760331,881,461,1342,-
chr1,3551586,0.968417761100688,651,491,1142,-
chr1,3551588,0.968417761100688,651,491,1142,-
chr1,3551609,0.4061818368762663,696,523,1219,-
chr1,3551611,0.3952307397625211,665,528,1193,-
chr1,3751598,3.503947208993655,813,599,1412,-
chr1,3756338,1.7307258376366221,750,626,1376,-
chr1,6245213,1.6305849838783972,1179,834,2013,-
chr1,6245775,0.5233586024184875,687,568,1255,-
chr1,6245777,0.6299385045544891,1861,1235,3096,-
chr1,6245801,3.1010101010101008,613,485,1098,-
chr1,6245802,0.4300966671475978,541,477,1018,-
chr1,6245841,1.3892847884859656,2202,1609,3811,-
chr1,6246119,1.5736141466322275,989,718,1707,-
chr1,6246138,1.8088048090523337,1002,706,1708,-
chr1,6246260,1.7835676684214037,1486,1046,2532,-
chr1,6246400,0.6831727165016879,5957,6635,12592,-
chr1,6246427,0.5544903525050164,6206,7685,13891,-
chr1,6246428,0.6064624806069714,5627,6172,11799,-
chr1,6246430,0.5377653585203046,4937,6286,11223,-
chr1,6246431,0.3538677009265244,1492,3059,4551,-
chr1,6246432,0.4793926699296534,5109,7885,12994,-
chr1,6246435,0.5657508601497673,1671,2195,3866,-
chr1,6246436,0.5657508601497673,1671,2195,3866,-
chr1,6246440,0.4243887543031446,2100,3802,5902,-
chr1,6246443,0.3289477425604481,1870,3625,5495,-
chr1,6246447,1.2007603104196136,2252,5512,7764,-
chr1,6246449,3.9335245480506154,4833,11146,15979,-
chr1,6246450,5.688106683662832,3933,8167,12100,-
chr1,6246451,6.433240450940493,5402,9498,14900,-
chr1,6246452,8.202745055570125,4020,6295,10315,-
chr1,6246453,13.227854187465116,2072,1759,3831,-
chr1,6246455,5.338326446280992,794,241,1035,-
chr1,6246457,4.431422543309764,1826,773,2599,-
chr1,6246458,6.304621875665509,1482,555,2037,-
chr1,6246460,7.941774059108956,1941,735,2676,-
chr1,6246462,7.497165081321622,1163,371,1534,-
chr1,6246464,5.585072874771287,1109,246,1355,-
chr1,6246465,6.023709643569499,2419,636,3055,-
chr1,6246467,5.812289462683557,1765,487,2252,-
chr1,6257759,1.148184929524471,8694,5583,14277,-
chr1,6257778,1.161892270980199,8809,6309,15118,-
chr1,6257814,1.212374974325969,12589,8162,20751,-
chr1,6257815,1.10376262547012,24126,16681,40807,-
chr1,6259630,0.7544040703237945,4234,3045,7279,-
chr1,6259643,1.0574671866400598,6864,4460,11324,-
chr1,6259646,1.2597529870481023,10297,7100,17397,-
chr1,6259647,1.2356132978999594,16770,10433,27203,-
chr1,6259649,1.3006121407543427,22967,13650,36617,-
chr1,6259650,1.3984610122903338,19119,11769,30888,-
chr1,6259651,1.1843550373638831,23246,13992,37238,-
chr1,6259653,1.0525197523746936,14014,8274,22288,-
chr1,6259654,0.9779649961190898,6146,3809,9955,-
chr1,6259655,1.0610647990555722,2933,1676,4609,-
chr1,6284105,2.0821561073750368,1108,950,2058,-
chr1,6284707,3.8416797959066646,607,407,1014,-
chr1,6294979,1.0469187675070029,689,475,1164,-
chr1,6294980,1.3625192802155943,880,619,1499,-
chr1,6697395,0.38218586190734305,889,520,1409,-
chr1,8072596,3.571107157314054,633,440,1073,-
chr1,8073020,29.52412747059906,2004,1626,3630,-
chr1,8073021,28.824491855199625,2260,1714,3974,-
chr1,8073022,16.620658135283364,1044,546,1590,-
chr1,8073023,6.528584817244611,773,290,1063,-
chr1,8921112,1.5148081529948165,15729,11489,27218,-
chr1,8921286,1.4486676996931305,11919,7472,19391,-
chr1,8921308,1.3186563507379965,32919,21395,54314,-
chr1,8921309,1.3322362586467267,38515,26441,64956,-
chr1,8921438,1.229902421961692,7529,5921,13450,-
chr1,8921458,1.227578890829522,20469,11697,32166,-
chr1,8921459,1.1154239358552,27750,17376,45126,-
chr1,8921468,1.2686613025431146,8486,4662,13148,-
chr1,8921488,1.0253727634194831,846,502,1348,-
chr1,8921489,1.0253727634194831,846,502,1348,-
chr1,8922976,0.6732450700105835,18161,11537,29698,-
chr1,8923004,0.9035006461201214,5117,3796,8913,-
chr1,8923005,0.9540105276209195,3290,2405,5695,-
chr1,8923337,1.2733466017045552,14743,11373,26116,-
chr1,8923338,1.2165287175659254,29188,20106,49294,-
chr1,8924056,0.849615908196321,27982,19550,47532,-
chr1,8924099,1.5482738898275856,9186,7484,16670,-
chr1,8924142,1.348094487695118,8772,6969,15741,-
chr1,8924151,0.68817986122025,853,601,1454,-
chr1,8925351,1.2281215867873307,31254,22981,54235,-
chr1,8925358,1.2002250187681849,13342,8300,21642,-
chr1,8925372,1.2692215077749556,13239,8125,21364,-
chr1,8925393,1.2383457080040716,7176,5517,12693,-
chr1,8925438,1.4918688915732987,8235,6257,14492,-
chr1,8925441,1.2569567510670003,7931,5914,13845,-
chr1,8925442,1.0892818993195386,24270,16407,40677,-
chr1,8926342,1.179076496326259,36965,27579,64544,-
chr1,8926399,1.235836929210719,24848,17142,41990,-
chr1,8926498,1.212652036576064,30937,23841,54778,-
chr1,8926499,1.2518688785026797,31463,22179,53642,-
chr1,8927194,1.2334813119499182,14571,9141,23712,-
chr1,8927195,0.8684922170266246,20010,15964,35974,-
chr1,8927245,1.2953166096198885,8636,6343,14979,-
chr1,8927306,1.1282257607508233,34052,25379,59431,-
chr1,8928116,0.986306663937605,1314,1008,2322,-
chr1,8928117,0.9383236434587701,3150,2462,5612,-
chr1,8931999,1.1573457205482327,46681,34351,81032,-
chr1,8932045,0.6649555700114913,776,574,1350,-
chr1,8934886,1.354672426638314,10266,8193,18459,-
chr1,8934895,0.7995402234301455,27380,21310,48690,-
chr1,8934932,1.1679479277648397,9705,7708,17413,-
chr1,8934974,1.405006741719057,10810,7241,18051,-
chr1,8934976,1.2510321009541303,13430,9067,22497,-
chr1,8934977,0.9596986937037156,1097,861,1958,-
chr1,8938712,1.3616429264093943,21046,9139,30185,-
chr1,8938737,1.709613275801843,56084,27642,83726,-
chr1,8938744,0.5564349096267985,49968,21461,71429,-
chr1,8938745,0.5524849438213338,23650,10382,34032,-
chr1,8938747,1.1142690595679234,12556,7663,20219,-
chr1,8938748,1.092077316343247,13580,9213,22793,-
chr1,8938767,1.4162782359268555,3554,2788,6342,-
chr1,8938768,1.4162782359268555,3554,2788,6342,-
chr1,9996643,2.5182308749525713,1084,911,1995,-
chr1,9996644,2.685091943957968,662,570,1232,-
chr1,9996649,4.9694333533093875,717,481,1198,-
chr1,10002780,1.6808275862068964,676,434,1110,-
chr1,10523655,1.4571223524413073,620,517,1137,-
chr1,11139814,2.1576843846712324,848,702,1550,-
chr1,11140578,2.178154980653976,745,572,1317,-
chr1,11148209,2.119175627240144,824,539,1363,-
chr1,11148222,1.706191708346341,960,542,1502,-
chr1,11148227,2.0970343748048896,1794,955,2749,-
chr1,11148228,1.2484513253408052,2249,1351,3600,-
chr1,11148233,2.7187138561184363,1021,523,1544,-
chr1,11148234,2.780150906656931,1497,746,2243,-
chr1,11148236,2.8007040306132645,1927,900,2827,-
chr1,11148237,2.393071593533487,941,432,1373,-
chr1,11148238,0.5555232558139535,587,429,1016,-
chr1,11150654,3.4613957981183616,757,421,1178,-
chr1,11736969,0.8768918666513539,4974,3598,8572,-
chr1,11736970,0.7280401628737322,4132,2865,6997,-
chr1,11736971,0.7280401628737322,4132,2865,6997,-
chr1,11736972,0.6226344776181209,715,588,1303,-
chr1,11736976,0.4786936326130233,1951,1506,3457,-
chr1,11736977,1.0374139636225101,1845,1197,3042,-
chr1,11736978,0.529042838036658,3881,2976,6857,-
chr1,11736979,0.7534371914965092,2325,1890,4215,-
chr1,11740432,1.3409459296953377,690,503,1193,-
chr1,11740481,1.5086862720242142,707,512,1219,-
chr1,11983480,2.6729838981129674,580,431,1011,-
chr1,15819009,2.656633906633907,691,406,1097,-
chr1,15819010,1.6098107144582183,1293,823,2116,-
chr1,15819499,1.0548571867912198,979,666,1645,-
chr1,15819501,1.0548571867912198,979,666,1645,-
chr1,15844705,2.4158613117148073,1144,819,1963,-
chr1,15844712,0.7960491535365761,1307,969,2276,-
chr1,15844714,1.0409007352941178,754,575,1329,-
chr1,15844849,2.759459181466687,843,611,1454,-
chr1,15850596,5.432728647014361,624,377,1001,-
chr1,15850597,5.432728647014361,624,377,1001,-
chr1,15850627,1.9571181167234064,824,512,1336,-
chr1,16134098,0.8332708097182456,840,571,1411,-
chr1,17010178,0.38016232732945004,1367,765,2132,-
chr1,17010179,0.46527030234999656,1059,609,1668,-
chr1,17010180,0.46527030234999656,1059,609,1668,-
chr1,17349128,1.4163601207319376,1464,1177,2641,-
chr1,17349129,2.0452039691289965,1059,906,1965,-
chr1,17349149,1.72679726974559,973,777,1750,-
chr1,17350475,2.043354391180478,1030,620,1650,-
chr1,17350479,2.1395008479771427,1809,1397,3206,-
chr1,17354250,1.3374537713273458,2178,1398,3576,-
chr1,17355134,1.425453561971817,5336,3806,9142,-
chr1,17359601,1.5157257025006445,2137,1723,3860,-
chr1,17371286,0.6274584978712424,3579,2461,6040,-
chr1,17371321,1.3992263537926233,1941,1546,3487,-
chr1,17371335,1.6208820965894977,2105,1479,3584,-
chr1,17371337,1.944474476793575,762,562,1324,-
chr1,17371364,1.9135828877005348,1916,1019,2935,-
chr1,17371365,1.9135828877005348,1916,1019,2935,-
chr1,17371373,3.017964071856288,559,500,1059,-
chr1,17371374,1.9792284471130668,1412,838,2250,-
chr1,17380464,1.1510248112189858,1066,926,1992,-
chr1,17380466,1.3366264876411351,1568,1355,2923,-
chr1,17380468,2.0612750086202656,1552,1262,2814,-
chr1,17380516,1.872420241464834,1065,597,1662,-
chr1,17380523,0.8196728540113325,1587,931,2518,-
chr1,17380524,0.6984578917254721,868,507,1375,-
chr1,17733493,1.9915110915689285,680,433,1113,-
chr1,17733610,2.117091365081216,784,510,1294,-
chr1,17734241,8.619225806451613,996,774,1770,-
chr1,17734242,9.280625623307868,1984,1573,3557,-
chr1,17734466,2.3584135678562923,744,548,1292,-
chr1,17734710,1.220862202173263,778,655,1433,-
chr1,17734755,0.49259019380568553,620,990,1610,-
chr1,17734758,0.3615071283095722,709,981,1690,-
chr1,17734759,0.3615071283095722,709,981,1690,-
chr1,17734826,0.1656580937972768,364,660,1024,-
chr1,17734833,18.219564287442036,3248,4075,7323,-
chr1,17734834,19.156458719500424,4099,4265,8364,-
chr1,17734835,19.156458719500424,4099,4265,8364,-
chr1,17734836,28.770252192005515,2848,1360,4208,-
chr1,17734842,8.02533574258719,2942,532,3474,-
chr1,17734843,8.536325394952678,3543,586,4129,-
chr1,17734844,10.228209071607404,3957,690,4647,-
chr1,17734845,12.919111421150918,3794,624,4418,-
chr1,17734847,10.28280849016253,1741,263,2004,-
chr1,17735564,2.913757700205339,859,486,1345,-
chr1,17735565,2.913757700205339,859,486,1345,-
chr1,17735668,2.2115313615293104,1476,1282,2758,-
chr1,17735670,2.2115313615293104,1476,1282,2758,-
chr1,17735688,1.1317410260837506,1478,973,2451,-
chr1,17736479,0.6667767639651542,645,456,1101,-
chr1,17736482,1.6646713195826526,1052,623,1675,-
chr1,17739635,2.337317397078353,639,501,1140,-
chr1,17739636,2.337317397078353,639,501,1140,-
chr1,17740107,1.319096509240247,802,486,1288,-
chr1,17747278,1.9722927241962773,745,393,1138,-
chr1,17747319,1.8846805584858237,1258,985,2243,-
chr1,17747320,1.961668241123447,1152,943,2095,-
chr1,17748756,3.096614732771113,778,527,1305,-
chr1,17755666,3.0220288224396787,612,443,1055,-
chr1,19441361,0.7743345914543102,844,600,1444,-
chr1,19633821,0.5919765657716228,800,514,1314,-
chr1,19670914,1.1704807808525184,694,486,1180,-
chr1,20978368,0.6120141265310923,1625,1106,2731,-
chr1,20978765,1.9372214770908147,994,796,1790,-
chr1,20978775,1.4957943925233643,581,534,1115,-
chr1,20978807,2.7460044681216704,550,528,1078,-
chr1,20978816,1.7942857142857143,784,489,1273,-
chr1,20978821,2.363109112286953,3445,2473,5918,-
chr1,20978822,2.3631091122869536,3445,2473,5918,-
chr1,20978823,0.6140538712949396,640,466,1106,-
chr1,20978917,0.8858696373553357,1957,1452,3409,-
chr1,20978960,0.4347511574074074,600,431,1031,-
chr1,20978991,0.2746558819355754,552,485,1037,-
chr1,20978992,1.8755102743924754,1802,1311,3113,-
chr1,20979348,1.6844357341172629,972,784,1756,-
chr1,20979427,1.5131956722394184,1983,1812,3795,-
chr1,20979434,1.1013589387115121,1891,1689,3580,-
chr1,20979450,1.8796441653584508,897,587,1484,-
chr1,20980250,0.5565293602103418,761,488,1249,-
chr1,20980752,2.645833333333333,888,559,1447,-
chr1,20981182,2.0991792929292927,810,659,1469,-
chr1,20981960,1.850314288394784,804,645,1449,-
chr1,20982001,1.70288638362517,925,757,1682,-
chr1,20982218,1.1232747662397535,2083,1457,3540,-
chr1,20982232,1.8246217511363738,1633,1061,2694,-
chr1,20982237,1.6900255754475704,589,424,1013,-
chr1,20982270,2.6652813852813853,961,549,1510,-
chr1,20982668,1.9581699346405228,748,611,1359,-
chr1,20987431,1.4454897360703811,1140,774,1914,-
chr1,20987460,0.6283093917053026,991,668,1659,-
chr1,20987750,1.5577849545720617,1520,943,2463,-
chr1,20987751,1.6111650283252097,1771,1128,2899,-
chr1,21069351,3.2946363421482734,689,529,1218,-
chr1,21069837,0.4706477732793522,619,415,1034,-
chr1,21069899,3.6776670817766703,610,437,1047,-
chr1,21069900,3.6776670817766703,610,437,1047,-
chr1,21070280,0.28514607405767,595,426,1021,-
chr1,21070285,2.0809456340941455,853,608,1461,-
chr1,21076358,2.934319218823651,959,660,1619,-
chr1,21083697,2.4461861079015645,680,448,1128,-
chr1,21097484,2.2232350680720243,629,481,1110,-
chr1,21100007,1.928395928395928,535,517,1052,-
chr1,21100009,1.6233116648008523,1030,909,1939,-
chr1,21106848,1.2397715007236871,628,537,1165,-
chr1,21133668,1.4208039350872383,697,604,1301,-
chr1,21133970,2.978723404255319,594,563,1157,-
chr1,21133971,2.978723404255319,594,563,1157,-
chr1,21143978,1.3670011776025386,705,422,1127,-
chr1,21143979,0.7442885297595585,725,465,1190,-
chr1,21186983,1.1091985994021853,2158,2001,4159,-
chr1,21186986,1.6813390313390315,813,779,1592,-
chr1,21186994,1.600053720118184,965,656,1621,-
chr1,21188738,2.915734888996921,946,725,1671,-
chr1,21188742,1.677595932090361,1724,1240,2964,-
chr1,21188744,1.7023025333761617,2446,1667,4113,-
chr1,21188747,1.6204379562043796,813,547,1360,-
chr1,21188751,1.848523748395379,1115,778,1893,-
chr1,21231460,2.563392012114329,2115,1760,3875,-
chr1,21268008,0.6359272697371803,1344,1002,2346,-
chr1,21268026,2.49041163828732,912,525,1437,-
chr1,21268027,1.6366373320981935,954,634,1588,-
chr1,21268074,2.1424302788844622,716,501,1217,-
chr1,21268086,1.9417140542850124,932,659,1591,-
chr1,21268559,2.4424326974047954,621,546,1167,-
chr1,21560055,1.8950576465436126,524,488,1012,-
chr1,21560111,1.9661524153757328,1144,710,1854,-
chr1,21571585,1.6038077930687813,986,702,1688,-
chr1,22021622,2.7482479502575736,712,467,1179,-
chr1,22056234,0.47112354567986026,1475,995,2470,-
chr1,22056236,0.485066778841098,1106,770,1876,-
chr1,22062968,3.630209897001163,1001,694,1695,-
chr1,23636932,1.5276634659350707,1027,728,1755,-
chr1,23637080,1.7827785591498673,712,473,1185,-
chr1,23637086,2.0431372549019606,520,492,1012,-
chr1,23637104,0.5000774161583006,768,750,1518,-
chr1,23637105,1.1366919403145188,1202,1062,2264,-
chr1,23637148,4.576946465453375,787,762,1549,-
chr1,23637149,3.0126136242188335,944,800,1744,-
chr1,23637291,10.092114695340502,760,371,1131,-
chr1,23637292,18.697235467726895,1743,1047,2790,-
chr1,23637293,18.697235467726895,1743,1047,2790,-
chr1,23637324,11.02451910508429,984,379,1363,-
chr1,23637477,3.514501610649957,2962,2225,5187,-
chr1,23637479,1.851119058606368,1125,787,1912,-
chr1,23637480,3.314135021097046,682,394,1076,-
chr1,23640051,2.134134134134134,1065,998,2063,-
chr1,23644990,0.6115046244078501,1003,805,1808,-
chr1,23645002,2.2303902993558165,980,811,1791,-
chr1,23645003,1.6022597379759076,984,668,1652,-
chr1,23645054,0.5132013201320133,621,403,1024,-
chr1,23645083,1.8942857142857144,883,549,1432,-
chr1,23648098,1.6047061092627415,831,668,1499,-
chr1,23648124,2.804395604395604,811,636,1447,-
chr1,23648129,1.7193930041152263,763,575,1338,-
chr1,23648142,1.6377240143369176,1118,743,1861,-
chr1,23648145,1.853567251461988,565,449,1014,-
chr1,23650064,2.426177536231884,973,575,1548,-
chr1,23665078,0.746117568597561,894,655,1549,-
chr1,23665088,2.013178294573643,741,515,1256,-
chr1,23670708,1.5554436625519756,850,596,1446,-
chr1,23724081,2.6127649236421666,591,416,1007,-
chr1,23724090,3.3127501157344525,614,466,1080,-
chr1,24123261,1.1103678929765886,663,459,1122,-
chr1,24123263,1.1103678929765886,663,459,1122,-
chr1,24123611,2.15214446952596,680,442,1122,-
chr1,24123612,2.15214446952596,680,442,1122,-
chr1,24124651,2.335662685991864,1839,1313,3152,-
chr1,24124661,1.4822558220775888,1766,1070,2836,-
chr1,24124672,0.4128073483537225,720,469,1189,-
chr1,24125159,2.9982740712912426,731,492,1223,-
chr1,24125160,2.5028276628659447,738,540,1278,-
chr1,24298084,1.7355769230769231,721,415,1136,-
chr1,24298361,1.7703892493049118,848,497,1345,-
chr1,24298370,3.087728937728938,732,389,1121,-
chr1,24298372,3.087728937728938,732,389,1121,-
chr1,24301466,0.544211256066049,784,386,1170,-
chr1,24301467,0.3506424925189227,663,436,1099,-
chr1,24305224,2.2020408163265306,1078,881,1959,-
chr1,24305242,2.892430278884462,791,501,1292,-
chr1,24305243,2.892430278884462,791,501,1292,-
chr1,24305247,1.364842454394693,822,602,1424,-
chr1,24305266,0.4166042309346113,658,419,1077,-
chr1,25554644,2.480621297325075,1309,1091,2400,-
chr1,25554645,2.3449093444909344,781,716,1497,-
chr1,25554697,2.138465952176374,2175,1642,3817,-
chr1,25572983,2.1555555555555554,775,607,1382,-
chr1,25572985,2.1555555555555554,775,607,1382,-
chr1,26227374,1.2997700648760486,3738,2965,6703,-
chr1,26227406,1.481309650053022,2234,1747,3981,-
chr1,26227545,1.418240257131378,3176,1964,5140,-
chr1,26228030,1.920913461538461,3049,2599,5648,-
chr1,26228075,1.460049872474376,3421,2378,5799,-
chr1,26230144,1.5371696997819715,3405,2578,5983,-
chr1,26230156,0.7362089275420437,3091,2346,5437,-
chr1,26230235,1.7043573774687542,2250,1378,3628,-
chr1,26231200,0.622568093385214,899,770,1669,-
chr1,26231219,0.4592894655491978,1298,1269,2567,-
chr1,26231220,1.072527208114311,1466,1038,2504,-
chr1,26231221,1.072527208114311,1466,1038,2504,-
chr1,26231227,1.6470695970695972,528,519,1047,-
chr1,26232897,0.7292893750478084,1134,768,1902,-
chr1,26232898,0.6707669896792905,1400,1034,2434,-
chr1,26232899,0.6953950367562911,1364,937,2301,-
chr1,27731067,4.274945816283112,1881,1310,3191,-
chr1,27731068,4.379537553027847,1720,1172,2892,-
chr1,27731069,3.740676993689042,814,497,1311,-
chr1,27734326,2.6363843699890945,684,551,1235,-
chr1,28218182,1.766273481869812,621,435,1056,-
chr1,28218446,30.25813484588657,1612,1216,2828,-
chr1,28218598,2.3294983416252077,724,535,1259,-
chr1,28218600,2.317818889970789,1081,789,1870,-
chr1,28218601,2.314635718891038,717,516,1233,-
chr1,28220873,2.808605919003115,576,427,1003,-
chr1,28220875,2.808605919003115,576,427,1003,-
chr1,28223610,2.0429624208854427,958,644,1602,-
chr1,28224206,2.4469798352661094,646,372,1018,-
chr1,28240968,3.309933005807141,1023,786,1809,-
chr1,28527139,0.5165525795082372,1616,1236,2852,-
chr1,28527739,1.7357915831663324,801,498,1299,-
chr1,28527809,2.13228794601574,1104,846,1950,-
chr1,28530269,0.524707055597108,618,572,1190,-
chr1,28531840,3.608058608058608,590,454,1044,-
chr1,28531844,2.8969727047146407,1080,774,1854,-
chr1,28531845,2.8969727047146407,1080,774,1854,-
chr1,28536534,2.243795620437956,847,547,1394,-
chr1,28555526,1.595628192698304,8847,7170,16017,-
chr1,28555528,1.5302345903856942,17138,13193,30331,-
chr1,28555529,1.4737126260244,12100,9705,21805,-
chr1,28555531,1.4455640859587249,6711,5981,12692,-
chr1,28555532,1.3960803603790193,3594,3381,6975,-
chr1,28555534,1.4579185520361992,1799,1699,3498,-
chr1,28559448,1.3322551952777553,1372,893,2265,-
chr1,28559449,1.3837621283255086,2111,1774,3885,-
chr1,28559450,1.3837621283255086,2111,1774,3885,-
chr1,28559453,0.9116819947836817,3438,2417,5855,-
chr1,28559454,0.9748152527342597,1498,1193,2691,-
chr1,28559455,0.9985255570117957,2414,1763,4177,-
chr1,28559456,1.1898620612313555,2121,1686,3807,-
chr1,28559457,0.500670266957754,1375,966,2341,-
chr1,28559458,1.5724533715925393,1917,1516,3433,-
chr1,28559459,0.9255940571445568,3184,2357,5541,-
chr1,28559460,0.5312410020155486,1229,905,2134,-
chr1,28559510,1.7095406212278763,882,622,1504,-
chr1,28559534,1.4642887950625232,757,527,1284,-
chr1,28905329,0.7819491892086934,8845,7905,16750,-
chr1,28905330,0.7819491892086933,8845,7905,16750,-
chr1,28905331,0.9418800326986881,1696,1517,3213,-
chr1,29309155,0.8120746920348599,16775,14252,31027,-
chr1,29309156,1.0025505493191267,10993,8588,19581,-
chr1,31405834,4.1599325657233415,680,451,1131,-
chr1,31405836,3.198240759889667,889,564,1453,-
chr1,31744314,1.0238431780984971,1100,610,1710,-
chr1,31744315,1.0238431780984971,1100,610,1710,-
chr1,31754327,1.949151951457427,825,618,1443,-
chr1,31764827,3.563493051732745,724,544,1268,-
chr1,32372550,2.553485647334505,640,568,1208,-
chr1,32372552,2.553485647334505,640,568,1208,-
chr1,32372666,1.3257488845756158,635,419,1054,-
chr1,32377361,1.719141703845337,866,522,1388,-
chr1,32381578,0.8091703395246634,1118,745,1863,-
chr1,32384713,0.4012929485041403,612,429,1041,-
chr1,32384714,1.174825174825175,587,428,1015,-
chr1,32384720,4.55890917977743,714,462,1176,-
chr1,32385232,2.7183273117675197,819,578,1397,-
chr1,32385234,2.476190476190476,636,440,1076,-
chr1,32799688,0.8448908634344215,728,667,1395,-
chr1,32799689,0.8448908634344215,728,667,1395,-
chr1,32799701,0.4215389784946237,578,495,1073,-
chr1,32799702,0.4215389784946237,578,495,1073,-
chr1,32799993,0.9150353773584904,738,529,1267,-
chr1,32799995,0.9150353773584904,738,529,1267,-
chr1,32800207,1.122127941665245,809,614,1423,-
chr1,32800208,1.122127941665245,809,614,1423,-
chr1,32800442,3.002967359050445,791,336,1127,-
chr1,32800516,0.4469631308753917,837,282,1119,-
chr1,32800680,1.1540019813414593,653,459,1112,-
chr1,32830951,3.94434593493417,634,556,1190,-
chr1,32830952,3.94434593493417,634,556,1190,-
chr1,33240983,2.3337279513954017,1493,1141,2634,-
chr1,33240984,2.6499740259740254,980,769,1749,-
chr1,33241172,2.4834704079987096,615,476,1091,-
chr1,33241177,2.897658122810253,581,492,1073,-
chr1,33241179,1.8391812865497077,628,503,1131,-
chr1,33241308,1.4187349173725194,1013,800,1813,-
chr1,33241419,2.727466250689332,988,831,1819,-
chr1,33241506,6.929684210526316,632,474,1106,-
chr1,33241559,3.5388026607538805,683,491,1174,-
chr1,33241562,0.1789858806919956,2751,1825,4576,-
chr1,33241610,1.8492974330905365,1555,1084,2639,-
chr1,33241611,0.4954492072812683,674,523,1197,-
chr1,33241613,0.3063917290226766,595,426,1021,-
chr1,33245014,1.6448878834753458,1487,972,2459,-
chr1,33245027,2.221298308608145,652,556,1208,-
chr1,33245040,1.8348794355484024,1300,1054,2354,-
chr1,33245043,1.3744694613155886,1185,914,2099,-
chr1,33245816,3.0712468193384224,709,654,1363,-
chr1,33245828,2.100796930342385,729,615,1344,-
chr1,33245847,1.5187699011228424,724,662,1386,-
chr1,33246669,1.8612449799196784,712,497,1209,-
chr1,33246714,1.7254172095043117,817,596,1413,-
chr1,33246720,2.489795918367347,609,454,1063,-
chr1,33246721,1.8241820246559894,1485,1037,2522,-
chr1,33248070,2.3135326831627308,735,652,1387,-
chr1,33248134,1.8525092224511552,1441,1150,2591,-
chr1,33248137,2.457944926604521,739,548,1287,-
chr1,33252024,1.7712737127371274,773,614,1387,-
chr1,33252041,3.117633570282046,823,622,1445,-
chr1,33256792,1.5348692403486923,985,875,1860,-
chr1,33263421,2.201906707524685,891,533,1424,-
chr1,33272098,1.7994695263450395,1258,1025,2283,-
chr1,33272099,0.9742370703501444,1337,848,2185,-
chr1,33272101,0.9742370703501444,1337,848,2185,-
chr1,33276278,0.6519736842105264,990,759,1749,-
chr1,33276301,1.5640336134453783,845,699,1544,-
chr1,33276324,0.6224873557255869,799,700,1499,-
chr1,33276331,2.0379979035639413,706,635,1341,-
chr1,33276542,1.6116463363134943,1197,981,2178,-
chr1,33282816,1.0414814814814817,987,701,1688,-
chr1,33282818,1.0414814814814817,987,701,1688,-
chr1,33282837,7.688120220925986,2234,1886,4120,-
chr1,33282838,7.688120220925986,2234,1886,4120,-
chr1,33282854,9.49465264882023,1566,922,2488,-
chr1,33282855,8.9236657852248,1557,839,2396,-
chr1,33475083,2.2482993144506964,819,577,1396,-
chr1,33475325,3.948141520087712,709,581,1290,-
chr1,33475835,3.1705428558302677,3113,2282,5395,-
chr1,33475836,2.78240415507451,5178,3433,8611,-
chr1,33475837,2.827899698752401,6575,4453,11028,-
chr1,33475840,3.8141809290953543,675,408,1083,-
chr1,33475953,1.6609063530761508,1102,733,1835,-
chr1,33476002,0.8159466614379404,3092,2145,5237,-
chr1,33476010,1.687433753385938,1591,1212,2803,-
chr1,33476011,1.687433753385938,1591,1212,2803,-
chr1,33476025,3.585500394011032,699,422,1121,-
chr1,33476031,1.127095384553514,1209,740,1949,-
chr1,33476036,1.0230176140226988,1114,730,1844,-
chr1,33476176,5.076795698189399,3211,2426,5637,-
chr1,33476203,2.6466165413533838,703,474,1177,-
chr1,33476274,0.635132382892057,890,981,1871,-
chr1,33476284,0.44861227922624053,634,724,1358,-
chr1,33476293,0.2755741127348643,483,957,1440,-
chr1,33476294,0.5302663438256658,1313,1533,2846,-
chr1,33476296,0.42903550270371915,4059,6317,10376,-
chr1,33476297,0.4456809516925794,3538,5509,9047,-
chr1,33476298,0.44452196927814014,4025,6049,10074,-
chr1,33476299,0.519738722670415,2135,2730,4865,-
chr1,33476301,1.2388792627181442,2037,3178,5215,-
chr1,33476302,4.9041252052549735,3727,6064,9791,-
chr1,33476304,10.16864656196422,5798,7750,13548,-
chr1,33476305,15.152983060582994,4293,5218,9511,-
chr1,33476306,15.152983060582994,4293,5218,9511,-
chr1,33476311,3.022070795145257,1938,1010,2948,-
chr1,33476313,6.00563629972162,4007,1844,5851,-
chr1,33476314,7.872156505914467,1572,470,2042,-
chr1,33476315,9.312751655488274,4329,1729,6058,-
chr1,33476316,16.285942033556793,3389,1183,4572,-
chr1,33476318,7.311015418808168,1547,312,1859,-
chr1,33476319,6.42641820557424,3480,806,4286,-
chr1,33476320,6.589428699678053,2809,651,3460,-
chr1,33476321,6.382604003006792,2656,645,3301,-
chr1,33476323,6.355759964377985,1034,207,1241,-
chr1,33478712,0.604223602484472,767,574,1341,-
chr1,33478860,1.2455276775433626,1988,1568,3556,-
chr1,33478970,4.009752355906202,988,701,1689,-
chr1,33480128,1.6841357885944122,3351,2042,5393,-
chr1,33480129,1.8812545653761867,1851,1183,3034,-
chr1,33480140,2.0018260075648886,1278,696,1974,-
chr1,33486988,2.9448,817,499,1316,-
chr1,33487012,2.2513562386980106,829,473,1302,-
chr1,33487199,1.7475328947368425,1124,863,1987,-
chr1,33487247,0.590550305725403,663,513,1176,-
chr1,33487266,1.040160642570281,776,497,1273,-
chr1,33487268,1.040160642570281,776,497,1273,-
chr1,33502346,1.101917255297679,1175,990,2165,-
chr1,33502348,1.3031375217658288,1959,1465,3424,-
chr1,33502441,1.2042895331741588,571,450,1021,-
chr1,33502442,1.0698056801195814,841,445,1286,-
chr1,33502443,1.0698056801195814,841,445,1286,-
chr1,33502448,0.5053651756595061,875,574,1449,-
chr1,35649380,4.883762777457914,1041,715,1756,-
chr1,35650092,0.3965365541513357,660,657,1317,-
chr1,35650095,0.9757776176785702,1089,1203,2292,-
chr1,35650097,1.2843228200371055,638,783,1421,-
chr1,35650112,0.4386206896551724,529,874,1403,-
chr1,35650113,0.4386206896551724,529,874,1403,-
chr1,35650136,0.4527223415272796,568,721,1289,-
chr1,35650143,9.251674206018334,989,1319,2308,-
chr1,35650149,2.439645789643462,966,1095,2061,-
chr1,35650152,6.149071777704602,1670,1598,3268,-
chr1,35650153,5.705922439824695,1454,1331,2785,-
chr1,35650160,20.58665648089883,2925,1683,4608,-
chr1,35650161,20.58665648089883,2925,1683,4608,-
chr1,35650162,20.58665648089883,2925,1683,4608,-
chr1,35653603,2.065931822820984,697,425,1122,-
chr1,35654627,1.8057240669788563,2452,1565,4017,-
chr1,35654669,0.2847462968799243,1389,834,2223,-
chr1,35654833,1.978915389236041,9246,6088,15334,-
chr1,35654859,1.5680267646287065,3156,2071,5227,-
chr1,35654863,1.4413954038542867,7947,4625,12572,-
chr1,35654864,1.7981558872910433,5398,3191,8589,-
chr1,35654867,1.3820397369925674,2209,1271,3480,-
chr1,35654871,1.8196256418513095,4174,2335,6509,-
chr1,35654873,0.5791784113488285,2088,1291,3379,-
chr1,35654878,1.4128801017458663,1832,960,2792,-
chr1,35654930,2.0482717245835067,1167,698,1865,-
chr1,35656132,1.792449139280125,832,567,1399,-
chr1,35656382,0.6864934937143944,1943,1293,3236,-
chr1,35657046,1.8147723063191608,1313,1043,2356,-
chr1,35657091,1.646017699115044,650,451,1101,-
chr1,35657841,2.6329790909756516,628,443,1071,-
chr1,36068083,2.7672397985839203,637,481,1118,-
chr1,36074947,1.5978881278538812,1017,583,1600,-
chr1,36074949,0.4927381134383121,585,421,1006,-
chr1,36074995,1.7681159420289851,731,551,1282,-
chr1,36106966,1.735206611570248,723,549,1272,-
chr1,36107010,1.4560851318944843,579,555,1134,-
chr1,36107016,3.108974358974359,775,467,1242,-
chr1,36107022,2.0780769986905905,1238,868,2106,-
chr1,36602282,0.0558990848379915,451,621,1072,-
chr1,36602284,0.0558990848379915,451,621,1072,-
chr1,36602309,0.17245662069790763,522,667,1189,-
chr1,36602369,3.5914997524209564,1245,2259,3504,-
chr1,36602370,3.4231343283582087,890,1339,2229,-
chr1,36602371,4.536845730027548,1084,1451,2535,-
chr1,36602372,19.789770092759834,2564,2553,5117,-
chr1,36602373,24.935728863185386,2500,2262,4762,-
chr1,36602374,29.459654782082456,2286,1949,4235,-
chr1,36602379,16.907029052995025,1160,164,1324,-
chr1,36602380,19.437494641581328,1177,149,1326,-
chr1,36603400,3.2157141591418648,834,586,1420,-
chr1,36603539,2.1802426343154244,850,576,1426,-
chr1,36603540,2.1802426343154244,850,576,1426,-
chr1,36921489,1.8473555430077169,754,692,1446,-
chr1,36921818,1.9889328063241103,739,574,1313,-
chr1,36921921,1.7996207332490517,948,790,1738,-
chr1,36921933,1.998999356729326,1215,822,2037,-
chr1,36921934,1.6738963320887326,870,627,1497,-
chr1,36926877,1.692402624766721,864,790,1654,-
chr1,36927709,1.6000119524293313,652,576,1228,-
chr1,36927745,1.993147751605996,536,466,1002,-
chr1,36927748,2.1642679468409787,1691,1233,2924,-
chr1,36927759,2.786445848768795,672,352,1024,-
chr1,36929427,1.7944444444444445,679,359,1038,-
chr1,36929883,1.9544752770536569,949,634,1583,-
chr1,36929885,0.8244704620609528,1024,667,1691,-
chr1,36929887,0.8211992662233433,954,622,1576,-
chr1,36929889,1.0201704167221408,612,405,1017,-
chr1,38033312,1.913312693498452,617,398,1015,-
chr1,38033908,2.2707612456747404,1364,883,2247,-
chr1,38033934,2.057021103896104,980,527,1507,-
chr1,38034558,1.7411990688449641,735,449,1184,-
chr1,38034559,0.3821570778684148,730,475,1205,-
chr1,38048417,4.315115447226761,692,469,1161,-
chr1,38049507,2.434375,873,735,1608,-
chr1,38049508,2.125,1291,1071,2362,-
chr1,38049510,2.111262078519602,1069,895,1964,-
chr1,38052931,1.9729914529914527,795,449,1244,-
chr1,38052970,0.5099059435661396,727,525,1252,-
chr1,38061409,2.9108882489748176,735,666,1401,-
chr1,38152110,2.572091397663714,780,511,1291,-
chr1,38152111,3.4286145493203737,604,409,1013,-
chr1,38269040,1.7327955137980224,926,700,1626,-
chr1,38269043,1.423694429954211,846,638,1484,-
chr1,38269073,2.735595045772752,1142,618,1760,-
chr1,38269075,2.5217622215918647,1629,943,2572,-
chr1,38269091,2.493524730847246,760,492,1252,-
chr1,38269093,2.493524730847246,760,492,1252,-
chr1,38269095,1.8247150213658425,701,456,1157,-
chr1,38269098,2.527134146341464,613,409,1022,-
chr1,38269100,2.527134146341464,613,409,1022,-
chr1,38269353,3.545954045954046,686,461,1147,-
chr1,38269355,3.545954045954046,686,461,1147,-
chr1,38423002,3.8627509168649556,581,844,1425,-
chr1,38423878,1.0823888231460725,1369,1019,2388,-
chr1,38425832,1.1181220780069965,1199,837,2036,-
chr1,38425833,1.1181220780069965,1199,837,2036,-
chr1,38433800,2.067318891218262,709,476,1185,-
chr1,38444697,1.2450299524453012,731,581,1312,-
chr1,38447472,1.249790772853083,1901,1356,3257,-
chr1,38449894,2.124113475177305,598,422,1020,-
chr1,39304788,2.338725720119192,757,543,1300,-
chr1,39332644,2.805771365149833,631,423,1054,-
chr1,39332645,2.805771365149833,631,423,1054,-
chr1,40036941,0.40304083814122205,627,501,1128,-
chr1,40038237,2.837907119770248,704,398,1102,-
chr1,40041622,2.527472527472528,229,870,1099,-
chr1,40041623,2.527472527472528,229,870,1099,-
chr1,40539077,1.755883298218048,893,682,1575,-
chr1,40539092,1.7575718849840252,808,625,1433,-
chr1,40539181,1.5173252279635256,935,657,1592,-
chr1,40539272,1.5476917895048934,1777,1293,3070,-
chr1,40539349,2.6441025641025644,1288,824,2112,-
chr1,40539485,0.69428146632348,1315,880,2195,-
chr1,40539577,1.567471533554066,1293,853,2146,-
chr1,40539608,1.3995438788542236,970,782,1752,-
chr1,40539625,1.7714711359404098,1033,894,1927,-
chr1,40539641,1.836613349711163,1825,1538,3363,-
chr1,40539642,1.9259800351958278,2607,2128,4735,-
chr1,40539733,2.2648401826484017,650,510,1160,-
chr1,40539764,2.137043111504694,1022,828,1850,-
chr1,40539835,2.149932738168032,585,480,1065,-
chr1,40542521,2.2141086319585304,613,492,1105,-
chr1,40546080,1.8598031173092702,686,529,1215,-
chr1,40546135,1.7253954305799648,713,568,1281,-
chr1,40555092,1.8800764452938368,786,482,1268,-
chr1,40555096,1.121443502410888,1362,1008,2370,-
chr1,40557031,2.0249593054801958,621,387,1008,-
chr1,40557752,0.2014652014652015,769,636,1405,-
chr1,40557806,3.0404085257548847,834,562,1396,-
chr1,40557813,1.918585251918585,1149,665,1814,-
chr1,40558136,1.5194395256639845,2303,1704,4007,-
chr1,40558137,0.5819007686932216,1513,1059,2572,-
chr1,40558139,0.5819007686932216,1513,1059,2572,-
chr1,40558164,1.5368733153638814,662,529,1191,-
chr1,40558170,2.2665803108808293,672,385,1057,-
chr1,40558177,1.8799091109345907,1117,734,1851,-
chr1,40562868,2.899988749632862,807,450,1257,-
chr1,43221241,1.0948722864762537,1319,847,2166,-
chr1,43221244,0.45445736434108536,937,687,1624,-
chr1,43221246,0.42400333496726156,2247,1558,3805,-
chr1,43221247,0.38245799303870887,1745,1193,2938,-
chr1,43221250,0.3890041493775933,699,481,1180,-
chr1,43221251,0.3890041493775933,699,481,1180,-
chr1,43392002,3.0093896713615025,640,425,1065,-
chr1,43392051,1.5317410061371326,911,700,1611,-
chr1,43392052,2.3666207919875566,926,689,1615,-
chr1,43392100,5.595351798790194,702,348,1050,-
chr1,43392101,7.5745282823819275,1462,830,2292,-
chr1,43392105,2.816649466804265,711,305,1016,-
chr1,43392106,2.995818198637912,998,461,1459,-
chr1,43392153,1.5491276864728194,900,564,1464,-
chr1,43392155,0.6145266232903996,1156,442,1598,-
chr1,43392163,0.5878136200716846,655,371,1026,-
chr1,43392166,0.4211940647271878,720,316,1036,-
chr1,43392170,0.3689966333050866,1400,928,2328,-
chr1,43392171,0.4312971342383107,1805,1223,3028,-
chr1,43392172,0.4312971342383107,1805,1223,3028,-
chr1,43392173,0.46567020250723234,1316,914,2230,-
chr1,43392175,0.5192067537619932,956,585,1541,-
chr1,43392179,0.43616996658266555,808,596,1404,-
chr1,43392667,1.069298245614035,688,389,1077,-
chr1,43392669,1.069298245614035,688,389,1077,-
chr1,43394632,2.7615877080665814,673,354,1027,-
chr1,43394633,2.7615877080665814,673,354,1027,-
chr1,43395446,0.6405948960621937,823,484,1307,-
chr1,43395450,2.560981781376518,697,415,1112,-
chr1,43395684,1.5666517499401595,656,457,1113,-
chr1,43395686,1.653525046382189,774,489,1263,-
chr1,43395687,4.9783365570599605,756,469,1225,-
chr1,43630326,1.999609328556746,2120,1484,3604,-
chr1,43630375,1.9083603896103896,921,615,1536,-
chr1,43630381,2.4025930851063837,1313,939,2252,-
chr1,43630382,2.4025930851063837,1313,939,2252,-
chr1,43630423,1.4180198041414205,1392,952,2344,-
chr1,43630443,1.7275113122171946,706,441,1147,-
chr1,43630463,1.790877192982456,695,512,1207,-
chr1,43632552,1.5593123961158253,1397,993,2390,-
chr1,43632553,2.20895701472838,1051,900,1951,-
chr1,43632845,0.6116756917142646,1063,883,1946,-
chr1,43632856,2.708668752935401,1584,1293,2877,-
chr1,43634623,1.7790697674418603,815,515,1330,-
chr1,43636493,1.9497709923664117,773,523,1296,-
chr1,43637194,0.8728327892636923,1023,918,1941,-
chr1,43637195,0.8728327892636923,1023,918,1941,-
chr1,43637298,1.4873914840843323,770,530,1300,-
chr1,43637311,0.6257885321532813,632,558,1190,-
chr1,43637739,1.8668035792870763,605,400,1005,-
chr1,43829133,31.535187696218266,999,1141,2140,-
chr1,43829134,36.3592095972798,726,612,1338,-
chr1,43829325,0.6596768336964416,558,458,1016,-
chr1,43850620,0.46483812187473506,1512,1025,2537,-
chr1,43850621,0.46483812187473506,1512,1025,2537,-
chr1,43850660,1.687140728124335,586,426,1012,-
chr1,43852575,1.6995677000482146,977,765,1742,-
chr1,43853176,1.5049019607843137,613,491,1104,-
chr1,43853246,1.021008403361345,1133,832,1965,-
chr1,43853247,1.2270080101089562,1622,1139,2761,-
chr1,43854039,1.1493241183910095,803,611,1414,-
chr1,44687302,0.7098189728810613,1205,921,2126,-
chr1,44687303,1.0566666666666666,633,524,1157,-
chr1,44774038,2.58730986603444,746,538,1284,-
chr1,44804771,0.25381085411550924,625,492,1117,-
chr1,45341320,1.884529081783289,1797,1128,2925,-
chr1,45341321,1.884529081783289,1797,1128,2925,-
chr1,45341322,1.9847852643076411,2230,1437,3667,-
chr1,45341325,2.4199162306254896,681,495,1176,-
chr1,45341334,1.53861800165983,1272,943,2215,-
chr1,45341335,1.1325757575757571,896,695,1591,-
chr1,45976904,1.4153283561555874,9081,7262,16343,-
chr1,45980550,1.3146693959488887,18072,13009,31081,-
chr1,45980652,1.5141971605071411,20898,16155,37053,-
chr1,45980653,1.5141971605071411,20898,16155,37053,-
chr1,45981330,1.2325214152319925,23543,16147,39690,-
chr1,45984634,1.3112767940354149,6236,4883,11119,-
chr1,45984703,1.228182624113475,4468,3524,7992,-
chr1,45984720,1.3128057738527097,14719,10581,25300,-
chr1,45987525,1.6619448397176912,1470,1282,2752,-
chr1,45987526,0.7760176378735183,1880,1543,3423,-
chr1,45987529,1.375051842840158,5464,3064,8528,-
chr1,45987530,1.375051842840158,5464,3064,8528,-
chr1,45987543,1.9525304945664226,6170,3005,9175,-
chr1,45987544,1.753606491685033,8078,3863,11941,-
chr1,45987545,1.7079868062027137,10242,5673,15915,-
chr1,45987546,1.5970947090780716,11118,6467,17585,-
chr1,45987547,1.330004076640848,4349,2675,7024,-
chr1,45987549,1.542364620172075,7955,4419,12374,-
chr1,45987550,1.632821282482217,6871,3254,10125,-
chr1,45987552,2.201583655705996,2697,1033,3730,-
chr1,45987555,0.7876089343177861,1635,757,2392,-
chr1,45988473,0.6903454233233896,2736,1991,4727,-
chr1,45988492,1.4886383559283716,3580,2666,6246,-
chr1,45988523,1.0864584530880756,2608,1274,3882,-
chr1,45988524,1.085227978414672,7329,4723,12052,-
chr1,45988525,0.9709988508799602,8356,5201,13557,-
chr1,45988526,0.975687407916823,3804,2239,6043,-
chr1,45988527,1.2023306231377244,3962,2587,6549,-
chr1,46093601,1.451129046563193,559,466,1025,-
chr1,46093603,0.6766236705136909,597,490,1087,-
chr1,46099226,1.2037692472000636,641,518,1159,-
chr1,46099243,1.4395442946003851,905,680,1585,-
chr1,46120311,2.667445904339846,991,630,1621,-
chr1,46120312,2.913107802215622,681,402,1083,-
chr1,46126774,2.014939020656121,591,447,1038,-
chr1,46654457,1.841696959849868,698,551,1249,-
chr1,46660300,1.4001868576767362,561,493,1054,-
chr1,46660301,1.4001868576767362,561,493,1054,-
chr1,47108920,2.121747030262294,760,418,1178,-
chr1,50907157,3.58965595807701,684,398,1082,-
chr1,50907159,3.58965595807701,684,398,1082,-
chr1,51032771,1.3066229171506056,765,591,1356,-
chr1,51048299,1.4838961038961038,627,388,1015,-
chr1,51253763,1.12577287109872,675,487,1162,-
chr1,51253831,2.137236292140284,533,479,1012,-
chr1,51253840,0.9508794508794509,805,517,1322,-
chr1,51253841,0.9508794508794509,805,517,1322,-
chr1,51826859,2.047324990436636,891,630,1521,-
chr1,51826860,2.047324990436636,891,630,1521,-
chr1,51829619,2.315526315789474,1256,949,2205,-
chr1,51829621,2.315526315789474,1256,949,2205,-
chr1,51829688,0.30548409343153143,849,552,1401,-
chr1,51829689,0.30548409343153143,849,552,1401,-
chr1,52257266,3.202769174713062,585,498,1083,-
chr1,52257268,2.01902001270648,996,786,1782,-
chr1,52257269,2.01902001270648,996,786,1782,-
chr1,52281985,2.6831342598112355,730,509,1239,-
chr1,52299808,0.534240530269605,766,597,1363,-
chr1,52343977,2.1882121469831697,639,462,1101,-
chr1,52489209,3.155348716662871,840,710,1550,-
chr1,52507224,1.1341210119513774,756,682,1438,-
chr1,52507226,1.4215326686269416,1275,1026,2301,-
chr1,52520686,2.2171210468920397,1505,916,2421,-
chr1,52520687,2.2171210468920397,1505,916,2421,-
chr1,52520706,1.8670702179176755,700,412,1112,-
chr1,52520724,2.716056410521384,875,494,1369,-
chr1,52520736,1.9351017402900332,1105,570,1675,-
chr1,52520738,2.523711340206185,815,387,1202,-
chr1,52520777,1.3117368804067144,717,432,1149,-
chr1,52859241,1.7110574223095334,1301,918,2219,-
chr1,52859248,2.0386258124419685,997,717,1714,-
chr1,52859250,1.8543000832213206,1763,1239,3002,-
chr1,52859251,2.159806055808431,948,651,1599,-
chr1,53152850,1.5991189427312773,571,453,1024,-
chr1,53237865,0.7121958147902661,2148,1431,3579,-
chr1,53237866,0.7121958147902661,2148,1431,3579,-
chr1,53692654,7.993079584775087,461,577,1038,-
chr1,53692680,21.360642454995745,4756,3994,8750,-
chr1,53692681,22.606532066537003,5249,4046,9295,-
chr1,53692682,29.051272129259797,3035,1909,4944,-
chr1,53692683,42.93564006859679,1482,430,1912,-
chr1,53692685,19.853211009174316,1081,108,1189,-
chr1,53692686,19.853211009174316,1081,108,1189,-
chr1,53692687,14.963322270080473,1590,162,1752,-
chr1,53692717,0.2557147059437586,926,331,1257,-
chr1,53701273,1.832317073170732,600,409,1009,-
chr1,53701303,1.64203125,677,511,1188,-
chr1,53704052,0.3620834972186323,536,480,1016,-
chr1,53704167,0.5325564382545203,661,574,1235,-
chr1,53711309,2.5866046150796826,626,468,1094,-
chr1,53732200,4.60079365079365,526,539,1065,-
chr1,53732248,1.0883273530371746,546,462,1008,-
chr1,54238125,1.9994902854108731,827,508,1335,-
chr1,54252854,0.1690857297883884,830,387,1217,-
chr1,54252855,0.2556085314169891,964,602,1566,-
chr1,54252856,0.23899401001638826,3491,2110,5601,-
chr1,54252857,0.2264943262452606,3058,1913,4971,-
chr1,54252858,0.1462987005781373,823,588,1411,-
chr1,54262592,2.020998288689319,708,534,1242,-
chr1,54395739,1.3689462093785751,11292,8386,19678,-
chr1,54395743,2.042581145464892,4136,3381,7517,-
chr1,54395748,1.9602382174403428,7476,5441,12917,-
chr1,54395749,1.9602382174403428,7476,5441,12917,-
chr1,54395776,1.5608854871168882,2956,1782,4738,-
chr1,54395805,1.473022768705636,1615,888,2503,-
chr1,54405666,2.0499449307540942,3470,2008,5478,-
chr1,54405669,1.8507409759496858,2082,1118,3200,-
chr1,54405688,1.7978033436844698,3302,1780,5082,-
chr1,54405689,1.7978033436844698,3302,1780,5082,-
chr1,54405695,0.2461557539682539,793,383,1176,-
chr1,54405708,0.460153452685422,691,390,1081,-
chr1,54405737,0.4455368830966446,1327,820,2147,-
chr1,54405759,1.60427807486631,719,509,1228,-
chr1,54411246,0.4281813173195629,625,505,1130,-
chr1,54506442,1.507648725212465,886,705,1591,-
chr1,54506445,2.212075088787417,871,656,1527,-
chr1,54509180,1.5095720720720722,765,575,1340,-
chr1,54513043,0.6084832979620316,909,648,1557,-
chr1,54518703,1.822881355932204,716,471,1187,-
chr1,54518865,2.273578595317726,823,459,1282,-
chr1,54518866,1.7603030066821868,1273,912,2185,-
chr1,54518873,0.6928509340133255,1219,826,2045,-
chr1,55315476,11.013784478809697,1942,1582,3524,-
chr1,55315481,10.811688311688311,1220,604,1824,-
chr1,55315482,12.549588782216,2585,1579,4164,-
chr1,55315488,2.916287483535064,1440,826,2266,-
chr1,55315616,2.2307187756639015,848,726,1574,-
chr1,55315657,1.0287698412698412,1036,719,1755,-
chr1,55315658,1.0287698412698412,1036,719,1755,-
chr1,55315771,0.5059646236116825,614,441,1055,-
chr1,55315781,1.8187438984705504,620,438,1058,-
chr1,55316040,2.557077625570776,839,510,1349,-
chr1,55316083,1.6527093596059113,670,376,1046,-
chr1,55316301,1.8376934414148853,664,471,1135,-
chr1,55316307,0.9166087976153569,1676,1224,2900,-
chr1,55316308,0.512713205439164,1783,1327,3110,-
chr1,55316345,2.024859579779488,720,505,1225,-
chr1,55316424,1.2451112286104713,1791,1395,3186,-
chr1,55316425,1.0174701016151466,1685,1263,2948,-
chr1,55316665,1.7423459244532804,625,502,1127,-
chr1,55316968,6.989168852739715,1263,892,2155,-
chr1,55317277,1.5478915662650603,570,497,1067,-
chr1,55317599,2.306034482758621,641,463,1104,-
chr1,55317727,3.0206671221406767,1044,713,1757,-
chr1,55317728,3.400037369207773,586,445,1031,-
chr1,55319722,0.6173456403586296,813,581,1394,-
chr1,55319724,1.2127796340570791,759,577,1336,-
chr1,55337111,2.2477364185110664,661,496,1157,-
chr1,55337113,2.2477364185110664,661,496,1157,-
chr1,55349352,2.006708074534161,787,574,1361,-
chr1,55349354,1.5222835614012695,1658,1154,2812,-
chr1,55349355,1.5408682993492482,1041,797,1838,-
chr1,55534078,3.813616643790842,497,559,1056,-
chr1,62166696,1.6148639441052721,1668,1179,2847,-
chr1,62175002,2.005791166783085,2318,1562,3880,-
chr1,62175003,2.0723508881270716,2737,1733,4470,-
chr1,62175006,0.6155123733599069,871,445,1316,-
chr1,62175022,1.9205465587044532,689,455,1144,-
chr1,63944492,2.2807017543859645,649,398,1047,-
chr1,63988871,1.0502313858500878,893,778,1671,-
chr1,63988872,1.325926076133604,561,490,1051,-
chr1,65301861,0.9072115384615383,628,415,1043,-
chr1,65301862,1.34126213592233,920,617,1537,-
chr1,65301864,1.5554617113259386,836,602,1438,-
chr1,65303668,0.2927478066081762,696,486,1182,-
chr1,65303669,0.2927478066081762,696,486,1182,-
chr1,65303670,0.2927478066081762,696,486,1182,-
chr1,65321350,3.5450328496488246,645,431,1076,-
chr1,67877163,1.7145085803432143,1098,640,1738,-
chr1,67877381,0.4662984505596558,794,498,1292,-
chr1,67877788,6.159098538122394,3511,2501,6012,-
chr1,67877813,15.677003809305058,4753,2767,7520,-
chr1,67877814,24.50368271954674,2126,1058,3184,-
chr1,67877815,18.302577954504002,6879,3825,10704,-
chr1,67877896,1.9020790746372835,1089,646,1735,-
chr1,67878151,0.6303319114902692,1454,1022,2476,-
chr1,67878218,3.04728903383612,574,445,1019,-
chr1,67878227,2.093367232621663,1293,969,2262,-
chr1,67878509,3.0401855513627263,924,592,1516,-
chr1,67878752,1.2793703101528031,3425,2432,5857,-
chr1,67878920,1.7605020882731826,2805,2030,4835,-
chr1,67880850,1.7612137203166227,1334,757,2091,-
chr1,67880852,1.9994526818588914,892,772,1664,-
chr1,67880856,2.43948076248392,595,502,1097,-
chr1,67880859,1.6341460258815987,1731,1108,2839,-
chr1,67880862,0.3147535062902546,580,448,1028,-
chr1,67880873,2.244615296564092,1527,1218,2745,-
chr1,67880874,2.336428452384003,2061,1628,3689,-
chr1,67880877,10.455309916481584,3353,1902,5255,-
chr1,67880878,9.830320699708455,2198,1028,3226,-
chr1,67880946,0.6680669079130501,1599,918,2517,-
chr1,67885708,1.497277676950998,1649,1253,2902,-
chr1,67885711,2.115285141600931,1453,835,2288,-
chr1,67885795,1.9945404172099088,1790,1247,3037,-
chr1,67885796,1.683327152529983,5017,3425,8442,-
chr1,67885829,2.5811802232854864,951,659,1610,-
chr1,67890796,0.6815178571428572,897,699,1596,-
chr1,67890801,0.5500028186481762,1026,656,1682,-
chr1,67891833,0.5772547232620416,4943,3609,8552,-
chr1,67891852,1.8693227091633464,1665,1254,2919,-
chr1,67891897,1.4001112966054534,2737,1796,4533,-
chr1,67891950,1.9012673353785343,2148,1298,3446,-
chr1,67891951,1.820938430473322,1437,957,2394,-
chr1,67895676,1.2302811519588126,2398,1603,4001,-
chr1,67895677,1.3765776810616974,3118,2064,5182,-
chr1,67895678,1.463290163634593,4282,2984,7266,-
chr1,67895679,1.656472543385833,3096,2082,5178,-
chr1,67895748,1.5840531561461795,893,419,1312,-
chr1,67895782,2.43850114416476,681,367,1048,-
chr1,67895831,4.791424212577971,2623,1700,4323,-
chr1,67895832,7.797183547486262,1648,1214,2862,-
chr1,67895868,0.287317620650954,1343,728,2071,-
chr1,67895874,1.7916947250280584,613,494,1107,-
chr1,67895913,2.0394642857142857,1214,699,1913,-
chr1,67895923,1.5692090395480227,1312,707,2019,-
chr1,67895924,1.915921115921116,765,494,1259,-
chr1,67895972,1.9943498405260291,2214,1674,3888,-
chr1,67895985,1.5195437182774318,1209,658,1867,-
chr1,67896064,1.0918358456319883,1626,1040,2666,-
chr1,68167973,3.586927277378013,732,554,1286,-
chr1,68168242,2.3975887771725235,605,404,1009,-
chr1,68170246,1.49655105719146,664,470,1134,-
chr1,68591509,0.2102425876010781,389,794,1183,-
chr1,68591510,0.2102425876010781,389,794,1183,-
chr1,68591549,0.2594994978239036,476,823,1299,-
chr1,68591553,2.9506007954126487,782,1236,2018,-
chr1,68591554,7.457534895524113,538,852,1390,-
chr1,68591563,10.316789134046134,1130,1739,2869,-
chr1,68591564,10.316789134046134,1130,1739,2869,-
chr1,68591574,13.186533666109836,600,608,1208,-
chr1,68591575,16.85270291818541,803,888,1691,-
chr1,68659642,1.5305120255584315,757,574,1331,-
chr1,68659798,1.9082419850069894,726,491,1217,-
chr1,68659835,2.1507174877142514,971,730,1701,-
chr1,68659837,0.4590773809523809,616,461,1077,-
chr1,68659839,2.1860536739948504,792,495,1287,-
chr1,68698042,3.4768195941836146,799,629,1428,-
chr1,68941902,0.4175189149799348,565,456,1021,-
chr1,68942536,2.2108629954274126,641,471,1112,-
chr1,71529248,1.496223759589272,1257,826,2083,-
chr1,71529297,2.3599562602141617,841,614,1455,-
chr1,71529346,1.6807342834740093,910,656,1566,-
chr1,71529453,1.7686184438221688,1221,858,2079,-
chr1,71529485,2.216559139784946,936,557,1493,-
chr1,71529486,2.216559139784946,936,557,1493,-
chr1,71530422,2.4175705632886513,1125,782,1907,-
chr1,71530516,2.6290384615384617,650,399,1049,-
chr1,71530696,2.3031888390632784,859,668,1527,-
chr1,71530698,2.3031888390632784,859,668,1527,-
chr1,71532528,3.976905311778291,573,432,1005,-
chr1,71536637,1.7933905958486511,1268,1032,2300,-
chr1,71544169,2.104196267879132,765,458,1223,-
chr1,77627015,1.9883320074250865,651,418,1069,-
chr1,77629538,0.46905651901174306,940,783,1723,-
chr1,77632412,1.6928823233171058,746,517,1263,-
chr1,77635036,0.48548271262952697,727,512,1239,-
chr1,78031101,1.7811173110954337,2581,1923,4504,-
chr1,78031102,1.7978545264259551,1461,909,2370,-
chr1,78031104,2.55608228980322,1680,1289,2969,-
chr1,78031105,2.55608228980322,1680,1289,2969,-
chr1,78031115,2.1431670281995663,683,460,1143,-
chr1,78031120,0.5380462079357107,856,542,1398,-
chr1,78031137,1.978107407738361,941,588,1529,-
chr1,78031139,1.978107407738361,941,588,1529,-
chr1,78031153,2.392763819095477,767,397,1164,-
chr1,78031155,2.392763819095477,767,397,1164,-
chr1,78031183,2.417103524637786,1020,591,1611,-
chr1,78031184,2.466566972869045,752,452,1204,-
chr1,78098561,2.5512265512265517,675,428,1103,-
chr1,78098562,2.5512265512265517,675,428,1103,-
chr1,78098658,3.4667325694787823,778,509,1287,-
chr1,78098736,4.021038062283737,806,424,1230,-
chr1,78098737,4.021038062283737,806,424,1230,-
chr1,78098756,2.768195689089261,658,363,1021,-
chr1,78194322,3.0846257787848534,1102,947,2049,-
chr1,78194323,3.141621849625646,1063,980,2043,-
chr1,78194325,2.497238132548569,1096,830,1926,-
chr1,78414287,1.9886461972750111,1721,1048,2769,-
chr1,78414288,1.9108555370524565,2011,1200,3211,-
chr1,78414290,1.9775197485951321,1662,987,2649,-
chr1,78414445,4.758374689826303,666,402,1068,-
chr1,78414452,0.4843023255813953,713,515,1228,-
chr1,78414908,3.858386894215565,867,582,1449,-
chr1,78421004,1.9936452917388796,492,576,1068,-
chr1,78421011,2.1809210526315788,701,683,1384,-
chr1,78421012,2.0918628779155095,1216,1052,2268,-
chr1,78428594,1.9992304732589457,865,564,1429,-
chr1,78429342,0.5140186076908438,783,588,1371,-
chr1,78430421,1.8575660565977443,4384,4517,8901,-
chr1,78430422,1.8149793083248962,5765,5852,11617,-
chr1,78430423,1.8149793083248962,5765,5852,11617,-
chr1,78430424,1.896253747512156,4248,4241,8489,-
chr1,78430557,1.5525997260334115,3355,2635,5990,-
chr1,78430563,1.4033893129770991,778,654,1432,-
chr1,78430567,0.6084328168656337,825,634,1459,-
chr1,78430568,2.166172839506173,565,449,1014,-
chr1,78430766,1.7067889192352712,672,465,1137,-
chr1,78432757,2.7553935860058307,726,489,1215,-
chr1,78433871,1.8317757009345803,874,534,1408,-
chr1,78435693,0.3308868501529052,540,653,1193,-
chr1,78444579,0.2199369936525481,1127,1947,3074,-
chr1,78444581,0.2869225764476252,839,1159,1998,-
chr1,78444593,0.2186538974625419,676,1206,1882,-
chr1,78444594,0.2186538974625419,676,1206,1882,-
chr1,78444597,0.2448663904264112,1089,3047,4136,-
chr1,78444598,0.2985060989538124,791,1651,2442,-
chr1,78444599,0.2634852491234993,1031,2796,3827,-
chr1,78444600,0.2560097591527671,1866,4265,6131,-
chr1,78444601,0.3154761904761904,476,1063,1539,-
chr1,78444602,0.2395445134575569,533,965,1498,-
chr1,78444609,2.7897504456327984,451,879,1330,-
chr1,78444610,4.897739710818389,932,2501,3433,-
chr1,78444613,18.20098255318484,977,857,1834,-
chr1,78444614,16.270833333333336,780,391,1171,-
chr1,78444615,16.270833333333336,780,391,1171,-
chr1,78444616,10.69659192483977,726,305,1031,-
chr1,84967514,1.625894030003027,2011,1427,3438,-
chr1,84967566,0.4346662588882942,757,637,1394,-
chr1,84967572,1.9745264747398483,1202,742,1944,-
chr1,84967574,2.2894111433852657,1784,1081,2865,-
chr1,84967575,2.2773961400065423,1769,1018,2787,-
chr1,84967577,2.590868794326241,1168,657,1825,-
chr1,85130156,2.661361626878868,644,521,1165,-
chr1,85718097,1.300509795416757,664,461,1125,-
chr1,85724249,3.540051679586563,684,386,1070,-
chr1,85724250,3.540051679586563,684,386,1070,-
chr1,85724251,3.540051679586563,684,386,1070,-
chr1,86842029,3.0923076923076924,602,419,1021,-
chr1,86842030,3.0923076923076924,602,419,1021,-
chr1,87328806,1.5316673052634566,2452,1697,4149,-
chr1,87329027,1.5092198581560283,1177,929,2106,-
chr1,87368984,1.8309966216216214,1140,739,1879,-
chr1,87368988,2.4635036496350367,944,821,1765,-
chr1,87369011,2.4372857430933657,1050,683,1733,-
chr1,87369073,1.7672138724538524,2082,1414,3496,-
chr1,87379795,0.7043642417782979,3415,2194,5609,-
chr1,87379796,0.8331922256478811,6683,4632,11315,-
chr1,87379797,1.1855542678667204,5394,4080,9474,-
chr1,87379807,1.4837092731829575,813,538,1351,-
chr1,89325871,1.219153869316471,626,454,1080,-
chr1,89329717,0.6944784026079869,1202,817,2019,-
chr1,89329723,1.7113358078416312,871,600,1471,-
chr1,89329725,0.6807541033204749,972,677,1649,-
chr1,89329735,0.6665133659097442,1022,734,1756,-
chr1,89414907,0.5753963221306277,697,414,1111,-
chr1,89414909,1.6541150410441503,3012,2113,5125,-
chr1,89414916,1.7277896233120114,1325,937,2262,-
chr1,89414943,1.335924978687127,943,849,1792,-
chr1,89414949,1.9975712412361037,1655,1183,2838,-
chr1,89414954,1.826425859640433,2338,1546,3884,-
chr1,91404945,4.229842192973506,653,436,1089,-
chr1,93621956,2.239203223426593,2320,2103,4423,-
chr1,93621992,1.4735388948597266,2038,1337,3375,-
chr1,93621999,1.8534588620548509,1697,1046,2743,-
chr1,93622013,1.786818425415787,2287,1582,3869,-
chr1,93622016,1.7106625363113053,2132,1415,3547,-
chr1,93622028,0.503731343283582,794,535,1329,-
chr1,93622036,0.5979312645979313,671,485,1156,-
chr1,93625700,2.948051948051948,680,395,1075,-
chr1,93625704,2.8384546271338724,717,370,1087,-
chr1,94027690,1.1089763315608008,1953,1418,3371,-
chr1,94027691,1.338710637308963,1848,1357,3205,-
chr1,94027693,1.9593562465902892,652,422,1074,-
chr1,94341268,1.8017152508170469,1225,1168,2393,-
chr1,94341269,1.8017152508170469,1225,1168,2393,-
chr1,94342863,1.7692307692307692,712,619,1331,-
chr1,94343065,5.141388174807197,719,388,1107,-
chr1,94343066,5.141388174807197,719,388,1107,-
chr1,94343067,5.141388174807197,719,388,1107,-
chr1,94343339,1.6480825958702063,905,677,1582,-
chr1,94343346,2.4782294489611565,1246,983,2229,-
chr1,94343348,2.119483962808894,3526,2741,6267,-
chr1,94343349,2.4773499915009345,1201,887,2088,-
chr1,94354584,1.1588997929049047,1581,1195,2776,-
chr1,94354585,0.9223757077966523,1288,973,2261,-
chr1,94367223,1.0990426965740199,774,556,1330,-
chr1,95363146,1.673978612558267,739,520,1259,-
chr1,95363156,2.3092105263157894,701,493,1194,-
chr1,95363298,2.4894736842105263,687,455,1142,-
chr1,95363331,5.096103896103896,653,384,1037,-
chr1,95363587,2.552303383872034,847,643,1490,-
chr1,97144433,2.3266898510979037,854,599,1453,-
chr1,97144455,1.5477618069815196,672,486,1158,-
chr1,101338637,5.0542573198515255,977,675,1652,-
chr1,101456129,1.1036933204119528,643,467,1110,-
chr1,101479292,0.521443998765813,675,462,1137,-
chr1,108677723,2.4464642923884545,656,439,1095,-
chr1,108677730,3.1949536701097685,641,407,1048,-
chr1,108677822,2.2972777614545388,621,439,1060,-
chr1,108700098,2.501065449010654,631,437,1068,-
chr1,108700099,2.501065449010654,631,437,1068,-
chr1,108742588,2.062279670975323,629,517,1146,-
chr1,108742590,2.062279670975323,629,517,1146,-
chr1,109191189,2.365315298257647,585,463,1048,-
chr1,109193733,1.0085796447854534,824,586,1410,-
chr1,109605416,3.502257235991358,779,533,1312,-
chr1,109605611,0.8090909673368443,928,632,1560,-
chr1,109605612,1.0066022544283413,657,459,1116,-
chr1,109606504,1.2073359242844441,842,623,1465,-
chr1,109823045,5.413547600905716,717,556,1273,-
chr1,109888385,2.6888329648780473,678,474,1152,-
chr1,109952554,1.7757818765036086,1383,1014,2397,-
chr1,109952560,2.603020121268296,1347,958,2305,-
chr1,109953707,1.5404273504273505,1613,974,2587,-
chr1,109954713,1.0505974510200045,3567,2794,6361,-
chr1,109954760,1.719815960653657,3793,2864,6657,-
chr1,109954762,1.719815960653657,3793,2864,6657,-
chr1,109955738,1.6350207709775233,4137,2844,6981,-
chr1,109964535,1.3655602018745492,1878,1386,3264,-
chr1,109968989,1.5441486547846484,2158,1451,3609,-
chr1,109969038,2.831532846715328,1118,684,1802,-
chr1,109969055,1.5958799344885615,1931,1056,2987,-
chr1,109969059,0.4685798113019971,805,382,1187,-
chr1,109969062,2.0152043253990524,842,425,1267,-
chr1,109969065,1.7195791724017466,720,302,1022,-
chr1,110279780,1.7117840978703716,3323,2484,5807,-
chr1,110279783,1.4794642748035634,1806,1120,2926,-
chr1,110280148,1.440552871712292,1129,971,2100,-
chr1,110280282,2.8212888426158953,2632,2126,4758,-
chr1,110280929,2.6883450397031776,4071,3090,7161,-
chr1,110282060,1.9945146139410763,5617,4174,9791,-
chr1,110282063,1.7803773055613998,2440,2036,4476,-
chr1,110282080,0.7771286650231539,2731,2122,4853,-
chr1,110282104,1.4776815304743616,3372,2724,6096,-
chr1,110282105,1.2613095411343138,6928,5557,12485,-
chr1,110282108,1.415500390033497,1927,1146,3073,-
chr1,110282475,1.55806821779044,3872,3158,7030,-
chr1,110282476,1.55806821779044,3872,3158,7030,-
chr1,110282477,1.383322833664197,4886,4022,8908,-
chr1,110282484,0.6390990139132784,756,672,1428,-
chr1,110282501,1.1181070769904882,1488,1070,2558,-
chr1,110282877,1.5931403799566497,734,505,1239,-
chr1,110282878,2.056603413198577,865,751,1616,-
chr1,110282890,0.5876351351351352,668,369,1037,-
chr1,110943960,1.5883892885691446,1302,1111,2413,-
chr1,110944068,1.735805416697754,1550,1030,2580,-
chr1,110944157,1.3427367487247728,1407,1001,2408,-
chr1,110944160,1.1099494086455444,3326,2381,5707,-
chr1,110946572,1.4692267593397046,1261,1150,2411,-
chr1,110946573,0.6233291582361821,1830,1454,3284,-
chr1,110948963,0.5943399906381651,982,985,1967,-
chr1,110948994,0.5950289802252342,1667,1516,3183,-
chr1,110950228,5.027206960038887,3198,3092,6290,-
chr1,110950234,18.03620495787881,3136,2808,5944,-
chr1,110950241,10.622453579305533,6243,4197,10440,-
chr1,110950242,10.622453579305532,6243,4197,10440,-
chr1,110950315,0.9032740822185572,727,427,1154,-
chr1,111660479,1.939413601143459,2170,1476,3646,-
chr1,111660481,1.939413601143459,2170,1476,3646,-
chr1,111660495,1.6818266319647317,1734,1123,2857,-
chr1,111660496,1.6818266319647317,1734,1123,2857,-
chr1,111660497,0.6278959810874705,829,422,1251,-
chr1,111660513,2.6918536009445098,911,461,1372,-
chr1,111660515,2.6918536009445098,911,461,1372,-
chr1,111660605,3.8497061293031063,654,396,1050,-
chr1,111668893,0.6001585623678646,756,527,1283,-
chr1,111682137,2.2141537557207034,1158,933,2091,-
chr1,111682138,2.2141537557207034,1158,933,2091,-
chr1,111682181,1.8879551820728293,673,475,1148,-
chr1,111682188,1.6375569671778014,724,545,1269,-
chr1,111983450,5.177666672527131,693,615,1308,-
chr1,111983460,19.106688081538955,1087,831,1918,-
chr1,111983461,20.128043564763427,1248,923,2171,-
chr1,111986535,0.2792161974956557,883,654,1537,-
chr1,111986536,0.6519815994338287,736,627,1363,-
chr1,111991252,2.8324798261949096,744,536,1280,-
chr1,111991254,2.12917206386055,1807,1227,3034,-
chr1,111991255,2.5739390463706373,1064,717,1781,-
chr1,111991256,2.5739390463706373,1064,717,1781,-
chr1,111991269,2.751793864531321,601,401,1002,-
chr1,113243967,0.7522085416515712,1198,757,1955,-
chr1,113243968,1.383587786259542,949,523,1472,-
chr1,113244097,0.5677636693443898,625,453,1078,-
chr1,113244109,1.7630062630480166,753,478,1231,-
chr1,113244195,1.6968557758031442,661,531,1192,-
chr1,113244234,2.6478269271601422,1240,911,2151,-
chr1,113245300,2.958,611,499,1110,-
chr1,113245314,0.5759892086330936,853,555,1408,-
chr1,113245699,2.1832307437207645,1090,879,1969,-
chr1,113246341,1.6765188834154352,1020,608,1628,-
chr1,113455117,2.31607849471049,1194,853,2047,-
chr1,113455118,2.31607849471049,1194,853,2047,-
chr1,113455275,1.8911216180719723,846,563,1409,-
chr1,113455312,0.9161152550529356,1561,1038,2599,-
chr1,113455313,0.9161152550529356,1561,1038,2599,-
chr1,113455396,3.1970048512971947,658,430,1088,-
chr1,113455411,1.8304178069695314,952,672,1624,-
chr1,113455430,1.269877992188162,666,437,1103,-
chr1,113456163,2.0573610659733506,1150,723,1873,-
chr1,113456302,4.667986597624124,612,468,1080,-
chr1,113456683,2.061303462321792,697,490,1187,-
chr1,113456714,2.368376865671642,818,535,1353,-
chr1,113456757,2.456278366111952,901,660,1561,-
chr1,113456759,2.456278366111952,901,660,1561,-
chr1,113460049,2.4131362889983583,667,405,1072,-
chr1,113460056,2.612260678975521,963,794,1757,-
chr1,113460081,1.5884508164078055,538,464,1002,-
chr1,113460275,2.102272727272727,702,615,1317,-
chr1,113460383,2.9971988795518207,534,475,1009,-
chr1,113464640,1.2438008423512523,937,791,1728,-
chr1,113498815,0.5934373706419859,1047,567,1614,-
chr1,113498816,0.5485175593393886,1512,911,2423,-
chr1,114254399,2.666359848344114,692,330,1022,-
chr1,115110479,0.45052780841342355,816,576,1392,-
chr1,115123954,1.0298136645962732,828,643,1471,-
chr1,115123955,1.0298136645962732,828,643,1471,-
chr1,115123989,3.5803615517890437,1049,923,1972,-
chr1,115123992,3.0423944441976727,740,606,1346,-
chr1,115247325,2.6014895293781852,655,500,1155,-
chr1,115248990,2.078069756330626,658,454,1112,-
chr1,115248991,2.078069756330626,658,454,1112,-
chr1,115249385,2.8029370299232355,585,450,1035,-
chr1,115249995,2.5559447898087226,665,594,1259,-
chr1,115258734,3.235294117647059,859,730,1589,-
chr1,115258735,7.412238422822662,1734,1557,3291,-
chr1,115258736,5.682177309318991,1515,1308,2823,-
chr1,115259684,2.677554662577755,1910,1295,3205,-
chr1,115259686,2.546461970741595,2801,1910,4711,-
chr1,115259687,4.762418300653595,1120,764,1884,-
chr1,115259689,8.47203312376862,2017,1341,3358,-
chr1,115259861,2.649497487437185,702,596,1298,-
chr1,115259862,2.649497487437185,702,596,1298,-
chr1,115260086,0.5929799080125878,1530,1214,2744,-
chr1,115260088,1.504932376404655,1031,852,1883,-
chr1,115260099,1.521374321880651,1025,789,1814,-
chr1,115260102,1.839595192915876,1982,1529,3511,-
chr1,115260103,1.839595192915876,1982,1529,3511,-
chr1,115260106,1.8964051968350104,946,705,1651,-
chr1,115260207,1.7571022727272725,1236,815,2051,-
chr1,115260714,1.3308897409813774,4165,3064,7229,-
chr1,115261309,1.3692184368737474,1652,997,2649,-
chr1,115262246,1.4737977364709351,3320,2554,5874,-
chr1,115263254,1.6105106894624357,2671,1858,4529,-
chr1,115263331,1.3963500665248558,10452,7298,17750,-
chr1,115263332,1.2180216206032535,7383,5155,12538,-
chr1,115263334,1.5657658266353252,4215,2885,7100,-
chr1,115266552,1.887283729920963,5266,4059,9325,-
chr1,115267865,0.6920662552091575,1380,1067,2447,-
chr1,115267880,1.48400374181478,1321,1068,2389,-
chr1,115268843,1.5397154585115296,1768,1500,3268,-
chr1,115273002,0.7654750847366962,2384,1500,3884,-
chr1,115273004,1.427664033233189,1854,1633,3487,-
chr1,115275228,1.6401608251523718,1625,1192,2817,-
chr1,115276370,1.5125910509885536,1839,1549,3388,-
chr1,115276612,1.332635676665903,2880,1984,4864,-
chr1,115276660,1.5189334024217302,2620,1647,4267,-
chr1,115277103,1.498454791575512,3880,2564,6444,-
chr1,115280151,2.7472729006006276,732,506,1238,-
chr1,115292603,1.353877163400973,1887,1273,3160,-
chr1,115292693,0.765925001732862,2124,1602,3726,-
chr1,115292780,1.6047183709460042,13504,12975,26479,-
chr1,115292787,2.3809758437655657,11881,10408,22289,-
chr1,115292811,0.8284999793120293,14062,11992,26054,-
chr1,115292812,0.8284999793120293,14062,11992,26054,-
chr1,115292814,1.1840167344356647,26188,21886,48074,-
chr1,115292816,1.3863831345153965,31462,25136,56598,-
chr1,115292817,1.3623419893173752,24190,19487,43677,-
chr1,115292823,1.3891415671275156,4347,3625,7972,-
chr1,115292826,1.2272597329456751,9036,6750,15786,-
chr1,115292827,0.7040184208385736,5847,5510,11357,-
chr1,115300551,1.6691176762677336,11950,9931,21881,-
chr1,115300554,1.6124213126110658,2261,2141,4402,-
chr1,115300556,2.020908596116655,12811,10389,23200,-
chr1,115300580,1.7117767254800207,3404,2623,6027,-
chr1,115300582,1.0860268054579372,5365,3697,9062,-
chr1,115300584,1.43721699262254,10416,7598,18014,-
chr1,115300585,1.5056457982056295,10794,7517,18311,-
chr1,115300588,1.3584071094642254,3914,2703,6617,-
chr1,115300593,2.263727959697733,1044,793,1837,-
chr1,115300601,0.9174195890868996,4503,2735,7238,-
chr1,115300605,0.5893580366318081,660,465,1125,-
chr1,115300607,0.5893580366318081,660,465,1125,-
chr1,115300613,0.7197081254407506,758,581,1339,-
chr1,120510127,1.203186487689186,716,581,1297,-
chr1,149680283,1.4505788576654477,4261,3006,7267,-
chr1,149680284,1.4505788576654477,4261,3006,7267,-
chr1,149680287,0.9441832496101299,1233,823,2056,-
chr1,149895391,2.014370028226841,627,432,1059,-
chr1,149895438,1.0364973352222897,667,548,1215,-
chr1,149895440,1.0364973352222897,667,548,1215,-
chr1,149898438,2.0441717791411045,587,488,1075,-
chr1,149898644,2.096703980099502,612,401,1013,-
chr1,149898779,2.1732739420935414,696,448,1144,-
chr1,149899079,2.713703563305535,1379,1318,2697,-
chr1,149899080,1.7747445934000805,3897,3456,7353,-
chr1,149899082,2.4583375871672724,3428,2848,6276,-
chr1,149899083,2.8848006295346638,2855,2485,5340,-
chr1,149899084,3.0535735443187955,2534,2052,4586,-
chr1,149899086,1.9940739656649138,2677,2128,4805,-
chr1,149899095,1.0041720154043643,1042,655,1697,-
chr1,149899096,1.0041720154043643,1042,655,1697,-
chr1,149899099,1.1557931286549707,972,607,1579,-
chr1,149899100,1.1557931286549707,972,607,1579,-
chr1,149899659,5.3446088794926,631,472,1103,-
chr1,149899660,4.8736431963846965,823,616,1439,-
chr1,149899674,1.537152249609395,845,536,1381,-
chr1,150191010,20.232020615995552,2658,2210,4868,-
chr1,150191011,21.23562199250091,2185,1804,3989,-
chr1,150191273,1.9110291948662859,823,678,1501,-
chr1,150192089,2.434979268752356,645,378,1023,-
chr1,150192983,0.4586561487533455,591,457,1048,-
chr1,150198984,2.744975891996143,637,583,1220,-
chr1,150199024,6.220680030723729,1331,1003,2334,-
chr1,150199030,5.14155615411568,1046,711,1757,-
chr1,150199036,4.223084445384733,758,505,1263,-
chr1,150201442,1.8259423503325944,731,491,1222,-
chr1,150202917,1.840649581324537,935,562,1497,-
chr1,150202929,2.195896433805569,898,533,1431,-
chr1,150202962,2.8282828282828283,849,494,1343,-
chr1,150204118,0.4737811617340047,642,478,1120,-
chr1,150204156,1.720234113712375,761,459,1220,-
chr1,150204252,1.1018128557482099,841,686,1527,-
chr1,150208158,0.4515402499273467,564,443,1007,-
chr1,150208169,5.540433271443234,3607,3059,6666,-
chr1,150208170,5.540433271443235,3607,3059,6666,-
chr1,150208171,3.207623839009288,725,815,1540,-
chr1,150208315,2.9718812557933023,582,479,1061,-
chr1,150237886,0.4165054179566563,573,607,1180,-
chr1,150237898,2.7575293234593534,1129,1412,2541,-
chr1,150237901,20.753947126001382,3154,2471,5625,-
chr1,150237902,21.202760450054022,3312,2521,5833,-
chr1,150237903,23.777199805133673,4032,2652,6684,-
chr1,150237904,30.36315789473684,640,379,1019,-
chr1,150237905,53.56204179833162,2511,655,3166,-
chr1,150237907,22.488626819228987,2606,445,3051,-
chr1,150237908,23.344242906979822,1825,309,2134,-
chr1,150237910,11.278801843317972,978,123,1101,-
chr1,150237911,10.042592592592593,985,119,1104,-
chr1,150237912,17.058755760368662,1138,123,1261,-
chr1,150237913,14.55420688182785,2315,259,2574,-
chr1,150237914,16.107209397008226,1800,194,1994,-
chr1,150238205,5.626207028343973,1619,1519,3138,-
chr1,150238234,4.622501111361571,1480,1077,2557,-
chr1,150238235,3.715122706609825,1373,1068,2441,-
chr1,150238237,2.9767702950622494,1883,1368,3251,-
chr1,150239583,1.5610930731068346,938,754,1692,-
chr1,150239828,0.4944586530264279,637,390,1027,-
chr1,150240387,1.6859879032258065,668,495,1163,-
chr1,150240425,1.2376788666729328,789,569,1358,-
chr1,150240467,0.3655382148357683,695,576,1271,-
chr1,150240522,4.196395896063735,598,438,1036,-
chr1,150241194,1.157826718816469,741,514,1255,-
chr1,150241195,0.7724001874890668,702,474,1176,-
chr1,150547292,0.6747290154976261,1075,914,1989,-
chr1,150547293,0.5226394355210439,736,552,1288,-
chr1,150547301,0.5784131326949383,782,849,1631,-
chr1,150547334,0.5050896046686553,943,1119,2062,-
chr1,150547335,0.3394749570612108,1145,1571,2716,-
chr1,150547353,1.7766304835419406,1549,2000,3549,-
chr1,150547355,0.8369921363040631,523,871,1394,-
chr1,150547356,2.2349811826935815,1908,2510,4418,-
chr1,150547357,1.0930859363917498,687,1136,1823,-
chr1,150547359,1.9842839853297776,1186,1221,2407,-
chr1,150547363,6.165352857628162,1260,1262,2522,-
chr1,150547366,7.13344053888102,1422,1361,2783,-
chr1,150547369,5.935562909949391,1401,1159,2560,-
chr1,150547372,12.152289742218262,3827,2230,6057,-
chr1,150547373,14.626515060914038,4887,2732,7619,-
chr1,150547374,16.11337807342233,4203,2481,6684,-
chr1,150547375,19.41434986192622,3153,1730,4883,-
chr1,150547380,4.831704668838219,889,306,1195,-
chr1,150547381,4.8576391350584895,992,402,1394,-
chr1,150547382,5.680173433164088,2747,760,3507,-
chr1,150547383,6.993129968259324,4871,1354,6225,-
chr1,150547384,7.888894644739906,5156,1244,6400,-
chr1,150547385,8.281154774568558,3181,680,3861,-
chr1,150547386,10.947279274059897,2350,405,2755,-
chr1,150547390,13.53948189339482,1077,164,1241,-
chr1,150547392,13.53948189339482,1077,164,1241,-
chr1,150547589,2.042553191489361,1827,1370,3197,-
chr1,150547708,1.50565593261773,1354,848,2202,-
chr1,150547766,2.569190600522193,1199,765,1964,-
chr1,150548015,2.048695652173913,949,574,1523,-
chr1,150548085,2.0580007040205706,1878,1376,3254,-
chr1,150548176,1.4236343852013056,1257,918,2175,-
chr1,150548183,0.3652231551038444,1130,805,1935,-
chr1,150548613,1.5661489314827055,1550,1067,2617,-
chr1,150549310,2.2354556623656454,4727,3454,8181,-
chr1,150549446,0.713469387755102,1839,1499,3338,-
chr1,150549500,1.979624163006696,1221,816,2037,-
chr1,150550899,1.5886659030924752,1226,933,2159,-
chr1,150550906,2.242604558049691,1748,1240,2988,-
chr1,150550907,2.8141993957703924,827,661,1488,-
chr1,150550925,1.5980401016346542,1633,1104,2737,-
chr1,150550942,0.9195794259732879,1617,1241,2858,-
chr1,150550943,1.011777526300348,1206,722,1928,-
chr1,150550944,0.9567206581986475,2823,1963,4786,-
chr1,150551320,1.3638397145838175,1436,1092,2528,-
chr1,150551341,1.9934768427919112,763,583,1346,-
chr1,150551543,1.7524710830704522,640,633,1273,-
chr1,150551903,2.6399825021872267,709,507,1216,-
chr1,150551905,2.258478484541985,957,694,1651,-
chr1,150594761,3.018707482993197,780,461,1241,-
chr1,150594900,2.8,678,484,1162,-
chr1,150594912,0.6009194395796847,548,570,1118,-
chr1,150594913,1.8047182175622545,611,435,1046,-
chr1,150594923,2.749013394799781,1681,1488,3169,-
chr1,150594993,0.39125972850456225,859,1469,2328,-
chr1,150595013,0.3989956057752668,453,707,1160,-
chr1,150595015,0.3243087970246672,733,1480,2213,-
chr1,150595020,0.8854166666666665,288,815,1103,-
chr1,150595021,0.8854166666666665,288,815,1103,-
chr1,150595025,0.1843969684078245,333,911,1244,-
chr1,150595029,7.377906170077042,1388,1941,3329,-
chr1,150595030,8.853223683012292,1709,1845,3554,-
chr1,150595031,8.91477567988914,939,501,1440,-
chr1,150595032,13.287171480781927,1927,731,2658,-
chr1,150595033,11.632860252078041,1900,502,2402,-
chr1,150595034,12.668043469886785,1960,488,2448,-
chr1,150595035,18.176786646363993,1714,380,2094,-
chr1,150595036,21.50497512437811,987,200,1187,-
chr1,150595038,14.986149733942705,1311,173,1484,-
chr1,150595040,26.53754319267945,1079,128,1207,-
chr1,150596735,7.652397763676392,844,555,1399,-
chr1,150596738,8.074388223524362,825,459,1284,-
chr1,150596743,13.71062052644065,1227,585,1812,-
chr1,150596744,10.783487670587563,843,429,1272,-
chr1,150597748,1.5962628557791816,6878,4384,11262,-
chr1,150597749,1.5613233743098758,9022,5572,14594,-
chr1,150597753,1.3784690731471447,3735,2458,6193,-
chr1,150597755,1.5933456075749604,2861,1900,4761,-
chr1,150597799,1.5343851619896425,1469,721,2190,-
chr1,150597800,1.6593726950230057,2231,1202,3433,-
chr1,150597801,1.6106935740301076,3700,1923,5623,-
chr1,150597802,1.6593726950230057,2231,1202,3433,-
chr1,150598130,2.7680806433879774,957,670,1627,-
chr1,150601928,2.141678192715537,1132,722,1854,-
chr1,150601929,1.6176373677184857,1582,1170,2752,-
chr1,150601965,5.397435897435897,841,467,1308,-
chr1,150601967,4.698633054639638,1147,676,1823,-
chr1,150784466,21.583678516278127,1246,849,2095,-
chr1,150784467,21.583678516278127,1246,849,2095,-
chr1,150784468,16.379356400778622,997,663,1660,-
chr1,150785675,0.3786606794221007,861,393,1254,-
chr1,150785676,0.9639140998218373,1367,625,1992,-
chr1,150785682,0.7096774193548387,857,233,1090,-
chr1,150785683,0.7096774193548387,857,233,1090,-
chr1,150808848,0.47746296149813716,631,491,1122,-
chr1,150938028,0.6660168940870697,696,458,1154,-
chr1,150939589,1.5996343692870203,874,546,1420,-
chr1,150939610,0.5690696022727273,640,511,1151,-
chr1,150941491,1.586813970064148,542,459,1001,-
chr1,150947179,3.038589266625704,483,923,1406,-
chr1,150947180,3.038589266625704,483,923,1406,-
chr1,151025243,3.0753244051966035,715,512,1227,-
chr1,151149020,0.6390748630553865,839,619,1458,-
chr1,151149027,2.8720337103570635,739,500,1239,-
chr1,151149116,2.755218661418679,832,633,1465,-
chr1,151149123,2.3170874535185946,1177,890,2067,-
chr1,151150494,1.983221476510067,590,446,1036,-
chr1,151150542,0.5194330473703842,632,382,1014,-
chr1,151156861,1.5734481034612966,5204,4094,9298,-
chr1,151156863,2.070300834088282,2693,2379,5072,-
chr1,151156865,2.1086006477830543,6645,4469,11114,-
chr1,151156866,2.3198243770197133,2292,1668,3960,-
chr1,151156867,2.150632299239946,5799,3782,9581,-
chr1,151156879,2.197942643391521,640,400,1040,-
chr1,151156893,2.1119611427469924,1046,725,1771,-
chr1,151158004,1.8846735002246093,1419,1041,2460,-
chr1,151158006,1.8846735002246093,1419,1041,2460,-
chr1,151158275,0.7425444925444925,740,566,1306,-
chr1,151158278,0.5659532364734676,1044,864,1908,-
chr1,151158280,0.5659532364734676,1044,864,1908,-
chr1,151162519,1.1196131381938341,830,649,1479,-
chr1,151313695,2.1454770047983986,698,473,1171,-
chr1,151314453,2.3729502870990355,705,489,1194,-
chr1,151315639,1.4835274069866515,1347,1005,2352,-
chr1,151315646,1.7440457161125318,2296,1563,3859,-
chr1,151315648,1.6663482754002217,3352,2233,5585,-
chr1,151315650,1.634150675195451,2163,1406,3569,-
chr1,151315836,2.454831932773109,737,356,1093,-
chr1,151315840,2.41336093857833,1365,804,2169,-
chr1,151315841,1.4067238457580666,2694,1693,4387,-
chr1,151315843,0.4223253541768442,1329,889,2218,-
chr1,151319723,0.8854378818737271,563,490,1053,-
chr1,151319724,0.9609365438089507,837,727,1564,-
chr1,151733954,1.9758695652173917,1638,1099,2737,-
chr1,151733955,1.9758695652173917,1638,1099,2737,-
chr1,151734896,1.5709854868913855,766,533,1299,-
chr1,151734941,0.448512585812357,587,436,1023,-
chr1,151734942,0.5598377281947262,647,458,1105,-
chr1,151735468,2.6292522314462268,1032,700,1732,-
chr1,151735853,2.844569288389513,650,533,1183,-
chr1,151735854,2.844569288389513,650,533,1183,-
chr1,151735868,2.3334459618355234,682,475,1157,-
chr1,151735875,1.2901719287217086,865,542,1407,-
chr1,151955669,1.334461211884222,3715,2522,6237,-
chr1,151955708,0.8070154069931649,3288,2528,5816,-
chr1,151958696,1.4702097902097904,1511,1000,2511,-
chr1,151958709,1.889557453416149,884,735,1619,-
chr1,151958723,2.6295205151548626,1654,1076,2730,-
chr1,151966259,2.1063934062659424,2230,1277,3507,-
chr1,151966287,0.5284195086175284,785,302,1087,-
chr1,151966311,1.0274379936261606,1618,1030,2648,-
chr1,151966312,0.9779854675652906,1838,1186,3024,-
chr1,151966313,0.8684205674111958,2931,1773,4704,-
chr1,151966314,0.8535074410175135,1892,1214,3106,-
chr1,152005045,1.5925934306020413,4614,3695,8309,-
chr1,152005048,1.4215292595641726,1321,1122,2443,-
chr1,152005299,0.5893448422450155,705,605,1310,-
chr1,152006125,1.3929479990152365,3725,2366,6091,-
chr1,152006251,2.3581514762516043,1836,1329,3165,-
chr1,152006265,1.5144145258342778,3658,2673,6331,-
chr1,152006273,1.1266587793795169,2622,2025,4647,-
chr1,152006274,1.1266587793795169,2622,2025,4647,-
chr1,152009390,0.6101340548518017,901,691,1592,-
chr1,152009392,1.591978226615098,1207,894,2101,-
chr1,152009399,1.8126441559748159,1878,1587,3465,-
chr1,152009417,3.5097996036115395,1225,716,1941,-
chr1,152009443,0.9148316397195243,2463,1540,4003,-
chr1,152009445,0.781744475729649,3861,2543,6404,-
chr1,152009447,0.5643226411704825,1487,841,2328,-
chr1,152009469,1.441455680591649,632,414,1046,-
chr1,152009473,1.0719037060500476,647,692,1339,-
chr1,152009475,2.0067912665044734,1473,1348,2821,-
chr1,152009478,0.49473629980771894,667,552,1219,-
chr1,153507193,0.8441124966100841,36208,26213,62421,-
chr1,153507289,1.3246858283445253,28142,21470,49612,-
chr1,153507705,1.2908669313172991,34889,26585,61474,-
chr1,153507723,1.056824257385017,21390,16618,38008,-
chr1,153507724,1.249106831632328,12052,9579,21631,-
chr1,153507763,1.1643807888118751,7827,4759,12586,-
chr1,153507768,1.6346656819707963,12961,8515,21476,-
chr1,153507836,0.441234634564312,756,528,1284,-
chr1,153507837,1.1193365083832358,759,545,1304,-
chr1,153508462,1.0324439901864433,13744,11013,24757,-
chr1,153508466,1.0605722471811565,3101,2876,5977,-
chr1,153508467,0.9148215668637232,4907,3493,8400,-
chr1,153508468,1.0996400586949697,11483,9389,20872,-
chr1,153508469,1.02475283924825,8494,6590,15084,-
chr1,153508470,1.2363682568137364,5505,3829,9334,-
chr1,153508476,1.7427670368846837,819,441,1260,-
chr1,153508487,0.6476336215638193,1300,742,2042,-
chr1,153508488,0.6476336215638193,1300,742,2042,-
chr1,153508493,0.6673366564828215,672,690,1362,-
chr1,153508495,0.5380944871717466,2328,2162,4490,-
chr1,153508496,0.44025588649407615,1349,1419,2768,-
chr1,153508498,0.3426299283154121,436,743,1179,-
chr1,153508499,0.22476727628348922,554,695,1249,-
chr1,153516166,1.7670542018368105,3025,2456,5481,-
chr1,153516167,1.7670542018368105,3025,2456,5481,-
chr1,153516390,1.377615060013733,6648,4728,11376,-
chr1,153518238,1.3642509389344832,2228,1579,3807,-
chr1,153518264,1.1006057207108968,3209,2399,5608,-
chr1,153518268,0.6556723626277712,1648,1198,2846,-
chr1,153518271,2.026537585421412,658,438,1096,-
chr1,153518274,1.356641975308642,2221,1649,3870,-
chr1,153518276,1.4403738905034953,3046,2194,5240,-
chr1,153518278,1.5758060262843083,3888,2983,6871,-
chr1,153518279,1.6251034372677124,3047,2561,5608,-
chr1,153518280,1.6873822628523285,3408,2763,6171,-
chr1,153518281,1.3907917385199664,1742,1340,3082,-
chr1,153579477,3.0129570465033724,969,625,1594,-
chr1,153579489,1.8120873539867952,891,536,1427,-
chr1,153579495,1.5704304710389902,870,521,1391,-
chr1,153579505,0.5654189754608164,624,477,1101,-
chr1,153579522,0.3162035274711331,711,425,1136,-
chr1,153579524,0.9921355111917726,655,569,1224,-
chr1,153579525,1.131445333063485,1057,692,1749,-
chr1,153579526,1.3664363343225714,1097,927,2024,-
chr1,153579691,0.6641556811048336,1057,766,1823,-
chr1,153579718,1.7514285714285711,612,574,1186,-
chr1,153579775,2.0192861027311566,1118,676,1794,-
chr1,153579902,0.3564814814814815,780,638,1418,-
chr1,153579903,0.3564814814814815,780,638,1418,-
chr1,153579910,2.111124827709724,1014,723,1737,-
chr1,153580046,1.9992441421012848,689,440,1129,-
chr1,153580144,2.3661759785881564,614,426,1040,-
chr1,153580579,1.4237847991726291,2452,1857,4309,-
chr1,153580588,1.3028215725292107,3003,1945,4948,-
chr1,153580592,1.4402872853776232,2629,1674,4303,-
chr1,153580594,0.7564135089432931,5029,3641,8670,-
chr1,153580599,1.6613374591713943,1811,1107,2918,-
chr1,153580601,1.373899460380574,1289,1005,2294,-
chr1,153580607,1.9744687356673287,1147,843,1990,-
chr1,153580626,1.962962962962963,1059,623,1682,-
chr1,153580628,1.4334045584045587,804,623,1427,-
chr1,153585463,0.43156289604963133,632,477,1109,-
chr1,153585544,1.3814196953599762,1081,1032,2113,-
chr1,153585546,3.4848264703990264,1932,1522,3454,-
chr1,153585547,12.564619293778742,630,547,1177,-
chr1,153591325,21.90616070041104,1564,1152,2716,-
chr1,153591374,0.3761848341232228,634,421,1055,-
chr1,153591431,2.4962325743732934,2383,1837,4220,-
chr1,153591435,1.7408474867044093,2244,1674,3918,-
chr1,153591453,1.4298312012716674,1798,1200,2998,-
chr1,153591455,1.3728514476178026,2333,1390,3723,-
chr1,153591485,2.045641914092837,1316,880,2196,-
chr1,153598814,1.8711725250372369,2373,1516,3889,-
chr1,153598838,1.8024652777777777,1402,959,2361,-
chr1,153598839,1.8024652777777777,1402,959,2361,-
chr1,153598859,2.0204810669206954,605,493,1098,-
chr1,153598973,1.9582757933894077,896,730,1626,-
chr1,153634759,0.7496112921958713,2388,1735,4123,-
chr1,153634771,1.7089510142376858,2046,1342,3388,-
chr1,153634994,1.55796467913971,1133,930,2063,-
chr1,153635255,1.588825665513396,1133,852,1985,-
chr1,153635503,1.89754338517016,978,764,1742,-
chr1,153635597,0.723867968765928,1577,1077,2654,-
chr1,153636939,1.7420721597936788,1248,1026,2274,-
chr1,153637720,1.3920032147880248,1731,1500,3231,-
chr1,153637743,1.7287268074216249,1350,1041,2391,-
chr1,153638180,1.788782274048119,2557,2099,4656,-
chr1,153640099,1.52,1823,1529,3352,-
chr1,153640131,1.7083692838654012,1187,914,2101,-
chr1,153640546,1.7412765957446807,1187,939,2126,-
chr1,153640942,1.3822991534534217,3029,2138,5167,-
chr1,153642333,1.5144927536231882,1234,896,2130,-
chr1,153642665,2.609383753501401,600,475,1075,-
chr1,153643411,2.1482059282371297,917,640,1557,-
chr1,153931660,45.58218032223258,6859,4572,11431,-
chr1,153931661,45.58218032223258,6859,4572,11431,-
chr1,153931666,2.5700218818380747,1130,456,1586,-
chr1,153931672,6.194693094629154,2152,781,2933,-
chr1,153931673,18.344108438717097,2863,1138,4001,-
chr1,153931810,0.6645935233597572,1086,846,1932,-
chr1,153931843,1.5296678903782124,873,688,1561,-
chr1,153931850,1.9887957874492128,2059,1563,3622,-
chr1,153931854,12.07855251544572,1609,1235,2844,-
chr1,153931855,13.715090564648106,4158,2953,7111,-
chr1,153931856,13.388082912033203,4937,3451,8388,-
chr1,153931870,2.634332855956229,1671,1133,2804,-
chr1,153931871,1.599386368617138,889,506,1395,-
chr1,153931872,2.739441340782123,1065,715,1780,-
chr1,153931904,0.35771920387305,664,506,1170,-
chr1,153931907,0.5822553808169181,903,600,1503,-
chr1,153932070,2.0549197111757733,1305,1030,2335,-
chr1,153932071,2.0953662968000426,1994,1680,3674,-
chr1,153932101,2.0513860824723884,1625,1152,2777,-
chr1,153932205,2.782035561005518,549,465,1014,-
chr1,153932298,0.564996829422955,692,580,1272,-
chr1,153932446,2.316146307323159,1867,1496,3363,-
chr1,153932462,0.5941572852358472,1177,750,1927,-
chr1,153932474,2.6683579335793355,1494,1083,2577,-
chr1,153932475,2.9667750770241854,3399,2394,5793,-
chr1,153932486,6.3747228381374725,689,450,1139,-
chr1,153932490,3.0415554072096125,674,427,1101,-
chr1,153932498,0.49107663165211307,3253,1991,5244,-
chr1,153932541,1.876780185758514,865,645,1510,-
chr1,153932548,1.8944383643418568,576,436,1012,-
chr1,153932574,1.8182847082494968,760,567,1327,-
chr1,153932694,0.663161150634086,602,548,1150,-
chr1,153932698,0.6303452644916059,795,573,1368,-
chr1,153932765,2.0951871657754007,652,439,1091,-
chr1,153933005,2.098945660989457,646,410,1056,-
chr1,153933165,0.5580800908832717,654,502,1156,-
chr1,153933207,0.5562043795620438,888,547,1435,-
chr1,153933211,2.026598795526241,1228,950,2178,-
chr1,153933213,2.026598795526241,1228,950,2178,-
chr1,153934741,1.1038169215080305,1388,1050,2438,-
chr1,153934801,0.4501272573021452,618,445,1063,-
chr1,153935105,2.868960244648318,646,435,1081,-
chr1,153935106,2.868960244648318,646,435,1081,-
chr1,153935986,0.46771459962665807,1290,1010,2300,-
chr1,153947075,1.2471676442216693,17865,13926,31791,-
chr1,153947088,1.5351048001080938,13947,10362,24309,-
chr1,153947097,1.7374446367080854,6106,4708,10814,-
chr1,153947124,1.6024226194222284,12552,8890,21442,-
chr1,153947198,1.54940927616984,2056,1364,3420,-
chr1,153947207,0.6012195121951219,4175,2459,6634,-
chr1,153947236,0.5722079837805252,3033,2257,5290,-
chr1,153948315,0.7738985724426216,5910,4089,9999,-
chr1,153948317,0.7738985724426216,5910,4089,9999,-
chr1,153948320,1.0756952138574578,4815,3229,8044,-
chr1,153948323,0.7151516051877053,2115,1621,3736,-
chr1,153948340,1.4511066434833009,2080,1283,3363,-
chr1,153949655,0.8938033559022666,1734,1421,3155,-
chr1,153949657,0.8938033559022666,1734,1421,3155,-
chr1,153949757,2.070747132597277,742,490,1232,-
chr1,153949814,1.691470054446461,931,550,1481,-
chr1,153949926,1.8505687248299125,1195,794,1989,-
chr1,153949938,1.8022988505747128,685,434,1119,-
chr1,153949962,0.7663366110255132,1044,908,1952,-
chr1,153949963,0.4252098527590477,514,558,1072,-
chr1,153950017,3.5681152579901174,1148,852,2000,-
chr1,153950058,0.8317300577179222,561,465,1026,-
chr1,153950060,0.8317300577179222,561,465,1026,-
chr1,153954392,2.12396265560166,629,481,1110,-
chr1,153954477,6.72998758496245,3631,2667,6298,-
chr1,153954478,6.729987584962449,3631,2667,6298,-
chr1,153954500,1.3730194323664626,1341,778,2119,-
chr1,153954501,1.1789014183017765,1302,794,2096,-
chr1,153954502,1.1278909863732969,693,420,1113,-
chr1,153954503,1.5903643700237986,1086,644,1730,-
chr1,153955732,1.9592119866814648,613,423,1036,-
chr1,153955760,0.557829181494662,725,561,1286,-
chr1,154129051,0.6926823016788415,1080,917,1997,-
chr1,154129321,2.586816321468436,926,732,1658,-
chr1,154129387,0.5833333333333333,685,587,1272,-
chr1,154129611,2.1654056570829936,1052,780,1832,-
chr1,154129646,1.3007974248142478,1718,1383,3101,-
chr1,154129680,4.39067934152562,1305,907,2212,-
chr1,154129681,3.4886457356149285,2295,1674,3969,-
chr1,154129865,0.6005979980066734,769,490,1259,-
chr1,154129966,1.69683257918552,824,571,1395,-
chr1,154130078,2.029299363057325,1079,784,1863,-
chr1,154130080,2.029299363057325,1079,784,1863,-
chr1,154143138,1.3707685616101206,28339,20567,48906,-
chr1,154143140,1.3749975980932343,25665,20428,46093,-
chr1,154143142,1.5962013392061511,20249,16274,36523,-
chr1,154143144,1.3196840371071266,27551,19000,46551,-
chr1,154143148,1.6348425787106446,11183,8049,19232,-
chr1,154143149,1.3646090121806465,32630,20090,52720,-
chr1,154143179,0.9352610043217658,10664,6396,17060,-
chr1,154144509,1.318200238732977,13606,8316,21922,-
chr1,154144510,1.318200238732977,13606,8316,21922,-
chr1,154144511,1.3606615691167108,15741,9564,25305,-
chr1,154144556,0.684472049689441,1367,804,2171,-
chr1,154145617,1.680726646881056,2610,1821,4431,-
chr1,154145626,1.5831588741567808,2240,1432,3672,-
chr1,154145650,0.6963992059971412,2904,1628,4532,-
chr1,154148614,0.6799090422685928,896,622,1518,-
chr1,154148615,0.6854640323648632,2137,1368,3505,-
chr1,154148632,1.7572755417956654,1055,679,1734,-
chr1,154148643,2.081309241706161,610,421,1031,-
chr1,154148701,1.3951510298303749,601,446,1047,-
chr1,154155520,3.6922956705496452,664,442,1106,-
chr1,154155649,0.8193395622680149,825,600,1425,-
chr1,154155651,0.8193395622680149,825,600,1425,-
chr1,154179364,1.5184235982864107,3152,2040,5192,-
chr1,154179429,1.4055614287091729,5543,3812,9355,-
chr1,154179445,1.6738987906548533,4120,2705,6825,-
chr1,154179482,0.666842426244505,2836,1710,4546,-
chr1,154179546,1.3239549839228295,1646,1243,2889,-
chr1,154179765,1.594268301995471,4290,3115,7405,-
chr1,154179800,0.4653313197149139,1350,1093,2443,-
chr1,154179810,1.5797828947368422,2202,1599,3801,-
chr1,154179811,1.5797828947368422,2202,1599,3801,-
chr1,154179821,1.489553059461158,3297,1755,5052,-
chr1,154179822,1.458370990849054,4736,2847,7583,-
chr1,154179904,1.3412024756852343,2757,1949,4706,-
chr1,154179953,1.957259158751696,1730,1473,3203,-
chr1,154179978,1.6333020540089669,1445,1250,2695,-
chr1,154180002,1.3837726485322348,2462,1642,4104,-
chr1,154180007,1.6511279926335174,2264,1447,3711,-
chr1,154180042,0.7070544198099625,1753,1358,3111,-
chr1,154184843,1.5013034594518422,1521,1244,2765,-
chr1,154185052,1.6290459965928448,1529,1173,2702,-
chr1,154187001,1.5448319796145884,2424,1637,4061,-
chr1,154192385,1.6487902457610972,910,723,1633,-
chr1,154192407,1.6420664206642066,889,812,1701,-
chr1,154192851,1.7974433852166338,1972,1650,3622,-
chr1,154192908,2.177068214804064,1279,831,2110,-
chr1,154192917,1.7932576582968047,1626,1293,2919,-
chr1,154192918,1.7932576582968047,1626,1293,2919,-
chr1,154192933,2.3495994579815975,3619,2666,6285,-
chr1,154192934,2.5323532955777805,2626,1929,4555,-
chr1,154192935,2.5323532955777805,2626,1929,4555,-
chr1,154192936,2.6426415094339624,1936,1377,3313,-
chr1,154192939,2.971764705882353,841,424,1265,-
chr1,154193035,0.5775261953510779,665,436,1101,-
chr1,154193053,1.1889542172179741,1036,772,1808,-
chr1,154193055,1.8077248703762128,1078,785,1863,-
chr1,154522598,2.0551668428818335,841,708,1549,-
chr1,154523902,1.7523178807947015,587,452,1039,-
chr1,154524625,1.2716023114527828,597,440,1037,-
chr1,154525536,0.8056679028669224,916,640,1556,-
chr1,154527234,1.885686328889443,10890,7750,18640,-
chr1,154527235,2.002374548362101,12448,8936,21384,-
chr1,154527237,2.37299248738022,3161,2457,5618,-
chr1,154527922,1.8784730213439602,1981,1136,3117,-
chr1,154527927,1.5979411233519958,1078,790,1868,-
chr1,154555551,0.7660906586526421,643,483,1126,-
chr1,154555553,0.7660906586526421,643,483,1126,-
chr1,154556311,0.9921002283527742,642,490,1132,-
chr1,154556312,0.9921002283527742,642,490,1132,-
chr1,154556959,1.0842338701673713,613,425,1038,-
chr1,154557431,1.125843637231063,961,636,1597,-
chr1,154558325,1.7020833333333336,816,479,1295,-
chr1,154558339,0.5977137231307772,682,388,1070,-
chr1,154558666,1.24997279947775,1331,727,2058,-
chr1,154558667,1.1085249337709793,1691,997,2688,-
chr1,154558668,1.24997279947775,1331,727,2058,-
chr1,154569460,2.4167926003851763,661,448,1109,-
chr1,154569605,1.519956029088449,718,437,1155,-
chr1,154569607,1.5122403927031234,643,375,1018,-
chr1,154574408,2.2610131340368103,614,399,1013,-
chr1,154574441,1.5511084208815311,587,485,1072,-
chr1,154917198,27.85431166427332,871,1089,1960,-
chr1,154917199,30.040617790056718,795,943,1738,-
chr1,154918762,1.6616942765172331,829,541,1370,-
chr1,154918764,1.2792559984508909,1220,835,2055,-
chr1,154935205,3.0997140007622788,615,389,1004,-
chr1,154935436,12.198915130511343,1517,1020,2537,-
chr1,154935437,12.198915130511343,1517,1020,2537,-
chr1,154935438,13.947856049717496,886,595,1481,-
chr1,154936162,2.5662733065578913,655,492,1147,-
chr1,154938424,2.005274634214932,562,471,1033,-
chr1,154938929,0.3764432989054834,1048,827,1875,-
chr1,154938930,0.39870460245173917,1055,818,1873,-
chr1,154938931,0.39257856872396824,863,694,1557,-
chr1,154942609,11.162879362465192,681,356,1037,-
chr1,154942610,11.162879362465192,681,356,1037,-
chr1,155112527,0.3122664673855023,649,550,1199,-
chr1,155112528,0.3122664673855023,649,550,1199,-
chr1,155112530,3.6576783790240865,776,517,1293,-
chr1,155112687,4.618055555555555,455,575,1030,-
chr1,155112707,0.504303493777178,1050,1234,2284,-
chr1,155112708,0.4884453781512605,526,475,1001,-
chr1,155112709,0.5270911617402783,1541,1902,3443,-
chr1,155112743,26.541444371879567,1373,1372,2745,-
chr1,155112744,27.97446647934972,1258,1229,2487,-
chr1,155112745,34.299446326319355,993,902,1895,-
chr1,155112970,12.828004157418896,5002,3359,8361,-
chr1,155112971,12.828004157418894,5002,3359,8361,-
chr1,155112972,12.828004157418894,5002,3359,8361,-
chr1,155141929,0.46843853820598,751,559,1310,-
chr1,155142027,0.5435374149659864,939,599,1538,-
chr1,155142033,2.1327835051546398,861,581,1442,-
chr1,155142297,1.8439294503691552,728,635,1363,-
chr1,155145066,2.044019138755981,800,569,1369,-
chr1,155145098,1.2884683523699796,1310,1006,2316,-
chr1,155145233,2.2690092165898617,605,433,1038,-
chr1,155145315,0.2508928571428571,561,831,1392,-
chr1,155145354,12.868709761021329,3652,4450,8102,-
chr1,155145355,12.868709761021329,3652,4450,8102,-
chr1,155145359,6.830706104616837,1552,940,2492,-
chr1,155145360,15.667718890291814,4552,3210,7762,-
chr1,155145361,15.667718890291816,4552,3210,7762,-
chr1,155145362,10.70423940149626,1532,801,2333,-
chr1,155145702,2.487098365014383,1018,458,1476,-
chr1,155217471,4.307692307692308,593,428,1021,-
chr1,155217472,4.307692307692308,593,428,1021,-
chr1,155217473,4.307692307692308,593,428,1021,-
chr1,155225918,1.8822880370543889,771,538,1309,-
chr1,155225926,3.340908575609931,696,529,1225,-
chr1,155226034,2.8423295454545454,620,395,1015,-
chr1,155226035,2.8423295454545454,620,395,1015,-
chr1,155226157,1.2485970819304153,622,461,1083,-
chr1,155226159,1.2485970819304153,622,461,1083,-
chr1,155226199,0.9713365539452496,753,620,1373,-
chr1,155226200,0.9713365539452496,753,620,1373,-
chr1,155227300,2.641961504672151,826,658,1484,-
chr1,155227302,2.641961504672151,826,658,1484,-
chr1,155227391,2.493774319066148,662,513,1175,-
chr1,155227392,2.493774319066148,662,513,1175,-
chr1,155228691,1.5515090543259555,700,496,1196,-
chr1,155228713,1.190101044722902,779,642,1421,-
chr1,155230346,1.0227589029881294,805,697,1502,-
chr1,155230347,1.0227589029881294,805,697,1502,-
chr1,155235676,3.486438005125173,728,487,1215,-
chr1,155640179,4.155053466548604,707,476,1183,-
chr1,155917036,2.2280820727838293,2037,1401,3438,-
chr1,155917068,0.6009503589121423,742,470,1212,-
chr1,155917071,3.377516252360185,2064,1398,3462,-
chr1,155917086,1.5096928884807672,1171,791,1962,-
chr1,155917087,1.4795072803176523,2458,1499,3957,-
chr1,155917088,1.2352624200235864,1693,979,2672,-
chr1,155917089,1.449820982966258,1287,708,1995,-
chr1,155920094,1.5029965808232848,839,650,1489,-
chr1,155978938,0.7131710604764497,1447,1001,2448,-
chr1,155979012,1.3644655510327153,1573,1187,2760,-
chr1,155979083,1.5861739130434782,1257,919,2176,-
chr1,155979277,1.082215242942702,5889,4189,10078,-
chr1,155979278,0.970563045819654,4532,3051,7583,-
chr1,155979299,1.666900322444974,1229,1018,2247,-
chr1,155981628,0.7062673664711331,1595,1184,2779,-
chr1,155984855,1.8133395090319595,1043,761,1804,-
chr1,155988079,1.3522151467692762,3901,2825,6726,-
chr1,155988133,1.369268959417901,1464,1156,2620,-
chr1,155989864,1.3425986508133474,2203,1395,3598,-
chr1,155989879,1.4137022397891963,1217,965,2182,-
chr1,155989925,1.5334735576923075,1500,959,2459,-
chr1,155989945,2.042320819112628,747,585,1332,-
chr1,155990694,1.7577669902912625,638,514,1152,-
chr1,155990698,1.8290171095641372,2452,1677,4129,-
chr1,155990700,1.8290171095641372,2452,1677,4129,-
chr1,155990702,2.0038524225811227,643,396,1039,-
chr1,155990712,2.111854103343465,1350,734,2084,-
chr1,155990713,2.111854103343465,1350,734,2084,-
chr1,155990714,2.111854103343465,1350,734,2084,-
chr1,156262620,3.717302423479532,1132,862,1994,-
chr1,156262626,6.941537906797606,1682,999,2681,-
chr1,156262627,6.941537906797606,1682,999,2681,-
chr1,156262885,4.4784093711644894,647,515,1162,-
chr1,156264628,0.881717248741683,766,608,1374,-
chr1,156264629,1.458362284210724,661,483,1144,-
chr1,156278836,0.7901340825397606,2920,2058,4978,-
chr1,156278973,1.543830626842526,4930,3371,8301,-
chr1,156278974,0.6204760058704621,1906,1473,3379,-
chr1,156279074,1.5591728091728092,1522,1220,2742,-
chr1,156280425,1.5047932547932548,1834,1331,3165,-
chr1,156280441,1.4180022168446464,5055,3748,8803,-
chr1,156280442,1.3861765036116622,2510,2081,4591,-
chr1,156280445,2.213589522047867,2574,2193,4767,-
chr1,156280461,1.6928303905831996,1090,889,1979,-
chr1,156280463,1.4372569812654648,2032,1310,3342,-
chr1,156280755,1.498958775050963,2744,2309,5053,-
chr1,156280872,0.6505755226685459,954,644,1598,-
chr1,156280984,1.400769125120176,2603,1617,4220,-
chr1,156287207,1.21755103350395,12248,9207,21455,-
chr1,156287219,1.3487268348911616,20054,14462,34516,-
chr1,156287221,1.3487268348911616,20054,14462,34516,-
chr1,156287228,1.4841499225415615,5348,3544,8892,-
chr1,156287252,1.3485357265856175,17578,11745,29323,-
chr1,156287253,1.370989194924753,10192,5928,16120,-
chr1,156287255,1.9449039048916876,4037,3273,7310,-
chr1,156287327,1.395312384895333,65802,59341,125143,-
chr1,156287331,1.306518826625961,71476,62763,134239,-
chr1,156287333,1.3091444082969872,86653,75545,162198,-
chr1,156287337,1.5063834479063638,11570,11442,23012,-
chr1,156287338,1.364709188627773,14286,13280,27566,-
chr1,156288664,1.2083185051003775,9642,8744,18386,-
chr1,156288666,0.8803236001149221,13522,10494,24016,-
chr1,156288667,1.1841995831950476,15407,12483,27890,-
chr1,156288674,1.1787875654263587,59016,47685,106701,-
chr1,156288675,1.2145487041656013,77374,62241,139615,-
chr1,156288677,1.2605261382788142,70833,55919,126752,-
chr1,156288678,1.1334391937012807,64636,50155,114791,-
chr1,156288680,0.9196266796547087,71548,55764,127312,-
chr1,156288681,0.7773367180678581,49615,38817,88432,-
chr1,156288682,0.8961858889853107,38353,31034,69387,-
chr1,156288684,1.499281673488806,10850,9033,19883,-
chr1,156288686,1.3773108609941636,18254,14185,32439,-
chr1,156288687,1.3203621697641714,11359,8567,19926,-
chr1,156288694,1.3977950628694789,19570,14287,33857,-
chr1,156288695,1.419218529492905,16054,11552,27606,-
chr1,156288723,0.8128214789565462,3091,2328,5419,-
chr1,156288756,1.4601462865716428,2030,1332,3362,-
chr1,156288760,1.351782363977486,3024,2254,5278,-
chr1,156290715,1.7301322880940715,2206,2197,4403,-
chr1,156290727,1.422634142414362,2109,1910,4019,-
chr1,156294819,1.386476303787428,2184,1844,4028,-
chr1,156305648,1.4098819698819698,2013,1574,3587,-
chr1,156305650,0.7366647326774229,5424,4118,9542,-
chr1,156305652,0.9316339214952862,8745,6212,14957,-
chr1,156305661,1.3797308500588044,2289,2033,4322,-
chr1,156305670,0.7595672280786785,2118,1833,3951,-
chr1,156308000,1.5375752735508363,3531,2292,5823,-
chr1,156308029,0.8291458451957865,2827,1892,4719,-
chr1,156308037,1.6177942648530883,784,628,1412,-
chr1,156308043,2.651303155006859,603,404,1007,-
chr1,156308047,0.5570135052179251,853,542,1395,-
chr1,156308053,0.8459128916060042,1715,1310,3025,-
chr1,156308054,1.0239653368846648,1731,1213,2944,-
chr1,156564944,2.1125000000000003,1312,930,2242,-
chr1,156564953,1.7142857142857144,619,433,1052,-
chr1,156565049,1.9351115670684789,502,556,1058,-
chr1,156565080,5.599711411815459,1006,1064,2070,-
chr1,156614946,2.6471053731785914,1716,1303,3019,-
chr1,156614947,2.6471053731785914,1716,1303,3019,-
chr1,156670835,4.363270777479893,650,372,1022,-
chr1,156693986,0.940934045788092,692,586,1278,-
chr1,156697124,1.5888774336622695,864,722,1586,-
chr1,156697125,2.2010955538923462,793,680,1473,-
chr1,156707158,1.438056134255744,2922,1456,4378,-
chr1,156707162,1.528786515565917,19550,10490,30040,-
chr1,156707163,1.4142592480135427,24557,13228,37785,-
chr1,156707165,1.4516523453331984,18653,10147,28800,-
chr1,156707167,1.7996780727772554,5762,3605,9367,-
chr1,156707170,1.0523542703308177,6282,3193,9475,-
chr1,156707191,1.4000000401987949,4705,2368,7073,-
chr1,156707287,1.5723684210526316,1194,721,1915,-
chr1,156707442,2.4067495559502663,812,562,1374,-
chr1,156707477,1.075594035103984,1808,1364,3172,-
chr1,156707494,0.4049586776859504,741,582,1323,-
chr1,156707496,2.1309343160632994,982,658,1640,-
chr1,156707845,1.5329066537857745,1153,844,1997,-
chr1,156707847,0.5878977569118414,804,638,1442,-
chr1,156707874,0.6042464323007309,743,662,1405,-
chr1,156707924,0.5754734167505634,1276,1226,2502,-
chr1,156707925,0.5754734167505634,1276,1226,2502,-
chr1,156708140,23.966423126802816,4772,5166,9938,-
chr1,156708142,25.120009144495416,7611,5971,13582,-
chr1,156708143,40.236406977553955,5181,3248,8429,-
chr1,156708144,38.94225750929987,2118,1161,3279,-
chr1,156708146,5.764430336267874,3078,499,3577,-
chr1,156708148,6.064263485672775,1962,295,2257,-
chr1,156708156,5.863524077007287,1564,318,1882,-
chr1,156708158,7.348416289592761,1014,220,1234,-
chr1,156708180,0.1854706160154895,1311,495,1806,-
chr1,156708219,2.029206349206349,798,449,1247,-
chr1,156708388,0.491832229580574,556,452,1008,-
chr1,156708396,1.625302247037923,1246,1111,2357,-
chr1,156708398,1.8529644268774703,1171,1034,2205,-
chr1,156708399,2.1681159420289853,747,644,1391,-
chr1,156708548,0.6009740259740259,616,439,1055,-
chr1,156712084,1.4148973433205798,4200,2650,6850,-
chr1,156712085,1.4148973433205798,4200,2650,6850,-
chr1,156712086,0.7138298594609274,1501,1132,2633,-
chr1,156712113,0.6648404255319148,1292,1127,2419,-
chr1,156712114,1.7847004608294932,1029,874,1903,-
chr1,156712119,2.205311778290993,1060,865,1925,-
chr1,156712154,1.6262829077926855,3146,2627,5773,-
chr1,156712311,1.6810757473967075,1270,915,2185,-
chr1,156712493,1.382095607156913,3163,1942,5105,-
chr1,156712525,0.8766082825617775,11120,7608,18728,-
chr1,156712526,0.7419371236550099,11811,7760,19571,-
chr1,156712527,0.7419371236550099,11811,7760,19571,-
chr1,156712528,0.8633883561878876,12766,8811,21577,-
chr1,156712530,0.749111175394722,5096,3503,8599,-
chr1,156712535,0.6674877627720477,3981,3028,7009,-
chr1,156712536,0.6674877627720477,3981,3028,7009,-
chr1,156712659,0.618705035971223,1203,972,2175,-
chr1,156712662,1.0393187258620336,2822,2035,4857,-
chr1,156712671,7.538955536806864,7371,5654,13025,-
chr1,156712672,4.081714314201414,5480,4181,9661,-
chr1,156712707,0.5847283523533077,1075,908,1983,-
chr1,156712722,0.4876512110984308,2944,3336,6280,-
chr1,156712723,0.4222588235294117,1993,2379,4372,-
chr1,156712724,0.5928899996719718,2264,2132,4396,-
chr1,156712729,0.5771840736652764,2019,2005,4024,-
chr1,156712754,0.4454044391479219,649,958,1607,-
chr1,156712759,7.918660153911176,2527,3051,5578,-
chr1,156712773,13.440925435807378,7394,6405,13799,-
chr1,156712774,13.440925435807378,7394,6405,13799,-
chr1,156712775,13.440925435807376,7394,6405,13799,-
chr1,156712779,9.235131335951348,2503,1509,4012,-
chr1,156712789,2.1390123731302118,3258,1350,4608,-
chr1,156712790,2.7809527025965335,3355,1648,5003,-
chr1,156712791,2.510597746842967,6002,2500,8502,-
chr1,156712792,2.738545481725092,1862,786,2648,-
chr1,156712793,2.7953321960137156,4589,1744,6333,-
chr1,156712795,6.843211363701747,4872,1610,6482,-
chr1,156712796,7.424109053257151,8067,2426,10493,-
chr1,156712797,7.733999645012643,8552,2527,11079,-
chr1,156712798,9.457203308051099,8505,2212,10717,-
chr1,156712799,15.13452532992763,1947,521,2468,-
chr1,156712800,6.053800634442244,5136,708,5844,-
chr1,156712801,9.380349510208235,6581,956,7537,-
chr1,156712802,9.002810311345357,6513,908,7421,-
chr1,156712803,15.646929824561404,1426,227,1653,-
chr1,156712890,2.2372016760794318,1534,997,2531,-
chr1,156713026,1.4140225303535978,3009,2291,5300,-
chr1,156713084,1.675792369565995,1867,1504,3371,-
chr1,156713110,0.5884875474187696,891,644,1535,-
chr1,156713147,2.7846638655462184,722,611,1333,-
chr1,156713454,1.6624634502923978,826,719,1545,-
chr1,156713521,1.6103648757016835,1189,927,2116,-
chr1,156713542,0.5498319979322822,1012,729,1741,-
chr1,156713641,0.65625,1028,783,1811,-
chr1,156713643,1.567392276725809,840,705,1545,-
chr1,156714003,2.293087086648661,848,720,1568,-
chr1,156714107,1.6746302616609783,1023,878,1901,-
chr1,156714831,1.574002834581899,1013,897,1910,-
chr1,156714839,1.5258465274285922,1943,1216,3159,-
chr1,156714909,0.722053627714005,5276,2755,8031,-
chr1,156714910,0.722053627714005,5276,2755,8031,-
chr1,156714923,0.63383796829576,2100,1235,3335,-
chr1,156714931,1.3025627728078135,1506,856,2362,-
chr1,156715132,1.2031922733268083,7486,5021,12507,-
chr1,156715134,1.0244269134478088,4658,3233,7891,-
chr1,156715138,1.192845046570703,1609,1180,2789,-
chr1,156715139,1.192845046570703,1609,1180,2789,-
chr1,156715157,0.6656723541343514,796,577,1373,-
chr1,156721192,1.6286524286524287,1001,714,1715,-
chr1,156721195,1.619096229753641,642,473,1115,-
chr1,156721201,1.7391914654688376,825,547,1372,-
chr1,156721458,0.48546222613096673,1231,935,2166,-
chr1,156721459,0.4721413183764214,1248,888,2136,-
chr1,156721471,0.2937364400207605,766,678,1444,-
chr1,159887950,5.095270487094328,10587,14708,25295,-
chr1,159887951,4.903811802546698,9684,12898,22582,-
chr1,159887968,5.73030396070003,3170,3256,6426,-
chr1,159887970,24.870242747944673,13184,12890,26074,-
chr1,159887971,31.021525783649025,11573,11211,22784,-
chr1,159887974,14.450916420805495,10013,5139,15152,-
chr1,159887975,15.17223667358574,8053,4403,12456,-
chr1,159887980,6.395923167168956,4457,2035,6492,-
chr1,159887984,15.180766319142418,20803,7067,27870,-
chr1,159887985,15.180766319142418,20803,7067,27870,-
chr1,159887986,15.180766319142418,20803,7067,27870,-
chr1,159888028,0.5641098484848485,1553,791,2344,-
chr1,159888071,1.8144144144144143,1006,584,1590,-
chr1,159888074,1.8111367904087825,1285,643,1928,-
chr1,159888076,1.8459064327485384,855,479,1334,-
chr1,159888078,1.733186285586594,4234,2191,6425,-
chr1,159888079,1.733186285586594,4234,2191,6425,-
chr1,159888088,1.8127240143369172,2736,1115,3851,-
chr1,159888089,1.8127240143369172,2736,1115,3851,-
chr1,159888090,1.8127240143369172,2736,1115,3851,-
chr1,159888095,2.431300880544941,812,462,1274,-
chr1,159888300,2.222439721189837,1887,1542,3429,-
chr1,159888466,1.5843014177752794,2229,1778,4007,-
chr1,159888528,1.5352272727272729,1350,1007,2357,-
chr1,159888558,0.6663667961562053,1357,1004,2361,-
chr1,159888584,1.7563423473654869,1119,843,1962,-
chr1,159888599,1.555371874803199,1282,947,2229,-
chr1,159888659,1.4968142968142968,1805,1484,3289,-
chr1,159888671,1.4101512397771934,3602,2845,6447,-
chr1,159888696,1.5791705722528577,3890,2476,6366,-
chr1,159888708,1.4954768262065117,1940,1090,3030,-
chr1,159889162,1.4419334097194487,6731,4521,11252,-
chr1,159889163,1.4458380374546886,5780,4255,10035,-
chr1,159889552,1.4862946817785527,2582,1849,4431,-
chr1,159889599,1.58566620348927,2646,1904,4550,-
chr1,159889608,1.459001044087434,3755,3298,7053,-
chr1,159889609,1.459001044087434,3755,3298,7053,-
chr1,159890147,1.5134561233439503,5043,2987,8030,-
chr1,159890148,1.4595902825502503,8999,5545,14544,-
chr1,159890150,1.2252359738194303,6782,4274,11056,-
chr1,159890278,1.4374359779709789,6547,4129,10676,-
chr1,159890279,1.391576735498599,2494,1675,4169,-
chr1,159890301,1.4862539164202815,2104,1332,3436,-
chr1,159895267,0.6309027119344087,3000,2251,5251,-
chr1,159895272,1.303299539170507,1963,874,2837,-
chr1,159895293,1.8964433529469042,2141,1118,3259,-
chr1,159895296,0.8420923369700987,3241,1621,4862,-
chr1,159895297,0.6693168699493047,1801,686,2487,-
chr1,160063587,3.2010380031902397,709,448,1157,-
chr1,160064884,2.4219742702032874,607,455,1062,-
chr1,160185568,17.520035119409094,516,773,1289,-
chr1,160185570,19.793295196993075,457,625,1082,-
chr1,160186672,5.629786197869173,1595,1403,2998,-
chr1,160186673,7.538594535260222,2909,2211,5120,-
chr1,160186674,7.538594535260221,2909,2211,5120,-
chr1,160186675,8.223964256584365,2374,1686,4060,-
chr1,160186681,6.5760163227360975,804,368,1172,-
chr1,160186988,9.403830546376227,478,585,1063,-
chr1,160209542,8.472008548117532,663,423,1086,-
chr1,160247758,0.4021795280856739,628,474,1102,-
chr1,160248615,0.9478243835938202,568,467,1035,-
chr1,160248828,1.1244270546174286,655,461,1116,-
chr1,160250030,1.0720063820965806,807,566,1373,-
chr1,160251833,1.1534323922734029,1048,672,1720,-
chr1,160251835,0.9945719452375128,1345,879,2224,-
chr1,160251914,9.52095158529357,846,625,1471,-
chr1,160253378,1.7468559462285773,1197,928,2125,-
chr1,160253379,1.3860467847721167,956,649,1605,-
chr1,160253382,0.4889397406559878,640,436,1076,-
chr1,160253385,2.4375,1013,655,1668,-
chr1,160253387,2.4375,1013,655,1668,-
chr1,160253392,0.8360700602079912,610,405,1015,-
chr1,160253393,0.8360700602079912,610,405,1015,-
chr1,160259549,2.6805702716974857,692,464,1156,-
chr1,160259604,0.49370728650428464,799,523,1322,-
chr1,160259644,1.2692901850863187,1164,838,2002,-
chr1,160259973,0.4380873410724157,633,401,1034,-
chr1,160260408,2.404279084135206,981,726,1707,-
chr1,160261275,2.675742574257426,657,403,1060,-
chr1,160261662,2.671012412282863,1044,772,1816,-
chr1,160261866,2.2890122725233173,938,675,1613,-
chr1,160261971,1.9832995235046362,1013,669,1682,-
chr1,160263190,2.133090824772431,1020,711,1731,-
chr1,160263221,1.089757211657069,822,613,1435,-
chr1,160264349,3.175917075633391,1140,947,2087,-
chr1,160264350,3.4788732394366195,740,638,1378,-
chr1,160265573,0.5172599784250269,684,514,1198,-
chr1,160265593,0.5115222330412204,787,552,1339,-
chr1,160265594,1.9417948218804757,664,466,1130,-
chr1,160265602,1.7686377829820457,624,426,1050,-
chr1,160267194,2.088625370572632,581,441,1022,-
chr1,160267377,1.7288263081491684,3171,3175,6346,-
chr1,160267378,1.9261228365834735,1932,2198,4130,-
chr1,160267381,0.5820158102766798,1082,835,1917,-
chr1,160267384,1.325488625312613,2571,2379,4950,-
chr1,160267385,1.6413398692810457,1616,1631,3247,-
chr1,160267388,1.5282124087578162,2240,1944,4184,-
chr1,160267389,2.034692380253642,1437,1315,2752,-
chr1,160267395,1.600530249143195,1862,1513,3375,-
chr1,160267396,1.6051552135060467,3477,2580,6057,-
chr1,160267397,1.600530249143195,1862,1513,3375,-
chr1,160267489,2.6430034129692834,725,585,1310,-
chr1,160267490,2.6430034129692834,725,585,1310,-
chr1,160268934,2.179229942299379,826,640,1466,-
chr1,160269015,1.0934816433162524,1002,748,1750,-
chr1,160275261,2.0750656327321826,681,612,1293,-
chr1,160275270,3.6405962917327406,1617,1176,2793,-
chr1,160275271,4.382093493949946,2428,1733,4161,-
chr1,160275549,2.1112299465240643,563,439,1002,-
chr1,160276149,1.9473319473319477,561,480,1041,-
chr1,160276193,2.336510586671149,1202,879,2081,-
chr1,160276215,1.0706305994569087,1190,906,2096,-
chr1,160276249,2.031746031746032,615,440,1055,-
chr1,160276985,1.6139243555769693,816,592,1408,-
chr1,160277007,2.087983115683947,1438,797,2235,-
chr1,160277012,1.6114285714285712,986,734,1720,-
chr1,160278901,1.5876524264387628,1816,1142,2958,-
chr1,160280022,2.1362596719924554,1195,766,1961,-
chr1,160281683,1.805263157894737,685,455,1140,-
chr1,160283872,1.10375191424196,743,652,1395,-
chr1,160283873,1.10375191424196,743,652,1395,-
chr1,160303405,1.7712415873200333,1711,1234,2945,-
chr1,160305055,1.7003165711812869,1470,955,2425,-
chr1,160305104,1.9874877810361686,781,464,1245,-
chr1,160309987,0.417042042042042,605,431,1036,-
chr1,160312950,0.408017179670723,899,761,1660,-
chr1,160312983,2.4590016478400485,1734,2033,3767,-
chr1,160312984,1.725410192545215,2320,2496,4816,-
chr1,160312985,0.8392044092978673,1750,1604,3354,-
chr1,160312987,0.5629243351889073,1104,1008,2112,-
chr1,160312990,1.8695589837701438,632,657,1289,-
chr1,160312992,1.8695589837701438,632,657,1289,-
chr1,161070530,2.2578403755868544,1092,851,1943,-
chr1,161071874,1.7730028700946008,22432,16279,38711,-
chr1,161071875,1.7550466702452225,32829,23817,56646,-
chr1,161071877,1.9869318274388457,22940,16818,39758,-
chr1,161071878,1.9396369453453006,20087,13610,33697,-
chr1,161071881,1.3944660406334988,16425,10781,27206,-
chr1,161071882,1.3959097579474407,24836,15569,40405,-
chr1,161071927,1.3545707686421056,3879,2402,6281,-
chr1,161071933,1.3784427284427283,2072,1109,3181,-
chr1,161071955,2.233101348412353,2825,1814,4639,-
chr1,161072087,1.8913214990138063,1337,779,2116,-
chr1,161072091,1.459030178454639,2195,1250,3445,-
chr1,161072132,1.4076700512895899,9026,5418,14444,-
chr1,161072136,1.5570196998768426,2752,1910,4662,-
chr1,161072144,0.49188658217296105,4772,2613,7385,-
chr1,161072147,0.9491258050369578,5172,3289,8461,-
chr1,161072151,1.0565559135687175,4782,3059,7841,-
chr1,161072162,1.6345857418111753,892,691,1583,-
chr1,161087746,0.2708633093525179,1003,555,1558,-
chr1,161087747,0.6133714707888565,2399,1712,4111,-
chr1,161087751,0.9745028034447025,2780,2004,4784,-
chr1,161087754,3.789488339997321,7322,4652,11974,-
chr1,161087755,3.789488339997321,7322,4652,11974,-
chr1,161087758,3.267898984639417,1045,500,1545,-
chr1,161087763,3.3790106951871652,1010,439,1449,-
chr1,161087787,0.5157408254781733,866,445,1311,-
chr1,161087829,0.5756107663035336,747,468,1215,-
chr1,161087836,1.2716779404400567,1050,683,1733,-
chr1,161141876,2.3245006657789613,758,750,1508,-
chr1,161141878,1.8297956698472404,1078,987,2065,-
chr1,165631654,12.922750947769517,3466,2446,5912,-
chr1,165631655,12.922750947769515,3466,2446,5912,-
chr1,165631656,10.650896722325292,1244,692,1936,-
chr1,165631673,2.553613204166238,691,408,1099,-
chr1,165632187,1.649620549414818,758,483,1241,-
chr1,165632344,2.822010771761773,837,549,1386,-
chr1,165636644,2.185469631905592,827,659,1486,-
chr1,165636685,1.5936579988927726,988,707,1695,-
chr1,165638680,3.0374355174788574,855,623,1478,-
chr1,165696874,1.4365441370883696,9295,8341,17636,-
chr1,165696877,1.3750988142292488,2413,1869,4282,-
chr1,165696913,1.9265267657304408,2879,2611,5490,-
chr1,165696936,2.569513304736969,2470,1856,4326,-
chr1,165697347,1.8375,566,479,1045,-
chr1,165738095,0.6416429098709711,630,494,1124,-
chr1,165738103,0.3844916135223623,678,463,1141,-
chr1,167510442,2.20947459086994,1165,859,2024,-
chr1,167510590,1.7226184086087466,4347,3725,8072,-
chr1,167510592,1.6800026824890941,6368,5398,11766,-
chr1,167510594,1.6350850629576927,10591,8130,18721,-
chr1,167510595,1.270649817588525,11756,8878,20634,-
chr1,167510596,1.270649817588525,11756,8878,20634,-
chr1,167510685,1.385893322031846,1285,994,2279,-
chr1,167510688,1.6287112724374,2459,1690,4149,-
chr1,167515342,1.5410454223148062,2617,1968,4585,-
chr1,167515425,0.6949713529183501,2341,1717,4058,-
chr1,167515508,1.6779661016949154,1132,823,1955,-
chr1,167517283,1.4372776193136707,1714,1096,2810,-
chr1,167517340,1.5370009737098345,1434,1026,2460,-
chr1,167517351,1.7922794117647058,1074,730,1804,-
chr1,167522664,1.6888077858880777,630,410,1040,-
chr1,167887532,0.5567401960784314,648,543,1191,-
chr1,167889826,1.0499391515994436,832,718,1550,-
chr1,167889827,0.8188656858747075,1398,1115,2513,-
chr1,167905002,0.657020031749819,779,572,1351,-
chr1,167905203,8.200591545462549,644,464,1108,-
chr1,169101952,0.5731115731115731,826,480,1306,-
chr1,169101954,2.013866142591986,1580,1277,2857,-
chr1,169101961,2.5777442562079367,1480,1111,2591,-
chr1,169101997,2.077722200846479,899,564,1463,-
chr1,169102004,1.7922928051001823,850,548,1398,-
chr1,169102006,1.5704805309044876,1807,1462,3269,-
chr1,169102009,1.8117360918690928,1417,801,2218,-
chr1,169102011,1.5284609178247472,4221,2725,6946,-
chr1,169102012,1.3174837780408675,2636,1523,4159,-
chr1,169102028,1.5933043187144291,660,514,1174,-
chr1,169102031,1.4860963166133951,1571,1076,2647,-
chr1,169102032,1.7658552210121716,1191,891,2082,-
chr1,169102051,1.6971613613014453,1035,675,1710,-
chr1,169433419,3.8150172539151344,626,443,1069,-
chr1,173833355,1.0211731404707076,45160,30993,76153,-
chr1,173833356,1.0211731404707076,45160,30993,76153,-
chr1,173833582,0.9573613242243144,11828,9077,20905,-
chr1,173833583,1.0103639853328532,12280,9458,21738,-
chr1,173833644,1.308858031973858,1660,1240,2900,-
chr1,173833645,1.308858031973858,1660,1240,2900,-
chr1,173833842,0.633569839050967,3331,2353,5684,-
chr1,173833843,1.15953173790798,946,682,1628,-
chr1,173834041,1.182835607015935,590,571,1161,-
chr1,173834042,0.704030042674004,933,616,1549,-
chr1,173834421,1.1684450991165085,934,627,1561,-
chr1,173834565,0.9733037126025904,47089,34655,81744,-
chr1,173834566,0.9978962351530529,14630,13729,28359,-
chr1,173834567,1.0068432269610892,11514,10083,21597,-
chr1,173834821,0.5977641056422569,1284,951,2235,-
chr1,173835162,0.882788076852343,80029,67242,147271,-
chr1,173835164,0.9233016378931151,110634,92601,203235,-
chr1,173835165,0.9950365591274545,41851,35145,76996,-
chr1,173835166,0.7913718606535242,14963,12879,27842,-
chr1,173835318,1.2473918518650535,28190,20826,49016,-
chr1,173835849,0.9731967770743104,7531,4403,11934,-
chr1,173835850,0.9604082879141104,10157,6391,16548,-
chr1,173835851,0.9485241820768135,1815,1405,3220,-
chr1,173835934,0.7910047185389147,709,576,1285,-
chr1,173836145,0.7969555218043002,6934,5140,12074,-
chr1,173836148,1.2836583152582886,4022,3305,7327,-
chr1,173836162,0.7135550671812463,3714,2331,6045,-
chr1,173836164,1.2221078889928283,5598,4275,9873,-
chr1,173836165,1.2221078889928283,5598,4275,9873,-
chr1,173836178,0.7326432096761588,1818,1646,3464,-
chr1,173837103,2.6972318339100343,1558,951,2509,-
chr1,173837108,0.6911997024219717,2199,1872,4071,-
chr1,173837110,1.781327964284151,1196,681,1877,-
chr1,173837112,0.6717593321782959,852,906,1758,-
chr1,173837114,0.3468736593736594,760,591,1351,-
chr1,173837115,1.3267173812816966,858,481,1339,-
chr1,173837116,0.49375350719158856,642,690,1332,-
chr1,173837117,0.6125,587,479,1066,-
chr1,173837118,1.4834605597964376,741,523,1264,-
chr1,173837120,0.3784033060928708,974,675,1649,-
chr1,173837121,0.9009046241447399,852,1036,1888,-
chr1,173837123,1.1596659615218847,2964,2754,5718,-
chr1,173837124,1.040110849183927,1444,1821,3265,-
chr1,173837125,1.0142448144018938,2680,2471,5151,-
chr1,173837126,0.9690146096159027,1815,1716,3531,-
chr1,174992560,1.0155943606438487,1040,670,1710,-
chr1,176055006,3.3015698871184855,633,469,1102,-
chr1,180257483,0.4696819085487077,674,502,1176,-
chr1,180257539,3.2463408919844374,657,471,1128,-
chr1,180461431,2.196078431372549,639,407,1046,-
chr1,180464642,1.8460869565217397,771,551,1322,-
chr1,180471338,1.7413640319317962,6486,4252,10738,-
chr1,180471339,1.873308396435849,3079,2327,5406,-
chr1,180471343,1.764155090557412,2743,1935,4678,-
chr1,180471345,2.0270244045191275,7101,4552,11653,-
chr1,180471346,1.7242460427117239,6504,4082,10586,-
chr1,180471347,1.9968142800106468,5053,3263,8316,-
chr1,180471348,2.034159951117721,4833,2990,7823,-
chr1,180471350,1.8419119342196264,3328,1924,5252,-
chr1,180471352,1.784507894618177,3192,1826,5018,-
chr1,180471391,2.0142857142857142,657,349,1006,-
chr1,180471457,0.4900937356743278,1742,1058,2800,-
chr1,180471459,0.5189542336889228,2017,1222,3239,-
chr1,180944737,17.73791688848747,1040,1039,2079,-
chr1,180944738,17.73791688848747,1040,1039,2079,-
chr1,182352835,2.5926587914470187,796,589,1385,-
chr1,183595530,1.6727471002280163,1435,916,2351,-
chr1,183595552,1.4488700266800008,2361,1657,4018,-
chr1,183595589,1.9833439287984749,820,604,1424,-
chr1,183595766,1.629847749707211,1187,694,1881,-
chr1,183595876,1.511967997901502,1047,662,1709,-
chr1,183595883,2.1550865343420527,3468,2458,5926,-
chr1,183595884,2.254387327224724,1527,1095,2622,-
chr1,183596146,2.0673854447439357,766,582,1348,-
chr1,183596147,1.559250603425156,968,606,1574,-
chr1,183596241,2.27027027027027,767,591,1358,-
chr1,183596570,2.148349163274536,949,669,1618,-
chr1,183596652,1.7795138888888888,1024,767,1791,-
chr1,183596680,2.294513179128564,897,675,1572,-
chr1,183599713,0.7496331866079766,1685,1376,3061,-
chr1,183599715,1.4085637198219978,1317,905,2222,-
chr1,183599733,1.8073512906846239,748,659,1407,-
chr1,183599740,1.7264677786758762,958,877,1835,-
chr1,183602233,1.5736357890301285,678,490,1168,-
chr1,183602253,1.9213747959836134,978,876,1854,-
chr1,183604730,1.0407938257993383,943,906,1849,-
chr1,183604732,1.0407938257993383,943,906,1849,-
chr1,183604784,2.425307950727883,636,469,1105,-
chr1,183604786,1.7633082706766918,532,531,1063,-
chr1,183604793,2.2879923318381272,1550,1420,2970,-
chr1,183604825,2.417484453071641,1461,842,2303,-
chr1,183604826,2.417484453071641,1461,842,2303,-
chr1,183604828,0.2598314606741573,924,622,1546,-
chr1,183604829,1.720403022670025,682,396,1078,-
chr1,183604849,6.275561326753794,4321,2807,7128,-
chr1,183604850,6.013546079361381,3958,2553,6511,-
chr1,183604888,1.0715679427897737,1566,941,2507,-
chr1,183604889,1.2852171023466394,2779,1640,4419,-
chr1,183604890,1.7922782874617738,787,479,1266,-
chr1,183604937,1.2442264834791377,2408,2002,4410,-
chr1,183604938,1.4602079861753996,1614,981,2595,-
chr1,183604940,2.319767441860465,944,386,1330,-
chr1,184679603,2.068214245682733,1622,1290,2912,-
chr1,184679604,2.031351132686084,1572,1338,2910,-
chr1,184679606,1.9419306184012064,1029,857,1886,-
chr1,184679610,1.878592718756653,904,670,1574,-
chr1,184679611,1.878592718756653,904,670,1574,-
chr1,185267078,20.197007003836365,3367,2846,6213,-
chr1,185267079,22.719632277764056,3816,3383,7199,-
chr1,185267202,2.5689935064935066,632,439,1071,-
chr1,185267218,1.59865282065675,711,508,1219,-
chr1,185267241,2.0129623141984885,980,688,1668,-
chr1,185267243,2.0129623141984885,980,688,1668,-
chr1,185269234,2.745550224423464,656,496,1152,-
chr1,185269673,1.8894736842105262,717,512,1229,-
chr1,185269678,1.3288250973520657,1325,1022,2347,-
chr1,185269683,2.3863944043321297,640,553,1193,-
chr1,185276204,1.7187381223869251,1291,876,2167,-
chr1,185276209,1.7080646792820553,2443,1745,4188,-
chr1,185276217,1.958269554361396,1918,1334,3252,-
chr1,185276219,1.958269554361396,1918,1334,3252,-
chr1,185277960,1.028192460500406,1353,1057,2410,-
chr1,185278181,0.6016078225567134,1448,1016,2464,-
chr1,186283126,12.051892838488802,1432,1170,2602,-
chr1,186283127,13.088053079838224,781,678,1459,-
chr1,186286653,2.2491475066435274,635,406,1041,-
chr1,186286728,0.9779904306220096,510,494,1004,-
chr1,186286730,0.9779904306220096,510,494,1004,-
chr1,186289465,0.9954805296539169,821,635,1456,-
chr1,186296773,1.984884789305853,1468,1180,2648,-
chr1,186296774,1.8251930695645064,2153,1702,3855,-
chr1,186296775,2.036736272235112,686,430,1116,-
chr1,186296776,1.966004123069742,1403,1093,2496,-
chr1,186296777,0.5542445733935096,1516,1268,2784,-
chr1,186296778,0.5542445733935096,1516,1268,2784,-
chr1,186304496,2.127190329439975,932,675,1607,-
chr1,186310168,1.6165923514937888,655,488,1143,-
chr1,186313517,0.45732411983029864,1811,1062,2873,-
chr1,186313518,0.48779511804721876,1430,832,2262,-
chr1,186319367,1.9081463634994729,575,457,1032,-
chr1,186319368,1.9081463634994729,575,457,1032,-
chr1,186331998,2.1421052631578945,628,379,1007,-
chr1,186332002,1.941860884679619,1849,1164,3013,-
chr1,186332004,2.2026502476241467,1869,1204,3073,-
chr1,186332005,2.126685691903083,1225,776,2001,-
chr1,186344102,3.5196918914855786,818,556,1374,-
chr1,186643641,2.3631904693249433,917,708,1625,-
chr1,186643642,2.1606962153410243,627,548,1175,-
chr1,192983684,1.1401384083044983,658,458,1116,-
chr1,192983685,1.615014916807485,1024,804,1828,-
chr1,192983688,2.085665529010239,678,585,1263,-
chr1,192983690,2.3331366082277385,973,822,1795,-
chr1,192983692,1.6218872560190924,893,701,1594,-
chr1,192985123,1.523138832997988,756,496,1252,-
chr1,192997231,1.6001541745730548,770,543,1313,-
chr1,192998578,1.8977072310405645,806,566,1372,-
chr1,192998675,3.407524030493868,708,430,1138,-
chr1,192998676,1.6131621187800962,803,533,1336,-
chr1,193020921,1.8326214382507031,1173,900,2073,-
chr1,193020922,2.518957151081504,805,578,1383,-
chr1,197065258,2.086489928847496,4094,3290,7384,-
chr1,197065262,0.6021880232104768,1093,738,1831,-
chr1,197065275,2.1312100597814885,1425,1077,2502,-
chr1,197065277,1.503192306369712,1659,1132,2791,-
chr1,197065281,1.3999047683831032,1469,963,2432,-
chr1,197069566,2.33001808318264,858,552,1410,-
chr1,197069579,3.0599018475750577,730,432,1162,-
chr1,197069581,1.9252899539096637,942,672,1614,-
chr1,197069583,1.8168994015389,932,725,1657,-
chr1,197069713,4.493933854080106,844,546,1390,-
chr1,197069714,4.493933854080106,844,546,1390,-
chr1,197070571,2.7915057915057915,722,517,1239,-
chr1,197070572,2.4592976630676313,1415,952,2367,-
chr1,200375939,3.5350613083318025,829,767,1596,-
chr1,200375940,3.926621160409557,589,585,1174,-
chr1,200375943,1.5978410512631047,895,683,1578,-
chr1,200573017,1.3493618688350315,800,428,1228,-
chr1,200587571,2.0517205093128488,708,558,1266,-
chr1,200587572,1.8084458553452452,1246,882,2128,-
chr1,200587584,3.4944264731596433,673,402,1075,-
chr1,200613540,2.556988366345496,601,428,1029,-
chr1,200617630,1.5142206783820378,5590,3806,9396,-
chr1,200617634,1.727188912458493,2113,1498,3611,-
chr1,200617672,1.492597087378641,1254,823,2077,-
chr1,200618274,1.1716091372022763,810,535,1345,-
chr1,201104022,0.4426847662141779,586,467,1053,-
chr1,201104104,2.547623258982017,767,592,1359,-
chr1,201104428,0.3247058823529411,689,424,1113,-
chr1,201104439,0.6011614401858305,646,491,1137,-
chr1,201104455,3.0039113428943938,671,412,1083,-
chr1,201104533,4.046020336503576,2785,2233,5018,-
chr1,201104534,4.118870963417138,2502,1932,4434,-
chr1,201104552,57.89904374823382,1641,1021,2662,-
chr1,201104684,0.5349119611414693,880,548,1428,-
chr1,201104789,1.0094725763068648,663,502,1165,-
chr1,201104791,1.0094725763068648,663,502,1165,-
chr1,201104893,2.0010380173867914,700,366,1066,-
chr1,201112983,1.982050469855348,721,450,1171,-
chr1,201113073,2.265219183729559,633,382,1015,-
chr1,201120909,1.761363636363636,729,583,1312,-
chr1,201120937,0.5802417324156455,1114,850,1964,-
chr1,201120938,1.5850156087408949,951,619,1570,-
chr1,201120971,2.424489795918368,593,440,1033,-
chr1,201120972,1.6013071895424835,979,764,1743,-
chr1,201123035,2.0817547357926225,575,471,1046,-
chr1,201123057,2.1535444947209657,1209,849,2058,-
chr1,201123058,2.1535444947209657,1209,849,2058,-
chr1,201123595,4.939682069875565,763,747,1510,-
chr1,201123597,0.9168926311783454,1256,881,2137,-
chr1,201123598,1.4760047512098833,4378,3379,7757,-
chr1,201123599,1.345606463532951,3637,2873,6510,-
chr1,201123600,1.4314963844996116,4203,3206,7409,-
chr1,201452747,0.5284953395472703,755,750,1505,-
chr1,201452750,2.108489141015743,1082,960,2042,-
chr1,201452778,7.08459252913158,4129,2834,6963,-
chr1,201452779,6.645257435018454,6011,4625,10636,-
chr1,201452789,4.0205188425362675,9489,6453,15942,-
chr1,201452790,4.0205188425362675,9489,6453,15942,-
chr1,201452791,3.0948469006721435,3023,1853,4876,-
chr1,201452849,1.5287298021882472,958,745,1703,-
chr1,201452897,1.515002718727826,8159,5233,13392,-
chr1,201452898,1.476142599093419,5973,3847,9820,-
chr1,201452910,0.546363206591477,1617,1138,2755,-
chr1,201452986,1.4452808159280182,2797,2136,4933,-
chr1,201453144,1.3353843410023185,1796,1245,3041,-
chr1,201453156,0.7441077441077439,2144,1619,3763,-
chr1,201453202,1.584029799355182,1744,1388,3132,-
chr1,201453203,1.496842105263158,1421,873,2294,-
chr1,201453205,1.0696948638105301,2659,2142,4801,-
chr1,201453398,0.66958545339802,1060,938,1998,-
chr1,201453409,2.386498582557646,2148,1643,3791,-
chr1,201453410,2.4520586820397603,7548,6136,13684,-
chr1,201453411,2.2096790098314414,4104,3191,7295,-
chr1,201453419,3.1997125627256606,4284,3615,7899,-
chr1,201453420,3.047331810193467,7712,5894,13606,-
chr1,201453421,2.921180510365824,9412,6998,16410,-
chr1,201453422,3.9858061685233426,8960,6495,15455,-
chr1,201453434,0.5265993265993266,735,527,1262,-
chr1,201453435,1.7019092299442082,1883,1145,3028,-
chr1,201453440,0.5173436492585428,1002,563,1565,-
chr1,201453441,1.7433409973260392,1927,1281,3208,-
chr1,201453444,2.0443349753694577,912,538,1450,-
chr1,201453557,2.3717728055077454,1377,1161,2538,-
chr1,201453660,1.499540936489561,1365,1065,2430,-
chr1,201454424,0.6667149044375303,1499,1086,2585,-
chr1,201458004,1.3241564497935805,2250,1612,3862,-
chr1,201458013,1.798116028708134,1178,759,1937,-
chr1,201458058,1.5981020790109763,2861,2014,4875,-
chr1,201458070,0.6950617283950618,1125,665,1790,-
chr1,201458075,0.6161720557114031,625,520,1145,-
chr1,201459390,1.4909638554216866,1484,995,2479,-
chr1,201459391,0.6517222273524794,940,832,1772,-
chr1,201459459,1.477358490566038,1673,1059,2732,-
chr1,201465379,1.6181033282272663,1262,834,2096,-
chr1,201465406,1.688326624496837,1100,704,1804,-
chr1,201465407,0.5968013468013468,708,593,1301,-
chr1,201465409,1.0421578977942276,1949,1443,3392,-
chr1,201465420,1.588477366255144,771,485,1256,-
chr1,201476238,1.7363984267327095,977,711,1688,-
chr1,202103133,1.9935926773455377,1209,574,1783,-
chr1,202103134,1.9720017636684306,1788,839,2627,-
chr1,202103136,2.034188034188034,1175,545,1720,-
chr1,202103141,1.9559034572733205,936,510,1446,-
chr1,202103142,1.461174637951689,1438,752,2190,-
chr1,202104591,0.46079232292701294,611,564,1175,-
chr1,202300910,1.3679127984084882,942,831,1773,-
chr1,202301020,1.0108019041524143,3231,2529,5760,-
chr1,202302141,0.6452815549253922,3373,2460,5833,-
chr1,202302202,1.367707299697224,1653,1190,2843,-
chr1,202302203,1.4716330051760886,1499,1001,2500,-
chr1,202302591,1.7067006269592475,1404,927,2331,-
chr1,202304145,1.5865547975639718,1213,980,2193,-
chr1,202304156,2.054048325561679,880,673,1553,-
chr1,202304185,0.7677940471912804,1404,1011,2415,-
chr1,202304793,1.3574573863636363,830,639,1469,-
chr1,202304802,1.8667443667443664,929,593,1522,-
chr1,202304804,0.7532656627007238,952,706,1658,-
chr1,202304805,0.6355111802892829,619,496,1115,-
chr1,202304877,2.225855855855856,796,554,1350,-
chr1,202304884,0.47834123603632567,743,540,1283,-
chr1,202304892,1.7325047801147226,696,522,1218,-
chr1,202304898,2.0280320366132725,708,459,1167,-
chr1,202910113,3.193405511811024,720,507,1227,-
chr1,202910229,1.7302377341299933,1774,1250,3024,-
chr1,202910470,2.6126299298869267,1431,1039,2470,-
chr1,202910602,1.8066148563166453,713,502,1215,-
chr1,202910770,1.8804916317991636,798,477,1275,-
chr1,202910815,2.1747751575667444,829,522,1351,-
chr1,202911204,1.0052651907869328,988,862,1850,-
chr1,202911205,1.0052651907869328,988,862,1850,-
chr1,202912977,1.0367580250671138,1103,880,1983,-
chr1,202914266,1.6061179395547238,1743,1206,2949,-
chr1,202915580,1.1109825562742246,1341,954,2295,-
chr1,202915708,1.650078575170246,734,580,1314,-
chr1,202915715,5.223583816863305,2509,1801,4310,-
chr1,202917509,2.69740760203188,1620,691,2311,-
chr1,202917513,1.6975609756097565,1478,614,2092,-
chr1,202917516,0.5414041167821886,1212,551,1763,-
chr1,202917524,1.66566518447302,1231,627,1858,-
chr1,202917533,1.743679599499374,1031,469,1500,-
chr1,202917537,1.7410092807424593,827,430,1257,-
chr1,202920096,3.0511881385592763,993,647,1640,-
chr1,202920146,0.5560528570184281,1091,796,1887,-
chr1,202920161,1.6308691308691308,652,461,1113,-
chr1,202920214,3.13588850174216,599,450,1049,-
chr1,202920216,3.13588850174216,599,450,1049,-
chr1,202927439,0.8123812536945736,601,437,1038,-
chr1,204372658,2.58850261304249,711,488,1199,-
chr1,204372659,1.4739928607853134,860,741,1601,-
chr1,204372767,2.3529411764705883,767,575,1342,-
chr1,204372779,0.54642499722006,701,528,1229,-
chr1,204373134,2.056889843016235,1094,770,1864,-
chr1,204373373,1.5363060303931741,3651,2410,6061,-
chr1,204373375,1.2899622691742036,3196,2067,5263,-
chr1,204373379,0.6859037213428585,1468,967,2435,-
chr1,204373381,0.6859037213428585,1468,967,2435,-
chr1,204373435,0.6555678364189002,729,516,1245,-
chr1,204373495,0.5194547442155034,699,618,1317,-
chr1,204373840,2.273509174311927,609,435,1044,-
chr1,204373946,1.978161170561258,646,481,1127,-
chr1,204374196,1.8966763642775282,693,596,1289,-
chr1,204374308,2.1978056426332286,778,579,1357,-
chr1,204374408,0.6335453100158983,796,628,1424,-
chr1,204374565,1.93338618794356,1175,885,2060,-
chr1,204374614,1.3260130718954248,2535,1699,4234,-
chr1,204374711,0.8551863200012348,5795,4052,9847,-
chr1,204374712,0.7080123329907503,4991,3499,8490,-
chr1,204378691,1.6266943866943868,630,480,1110,-
chr1,204378762,2.074743213695107,1428,933,2361,-
chr1,204378985,2.751408987052552,668,504,1172,-
chr1,204379078,1.6580787138008306,2481,1870,4351,-
chr1,204379087,2.422382671480144,670,553,1223,-
chr1,204379135,1.6262626262626259,919,549,1468,-
chr1,204379216,1.7498011928429424,606,502,1108,-
chr1,204379372,2.768986568986569,781,545,1326,-
chr1,204379377,1.885090780057957,624,456,1080,-
chr1,204379684,2.121312562147829,639,430,1069,-
chr1,204379781,1.8335719057161943,738,498,1236,-
chr1,204379810,1.7095873409866582,869,585,1454,-
chr1,204379895,1.897942197471488,1424,1028,2452,-
chr1,204379900,0.6827859836580766,1336,1031,2367,-
chr1,204379950,0.5556818181818182,814,499,1313,-
chr1,204380070,1.4484118291347206,1063,769,1832,-
chr1,204380090,0.5581074873679375,809,621,1430,-
chr1,204380176,1.9564530313088306,904,542,1446,-
chr1,204380347,1.717948717948718,803,584,1387,-
chr1,204380469,0.9044075283272518,896,507,1403,-
chr1,204380470,0.9044075283272518,896,507,1403,-
chr1,204380547,1.680942334739803,582,473,1055,-
chr1,204380765,1.4669604342643778,982,682,1664,-
chr1,205065943,2.2062504233464897,600,653,1253,-
chr1,205070750,0.509090909090909,623,389,1012,-
chr1,205070755,1.0933450489941523,947,684,1631,-
chr1,205682480,2.8964019851116625,608,402,1010,-
chr1,205682905,1.9116337481447652,597,460,1057,-
chr1,205683023,1.7844444444444445,802,599,1401,-
chr1,205683369,4.160201735992367,2623,3197,5820,-
chr1,205683370,4.160201735992367,2623,3197,5820,-
chr1,205683416,16.178221512917084,3416,2240,5656,-
chr1,205683417,16.5057597718693,3632,2325,5957,-
chr1,205683418,14.030155696158422,3566,2099,5665,-
chr1,205683420,10.527477179284608,3031,1130,4161,-
chr1,205683421,20.611789064226343,2722,952,3674,-
chr1,205683422,18.868063995536442,3381,1171,4552,-
chr1,205683423,16.43799321870057,1012,340,1352,-
chr1,205683431,2.946059113300493,885,279,1164,-
chr1,205683433,2.8027577016534133,1118,359,1477,-
chr1,205683438,2.322097378277154,867,266,1133,-
chr1,205683439,2.4636106771969057,1081,336,1417,-
chr1,205683515,0.3971614829363699,737,511,1248,-
chr1,205683729,0.6730018028846153,866,623,1489,-
chr1,205683956,2.109223971278652,610,425,1035,-
chr1,205684061,2.516730401529637,701,522,1223,-
chr1,205684179,2.132448607858444,744,548,1292,-
chr1,205684452,1.978576669458253,1256,882,2138,-
chr1,205684599,1.8382113821138213,968,737,1705,-
chr1,205684600,1.8382113821138213,968,737,1705,-
chr1,205684681,1.6462189697230594,3529,2759,6288,-
chr1,205684682,1.475440925858477,6904,5152,12056,-
chr1,205684684,1.8382312762542263,3337,2491,5828,-
chr1,205684688,1.6391304347826086,1507,1034,2541,-
chr1,205684711,2.723619464188081,1106,707,1813,-
chr1,205684734,3.7244027936322666,1563,1019,2582,-
chr1,205684770,1.7312995013200352,907,486,1393,-
chr1,205685051,2.0749922528664397,647,460,1107,-
chr1,205685064,2.653065079438455,953,646,1599,-
chr1,205685318,2.009057059474691,712,522,1234,-
chr1,205685801,1.476470588235294,752,509,1261,-
chr1,205685810,0.5310077519379844,684,429,1113,-
chr1,205685833,4.39920634920635,722,419,1141,-
chr1,205686009,1.786354107108824,720,476,1196,-
chr1,205686092,2.5375647668393784,652,385,1037,-
chr1,205686111,1.2521241476428937,1005,689,1694,-
chr1,205686493,2.3228534402694425,980,698,1678,-
chr1,205686503,1.4860628714204043,1115,826,1941,-
chr1,205686749,31.586688118487995,2751,3237,5988,-
chr1,205686750,40.023315949168015,5261,4894,10155,-
chr1,205686751,40.728914746332265,6179,5005,11184,-
chr1,205686752,57.60638425160493,3659,1987,5646,-
chr1,205686753,52.84435406754838,3387,705,4092,-
chr1,205686755,6.167211753580688,4183,530,4713,-
chr1,205686756,6.681493052024731,5793,798,6591,-
chr1,205686757,7.504792121694741,6965,944,7909,-
chr1,205686758,7.363574491973001,5789,793,6582,-
chr1,205686759,9.764235957899164,4882,643,5525,-
chr1,205686761,14.39578947368421,1051,94,1145,-
chr1,205687182,1.722004357298475,759,458,1217,-
chr1,205687207,0.37266195523767487,670,444,1114,-
chr1,205687208,1.076398868851699,748,582,1330,-
chr1,205687210,0.8354105571847508,1112,867,1979,-
chr1,205687211,1.062123851757998,724,573,1297,-
chr1,205687333,1.7407069970845477,931,685,1616,-
chr1,205687356,1.9161635582981518,1257,903,2160,-
chr1,205688802,1.662581699346405,554,458,1012,-
chr1,205688803,1.228197317086206,1387,1070,2457,-
chr1,205689665,2.313807531380753,552,477,1029,-
chr1,205689718,1.643950380017145,3612,2888,6500,-
chr1,205689719,1.9844871968567943,1518,1341,2859,-
chr1,205693069,1.467946498819827,1195,1270,2465,-
chr1,205693076,2.261239258254184,2154,2009,4163,-
chr1,205693077,2.261239258254184,2154,2009,4163,-
chr1,205696849,1.447547329386507,956,808,1764,-
chr1,205698729,1.5100446428571428,2936,2135,5071,-
chr1,205698733,1.2896160074335692,2671,1862,4533,-
chr1,205698737,0.5262060620197986,2042,1820,3862,-
chr1,205698748,0.4320857863751051,1643,1623,3266,-
chr1,205698749,0.46515092468093766,1991,1821,3812,-
chr1,205719100,0.5726967736313531,1812,2353,4165,-
chr1,205719102,0.6008292790800531,3376,4521,7897,-
chr1,205719103,0.601530388506106,2433,3321,5754,-
chr1,205719104,0.557079435443048,3651,4675,8326,-
chr1,205719107,1.7028535980148882,670,805,1475,-
chr1,205719112,0.5515734540538841,604,921,1525,-
chr1,205719116,1.841843088418431,608,510,1118,-
chr1,205719121,0.3721958925750395,495,843,1338,-
chr1,205719126,0.4463327837708636,1690,2884,4574,-
chr1,205719127,0.4149984601170311,1224,2291,3515,-
chr1,205719128,0.4149984601170311,1224,2291,3515,-
chr1,205719129,0.42441054091539526,1053,1518,2571,-
chr1,205719130,0.42441054091539526,1053,1518,2571,-
chr1,205719131,0.41800451507085595,1392,2207,3599,-
chr1,205719136,0.3433649289099526,566,1265,1831,-
chr1,205719137,0.44527002537151134,545,711,1256,-
chr1,205719138,0.38655214808290067,1961,3726,5687,-
chr1,205719139,0.4333394053436189,1279,2088,3367,-
chr1,205719140,0.39290509087699776,1282,2725,4007,-
chr1,205719141,0.4144214031450477,626,702,1328,-
chr1,205719142,0.3860131317758436,473,1061,1534,-
chr1,205719143,1.2281423218403462,875,1398,2273,-
chr1,205719145,5.910525325327143,1664,2851,4515,-
chr1,205719146,7.638928033840659,1562,2533,4095,-
chr1,205719147,9.99584336123348,1277,2097,3374,-
chr1,205719148,21.579508726567557,745,883,1628,-
chr1,205719149,28.64928716904277,555,490,1045,-
chr1,205737423,2.745800395256917,1169,1011,2180,-
chr1,205737430,1.724508212863983,2105,1562,3667,-
chr1,205737459,1.2842260237801857,749,552,1301,-
chr1,205737468,1.740623219552907,1059,720,1779,-
chr1,206765072,2.14311816405873,883,668,1551,-
chr1,206765157,2.0568913397364943,635,519,1154,-
chr1,206769176,0.5933179723502304,720,587,1307,-
chr1,206772438,3.6628217849366504,685,556,1241,-
chr1,206776414,2.165482803100286,937,654,1591,-
chr1,206778772,0.9429767087965508,857,576,1433,-
chr1,206778773,0.9429767087965508,857,576,1433,-
chr1,206781638,1.6903219792833801,755,586,1341,-
chr1,206784562,3.3211125158027803,709,564,1273,-
chr1,206784564,3.3211125158027803,709,564,1273,-
chr1,206784673,2.6138547377671126,940,656,1596,-
chr1,206785741,2.5614454790899055,705,478,1183,-
chr1,211836807,2.6923494009897224,940,553,1493,-
chr1,211836809,2.738095238095238,689,359,1048,-
chr1,211836863,3.1393310038976647,682,469,1151,-
chr1,211840572,1.6458539224977569,677,402,1079,-
chr1,211842504,2.170643153526971,557,481,1038,-
chr1,211842509,1.8352638352638355,712,480,1192,-
chr1,211848786,2.377204585537919,788,503,1291,-
chr1,211848787,2.16787532590893,1710,1327,3037,-
chr1,211848789,2.002612421161851,2146,1789,3935,-
chr1,211848790,1.529333810836285,810,786,1596,-
chr1,211848794,1.5837913997651851,702,592,1294,-
chr1,211848796,0.8674128282393457,619,605,1224,-
chr1,211848798,0.8707207888103082,622,523,1145,-
chr1,212538457,1.056038616725586,662,449,1111,-
chr1,212911895,0.44668920613059077,1184,831,2015,-
chr1,212911897,0.4969802555168408,777,573,1350,-
chr1,212965109,3.221036523609231,913,419,1332,-
chr1,214527711,2.5997150997151,729,467,1196,-
chr1,214527732,2.2058921495397343,636,431,1067,-
chr1,214527745,1.7138422062147631,732,454,1186,-
chr1,220142080,0.4647577092511014,632,453,1085,-
chr1,220142142,2.3354673495518568,911,567,1478,-
chr1,220142258,2.073740085719575,1650,1237,2887,-
chr1,220142259,2.156966898761647,1823,1215,3038,-
chr1,220146731,4.10562015503876,891,687,1578,-
chr1,220151969,1.3781858537913347,4912,3742,8654,-
chr1,220151995,0.7837385100381619,3412,2624,6036,-
chr1,220151996,0.7837385100381619,3412,2624,6036,-
chr1,220152012,0.5683713348241343,1045,810,1855,-
chr1,220153493,1.8592022116903635,806,632,1438,-
chr1,220153513,1.6260096930533117,792,618,1410,-
chr1,220154113,1.9166860868989872,1305,1015,2320,-
chr1,220156610,2.002908627394721,1541,1215,2756,-
chr1,220157565,1.8545086119554208,571,469,1040,-
chr1,220157589,1.847345132743363,667,451,1118,-
chr1,220160496,1.6569736410433828,1109,852,1961,-
chr1,220160497,0.5357142857142857,575,447,1022,-
chr1,220162015,1.7876840140991086,957,688,1645,-
chr1,220162018,1.556903718683294,1013,620,1633,-
chr1,220162109,2.049057283535487,1874,1513,3387,-
chr1,220162110,2.074922663421066,2745,2190,4935,-
chr1,220162112,1.994484555670159,1800,1416,3216,-
chr1,220170345,2.380361173814898,702,442,1144,-
chr1,220170385,2.3672890216579536,586,514,1100,-
chr1,220170460,3.735294117647059,634,509,1143,-
chr1,220170623,1.5223823540655224,1047,706,1753,-
chr1,220178699,3.2237343494828528,657,500,1157,-
chr1,220179457,2.204654197477164,653,483,1136,-
chr1,220179461,2.185897435897436,626,467,1093,-
chr1,220179469,1.8437246963562754,827,569,1396,-
chr1,220179511,2.096082089552239,748,535,1283,-
chr1,220180581,0.5050872093023256,833,575,1408,-
chr1,220184373,1.665193281363015,739,540,1279,-
chr1,220197610,2.022699573430835,780,546,1326,-
chr1,220197613,2.0916666666666663,752,503,1255,-
chr1,220198555,1.1341091690805687,1251,1117,2368,-
chr1,220198578,2.29757785467128,663,577,1240,-
chr1,220203749,1.898589494163424,632,513,1145,-
chr1,220203821,0.8051905279451964,3055,2093,5148,-
chr1,220205737,0.9584978640702884,4690,3140,7830,-
chr1,220205739,0.9058601268621003,7921,5590,13511,-
chr1,220205741,0.8333106668479985,3231,2450,5681,-
chr1,220205742,1.412261483843445,2055,1396,3451,-
chr1,220205752,1.1373432150270888,3381,2196,5577,-
chr1,220205753,0.977331796505978,2275,1371,3646,-
chr1,220205759,1.675855996869497,1841,1344,3185,-
chr1,220205760,1.675855996869497,1841,1344,3185,-
chr1,220205851,0.6577756025939068,895,742,1637,-
chr1,220205852,1.6705761316872427,705,539,1244,-
chr1,220219781,1.8685814346598817,724,565,1289,-
chr1,220231196,3.102448568208065,610,511,1121,-
chr1,220231258,3.8864820728175737,800,528,1328,-
chr1,220231265,1.5060511856753382,1632,1247,2879,-
chr1,220231266,1.7897727272727273,719,511,1230,-
chr1,220231267,0.9130498033016491,892,595,1487,-
chr1,220231844,1.6613922384823279,709,533,1242,-
chr1,220340716,0.6241380787185747,766,542,1308,-
chr1,220340722,2.077302973591183,1288,915,2203,-
chr1,220340723,2.077302973591183,1288,915,2203,-
chr1,222757505,1.9821428571428572,776,769,1545,-
chr1,222757506,1.9821428571428572,776,769,1545,-
chr1,224575818,0.29746618533263364,1013,1593,2606,-
chr1,224575820,0.2533385531675852,543,767,1310,-
chr1,224575826,9.923696057858788,864,1365,2229,-
chr1,224575827,10.674601192841628,784,1215,1999,-
chr1,224588750,1.9427525175465368,691,564,1255,-
chr1,224588751,1.3988425543604963,1154,877,2031,-
chr1,224588759,0.39855074419910264,598,426,1024,-
chr1,225590074,1.536087605774017,3085,2008,5093,-
chr1,225590139,3.017543859649123,895,607,1502,-
chr1,225590157,0.3554022988505747,1545,999,2544,-
chr1,225590158,1.4890564181859434,3484,2281,5765,-
chr1,225590166,1.858736842105263,980,499,1479,-
chr1,225590173,1.7246919146748363,2643,1433,4076,-
chr1,225590190,1.852374839537869,1442,778,2220,-
chr1,225591023,0.9570153595938418,695,565,1260,-
chr1,225611780,1.2374362107286843,929,672,1601,-
chr1,225684027,9.699242302772637,1114,775,1889,-
chr1,225684028,10.466059185991199,899,536,1435,-
chr1,225684498,21.985067269278506,1715,1118,2833,-
chr1,225684499,21.985067269278506,1715,1118,2833,-
chr1,226107737,1.597413202586257,1659,1218,2877,-
chr1,226107766,0.3606478381947979,922,876,1798,-
chr1,226107829,12.12390516369009,2331,1893,4224,-
chr1,226107830,12.12390516369009,2331,1893,4224,-
chr1,226107831,12.642359877962175,2486,1975,4461,-
chr1,226107997,0.8458403260608965,881,775,1656,-
chr1,226107998,0.6142423250148005,1940,1636,3576,-
chr1,226108028,1.0780073800738006,540,541,1081,-
chr1,226108029,1.0780073800738006,540,541,1081,-
chr1,226108046,1.4742887376979383,1304,1038,2342,-
chr1,226109339,5.091073873752769,737,519,1256,-
chr1,226109716,2.208384299733282,646,440,1086,-
chr1,226109981,1.3952804787566382,643,589,1232,-
chr1,226111424,1.7723945179736122,2531,1768,4299,-
chr1,226111428,1.8547243107769424,1662,1139,2801,-
chr1,226111429,1.709789832238812,2385,1616,4001,-
chr1,226111431,1.6645092090697142,2115,1402,3517,-
chr1,226352563,1.7647925494753418,1389,1265,2654,-
chr1,226352566,1.3071300893743798,1152,950,2102,-
chr1,226352598,1.224307985161665,835,633,1468,-
chr1,226548842,1.7916523334479992,624,458,1082,-
chr1,226548905,2.0647969052224373,853,563,1416,-
chr1,226549062,1.9525422953225278,4468,3383,7851,-
chr1,226549063,1.9525422953225278,4468,3383,7851,-
chr1,226549118,1.8007067894624118,884,643,1527,-
chr1,226549676,1.624375,1129,799,1928,-
chr1,226549710,0.5920444033302498,895,643,1538,-
chr1,226549750,1.820136852394917,930,626,1556,-
chr1,226549764,3.548446069469835,646,546,1192,-
chr1,226550813,1.7222417222417223,639,406,1045,-
chr1,226551677,0.3736100815418828,671,425,1096,-
chr1,226552723,2.6066101694915256,1182,707,1889,-
chr1,226552725,2.356326246945645,1731,1160,2891,-
chr1,226555195,1.0333914878656043,1775,1476,3251,-
chr1,226555209,0.4636031244806381,796,546,1342,-
chr1,226555225,2.01,736,659,1395,-
chr1,226555226,1.6137295081967211,584,487,1071,-
chr1,226555233,1.9571106094808128,577,442,1019,-
chr1,226555298,0.5828020966142513,725,542,1267,-
chr1,226555300,1.899715660542432,598,507,1105,-
chr1,226555918,1.6309127248501003,951,552,1503,-
chr1,226561972,2.592375366568915,883,619,1502,-
chr1,226562012,1.734169278996865,921,604,1525,-
chr1,226562015,2.931864406779661,836,589,1425,-
chr1,226562028,0.6425189393939393,825,615,1440,-
chr1,226564864,0.5850016168386395,994,666,1660,-
chr1,226564890,1.7019858453679864,1025,907,1932,-
chr1,226564950,2.08686581488344,1101,775,1876,-
chr1,226566894,0.2297653055508878,585,540,1125,-
chr1,226566900,0.4586720867208672,676,539,1215,-
chr1,226567280,1.9747340425531918,593,469,1062,-
chr1,226567704,1.8998848750414512,833,604,1437,-
chr1,226567821,0.3929131799163179,600,477,1077,-
chr1,226568772,3.3946506550218336,690,457,1147,-
chr1,226568797,0.528195601366333,677,406,1083,-
chr1,226568798,1.4850669390344502,987,730,1717,-
chr1,226568900,1.3690334134288307,1279,934,2213,-
chr1,226570754,2.695322838147734,980,662,1642,-
chr1,226573245,1.6092782884462193,1012,878,1890,-
chr1,226573289,1.7561557023129035,1318,831,2149,-
chr1,226573301,3.89937106918239,650,370,1020,-
chr1,226576370,2.6017992424242427,784,659,1443,-
chr1,226576396,1.7758276131722996,928,676,1604,-
chr1,226578153,0.4919384337273508,961,714,1675,-
chr1,226578203,2.012531328320802,656,377,1033,-
chr1,226579905,2.240661938534279,676,469,1145,-
chr1,228645211,1.8835270800251473,665,530,1195,-
chr1,229738623,0.5619355072771763,1144,807,1951,-
chr1,229738660,1.8650325646442363,876,685,1561,-
chr1,229738661,1.8650325646442363,876,685,1561,-
chr1,231057238,2.458056985111027,653,441,1094,-
chr1,231359982,2.9673573132956887,1001,784,1785,-
chr1,231359987,1.6289316702819954,800,460,1260,-
chr1,231359988,2.0291523391368815,1022,842,1864,-
chr1,231359990,1.928512960436562,797,732,1529,-
chr1,231359991,1.8310249307479225,660,360,1020,-
chr1,231359993,1.7423379595092867,1225,818,2043,-
chr1,231359994,1.6504515042601025,1730,1065,2795,-
chr1,231506311,1.640190016774084,6108,4042,10150,-
chr1,231506312,1.8186441361832457,4247,2603,6850,-
chr1,231506314,1.9125608766233768,2117,1279,3396,-
chr1,231506320,1.8610102604577743,1937,1085,3022,-
chr1,231506321,1.8610102604577743,1937,1085,3022,-
chr1,231506333,2.0074322144356844,1828,1153,2981,-
chr1,231506336,1.6685714285714286,875,524,1399,-
chr1,232626650,4.630846915021688,677,379,1056,-
chr1,234740107,2.5541052631578944,673,474,1147,-
chr1,234740109,2.5541052631578944,673,474,1147,-
chr1,234740152,2.947908758023704,644,397,1041,-
chr1,234742937,2.126150751876746,835,620,1455,-
chr1,235272823,1.838345864661654,977,702,1679,-
chr1,235272859,1.5312738367658276,1094,827,1921,-
chr1,235272860,2.058319738988581,720,612,1332,-
chr1,235273182,1.6372493910436574,770,592,1362,-
chr1,235273189,0.5773678056385605,807,715,1522,-
chr1,235273190,0.5198265179677819,838,537,1375,-
chr1,235273217,1.5928030303030303,840,527,1367,-
chr1,235273218,2.602587800369686,703,540,1243,-
chr1,235273420,2.103373033912173,660,646,1306,-
chr1,235273501,0.5481306778476589,501,635,1136,-
chr1,235273533,8.566088883454956,3061,3296,6357,-
chr1,235273534,8.566088883454956,3061,3296,6357,-
chr1,235273552,2.1922839107432828,980,711,1691,-
chr1,235273586,0.18067716121954822,569,780,1349,-
chr1,235273616,13.518831470220654,3609,3288,6897,-
chr1,235273617,13.518831470220654,3609,3288,6897,-
chr1,235273618,13.518831470220654,3609,3288,6897,-
chr1,235273625,21.653641375208473,1554,844,2398,-
chr1,235273631,18.475713337762187,3480,914,4394,-
chr1,235273632,18.53160997765563,3487,893,4380,-
chr1,235273633,18.18666341369954,1884,508,2392,-
chr1,235273744,0.4949715182233007,1728,1362,3090,-
chr1,235273745,0.4872519406281464,1153,932,2085,-
chr1,235273916,2.0257907118585,749,498,1247,-
chr1,235274034,2.7453703703703702,592,413,1005,-
chr1,235274083,2.096846846846846,664,443,1107,-
chr1,235274086,1.8413216664490009,612,402,1014,-
chr1,235274105,1.6933920213951417,920,640,1560,-
chr1,235274641,2.0804626815265115,600,563,1163,-
chr1,235274681,1.6540642722117205,699,528,1227,-
chr1,235275250,2.432522123893805,732,564,1296,-
chr1,235277122,1.519279571408431,1164,691,1855,-
chr1,235277143,2.1648099245819497,2047,1254,3301,-
chr1,235283164,2.0243767313019387,695,379,1074,-
chr1,235283167,1.6036844591402928,775,583,1358,-
chr1,235291962,1.0803861917922253,1868,1449,3317,-
chr1,235291963,1.5476895734597156,824,632,1456,-
chr1,235291968,1.7454545454545456,671,549,1220,-
chr1,235291971,2.4548490314821976,1519,1068,2587,-
chr1,235292053,2.5142857142857142,1249,624,1873,-
chr1,235292054,2.5142857142857142,1249,624,1873,-
chr1,235292145,0.5531914893617021,584,422,1006,-
chr1,235292149,0.7737379770402915,2048,1438,3486,-
chr1,235292151,0.8719853564617979,1324,992,2316,-
chr1,235295156,4.446428571428571,663,447,1110,-
chr1,235295158,4.446428571428571,663,447,1110,-
chr1,235301223,1.533777986881798,2770,1570,4340,-
chr1,235301230,1.971101223581757,2160,1549,3709,-
chr1,235301407,1.4302470561071348,1601,914,2515,-
chr1,235301411,1.998277054308993,2783,1680,4463,-
chr1,235301435,1.6416382252559725,961,585,1546,-
chr1,235301459,2.049562682215744,1405,685,2090,-
chr1,235301460,2.049562682215744,1405,685,2090,-
chr1,235301464,2.4843243243243247,1148,665,1813,-
chr1,235336038,3.2910861475099114,598,407,1005,-
chr1,236719482,1.768511846719152,567,450,1017,-
chr1,240654129,6.012862392940093,1473,1367,2840,-
chr1,240654130,6.161813515907983,1729,1652,3381,-
chr1,240654131,9.375462964982617,1063,769,1832,-
chr1,240654133,19.27407612987631,1019,628,1647,-
chr1,240654470,0.2591899850858975,469,738,1207,-
chr1,240654474,7.091503267973856,433,611,1044,-
chr1,240654475,13.519846038083484,1110,1534,2644,-
chr1,240654476,13.57027933376894,911,1198,2109,-
chr1,240654477,19.9213048855906,478,587,1065,-
chr1,240655226,1.3375457770211248,615,477,1092,-
chr1,240655297,2.2043324792603607,1795,1665,3460,-
chr1,240655299,2.1417732923296366,4150,3580,7730,-
chr1,240655300,1.8982309859154929,3335,2839,6174,-
chr1,240655301,1.8982309859154929,3335,2839,6174,-
chr1,240655302,1.91273566249176,2458,2049,4507,-
chr1,240655495,0.5200447700447701,806,545,1351,-
chr1,240655497,0.5200447700447701,806,545,1351,-
chr1,241663766,1.7651174295759189,6131,4856,10987,-
chr1,241663789,1.5335122363319167,6368,4461,10829,-
chr1,241663790,1.5335122363319167,6368,4461,10829,-
chr1,241663795,1.3504261013746273,5716,3830,9546,-
chr1,241663796,1.331515450845867,8151,5530,13681,-
chr1,241663799,1.3379588550396702,11107,7336,18443,-
chr1,241663800,1.1497539542235906,24723,17598,42321,-
chr1,241663801,1.052612254605421,17748,13187,30935,-
chr1,241663802,1.2008163933655172,21742,15561,37303,-
chr1,241663804,1.6009012974803962,5258,3268,8526,-
chr1,241663805,1.0584796063254263,6924,4938,11862,-
chr1,241663807,1.7234146077742336,1770,1046,2816,-
chr1,241663810,0.7037702661364332,1635,933,2568,-
chr1,241663813,1.6621766519233347,2917,1657,4574,-
chr1,241663814,1.6621766519233347,2917,1657,4574,-
chr1,241663816,1.7986764553820702,1774,1526,3300,-
chr1,241663817,1.613652034015169,1238,686,1924,-
chr1,241663832,0.6417569521574216,1913,1202,3115,-
chr1,241663833,1.0135322323566562,3466,2344,5810,-
chr1,241663852,1.716923076923077,1487,1039,2526,-
chr1,241665753,0.3246912070441481,884,628,1512,-
chr1,241667360,1.6593992248062013,684,515,1199,-
chr1,241669336,2.2179700499168056,773,600,1373,-
chr1,241669350,0.6891510385158297,1366,1043,2409,-
chr1,241669397,1.5626167099241877,2266,1555,3821,-
chr1,241669426,3.3142605633802824,752,496,1248,-
chr1,241671951,2.237484737484737,732,545,1277,-
chr1,241671979,1.823695238095238,747,524,1271,-
chr1,241675425,1.9426847662141782,1471,951,2422,-
chr1,241680551,1.7239332096474953,1413,1154,2567,-
chr1,241680552,1.399506633423228,4145,2928,7073,-
chr1,241680555,1.85310778606868,2563,1968,4531,-
chr1,241680556,1.85310778606868,2563,1968,4531,-
chr1,241680559,3.518479669278707,1187,852,2039,-
chr1,241680571,1.4651941097724228,2188,1493,3681,-
chr1,241680572,1.4651941097724228,2188,1493,3681,-
chr1,241680587,1.1724797546980033,2011,1524,3535,-
chr1,241680591,1.1725905566374668,2269,1561,3830,-
chr1,241680607,0.5591120289106867,721,595,1316,-
chr1,241680608,2.546626984126984,905,503,1408,-
chr1,241682894,1.8671289613574702,1868,1042,2910,-
chr1,241682895,1.9175870574197655,1869,988,2857,-
chr1,241682916,1.037611080733669,1460,813,2273,-
chr1,241682918,1.5465445043675587,1418,737,2155,-
chr1,241683021,0.5080650248160475,686,496,1182,-
chr1,241683036,0.3558325403550721,872,612,1484,-
chr1,241683046,0.808901338313103,781,577,1358,-
chr1,241683047,0.808901338313103,781,577,1358,-
chr1,241683048,0.8262776807654835,1409,1162,2571,-
chr1,241757139,2.791590016826825,1168,834,2002,-
chr1,241757394,0.3772811425548796,633,397,1030,-
chr1,241757519,0.5698807157057655,636,502,1138,-
chr1,241757547,1.4868197278911564,1075,767,1842,-
chr1,241757600,0.6506226053639846,1044,695,1739,-
chr1,241757632,3.2178996170126988,613,450,1063,-
chr1,241757722,0.6175098002613404,826,486,1312,-
chr1,241761071,2.411642411642412,869,480,1349,-
chr1,241761086,2.86272559906896,1219,740,1959,-
chr1,241761097,1.6881762516885697,1802,1132,2934,-
chr1,241761168,0.3804194394031054,685,521,1206,-
chr1,241792459,2.350992746701172,998,645,1643,-
chr1,241792460,2.2926013805004315,732,487,1219,-
chr1,241793125,0.3600975557328911,625,377,1002,-
chr1,241793600,3.5040820786487252,640,448,1088,-
chr1,241803201,5.761351574570826,852,657,1509,-
chr1,244572293,28.444473931661925,2438,3217,5655,-
chr1,244572294,32.42270513570262,2148,2681,4829,-
chr1,244572309,4.44326178747361,677,463,1140,-
chr1,244572310,7.545067490634025,1436,1240,2676,-
chr1,245017122,0.36543497474746045,1081,777,1858,-
chr1,245017160,2.3322839371816526,656,588,1244,-
chr1,245017212,1.9074246880785617,804,611,1415,-
chr1,245017656,2.492260061919505,804,569,1373,-
chr1,245018312,1.279039289535374,911,702,1613,-
chr1,245018827,1.6558813250203825,735,897,1632,-
chr1,245018828,1.036336620289072,547,672,1219,-
chr1,245018833,6.613046610824345,2513,2008,4521,-
chr1,245018834,6.257557819204482,3337,2430,5767,-
chr1,245018835,7.938104448742746,759,704,1463,-
chr1,245018836,4.357735123174639,1692,985,2677,-
chr1,245018874,2.1902323922930784,804,440,1244,-
chr1,245019283,2.4557800400599428,1161,834,1995,-
chr1,245023663,2.286218691382545,559,476,1035,-
chr1,245025989,2.3831160680721535,865,705,1570,-
chr1,245026002,0.33862672841602715,632,430,1062,-
chr1,245027345,4.249160760910108,711,382,1093,-
chr1,245027585,2.389216092608993,611,455,1066,-
chr1,245912897,4.376983947380976,619,524,1143,-
chr1,246027158,2.0871997396497584,2372,1926,4298,-
chr1,246027159,2.0871997396497584,2372,1926,4298,-
chr1,246027165,3.851971772519718,1078,802,1880,-
chr1,246027173,1.5341134908368297,964,646,1610,-
chr1,246078845,2.1888843503089572,685,415,1100,-
chr1,246078858,2.502742230347349,887,546,1433,-
chr1,246078859,2.53837049447662,1540,906,2446,-
chr1,246078867,1.8788328565533574,1363,715,2078,-
chr1,246078868,2.324962779156327,731,402,1133,-
chr1,246720754,1.4090097829199486,1090,758,1848,-
chr1,246720755,0.2992507903512191,690,536,1226,-
chr1,247013197,2.1404406282141135,2352,1694,4046,-
chr1,247013222,1.9115703282055934,1614,1040,2654,-
chr1,247061578,1.7051889478564328,657,471,1128,-
