chromosome,position,rsr,t_read,c_read,total_reads,strand
chr3,3189214,0.342126891597613,954,485,1439,+
chr3,3189219,2.19124155602143,817,476,1293,+
chr3,3189221,2.0568556361239287,1782,1147,2929,+
chr3,3189222,1.9897959183673468,1388,925,2313,+
chr3,3189223,1.4585632137144646,2991,1990,4981,+
chr3,3189225,1.4388747935758561,3265,2378,5643,+
chr3,3189226,1.8970052696971,1702,1372,3074,+
chr3,3189227,2.044915373435229,2319,1938,4257,+
chr3,3189229,2.0740129768083095,2214,1579,3793,+
chr3,3189232,2.176646117027182,3021,2149,5170,+
chr3,3189233,2.176646117027182,3021,2149,5170,+
chr3,3189236,1.7959636045296132,2117,1066,3183,+
chr3,4681093,2.267458414714295,681,495,1176,+
chr3,4716816,1.1049847588309127,724,428,1152,+
chr3,4716817,1.1049847588309127,724,428,1152,+
chr3,4725229,1.320958967387977,746,549,1295,+
chr3,4732866,1.0364125560538118,641,445,1086,+
chr3,4732867,1.0364125560538118,641,445,1086,+
chr3,4847899,2.5043194905047104,633,502,1135,+
chr3,4856759,0.448754158036779,714,338,1052,+
chr3,4856760,0.5258215962441315,671,354,1025,+
chr3,4856771,2.4582524271844663,1687,926,2613,+
chr3,4856773,2.4582524271844663,1687,926,2613,+
chr3,4856789,0.9990070321656466,2272,1096,3368,+
chr3,4856791,1.1920882233071413,3264,1684,4948,+
chr3,4856802,1.288389884908355,2457,1666,4123,+
chr3,4856833,1.6683213826070968,2791,1553,4344,+
chr3,4888528,2.22196261682243,633,427,1060,+
chr3,5021158,1.5212697325675455,900,561,1461,+
chr3,5021160,0.9911273029296286,698,422,1120,+
chr3,5021249,2.936863543788188,617,490,1107,+
chr3,5021257,1.9665970897903178,1393,1065,2458,+
chr3,5021471,1.761246290025778,1036,835,1871,+
chr3,5021672,1.6562194611196428,718,550,1268,+
chr3,5021691,2.1433982683982684,698,395,1093,+
chr3,5021986,2.0452079566003616,782,473,1255,+
chr3,5021992,1.6092511235671365,1027,860,1887,+
chr3,5021993,1.7604884397488898,1242,932,2174,+
chr3,5021994,1.4915403326682268,3611,2544,6155,+
chr3,5022015,0.9874072796273936,2861,2107,4968,+
chr3,5022016,0.9874072796273936,2861,2107,4968,+
chr3,5022018,1.6039081624039842,1245,1076,2321,+
chr3,5022083,1.7552436524207538,1112,745,1857,+
chr3,5023092,0.6470547619202324,3351,2296,5647,+
chr3,5024672,3.486648066958948,728,385,1113,+
chr3,5024702,2.5698347107438018,690,483,1173,+
chr3,5024744,0.6074806907923282,874,500,1374,+
chr3,5024786,1.7327426204630962,2443,1521,3964,+
chr3,5024858,0.6488605733888754,661,461,1122,+
chr3,5024879,1.7837209302325578,707,515,1222,+
chr3,5024919,1.0252594347492408,1706,1302,3008,+
chr3,5024920,2.7575596816976127,677,434,1111,+
chr3,5024921,1.0252594347492408,1706,1302,3008,+
chr3,5024969,1.8972011784511784,948,703,1651,+
chr3,5024986,1.6629445474464857,876,697,1573,+
chr3,5025117,1.6611062335381916,703,535,1238,+
chr3,5025166,2.212987012987013,638,384,1022,+
chr3,5025234,1.8864838864838864,813,692,1505,+
chr3,5025252,0.5898650313557108,1314,1055,2369,+
chr3,5025283,2.423553719008265,917,725,1642,+
chr3,5025537,1.9853571215101757,942,703,1645,+
chr3,5025575,0.5645874263261297,626,508,1134,+
chr3,5025655,1.7302602665773295,2019,1549,3568,+
chr3,5025683,0.5074599954924498,865,492,1357,+
chr3,5025684,1.6259498480243157,950,657,1607,+
chr3,5025721,0.4116309291747888,723,647,1370,+
chr3,5025801,1.80794732061762,970,733,1703,+
chr3,5025973,2.416064177478459,696,438,1134,+
chr3,5026008,0.2965350523771152,988,730,1718,+
chr3,5026010,1.706437768240343,709,465,1174,+
chr3,5026013,2.0995502248875564,777,666,1443,+
chr3,5026070,1.7191954387076336,834,573,1407,+
chr3,5026239,0.5783132530120482,1903,1244,3147,+
chr3,5026240,1.0554850237281712,2424,1850,4274,+
chr3,5026241,0.5783132530120482,1903,1244,3147,+
chr3,5026242,1.653320772491757,701,578,1279,+
chr3,5026500,1.5909463497183955,1743,1281,3024,+
chr3,5026631,2.0033508896247656,1185,664,1849,+
chr3,5026634,1.7074468085106382,534,469,1003,+
chr3,5213888,4.7558578410024674,790,448,1238,+
chr3,5213890,4.862876254180602,726,482,1208,+
chr3,9839431,2.042207792207792,628,391,1019,+
chr3,9839434,1.8223365617433416,668,412,1080,+
chr3,9839439,2.406146572104019,726,422,1148,+
chr3,9839441,1.807572936064556,831,536,1367,+
chr3,9841872,1.3943479628649236,2089,1272,3361,+
chr3,9841873,1.0303838802166294,1034,583,1617,+
chr3,9841918,1.5546139359698683,1015,707,1722,+
chr3,9841920,1.4801011804384483,2095,1185,3280,+
chr3,9841951,1.735272968637646,3068,1610,4678,+
chr3,9843351,2.042809042809042,821,566,1387,+
chr3,9843361,1.8300170217761345,916,630,1546,+
chr3,9845530,1.796146550863532,691,476,1167,+
chr3,9845651,2.37163244502694,957,653,1610,+
chr3,9847916,0.5398737808376363,940,580,1520,+
chr3,9848012,23.743820224719094,586,444,1030,+
chr3,9848013,20.21596455595509,1106,650,1756,+
chr3,9848014,17.049633044298407,1511,1144,2655,+
chr3,9848027,4.636674863107048,507,790,1297,+
chr3,9848034,4.4054993999815375,646,966,1612,+
chr3,9848056,0.42104563522758237,476,594,1070,+
chr3,9848354,7.275135297252206,1306,1046,2352,+
chr3,9848357,7.537283518182396,1144,1001,2145,+
chr3,9935055,0.6842485654389091,800,651,1451,+
chr3,10157455,1.6681974168103486,1921,1545,3466,+
chr3,10157474,1.8769015659955255,906,595,1501,+
chr3,10168078,1.9460227272727275,684,351,1035,+
chr3,10168158,10.10387613490532,5733,7680,13413,+
chr3,10168159,10.10387613490532,5733,7680,13413,+
chr3,10168197,0.5020174806157427,922,1082,2004,+
chr3,10168449,2.4399506356873126,909,664,1573,+
chr3,10191523,2.0354029532111726,1345,802,2147,+
chr3,10191525,2.0354029532111726,1345,802,2147,+
chr3,11354884,0.6036382846320394,611,447,1058,+
chr3,11354886,0.6036382846320394,611,447,1058,+
chr3,14166673,4.384768052776184,1106,759,1865,+
chr3,14166675,4.022693594329253,916,635,1551,+
chr3,14173156,2.6667765063620936,626,434,1060,+
chr3,14220350,1.7102970054000983,1185,671,1856,+
chr3,14220351,2.0634058541203295,1612,957,2569,+
chr3,14220355,1.3159550561797753,731,444,1175,+
chr3,14223060,1.3950945324476238,1240,926,2166,+
chr3,14223064,1.4487769870223073,949,726,1675,+
chr3,14223097,0.7328183578517407,3675,2767,6442,+
chr3,14223112,1.059720480878875,4137,3147,7284,+
chr3,14223137,1.037040915412684,4980,3070,8050,+
chr3,14223139,1.3405545927209706,2573,1730,4303,+
chr3,14223154,2.138727562456376,3247,2300,5547,+
chr3,14239622,1.7045790251107829,1153,676,1829,+
chr3,14239638,0.9666361974405849,1394,1093,2487,+
chr3,14239639,0.9666361974405849,1394,1093,2487,+
chr3,14489137,1.1323866716383009,593,411,1004,+
chr3,14489256,0.4785668586052463,923,520,1443,+
chr3,14489258,0.7833799385840009,1426,820,2246,+
chr3,14489260,1.023736780258519,989,574,1563,+
chr3,14518777,3.5929277569989777,948,626,1574,+
chr3,14526623,0.3176999101527403,662,476,1138,+
chr3,14526625,0.3176999101527403,662,476,1138,+
chr3,14526848,1.9932523616734144,632,467,1099,+
chr3,14526913,0.5937701119835243,658,456,1114,+
chr3,14527247,1.8895384240652784,534,482,1016,+
chr3,14527499,1.0426008968609863,650,445,1095,+
chr3,14527501,1.0426008968609863,650,445,1095,+
chr3,14527542,1.9503381217797924,714,482,1196,+
chr3,14527618,20.028531053036534,1529,747,2276,+
chr3,14527619,20.32742938357247,2035,959,2994,+
chr3,14527620,20.028531053036534,1529,747,2276,+
chr3,14527623,18.120333814456757,836,461,1297,+
chr3,14527630,6.742607807882621,971,648,1619,+
chr3,14527946,0.8063514677301162,1195,772,1967,+
chr3,14527947,0.9695530328219256,971,568,1539,+
chr3,14528319,3.1985896149025455,763,525,1288,+
chr3,14528325,1.6483175051873191,647,539,1186,+
chr3,14528350,1.2770937796088702,1216,772,1988,+
chr3,14528352,0.9544159544159545,937,584,1521,+
chr3,14528376,1.688374923919659,583,423,1006,+
chr3,14528598,4.797668170162901,2182,2010,4192,+
chr3,14528599,4.797668170162901,2182,2010,4192,+
chr3,14528710,1.2929702659950235,1126,820,1946,+
chr3,14528749,0.4597207303974221,641,398,1039,+
chr3,14530435,1.100897118215148,1055,780,1835,+
chr3,14530471,2.2032124430061053,1031,739,1770,+
chr3,14530518,1.852941176470588,1106,737,1843,+
chr3,14708983,1.2720198833141703,614,460,1074,+
chr3,14708986,2.393382879977914,1075,889,1964,+
chr3,15643253,1.3187032173336029,727,596,1323,+
chr3,15643254,1.1561355311355312,605,447,1052,+
chr3,15643255,1.1561355311355312,605,447,1052,+
chr3,15643305,0.8737201365187713,913,585,1498,+
chr3,15643307,0.8892972603289719,2475,1693,4168,+
chr3,15643308,1.1573516211709314,1769,1133,2902,+
chr3,15677142,3.6829037942140763,649,450,1099,+
chr3,15677148,0.9613912738879005,972,720,1692,+
chr3,20025409,2.5196881475761317,740,487,1227,+
chr3,20026110,9.728581775071511,847,816,1663,+
chr3,20026111,8.503157991859924,1320,1119,2439,+
chr3,20026112,13.469142239156232,1739,1406,3145,+
chr3,22423482,3.6059651405677497,624,478,1102,+
chr3,22423491,1.8178819093836587,948,745,1693,+
chr3,23848752,11.246230264293706,805,758,1563,+
chr3,23848753,10.16123984858094,1017,971,1988,+
chr3,23848754,8.558363939358253,630,437,1067,+
chr3,23929164,3.023586783439491,778,627,1405,+
chr3,23929165,3.023586783439491,778,627,1405,+
chr3,23930723,2.4073895891465407,833,546,1379,+
chr3,23932171,15.845122221391781,3471,244,3715,+
chr3,23932172,16.052402804255017,4134,266,4400,+
chr3,23932173,30.163723916532906,1565,88,1653,+
chr3,23932175,27.09733870464587,3273,184,3457,+
chr3,23932176,44.64255160411016,6153,1168,7321,+
chr3,23932177,24.91317267840168,4185,2977,7162,+
chr3,23932178,24.894037733273485,7224,4889,12113,+
chr3,23932179,20.50194061026377,5174,4769,9943,+
chr3,23932197,2.86054307743882,741,941,1682,+
chr3,23958622,1.5205084965624596,665,592,1257,+
chr3,23958624,1.1188333303920623,1684,1408,3092,+
chr3,23958625,0.9175006389964808,1036,904,1940,+
chr3,23958628,0.5814058140581405,679,541,1220,+
chr3,23958633,0.7700421940928269,1970,1421,3391,+
chr3,23958634,0.7700421940928269,1970,1421,3391,+
chr3,23958638,1.3651107197516856,2132,1685,3817,+
chr3,23958645,1.4813340244944906,2518,2094,4612,+
chr3,23958647,1.5261780104712044,901,763,1664,+
chr3,23958678,1.837880291005291,516,503,1019,+
chr3,23958681,1.773980068514481,734,493,1227,+
chr3,23959435,1.830263157894737,1390,1044,2434,+
chr3,23959453,1.7180831674284271,3311,1876,5187,+
chr3,23959454,1.9195695633842833,7780,3735,11515,+
chr3,23959456,2.0847260007773025,4469,1859,6328,+
chr3,23959485,1.2778245202347365,7324,4736,12060,+
chr3,23959486,0.767726127618456,3475,2971,6446,+
chr3,23960023,1.3086898341589075,6372,3958,10330,+
chr3,23960843,1.6312249900483966,3663,1617,5280,+
chr3,23960845,0.7876771267475969,6433,5005,11438,+
chr3,23960854,1.2980848110052379,4613,2066,6679,+
chr3,23960855,1.42083644510829,3804,2209,6013,+
chr3,23960875,1.3608614634354521,16675,10309,26984,+
chr3,23960899,1.4357190540702522,23680,15467,39147,+
chr3,23960953,1.428219541011779,7914,4504,12418,+
chr3,23961114,1.6083916083916083,1149,714,1863,+
chr3,23961117,1.4394849405241055,4074,2415,6489,+
chr3,23961133,1.8499053636738816,2130,1190,3320,+
chr3,23961138,1.8753193269908384,2332,1375,3707,+
chr3,23961145,1.9039630958484661,4465,2886,7351,+
chr3,23961425,0.6790013122765737,1538,1077,2615,+
chr3,23961446,1.5136698263390744,3609,2709,6318,+
chr3,23961489,0.4789245982694684,1106,808,1914,+
chr3,23961536,1.761198706953424,1694,1143,2837,+
chr3,23961621,1.760703499733523,1165,865,2030,+
chr3,23961920,2.383330339500629,855,585,1440,+
chr3,24021860,5.873976522291003,506,662,1168,+
chr3,28361023,0.56453937884943,717,586,1303,+
chr3,31574518,3.0502708614187353,931,714,1645,+
chr3,31574754,2.3033061169856777,955,481,1436,+
chr3,31574755,1.814254740868899,1241,663,1904,+
chr3,31574776,0.74389729639751,2228,1449,3677,+
chr3,31574777,0.6279186291211544,963,586,1549,+
chr3,31574778,1.0286670283957318,909,581,1490,+
chr3,31617902,0.5707699400645458,618,481,1099,+
chr3,31617914,1.323304847705774,1072,799,1871,+
chr3,31617937,1.6838709677419357,809,557,1366,+
chr3,31621402,0.585025641025641,712,499,1211,+
chr3,31621423,0.5920593858958497,657,522,1179,+
chr3,31621470,4.131600000000001,625,499,1124,+
chr3,31656672,2.828522920203735,783,495,1278,+
chr3,31658471,1.83062435500516,616,407,1023,+
chr3,31659434,3.716740088105727,648,453,1101,+
chr3,31663722,1.0055651506428709,654,578,1232,+
chr3,31663724,1.0055651506428709,654,578,1232,+
chr3,31665229,1.919642857142857,773,479,1252,+
chr3,31666420,3.001139601139601,686,404,1090,+
chr3,31666467,2.25933908045977,924,579,1503,+
chr3,31667524,1.8483660130718955,706,509,1215,+
chr3,31670869,2.702930402930403,1098,734,1832,+
chr3,31670880,1.789992119779354,923,845,1768,+
chr3,31670885,1.5312594382361824,974,902,1876,+
chr3,31670893,1.604523621765001,1040,753,1793,+
chr3,31674428,1.2925581812694242,1365,1476,2841,+
chr3,31674437,1.841266479589136,1511,1716,3227,+
chr3,31674499,2.655574043261232,965,600,1565,+
chr3,31677481,0.4719275549805951,1055,772,1827,+
chr3,31677541,0.39752066115702483,739,549,1288,+
chr3,31677863,1.867174959871589,704,444,1148,+
chr3,31678149,2.303586278586278,1080,739,1819,+
chr3,31678848,3.107940446650124,667,495,1162,+
chr3,32726927,0.4778711484593838,852,398,1250,+
chr3,32726928,0.4778711484593838,852,398,1250,+
chr3,33155732,2.1298419584753643,710,460,1170,+
chr3,33155769,0.3042220936957779,525,545,1070,+
chr3,33155771,0.3042220936957779,525,545,1070,+
chr3,33155873,1.0790742526518804,745,609,1354,+
chr3,33155874,1.4805667499605157,1358,1088,2446,+
chr3,33155990,2.219332789083541,899,552,1451,+
chr3,33156013,1.4379556803353002,1543,1057,2600,+
chr3,33161837,1.761981312167186,922,806,1728,+
chr3,33161840,1.621001310291233,1658,1490,3148,+
chr3,33161846,1.5267782644972883,1672,1127,2799,+
chr3,33165947,1.482851520835632,1942,1430,3372,+
chr3,33165984,1.4651304230301392,1605,1056,2661,+
chr3,33165987,1.1073023120807142,6012,4108,10120,+
chr3,33165988,0.6705824849996629,3616,2281,5897,+
chr3,33174058,1.3112898677487657,2637,1700,4337,+
chr3,33184307,0.5619327996422435,1548,1160,2708,+
chr3,33184320,3.638850665043048,624,457,1081,+
chr3,33184414,0.9589495113249787,3980,2747,6727,+
chr3,33184415,0.7649167775218196,1520,1257,2777,+
chr3,33184416,1.491259012600003,1354,757,2111,+
chr3,33184424,0.6061794582392777,2386,1771,4157,+
chr3,33184425,0.6061794582392777,2386,1771,4157,+
chr3,33184426,1.9993751421831167,2385,1626,4011,+
chr3,33184427,2.2758896441423437,1422,1036,2458,+
chr3,33184485,1.3553595658073267,1426,1099,2525,+
chr3,33185183,3.064662676816726,765,579,1344,+
chr3,33185407,12.123389488393888,1108,373,1481,+
chr3,33185422,8.025682944002684,692,359,1051,+
chr3,33185425,9.757604658543586,1270,1133,2403,+
chr3,33185426,9.757604658543588,1270,1133,2403,+
chr3,33185440,0.2875275265216193,659,774,1433,+
chr3,33185618,2.3143812709030103,864,574,1438,+
chr3,33185619,2.3143812709030103,864,574,1438,+
chr3,33185645,2.4807298772169166,745,732,1477,+
chr3,33185649,1.6354580152671756,1241,1047,2288,+
chr3,33185651,1.8430776612528874,2822,2619,5441,+
chr3,33185653,2.1144644216133943,1326,1167,2493,+
chr3,33185854,0.39656955173043,651,400,1051,+
chr3,33185856,0.39656955173043,651,400,1051,+
chr3,33186010,1.7108695879547837,586,469,1055,+
chr3,33186333,0.29670042405438246,938,652,1590,+
chr3,33186450,4.514588949196607,1170,885,2055,+
chr3,33186451,3.811133200795229,638,502,1140,+
chr3,33877608,1.883627015230916,963,723,1686,+
chr3,33879723,2.5825336388253057,1137,785,1922,+
chr3,33879747,2.57220257990597,1030,740,1770,+
chr3,33896713,0.47395833333333326,769,527,1296,+
chr3,33908000,1.0204592901878915,657,478,1135,+
chr3,33908001,1.0204592901878915,657,478,1135,+
chr3,33910867,1.9655788582714195,835,685,1520,+
chr3,33910868,1.5221950622985734,1169,935,2104,+
chr3,37367423,2.1839601861686018,606,407,1013,+
chr3,37367581,2.956745948502211,902,665,1567,+
chr3,37367631,0.5273133193995819,652,553,1205,+
chr3,37367878,1.9898346327774017,854,594,1448,+
chr3,37370017,3.032245846775992,643,418,1061,+
chr3,39433462,5.880441348729319,778,478,1256,+
chr3,39433479,3.6102038976892072,748,488,1236,+
chr3,39448208,0.9942757243871553,7580,4969,12549,+
chr3,39448209,1.0384708970993148,1571,1609,3180,+
chr3,39448210,0.9368968548828945,32953,15068,48021,+
chr3,39448211,0.9422774450030058,29768,12419,42187,+
chr3,39448212,0.8841119656945481,23468,10676,34144,+
chr3,39448216,0.7580293882502137,1963,1694,3657,+
chr3,39449206,1.2448503761474299,12691,7887,20578,+
chr3,39449207,1.4838676636279833,4828,3003,7831,+
chr3,39449214,1.2537577337611727,13666,7563,21229,+
chr3,39449233,1.1918257160001675,21346,14376,35722,+
chr3,39449250,1.1709422257663866,9202,6421,15623,+
chr3,39450115,1.3288387043033882,14461,10490,24951,+
chr3,39452403,1.3893251567036604,3121,1344,4465,+
chr3,39452406,1.2303414586020807,9792,5750,15542,+
chr3,39452407,1.2842571047495872,9389,4983,14372,+
chr3,39452408,1.5162340520311233,8389,3805,12194,+
chr3,39452409,1.3792775928651655,6433,3444,9877,+
chr3,39452410,1.4026960955460581,12615,6842,19457,+
chr3,39452413,1.336463958807144,12579,7697,20276,+
chr3,39452417,1.465580069486668,18823,9889,28712,+
chr3,39452418,1.465580069486668,18823,9889,28712,+
chr3,39452421,1.4089906232763374,5501,2743,8244,+
chr3,39452424,1.210267779957471,22109,14486,36595,+
chr3,39452436,1.336368538608396,13459,7785,21244,+
chr3,39452441,1.1483622350674374,8939,4994,13933,+
chr3,39453204,1.4605743773838906,17130,8913,26043,+
chr3,39453205,1.4605743773838906,17130,8913,26043,+
chr3,39453213,1.4911834056944173,26514,16602,43116,+
chr3,39453215,1.6393957837658386,18517,10229,28746,+
chr3,39453540,1.2836692355569737,8925,8102,17027,+
chr3,39453965,3.730763855461192,650,428,1078,+
chr3,40351445,2.5503220996906792,635,467,1102,+
chr3,40353503,0.4868405351571967,944,677,1621,+
chr3,40353685,1.9648161168314568,979,734,1713,+
chr3,40498819,1.2688238467339226,826,631,1457,+
chr3,40498821,1.616504972082542,1161,850,2011,+
chr3,40498828,1.1064116086009799,1060,879,1939,+
chr3,40498835,1.928362573099415,1318,759,2077,+
chr3,40498839,1.3742893431716463,1489,1180,2669,+
chr3,40498845,1.4576564868962527,2018,1196,3214,+
chr3,40499443,1.1863454356065166,9022,6041,15063,+
chr3,40500200,1.489279239979939,8292,5391,13683,+
chr3,40500213,1.3992394529955188,19575,14657,34232,+
chr3,40502895,0.9738172426738337,639,569,1208,+
chr3,40503533,0.472652694091638,4590,4011,8601,+
chr3,40503534,0.5879318713640747,8172,6048,14220,+
chr3,40503539,0.539689967244452,5705,4366,10071,+
chr3,40503540,0.6257528470960951,10012,6722,16734,+
chr3,40503553,1.4697109839488576,20713,13483,34196,+
chr3,40503554,1.4282282608623476,24718,16395,41113,+
chr3,40503564,1.3319946752902976,12888,9127,22015,+
chr3,40503567,1.48312081015547,6608,5534,12142,+
chr3,40503568,1.3163025177665533,7642,4712,12354,+
chr3,40503631,1.2475495249887767,21812,16978,38790,+
chr3,41266068,2.103640776699029,641,514,1155,+
chr3,41266082,1.758147512864494,614,476,1090,+
chr3,41266103,3.2641921397379914,689,457,1146,+
chr3,41266229,1.7928921568627454,1329,1019,2348,+
chr3,41266230,1.7928921568627454,1329,1019,2348,+
chr3,41266456,1.7545008183306057,803,563,1366,+
chr3,41266525,1.999324552516042,591,422,1013,+
chr3,41266536,1.6683841940734847,1256,911,2167,+
chr3,41266540,2.3119136960600377,635,532,1167,+
chr3,41266619,2.291929463251384,613,456,1069,+
chr3,41266633,1.7316137566137566,688,503,1191,+
chr3,41266640,1.6555183946488294,719,551,1270,+
chr3,41266682,1.8924485125858124,826,588,1414,+
chr3,41266832,1.803001154290112,567,451,1018,+
chr3,41266833,0.496911351784998,651,553,1204,+
chr3,41267172,1.8597678916827851,640,516,1156,+
chr3,41267257,1.5592324093816632,830,669,1499,+
chr3,41267341,1.9618907809747503,902,654,1556,+
chr3,41274926,1.7620237019716214,920,606,1526,+
chr3,41275137,2.181650530198248,675,481,1156,+
chr3,41275209,2.103695029924538,702,426,1128,+
chr3,41275278,2.2555282555282554,611,406,1017,+
chr3,41275296,0.572429906542056,664,427,1091,+
chr3,41275638,2.412613981762918,634,469,1103,+
chr3,41277218,3.008194233687405,884,658,1542,+
chr3,41277219,6.962752076306817,2114,1535,3649,+
chr3,41277231,2.218281595544271,1021,841,1862,+
chr3,41277233,2.125075460321903,1619,1232,2851,+
chr3,41277237,0.4882104740630429,561,473,1034,+
chr3,41277279,1.9088902267710213,655,452,1107,+
chr3,41278084,2.903669724770642,632,435,1067,+
chr3,41278126,0.5212765957446809,734,469,1203,+
chr3,41278135,1.8117396593673964,850,547,1397,+
chr3,41279523,2.380878587963914,1377,942,2319,+
chr3,41280933,12.696334452079949,621,431,1052,+
chr3,41281506,0.47605322522701277,771,500,1271,+
chr3,41281513,0.8775506509269281,813,605,1418,+
chr3,41281515,0.845272612735291,658,523,1181,+
chr3,41281542,2.066898556249107,1057,676,1733,+
chr3,41281574,2.158426368952685,724,494,1218,+
chr3,41281626,1.9343283582089554,971,669,1640,+
chr3,41281784,1.6147071158954283,699,621,1320,+
chr3,41281840,2.9128043990573445,926,669,1595,+
chr3,44442751,2.0928688865992937,703,551,1254,+
chr3,44442766,1.7675,706,591,1297,+
chr3,44881885,3.2925084925307737,986,598,1584,+
chr3,44881907,3.59594383775351,921,640,1561,+
chr3,44881908,3.59594383775351,921,640,1561,+
chr3,44881927,1.6938601750110158,850,460,1310,+
chr3,44882576,1.7867847411444142,853,733,1586,+
chr3,44882584,1.0694415852501942,1686,1306,2992,+
chr3,44882594,3.259932375316991,856,675,1531,+
chr3,45031057,2.394099289305012,553,470,1023,+
chr3,45038598,0.5547624907703667,643,477,1120,+
chr3,45046846,0.4026484229321118,2226,1566,3792,+
chr3,45052778,1.7939730666554745,851,640,1491,+
chr3,45052780,1.0133957845433257,600,426,1026,+
chr3,45052784,0.4444469755255861,643,451,1094,+
chr3,47451180,1.1900129928500895,943,485,1428,+
chr3,47451184,1.9853217276094999,800,532,1332,+
chr3,47451199,2.499646592177987,734,553,1287,+
chr3,47846903,0.516558612230594,736,438,1174,+
chr3,47857464,1.9721235795454541,765,511,1276,+
chr3,47857482,1.193798732825979,915,438,1353,+
chr3,47857508,2.5207816463635604,1923,1236,3159,+
chr3,47857509,2.5207816463635604,1923,1236,3159,+
chr3,47857510,2.5207816463635604,1923,1236,3159,+
chr3,47857533,1.8633312355779321,934,680,1614,+
chr3,47866712,4.278409090909091,752,439,1191,+
chr3,47866724,2.1971729412586436,872,776,1648,+
chr3,47866726,2.28705035971223,577,555,1132,+
chr3,47866729,1.3534347570963443,633,568,1201,+
chr3,47868846,0.4917135709818635,1479,1247,2726,+
chr3,47868847,0.4917135709818635,1479,1247,2726,+
chr3,47868851,1.121466012289665,1480,1259,2739,+
chr3,47868890,2.0229056749453096,654,408,1062,+
chr3,47868915,1.6150265957446808,693,469,1162,+
chr3,47868929,2.022478070175439,713,455,1168,+
chr3,47868932,1.7378048780487805,740,491,1231,+
chr3,47868959,1.9798910766652704,972,538,1510,+
chr3,47868962,0.6631063512971765,1493,918,2411,+
chr3,47870529,1.6847784958154195,4731,3608,8339,+
chr3,47870530,1.6847784958154195,4731,3608,8339,+
chr3,47870531,1.6506561232539347,5691,4194,9885,+
chr3,47883198,1.840399002493765,614,400,1014,+
chr3,47884604,3.072795854393748,526,476,1002,+
chr3,47888127,2.3057385003823483,901,611,1512,+
chr3,47888128,2.2270300069044344,674,488,1162,+
chr3,47889304,0.3328192700301094,823,533,1356,+
chr3,47889306,0.3328192700301094,823,533,1356,+
chr3,47890454,1.0291365016001384,823,454,1277,+
chr3,47891168,2.0826608825498982,675,582,1257,+
chr3,48481818,1.6064448469825532,673,616,1289,+
chr3,48481819,0.6796962529565542,1343,1107,2450,+
chr3,48481821,1.0040473890097446,1811,1487,3298,+
chr3,48481841,1.477110158518797,2240,1710,3950,+
chr3,48481842,1.3865403647674257,1400,1285,2685,+
chr3,48482005,0.6156058189551012,1018,725,1743,+
chr3,48964945,2.9848735947245304,1179,806,1985,+
chr3,49011162,0.38277826110201163,614,431,1045,+
chr3,49011240,0.5600075690529591,1331,853,2184,+
chr3,49012253,1.9888729931648383,735,465,1200,+
chr3,49012295,3.1408045977011496,1092,695,1787,+
chr3,49012397,4.061988636363636,1458,799,2257,+
chr3,49020961,8.20958544368608,956,711,1667,+
chr3,49049974,7.282342426854622,584,646,1230,+
chr3,49049975,6.706130010752847,692,751,1443,+
chr3,49051147,2.7700807271149475,616,436,1052,+
chr3,49060139,0.32647066606684483,948,712,1660,+
chr3,49060141,0.32647066606684483,948,712,1660,+
chr3,49060150,0.4188536636573588,664,432,1096,+
chr3,49060569,3.644600141724606,775,634,1409,+
chr3,49570626,1.303007889546351,754,467,1221,+
chr3,49571179,7.459301975224025,1609,966,2575,+
chr3,49571180,6.49891156462585,1290,734,2024,+
chr3,49571181,8.20068468240199,2265,1475,3740,+
chr3,49571211,3.0523284831231488,969,819,1788,+
chr3,49571917,0.982406575060999,917,598,1515,+
chr3,49571919,1.2885760987400203,1070,708,1778,+
chr3,49572300,68.44280683696644,868,1104,1972,+
chr3,49713386,0.443027027027027,682,374,1056,+
chr3,49713826,1.7628600823045266,595,431,1026,+
chr3,49713846,0.5603141603141604,757,480,1237,+
chr3,49720299,1.2560697094474607,705,466,1171,+
chr3,49720348,2.3373842592592595,576,479,1055,+
chr3,49720349,2.891150442477876,593,451,1044,+
chr3,49720350,2.3373842592592595,576,479,1055,+
chr3,49720351,2.891150442477876,593,451,1044,+
chr3,49720539,1.5210606489838852,1035,722,1757,+
chr3,49720699,1.5896031977731249,1293,1062,2355,+
chr3,49720700,1.2020789091315525,955,777,1732,+
chr3,49720733,2.0344497607655505,1062,626,1688,+
chr3,49720734,2.0344497607655505,1062,626,1688,+
chr3,50156039,1.642102961724884,845,619,1464,+
chr3,50156041,2.547330376873765,961,602,1563,+
chr3,50156062,3.1597791236195225,656,400,1056,+
chr3,50156063,3.1597791236195225,656,400,1056,+
chr3,50273825,1.2411587246980993,660,424,1084,+
chr3,50273848,1.979004771127589,1379,730,2109,+
chr3,50273849,2.0525620320070472,1397,694,2091,+
chr3,50273851,1.9061827346850166,1736,944,2680,+
chr3,50273867,2.5352005635360295,1513,918,2431,+
chr3,50289889,1.2250846808565983,640,480,1120,+
chr3,50289892,1.5523268559138124,1752,1273,3025,+
chr3,50289893,2.118110708184733,1284,1093,2377,+
chr3,50289895,2.2981178525121866,1946,1533,3479,+
chr3,50289896,2.31427901887232,1594,1266,2860,+
chr3,50289902,1.671652128392578,1196,907,2103,+
chr3,50290552,2.148936345863952,612,394,1006,+
chr3,50294416,2.681150441901268,773,596,1369,+
chr3,50294424,0.4633025721578637,693,462,1155,+
chr3,50294425,0.9507557404695663,1077,809,1886,+
chr3,50294937,2.22289156626506,614,497,1111,+
chr3,50294939,2.22289156626506,614,497,1111,+
chr3,50311237,1.7873986825761503,855,664,1519,+
chr3,50312813,0.2642059210441187,622,462,1084,+
chr3,50314387,5.432101284652419,987,735,1722,+
chr3,51422782,1.87609777915743,366,719,1085,+
chr3,51422821,0.25515980563459606,532,813,1345,+
chr3,51423709,2.25014400921659,624,433,1057,+
chr3,51423728,2.744866385372714,696,473,1169,+
chr3,51423756,1.896154537251726,1596,1146,2742,+
chr3,51425200,2.3151049364469407,711,397,1108,+
chr3,51425204,1.47612551159618,1081,732,1813,+
chr3,51425207,2.0617884250474385,1158,815,1973,+
chr3,51425252,0.5808102345415778,1361,1004,2365,+
chr3,51425258,1.5232934447204032,2069,1160,3229,+
chr3,51425259,1.4483759266281633,5808,3602,9410,+
chr3,51425260,1.566638216048111,2437,1670,4107,+
chr3,51425261,1.3155434782608697,3821,2249,6070,+
chr3,51425262,0.5572642310960068,936,641,1577,+
chr3,51425263,1.4785818785573834,13267,9443,22710,+
chr3,51425264,1.5219353298220353,11965,8671,20636,+
chr3,51425265,1.6638427320954994,7678,6310,13988,+
chr3,51425267,1.5990949694072172,6286,5491,11777,+
chr3,51425269,1.660886383398097,6667,6126,12793,+
chr3,51425271,1.4791979065610983,12428,11336,23764,+
chr3,51425272,1.4555802712075432,10193,9303,19496,+
chr3,51425273,1.6480993128896808,10413,10839,21252,+
chr3,51425275,1.5227591829055716,18867,16363,35230,+
chr3,51425276,1.5589930478619762,12126,10951,23077,+
chr3,51426435,2.198938679245283,642,529,1171,+
chr3,51426460,1.992233009708738,721,514,1235,+
chr3,51426478,1.8845497485354135,1375,1135,2510,+
chr3,51426687,3.174909968416901,726,612,1338,+
chr3,52233241,2.01983943744978,594,444,1038,+
chr3,52233362,2.311740890688259,570,474,1044,+
chr3,52236637,2.892621384389196,650,397,1047,+
chr3,52238925,1.6742906389447283,648,451,1099,+
chr3,52239894,0.3718246945606828,650,495,1145,+
chr3,52242208,8.727703704128574,1160,384,1544,+
chr3,52242212,10.5858310626703,776,366,1142,+
chr3,52242213,16.361880198817698,2488,1379,3867,+
chr3,52242214,16.60742445442303,1968,1133,3101,+
chr3,52242215,16.4273200318889,2222,1267,3489,+
chr3,52242219,7.1128322309576,1517,1178,2695,+
chr3,52242220,9.392194310157441,2138,1892,4030,+
chr3,52242221,9.392194310157441,2138,1892,4030,+
chr3,52242225,2.839279864515351,839,1041,1880,+
chr3,52242244,0.4062074829931972,561,734,1295,+
chr3,52242246,0.4062074829931972,561,734,1295,+
chr3,52245385,1.5928801641310717,805,583,1388,+
chr3,52720047,0.9192856762230166,5766,1994,7760,+
chr3,52720108,1.703459064835738,1049,522,1571,+
chr3,52720111,2.2790752135151666,2463,1179,3642,+
chr3,52720784,1.679561680225801,1685,950,2635,+
chr3,52720789,1.937414853081129,4568,2621,7189,+
chr3,52720790,1.832291536719027,6428,3745,10173,+
chr3,52720816,2.9482733709001585,1154,768,1922,+
chr3,52721297,0.664584578601315,1201,955,2156,+
chr3,52723189,1.1369828298978917,7657,6021,13678,+
chr3,52723190,1.4798065364312163,5860,5034,10894,+
chr3,52723191,1.1132795336626788,11324,8905,20229,+
chr3,52723192,1.4425979517216283,4471,3886,8357,+
chr3,52724652,1.625953907203907,990,818,1808,+
chr3,52724709,1.5023229173295995,1072,826,1898,+
chr3,52725639,1.791930897000905,2710,2163,4873,+
chr3,52726929,1.9563655187113669,1366,800,2166,+
chr3,52727535,1.4899826861241654,1505,932,2437,+
chr3,52727790,1.5727882665002342,959,753,1712,+
chr3,52727806,2.4197879858657245,1069,848,1917,+
chr3,52727812,1.2402538149590265,3650,3050,6700,+
chr3,52727813,1.5386710524937408,2447,2097,4544,+
chr3,52727815,1.8922603737611745,1593,1048,2641,+
chr3,52740660,2.0829133064516125,569,495,1064,+
chr3,52740663,1.6730527638190955,760,397,1157,+
chr3,52740665,1.764903677758319,662,570,1232,+
chr3,52740672,0.6361779035046362,703,605,1308,+
chr3,52740824,0.693426724137931,1052,782,1834,+
chr3,57283559,1.4848034895946896,587,494,1081,+
chr3,57283562,2.4070895650522237,991,806,1797,+
chr3,57283563,2.703217483684929,726,598,1324,+
chr3,57283566,2.761705101327743,607,476,1083,+
chr3,57283567,2.761705101327743,607,476,1083,+
chr3,57306488,2.312395775430795,959,513,1472,+
chr3,57306490,2.206596350242759,658,361,1019,+
chr3,57306534,2.243984962406015,888,664,1552,+
chr3,57306536,2.632713026444662,1343,1020,2363,+
chr3,57306537,2.7520383693045565,905,694,1599,+
chr3,57914356,1.947164695767508,992,709,1701,+
chr3,58098000,2.2245803548628507,597,443,1040,+
chr3,58112382,2.4035381952183306,773,603,1376,+
chr3,58112384,2.4035381952183306,773,603,1376,+
chr3,58128426,2.030159574806388,787,465,1252,+
chr3,58128470,2.66461461691165,732,554,1286,+
chr3,58132562,1.9496802966010778,1154,1120,2274,+
chr3,58132564,1.9005697548916103,1234,1041,2275,+
chr3,58145396,2.158619388909845,762,481,1243,+
chr3,58145398,1.6648018416264978,1392,920,2312,+
chr3,58145400,0.9201168402336805,804,507,1311,+
chr3,58145404,0.47921390778533635,633,489,1122,+
chr3,58145405,0.47921390778533635,633,489,1122,+
chr3,58148886,1.076601594365039,878,648,1526,+
chr3,58156555,2.004674830241655,923,594,1517,+
chr3,58156803,1.2797202797202798,731,571,1302,+
chr3,69134321,0.4223803236508904,622,472,1094,+
chr3,69151141,1.4041414226284923,3329,2508,5837,+
chr3,69151142,1.4041414226284923,3329,2508,5837,+
chr3,69151149,1.924915336236091,811,688,1499,+
chr3,69151191,1.7660150513950077,894,680,1574,+
chr3,69151194,0.9302429846840411,1564,1191,2755,+
chr3,69153965,1.713718049274065,1169,801,1970,+
chr3,69154002,1.7292623038326038,622,492,1114,+
chr3,69154030,0.5014004413512138,694,547,1241,+
chr3,69154096,3.3431334622823985,595,516,1111,+
chr3,70016568,31.327036153811108,709,456,1165,+
chr3,73160216,0.5003126954346467,679,532,1211,+
chr3,99881175,2.9180428134556577,733,435,1168,+
chr3,99891237,0.5951742627345845,665,372,1037,+
chr3,100058771,1.19204010376994,855,670,1525,+
chr3,100074049,2.710983088415748,2406,1511,3917,+
chr3,100074050,2.238805970149253,1649,937,2586,+
chr3,100074051,2.238805970149253,1649,937,2586,+
chr3,100277396,3.049600968631575,673,443,1116,+
chr3,100432501,0.6066711066711067,642,461,1103,+
chr3,100432509,2.2064056939501784,712,561,1273,+
chr3,100432631,1.5420065595828778,1145,758,1903,+
chr3,100451370,0.5757997218358832,1169,718,1887,+
chr3,100463691,1.7430902430902429,721,545,1266,+
chr3,100467056,1.8120915032679736,1108,917,2025,+
chr3,100467057,2.1958507837170775,1641,1348,2989,+
chr3,100467124,1.59229853116316,572,457,1029,+
chr3,100467248,1.7082178217821782,638,504,1142,+
chr3,101284602,2.3292113566618564,833,571,1404,+
chr3,101284713,1.8831060942154247,844,550,1394,+
chr3,101293078,4.622843764896046,615,522,1137,+
chr3,101298697,1.5508232278418614,714,482,1196,+
chr3,101298732,2.17479674796748,534,491,1025,+
chr3,101298736,1.7752205600306867,711,473,1184,+
chr3,101298774,0.6140669231327575,845,598,1443,+
chr3,101298810,1.6343246551324888,1073,816,1889,+
chr3,101304288,1.7333333333333332,692,494,1186,+
chr3,101304294,2.533067404606693,3841,2688,6529,+
chr3,101304350,2.5690156089780105,4746,3751,8497,+
chr3,101304351,2.5690156089780105,4746,3751,8497,+
chr3,101309058,2.492483684094742,2471,2097,4568,+
chr3,101311528,1.8303910402429764,664,438,1102,+
chr3,101311601,1.823121387283237,663,345,1008,+
chr3,101311627,7.181287770773092,2576,2235,4811,+
chr3,101311628,7.580125648771685,4257,3363,7620,+
chr3,101311643,9.338027270224803,3324,3212,6536,+
chr3,101311668,3.662265645629786,803,1081,1884,+
chr3,101312823,0.5634469696969697,849,479,1328,+
chr3,101477188,2.618870315331589,770,552,1322,+
chr3,107491639,2.133973710819009,937,515,1452,+
chr3,107491701,4.667884322678843,901,656,1557,+
chr3,107519985,3.1249405189859454,887,736,1623,+
chr3,107526373,0.9885222381635581,688,594,1282,+
chr3,107526374,0.9885222381635581,688,594,1282,+
chr3,107526411,1.489071038251366,544,487,1031,+
chr3,107526415,2.007929104477612,573,535,1108,+
chr3,107526674,70.70550256403081,699,640,1339,+
chr3,111578371,2.530534253857974,756,412,1168,+
chr3,111578394,2.231045167128382,858,548,1406,+
chr3,111603385,0.4181459566074951,741,363,1104,+
chr3,111603389,1.9536601062255543,2114,1220,3334,+
chr3,111603469,1.7028072848968372,1162,998,2160,+
chr3,111603470,1.6827058943557296,1757,1381,3138,+
chr3,111671449,2.6222546870687715,588,474,1062,+
chr3,111694885,1.5385248178758384,640,462,1102,+
chr3,111710470,1.6194042557620336,2162,1134,3296,+
chr3,111710475,1.8584831899921812,2376,1278,3654,+
chr3,111710477,1.8584831899921812,2376,1278,3654,+
chr3,111710513,2.372130704833918,1097,528,1625,+
chr3,111710558,1.7156040756914122,1900,1144,3044,+
chr3,111710563,1.612093909481067,5463,3587,9050,+
chr3,111710565,1.92793750101653,4134,2752,6886,+
chr3,113530462,3.0636604774535807,692,434,1126,+
chr3,113530470,0.50859291084855,946,531,1477,+
chr3,113530472,0.5661259501747815,1758,950,2708,+
chr3,113530489,1.9010248666927234,1884,1232,3116,+
chr3,113530504,1.7295138888888888,878,539,1417,+
chr3,113530510,1.8810550727150568,1577,1072,2649,+
chr3,113530522,1.7641144624903324,2280,1723,4003,+
chr3,113530523,1.7641144624903324,2280,1723,4003,+
chr3,113530539,3.150504124656279,1321,1090,2411,+
chr3,113530587,3.0561877845216556,785,582,1367,+
chr3,119219637,1.2815544909054908,667,525,1192,+
chr3,119222856,1.997229916897507,720,512,1232,+
chr3,119232510,1.8803285343993008,1337,780,2117,+
chr3,119232511,1.8803285343993008,1337,780,2117,+
chr3,119232559,1.4334559098565516,2264,1312,3576,+
chr3,119236054,1.888171304763945,2551,1554,4105,+
chr3,119236068,1.4334801488074171,3284,2133,5417,+
chr3,119236071,1.5251977089573752,1713,1092,2805,+
chr3,119236076,1.6664864540157387,3879,2684,6563,+
chr3,119236077,1.6664864540157387,3879,2684,6563,+
chr3,119242467,1.8421189979123171,542,478,1020,+
chr3,119242581,1.887895156291508,819,490,1309,+
chr3,119242765,0.2665770609318996,594,431,1025,+
chr3,120315184,1.1757813669241548,914,570,1484,+
chr3,120315187,2.5596126239797052,723,544,1267,+
chr3,120315218,1.4747199999999998,708,499,1207,+
chr3,120315273,1.7185495264082444,2446,1712,4158,+
chr3,120315275,1.5490669593852906,1028,910,1938,+
chr3,120315323,0.5505840071877808,1148,953,2101,+
chr3,120315354,1.4241286863270777,1327,1118,2445,+
chr3,120319957,1.4386082301773169,1547,1280,2827,+
chr3,120320089,1.8735882702595605,1575,926,2501,+
chr3,120321061,1.3990071584189232,6330,4049,10379,+
chr3,120321062,1.3990071584189232,6330,4049,10379,+
chr3,120321063,1.3990071584189232,6330,4049,10379,+
chr3,122103098,0.8287386687657797,634,477,1111,+
chr3,122103123,0.2747806608176218,551,486,1037,+
chr3,122103124,0.2747806608176218,551,486,1037,+
chr3,122121695,1.7108,657,499,1156,+
chr3,122121705,2.068814968814969,641,480,1121,+
chr3,122126149,0.5167803798635442,884,637,1521,+
chr3,122126168,1.9471563613823026,717,477,1194,+
chr3,122126213,1.5517813816881625,867,572,1439,+
chr3,122128628,1.9873576616157085,714,586,1300,+
chr3,122128657,2.7979579815432944,569,462,1031,+
chr3,122128720,2.056485607611706,682,436,1118,+
chr3,122821611,1.0527439675421737,579,445,1024,+
chr3,122821612,1.0527439675421737,579,445,1024,+
chr3,122821613,1.0527439675421737,579,445,1024,+
chr3,124456949,1.8730904900722556,1095,802,1897,+
chr3,124456950,1.4656170409817084,843,616,1459,+
chr3,124456951,1.0991352035435562,578,430,1008,+
chr3,124456963,1.4261951272401836,1334,1007,2341,+
chr3,124456964,2.0415959252971136,739,588,1327,+
chr3,124456967,1.0172012740560654,4366,3192,7558,+
chr3,124456968,1.0172012740560654,4366,3192,7558,+
chr3,124456990,1.598787429999537,704,696,1400,+
chr3,124457069,1.6095214701265121,655,445,1100,+
chr3,126571502,3.6136068422351393,940,612,1552,+
chr3,126571541,1.7234241473240608,1590,1097,2687,+
chr3,126571543,1.7234241473240608,1590,1097,2687,+
chr3,126571553,1.9338530748272462,1110,603,1713,+
chr3,126571562,1.4500991340336513,1794,1088,2882,+
chr3,126571563,2.247733077157384,1682,870,2552,+
chr3,126571565,2.3148590539894887,1139,597,1736,+
chr3,126633528,2.065528659338665,1665,1120,2785,+
chr3,126633529,1.746204409806176,2092,1423,3515,+
chr3,126633532,2.1069572759896844,3844,2716,6560,+
chr3,126633533,1.9362773497777883,4232,3138,7370,+
chr3,126633534,1.9290797596674398,6097,4597,10694,+
chr3,126633535,2.5502864474766667,6333,4698,11031,+
chr3,126633536,2.544360873648192,5409,4013,9422,+
chr3,127318213,0.8806221101303068,837,487,1324,+
chr3,127318215,0.8806221101303068,837,487,1324,+
chr3,127323481,2.818055071453468,734,452,1186,+
chr3,127323482,2.8501477802317017,948,607,1555,+
chr3,127323856,1.0441127119796132,741,465,1206,+
chr3,127323921,1.2756810345479144,609,489,1098,+
chr3,127325464,0.5055455856424497,700,480,1180,+
chr3,127325535,2.264516129032258,755,619,1374,+
chr3,127325537,2.264516129032258,755,619,1374,+
chr3,127327252,0.4385943355655219,648,396,1044,+
chr3,127327688,1.7833753148614608,1238,793,2031,+
chr3,127327690,1.8845332496977802,2154,1485,3639,+
chr3,127327699,1.8426323319027185,551,465,1016,+
chr3,127327773,1.3360649704949337,1540,1029,2569,+
chr3,127327801,2.5311544342507646,778,653,1431,+
chr3,127327860,2.571428571428572,575,447,1022,+
chr3,127334732,2.2146345305608066,906,551,1457,+
chr3,127335733,0.32980683834734914,851,652,1503,+
chr3,127336136,2.111342155009452,656,459,1115,+
chr3,127336820,2.0531190866551543,733,498,1231,+
chr3,127338015,2.235126201923077,782,511,1293,+
chr3,127338016,2.235126201923077,782,511,1293,+
chr3,127338020,1.8830693394428795,795,519,1314,+
chr3,127338074,2.633855184061845,1652,1216,2868,+
chr3,127338088,2.957575757575757,609,524,1133,+
chr3,127338110,1.8206632653061223,1286,879,2165,+
chr3,127338111,1.054423035980413,1685,975,2660,+
chr3,127338112,1.3982386000198244,2971,1854,4825,+
chr3,127339551,0.48073079075717584,924,757,1681,+
chr3,127339577,0.6360201113078674,1218,943,2161,+
chr3,127339579,1.77975875224868,5644,3574,9218,+
chr3,127339580,1.7400146963880292,8413,5836,14249,+
chr3,127339581,1.5315350181250562,3391,1913,5304,+
chr3,127339582,1.7340245557874263,3934,3204,7138,+
chr3,127339583,1.6019577923526525,2778,2324,5102,+
chr3,127339589,1.4307975633942485,1615,1447,3062,+
chr3,127339691,1.4591968315372568,1005,781,1786,+
chr3,127339948,0.6345776031434185,645,508,1153,+
chr3,127339999,2.076252723311547,952,755,1707,+
chr3,127340001,1.9747970396011052,1810,1293,3103,+
chr3,127340512,1.5503355704697983,692,595,1287,+
chr3,127340720,2.858728439325834,1061,837,1898,+
chr3,127340844,2.4802631578947367,695,455,1150,+
chr3,127340852,1.8408000000000002,707,499,1206,+
chr3,127340882,1.4005523901995187,1805,1377,3182,+
chr3,127341173,1.053717689607489,761,552,1313,+
chr3,127341175,1.053717689607489,761,552,1313,+
chr3,127358208,4.119047619047619,691,383,1074,+
chr3,127358209,4.119047619047619,691,383,1074,+
chr3,127358241,2.5059571333115853,720,464,1184,+
chr3,127358324,1.785714285714286,703,447,1150,+
chr3,127379227,2.3568802521008405,717,475,1192,+
chr3,127379403,3.944616470279,1362,1074,2436,+
chr3,127379404,3.6981788418252504,582,542,1124,+
chr3,127379446,2.6469579622511046,718,613,1331,+
chr3,127379855,1.359384197407948,933,771,1704,+
chr3,127379856,0.9774951076320938,554,510,1064,+
chr3,127379888,1.0302287581699348,872,611,1483,+
chr3,127379889,1.0302287581699348,872,611,1483,+
chr3,127379949,2.0994708994708997,991,755,1746,+
chr3,127379950,2.0994708994708997,991,755,1746,+
chr3,127390415,1.3014770662883888,780,504,1284,+
chr3,127391132,2.2606168244075096,651,565,1216,+
chr3,127391150,2.4325089468384458,1342,1764,3106,+
chr3,127391152,2.3397547633804687,1923,2262,4185,+
chr3,127391153,2.3238041890891634,959,1350,2309,+
chr3,127391268,12.652649735257928,1045,732,1777,+
chr3,127391269,13.400706536180394,1277,952,2229,+
chr3,127391270,12.560177407195525,1402,1039,2441,+
chr3,127391279,7.626902125813771,747,813,1560,+
chr3,127771693,0.5234371901759267,726,552,1278,+
chr3,127771707,2.914748453172666,1429,1101,2530,+
chr3,127771709,2.9996309963099628,738,541,1279,+
chr3,127785842,2.777957081148366,1218,801,2019,+
chr3,127785844,2.87354205033763,905,542,1447,+
chr3,127788716,0.5983224603914259,962,665,1627,+
chr3,127788895,1.8086608927381749,616,394,1010,+
chr3,127788995,2.7777310924369747,600,594,1194,+
chr3,127788997,2.7777310924369747,600,594,1194,+
chr3,127789059,1.541946902654867,846,564,1410,+
chr3,127789474,3.192338387869114,749,536,1285,+
chr3,127789475,3.192338387869114,749,536,1285,+
chr3,127789526,2.2164446410450944,993,766,1759,+
chr3,127789591,2.858749315187225,654,507,1161,+
chr3,127790215,1.5592390748773328,879,609,1488,+
chr3,127790425,8.99009322194029,1531,1030,2561,+
chr3,127790427,6.656669107663783,1083,675,1758,+
chr3,127790445,8.456494366587256,1561,1486,3047,+
chr3,127790446,8.225106624160935,1821,1847,3668,+
chr3,127790447,8.654507884816507,1397,1456,2853,+
chr3,128445026,0.6197914456693144,1234,906,2140,+
chr3,128445034,0.6980937311121828,1154,610,1764,+
chr3,128445035,0.5863941167268135,2329,1357,3686,+
chr3,128514204,0.8446428571428571,601,559,1160,+
chr3,128514206,0.8446428571428571,601,559,1160,+
chr3,128525321,1.6620008840430236,704,616,1320,+
chr3,128525372,2.4399168399168403,651,480,1131,+
chr3,128526418,1.2525185155685414,1174,757,1931,+
chr3,128526421,1.668103448275862,1547,927,2474,+
chr3,128526423,1.668103448275862,1547,927,2474,+
chr3,128526424,1.79290780141844,631,469,1100,+
chr3,128526437,1.1703543294730565,1667,1202,2869,+
chr3,128532201,1.177683947834637,1960,1378,3338,+
chr3,128532202,0.8130561942990628,2175,1578,3753,+
chr3,128532221,2.9498120955837472,1174,941,2115,+
chr3,128532232,2.055900100569896,662,627,1289,+
chr3,128532235,1.6475455046883618,720,685,1405,+
chr3,128532451,2.3641795865633077,828,700,1528,+
chr3,128532756,0.5145354021758517,576,533,1109,+
chr3,128532782,0.3321818058660163,612,398,1010,+
chr3,128532804,0.5693536673928832,783,560,1343,+
chr3,128532994,1.8808823368497853,971,671,1642,+
chr3,128533256,4.290970772442589,608,478,1086,+
chr3,128533257,4.290970772442589,608,478,1086,+
chr3,128631537,2.538798609813634,843,606,1449,+
chr3,128631787,26.81860959282587,815,472,1287,+
chr3,128631789,24.06250939980504,670,405,1075,+
chr3,128968559,1.6483963959446735,723,558,1281,+
chr3,128968561,2.4262840066789506,790,523,1313,+
chr3,128969552,3.12311901504788,760,558,1318,+
chr3,128969553,3.12311901504788,760,558,1318,+
chr3,128971147,1.2854947937117314,976,685,1661,+
chr3,128971532,1.7696139476961394,1217,802,2019,+
chr3,128971533,1.9371716990976395,1910,1323,3233,+
chr3,128971720,0.5632374631268438,610,451,1061,+
chr3,128973530,2.105124909706652,2199,1590,3789,+
chr3,128973531,1.9239396109228935,4433,3189,7622,+
chr3,128973533,1.689208550634632,4612,3266,7878,+
chr3,128973534,1.587581026231296,3725,2912,6637,+
chr3,128973536,1.644248787477954,2538,2015,4553,+
chr3,128973537,1.984770295783512,1212,680,1892,+
chr3,128973582,3.2526099846403653,910,618,1528,+
chr3,128973855,0.9343129537304294,762,617,1379,+
chr3,128973857,1.2453905523810966,1140,919,2059,+
chr3,128974976,2.221326164874552,669,557,1226,+
chr3,128974978,2.2517341748396045,1080,860,1940,+
chr3,128976365,1.1671611654500085,1065,883,1948,+
chr3,128976366,1.044840056732332,1589,1318,2907,+
chr3,128976612,1.2747406463695523,768,572,1340,+
chr3,128982781,1.8559272300469485,1264,851,2115,+
chr3,128982782,1.8559272300469485,1264,851,2115,+
chr3,128984534,2.586133802317752,890,566,1456,+
chr3,128986871,0.5514541387024608,811,595,1406,+
chr3,128986878,1.4907469327950595,2261,1651,3912,+
chr3,128987389,1.8702486097401751,1230,812,2042,+
chr3,128987795,2.287130290103899,1345,1152,2497,+
chr3,128987796,2.1503364630161905,2043,1572,3615,+
chr3,128987837,1.9503073312398256,883,727,1610,+
chr3,128991240,2.355255544840887,1135,609,1744,+
chr3,128991241,2.355255544840887,1135,609,1744,+
chr3,128991657,3.8858190709046454,690,408,1098,+
chr3,128991673,3.239739027283512,880,561,1441,+
chr3,128991687,1.7620640229335882,921,597,1518,+
chr3,128991695,1.7197563240128444,2010,1268,3278,+
chr3,128994107,0.4969040247678019,641,373,1014,+
chr3,128996138,4.98655462184874,1241,764,2005,+
chr3,128996139,4.98655462184874,1241,764,2005,+
chr3,128996171,1.3991364219862297,1163,901,2064,+
chr3,128996172,1.1804804957618906,1691,1321,3012,+
chr3,128996173,0.6418390046963829,778,457,1235,+
chr3,128996184,1.907560975609756,710,614,1324,+
chr3,128996489,1.0058173356602675,493,572,1065,+
chr3,128996490,1.0058173356602675,493,572,1065,+
chr3,130649322,3.4375,604,549,1153,+
chr3,130649323,3.4375,604,549,1153,+
chr3,130649335,0.9857904085257548,554,562,1116,+
chr3,130649336,0.9857904085257548,554,562,1116,+
chr3,130650897,2.1424658128149434,1388,1109,2497,+
chr3,130682894,0.9765732592675134,923,590,1513,+
chr3,130712920,9.56508515815085,628,410,1038,+
chr3,130712921,9.56508515815085,628,410,1038,+
chr3,133292843,0.49347608899026585,580,470,1050,+
chr3,133293891,0.5528548646110096,617,642,1259,+
chr3,133293912,1.2045211863629257,705,700,1405,+
chr3,133302923,6.792819886792976,3378,1112,4490,+
chr3,133302924,3.770024772914946,793,345,1138,+
chr3,133302925,7.43247223871793,5677,1939,7616,+
chr3,133302926,8.81904306020264,5165,1905,7070,+
chr3,133302927,9.635294117647058,1871,594,2465,+
chr3,133302928,4.89997408655092,1145,453,1598,+
chr3,133302930,10.702481253784468,2411,1584,3995,+
chr3,133302931,10.075355022789713,4835,3448,8283,+
chr3,133302932,9.492334704191206,4056,2973,7029,+
chr3,133306919,2.16341616860648,654,373,1027,+
chr3,133307001,0.4699423247559893,891,735,1626,+
chr3,133307002,0.9380501395947695,1226,962,2188,+
chr3,133307410,1.8967348851741916,1064,864,1928,+
chr3,133307411,1.8967348851741916,1064,864,1928,+
chr3,133307622,19.904332873897182,2045,1327,3372,+
chr3,133307623,13.187132656323023,2183,1481,3664,+
chr3,133307624,10.884313725490196,914,449,1363,+
chr3,133307796,1.1317899316121174,729,625,1354,+
chr3,133307905,0.4772374417789353,732,486,1218,+
chr3,133308652,1.6026299475449264,562,508,1070,+
chr3,133308822,4.712882266169015,795,594,1389,+
chr3,133538560,5.728698496710565,1777,1298,3075,+
chr3,133538561,5.355220982429832,1527,1104,2631,+
chr3,133538621,0.41510417542133093,861,586,1447,+
chr3,134251652,2.9808917197452227,683,470,1153,+
chr3,134251653,2.9808917197452227,683,470,1153,+
chr3,136035819,2.109087481380754,1048,779,1827,+
chr3,136045657,2.576808962814413,831,569,1400,+
chr3,136046549,2.651845363814979,631,455,1086,+
chr3,136664867,0.3092772103622579,726,522,1248,+
chr3,136665075,1.5682300722163522,617,407,1024,+
chr3,136667228,2.5284831846259435,920,563,1483,+
chr3,136667229,2.5284831846259435,920,563,1483,+
chr3,136667354,1.9997970779220782,656,447,1103,+
chr3,136667477,2.250013903526405,618,460,1078,+
chr3,136667481,1.2103644487599852,832,601,1433,+
chr3,136667716,3.899667361973103,898,571,1469,+
chr3,137993325,4.164206477322353,652,428,1080,+
chr3,139065736,0.7530413625304136,618,410,1028,+
chr3,139065738,0.5739549839228296,965,621,1586,+
chr3,139065740,0.2005395683453237,668,416,1084,+
chr3,139065751,2.321139414937958,662,487,1149,+
chr3,139067004,1.9712565943282494,3256,2402,5658,+
chr3,139067006,2.0174690895466467,3113,2511,5624,+
chr3,139067007,1.838270400120111,2110,1729,3839,+
chr3,139067015,1.6047735699152543,1468,1023,2491,+
chr3,140695557,1.6090817064285414,646,431,1077,+
chr3,140696160,3.275076194597519,896,568,1464,+
chr3,140696739,18.386789006451952,648,393,1041,+
chr3,140697064,2.0066574380628683,627,416,1043,+
chr3,140698311,2.1207972054145094,683,490,1173,+
chr3,141166424,1.3025136501177321,2115,1192,3307,+
chr3,141166425,0.976506285218899,1407,768,2175,+
chr3,141166431,1.431365517241379,978,624,1602,+
chr3,141166451,1.1380783877235774,3705,2391,6096,+
chr3,141166453,0.5511286292754373,2610,1589,4199,+
chr3,141166454,1.5483624193162802,1407,889,2296,+
chr3,141166455,2.3814762623480856,2447,1968,4415,+
chr3,141166457,2.040403143834734,3730,3036,6766,+
chr3,141166458,1.734730480672187,2524,2081,4605,+
chr3,141464017,1.006225296442688,598,459,1057,+
chr3,141464019,1.006225296442688,598,459,1057,+
chr3,141464103,1.5662668573634735,615,447,1062,+
chr3,141595643,1.9170643535965914,858,629,1487,+
chr3,141595721,0.6816737288135593,584,471,1055,+
chr3,141595722,0.6777696258253852,893,704,1597,+
chr3,141622464,1.731640041374555,987,790,1777,+
chr3,141622476,1.90797779298806,783,486,1269,+
chr3,141622487,1.5904934177469603,832,641,1473,+
chr3,141622562,0.6981993195585429,1201,926,2127,+
chr3,141626063,1.3063157894736843,2408,1649,4057,+
chr3,141632563,0.6987704918032787,1704,1219,2923,+
chr3,141640892,2.0769065736026087,2993,1815,4808,+
chr3,141640893,3.5155036060200047,4648,3024,7672,+
chr3,141640894,2.0680954964731417,967,775,1742,+
chr3,141644383,0.6721759500260281,1032,790,1822,+
chr3,141644523,1.2968696526351815,2224,1460,3684,+
chr3,141644687,1.530169491525424,1627,1099,2726,+
chr3,141644750,1.9071203528670448,817,689,1506,+
chr3,141644819,1.6290351664908886,2106,1640,3746,+
chr3,142740371,2.390579708481343,605,413,1018,+
chr3,142741393,0.5611346018322763,636,527,1163,+
chr3,142741414,1.2420576001695112,1315,1010,2325,+
chr3,142741420,0.5388963660834455,1000,742,1742,+
chr3,142741424,1.7999567109978114,1187,966,2153,+
chr3,142741425,1.7999567109978114,1187,966,2153,+
chr3,142747361,1.2862644415917843,667,491,1158,+
chr3,142747363,1.967636457933941,1836,1262,3098,+
chr3,142747364,2.3743523316062176,1169,771,1940,+
chr3,142747381,1.8795731707317076,684,491,1175,+
chr3,142769873,2.853981106612685,621,493,1114,+
chr3,142775226,9.697130769704232,676,504,1180,+
chr3,148727080,2.7730201590311223,702,527,1229,+
chr3,150270146,1.0835759611795446,1000,704,1704,+
chr3,150270147,1.2954044048029338,1340,966,2306,+
chr3,150270160,2.163291277581709,987,811,1798,+
chr3,150270184,0.5803591221458657,951,693,1644,+
chr3,150270192,0.3023145961265942,559,510,1069,+
chr3,150280336,2.094949494949495,914,549,1463,+
chr3,150280347,1.783517417162277,655,534,1189,+
chr3,150280412,1.7456516383345653,1041,614,1655,+
chr3,150281307,1.7847888053899972,550,453,1003,+
chr3,150281343,2.7024584237165583,597,460,1057,+
chr3,150281388,1.899168975069252,856,721,1577,+
chr3,150281395,1.4694562146892656,1188,767,1955,+
chr3,150285708,0.8960824742268041,1271,969,2240,+
chr3,150285709,0.8960824742268041,1271,969,2240,+
chr3,150285743,2.763728813559322,788,589,1377,+
chr3,150286056,1.9215853762706077,702,508,1210,+
chr3,150290047,1.768147145669291,870,507,1377,+
chr3,150290122,1.763200078916866,1323,942,2265,+
chr3,150290144,0.6437978426874055,2071,1484,3555,+
chr3,150290310,1.7436166940114848,1114,847,1961,+
chr3,150293532,1.64373621270173,808,637,1445,+
chr3,150301011,2.541038525963149,778,596,1374,+
chr3,150301727,1.5674600628729072,2035,1416,3451,+
chr3,150301771,1.490126504165381,1485,925,2410,+
chr3,150301774,1.8722222222222225,1010,674,1684,+
chr3,150301883,1.2079724437859003,3670,1960,5630,+
chr3,150301913,1.7032640949554896,2435,2021,4456,+
chr3,150340205,0.9864267676767676,624,395,1019,+
chr3,150340206,0.9864267676767676,624,395,1019,+
chr3,150340217,1.8684487074314804,678,518,1196,+
chr3,150342677,0.7156370586256311,1109,708,1817,+
chr3,150342679,0.9813829787234043,737,422,1159,+
chr3,150342680,2.4116007211882087,1067,829,1896,+
chr3,150342681,1.8155448288191651,828,677,1505,+
chr3,150345509,3.002028146185589,925,605,1530,+
chr3,150346058,1.8043577831577569,765,526,1291,+
chr3,152017343,4.6164466048410775,650,501,1151,+
chr3,152180625,5.018644094661287,754,469,1223,+
chr3,152181599,1.7861863464694214,789,607,1396,+
chr3,152181717,2.725526432849957,572,438,1010,+
chr3,152182903,2.2307531788067694,1642,1186,2828,+
chr3,155611346,2.4442528486240334,632,427,1059,+
chr3,155615739,0.3726456099681252,642,405,1047,+
chr3,155621735,2.647745358090186,650,434,1084,+
chr3,155624036,1.9833591331269351,1124,611,1735,+
chr3,155624037,1.9064562410329982,603,409,1012,+
chr3,155628486,0.6121105232216343,821,566,1387,+
chr3,155628496,1.4199212836815018,2099,1100,3199,+
chr3,155628501,1.5416132067402275,2420,1298,3718,+
chr3,155629042,1.981972111553785,736,501,1237,+
chr3,155633887,0.58080152067163,678,534,1212,+
chr3,155633966,0.5124516960068699,650,410,1060,+
chr3,155654159,1.7845586238921212,565,442,1007,+
chr3,156422999,50.28571428571428,807,201,1008,+
chr3,156423000,23.023,818,449,1267,+
chr3,156423001,15.522954880413977,2064,2460,4524,+
chr3,156423002,15.317990764032754,1863,2454,4317,+
chr3,156423003,13.783174384051726,1333,1759,3092,+
chr3,156423027,0.13378756982395518,350,683,1033,+
chr3,158254895,3.2557657752781,742,464,1206,+
chr3,158254896,4.1090467252622815,721,477,1198,+
chr3,158366927,3.066812534327137,788,628,1416,+
chr3,158369960,2.4368549062422207,973,609,1582,+
chr3,158369966,2.1998898678414096,704,453,1157,+
chr3,158369975,1.1687263556116017,1985,1219,3204,+
chr3,158369976,1.6088082901554404,620,385,1005,+
chr3,158369977,1.2002276453110012,3014,1999,5013,+
chr3,158369979,1.2560209743308333,1029,780,1809,+
chr3,158369982,0.4509145203434117,603,422,1025,+
chr3,158370001,2.758061902446929,919,560,1479,+
chr3,158402447,0.2368256218403846,566,439,1005,+
chr3,158409644,1.949791921041921,907,731,1638,+
chr3,158409798,2.4952098081460967,685,455,1140,+
chr3,158538017,1.4021739130434785,687,447,1134,+
chr3,160117490,8.169625340715804,983,678,1661,+
chr3,160134167,0.6382024304705979,1251,731,1982,+
chr3,160134172,0.4041818181818182,1481,824,2305,+
chr3,160134198,2.179746835443038,1270,789,2059,+
chr3,160135540,1.2019892750893744,1219,741,1960,+
chr3,160137273,1.8791574279379157,677,573,1250,+
chr3,160137276,2.110748256253681,1749,1422,3171,+
chr3,160137285,1.955352606599834,1660,1716,3376,+
chr3,160137287,1.955352606599834,1660,1716,3376,+
chr3,160141420,2.050447090056377,746,637,1383,+
chr3,160141611,0.5830721003134797,557,494,1051,+
chr3,160142656,0.2961538461538461,615,389,1004,+
chr3,160142659,0.554765810096592,1521,825,2346,+
chr3,160142661,0.554765810096592,1521,825,2346,+
chr3,160142666,1.747141041931385,899,786,1685,+
chr3,160142691,0.5768460575719649,1256,1019,2275,+
chr3,160142782,0.4588761423293798,707,416,1123,+
chr3,160148458,2.139276649746193,612,393,1005,+
chr3,160148476,2.6755852842809364,599,413,1012,+
chr3,160148832,1.8448551062465122,1078,804,1882,+
chr3,160148880,0.3170506912442396,558,454,1012,+
chr3,160151571,1.990269549592473,1076,850,1926,+
chr3,160152380,1.7370650183150185,606,415,1021,+
chr3,160152613,2.2750289671342303,883,701,1584,+
chr3,160152690,2.3688658790211954,753,836,1589,+
chr3,160152692,2.3688658790211954,753,836,1589,+
chr3,160956543,0.5658745730688176,598,416,1014,+
chr3,160958881,1.5580144020799647,1301,1031,2332,+
chr3,160958882,1.0583449558344955,784,716,1500,+
chr3,160958931,2.6733720754479653,709,599,1308,+
chr3,160967250,2.05266041224406,1089,858,1947,+
chr3,160967251,2.05266041224406,1089,858,1947,+
chr3,160967254,2.0222960151802654,587,495,1082,+
chr3,169684615,3.0162169503433116,606,427,1033,+
chr3,169684617,4.798125853899441,780,533,1313,+
chr3,169693403,2.90620307426492,590,477,1067,+
chr3,169693449,1.4699797136526531,858,683,1541,+
chr3,169693496,2.0423500611995107,617,429,1046,+
chr3,169694826,1.2526003659543827,1176,830,2006,+
chr3,169710554,2.4998575874161344,854,685,1539,+
chr3,169710660,4.224810974533905,1094,988,2082,+
chr3,169710661,3.7028001858571375,1718,1434,3152,+
chr3,169710697,0.3205724508050089,511,519,1030,+
chr3,169710699,0.3205724508050089,511,519,1030,+
chr3,169710878,3.9141865079365092,606,447,1053,+
chr3,169993064,2.347478766570843,1430,825,2255,+
chr3,169993066,2.084254584108424,1802,1059,2861,+
chr3,169993067,2.10232825524576,1907,1175,3082,+
chr3,169993069,1.5684894055290381,1766,1089,2855,+
chr3,169998094,2.5619678334910123,1353,1207,2560,+
chr3,169998097,1.5001745810055866,1321,715,2036,+
chr3,170016865,1.4851859762596782,796,615,1411,+
chr3,170021776,1.5278367560041768,631,396,1027,+
chr3,170022554,2.1102743402939845,743,457,1200,+
chr3,170022847,1.3527346741661292,736,569,1305,+
chr3,172472340,1.1722690439624048,1002,747,1749,+
chr3,172472341,2.719444444444445,622,419,1041,+
chr3,172480559,4.22486144101346,695,420,1115,+
chr3,172480718,1.8766373053578804,797,678,1475,+
chr3,172482110,1.9365904365904365,689,480,1169,+
chr3,172486816,2.236697839406643,577,442,1019,+
chr3,172491699,2.311197248497201,866,582,1448,+
chr3,172499960,0.5980066445182723,809,629,1438,+
chr3,172499972,2.6863693075483472,688,457,1145,+
chr3,172502537,0.74581795523175,777,672,1449,+
chr3,172502538,0.74581795523175,777,672,1449,+
chr3,172520735,2.2705882352941176,771,577,1348,+
chr3,172520736,2.2705882352941176,771,577,1348,+
chr3,172534533,0.6861395660608022,3923,2417,6340,+
chr3,172534534,0.6866170318704123,3775,2370,6145,+
chr3,172534536,0.7743928823722758,3491,2175,5666,+
chr3,179085243,1.9500681091649907,690,442,1132,+
chr3,179085329,1.0682769288004605,733,469,1202,+
chr3,179085352,1.7740481100109287,1394,781,2175,+
chr3,179085353,2.22583850931677,1053,574,1627,+
chr3,179085832,1.8261597321855572,1090,573,1663,+
chr3,179085834,1.9885979729729728,1661,887,2548,+
chr3,179085836,2.4785975072390785,1124,610,1734,+
chr3,179085839,1.237399038240952,2243,1219,3462,+
chr3,179085840,1.6345117845117847,1386,659,2045,+
chr3,179085875,2.1880979284369118,936,530,1466,+
chr3,179085880,1.9358058788715724,1140,684,1824,+
chr3,179109825,1.2947837700954123,679,414,1093,+
chr3,179110481,1.6909600795765851,1456,708,2164,+
chr3,179110482,1.358099352051836,916,462,1378,+
chr3,179110530,1.8439820601426362,759,468,1227,+
chr3,179287644,1.034354644149578,1260,828,2088,+
chr3,179287645,1.034354644149578,1260,828,2088,+
chr3,179287653,2.2177953234133008,1431,889,2320,+
chr3,179287655,2.2177953234133008,1431,889,2320,+
chr3,179287677,2.383558624742874,1029,663,1692,+
chr3,179287682,0.5937949374569093,1255,780,2035,+
chr3,179287857,1.6822410865874364,1435,949,2384,+
chr3,179291212,1.5390066925865526,724,608,1332,+
chr3,179304356,2.966701262829625,752,512,1264,+
chr3,179332767,2.843621399176955,690,485,1175,+
chr3,179332770,1.813542074363992,723,510,1233,+
chr3,179336301,1.4487184413787804,1449,981,2430,+
chr3,179342083,1.3104125624226877,2570,1678,4248,+
chr3,179342156,1.6068214026603163,3050,2118,5168,+
chr3,180322763,2.0983606602101528,790,482,1272,+
chr3,180322775,2.6310705134847194,1071,694,1765,+
chr3,180323589,1.8945320499692813,637,513,1150,+
chr3,180323593,2.4037961617860693,1412,1275,2687,+
chr3,180323594,2.4037961617860693,1412,1275,2687,+
chr3,180666146,0.4492198999116867,762,631,1393,+
chr3,180667127,1.6772864162307812,961,700,1661,+
chr3,180669201,1.860258780036969,628,540,1168,+
chr3,180669219,3.457814661134164,624,481,1105,+
chr3,180669248,1.4978097363418463,883,653,1536,+
chr3,180675622,2.1007781604796527,715,602,1317,+
chr3,180675634,2.2351190476190474,750,615,1365,+
chr3,180675642,2.200374651534602,2102,1603,3705,+
chr3,180675675,1.9502196193265007,813,682,1495,+
chr3,180675698,1.4645526589281648,2480,1713,4193,+
chr3,180680701,1.5443208070077847,2690,2071,4761,+
chr3,180686020,2.1546603475513426,592,421,1013,+
chr3,180686023,1.862147177419355,820,495,1315,+
chr3,180686034,0.5968660968660968,837,623,1460,+
chr3,180687947,1.968791064388962,921,760,1681,+
chr3,180687950,0.4967376642931082,1172,897,2069,+
chr3,180687951,1.5721494447918034,3713,2804,6517,+
chr3,180687952,1.6252948159873368,2615,1804,4419,+
chr3,180688015,2.254344122657581,801,586,1387,+
chr3,180688115,1.7823935814575442,768,640,1408,+
chr3,180693106,2.0366428824349194,830,677,1507,+
chr3,180694388,47.18044034466988,922,337,1259,+
chr3,180694389,31.91535378052368,742,288,1030,+
chr3,180694392,10.955809025180752,444,763,1207,+
chr3,180694393,15.902346860830379,1633,2590,4223,+
chr3,180694394,15.902346860830379,1633,2590,4223,+
chr3,180694398,6.052135269323728,790,2036,2826,+
chr3,180694447,0.4065995662428675,903,1306,2209,+
chr3,180694649,3.6030236422516166,653,424,1077,+
chr3,183894794,1.6280620907106476,894,531,1425,+
chr3,183896674,1.670408389220338,2397,1447,3844,+
chr3,183896676,1.5799604925818518,2031,1132,3163,+
chr3,183896711,0.6120920837251419,924,562,1486,+
chr3,183896717,0.5520524426408615,785,595,1380,+
chr3,183896777,1.5962147380541165,1081,771,1852,+
chr3,183897981,0.786369575491368,3662,2766,6428,+
chr3,183898002,1.6969450869305336,2440,1672,4112,+
chr3,183898911,1.8188188188188188,710,665,1375,+
chr3,183898913,1.6220154164316598,1014,590,1604,+
chr3,183898914,1.5977961432506886,724,549,1273,+
chr3,183898920,1.952526799387443,1049,652,1701,+
chr3,183898924,0.5233766233766234,805,594,1399,+
chr3,183898936,2.1292682926829265,581,532,1113,+
chr3,183898962,2.7579393871741917,796,778,1574,+
chr3,183898968,1.5335395720546532,1213,861,2074,+
chr3,183899567,0.5643218033424019,1583,1115,2698,+
chr3,183899569,1.6549,870,624,1494,+
chr3,183899755,1.998625944663044,999,592,1591,+
chr3,183899769,0.597348303870043,1666,965,2631,+
chr3,183899986,1.9749430523917997,577,438,1015,+
chr3,183900004,2.0471311475409832,628,487,1115,+
chr3,183900017,1.7769516728624535,716,537,1253,+
chr3,183900569,1.9203251723263475,1935,1344,3279,+
chr3,183900576,1.8069040697674417,1057,687,1744,+
chr3,183900586,1.579033579033579,963,665,1628,+
chr3,183901609,2.0894179894179894,717,419,1136,+
chr3,183901643,2.289473684210526,695,455,1150,+
chr3,183901774,1.545058139534884,1062,687,1749,+
chr3,184017647,1.6748544550261584,1281,891,2172,+
chr3,184017649,2.040340909090909,1025,659,1684,+
chr3,184017666,0.561103244474543,650,438,1088,+
chr3,184018133,2.057632769707073,719,441,1160,+
chr3,184019346,1.8199793418916923,880,501,1381,+
chr3,184020224,1.801573781130851,693,586,1279,+
chr3,184020286,1.3039155641426587,1607,1062,2669,+
chr3,184020297,2.3021523178807946,926,603,1529,+
chr3,184020474,1.822778827977316,797,528,1325,+
chr3,184021226,0.4917929292929292,778,494,1272,+
chr3,184021238,0.8429275347340809,1543,1336,2879,+
chr3,184021239,0.7866855510327492,1956,1499,3455,+
chr3,184021496,1.9059805781619679,1197,805,2002,+
chr3,184022160,2.534210526315789,641,379,1020,+
chr3,184023586,1.6956574998468794,790,562,1352,+
chr3,184023613,2.565445026178011,783,572,1355,+
chr3,184024173,2.3890587464511905,662,481,1143,+
chr3,184024247,2.032781754192318,704,595,1299,+
chr3,184024554,2.3826668303329983,1853,1278,3131,+
chr3,184024556,2.3826668303329983,1853,1278,3131,+
chr3,184024581,1.4504296100462657,692,533,1225,+
chr3,184025202,2.0539762192008335,807,732,1539,+
chr3,184025239,0.4128363697141902,569,578,1147,+
chr3,184025735,2.384157322551932,890,673,1563,+
chr3,184025740,1.1309413038795892,752,647,1399,+
chr3,184037509,1.3243480172734086,787,501,1288,+
chr3,184037542,2.6160040598818872,627,530,1157,+
chr3,184038419,2.537617399901137,712,594,1306,+
chr3,184038420,2.537617399901137,712,594,1306,+
chr3,184038421,1.1333654820042975,1058,772,1830,+
chr3,184039299,3.059429666906303,750,641,1391,+
chr3,184039301,3.059429666906303,750,641,1391,+
chr3,184039689,3.5883891734466107,1174,744,1918,+
chr3,184039691,2.896223923950356,913,540,1453,+
chr3,184039861,0.9186768402741262,948,686,1634,+
chr3,184039888,2.127664399092971,852,419,1271,+
chr3,184040434,2.4263378110548337,786,477,1263,+
chr3,184040467,1.575637674715983,1945,1361,3306,+
chr3,184040476,1.9290060851926978,950,781,1731,+
chr3,184040478,1.6980628246832064,1398,957,2355,+
chr3,184040635,2.224644801847561,3440,2552,5992,+
chr3,184040637,2.064012577018357,1732,1210,2942,+
chr3,184040639,2.0374531835206,679,444,1123,+
chr3,184041219,2.198591750721251,813,489,1302,+
chr3,184041230,3.174198717948718,682,415,1097,+
chr3,184041232,2.6732343999241928,1158,814,1972,+
chr3,184041279,2.9878189739486083,1083,977,2060,+
chr3,184041280,2.9878189739486083,1083,977,2060,+
chr3,184041281,2.9878189739486083,1083,977,2060,+
chr3,184042005,1.9204389574759941,1014,728,1742,+
chr3,184042006,1.9204389574759941,1014,728,1742,+
chr3,184042014,1.9544604927782503,638,534,1172,+
chr3,184042743,2.1534455128205128,644,415,1059,+
chr3,184042891,1.4306878306878308,844,524,1368,+
chr3,184042899,0.5994749861174214,949,638,1587,+
chr3,184043154,1.8575997306850698,711,456,1167,+
chr3,184043280,1.5499283336085565,2452,1445,3897,+
chr3,184043282,1.41687552213868,1055,626,1681,+
chr3,184043303,1.8050255987101687,4076,2541,6617,+
chr3,184043306,1.4291199667911996,1464,802,2266,+
chr3,184043341,1.671794871794872,651,454,1105,+
chr3,184043645,2.5381503602917257,594,483,1077,+
chr3,184044401,1.2622069350957432,880,572,1452,+
chr3,184044687,3.0162105703687874,1383,967,2350,+
chr3,184044738,2.122555541852876,1026,805,1831,+
chr3,184044741,0.6117274167987321,771,630,1401,+
chr3,184045087,10.162315802852511,2091,1386,3477,+
chr3,184045088,11.054452920649146,2221,1501,3722,+
chr3,184045089,10.162315802852511,2091,1386,3477,+
chr3,184045432,2.2826946472019465,882,547,1429,+
chr3,184045433,2.446534292455406,1117,752,1869,+
chr3,184045437,1.8177389702398326,727,533,1260,+
chr3,184045465,2.346102491461125,965,717,1682,+
chr3,184046425,1.8938691086888988,1251,924,2175,+
chr3,184046426,2.0470035252643948,669,554,1223,+
chr3,184046453,1.6785028790786949,741,520,1261,+
chr3,184049102,1.2729046563192905,551,450,1001,+
chr3,184049103,1.2729046563192905,551,450,1001,+
chr3,184049538,0.5966487788851167,680,396,1076,+
chr3,184049792,1.2881433272807,1089,787,1876,+
chr3,184081314,2.0273224043715845,529,487,1016,+
chr3,184081341,1.6946818613485282,746,701,1447,+
chr3,184084522,3.0485375494071145,621,574,1195,+
chr3,184086057,1.336753217766949,1009,725,1734,+
chr3,184086205,2.4032761310452417,1026,640,1666,+
chr3,184086206,2.2150244964616226,1564,1001,2565,+
chr3,184086208,2.1384393063583818,1056,691,1747,+
chr3,184086295,1.6301669860388726,793,561,1354,+
chr3,186289988,1.0776829815895823,999,654,1653,+
chr3,186289990,1.0776829815895823,999,654,1653,+
chr3,186289997,0.5605058378370347,1096,852,1948,+
chr3,186290008,1.1022067668102509,1034,882,1916,+
chr3,186293713,1.5678845137420716,1216,703,1919,+
chr3,186293717,1.436622123553772,1345,793,2138,+
chr3,186293723,1.4996420332511335,1570,966,2536,+
chr3,186299794,0.8071284851968957,623,496,1119,+
chr3,186299795,0.8071284851968957,623,496,1119,+
chr3,186299814,0.4071964017991004,775,579,1354,+
chr3,186299816,0.4071964017991004,775,579,1354,+
chr3,186302303,1.7812164195142917,591,422,1013,+
chr3,186501366,0.552438114855986,548,760,1308,+
chr3,186501367,0.552438114855986,548,760,1308,+
chr3,186501368,0.552438114855986,548,760,1308,+
chr3,186501386,0.9667807366953401,2190,2062,4252,+
chr3,186501388,0.6112594469144479,2557,2628,5185,+
chr3,186501389,0.6076141753535034,2297,2056,4353,+
chr3,186501396,1.1080633076332866,2630,2212,4842,+
chr3,186501399,1.6508247345032765,842,780,1622,+
chr3,186501421,1.3854348523176685,2827,2158,4985,+
chr3,186502219,0.3966819844766291,1943,1432,3375,+
chr3,186502239,1.7661252900232018,1556,1292,2848,+
chr3,186503739,0.7854404365600257,5448,4028,9476,+
chr3,186503957,1.6198164483649644,3951,2493,6444,+
chr3,186504960,1.3783127441664027,3293,2078,5371,+
chr3,186505186,0.7317544604927781,732,534,1266,+
chr3,186505353,1.332684824902724,2739,2055,4794,+
chr3,186505358,1.9765304558753767,5221,4332,9553,+
chr3,191074927,2.7332920792079207,630,403,1033,+
chr3,191074928,2.7332920792079207,630,403,1033,+
chr3,191075793,2.183232259477819,868,675,1543,+
chr3,193374979,2.0544590512903484,688,463,1151,+
chr3,193380619,1.2566243194192377,576,434,1010,+
chr3,193380620,1.2566243194192377,576,434,1010,+
chr3,193380655,2.2127531337285182,711,626,1337,+
chr3,193385026,1.428358824411456,733,502,1235,+
chr3,193854253,1.9946735352548486,1032,761,1793,+
chr3,196313929,1.5142944941367023,1910,1452,3362,+
chr3,196313930,1.5142944941367023,1910,1452,3362,+
chr3,196313954,2.229437229437229,617,566,1183,+
chr3,196454906,2.585987261146497,1072,627,1699,+
chr3,196454907,2.585987261146497,1072,627,1699,+
chr3,196454908,2.585987261146497,1072,627,1699,+
chr3,196541416,1.261448725170558,561,455,1016,+
chr3,196670239,0.45708890697879084,597,436,1033,+
chr3,197483309,0.786243631310792,678,507,1185,+
chr3,197483311,1.6217164179104475,700,535,1235,+
chr3,197483312,2.8068984410163855,873,642,1515,+
chr3,197508854,3.393396884445478,694,390,1084,+
chr3,197508855,3.393396884445478,694,390,1084,+
chr3,197509100,2.611416352182514,722,515,1237,+
chr3,197509492,1.0474955023824588,1121,729,1850,+
chr3,197509542,3.610658603579442,875,629,1504,+
chr3,197677063,1.0317090500141919,10615,6823,17438,+
chr3,197677064,1.0442512758776221,18620,12733,31353,+
chr3,197677065,1.0442512758776221,18620,12733,31353,+
chr3,197677066,1.04250548323154,21819,14612,36431,+
chr3,197677068,0.8826631896761596,18629,13155,31784,+
chr3,197677078,1.1560891994099651,16528,11888,28416,+
chr3,197677827,0.8580664278459452,8306,6153,14459,+
chr3,197677828,0.859904862276136,8722,6887,15609,+
chr3,197678027,0.9187510999142009,1218,832,2050,+
chr3,197678028,1.0147699773010086,678,408,1086,+
chr3,197678103,1.3650692755453258,12920,8115,21035,+
chr3,197680922,3.3630894330079086,22070,17573,39643,+
chr3,197680926,1.2196607851149677,16104,11709,27813,+
chr4,1333005,5.829089745809481,4242,2560,6802,+
chr4,1333006,5.800668956375582,4374,2649,7023,+
chr4,1333007,4.114402008019514,4910,3135,8045,+
chr4,1333009,1.2738028169014082,1291,1135,2426,+
chr4,1333024,0.2208102054727821,906,651,1557,+
chr4,1742606,2.015437649880096,790,555,1345,+
chr4,1742608,2.5621707983407513,1027,674,1701,+
chr4,1742645,1.5839311334289812,815,577,1392,+
chr4,1936889,0.3942265038967131,1202,709,1911,+
chr4,1936890,0.3802083333333333,656,359,1015,+
chr4,1936924,1.9294271919890325,1078,882,1960,+
chr4,1936925,2.168928844717838,2216,1735,3951,+
chr4,1936927,2.24637526652452,1108,937,2045,+
chr4,2470974,0.580537518037518,740,412,1152,+
chr4,2470975,1.040362283578023,965,531,1496,+
chr4,2470977,2.4693468946707817,705,395,1100,+
chr4,2492071,3.086397599278161,661,389,1050,+
chr4,2492095,0.25993854263486144,1398,791,2189,+
chr4,2492097,0.2739082365948038,990,602,1592,+
chr4,2492118,0.9370529696398693,2215,1198,3413,+
chr4,2492120,1.314173554463112,889,518,1407,+
chr4,2492132,1.9561736198904336,1054,677,1731,+
chr4,2886370,2.6052631578947367,809,539,1348,+
chr4,2886371,2.6052631578947367,809,539,1348,+
chr4,2886385,2.6159402479131773,588,455,1043,+
chr4,2895758,3.041131105398457,636,388,1024,+
chr4,2895759,3.041131105398457,636,388,1024,+
chr4,2909513,2.892059553349876,665,495,1160,+
chr4,2909517,2.052595354172641,905,633,1538,+
chr4,2909518,2.052595354172641,905,633,1538,+
chr4,6642410,0.9385811186936893,1796,909,2705,+
chr4,6642411,0.94161031667188,2975,1631,4606,+
chr4,6642474,0.8990384615384618,879,519,1398,+
chr4,6642475,0.8990384615384618,879,519,1398,+
chr4,6642650,2.7305790960451977,702,471,1173,+
chr4,6642656,2.129388903779148,962,573,1535,+
chr4,6642665,2.2503996163682864,760,543,1303,+
chr4,6642698,1.9875111507582517,556,471,1027,+
chr4,6642764,1.676595744680851,787,469,1256,+
chr4,6642785,1.8576052814757507,1034,827,1861,+
chr4,6642823,1.117673141891892,1230,739,1969,+
chr4,6642824,1.3611612294082411,1783,1200,2983,+
chr4,6642828,0.6057725869244194,777,572,1349,+
chr4,6642837,0.39256415161313507,1589,1077,2666,+
chr4,6642905,1.4956346083465366,1689,1160,2849,+
chr4,6642953,1.1876417344207622,1534,1141,2675,+
chr4,6643469,2.467550143266476,930,697,1627,+
chr4,6643480,1.9102112676056335,769,567,1336,+
chr4,6643498,1.9856910229936664,3185,2377,5562,+
chr4,6643833,1.923563162501216,1289,790,2079,+
chr4,6643875,1.6247778624016247,1199,908,2107,+
chr4,6643967,1.5042223786066151,1349,881,2230,+
chr4,6643986,1.537162162162162,909,767,1676,+
chr4,6644174,1.4921827099938687,1179,931,2110,+
chr4,6644177,1.7307963354474982,1227,989,2216,+
chr4,6644323,1.4033334474143535,1205,957,2162,+
chr4,6695602,0.9458054195040692,4176,3521,7697,+
chr4,6695603,0.9608163625469207,5841,4874,10715,+
chr4,6695604,0.8656318037481848,11724,8536,20260,+
chr4,6695606,0.7172104483265368,9745,6621,16366,+
chr4,6695687,2.649462365591398,1567,1049,2616,+
chr4,6698642,2.134038800705467,769,566,1335,+
chr4,6698646,1.411527698027361,4395,3092,7487,+
chr4,6698739,1.4618260527351437,1563,923,2486,+
chr4,6698762,1.559792027729636,1619,1153,2772,+
chr4,17609210,1.892449807510762,627,426,1053,+
chr4,17835973,2.870987736640513,744,500,1244,+
chr4,25915926,4.3772749547966265,694,309,1003,+
chr4,25915942,2.069542037010847,1098,637,1735,+
chr4,25915943,2.9833333333333334,715,339,1054,+
chr4,25915960,1.109643453873739,2537,1707,4244,+
chr4,25915961,1.1181396916336674,1251,912,2163,+
chr4,25915974,2.177922077922078,859,615,1474,+
chr4,25915975,1.7477302204928662,879,513,1392,+
chr4,25915977,1.5734198732807914,978,718,1696,+
chr4,25915981,1.8256978334399434,2124,1519,3643,+
chr4,25915984,1.4774164465655104,3612,2732,6344,+
chr4,39699953,0.222447960432748,570,824,1394,+
chr4,39699954,0.25620273813609995,483,634,1117,+
chr4,39783262,1.8173908364083637,881,474,1355,+
chr4,39783284,2.486371404905514,967,609,1576,+
chr4,39783298,1.729776247848537,602,497,1099,+
chr4,41496607,1.7734736842105263,647,499,1146,+
chr4,41526438,2.19974272014969,626,502,1128,+
chr4,41600949,0.5865067466266867,977,666,1643,+
chr4,41615512,1.7656755009696183,606,475,1081,+
chr4,41621344,0.2665314401622718,656,492,1148,+
chr4,41621345,1.8613636363636363,545,494,1039,+
chr4,41646601,1.9181649182342662,566,486,1052,+
chr4,41648247,2.2365308804204997,850,760,1610,+
chr4,41648535,2.490804413881337,622,480,1102,+
chr4,41648536,2.143044619422572,638,380,1018,+
chr4,41652499,2.328412328412328,619,428,1047,+
chr4,41652532,2.48578370554177,814,623,1437,+
chr4,41668632,2.099706744868035,715,557,1272,+
chr4,41682100,0.4436180684676802,675,445,1120,+
chr4,41686466,2.2242335290280497,592,437,1029,+
chr4,41686510,2.625310559006212,956,643,1599,+
chr4,41686512,2.625310559006212,956,643,1599,+
chr4,41686513,1.4835346215780998,856,551,1407,+
chr4,41687728,5.570390868211692,731,412,1143,+
chr4,41687735,0.6413662965596455,2726,1944,4670,+
chr4,41687736,0.8422967967960087,3569,2429,5998,+
chr4,41687737,0.6413662965596455,2726,1944,4670,+
chr4,41687751,1.63699900619031,4757,3453,8210,+
chr4,41687764,1.3046914839367667,2665,2293,4958,+
chr4,41687769,1.7251415037533622,2864,2576,5440,+
chr4,41687819,1.5831417624521071,1032,724,1756,+
chr4,41691627,1.6155844155844157,932,629,1561,+
chr4,41694302,1.826086956521739,704,469,1173,+
chr4,41699398,3.20944783163291,829,539,1368,+
chr4,41699425,0.9701403813617449,1663,1150,2813,+
chr4,41699426,0.8807724454936995,2136,1449,3585,+
chr4,41699436,1.656090723751274,950,653,1603,+
chr4,41699673,2.350185873605948,653,537,1190,+
chr4,41699830,2.3881834672194877,575,453,1028,+
chr4,41700219,2.0917463277980612,1274,936,2210,+
chr4,41700233,1.0481974682299913,931,686,1617,+
chr4,41700390,1.9176731301939058,640,474,1114,+
chr4,41700642,2.1245811757538835,557,468,1025,+
chr4,41700734,1.6800107616267457,905,652,1557,+
chr4,48834654,3.0619550945012883,692,632,1324,+
chr4,48834691,2.40421687684445,954,744,1698,+
chr4,48835447,0.5591391711382577,652,460,1112,+
chr4,48853842,0.4410186256971483,761,441,1202,+
chr4,48859373,0.6292127435492365,868,632,1500,+
chr4,48862745,0.452815120457873,971,682,1653,+
chr4,48862804,1.6463762073518171,816,532,1348,+
chr4,48862827,2.002159191284719,599,442,1041,+
chr4,53579039,3.158056542232001,1480,1151,2631,+
chr4,53579041,2.4344176918087173,1451,1178,2629,+
chr4,53579043,1.1729505215041824,900,901,1801,+
chr4,53579045,0.9469925452191897,695,685,1380,+
chr4,53579692,2.0453933977695833,601,485,1086,+
chr4,53579773,3.9070197044334964,674,579,1253,+
chr4,56277781,1.0407030527289547,674,482,1156,+
chr4,56277783,1.0407030527289547,674,482,1156,+
chr4,56277784,1.0035773170424178,642,500,1142,+
chr4,56277816,0.4800745746912142,1029,612,1641,+
chr4,56277817,0.9062985936020705,1361,872,2233,+
chr4,56290756,2.5840391379253034,1525,1216,2741,+
chr4,56290757,2.032924160243601,871,677,1548,+
chr4,56292143,2.436192354036587,694,536,1230,+
chr4,56292145,2.2579828827479784,1196,866,2062,+
chr4,56292149,2.559852315400722,1048,722,1770,+
chr4,57302464,2.017975937721161,1613,941,2554,+
chr4,57302465,2.017975937721161,1613,941,2554,+
chr4,57302468,0.7169350665179351,1383,1045,2428,+
chr4,57307831,1.808192098607518,1243,838,2081,+
chr4,57314654,0.5763286452920664,3881,2860,6741,+
chr4,57314655,0.5763286452920664,3881,2860,6741,+
chr4,57314657,1.8124419684308266,1463,1076,2539,+
chr4,57318108,1.500685528098587,1738,1408,3146,+
chr4,57318109,1.6434295393222462,3724,2518,6242,+
chr4,57318110,1.7884788478847886,1986,1110,3096,+
chr4,57318113,0.6701394428667157,1076,846,1922,+
chr4,57319847,1.1265107821996831,1836,1188,3024,+
chr4,57319855,1.6079854809437386,885,721,1606,+
chr4,57319916,1.6616320415176284,2041,1581,3622,+
chr4,57325706,1.6432981204554808,1129,984,2113,+
chr4,57325839,1.9185468993898118,675,485,1160,+
chr4,57326151,3.5512485458439413,802,671,1473,+
chr4,57326152,3.5512485458439413,802,671,1473,+
chr4,57326193,1.6550366300366297,582,454,1036,+
chr4,57326194,1.756953642384106,757,754,1511,+
chr4,57326195,1.756953642384106,757,754,1511,+
chr4,57326249,1.7207606519874175,829,537,1366,+
chr4,57326557,0.5683269476372924,889,608,1497,+
chr4,57326613,3.8463647566433057,1136,967,2103,+
chr4,57326839,2.7930049964311205,601,466,1067,+
chr4,57327151,1.807602851211057,840,670,1510,+
chr4,57327160,1.798128342245989,806,560,1366,+
chr4,57333799,0.5719129635581865,1637,759,2396,+
chr4,57333825,12.890497336434963,4689,3160,7849,+
chr4,57333826,12.890497336434963,4689,3160,7849,+
chr4,57333851,1.2808109736640743,1717,1458,3175,+
chr4,57333868,1.6299258545245165,2134,1870,4004,+
chr4,57335878,1.671558704453442,733,493,1226,+
chr4,57340473,2.10880195599022,599,408,1007,+
chr4,57344603,1.977977977977978,607,443,1050,+
chr4,57356748,1.7490361803084225,760,561,1321,+
chr4,57366744,1.722972972972973,1172,850,2022,+
chr4,57366765,1.349949227792542,3309,2569,5878,+
chr4,57368277,1.8682692307692308,602,467,1069,+
chr4,57368755,2.5965405543035476,885,713,1598,+
chr4,57368756,2.2892863341678145,1439,1090,2529,+
chr4,57368762,0.4459459459459459,620,413,1033,+
chr4,57369124,0.4832059491840528,730,514,1244,+
chr4,57369155,0.6272504091653028,802,571,1373,+
chr4,57860833,2.3054072354128587,846,611,1457,+
chr4,57865853,1.3070840107529198,662,482,1144,+
chr4,57888340,1.8135867646409818,624,455,1079,+
chr4,57889507,2.098724884080371,764,646,1410,+
chr4,57889556,1.7005400098183603,865,872,1737,+
chr4,57889560,1.2522582935584394,961,1003,1964,+
chr4,57889565,1.7901127493495228,1031,1152,2183,+
chr4,57889567,2.0493754807516207,1491,1186,2677,+
chr4,57889568,2.08136559111416,1126,1306,2432,+
chr4,57889571,1.9447848884957992,1183,1438,2621,+
chr4,57889574,1.8354338693321743,1266,1637,2903,+
chr4,57889668,3.925786311697491,876,652,1528,+
chr4,57889670,3.925786311697491,876,652,1528,+
chr4,57889738,2.1911069063386943,578,452,1030,+
chr4,57889859,0.302312925170068,605,629,1234,+
chr4,57889860,0.302312925170068,605,629,1234,+
chr4,57891586,7.535927229601984,655,468,1123,+
chr4,57896390,1.391609162525335,1112,885,1997,+
chr4,57896391,1.5776866283839213,600,529,1129,+
chr4,57896392,1.391609162525335,1112,885,1997,+
chr4,66439564,0.8752119866513459,590,602,1192,+
chr4,69242319,0.6532906852767276,673,542,1215,+
chr4,69242328,1.7586825083378956,1622,1382,3004,+
chr4,69242329,3.0159930701192565,702,752,1454,+
chr4,71555620,0.3662020451884595,2978,1483,4461,+
chr4,71555622,0.3456528553978532,2283,1170,3453,+
chr4,71555652,0.6026469950097635,867,418,1285,+
chr4,71555656,3.542434924078092,900,460,1360,+
chr4,71555666,2.504369538077403,1002,533,1535,+
chr4,71555709,2.1653768988248783,1510,1162,2672,+
chr4,71891562,3.2436959204874447,748,590,1338,+
chr4,75180348,1.7224048287814495,738,576,1314,+
chr4,75180349,1.6595496894409938,683,367,1050,+
chr4,76695920,0.9762806132768401,1100,654,1754,+
chr4,76695921,1.2063492063492065,835,440,1275,+
chr4,76725294,1.7619834710743802,655,483,1138,+
chr4,76725299,3.177179962894248,684,538,1222,+
chr4,76725326,1.5392997014230871,2246,2090,4336,+
chr4,76725327,1.5392997014230871,2246,2090,4336,+
chr4,76733455,2.9621380846325165,664,448,1112,+
chr4,76734984,1.9336604082280229,898,622,1520,+
chr4,79512704,0.9615709459459458,791,591,1382,+
chr4,79512705,0.9615709459459458,791,591,1382,+
chr4,79525550,2.9746355088399277,672,449,1121,+
chr4,83381855,4.64370236505068,664,493,1157,+
chr4,83970452,1.8344632347463308,683,432,1115,+
chr4,83971036,2.2760299625468163,720,622,1342,+
chr4,83984378,0.9702988012166756,637,413,1050,+
chr4,83984379,0.9702988012166756,637,413,1050,+
chr4,88059985,1.214100383743241,639,537,1176,+
chr4,95587001,7.53069722739716,612,579,1191,+
chr4,106890766,1.7646485397664329,612,425,1037,+
chr4,106890896,1.654805627164319,733,529,1262,+
chr4,107238150,2.386764999706176,732,568,1300,+
chr4,107238153,2.03499046756455,1233,1029,2262,+
chr4,107238154,1.6020166073546855,656,561,1217,+
chr4,107249255,1.634851485148515,644,504,1148,+
chr4,107252907,2.769777265745008,576,433,1009,+
chr4,107252982,0.6045699777848302,634,410,1044,+
chr4,107253033,4.648781800566939,1097,701,1798,+
chr4,107258047,3.6784313725490194,602,458,1060,+
chr4,107258048,3.6784313725490194,602,458,1060,+
chr4,107258130,2.00269566833984,694,488,1182,+
chr4,107258147,1.7169642857142855,640,419,1059,+
chr4,107258170,0.5058035714285715,617,419,1036,+
chr4,108940761,2.7656440566657285,718,560,1278,+
chr4,108948855,6.956086762033656,664,428,1092,+
chr4,109541726,1.1454727113775445,1894,1274,3168,+
chr4,109541727,1.1454727113775445,1894,1274,3168,+
chr4,109541730,1.725902768188764,4096,3370,7466,+
chr4,109541731,0.784810650765058,1235,946,2181,+
chr4,109541732,1.3244550182761123,4725,3930,8655,+
chr4,109541736,1.5114311102253002,1716,1352,3068,+
chr4,109541746,0.7819431368346225,3274,2206,5480,+
chr4,109541750,0.9512125262554898,7748,5236,12984,+
chr4,109541752,1.0441517122979787,11177,8340,19517,+
chr4,109543107,1.3593614475432,10295,8159,18454,+
chr4,109543108,1.3054993771822376,11011,9303,20314,+
chr4,109543113,0.7283067271943802,6606,4494,11100,+
chr4,109543327,1.2533812680475784,28052,19703,47755,+
chr4,109576729,4.243990384615385,641,415,1056,+
chr4,109576736,1.5585005679666797,1028,555,1583,+
chr4,109578676,1.7316787904721154,1083,854,1937,+
chr4,109588411,1.7698722113926793,1107,971,2078,+
chr4,109588514,1.750930356193514,940,692,1632,+
chr4,109588742,1.919534317384093,1946,1547,3493,+
chr4,110451591,4.92603550295858,665,337,1002,+
chr4,110451593,4.28750700280112,1006,524,1530,+
chr4,110451594,5.194904849600983,676,361,1037,+
chr4,110745178,5.758848388386049,714,793,1507,+
chr4,110745580,6.641418711691791,813,995,1808,+
chr4,113571649,2.0790272138390127,764,546,1310,+
chr4,119199971,0.3883586819224895,752,663,1415,+
chr4,119200237,2.020220588235294,627,383,1010,+
chr4,119200268,1.574414989363443,894,678,1572,+
chr4,119200553,1.5625463557589685,1463,1042,2505,+
chr4,120214963,3.663685804507111,668,363,1031,+
chr4,120215004,1.8490838681157635,852,607,1459,+
chr4,120215018,0.46011782951166963,1319,830,2149,+
chr4,120215021,2.1780368657466345,1639,1159,2798,+
chr4,122734489,1.2093787714709736,676,481,1157,+
chr4,128743944,1.5723163203268702,720,418,1138,+
chr4,128743962,2.413895486935867,812,420,1232,+
chr4,128743971,2.498091825681193,1805,1090,2895,+
chr4,128743972,2.498091825681193,1805,1090,2895,+
chr4,128744027,1.8073796122576609,1155,701,1856,+
chr4,128744033,2.423974394273128,1380,907,2287,+
chr4,128905537,2.9165424739195234,926,548,1474,+
chr4,128905538,2.591018319977424,835,587,1422,+
chr4,128999110,2.4431434538200194,810,514,1324,+
chr4,129003321,2.4302846845793566,1514,1107,2621,+
chr4,129003323,2.769468143038664,1044,786,1830,+
chr4,141294838,0.8853746256743016,725,503,1228,+
chr4,141300329,0.4748427672955975,603,423,1026,+
chr4,141302336,2.1897610030037877,728,402,1130,+
chr4,141302441,2.136708296164139,736,471,1207,+
chr4,141302573,2.1821566875186176,636,372,1008,+
chr4,141302653,1.7845740515214632,1238,758,1996,+
chr4,141302707,2.029691242922474,1107,653,1760,+
chr4,141302790,1.68201642594166,1023,534,1557,+
chr4,141302795,1.6905345601579167,3437,1922,5359,+
chr4,141302796,1.6905345601579167,3437,1922,5359,+
chr4,141302797,1.2973811513424367,5263,2761,8024,+
chr4,141302903,1.959393063583815,1042,691,1733,+
chr4,141302942,2.8064747342014096,1145,760,1905,+
chr4,144446628,2.1483845970224698,649,453,1102,+
chr4,144460017,2.771573604060914,740,393,1133,+
chr4,144460018,3.032799656368945,1005,564,1569,+
chr4,144460024,2.543218429990341,781,429,1210,+
chr4,144467120,5.032165911326502,717,474,1191,+
chr4,144468591,1.9014716439339556,814,795,1609,+
chr4,144468610,2.597946287519747,597,632,1229,+
chr4,146019465,0.5279526384246942,1479,1090,2569,+
chr4,146019467,0.2917499286326006,729,564,1293,+
chr4,146025573,1.6957632531403022,589,426,1015,+
chr4,146026789,1.9386123470522807,714,463,1177,+
chr4,146031339,4.0821342925659465,618,416,1034,+
chr4,146031541,1.9444658086013944,1088,749,1837,+
chr4,146038505,1.185168927906358,747,506,1253,+
chr4,146041227,1.719651605879151,728,500,1228,+
chr4,146042348,2.178424204013267,1004,704,1708,+
chr4,146042500,1.0566274192406278,1636,1215,2851,+
chr4,146044374,2.3093867334167717,658,469,1127,+
chr4,146046214,1.875,737,327,1064,+
chr4,146048859,2.028449502133713,712,443,1155,+
chr4,146048879,1.834213197969543,622,393,1015,+
chr4,146049371,1.0743203566994515,978,724,1702,+
chr4,146049551,1.8762335526315788,675,511,1186,+
chr4,146049784,2.1457435344827585,589,463,1052,+
chr4,146049789,1.728270087875999,1348,1130,2478,+
chr4,146049791,1.728270087875999,1348,1130,2478,+
chr4,146049796,2.122893165228932,743,684,1427,+
chr4,147108505,1.029765692805989,720,407,1127,+
chr4,152020754,0.7137624197205825,1141,520,1661,+
chr4,152020756,0.8095063766011249,742,366,1108,+
chr4,152020772,1.5833796382658747,1648,914,2562,+
chr4,152020777,1.0397877815365182,20744,15996,36740,+
chr4,152020778,0.9949654172073856,46421,35306,81727,+
chr4,152020779,0.9808750913485235,25979,18959,44938,+
chr4,152020780,0.9788308244004558,40922,31821,72743,+
chr4,152020782,0.48624441972375754,10011,8550,18561,+
chr4,152020786,0.47431732531203535,5812,4664,10476,+
chr4,152020798,0.993332110979581,16437,11702,28139,+
chr4,152020809,0.6770854700887229,11331,7528,18859,+
chr4,152020813,0.7976586404836329,13076,8361,21437,+
chr4,152020816,1.0265295889964616,49798,33205,83003,+
chr4,152020817,0.8644074634682314,40832,26193,67025,+
chr4,152020819,0.8156767554060734,46277,28917,75194,+
chr4,152020843,1.420969344474105,75289,49291,124580,+
chr4,152020844,0.9934498708972428,24306,18400,42706,+
chr4,152024027,0.45310479771923806,1246,670,1916,+
chr4,152024031,0.46078377951468036,2706,1395,4101,+
chr4,152024032,0.4957590631887157,3275,1755,5030,+
chr4,152024035,1.1303547404942291,1227,486,1713,+
chr4,152024037,1.1303547404942291,1227,486,1713,+
chr4,152024038,2.5123389386328894,718,481,1199,+
chr4,152024041,1.4888897160084862,1355,801,2156,+
chr4,152024044,1.428144027564077,1794,1277,3071,+
chr4,152024046,1.428144027564077,1794,1277,3071,+
chr4,152024047,1.458078079750501,1774,1071,2845,+
chr4,152024049,1.462311249523785,3580,1827,5407,+
chr4,152024051,1.400055141990626,2538,1052,3590,+
chr4,152024060,1.4107440694442075,5137,3069,8206,+
chr4,152024061,1.4146842489303115,6845,4130,10975,+
chr4,152024064,1.3218590694423131,1890,1196,3086,+
chr4,152024076,1.455818965517241,2701,1217,3918,+
chr4,152024094,1.3606655256139792,4272,2848,7120,+
chr4,152024098,0.7679447211258853,7798,4621,12419,+
chr4,152024099,1.093746596505172,12927,8299,21226,+
chr4,152024106,1.2086381051898292,5898,4300,10198,+
chr4,152024107,1.343698048377721,12096,5709,17805,+
chr4,152024109,1.3508974945569332,17389,8870,26259,+
chr4,152024113,1.2368932855750459,13573,8505,22078,+
chr4,152024121,1.4300381301285583,8166,4182,12348,+
chr4,152024143,1.1578234467454498,23022,13571,36593,+
chr4,152025374,1.3188274145771646,22566,15221,37787,+
chr4,152025376,1.666686059485479,12337,6603,18940,+
chr4,165864970,0.49970521350964364,697,382,1079,+
chr4,166254657,2.407612556882471,723,464,1187,+
chr4,166261393,6.539033459646028,681,502,1183,+
chr4,166263007,2.1894490644490645,673,480,1153,+
chr4,166263776,0.6528540721280153,780,476,1256,+
chr4,166263777,0.6714090930711623,1120,717,1837,+
chr4,166263805,0.834367756723742,4669,3063,7732,+
chr4,166263806,0.6982960284186239,3958,2499,6457,+
chr4,166263807,0.7481448328147299,6257,4123,10380,+
chr4,166263908,0.5058491327148044,1139,739,1878,+
chr4,166263989,1.4303405572755417,1385,1036,2421,+
chr4,166419103,3.9016144907282446,740,462,1202,+
chr4,166924623,1.5903313319804204,1345,852,2197,+
chr4,166924625,1.5903313319804204,1345,852,2197,+
chr4,166924628,2.1067338862789584,1059,760,1819,+
chr4,166924629,1.6557159858577988,1183,846,2029,+
chr4,169819834,2.2377864245568526,646,513,1159,+
chr4,169842772,4.582919181741463,614,415,1029,+
chr4,169846181,3.324133244062984,694,498,1192,+
chr4,169847517,1.2875457875457876,835,530,1365,+
chr4,169847973,1.8512396694214879,735,483,1218,+
chr4,169848368,2.2750190097462366,954,676,1630,+
chr4,169848665,0.8549160671462829,712,555,1267,+
chr4,169848667,1.4731992843455122,1249,859,2108,+
chr4,169848778,2.8859570661896248,716,515,1231,+
chr4,169849322,0.588095238095238,740,629,1369,+
chr4,177245335,0.5190677966101696,699,471,1170,+
chr4,177252342,0.2728194864392945,609,586,1195,+
chr4,177252343,0.29813736247415623,1091,977,2068,+
chr4,177252346,0.15339491796736518,836,657,1493,+
chr4,178262764,0.9421331656033785,698,358,1056,+
chr4,178262765,0.9421331656033785,698,358,1056,+
chr4,178272548,2.4791666666666665,832,503,1335,+
chr4,178272556,1.3890005365456233,2696,1912,4608,+
chr4,178272557,1.7229694092827004,1431,947,2378,+
chr4,178272561,1.9455220104570756,768,538,1306,+
chr4,178272573,1.7394973535521818,2421,1674,4095,+
chr4,184175076,0.7900151796255692,1170,846,2016,+
chr4,184175077,1.1268576458734045,1734,1183,2917,+
chr4,184175099,1.921994680851064,1416,939,2355,+
chr4,184175100,1.503919440420742,3179,2171,5350,+
chr4,184175101,1.1030181893328188,2492,1768,4260,+
chr4,184175103,1.3171704330324663,1673,1092,2765,+
chr4,184175105,2.083350785340314,828,572,1400,+
chr4,184237838,5.46342192015736,659,544,1203,+
chr4,184237839,5.46342192015736,659,544,1203,+
chr4,184238003,5.215368315340921,599,478,1077,+
chr4,184369013,1.591738844928916,654,491,1145,+
chr4,184589190,3.059863957567148,609,418,1027,+
chr4,184589204,2.665640093672245,745,491,1236,+
chr4,184595868,2.085012652227627,1054,709,1763,+
chr4,190862150,3.1601827481017617,719,503,1222,+
chr4,190883040,3.0175438949244904,644,423,1067,+
chr5,218436,1.2028253586721354,1723,1271,2994,+
chr5,218437,1.1350361262517428,592,489,1081,+
chr5,218438,1.36293301387641,644,370,1014,+
chr5,223603,2.1228030130107283,929,673,1602,+
chr5,223604,2.023277739356175,2034,1316,3350,+
chr5,223606,1.932065217391304,1105,643,1748,+
chr5,223609,2.220105299838517,1542,1183,2725,+
chr5,223611,2.436923076923077,1022,805,1827,+
chr5,223612,1.0363098020882031,1329,827,2156,+
chr5,223613,1.0363098020882031,1329,827,2156,+
chr5,223616,1.8380829015544042,1418,964,2382,+
chr5,223617,1.8380829015544042,1418,964,2382,+
chr5,224502,0.5666734527687296,878,613,1491,+
chr5,224554,0.6410730804810361,1385,1034,2419,+
chr5,224612,1.6272437093230527,1032,730,1762,+
chr5,225557,1.9012594458438288,1257,793,2050,+
chr5,225567,1.7192546583850932,1037,689,1726,+
chr5,225572,1.5879940954567822,1441,870,2311,+
chr5,225591,1.8303714859437752,1804,1199,3003,+
chr5,225624,1.857346366266328,2172,1341,3513,+
chr5,225627,1.8170242214532875,1640,849,2489,+
chr5,225636,1.4696812495989908,4407,2607,7014,+
chr5,225639,1.3610701742229931,12993,8312,21305,+
chr5,225641,1.6190207341179335,13002,8196,21198,+
chr5,225642,1.7560591206139098,8877,6240,15117,+
chr5,225644,1.838841775092937,6029,4303,10332,+
chr5,226039,0.6735628162669692,1586,1117,2703,+
chr5,226040,0.7629487962176397,1654,1046,2700,+
chr5,226041,2.1170437405731524,637,509,1146,+
chr5,226042,0.6250000000000001,624,499,1123,+
chr5,226067,2.326834447828995,1514,1144,2658,+
chr5,226075,1.5984157590286105,851,618,1469,+
chr5,226119,1.7692880000329994,2474,1857,4331,+
chr5,226154,0.4548659003831417,741,724,1465,+
chr5,231055,2.1586021505376345,656,371,1027,+
chr5,233650,2.3183268344558665,653,402,1055,+
chr5,233670,0.2990271377368151,875,650,1525,+
chr5,233671,1.5516258741079685,2170,1541,3711,+
chr5,233744,1.6843339587242028,1196,727,1923,+
chr5,235306,2.149548532731377,585,442,1027,+
chr5,235362,0.6255956432947583,918,564,1482,+
chr5,235395,1.3602554470323065,638,483,1121,+
chr5,235413,0.6043250715907968,719,493,1212,+
chr5,235415,1.7352490421455935,646,521,1167,+
chr5,235416,1.6581818181818182,911,549,1460,+
chr5,235445,1.875892857142857,763,639,1402,+
chr5,236644,1.7062780269058295,760,445,1205,+
chr5,236663,2.5105670642393805,856,530,1386,+
chr5,240491,2.821865921745439,1109,785,1894,+
chr5,240508,1.7316869565217394,802,574,1376,+
chr5,240521,2.095238095238096,695,608,1303,+
chr5,240531,1.5338345864661658,883,545,1428,+
chr5,251165,0.5662538699690403,943,759,1702,+
chr5,251501,2.410571127404359,924,510,1434,+
chr5,254583,1.1802011951147402,1419,928,2347,+
chr5,256480,1.5741506869998487,1085,894,1979,+
chr5,271774,1.1789428836550635,604,424,1028,+
chr5,271888,0.4538956906710748,635,553,1188,+
chr5,271910,2.7490514905149053,633,368,1001,+
chr5,271923,1.1589487203677853,1603,1484,3087,+
chr5,271925,0.922854387656702,1130,1104,2234,+
chr5,271926,2.157860962566845,775,560,1335,+
chr5,304298,1.8651460349472717,1800,1371,3171,+
chr5,304299,1.7548418972332016,1203,1011,2214,+
chr5,304305,0.6215796949679453,1436,1182,2618,+
chr5,304307,2.503399175632996,697,478,1175,+
chr5,304332,2.417081905948302,886,675,1561,+
chr5,306758,1.7429292929292928,713,539,1252,+
chr5,306775,2.318178936021812,913,750,1663,+
chr5,306779,1.5949623624782858,786,627,1413,+
chr5,306838,0.5387577219260388,748,605,1353,+
chr5,311425,1.576399642024072,1982,1622,3604,+
chr5,311449,1.6356783919597988,1053,795,1848,+
chr5,311491,1.7351154313487245,1231,822,2053,+
chr5,314618,1.3692854670735928,1359,858,2217,+
chr5,314626,2.186612576064909,1407,927,2334,+
chr5,446276,0.904015054266542,643,531,1174,+
chr5,453959,0.7708243305075252,655,443,1098,+
chr5,454062,2.0590415671877684,1153,747,1900,+
chr5,454068,1.8306122448979596,623,391,1014,+
chr5,480843,3.3631578947368426,638,509,1147,+
chr5,480844,3.3631578947368426,638,509,1147,+
chr5,480845,3.3631578947368426,638,509,1147,+
chr5,894907,0.8951661999269451,918,763,1681,+
chr5,894908,0.8951661999269451,918,763,1681,+
chr5,894915,0.5411003236245955,626,514,1140,+
chr5,894921,1.7203389830508473,695,589,1284,+
chr5,896832,2.7159717964439,610,465,1075,+
chr5,896850,2.104952830188679,594,476,1070,+
chr5,896883,2.124264705882353,641,509,1150,+
chr5,904278,2.1208377624508175,1675,1269,2944,+
chr5,904291,2.150175644028103,564,487,1051,+
chr5,908522,1.697959183673469,647,440,1087,+
chr5,908569,0.5600463149968733,1945,1338,3283,+
chr5,908570,1.6491440377804014,946,769,1715,+
chr5,912001,1.7229390681003585,873,719,1592,+
chr5,912043,1.6891025641025639,774,599,1373,+
chr5,912073,1.6002854504239779,777,553,1330,+
chr5,914588,2.305950799974704,847,752,1599,+
chr5,917180,1.630188679245283,647,476,1123,+
chr5,917236,1.663053548267556,618,513,1131,+
chr5,917326,0.48311734109142196,684,596,1280,+
chr5,917341,2.2214396628216506,976,783,1759,+
chr5,917478,2.093712255772646,892,562,1454,+
chr5,917917,4.2073379605058,1158,896,2054,+
chr5,917995,1.0820136940849998,943,770,1713,+
chr5,917996,1.0820136940849998,943,770,1713,+
chr5,1801527,0.8013555787278415,741,587,1328,+
chr5,1801528,0.8438718897773043,1746,1091,2837,+
chr5,1801529,1.1073051669845897,1907,1008,2915,+
chr5,1801531,1.5592529711375214,1119,588,1707,+
chr5,1801543,2.499062153217199,1535,1057,2592,+
chr5,1801546,3.4333333333333336,617,485,1102,+
chr5,1801562,1.705349794238683,559,485,1044,+
chr5,1801610,1.702972493345164,852,643,1495,+
chr5,1801624,0.5402745402745402,744,494,1238,+
chr5,1801640,1.655979540167154,1737,1305,3042,+
chr5,1801643,1.6243461721350452,853,700,1553,+
chr5,1802438,0.5498683665898879,3123,2451,5574,+
chr5,1802441,0.696798125732136,1742,1181,2923,+
chr5,1802443,1.3117606123869172,2174,1436,3610,+
chr5,1802480,1.3533682336055075,2469,1730,4199,+
chr5,1815967,0.7703418003432488,5073,3470,8543,+
chr5,1815968,0.9116898759848086,3903,2477,6380,+
chr5,1816082,1.6468642555599076,1375,850,2225,+
chr5,5461531,2.021635883905013,1276,757,2033,+
chr5,5461533,2.021635883905013,1276,757,2033,+
chr5,5461545,1.8664373746059044,1627,1162,2789,+
chr5,5461546,1.8664373746059044,1627,1162,2789,+
chr5,5461643,4.000211327134404,822,727,1549,+
chr5,5461644,2.3775458676990406,564,456,1020,+
chr5,5461645,4.000211327134404,822,727,1549,+
chr5,5461650,0.6754065611636545,697,542,1239,+
chr5,5463980,1.9992820623384773,703,526,1229,+
chr5,5464177,3.1875924205084574,649,484,1133,+
chr5,5465233,1.7050051277282336,740,545,1285,+
chr5,5490154,0.6880563602049248,749,566,1315,+
chr5,6746420,2.16701860231272,936,764,1700,+
chr5,6746421,2.426082644628099,1438,1209,2647,+
chr5,6746423,2.494842037395229,980,845,1825,+
chr5,6749727,0.39024798349081,1040,663,1703,+
chr5,6749742,2.0813779939716843,2232,1439,3671,+
chr5,6756938,0.4230557087699944,707,517,1224,+
chr5,6756940,0.4230557087699944,707,517,1224,+
chr5,7875420,1.183953033268102,659,583,1242,+
chr5,7875422,1.183953033268102,659,583,1242,+
chr5,7878200,1.4550705172641447,640,494,1134,+
chr5,7883334,0.4846278317152103,598,411,1009,+
chr5,7883355,1.7602880658436215,766,485,1251,+
chr5,7885862,2.3066347947761194,4244,3199,7443,+
chr5,7885863,2.3066347947761194,4244,3199,7443,+
chr5,7885864,2.3066347947761194,4244,3199,7443,+
chr5,7885867,3.565039866255144,1518,1295,2813,+
chr5,7897028,2.056998455706865,665,418,1083,+
chr5,7900104,1.7456953642384103,658,452,1110,+
chr5,7900869,1.754054054054054,648,443,1091,+
chr5,7901028,1.710509754562618,603,453,1056,+
chr5,7901033,2.5679598838743734,694,420,1114,+
chr5,7901162,1.6475706399956278,1815,1709,3524,+
chr5,7901163,1.6516196243904382,3385,2671,6056,+
chr5,7901164,1.7248328432219753,4078,3393,7471,+
chr5,7901166,1.54745406824147,2875,3047,5922,+
chr5,7901167,1.5033025380640759,4520,3962,8482,+
chr5,7901168,1.5724297498491044,2232,2417,4649,+
chr5,8460270,8.38060465412203,1097,826,1923,+
chr5,10250318,0.6820138556012192,1339,750,2089,+
chr5,10250320,0.9948755780839739,1501,782,2283,+
chr5,10250321,1.1264579251773938,2578,1333,3911,+
chr5,10250322,1.1701331510863364,2383,1209,3592,+
chr5,10250323,1.1725293132328307,1399,749,2148,+
chr5,10250327,0.9800332778702165,836,600,1436,+
chr5,10250329,0.9800332778702165,836,600,1436,+
chr5,10250380,2.7577236777063767,782,475,1257,+
chr5,10250386,1.5991523753203236,824,533,1357,+
chr5,10250387,0.4535856573705179,758,501,1259,+
chr5,10250391,0.6308829926054806,1035,626,1661,+
chr5,10250392,1.5443330078991744,869,592,1461,+
chr5,10250399,1.9057777777777773,1071,774,1845,+
chr5,10250410,2.2358647179453794,1295,990,2285,+
chr5,10250428,1.2671992065761652,7257,4754,12011,+
chr5,10250429,1.0183833325589884,18604,12729,31333,+
chr5,10250430,0.840147952824288,7877,5873,13750,+
chr5,10250431,0.8546170657821015,20453,14176,34629,+
chr5,10250433,0.6858342650905701,9031,6462,15493,+
chr5,10250434,0.848952438430737,3649,2670,6319,+
chr5,10250482,1.162901813056907,5270,3831,9101,+
chr5,10254261,1.1184231730006886,18615,12634,31249,+
chr5,10254262,1.2598078156475374,18383,11933,30316,+
chr5,10254285,1.2408265932760378,13106,9000,22106,+
chr5,10254875,1.1595303739041545,7963,5096,13059,+
chr5,10254920,1.183183146315712,5999,4687,10686,+
chr5,10256085,1.2498806821488857,5675,4481,10156,+
chr5,10256088,1.4786467738081714,6039,4816,10855,+
chr5,10258242,1.430921589125628,8318,6285,14603,+
chr5,10258251,1.3084150725369237,37919,27095,65014,+
chr5,10261717,1.255487016972274,12096,8261,20357,+
chr5,10261729,1.2767753992524635,5391,4359,9750,+
chr5,10261738,2.6586639370139,5741,4794,10535,+
chr5,10261786,1.5370942089999065,6199,4071,10270,+
chr5,10261806,1.564375063308165,4686,3480,8166,+
chr5,10261809,1.3335322468232755,17315,12580,29895,+
chr5,10261810,1.414406434889749,9973,7622,17595,+
chr5,10262708,1.3385362262611793,6146,3722,9868,+
chr5,10263256,1.3077234652185674,12119,8471,20590,+
chr5,10263381,1.4365770069787425,15167,11386,26553,+
chr5,10263421,0.8583958902447031,9749,7078,16827,+
chr5,10354003,1.3580388464976374,747,485,1232,+
chr5,10377945,0.7780637904656311,1316,896,2212,+
chr5,10377946,1.44007932395541,1446,974,2420,+
chr5,10390606,0.608976456556958,609,532,1141,+
chr5,10391792,12.019836363524497,903,824,1727,+
chr5,10391826,0.4693200131424842,597,551,1148,+
chr5,10402240,1.8122298850574712,757,434,1191,+
chr5,10402528,1.7517614710431348,702,505,1207,+
chr5,10402665,2.172116421128279,805,483,1288,+
chr5,10402673,1.665724514791784,883,548,1431,+
chr5,10426509,0.5629963721933523,637,433,1070,+
chr5,10430028,1.9591463414634145,713,491,1204,+
chr5,10433945,1.1793916821849784,911,536,1447,+
chr5,10433947,1.1793916821849784,911,536,1447,+
chr5,10434013,1.9978352049790287,641,388,1029,+
chr5,14696508,1.7278144071422725,737,728,1465,+
chr5,14696509,1.9492943773585814,603,430,1033,+
chr5,17217736,0.8433871674068075,1084,797,1881,+
chr5,17217738,1.0871365906717172,1360,1164,2524,+
chr5,17217739,1.6753626326044595,692,595,1287,+
chr5,17217746,0.3467896802204224,922,811,1733,+
chr5,17217748,0.3467896802204224,922,811,1733,+
chr5,17217755,1.8309283309283308,661,377,1038,+
chr5,17217769,1.525935631257139,856,725,1581,+
chr5,17217788,1.7731980332670785,1129,868,1997,+
chr5,17217815,1.3041158536585369,3218,2623,5841,+
chr5,17217817,1.3610407640503797,4381,3745,8126,+
chr5,17217860,0.9159219724422144,3642,2102,5744,+
chr5,17217861,1.0651560303389118,5350,3419,8769,+
chr5,17217884,1.3204418052451914,6232,4253,10485,+
chr5,17217888,1.276846679081316,2991,1789,4780,+
chr5,17217893,1.5165342281237295,4424,3390,7814,+
chr5,17217899,1.5482250006014122,14656,12011,26667,+
chr5,17217900,1.6178902002539204,19400,15609,35009,+
chr5,17217902,1.7782531119274059,15662,13306,28968,+
chr5,17217908,1.807381193124368,4419,2923,7342,+
chr5,17217912,1.4486524480439775,4808,3352,8160,+
chr5,17275462,1.363130943672275,1814,1366,3180,+
chr5,17275490,1.735192723371357,4270,3425,7695,+
chr5,17275491,1.7834570189566563,5991,4796,10787,+
chr5,17275538,1.6212719930243042,5334,4567,9901,+
chr5,17275539,1.6212719930243042,5334,4567,9901,+
chr5,17275545,2.0500995355009954,2811,2602,5413,+
chr5,17275683,1.735693090292497,861,673,1534,+
chr5,17275686,2.685548617305977,668,353,1021,+
chr5,17275740,2.1222222222222222,763,647,1410,+
chr5,17275755,1.4129774704197955,1281,1114,2395,+
chr5,17275756,0.9825632366788972,2039,1793,3832,+
chr5,17275758,0.9825632366788972,2039,1793,3832,+
chr5,17275762,1.4485201966644172,1112,1011,2123,+
chr5,17275763,0.580064715499926,4647,3474,8121,+
chr5,17275765,0.9918630189875032,2544,2268,4812,+
chr5,17275767,0.8786052429085798,4323,3639,7962,+
chr5,17275813,1.5686642599277978,2294,1384,3678,+
chr5,17275903,1.4878413565411133,4264,2458,6722,+
chr5,17275904,1.5034142186535386,8387,5727,14114,+
chr5,17275942,1.4740951107571252,8593,7010,15603,+
chr5,17275944,1.3973787381205809,10028,7852,17880,+
chr5,17275945,1.163619615204992,13452,9847,23299,+
chr5,17275972,1.4581589849549896,3532,2811,6343,+
chr5,17275986,1.1257060325384212,7640,5283,12923,+
chr5,17276083,1.3047251598905358,4577,3645,8222,+
chr5,17276218,9.372654074714664,12865,1211,14076,+
chr5,17276221,7.702029902459234,10623,1001,11624,+
chr5,17276222,6.954013586428129,26516,2516,29032,+
chr5,17276224,8.238746140348471,79529,6898,86427,+
chr5,17276225,26.788646850261554,92530,13853,106383,+
chr5,17276226,33.741910070798184,116893,66974,183867,+
chr5,17276227,31.146875731320645,93909,65024,158933,+
chr5,17276228,27.096564108461518,70971,63095,134066,+
chr5,17276262,0.342674714989352,33178,68103,101281,+
chr5,17276376,0.650520716935592,14409,8604,23013,+
chr5,17276377,1.1912996950077586,14135,8494,22629,+
chr5,17276381,0.9995327676101952,68433,40208,108641,+
chr5,17276382,0.9995327676101952,68433,40208,108641,+
chr5,17276406,1.2592808200505,39715,24422,64137,+
chr5,17276464,0.7745736232261424,10594,7680,18274,+
chr5,17276590,0.8984801007416552,17098,13512,30610,+
chr5,17276748,1.0572072354008886,3555,2457,6012,+
chr5,17276749,1.0572072354008886,3555,2457,6012,+
chr5,17276752,1.1096220326142419,2212,1292,3504,+
chr5,17276753,1.6301099644308694,3688,2350,6038,+
chr5,17276755,1.6692259311757907,7160,4942,12102,+
chr5,17276756,1.153458784599125,6086,4221,10307,+
chr5,17276758,1.0286132753215211,11577,7727,19304,+
chr5,17276759,0.99457006924769,12388,8378,20766,+
chr5,17276760,0.7935667503213565,5417,3161,8578,+
chr5,17276765,1.6558381775420639,4190,3136,7326,+
chr5,17276769,1.5064993182117141,6714,5143,11857,+
chr5,17276771,1.3894864832002594,3203,2242,5445,+
chr5,17276856,1.390734949179046,1422,1278,2700,+
chr5,17276866,1.0350492076274969,3531,3007,6538,+
chr5,31535879,0.9221628045157456,581,458,1039,+
chr5,31535880,0.9221628045157456,581,458,1039,+
chr5,31535883,1.4788010560646063,1034,684,1718,+
chr5,31535885,1.4788010560646063,1034,684,1718,+
chr5,31535890,0.5824869860072054,1369,887,2256,+
chr5,31535894,2.8127483255761154,934,765,1699,+
chr5,31535896,2.308647178269032,1451,1213,2664,+
chr5,31535898,2.024108615657912,996,851,1847,+
chr5,31535902,1.901497842091901,855,605,1460,+
chr5,32585662,0.9175323614345293,779,432,1211,+
chr5,32585672,2.0406287926536115,1291,757,2048,+
chr5,32585674,1.937957497048406,1058,604,1662,+
chr5,32585676,1.9530797841564465,1451,918,2369,+
chr5,32585679,1.2863170949208946,1299,879,2178,+
chr5,32585690,1.5773290802065176,904,646,1550,+
chr5,32585691,1.5055312976973287,1668,1026,2694,+
chr5,32585698,1.7681159420289854,1481,896,2377,+
chr5,32585704,1.8360194838377082,2035,1466,3501,+
chr5,32585716,1.6195970695970696,1911,1247,3158,+
chr5,32588623,0.620200944839976,2150,1595,3745,+
chr5,32591676,1.1916768956602637,10038,7570,17608,+
chr5,32591695,1.5012969189789,5452,3846,9298,+
chr5,32591749,1.9983660130718954,9783,8295,18078,+
chr5,32601126,1.682106289614822,2474,1757,4231,+
chr5,33441097,0.9527252974826433,1329,1075,2404,+
chr5,33441098,0.9527252974826433,1329,1075,2404,+
chr5,33441241,1.712242617717478,1165,894,2059,+
chr5,33445472,0.7243859762815112,1700,1186,2886,+
chr5,33453468,1.6525943396226417,1143,847,1990,+
chr5,33455052,1.9051191871824933,1107,852,1959,+
chr5,33455806,1.772707705553164,1561,1110,2671,+
chr5,33456118,1.4314342567634315,1609,1200,2809,+
chr5,33457390,1.5111677205113043,2264,1690,3954,+
chr5,33457440,1.6728300733496333,1967,1635,3602,+
chr5,33459848,1.463725796920082,2131,1337,3468,+
chr5,33461010,1.6101338432122372,1202,1045,2247,+
chr5,33461057,1.8557804047285116,1076,804,1880,+
chr5,33461071,0.7881311052797272,5870,4205,10075,+
chr5,33461072,1.0387680055260966,2481,1822,4303,+
chr5,33461124,1.3643017650109757,3446,2313,5759,+
chr5,33461332,1.4842289719626167,2309,1497,3806,+
chr5,33462104,1.4437935227147123,2176,1307,3483,+
chr5,33462220,1.393703415285349,2348,1514,3862,+
chr5,33463915,1.4619017946161514,1922,1179,3101,+
chr5,33463925,0.6932325556588391,2006,1436,3442,+
chr5,33466982,1.4441101026045775,2341,1447,3788,+
chr5,33467682,1.6128684452335988,4807,3308,8115,+
chr5,33467820,1.454702305839165,2663,1894,4557,+
chr5,33467827,1.4810725340023647,4506,3218,7724,+
chr5,34915813,1.63606862225243,722,501,1223,+
chr5,34915903,2.2245179063360885,645,483,1128,+
chr5,34915967,1.932447503784055,1148,803,1951,+
chr5,34915979,1.9851851851851852,669,449,1118,+
chr5,34918477,0.6228727025187202,1829,1355,3184,+
chr5,34918479,0.6228727025187202,1829,1355,3184,+
chr5,34918484,1.6790248857287962,1043,715,1758,+
chr5,34918537,1.513947590870668,1193,844,2037,+
chr5,34919950,1.5914318573893045,944,657,1601,+
chr5,34922671,1.6722649762547044,2727,1906,4633,+
chr5,34922819,1.5366868818552915,3654,2840,6494,+
chr5,34922820,1.5883669677196317,2136,1584,3720,+
chr5,34922858,1.4594943948753147,1656,1409,3065,+
chr5,34923241,0.7667941759022663,1609,1120,2729,+
chr5,34923257,2.5778695577353297,2139,1340,3479,+
chr5,34923263,1.6204453690785483,4343,3152,7495,+
chr5,34923264,1.298588440153673,10105,6979,17084,+
chr5,34924979,1.781483325037332,1192,860,2052,+
chr5,34925049,1.5406590801327644,950,702,1652,+
chr5,34925409,1.427571412442136,1307,1041,2348,+
chr5,34937581,2.325476992143659,443,593,1036,+
chr5,34937582,3.419853260818783,1299,1292,2591,+
chr5,34937583,4.148968253968254,856,699,1555,+
chr5,34945027,3.807677777686993,931,577,1508,+
chr5,34954051,1.4358881526295006,1002,642,1644,+
chr5,34954677,0.3329670329670329,908,545,1453,+
chr5,34954686,3.601783060921248,1009,672,1681,+
chr5,36153124,2.2141792103471722,722,532,1254,+
chr5,36166635,2.3072470830531784,657,468,1125,+
chr5,36170506,2.055209042553325,1365,879,2244,+
chr5,36170507,2.242102320380207,801,510,1311,+
chr5,36177079,1.8388801752426587,934,670,1604,+
chr5,36606757,0.9998963300850092,642,370,1012,+
chr5,36606759,1.6665302454229904,825,518,1343,+
chr5,36608651,0.5314132789601121,694,412,1106,+
chr5,36629644,0.4293522267206478,706,493,1199,+
chr5,36677207,1.1269619682774088,1337,894,2231,+
chr5,36677275,0.6447114056890362,1333,638,1971,+
chr5,36677277,0.6479956466533647,1373,744,2117,+
chr5,36677280,0.7025207025207025,1543,813,2356,+
chr5,36679730,3.1753678693811738,1601,901,2502,+
chr5,36679844,3.2687176532336935,834,575,1409,+
chr5,36684075,0.8883521202361783,661,551,1212,+
chr5,36684076,0.8883521202361783,661,551,1212,+
chr5,36686240,1.961130684946043,1155,764,1919,+
chr5,36686513,2.128262022386771,1410,875,2285,+
chr5,36686526,0.5379279811097992,728,461,1189,+
chr5,36686548,2.0088018817816224,853,572,1425,+
chr5,36686555,1.4928774928774928,1047,701,1748,+
chr5,36687075,2.3289237668161435,798,668,1466,+
chr5,36687077,2.3289237668161435,798,668,1466,+
chr5,36687139,0.3013546989024889,872,677,1549,+
chr5,36687205,2.446753246753247,941,604,1545,+
chr5,36687206,2.446753246753247,941,604,1545,+
chr5,36687209,2.0434487270777186,877,646,1523,+
chr5,36687312,1.4199441466919815,1048,897,1945,+
chr5,36687351,0.6241597849049357,649,507,1156,+
chr5,36687547,1.7703163348786473,1128,771,1899,+
chr5,36687562,0.6104536489151874,618,467,1085,+
chr5,36688008,1.588336192109777,925,688,1613,+
chr5,36688057,1.7971014492753623,743,503,1246,+
chr5,37057288,0.8180130573449539,676,464,1140,+
chr5,37064667,1.1112102328477762,605,487,1092,+
chr5,38869154,1.4296713430852115,1097,779,1876,+
chr5,38869172,0.5835591689250225,759,539,1298,+
chr5,38881751,1.997924601707162,1182,802,1984,+
chr5,38881812,1.7567567567567568,714,591,1305,+
chr5,38884160,2.6168564920273347,717,438,1155,+
chr5,38884169,3.1586044318717588,778,504,1282,+
chr5,38885549,2.2032374100719423,839,555,1394,+
chr5,38885550,1.2230692741133575,1311,861,2172,+
chr5,38885552,0.9448902027027029,894,591,1485,+
chr5,38886535,0.5086304470854556,718,557,1275,+
chr5,38932994,0.7833891127084349,606,472,1078,+
chr5,38933953,2.7006319118369935,659,437,1096,+
chr5,38934393,6.933122279382667,729,360,1089,+
chr5,41920734,19.676523153254543,818,431,1249,+
chr5,41920753,7.103723158070015,654,633,1287,+
chr5,41920760,8.638820382598611,1145,1707,2852,+
chr5,41920761,8.638820382598611,1145,1707,2852,+
chr5,41929975,1.7383910573575228,846,534,1380,+
chr5,41929977,1.840338933298179,1139,749,1888,+
chr5,41934074,2.295003681811936,1179,899,2078,+
chr5,41934088,1.9233817701453104,895,756,1651,+
chr5,43175091,1.9059792337987824,618,398,1016,+
chr5,43609310,1.204152249134948,911,645,1556,+
chr5,43609312,1.204152249134948,911,645,1556,+
chr5,43628439,3.7928518289144137,586,428,1014,+
chr5,43653253,4.027777777777778,608,419,1027,+
chr5,43653254,4.027777777777778,608,419,1027,+
chr5,43705038,0.46567806744797885,707,451,1158,+
chr5,43705395,1.756686977176495,629,420,1049,+
chr5,44809575,3.428861781514973,1036,583,1619,+
chr5,44809577,3.428861781514973,1036,583,1619,+
chr5,44811114,2.243092824488173,609,558,1167,+
chr5,44811115,2.243092824488173,609,558,1167,+
chr5,44812047,1.6478212021507102,1052,732,1784,+
chr5,44812059,1.994043186895012,617,473,1090,+
chr5,44813256,1.88459139114161,635,457,1092,+
chr5,44813271,1.7335453997322934,1934,1357,3291,+
chr5,44815138,2.5524222704266086,705,460,1165,+
chr5,44815277,2.8388017118402282,994,700,1694,+
chr5,52096502,1.0008386968229959,706,433,1139,+
chr5,52097547,1.2656316080518377,1271,805,2076,+
chr5,52097549,1.2935267857142856,731,383,1114,+
chr5,52097687,1.1786797127345527,1098,779,1877,+
chr5,52145297,1.0768431983385254,731,427,1158,+
chr5,52145298,1.0768431983385254,731,427,1158,+
chr5,52161570,1.9373087677580603,592,527,1119,+
chr5,52204748,0.4271708683473389,609,419,1028,+
chr5,52204749,0.6486435877630317,865,908,1773,+
chr5,52204753,1.5381535484301492,921,730,1651,+
chr5,52204780,1.7747818130630628,3093,2959,6052,+
chr5,52204781,1.7747818130630628,3093,2959,6052,+
chr5,52206027,1.7996935121319617,652,459,1111,+
chr5,52206070,2.909236214179701,821,460,1281,+
chr5,52206071,3.1105931305032803,1113,652,1765,+
chr5,52206179,2.297242038571393,666,512,1178,+
chr5,52243261,0.5147705845380264,584,429,1013,+
chr5,52248323,1.2671763019589104,601,400,1001,+
chr5,52248433,1.7016961651917406,709,451,1160,+
chr5,52248919,2.354196799723291,641,517,1158,+
chr5,52250164,2.072482638888889,954,511,1465,+
chr5,52250165,2.072482638888889,954,511,1465,+
chr5,52250174,2.5030051813471506,928,578,1506,+
chr5,52250176,1.3148388384392775,1463,910,2373,+
chr5,52250177,1.521520704997473,1099,627,1726,+
chr5,52250178,1.0095317032739328,1014,634,1648,+
chr5,52250207,0.4588165464341157,772,465,1237,+
chr5,52250208,1.871674491392801,1039,709,1748,+
chr5,52250211,0.5578996939015776,1076,684,1760,+
chr5,52856555,2.4913137383791906,757,462,1219,+
chr5,52856557,2.6538402738909106,1099,663,1762,+
chr5,52899325,2.3931593548054644,1081,820,1901,+
chr5,52954390,2.0809298862495176,943,775,1718,+
chr5,54456005,0.8135794950321044,828,504,1332,+
chr5,54456007,0.9340459759602151,3039,1929,4968,+
chr5,54456008,1.0262152210936946,3837,2447,6284,+
chr5,54456855,1.0709060784158289,1489,1170,2659,+
chr5,54456888,2.5384615384615383,611,407,1018,+
chr5,54456907,2.0343859649122806,668,474,1142,+
chr5,54456995,0.642072213500785,817,571,1388,+
chr5,54456997,2.3813882250323655,1731,1218,2949,+
chr5,54459974,0.6237647182506307,878,655,1533,+
chr5,54459995,2.254697286012526,559,478,1037,+
chr5,54460208,0.6606567747872094,918,643,1561,+
chr5,54460233,2.155478964932436,984,676,1660,+
chr5,54646776,3.106548004408336,717,626,1343,+
chr5,54674259,4.338513550865979,691,471,1162,+
chr5,54696155,2.8229456406521494,1120,832,1952,+
chr5,55240811,1.8453417788334652,607,420,1027,+
chr5,55240815,1.5978865406006677,675,495,1170,+
chr5,55240816,1.5912598204264872,1744,1295,3039,+
chr5,55240828,2.632166098543539,547,460,1007,+
chr5,55240829,2.632166098543539,547,460,1007,+
chr5,56557095,1.8560637028401408,595,434,1029,+
chr5,60241034,0.3540497193263833,882,405,1287,+
chr5,60241169,2.3917728733907078,884,745,1629,+
chr5,60448656,0.6236772486772487,983,671,1654,+
chr5,60448681,1.5372058144900784,1133,787,1920,+
chr5,60448690,1.4884677636903156,1050,673,1723,+
chr5,60448694,0.6811271607861711,1597,1029,2626,+
chr5,64859218,2.031957461051607,647,377,1024,+
chr5,64867925,0.4612941643509329,580,457,1037,+
chr5,64867927,0.4300205821817112,935,715,1650,+
chr5,64867929,0.3820929569432563,669,500,1169,+
chr5,64960464,4.994364973783756,728,419,1147,+
chr5,65288630,2.107367693305551,1105,638,1743,+
chr5,65288646,1.6176030693198078,2313,1397,3710,+
chr5,65288647,1.6176030693198078,2313,1397,3710,+
chr5,65288648,1.6176030693198078,2313,1397,3710,+
chr5,65321752,2.3493100944081338,646,611,1257,+
chr5,65321753,2.4253301471842046,957,809,1766,+
chr5,65349720,1.8287187934734364,1002,681,1683,+
chr5,65349722,1.8771965341323185,652,465,1117,+
chr5,65349726,2.55001992825827,913,771,1684,+
chr5,65349728,2.55001992825827,913,771,1684,+
chr5,65349738,2.3823383823383826,751,480,1231,+
chr5,65350047,3.3769848821674757,847,498,1345,+
chr5,65350084,1.776277160409319,1320,716,2036,+
chr5,65350088,2.664572864321608,807,397,1204,+
chr5,65350108,1.5361730899256254,1135,637,1772,+
chr5,65350113,3.116024804177546,1272,765,2037,+
chr5,65350129,1.788028092334495,3623,2623,6246,+
chr5,65350130,1.788028092334495,3623,2623,6246,+
chr5,65350131,1.9387564282374943,4900,3626,8526,+
chr5,65350133,2.011921943592519,2524,1927,4451,+
chr5,65350141,2.1363713263379673,3733,2717,6450,+
chr5,65374908,3.026353276353277,606,467,1073,+
chr5,68463081,2.6402805611222444,526,498,1024,+
chr5,68463818,1.8548214285714288,798,447,1245,+
chr5,68463835,0.6039160179287567,639,470,1109,+
chr5,68463864,2.099797160243408,646,434,1080,+
chr5,68463869,1.6956873861105488,669,448,1117,+
chr5,68463876,0.529423996672905,803,686,1489,+
chr5,68463888,1.5668665837063371,1434,1089,2523,+
chr5,68464103,3.120160213618157,778,427,1205,+
chr5,68464127,2.37876277271472,748,425,1173,+
chr5,68464142,1.7222009321736311,1556,991,2547,+
chr5,68464143,2.0559210526315788,624,474,1098,+
chr5,68470718,1.5880884777431763,1260,823,2083,+
chr5,68470774,1.5957488812845486,3185,2357,5542,+
chr5,68470776,1.581090782241554,5048,3604,8652,+
chr5,68470779,1.5569505564381907,6721,5094,11815,+
chr5,68470781,1.5408348703482693,3664,2835,6499,+
chr5,68470867,0.6656167714462097,2031,1333,3364,+
chr5,68470928,1.4130090987868285,1946,1153,3099,+
chr5,68471267,1.931927133269415,779,595,1374,+
chr5,68471307,0.6075304965901451,1099,717,1816,+
chr5,68471308,1.1302166977001302,1882,1456,3338,+
chr5,68490476,2.641898864809081,639,509,1148,+
chr5,68490477,2.641898864809081,639,509,1148,+
chr5,68490478,1.81250758955677,877,609,1486,+
chr5,68506000,2.3074047052286275,663,449,1112,+
chr5,68506096,1.9236138127630173,777,543,1320,+
chr5,68531247,5.378824476650564,861,551,1412,+
chr5,68531250,2.630749945498147,1026,833,1859,+
chr5,68548259,1.8140876931849115,1009,741,1750,+
chr5,68565084,2.409128289473684,650,455,1105,+
chr5,68568810,1.3513002236891196,688,528,1216,+
chr5,68572453,0.4332049763033175,584,421,1005,+
chr5,70898454,0.9791325241638119,1139,686,1825,+
chr5,70900183,0.4503771671328601,1543,834,2377,+
chr5,72144260,0.596642685851319,621,416,1037,+
chr5,72144301,2.123348017621145,722,453,1175,+
chr5,72144310,3.573932092004381,752,497,1249,+
chr5,72147084,0.49062043870008076,1435,921,2356,+
chr5,72157647,2.3510514018691584,574,427,1001,+
chr5,72171446,2.03399209486166,663,505,1168,+
chr5,72173098,1.9588948787062,968,741,1709,+
chr5,72178322,1.8648111332007955,669,502,1171,+
chr5,72182896,2.187430912027295,792,656,1448,+
chr5,72183918,1.22642288841272,895,765,1660,+
chr5,72184104,1.7014157014157016,660,554,1214,+
chr5,72185697,0.5139048324384373,770,490,1260,+
chr5,72185699,0.6451466173393576,924,672,1596,+
chr5,72185700,2.305504019789734,931,636,1567,+
chr5,72185701,2.305504019789734,931,636,1567,+
chr5,72189024,1.9476082004555808,569,438,1007,+
chr5,72189045,1.5717687811214551,659,595,1254,+
chr5,72192377,1.862868809331439,1389,1002,2391,+
chr5,72195892,0.8623807631160574,788,628,1416,+
chr5,72195893,0.8623807631160574,788,628,1416,+
chr5,72199581,2.1629416005767843,719,437,1156,+
chr5,72201234,2.336187639612807,752,473,1225,+
chr5,72204657,28.44231334868518,2747,535,3282,+
chr5,72204658,27.900079374169195,2758,573,3331,+
chr5,72204660,28.03704891740177,1546,644,2190,+
chr5,72204661,52.6570814164242,2792,2080,4872,+
chr5,72204662,52.65708141642419,2792,2080,4872,+
chr5,72204665,13.669589127367827,1254,2066,3320,+
chr5,72204679,0.3307955169131771,779,1198,1977,+
chr5,72204680,0.5281321337451323,512,676,1188,+
chr5,72204703,0.6388092269326683,758,801,1559,+
chr5,72204789,0.5835809665657242,1717,1173,2890,+
chr5,72204797,1.9752345215759848,751,532,1283,+
chr5,72204994,0.4202767360662097,649,406,1055,+
chr5,72205020,2.61954261954262,629,443,1072,+
chr5,72205052,4.288503253796096,658,460,1118,+
chr5,72205212,13.096743502484513,1722,162,1884,+
chr5,72205213,13.126778491721076,2515,203,2718,+
chr5,72205214,12.497814933630465,3502,301,3803,+
chr5,72205215,30.926542987424906,4811,444,5255,+
chr5,72205216,68.10217025428747,6876,1956,8832,+
chr5,72205217,68.71062043783687,6406,2433,8839,+
chr5,72205218,67.76285567802479,5204,2338,7542,+
chr5,72205236,8.019135865002559,4057,5990,10047,+
chr5,72205237,8.019135865002559,4057,5990,10047,+
chr5,72205418,1.676407697790449,671,487,1158,+
chr5,72205488,2.2986438679245285,677,423,1100,+
chr5,72205795,1.2294085012814246,2395,1794,4189,+
chr5,72208852,0.3986765126341564,805,510,1315,+
chr5,72209078,2.3580740238306803,1111,752,1863,+
chr5,72794265,0.7154102126419302,1241,618,1859,+
chr5,72794266,0.8802423860723924,1748,1038,2786,+
chr5,72794267,0.9624588517184048,2544,1295,3839,+
chr5,72794268,1.0596751061722152,2086,1343,3429,+
chr5,72794272,0.7932923445117739,2221,1080,3301,+
chr5,72794277,1.7391705069124423,1664,650,2314,+
chr5,72794283,1.2997504735925567,5658,3470,9128,+
chr5,72794342,0.5841265489637022,1868,1657,3525,+
chr5,72794347,1.5433705684572323,4051,2920,6971,+
chr5,72794348,1.5433705684572323,4051,2920,6971,+
chr5,72794366,0.7461421176470587,2416,2124,4540,+
chr5,72794367,1.696750978584596,5680,3813,9493,+
chr5,72794980,0.7968,4232,3124,7356,+
chr5,72798856,1.244026620321728,5324,3342,8666,+
chr5,72801180,1.4653429602888086,3074,1661,4735,+
chr5,72801182,1.3594299247932853,5276,3521,8797,+
chr5,72801183,1.3594299247932853,5276,3521,8797,+
chr5,72875784,0.6834181610606475,1015,493,1508,+
chr5,73981034,0.9001452912429005,704,338,1042,+
chr5,73981035,0.9001452912429005,704,338,1042,+
chr5,73981036,2.3052943063556373,831,440,1271,+
chr5,73985201,1.156556743971799,1267,869,2136,+
chr5,73985211,2.322678843226788,762,510,1272,+
chr5,73985276,0.5386138613861385,951,706,1657,+
chr5,73985287,0.7516025641025641,1406,953,2359,+
chr5,73985295,1.7684151239102752,1312,995,2307,+
chr5,73989464,1.4773123375630637,1360,1054,2414,+
chr5,73989465,0.7070197970654394,3720,2342,6062,+
chr5,74009454,2.464985163204748,1064,673,1737,+
chr5,74011337,1.8085714285714285,843,599,1442,+
chr5,74011397,1.5912618245951575,1626,1154,2780,+
chr5,74014696,1.6201073694485115,771,682,1453,+
chr5,74014716,1.7954751927492258,2096,1677,3773,+
chr5,74014731,0.702537903757416,1420,1109,2529,+
chr5,74016335,1.7052412931434482,1957,1294,3251,+
chr5,74016501,2.5363941769316907,754,563,1317,+
chr5,74017001,2.3030303030303028,727,571,1298,+
chr5,74017012,1.6322837049882961,2051,1448,3499,+
chr5,74063112,2.5505229275808037,780,599,1379,+
chr5,74064759,1.9070355731225297,651,574,1225,+
chr5,74064860,1.7213501186711346,1615,971,2586,+
chr5,74065138,1.593440779610195,1148,666,1814,+
chr5,74065160,2.447709497206704,1152,715,1867,+
chr5,74066514,1.6856043110084682,643,432,1075,+
chr5,74066517,2.268431001890359,999,574,1573,+
chr5,74066537,2.416576479076479,1164,791,1955,+
chr5,74066539,1.995725190839695,859,654,1513,+
chr5,74069714,2.28604118993135,665,436,1101,+
chr5,74646999,1.740141362802046,710,554,1264,+
chr5,74647067,2.1628915662650603,611,414,1025,+
chr5,74650404,3.5648588414995452,639,503,1142,+
chr5,74650438,0.40026073020968084,607,511,1118,+
chr5,74882862,1.6778032798552227,699,549,1248,+
chr5,76355530,1.477643901324806,1032,706,1738,+
chr5,76715669,3.2802389071054145,1020,695,1715,+
chr5,76715671,2.2349049251706066,1206,735,1941,+
chr5,76715673,2.3783783783783785,725,443,1168,+
chr5,85913744,0.7398593905704417,1295,512,1807,+
chr5,85913749,2.3204942498530525,1241,574,1815,+
chr5,85913751,1.7237567318113527,2151,974,3125,+
chr5,85913753,1.798552106598189,4309,2246,6555,+
chr5,85913754,1.825750305792927,3934,2320,6254,+
chr5,85913755,1.719181214549069,6486,3951,10437,+
chr5,85913756,2.1042385137390145,1939,1615,3554,+
chr5,85913757,1.616299799871056,5305,3639,8944,+
chr5,85913759,1.5921367456574032,5781,3784,9565,+
chr5,85913760,1.1885010325564576,2472,1533,4005,+
chr5,85913761,2.279420289855073,982,574,1556,+
chr5,85913762,1.438644945517316,1257,712,1969,+
chr5,85913779,1.547519982614754,5116,3357,8473,+
chr5,85913781,1.5172024159682218,3655,2443,6098,+
chr5,85913785,0.7014838852501633,3367,2513,5880,+
chr5,85913786,1.4985919899874844,2603,1903,4506,+
chr5,85913792,0.6887060812385543,11079,7667,18746,+
chr5,85913794,0.9698786473546328,9403,6037,15440,+
chr5,85913795,1.3176606441615013,11587,8050,19637,+
chr5,85913944,0.7794992249601684,8357,4804,13161,+
chr5,85915168,1.3256603102204538,25612,12394,38006,+
chr5,85915169,1.269390385437634,85171,45169,130340,+
chr5,85915170,1.3332475423915184,74284,39269,113553,+
chr5,85915186,1.9640490484967061,30014,19262,49276,+
chr5,85915187,0.7315833400445924,48170,25890,74060,+
chr5,85915189,1.63104405589001,79484,53170,132654,+
chr5,85915190,1.679777303320932,83686,53155,136841,+
chr5,85915204,1.0967929800421246,24954,12273,37227,+
chr5,85915207,1.3286390278209377,37092,19401,56493,+
chr5,85915217,1.6518284247010973,33693,16760,50453,+
chr5,85915221,1.5743639779832201,71748,38469,110217,+
chr5,85915224,1.3935596920163718,78203,42650,120853,+
chr5,85915229,1.659990377269719,40889,24253,65142,+
chr5,85915235,1.0409219796350417,186461,125206,311667,+
chr5,85915243,1.362153590598983,52592,34385,86977,+
chr5,85915258,1.422604294452929,70538,48743,119281,+
chr5,85915261,1.749095363501602,76453,55101,131554,+
chr5,85916483,1.3354553575009287,665,500,1165,+
chr5,92929669,3.3000403594822165,749,255,1004,+
chr5,92929670,3.6615005499441367,1268,397,1665,+
chr5,92929672,8.311723602484472,792,275,1067,+
chr5,92929673,8.775013975627575,962,436,1398,+
chr5,92929676,6.67942020030233,1549,1112,2661,+
chr5,92929677,4.42374074995504,2079,1578,3657,+
chr5,92929679,2.881117543216047,1332,1211,2543,+
chr5,92929680,0.3174387947269303,601,589,1190,+
chr5,92929684,0.4403108321660849,842,660,1502,+
chr5,92929695,0.47550142721128325,1560,1083,2643,+
chr5,92929697,0.45762711864406774,989,648,1637,+
chr5,92929698,0.47233910942932655,2222,1553,3775,+
chr5,92929699,0.548575417221905,1364,917,2281,+
chr5,92929701,0.5164329455902437,3016,1916,4932,+
chr5,92929703,0.5339775166421505,3800,2389,6189,+
chr5,92929704,1.1618145706159406,3875,2398,6273,+
chr5,92929705,0.4628340757238307,699,448,1147,+
chr5,92929800,2.1730027548209367,543,483,1026,+
chr5,92929881,2.302526748568219,640,421,1061,+
chr5,93964519,3.4896240234375,732,511,1243,+
chr5,93964520,3.4896240234375,732,511,1243,+
chr5,93989061,0.4872526636225266,590,437,1027,+
chr5,93989082,2.4164102564102565,911,584,1495,+
chr5,94027893,1.256630707154221,645,633,1278,+
chr5,94030544,1.6967410714285716,926,699,1625,+
chr5,94030569,1.7143483023001096,601,414,1015,+
chr5,94030607,2.3760731099418444,714,470,1184,+
chr5,94030631,2.010303143745167,1942,1287,3229,+
chr5,94031115,3.7645283018867928,687,529,1216,+
chr5,94031184,1.5923022095509622,1116,731,1847,+
chr5,94032276,1.9638200647224433,681,485,1166,+
chr5,95129344,2.125082991741636,689,485,1174,+
chr5,95129369,4.078387872065077,718,484,1202,+
chr5,95130006,1.211023643273099,829,644,1473,+
chr5,95131406,4.239361805642048,653,494,1147,+
chr5,95131882,1.628842504743833,739,526,1265,+
chr5,96011283,2.029436751675207,622,481,1103,+
chr5,96063197,2.351723962297024,843,711,1554,+
chr5,96065330,1.999487486119416,835,508,1343,+
chr5,96071892,1.7734553775743709,588,436,1024,+
chr5,96071910,1.663221153846154,628,479,1107,+
chr5,96075780,0.4023906740043789,679,392,1071,+
chr5,96077053,0.48044156467482596,615,462,1077,+
chr5,96078360,2.8749083681252317,1026,668,1694,+
chr5,96083084,1.6519239274657231,829,645,1474,+
chr5,96084296,1.7320197044334973,878,608,1486,+
chr5,96089777,2.157635467980296,656,405,1061,+
chr5,96089825,1.723726977248104,1031,567,1598,+
chr5,96089857,1.7271965628356605,1960,1224,3184,+
chr5,96090374,0.4648895799024171,2900,1656,4556,+
chr5,96093355,2.1697274881516586,585,421,1006,+
chr5,96100935,1.6693333333333331,625,389,1014,+
chr5,96103626,2.157738095238095,550,455,1005,+
chr5,96103627,1.8352916924345493,613,440,1053,+
chr5,96103689,2.039059913935783,615,476,1091,+
chr5,96106273,2.668056279312142,799,504,1303,+
chr5,96106274,1.793774711426651,1066,927,1993,+
chr5,96107391,2.186014308792984,887,618,1505,+
chr5,96108349,1.9549549549549547,588,443,1031,+
chr5,96108362,1.7659892927094083,1592,1142,2734,+
chr5,96108409,1.7263320463320464,827,517,1344,+
chr5,96110262,1.3627566910398103,1074,810,1884,+
chr5,102201922,2.3671810791664867,703,517,1220,+
chr5,102201924,2.3671810791664867,703,517,1220,+
chr5,102284100,1.668868472211469,939,664,1603,+
chr5,102284128,2.5051817641687375,944,744,1688,+
chr5,102326011,2.1250040274286284,744,502,1246,+
chr5,102342710,2.4837662337662336,764,461,1225,+
chr5,102342712,2.4837662337662336,764,461,1225,+
chr5,102343277,0.5508998119795863,585,437,1022,+
chr5,102355509,1.5324932058054819,1511,1059,2570,+
chr5,102355510,0.990303951367781,1050,699,1749,+
chr5,102355512,2.0902989627821844,1141,893,2034,+
chr5,102355513,2.4014723741408406,2184,1675,3859,+
chr5,102361015,3.3957038193810996,1299,994,2293,+
chr5,102361016,4.404944325263051,979,752,1731,+
chr5,109153084,2.058241994412207,1255,1033,2288,+
chr5,109153086,1.9461382113821135,1914,1598,3512,+
chr5,109153087,1.813447009665302,1301,1101,2402,+
chr5,109203622,18.260547411759312,552,941,1493,+
chr5,109203648,0.168670450244389,661,1077,1738,+
chr5,109203650,0.2298987492555092,385,656,1041,+
chr5,110097917,0.5230345814133636,1056,713,1769,+
chr5,111496775,1.6265137029955383,637,522,1159,+
chr5,111496776,1.6265137029955383,637,522,1159,+
chr5,111496777,1.6265137029955383,637,522,1159,+
chr5,111496805,2.361087866108787,593,477,1070,+
chr5,111496806,2.361087866108787,593,477,1070,+
chr5,111496815,3.739195790810359,582,445,1027,+
chr5,112200412,2.9472107448685194,828,593,1421,+
chr5,112203238,2.177369077306733,634,400,1034,+
chr5,112203306,5.928814113517208,1198,983,2181,+
chr5,112203367,1.495026525198939,1001,753,1754,+
chr5,115249151,1.0957743457743458,600,443,1043,+
chr5,115249153,1.0957743457743458,600,443,1043,+
chr5,115249419,2.5953859804791484,674,482,1156,+
chr5,118454641,1.7255353640662376,972,662,1634,+
chr5,118454648,2.1020369898877247,643,476,1119,+
chr5,118829547,2.8558233085650464,593,433,1026,+
chr5,118865593,2.294980346952224,575,501,1076,+
chr5,118872175,1.454239469745123,2337,1475,3812,+
chr5,118872176,1.7652516384128019,1828,1126,2954,+
chr5,118872187,1.713476652797041,592,411,1003,+
chr5,118872189,1.9426492819349959,708,377,1085,+
chr5,118872202,1.557023844337268,2798,1895,4693,+
chr5,118872203,0.4781294647763491,1581,1010,2591,+
chr5,118872209,2.2342883548983368,966,540,1506,+
chr5,118877603,2.059054785968583,1848,1260,3108,+
chr5,118877606,1.6794988430275104,3830,2570,6400,+
chr5,118877607,1.6794988430275104,3830,2570,6400,+
chr5,118877618,1.4817156773528999,4748,3308,8056,+
chr5,118877639,3.522773837667455,2991,2294,5285,+
chr5,122143973,3.186083223723124,940,818,1758,+
chr5,122143983,2.1793986621821837,978,938,1916,+
chr5,122165347,1.0724416135881103,573,470,1043,+
chr5,122165348,1.0724416135881103,573,470,1043,+
chr5,126140579,5.926114016120506,629,376,1005,+
chr5,126145884,0.5695243653341115,1573,1149,2722,+
chr5,126145885,0.8330142053680984,1885,1372,3257,+
chr5,126145932,2.106782106782107,1167,791,1958,+
chr5,126172274,5.838383838383839,577,439,1016,+
chr5,126172275,5.225713482217362,1262,929,2191,+
chr5,126172276,4.952014871148483,1700,1253,2953,+
chr5,126172382,3.936355115104778,1019,850,1869,+
chr5,126172607,25.165813946175774,737,613,1350,+
chr5,126172611,12.754752376463852,1186,1907,3093,+
chr5,126172612,12.754752376463852,1186,1907,3093,+
chr5,126172622,0.3148724046464831,404,753,1157,+
chr5,126172623,0.3148724046464831,404,753,1157,+
chr5,126865996,6.809052119293265,1970,1647,3617,+
chr5,126865997,6.809052119293265,1970,1647,3617,+
chr5,126874771,3.298891197323439,615,444,1059,+
chr5,126887714,1.5040456788767218,874,581,1455,+
chr5,126888561,2.9555028024160634,615,466,1081,+
chr5,126890568,2.2295699487286806,760,502,1262,+
chr5,131927649,2.8739581068348192,861,510,1371,+
chr5,131927650,2.8739581068348192,861,510,1371,+
chr5,131927718,1.6691304347826086,697,459,1156,+
chr5,131927722,1.6369925697735201,1990,1309,3299,+
chr5,131930561,0.5930656934306568,844,547,1391,+
chr5,131930565,1.4498091119080985,1458,953,2411,+
chr5,131930569,1.9998328108672936,1017,724,1741,+
chr5,131939633,1.5233025233025232,635,438,1073,+
chr5,131944372,0.3332884641270696,618,436,1054,+
chr5,131944373,0.3332884641270696,618,436,1054,+
chr5,131951762,1.7823303457106272,1043,780,1823,+
chr5,131951764,1.7823303457106272,1043,780,1823,+
chr5,131951785,2.231212121212121,596,494,1090,+
chr5,131951788,2.0290760869565214,654,574,1228,+
chr5,131951795,1.9863132113528312,810,630,1440,+
chr5,132202330,1.3907639625147996,545,502,1047,+
chr5,132202371,0.579100145137881,778,688,1466,+
chr5,132202571,0.971540903781934,3067,1761,4828,+
chr5,132202572,0.971540903781934,3067,1761,4828,+
chr5,132202582,1.944493461400426,1900,1422,3322,+
chr5,132202590,1.1323464963704142,3372,2428,5800,+
chr5,132202596,1.4149659863945576,987,797,1784,+
chr5,132203179,1.6842753745634786,2116,1613,3729,+
chr5,132203203,1.6970564249334503,2689,2240,4929,+
chr5,132388026,2.4679554359142966,692,444,1136,+
chr5,132388027,0.9944751381215469,539,542,1081,+
chr5,132388029,0.9944751381215469,539,542,1081,+
chr5,132403198,1.775675675675676,656,443,1099,+
chr5,132403220,2.9589758510328776,677,490,1167,+
chr5,132406158,1.6211467690237822,1137,682,1819,+
chr5,132412450,1.6018700787401574,650,507,1157,+
chr5,132412533,0.3545191040843214,960,758,1718,+
chr5,132424108,2.120343839541547,1109,697,1806,+
chr5,132424112,2.063768115942029,711,614,1325,+
chr5,132424204,0.5819269062651772,1008,567,1575,+
chr5,132426902,1.8953161306102484,573,480,1053,+
chr5,132426947,1.9917999110183107,2328,1467,3795,+
chr5,132426961,0.6049513704686119,1865,1304,3169,+
chr5,132426994,1.6559520253658984,1637,1225,2862,+
chr5,132428470,1.8614718614718613,859,692,1551,+
chr5,132428471,1.8614718614718613,859,692,1551,+
chr5,132431861,2.862633900441084,648,528,1176,+
chr5,132437490,1.9269776876267748,569,492,1061,+
chr5,132439603,0.6273183381250352,855,656,1511,+
chr5,132439996,0.6209944751381214,842,542,1384,+
chr5,132440069,2.0071202382224715,1202,774,1976,+
chr5,132440276,12.672301979017341,654,515,1169,+
chr5,134076894,0.31726953931336954,704,473,1177,+
chr5,134076980,2.621720116618076,1198,587,1785,+
chr5,134076982,2.621720116618076,1198,587,1785,+
chr5,134076985,1.6287150542375872,1025,666,1691,+
chr5,134077003,2.4480260536021756,1871,1072,2943,+
chr5,134077013,2.4804584897506365,2902,1858,4760,+
chr5,134077182,2.829326923076924,641,415,1056,+
chr5,134086501,2.1530898876404496,656,533,1189,+
chr5,134086691,0.47074133154227177,800,553,1353,+
chr5,134086744,1.6991418475517417,1121,848,1969,+
chr5,134099640,1.778203812834227,1554,1036,2590,+
chr5,134099642,2.176673567977916,829,482,1311,+
chr5,134099644,1.9393165122963911,919,504,1423,+
chr5,134099645,1.9393165122963911,919,504,1423,+
chr5,134099665,2.192276200873362,594,457,1051,+
chr5,134106668,1.458498232351814,1349,903,2252,+
chr5,134106669,0.9663865546218486,679,475,1154,+
chr5,134106672,2.8167118827997832,720,484,1204,+
chr5,134106678,2.425593328422948,834,605,1439,+
chr5,134109442,1.972079154242342,581,433,1014,+
chr5,134109463,1.775692695214106,612,396,1008,+
chr5,134117684,2.336441626916442,595,447,1042,+
chr5,134118702,2.0545173966705703,647,530,1177,+
chr5,134153256,3.2738010450039554,680,471,1151,+
chr5,134153265,1.816550796142633,809,636,1445,+
chr5,134153267,0.7450229709035223,833,652,1485,+
chr5,134153268,0.3539256198347107,570,439,1009,+
chr5,134229310,2.183712121212121,1152,758,1910,+
chr5,134229311,2.183712121212121,1152,758,1910,+
chr5,134229334,1.1017281095519489,1329,950,2279,+
chr5,134231983,2.2219588087124023,651,396,1047,+
chr5,134232027,2.212163237015219,3599,2881,6480,+
chr5,134232028,2.0434610830816156,2932,2412,5344,+
chr5,134235352,4.685417237912439,663,379,1042,+
chr5,135364678,1.2275552486187844,710,361,1071,+
chr5,135369471,2.454571447382034,702,460,1162,+
chr5,135369494,1.7777777777777777,751,563,1314,+
chr5,135369498,0.4331901995453397,685,427,1112,+
chr5,135369527,1.7769880906646176,637,547,1184,+
chr5,135382047,2.5601750547045947,584,456,1040,+
chr5,135382634,1.6804511278195489,595,455,1050,+
chr5,135382659,1.719607843137255,876,713,1589,+
chr5,135382666,0.5966148892659793,856,488,1344,+
chr5,135382667,0.6252640473172792,1035,788,1823,+
chr5,135383007,1.4446783625730997,1543,824,2367,+
chr5,135383013,1.5477601150684523,2595,1753,4348,+
chr5,135383023,1.4115048526619312,2892,1927,4819,+
chr5,135383029,1.884577907697759,2552,1430,3982,+
chr5,135383031,2.002507809592548,7417,5743,13160,+
chr5,135383033,1.673993620282071,19429,15224,34653,+
chr5,135383034,1.5438703348079228,16756,12884,29640,+
chr5,135383035,1.6964557207119373,12137,10011,22148,+
chr5,135383038,1.4653010611494262,9117,7288,16405,+
chr5,135383041,2.2037426666221376,3534,2217,5751,+
chr5,135385169,2.414431898376853,594,435,1029,+
chr5,135385176,1.6325994084784754,647,536,1183,+
chr5,135385233,2.0318386195163445,835,632,1467,+
chr5,135385253,1.792342512259525,730,481,1211,+
chr5,135388616,0.6595923728987501,823,586,1409,+
chr5,135389635,3.1175651481997213,652,456,1108,+
chr5,135392412,0.4126370887337986,601,471,1072,+
chr5,135392434,1.2466635435987568,1791,1330,3121,+
chr5,135392467,1.705263157894737,623,519,1142,+
chr5,135394798,1.6532593619972262,595,514,1109,+
chr5,135394826,1.6133333333333333,725,599,1324,+
chr5,135396522,1.8046482083149753,866,553,1419,+
chr5,135396543,0.5961844197138315,649,480,1129,+
chr5,135396603,2.0625,549,479,1028,+
chr5,135397190,2.148724082934609,633,527,1160,+
chr5,135397216,0.6119767223577999,977,760,1737,+
chr5,135399077,1.875687568756876,619,403,1022,+
chr5,135399119,1.7053310800430173,739,565,1304,+
chr5,135399176,2.723642172523961,774,625,1399,+
chr5,135399264,1.472405380312086,2547,1996,4543,+
chr5,135399326,1.687435098650052,874,748,1622,+
chr5,135515923,2.910611303344868,720,407,1127,+
chr5,135515924,2.910611303344868,720,407,1127,+
chr5,137514864,2.4185990080837905,666,348,1014,+
chr5,137519395,1.1259523412641328,1038,624,1662,+
chr5,137519727,3.95245453648286,714,433,1147,+
chr5,137519728,4.770476487075677,850,493,1343,+
chr5,137520552,1.111388384754991,851,550,1401,+
chr5,137520553,1.111388384754991,851,550,1401,+
chr5,137520595,2.0398095005495174,695,430,1125,+
chr5,137520602,1.7414933837429112,736,459,1195,+
chr5,137520607,1.7054994388327722,785,494,1279,+
chr5,137520806,2.32998324958124,641,397,1038,+
chr5,137520817,0.5951532430506059,834,426,1260,+
chr5,137520821,3.356087791037303,913,520,1433,+
chr5,137520837,1.6017505839741593,3085,2051,5136,+
chr5,137520840,0.7280506621482189,2023,1417,3440,+
chr5,137523097,3.3387278799958446,835,618,1453,+
chr5,137754715,2.2648821606562852,1516,865,2381,+
chr5,137754716,2.526111235202144,926,604,1530,+
chr5,137754718,2.4478690540577355,1048,653,1701,+
chr5,138089137,2.541033780090542,726,455,1181,+
chr5,138089170,1.5909090909090908,804,436,1240,+
chr5,138118876,1.8670805475963068,950,697,1647,+
chr5,138118992,1.7314166824285981,795,621,1416,+
chr5,138145763,1.5021997718755091,877,721,1598,+
chr5,138145820,2.00109649122807,656,455,1111,+
chr5,138145827,1.8542657100873021,691,502,1193,+
chr5,138145852,1.6892652219932038,797,618,1415,+
chr5,138147876,2.1372027972027974,825,714,1539,+
chr5,138160264,2.032898206751055,880,631,1511,+
chr5,138160273,1.5687215515535329,812,651,1463,+
chr5,138160327,2.454280155642023,840,513,1353,+
chr5,138160341,1.7600373482726424,579,475,1054,+
chr5,138160360,2.214533171661181,946,501,1447,+
chr5,138160392,1.8626215747576913,1438,904,2342,+
chr5,138163212,0.4008791208791209,607,519,1126,+
chr5,138163274,2.3770491803278686,608,426,1034,+
chr5,138163297,0.4001826582142473,572,453,1025,+
chr5,138221910,0.5618275954814417,982,571,1553,+
chr5,138221946,1.8260084566215342,1796,1362,3158,+
chr5,138240071,2.276981351981352,952,779,1731,+
chr5,138253515,1.5278282334311393,1111,841,1952,+
chr5,138260306,2.747840292895536,2107,1513,3620,+
chr5,138260315,2.20871327254306,871,563,1434,+
chr5,138260327,1.7689317106152804,896,611,1507,+
chr5,138260339,1.6860966542750928,666,537,1203,+
chr5,138261019,2.055050505050505,625,439,1064,+
chr5,138261020,1.9617494023344113,899,546,1445,+
chr5,138261026,2.543722943722944,677,494,1171,+
chr5,138261048,4.176394293125811,643,513,1156,+
chr5,138261088,1.69126213592233,870,720,1590,+
chr5,138266197,1.9682556095543369,704,508,1212,+
chr5,138266198,1.5401125497518433,1638,1058,2696,+
chr5,138266228,1.5254495580615666,769,578,1347,+
chr5,138266229,1.739961759082218,699,522,1221,+
chr5,138266260,1.5530386740331492,936,723,1659,+
chr5,138268324,1.9861111111111112,714,389,1103,+
chr5,138268376,1.7637014825920374,604,521,1125,+
chr5,138268388,3.806324110671937,641,505,1146,+
chr5,138269502,1.693760611205433,693,588,1281,+
chr5,138269509,1.5237851849147528,1017,558,1575,+
chr5,138269573,2.4375159235668797,780,784,1564,+
chr5,138269578,1.2639911284577732,2832,2480,5312,+
chr5,138269580,0.7287629191174109,3932,2895,6827,+
chr5,138269581,0.7349397590361446,1082,1082,2164,+
chr5,138269586,1.415454182737066,1266,1029,2295,+
chr5,138269589,0.9898058762585048,4650,3877,8527,+
chr5,138269590,0.7340217367079955,3228,2964,6192,+
chr5,138269608,1.4257723408666805,1617,1112,2729,+
chr5,138269635,1.929700454109903,2292,1904,4196,+
chr5,138269715,1.5661473788328386,716,673,1389,+
chr5,138269817,1.6619433198380569,820,493,1313,+
chr5,138269830,2.7395256504022565,873,562,1435,+
chr5,138269886,1.7557456109425649,2989,2180,5169,+
chr5,138270169,2.1769323671497585,720,643,1363,+
chr5,138270238,1.5571544289321961,859,676,1535,+
chr5,138270245,2.3064935064935064,887,714,1601,+
chr5,138270521,3.1908843419379727,1165,914,2079,+
chr5,138643077,0.5459155215252777,768,480,1248,+
chr5,138643227,1.9851180074091221,1135,791,1926,+
chr5,138643277,1.57157960199005,682,535,1217,+
chr5,138643292,3.1717323327079425,817,532,1349,+
chr5,138643511,2.33795476892822,766,564,1330,+
chr5,138643614,3.485611510791367,968,555,1523,+
chr5,138643643,1.7108066971080669,1123,656,1779,+
chr5,138643903,2.036666666666666,1000,769,1769,+
chr5,138643904,1.5875069893761482,1045,641,1686,+
chr5,138643905,1.8879331894687492,1842,1402,3244,+
chr5,138643925,2.014093137254902,864,679,1543,+
chr5,138650389,1.4801789106059675,1027,858,1885,+
chr5,138651867,1.9873748692663973,718,581,1299,+
chr5,138652748,1.9449050943373387,1446,1061,2507,+
chr5,138652788,1.7391097922848662,791,673,1464,+
chr5,138653286,1.975757575757576,651,604,1255,+
chr5,138653358,1.1445000705635862,1825,1284,3109,+
chr5,138654644,0.4740569074288657,1051,862,1913,+
chr5,138655051,1.7281307248816418,3794,2809,6603,+
chr5,138657612,0.9652229174097553,1227,790,2017,+
chr5,138657641,1.9720756776423505,656,477,1133,+
chr5,138657644,1.74417292918134,2075,1573,3648,+
chr5,138657701,1.4637549287230818,1523,1098,2621,+
chr5,138658517,1.8935652173913045,1360,999,2359,+
chr5,138658550,1.2908874473811331,2049,1347,3396,+
chr5,138658580,0.7689383599039092,2781,1927,4708,+
chr5,138665041,1.6364623552123552,821,591,1412,+
chr5,138665044,1.943392919733614,852,633,1485,+
chr5,138665301,1.943305359526988,1044,748,1792,+
chr5,138665432,1.4380050870923082,1513,1070,2583,+
chr5,138665502,1.667176632270349,2334,1538,3872,+
chr5,138665508,1.432939420757631,1587,1010,2597,+
chr5,138665583,1.5211538461538463,1468,909,2377,+
chr5,138665654,1.8283892792089516,610,426,1036,+
chr5,138677557,0.47719808560704624,750,512,1262,+
chr5,138677594,5.180101567968657,1157,776,1933,+
chr5,138699447,4.1731266668695985,2139,1607,3746,+
chr5,138699448,3.7031102220463237,3967,3139,7106,+
chr5,138699450,2.883607556368068,1182,1093,2275,+
chr5,138699473,0.6069122219564698,869,677,1546,+
chr5,138699477,0.6223646723646723,1027,779,1806,+
chr5,138700335,1.945754716981132,1374,1059,2433,+
chr5,138704435,2.8814204545454545,1078,799,1877,+
chr5,138705189,0.6269675090252707,826,553,1379,+
chr5,138705218,1.702310361560329,1606,1165,2771,+
chr5,138994335,1.9722694432639187,976,723,1699,+
chr5,138994484,1.1257007221510589,1649,1178,2827,+
chr5,138994504,1.7169052296753673,591,508,1099,+
chr5,139002963,1.8115870821015627,1622,1446,3068,+
chr5,139002980,1.683338248870006,1846,1797,3643,+
chr5,139002994,2.3298315679805524,1788,1771,3559,+
chr5,139002995,2.053438037450289,3910,3662,7572,+
chr5,139006347,0.6052824651504035,1055,751,1806,+
chr5,139006710,26.193970173263395,2158,1255,3413,+
chr5,139006711,26.193970173263402,2158,1255,3413,+
chr5,139006731,8.45904780975301,2822,3737,6559,+
chr5,139006732,6.358554570711533,3385,4662,8047,+
chr5,139006733,4.624076680908289,2169,3162,5331,+
chr5,139006734,4.027159176571513,1643,2667,4310,+
chr5,139006946,2.451516479227028,829,542,1371,+
chr5,139554795,0.6866417944697133,1024,531,1555,+
chr5,139623030,3.2041156005422633,927,688,1615,+
chr5,139623084,1.60403973571595,1031,785,1816,+
chr5,139623134,0.3753623188405797,776,597,1373,+
chr5,139623177,1.8597416020671835,946,644,1590,+
chr5,139623204,1.921741383778181,617,453,1070,+
chr5,139623210,0.5268762677484787,1038,713,1751,+
chr5,139819736,2.70935960591133,899,521,1420,+
chr5,139819738,2.70935960591133,899,521,1420,+
chr5,139819778,1.9143794749403347,712,418,1130,+
chr5,139819781,2.1281791569336983,1527,1066,2593,+
chr5,139819798,1.618045112781955,1075,683,1758,+
chr5,139819799,2.837491455912509,737,417,1154,+
chr5,139819836,0.5017861926493875,2705,1860,4565,+
chr5,139819837,1.5066666666666666,1355,809,2164,+
chr5,139819842,1.7986953106321935,1815,1540,3355,+
chr5,139825371,2.077797252219144,734,768,1502,+
chr5,139825373,2.0935647445807692,1037,1016,2053,+
chr5,139825518,0.959420977693403,932,587,1519,+
chr5,139825520,0.959420977693403,932,587,1519,+
chr5,139825527,0.5449010867959948,1206,716,1922,+
chr5,139825536,1.7528663247039766,2549,1510,4059,+
chr5,139825538,1.6849039394490288,3350,2027,5377,+
chr5,139825539,0.4189599934280785,849,517,1366,+
chr5,139825540,1.5174645299581504,1516,969,2485,+
chr5,139825543,1.033822135122547,1909,1214,3123,+
chr5,139825544,1.7733248707951763,888,537,1425,+
chr5,139825551,1.4443141852286048,1343,852,2195,+
chr5,139825553,1.1274503774762417,5324,3529,8853,+
chr5,139825554,1.540046701081664,2657,1948,4605,+
chr5,139825555,0.6801796453192336,2667,1581,4248,+
chr5,139828797,1.451937775379912,1686,1010,2696,+
chr5,139876277,1.978903373469997,977,772,1749,+
chr5,139876278,1.3705326282672508,1636,1258,2894,+
chr5,139876399,4.028984249576952,1271,1212,2483,+
chr5,139876400,4.028984249576952,1271,1212,2483,+
chr5,139885317,0.474754216034799,948,408,1356,+
chr5,139944413,0.8324611783820802,762,571,1333,+
chr5,139946227,0.36923910520045883,649,453,1102,+
chr5,139947022,2.0939570633448183,1373,685,2058,+
chr5,139947023,2.1794527709512757,2266,1334,3600,+
chr5,139947024,2.07791185729276,1868,952,2820,+
chr5,139947025,1.865981543624161,1434,744,2178,+
chr5,139947037,0.5521844660194175,734,411,1145,+
chr5,139947040,1.4060495745680932,1284,822,2106,+
chr5,139947047,0.424087994858996,1050,868,1918,+
chr5,139947048,0.6854344656231409,1702,1059,2761,+
chr5,139947049,1.4704447912602416,1004,698,1702,+
chr5,139947051,1.344308112688268,2902,1672,4574,+
chr5,139947052,1.4219300909076098,4037,2473,6510,+
chr5,139947054,0.5838430406936386,1650,1261,2911,+
chr5,139947061,1.571873296590152,1425,1044,2469,+
chr5,139947067,0.7929354905082223,4442,2913,7355,+
chr5,139947071,1.5788899684717732,1749,1362,3111,+
chr5,139947076,1.7635748893304055,3911,3284,7195,+
chr5,139947078,1.7635748893304055,3911,3284,7195,+
chr5,139947079,1.317121517822378,3049,2189,5238,+
chr5,139947082,1.3826082105156086,5649,4033,9682,+
chr5,139948018,2.442664632595983,738,512,1250,+
chr5,139948019,2.442664632595983,738,512,1250,+
chr5,139948251,0.42100532445340233,886,668,1554,+
chr5,140027423,0.45606314169506457,620,468,1088,+
chr5,140031724,2.6834079761143106,718,520,1238,+
chr5,140031725,2.6834079761143106,718,520,1238,+
chr5,140032597,2.7288888888888887,613,434,1047,+
chr5,140032616,1.9013751394850908,1690,1251,2941,+
chr5,140033573,2.225350453132068,1171,746,1917,+
chr5,140033588,2.1942626635537383,718,460,1178,+
chr5,140033590,2.988704611062848,1040,731,1771,+
chr5,140034297,1.792792792792793,596,443,1039,+
chr5,140037173,2.393916349809886,786,525,1311,+
chr5,140037174,1.7906708315950204,1097,773,1870,+
chr5,140037222,0.4669008875739645,1009,675,1684,+
chr5,140037223,0.4669008875739645,1009,675,1684,+
chr5,140038336,1.8666666666666667,689,413,1102,+
chr5,140038563,1.8846701253385973,1641,946,2587,+
chr5,140038588,1.5842159728773872,4814,2865,7679,+
chr5,140038590,1.5943488391753344,4150,2394,6544,+
chr5,140038608,1.9002676601691808,5102,3256,8358,+
chr5,140038610,2.404074702886248,3539,2386,5925,+
chr5,140038706,0.38033036832567163,657,397,1054,+
chr5,140039704,2.0942054595921067,890,662,1552,+
chr5,140041506,1.9151972274671973,956,634,1590,+
chr5,140080488,1.8689345314505776,632,409,1041,+
chr5,140081620,1.867389060887513,657,407,1064,+
chr5,140083503,2.661063524709821,1208,743,1951,+
chr5,140083543,2.037106524911403,1046,701,1747,+
chr5,140083553,2.125054422452192,1093,806,1899,+
chr5,140083566,1.556938451056098,901,594,1495,+
chr5,140083569,1.8165812639600576,1337,1061,2398,+
chr5,140084013,1.7950481430536451,1246,726,1972,+
chr5,140084016,1.67512077294686,1386,827,2213,+
chr5,140084048,1.9802027543993879,1639,1306,2945,+
chr5,140085461,10.363393814299416,1527,191,1718,+
chr5,140085462,8.257525320527884,2554,327,2881,+
chr5,140085463,9.35868754660701,1254,148,1402,+
chr5,140085464,6.395922243233636,3940,536,4476,+
chr5,140085465,6.416703970529127,2164,307,2471,+
chr5,140085466,6.158308072552925,2432,328,2760,+
chr5,140085470,11.372127215406882,936,122,1058,+
chr5,140085474,50.838948342379595,1684,959,2643,+
chr5,140085475,24.9854649279447,3847,3147,6994,+
chr5,140085476,24.9854649279447,3847,3147,6994,+
chr5,140085477,22.653963957268626,3361,3089,6450,+
chr5,141511428,2.438958707360862,740,556,1296,+
chr5,141511430,2.438958707360862,740,556,1296,+
chr5,141515316,2.4701025337783244,1214,821,2035,+
chr5,141517363,2.46594982078853,1375,863,2238,+
chr5,141517402,1.6987656449247714,3354,2003,5357,+
chr5,141517406,1.621167484997272,1172,704,1876,+
chr5,141520179,1.7812100668101187,4232,2768,7000,+
chr5,141520186,2.33934025656689,8879,6547,15426,+
chr5,141520187,2.33934025656689,8879,6547,15426,+
chr5,141520188,2.33934025656689,8879,6547,15426,+
chr5,141531340,2.2284675615212524,612,446,1058,+
chr5,141531372,1.6153628022762012,1342,1091,2433,+
chr5,141531520,1.6158199356913183,738,621,1359,+
chr5,141531821,1.328485410644009,2563,1906,4469,+
chr5,141531841,2.224861765308212,775,513,1288,+
chr5,141531900,3.8058305830583055,628,403,1031,+
chr5,145609421,2.589660301241218,734,335,1069,+
chr5,145609429,3.0743828236976825,744,355,1099,+
chr5,145849142,2.0289888682745825,672,391,1063,+
chr5,145849143,1.813859275053305,904,669,1573,+
chr5,145849146,0.645206670759157,1008,723,1731,+
chr5,145849159,1.4741103896103895,2440,1374,3814,+
chr5,145849161,1.4741103896103895,2440,1374,3814,+
chr5,145849162,1.4412413052635253,2719,1817,4536,+
chr5,145849165,1.9912102772143336,3039,1855,4894,+
chr5,145849167,1.8749951765994164,4423,2693,7116,+
chr5,145849177,1.636559600645421,1730,1071,2801,+
chr5,145849185,2.121326164874552,1994,1349,3343,+
chr5,145849258,1.8109336552915287,1960,1293,3253,+
chr5,145849266,1.9998619858124305,3311,2409,5720,+
chr5,145849270,1.4800713053029444,3106,2436,5542,+
chr5,145882940,2.3176926220471494,776,549,1325,+
chr5,145883014,2.1596091205211727,935,613,1548,+
chr5,145883016,2.1596091205211727,935,613,1548,+
chr5,145883079,2.7981288981288985,1251,739,1990,+
chr5,145883091,2.1559670781893003,844,449,1293,+
chr5,145883093,2.138727560718057,1472,946,2418,+
chr5,145883397,1.7334607809060365,1300,821,2121,+
chr5,145883403,1.5364049145299143,1402,719,2121,+
chr5,145883431,1.308065038790721,2227,1304,3531,+
chr5,145883454,2.5492786486575305,2705,2253,4958,+
chr5,145883462,0.23144342359767892,1640,1127,2767,+
chr5,145888780,2.3424962736233805,1865,1339,3204,+
chr5,145890233,2.4254841119915755,634,403,1037,+
chr5,147796695,2.0625,758,367,1125,+
chr5,147796696,2.0625,758,367,1125,+
chr5,147796711,2.357600465928946,1103,605,1708,+
chr5,147796713,2.357600465928946,1103,605,1708,+
chr5,147796719,1.5121252204585538,721,431,1152,+
chr5,147796720,1.9866412213740459,693,392,1085,+
chr5,147796727,1.7054794520547945,746,437,1183,+
chr5,147796735,1.8655973522174245,2159,1348,3507,+
chr5,147796741,2.118866459627329,826,559,1385,+
chr5,148733721,1.8935714285714287,722,399,1121,+
chr5,149473876,0.6357531698727921,1037,696,1733,+
chr5,149740736,1.091108091183381,632,429,1061,+
chr5,149743710,1.616750310290864,1283,782,2065,+
chr5,149743711,1.616750310290864,1283,782,2065,+
chr5,149743720,1.6186312737513864,1187,922,2109,+
chr5,149743726,2.65698500394633,1051,904,1955,+
chr5,149743730,1.5737817688521742,3200,2729,5929,+
chr5,149743731,1.5424042514201943,2305,2139,4444,+
chr5,149755810,2.0462962962962963,1364,1439,2803,+
chr5,149755811,2.0462962962962963,1364,1439,2803,+
chr5,149755812,2.0462962962962963,1364,1439,2803,+
chr5,151151565,1.496047358180343,827,552,1379,+
chr5,151151567,1.2161716171617163,669,403,1072,+
chr5,151166254,0.39217367360839384,705,525,1230,+
chr5,151170472,2.0354240937217236,1018,704,1722,+
chr5,151170529,2.095501912676428,610,398,1008,+
chr5,151170531,0.2737658617784387,753,594,1347,+
chr5,151170572,0.532345955009082,634,420,1054,+
chr5,151173794,0.5181863477827603,649,445,1094,+
chr5,151180361,6.71626984126984,676,419,1095,+
chr5,151183573,5.171661062864581,872,596,1468,+
chr5,151184502,1.911544227886057,662,376,1038,+
chr5,151184541,0.6015789031662047,753,566,1319,+
chr5,151189855,1.209045792872376,775,501,1276,+
chr5,153826309,1.9982715177156676,652,456,1108,+
chr5,153835495,1.0343177082276174,1080,1046,2126,+
chr5,153835496,0.5764055023923444,770,835,1605,+
chr5,153835523,2.6052631578947367,521,550,1071,+
chr5,154174859,0.2591036414565826,1109,509,1618,+
chr5,154174860,0.2591036414565826,1109,509,1618,+
chr5,154174861,0.2591036414565826,1109,509,1618,+
chr5,154174864,2.236275257338925,1187,687,1874,+
chr5,154174865,1.7791869873765471,2031,1150,3181,+
chr5,154174866,2.27043636249349,2183,1229,3412,+
chr5,154174868,2.1429814945664876,1519,911,2430,+
chr5,154193717,6.949017998948672,611,571,1182,+
chr5,154193719,6.977645131974905,722,672,1394,+
chr5,154193740,4.339787190234014,488,710,1198,+
chr5,154194318,0.8385787010920929,890,618,1508,+
chr5,154194320,1.6347782400254267,768,476,1244,+
chr5,154195236,10.947745148020251,910,544,1454,+
chr5,154195237,10.947745148020251,910,544,1454,+
chr5,154195238,10.947745148020251,910,544,1454,+
chr5,154196292,2.315448912306282,864,617,1481,+
chr5,154196701,4.14197638728344,936,658,1594,+
chr5,154251391,1.4362235116201487,953,744,1697,+
chr5,154251394,2.084558823529412,620,390,1010,+
chr5,154251400,0.5707317073170732,701,419,1120,+
chr5,154251401,0.5269876290284454,703,517,1220,+
chr5,154252105,1.699225473321859,1076,663,1739,+
chr5,154255692,0.5114300903774588,591,455,1046,+
chr5,154335973,2.3492242242242245,750,443,1193,+
chr5,154335990,1.6667429268664684,682,422,1104,+
chr5,154346276,2.22607688713335,1444,911,2355,+
chr5,154346278,2.1943102522812667,1021,620,1641,+
chr5,158699077,0.6043233082706766,642,607,1249,+
chr5,158699080,1.8556204619361223,1878,1509,3387,+
chr5,158699082,2.1895084738482042,1574,1143,2717,+
chr5,159437777,2.871856607811664,1129,711,1840,+
chr5,159437778,2.871856607811664,1129,711,1840,+
chr5,159437795,2.715480274442539,744,582,1326,+
chr5,159437799,1.8392658392658392,1287,1220,2507,+
chr5,159463714,2.9721808414960518,711,504,1215,+
chr5,159476529,2.3443727598566317,583,464,1047,+
chr5,159848868,2.8463991997322036,738,479,1217,+
chr5,159848875,1.6224443363264378,1137,719,1856,+
chr5,159848876,2.067752771246221,866,457,1323,+
chr5,159848884,0.6453611321483688,2590,1815,4405,+
chr5,159848885,0.747229745046996,2098,1722,3820,+
chr5,159848886,0.7582084398441007,4920,3297,8217,+
chr5,159848888,0.9805201126619268,3434,1830,5264,+
chr5,159848889,1.605299961419753,2662,1439,4101,+
chr5,159848890,1.605299961419753,2662,1439,4101,+
chr5,159849310,1.4896965349552764,2431,1493,3924,+
chr5,159849329,1.996196471899797,1521,896,2417,+
chr5,159849348,1.5258896949502188,2505,2101,4606,+
chr5,159854789,1.5980392156862744,977,683,1660,+
chr5,159854790,1.4439146597704864,1050,806,1856,+
chr5,162868316,1.8880167451596024,655,363,1018,+
chr5,162870965,0.6059187600769751,931,662,1593,+
chr5,162871403,2.546196305150322,922,727,1649,+
chr5,162871775,2.1259505885108156,933,691,1624,+
chr5,162871804,1.9035714285714285,1039,699,1738,+
chr5,162898427,5.018478260869566,683,367,1050,+
chr5,162898429,5.018478260869566,683,367,1050,+
chr5,162910288,1.259393516904845,646,475,1121,+
chr5,162918153,1.7271500297620823,715,556,1271,+
chr5,162932705,5.44067404749355,735,2290,3025,+
chr5,162932706,5.372917274950742,635,2084,2719,+
chr5,162932707,2.3009487666034154,300,1084,1384,+
chr5,162932715,0.1769677371940912,343,1236,1579,+
chr5,162932716,0.2630643441166014,369,1260,1629,+
chr5,162932717,0.2630643441166014,369,1260,1629,+
chr5,162932718,0.31660485670902944,537,1532,2069,+
chr5,162932720,0.3135872516591863,478,1317,1795,+
chr5,162939159,0.5349264705882353,581,509,1090,+
chr5,162940598,2.164874551971326,603,464,1067,+
chr5,162940655,0.547319609358533,819,661,1480,+
chr5,162940865,2.60355961568751,1159,906,2065,+
chr5,162940871,1.544685790061421,2921,2394,5315,+
chr5,162943564,1.8603174603174604,585,419,1004,+
chr5,162945310,2.9888215233042823,630,376,1006,+
chr5,162945646,2.2859375,615,511,1126,+
chr5,162945790,3.0881037959147895,926,670,1596,+
chr5,162946026,2.9454853591940493,868,558,1426,+
chr5,162946027,2.9454853591940493,868,558,1426,+
chr5,165809560,0.7443192234553084,829,503,1332,+
chr5,165809561,0.7443192234553084,829,503,1332,+
chr5,167798432,2.5644101754038195,885,1091,1976,+
chr5,167798433,2.2682649842271294,748,950,1698,+
chr5,167798434,2.2682649842271294,748,950,1698,+
chr5,167881043,17.6825951584466,528,774,1302,+
chr5,167881044,13.733775871626106,726,1014,1740,+
chr5,167896020,0.44930420718464614,710,506,1216,+
chr5,167896223,1.7183585313174945,611,462,1073,+
chr5,167915617,1.9611452063803074,714,430,1144,+
chr5,167915646,1.5677670290216417,785,541,1326,+
chr5,167915715,2.3433133732534928,586,500,1086,+
chr5,167920917,2.2176501035196687,778,503,1281,+
chr5,167922398,1.9259259259259263,683,485,1168,+
chr5,167924261,1.335071542281699,979,803,1782,+
chr5,167924301,1.7689793866264454,680,441,1121,+
chr5,167924304,1.921583850931677,824,559,1383,+
chr5,167927707,1.747345132743363,717,451,1168,+
chr5,167933775,2.1471303501945527,653,513,1166,+
chr5,167933784,0.5670415224913495,797,577,1374,+
chr5,167933788,0.5781981644502716,685,561,1246,+
chr5,167937677,2.1370281724117532,1263,948,2211,+
chr5,167943839,1.7573389700750572,1314,930,2244,+
chr5,167943906,3.0681818181818183,701,571,1272,+
chr5,167944849,2.7678888231815493,850,533,1383,+
chr5,167945021,0.3833053221288515,621,509,1130,+
chr5,167946088,2.3211084905660377,728,423,1151,+
chr5,169021408,2.090480548377835,631,401,1032,+
chr5,169021414,2.053354399611084,544,483,1027,+
chr5,169021420,0.6023340248962655,552,481,1033,+
chr5,169021429,1.8359902340945002,751,632,1383,+
chr5,169021430,1.1646586345381524,695,497,1192,+
chr5,169021431,1.1646586345381524,695,497,1192,+
chr5,169021434,0.5464388625316529,893,730,1623,+
chr5,169021458,1.4457013853258085,2462,1948,4410,+
chr5,169021459,1.6047099248108827,4045,3064,7109,+
chr5,169021464,2.60941475826972,585,523,1108,+
chr5,170814852,0.9451451517398954,6015,4225,10240,+
chr5,170814853,0.9809823334908143,7581,5535,13116,+
chr5,170814854,1.0426229940021503,6579,5307,11886,+
chr5,170814855,1.4209304766891535,6253,5172,11425,+
chr5,170814856,1.383562127129617,3240,2648,5888,+
chr5,170814857,1.4118043948254066,4267,3123,7390,+
chr5,170814861,1.3311024894924022,3166,2061,5227,+
chr5,170814863,1.2925969831600794,5610,3505,9115,+
chr5,170814864,0.7495010948886474,3536,3162,6698,+
chr5,170814882,1.5304584437636353,5835,5285,11120,+
chr5,170814883,1.2572388362593805,3732,2692,6424,+
chr5,170814891,1.2446667617514615,3301,2886,6187,+
chr5,170814900,1.135033108869938,5693,4198,9891,+
chr5,170814995,1.272113935969868,5162,2949,8111,+
chr5,170817058,1.365720319581666,29068,20121,49189,+
chr5,170817060,1.4018569210821474,35182,23054,58236,+
chr5,170817061,1.419365198741638,29475,19787,49262,+
chr5,170817063,1.4866052295139072,10585,7493,18078,+
chr5,170817125,1.3902887635905343,7460,5595,13055,+
chr5,170827162,1.6121037172085486,8376,6581,14957,+
chr5,170827174,1.4747117963838894,6289,4459,10748,+
chr5,170827192,1.2622745486470668,8102,5844,13946,+
chr5,170832402,1.3673341727626176,19340,11747,31087,+
chr5,170833523,1.815920024565833,2830,1854,4684,+
chr5,170837537,1.2710215365007564,9285,5501,14786,+
chr5,170837710,0.6596305257114738,1738,1095,2833,+
chr5,170837711,1.335155612013429,2486,1235,3721,+
chr5,170837726,1.2929741264337158,3245,1724,4969,+
chr5,172261382,1.8805012224938873,878,408,1286,+
chr5,172261423,1.194470550314827,686,542,1228,+
chr5,172315709,3.0541320822807654,818,488,1306,+
chr5,172315759,0.4481668096054889,928,703,1631,+
chr5,172315760,1.0325877471249614,1641,1373,3014,+
chr5,172324058,0.5741472697994437,3921,2888,6809,+
chr5,172324059,0.5953470931227269,6726,4877,11603,+
chr5,172324060,0.6046127146510779,5366,3909,9275,+
chr5,172324061,0.5961479986545577,4140,2972,7112,+
chr5,172324073,1.7386186602042584,1781,1198,2979,+
chr5,172336715,0.9681497119920768,3127,2087,5214,+
chr5,172336716,1.3016285394925897,4738,3193,7931,+
chr5,172336726,0.7118156664835905,1990,1141,3131,+
chr5,172336739,1.7489258565605375,1904,1251,3155,+
chr5,172336753,2.582305953278071,1946,1326,3272,+
chr5,172341772,1.632691234560415,1487,1254,2741,+
chr5,172341794,0.5228764502143531,1027,778,1805,+
chr5,172351043,3.694351145038168,980,654,1634,+
chr5,172351063,0.639978578122908,955,678,1633,+
chr5,172353524,1.9842195540308747,722,582,1304,+
chr5,172362236,1.1637891162689793,1447,1190,2637,+
chr5,172362298,1.495483870967742,1158,774,1932,+
chr5,172377789,0.5487583282858873,905,507,1412,+
chr5,172377808,1.7740949119373777,966,510,1476,+
chr5,172377907,0.5250311332503113,1053,656,1709,+
chr5,172377947,13.549727181419088,4988,3561,8549,+
chr5,172377948,10.46440064691522,3709,2575,6284,+
chr5,172377968,2.1592248062015504,732,644,1376,+
chr5,172378095,2.0739779840554804,3556,2438,5994,+
chr5,172378098,7.059046108842702,7404,6552,13956,+
chr5,172378099,7.376976545569714,9614,8007,17621,+
chr5,172378100,7.376976545569713,9614,8007,17621,+
chr5,172378139,0.6203602767522906,2225,1826,4051,+
chr5,172378146,0.5605639319392868,1691,1664,3355,+
chr5,172378307,1.799587912087912,793,559,1352,+
chr5,172378309,1.5760148822115934,1690,1310,3000,+
chr5,172378417,1.5750000000000004,881,649,1530,+
chr5,172378431,0.48683784658539214,949,712,1661,+
chr5,172378437,1.9808823807778373,2447,1690,4137,+
chr5,172378463,1.587707656163061,2473,1794,4267,+
chr5,172378535,1.4581135061802832,2344,1487,3831,+
chr5,172378537,1.4581135061802832,2344,1487,3831,+
chr5,172378642,0.7118182396741551,1363,826,2189,+
chr5,172378663,0.739465180577849,2942,1831,4773,+
chr5,172378695,3.2539405554605385,7907,4972,12879,+
chr5,172378696,2.449037479812137,4456,2614,7070,+
chr5,172378705,1.401157335001564,1580,1111,2691,+
chr5,172378776,1.8192431396395732,2546,1890,4436,+
chr5,172379008,2.0678440084954173,720,582,1302,+
chr5,172379044,2.0477624013040976,1390,924,2314,+
chr5,172379055,0.4899397855779117,833,618,1451,+
chr5,172379058,0.5824508320726173,923,660,1583,+
chr5,172379072,1.6785595751742448,594,523,1117,+
chr5,172379089,0.5709728867623605,715,626,1341,+
chr5,172379106,1.5568898367952522,818,673,1491,+
chr5,172379151,0.7423565750164565,1903,1361,3264,+
chr5,172379458,18.064253322974754,1736,130,1866,+
chr5,172379459,20.12284730195178,2061,133,2194,+
chr5,172379460,44.722481231213465,2840,372,3212,+
chr5,172379461,51.011867372284364,6568,875,7443,+
chr5,172379462,53.18943958273601,5886,836,6722,+
chr5,172379463,36.49011829418694,4032,680,4712,+
chr5,172379465,43.24558055452807,3960,2280,6240,+
chr5,172379466,18.39557513405716,6911,6474,13385,+
chr5,172379467,18.39557513405716,6911,6474,13385,+
chr5,172379468,18.168565736678204,5925,6258,12183,+
chr5,172379472,3.528169014084507,667,567,1234,+
chr5,172379524,0.32749219488861386,414,693,1107,+
chr5,172379525,0.5641538075211867,635,830,1465,+
chr5,172379526,0.5204340798891711,643,487,1130,+
chr5,172379528,0.5204340798891711,643,487,1130,+
chr5,172379531,0.6261227072937025,1858,1392,3250,+
chr5,172379532,0.6261227072937025,1858,1392,3250,+
chr5,172379561,1.210188715770753,1895,1514,3409,+
chr5,172379562,1.008523863182,1046,901,1947,+
chr5,172386882,2.4593241551939924,654,375,1029,+
chr5,172386883,2.4593241551939924,654,375,1029,+
chr5,172386909,1.0690349081762993,1141,789,1930,+
chr5,172387036,1.416165500521524,711,498,1209,+
chr5,172395476,1.4853460554008333,632,481,1113,+
chr5,172395534,1.7212740981756196,2112,1454,3566,+
chr5,172395557,2.9163314561544653,579,451,1030,+
chr5,172395569,2.4022230568911103,1438,1070,2508,+
chr5,172396450,0.5601039636127355,861,683,1544,+
chr5,172396607,2.533190578158458,727,466,1193,+
chr5,172396608,2.533190578158458,727,466,1193,+
chr5,172410860,3.316153142649507,772,612,1384,+
chr5,172421777,2.3131868131868134,841,727,1568,+
chr5,172421778,1.6985444555429525,1750,1461,3211,+
chr5,172421781,0.4640030882069099,600,470,1070,+
chr5,172447316,0.48313308687615525,737,540,1277,+
chr5,172461424,0.6518105849582173,845,717,1562,+
chr5,172461431,3.0044709388971684,587,426,1013,+
chr5,172461580,2.817110655737705,610,487,1097,+
chr5,172461714,1.9818404907975464,672,488,1160,+
chr5,172461721,2.061630760839924,755,578,1333,+
chr5,172461730,0.6603666245259164,1347,903,2250,+
chr5,172461731,1.396987275449102,1658,1335,2993,+
chr5,172461745,0.744880666572518,1917,1459,3376,+
chr5,173386082,1.4081944469287864,753,416,1169,+
chr5,174939126,2.8878524358558972,698,519,1217,+
chr5,174949418,1.8764173674761413,1512,1113,2625,+
chr5,174949419,1.4699781123658808,2325,1586,3911,+
chr5,174955181,2.5670593890043394,869,559,1428,+
chr5,174955182,2.5670593890043394,869,559,1428,+
chr5,175815757,1.4501652682430712,670,683,1353,+
chr5,175815758,1.4501652682430712,670,683,1353,+
chr5,175815759,1.0873321750118463,942,973,1915,+
chr5,175815761,0.7782874617737003,508,544,1052,+
chr5,175815825,2.2422519309102245,1202,796,1998,+
chr5,175815926,2.4285714285714284,577,475,1052,+
chr5,175816421,1.628017079593986,805,623,1428,+
chr5,175816531,0.6544655929721815,893,682,1575,+
chr5,175816621,2.149122807017544,587,455,1042,+
chr5,176730867,2.635902031063321,705,371,1076,+
chr5,176730869,2.635902031063321,705,371,1076,+
chr5,176730947,1.437535343618616,690,574,1264,+
chr5,176730948,1.7992978635838528,586,495,1081,+
chr5,176730983,1.5530310106955718,762,521,1283,+
chr5,176730988,1.2697339965397922,670,577,1247,+
chr5,176730990,1.2697339965397922,670,577,1247,+
chr5,176731701,1.9260204081632653,754,391,1145,+
chr5,176731713,2.8905742145178768,666,496,1162,+
chr5,176731735,1.8916155419222904,1199,651,1850,+
chr5,176731738,1.4367322443315016,1343,750,2093,+
chr5,176732879,1.9444444444444444,545,467,1012,+
chr5,176732882,2.3626760563380285,670,354,1024,+
chr5,176732888,0.5515644955300127,690,521,1211,+
chr5,176732901,1.5431834929992634,973,589,1562,+
chr5,176733119,1.7523809523809522,689,524,1213,+
chr5,176733538,2.1214193640430854,1509,844,2353,+
chr5,176733539,1.775188562422605,1212,657,1869,+
chr5,176733551,2.8404842968700774,1231,848,2079,+
chr5,176733554,2.1241464587031964,1285,912,2197,+
chr5,177019203,0.9112387923686707,755,316,1071,+
chr5,177019207,2.740036151626492,1112,527,1639,+
chr5,177019208,2.604411764705882,692,339,1031,+
chr5,177019212,1.981136701945692,1404,587,1991,+
chr5,177019213,2.1852693416094,916,346,1262,+
chr5,177019240,2.7278911564625847,801,391,1192,+
chr5,177019268,2.469346733668341,818,397,1215,+
chr5,177019274,1.911184210526316,580,436,1016,+
chr5,177019277,1.3954248135854974,1639,995,2634,+
chr5,177019297,3.306073153899241,870,413,1283,+
chr5,177019300,2.148833616546694,2431,1491,3922,+
chr5,177019317,1.492523073387282,4722,3241,7963,+
chr5,177019318,1.492523073387282,4722,3241,7963,+
chr5,177019319,1.492523073387282,4722,3241,7963,+
chr5,177019320,2.10375,1121,599,1720,+
chr5,177019330,1.6550037459175637,3874,2634,6508,+
chr5,177019372,1.6507965693979807,2055,1623,3678,+
chr5,177019643,1.6977402925740765,1200,971,2171,+
chr5,177019644,1.8056818181818184,680,527,1207,+
chr5,177019653,1.774580335731415,739,416,1155,+
chr5,177020689,1.5726966636057547,733,604,1337,+
chr5,177020702,0.6414061469463133,1166,721,1887,+
chr5,177020726,0.7390334127890023,2330,1590,3920,+
chr5,177021158,1.5566832530342525,1764,1150,2914,+
chr5,177021165,1.4443712004687614,1971,1331,3302,+
chr5,177021167,1.690786131572263,1745,1015,2760,+
chr5,177021168,1.0024854654570383,3980,2880,6860,+
chr5,177021179,1.3659606291573791,4845,3119,7964,+
chr5,177021186,1.3659195401547046,5055,3669,8724,+
chr5,177021188,1.3163096569456791,2673,1621,4294,+
chr5,177021200,0.7784070629591968,3123,1821,4944,+
chr5,177021205,1.4154656392826535,7951,5199,13150,+
chr5,177021263,1.6114643150123054,2244,1655,3899,+
chr5,177021272,1.1710932588234326,5979,4448,10427,+
chr5,177022330,2.0257273706896552,556,463,1019,+
chr5,177022337,2.0484848484848484,584,494,1078,+
chr5,177022392,3.294979079497908,818,477,1295,+
chr5,177022402,1.6575466443887497,820,512,1332,+
chr5,177022403,0.5031055900621119,845,643,1488,+
chr5,177022456,1.8213245997088792,714,457,1171,+
chr5,177022565,1.7356486210418791,707,444,1151,+
chr5,177022568,1.9122739515198155,709,451,1160,+
chr5,177022577,3.704638218923933,767,489,1256,+
chr5,177022580,1.6313840564521767,933,733,1666,+
chr5,177022600,0.507533703409992,599,484,1083,+
chr5,177022639,0.5621352140077821,602,513,1115,+
chr5,177022733,5.782297317575082,2426,436,2862,+
chr5,177022734,6.276592852584557,2744,390,3134,+
chr5,177022735,5.231030626262626,2855,520,3375,+
chr5,177022736,6.743863669315998,3813,585,4398,+
chr5,177022738,15.366761578066079,7523,6082,13605,+
chr5,177022739,10.65581450654624,7747,8640,16387,+
chr5,177022740,10.65581450654624,7747,8640,16387,+
chr5,177022741,8.325826622298159,4659,6436,11095,+
chr5,177022747,5.798772176390611,2220,4698,6918,+
chr5,177022752,0.5861108929378117,1317,2148,3465,+
chr5,177022778,0.4021686357015698,709,1335,2044,+
chr5,177022816,1.5064560727131677,1221,1345,2566,+
chr5,177022817,0.382861528737189,847,962,1809,+
chr5,177022902,6.480842351564785,1230,262,1492,+
chr5,177022903,4.015160870365625,2240,658,2898,+
chr5,177022904,5.650700017524561,2850,684,3534,+
chr5,177022906,4.8395883137198945,4737,1175,5912,+
chr5,177022907,25.15984037729004,2366,744,3110,+
chr5,177022908,17.771588065066076,7735,4438,12173,+
chr5,177022909,16.883203597359476,9298,8123,17421,+
chr5,177022910,17.023782257777135,8712,8005,16717,+
chr5,177022911,17.583775740456133,6945,7541,14486,+
chr5,177022923,1.6772128060263654,1167,2159,3326,+
chr5,177022924,2.309683045960507,3156,4955,8111,+
chr5,177022980,0.5169342288475715,934,841,1775,+
chr5,177022981,0.5172222222222222,797,959,1756,+
chr5,177022999,0.4888888888888889,769,734,1503,+
chr5,177023030,7.179511602329561,1905,1562,3467,+
chr5,177631532,0.8494555298074359,893,402,1295,+
chr5,177631533,0.8347978720344025,1248,617,1865,+
chr5,177631538,1.6983416252072967,930,401,1331,+
chr5,177631956,1.5877322267496237,808,423,1231,+
chr5,177631980,2.018646616541353,838,759,1597,+
chr5,177631982,2.018646616541353,838,759,1597,+
chr5,177631992,1.4317135874567557,570,642,1212,+
chr5,177632018,1.7472887767969736,865,609,1474,+
chr5,177632842,1.0397638197719163,2181,1421,3602,+
chr5,177632843,1.9238364866731115,752,556,1308,+
chr5,177632844,0.7359670781893004,1314,809,2123,+
chr5,177632846,1.6587869899059615,1767,1383,3150,+
chr5,177632847,1.7074487274418182,5119,3512,8631,+
chr5,177632892,1.4499622591732195,3440,2236,5676,+
chr5,177632907,0.5235880897022426,2147,1193,3340,+
chr5,177632927,1.844937452484622,2751,1589,4340,+
chr5,177632931,0.6763792808428463,5533,3718,9251,+
chr5,177632934,1.0797068387461142,13165,8064,21229,+
chr5,177632937,1.46773484840412,7759,4639,12398,+
chr5,177633771,1.5643021595735072,6730,5269,11999,+
chr5,177633772,1.6058884214772011,12809,9651,22460,+
chr5,177633773,1.725569480746748,4029,3122,7151,+
chr5,177633777,1.3506437381831276,4687,3063,7750,+
chr5,177633778,0.7371350975729486,8585,6809,15394,+
chr5,177633779,0.9772135336689488,21582,16065,37647,+
chr5,177633780,1.3962807495120086,7757,5632,13389,+
chr5,177633781,0.7066253928978365,10129,7821,17950,+
chr5,177633795,1.746767051443001,3325,2698,6023,+
chr5,177633823,1.5183105894435531,18961,15390,34351,+
chr5,177636376,1.7615131578947367,594,455,1049,+
chr5,177636438,5.426304661623219,1890,535,2425,+
chr5,177636440,5.0622291930123575,2215,642,2857,+
chr5,177637132,12.168306596524253,3614,3252,6866,+
chr5,177637133,12.168306596524257,3614,3252,6866,+
chr5,177637134,10.848525469947793,2996,2522,5518,+
chr5,177637227,1.247594273854026,1006,759,1765,+
chr5,177637267,3.448325221872316,802,498,1300,+
chr5,177637554,6.742544186708215,2770,2117,4887,+
chr5,177637560,3.0580189779842386,4249,3939,8188,+
chr5,177637561,2.8785104383296005,2628,2731,5359,+
chr5,177637564,1.630327868852459,584,609,1193,+
chr5,177637567,0.5773290802065179,797,646,1443,+
chr5,177637601,0.6152197213290461,901,932,1833,+
chr5,177637606,1.5874202551834131,1224,835,2059,+
chr5,177637696,0.568070266081116,1465,1077,2542,+
chr5,177637719,1.7864064869141012,1593,1378,2971,+
chr5,177637762,1.612957937584803,950,736,1686,+
chr5,177637908,1.3274869725069907,3327,2369,5696,+
chr5,177637943,1.766071428571429,643,559,1202,+
chr5,177637954,1.852126682986536,780,687,1467,+
chr5,179125986,0.5286343016806593,651,399,1050,+
chr5,179125987,0.6499166248334435,985,506,1491,+
chr5,179126010,1.8318460941556582,1014,461,1475,+
chr5,179126022,0.4822857142857142,843,279,1122,+
chr5,179126026,0.5297906602254429,986,298,1284,+
chr5,179126027,0.7315754500422859,2741,1067,3808,+
chr5,179126028,0.7315754500422859,2741,1067,3808,+
chr5,179126029,0.7315754500422859,2741,1067,3808,+
chr5,179126060,4.627138051338417,7495,2844,10339,+
chr5,179126061,9.193858433821065,8820,4172,12992,+
chr5,179126062,9.1668675527362,13030,5627,18657,+
chr5,179126063,9.82917730456468,10442,4734,15176,+
chr5,179126067,10.370741482965933,1609,997,2606,+
chr5,179126068,15.446129673577422,5343,3137,8480,+
chr5,179126069,16.290093377035422,4403,2328,6731,+
chr5,179126074,11.091671736606182,3912,2516,6428,+
chr5,179126075,18.04001363989672,6291,4728,11019,+
chr5,179132723,0.4093233494658022,814,931,1745,+
chr5,179132847,2.0562219976166096,2202,1732,3934,+
chr5,179136971,2.065097767538527,12967,7767,20734,+
chr5,179136972,2.0892258807217243,17528,10698,28226,+
chr5,179136973,2.0892258807217243,17528,10698,28226,+
chr5,179136974,2.1530589796541126,13335,8288,21623,+
chr5,179143154,1.679506474253654,5045,3551,8596,+
chr5,179143163,1.2432110594605397,9990,6881,16871,+
chr5,179143187,1.3380158940563498,20010,15317,35327,+
chr5,179143188,1.49682569230952,15044,11799,26843,+
chr5,179143246,1.4624765478424016,1558,1065,2623,+
chr5,179143250,2.5118048949234635,1095,745,1840,+
chr5,179143265,1.4394651099440956,2950,1874,4824,+
chr5,179143271,1.8408941485864565,1249,844,2093,+
chr5,179146728,1.7803180914512922,1193,1005,2198,+
chr5,179147422,1.9343434343434345,765,629,1394,+
chr5,179147502,0.5556467548259614,961,644,1605,+
chr5,179147522,1.4108156401093126,1364,851,2215,+
chr5,179149812,1.614707903780069,690,581,1271,+
chr5,179149993,1.7922571724853091,609,525,1134,+
chr5,179150722,1.951896787441706,2410,1774,4184,+
chr5,179150745,1.8549355566940986,2036,1704,3740,+
chr5,179150752,3.1519612230706207,2630,2380,5010,+
chr5,179150754,2.6738588277938176,6470,5799,12269,+
chr5,179150755,3.198949723200651,4035,3936,7971,+
chr5,179150757,2.5661032689450223,2708,2691,5399,+
chr5,179150760,2.0069038340985212,3005,2903,5908,+
chr5,179151677,2.221002386634845,1550,1675,3225,+
chr5,179151681,1.4983528482913657,5072,5250,10322,+
chr5,179151682,1.5315120525931338,3527,4106,7633,+
chr5,179151763,2.0686666666666667,1604,999,2603,+
chr5,179151770,3.00280595734988,4264,2931,7195,+
chr5,179151778,1.6993706293706294,1278,974,2252,+
chr5,179153689,1.4930102516309414,2051,1405,3456,+
chr5,179153707,1.4674584836723312,2552,1792,4344,+
chr5,179153742,1.9375120076849182,2261,2081,4342,+
chr5,179156378,2.417345073932547,581,462,1043,+
chr5,179156389,1.0971919049538024,2275,1529,3804,+
chr5,179156438,1.654559462880414,858,672,1530,+
chr5,179156443,1.8288135593220336,663,471,1134,+
chr5,179156489,2.877551020408163,704,538,1242,+
chr5,179156584,1.843936838877817,775,592,1367,+
chr5,179157456,0.4699876237623762,1084,807,1891,+
chr5,179157458,1.4363804558069126,1707,1033,2740,+
chr5,179203022,1.14414104850301,713,440,1153,+
chr5,179203065,2.1560395240976007,1090,854,1944,+
chr5,179203067,2.1560395240976007,1090,854,1944,+
chr5,179247903,0.9197617972454276,638,411,1049,+
chr5,179247904,0.8148223917253062,1682,1174,2856,+
chr5,179247991,0.9472355465791468,937,465,1402,+
chr5,179247992,2.2625048263673975,1587,1003,2590,+
chr5,179249993,0.5302952576379388,808,730,1538,+
chr5,179249994,0.5388961620616,868,630,1498,+
chr5,179250858,0.2418710021321961,604,468,1072,+
chr5,179250916,1.8755118755118756,686,332,1018,+
chr5,179250920,2.261437908496732,691,356,1047,+
chr5,179250926,1.8275896119285078,660,532,1192,+
chr5,179250932,1.9082948634869497,1112,875,1987,+
chr5,179251184,1.7810549798285473,1029,702,1731,+
chr5,179252167,0.6137286375224247,779,622,1401,+
chr5,179252172,1.597674688228306,1333,1014,2347,+
chr5,179252184,1.7398298938484869,732,522,1254,+
chr5,179260035,1.6451711181070374,1349,915,2264,+
chr5,179260041,2.2471428571428573,857,599,1456,+
chr5,179260123,1.7667021369839329,2181,1530,3711,+
chr5,179260600,2.667304015296367,836,522,1358,+
chr5,179260607,1.3828615363451258,1347,1080,2427,+
chr5,179260768,0.4758705785577186,533,520,1053,+
chr5,179263468,2.3776430621320808,1315,1038,2353,+
chr5,179263528,1.951756900647064,1013,841,1854,+
chr5,179263530,1.951756900647064,1013,841,1854,+
chr5,179263566,1.7610921501706485,859,585,1444,+
chr5,179263656,1.7691224849661624,1790,1284,3074,+
chr5,179263895,1.601568243077677,816,741,1557,+
chr5,179263931,0.6193740685543965,1038,731,1769,+
chr5,179264191,0.5793156925462828,963,904,1867,+
chr6,1613257,2.359956236323851,718,456,1174,+
chr6,1613258,2.359956236323851,718,456,1174,+
chr6,1613261,2.692789968652037,858,637,1495,+
chr6,1613263,2.168528546454611,1320,997,2317,+
chr6,1613265,2.0829227485896125,1537,998,2535,+
chr6,2779570,2.9069285155937523,684,504,1188,+
chr6,2779605,2.1810619480511053,616,477,1093,+
chr6,2785485,0.6853448275862069,529,479,1008,+
chr6,3010372,2.405119369923702,697,477,1174,+
chr6,3010412,2.0762472885032537,708,460,1168,+
chr6,3267866,4.4846939466587665,543,498,1041,+
chr6,4032820,2.5413978494623657,651,371,1022,+
chr6,4032980,2.749233155947626,903,691,1594,+
chr6,4032981,3.108513662928448,614,486,1100,+
chr6,4037753,1.5699976706266017,673,476,1149,+
chr6,4037754,1.5307518642676337,894,621,1515,+
chr6,4061466,1.4728053435114503,881,523,1404,+
chr6,4061467,1.4728053435114503,881,523,1404,+
chr6,4061468,1.10445133172453,1319,874,2193,+
chr6,4061482,2.3971320677239616,780,563,1343,+
chr6,4892220,2.0032813932451656,1150,726,1876,+
chr6,4892229,2.137839763819607,749,516,1265,+
chr6,7395332,1.449010770435261,592,476,1068,+
chr6,7401194,1.9814850655443228,1146,685,1831,+
chr6,7401223,1.6520066889632106,1067,597,1664,+
chr6,7401229,1.5342777008556112,1167,686,1853,+
chr6,7401235,2.2638308977035493,693,478,1171,+
chr6,7401274,2.957081545064378,847,465,1312,+
chr6,7401278,1.8192591141688907,1375,868,2243,+
chr6,7402839,1.509588471177121,2504,1683,4187,+
chr6,7402861,1.3642739301468583,7108,4918,12026,+
chr6,7402867,1.8873348991450756,4473,3236,7709,+
chr6,7402874,1.2438924145070058,8637,6326,14963,+
chr6,7575624,2.5666305075369387,865,602,1467,+
chr6,7575661,2.2641148325358853,909,835,1744,+
chr6,7575662,2.2641148325358853,909,835,1744,+
chr6,7576541,2.021270987000083,546,469,1015,+
chr6,7578111,2.07360559326233,945,635,1580,+
chr6,7578759,3.103135185472606,1480,1136,2616,+
chr6,7578761,3.103135185472606,1480,1136,2616,+
chr6,7578764,1.9476484300013712,2448,2144,4592,+
chr6,7578765,2.0896170452171674,2844,2400,5244,+
chr6,7578766,2.0160246686713585,3242,2679,5921,+
chr6,7580299,2.9057404816765415,748,428,1176,+
chr6,7580357,2.186688671676537,1681,1281,2962,+
chr6,7580358,2.98582995951417,884,740,1624,+
chr6,7583010,0.5958918695562556,878,525,1403,+
chr6,7583012,2.694293721845043,730,377,1107,+
chr6,7583039,3.055714285714286,712,349,1061,+
chr6,7583040,3.674164294983206,960,487,1447,+
chr6,7583061,1.5074805909746034,1144,626,1770,+
chr6,7583062,0.9872659176029964,658,355,1013,+
chr6,7583125,0.6134085213032582,978,607,1585,+
chr6,7583137,1.7405159332321698,1053,658,1711,+
chr6,7583138,1.5953861069921296,1096,796,1892,+
chr6,7583149,2.038845997561967,895,534,1429,+
chr6,7584110,0.7945485794206066,689,425,1114,+
chr6,7584472,2.110410108413286,820,560,1380,+
chr6,7584473,2.110410108413286,820,560,1380,+
chr6,7584561,2.766404805914972,613,540,1153,+
chr6,7586672,5.702010767786605,608,479,1087,+
chr6,7594054,3.021959268299024,624,472,1096,+
chr6,7606268,0.9960786166493432,726,556,1282,+
chr6,7606269,0.9960786166493432,726,556,1282,+
chr6,7606378,1.741348200546517,714,563,1277,+
chr6,7609104,1.2255538064324558,974,729,1703,+
chr6,7609555,3.7545573457865307,737,489,1226,+
chr6,7609801,4.050803402646503,552,528,1080,+
chr6,7609803,3.3778684468351643,790,809,1599,+
chr6,7609881,9.556944444444444,982,159,1141,+
chr6,7609882,17.259377494014366,982,178,1160,+
chr6,7609884,10.734445429426671,2293,523,2816,+
chr6,7609885,12.920748975707326,1076,262,1338,+
chr6,7609886,7.1587366457496335,1130,256,1386,+
chr6,7609891,88.65179381283615,2400,1978,4378,+
chr6,7609892,107.6508763411565,2043,1904,3947,+
chr6,7610345,1.1660101891614216,658,448,1106,+
chr6,7610465,0.3390783064818283,904,627,1531,+
chr6,7610466,0.3390783064818283,904,627,1531,+
chr6,7610844,2.191445248428533,1518,1124,2642,+
chr6,7610851,1.6692368214004722,815,614,1429,+
chr6,7611729,3.2883143028996886,742,481,1223,+
chr6,10629416,2.7337031900138697,875,411,1286,+
chr6,10629417,2.5116268382352938,1332,639,1971,+
chr6,10629419,2.484472049689441,899,440,1339,+
chr6,10702603,2.9246454694730555,780,525,1305,+
chr6,10702707,2.338863365662753,742,652,1394,+
chr6,10702708,2.338863365662753,742,652,1394,+
chr6,10704811,2.72493870736254,957,643,1600,+
chr6,10709547,2.5422409968604125,780,572,1352,+
chr6,10709626,2.1837815505805054,1358,996,2354,+
chr6,10723398,0.8378231152660792,2090,1395,3485,+
chr6,10723399,0.8892381298314844,1177,810,1987,+
chr6,10723400,0.6039857877564563,698,427,1125,+
chr6,10723409,1.864022435897436,1622,719,2341,+
chr6,10723410,1.864022435897436,1622,719,2341,+
chr6,10723444,1.9943820224719098,1206,622,1828,+
chr6,10724816,1.8422409091197938,3200,2234,5434,+
chr6,10724833,1.5916415234597052,1842,1385,3227,+
chr6,10724835,1.5916415234597052,1842,1385,3227,+
chr6,10724840,1.502880288028803,1697,1110,2807,+
chr6,10724863,1.538510051241624,1147,884,2031,+
chr6,10725193,1.5488897182310135,1276,1164,2440,+
chr6,10725259,1.36296875,1585,1279,2864,+
chr6,10726177,1.8409553602462885,1482,958,2440,+
chr6,10726211,1.6105248196709665,1224,1061,2285,+
chr6,10728874,1.4021552954610337,1592,1355,2947,+
chr6,10728880,1.486573005459117,3295,2340,5635,+
chr6,10730875,1.3951515747547514,2339,1827,4166,+
chr6,10731015,1.6211138572612254,5314,3821,9135,+
chr6,10749919,1.702831448668863,1662,1020,2682,+
chr6,10749920,2.005172881525794,2217,1407,3624,+
chr6,10749922,0.6215987645241946,734,522,1256,+
chr6,10749923,2.160919540229885,619,464,1083,+
chr6,10751438,1.6693390063181082,1441,1082,2523,+
chr6,10755449,0.6961642177095372,1149,672,1821,+
chr6,10756730,1.382233199897794,1287,994,2281,+
chr6,10756745,2.1847611202635915,841,606,1447,+
chr6,10756898,2.0237885870319805,910,696,1606,+
chr6,10756915,1.0225365177761645,5811,4381,10192,+
chr6,10756917,1.0225365177761645,5811,4381,10192,+
chr6,10756918,1.788361581920904,2260,1415,3675,+
chr6,10757062,1.6702577276870805,1389,1096,2485,+
chr6,11137086,0.7102529135863878,757,583,1340,+
chr6,11137087,0.6067477193952664,1364,959,2323,+
chr6,12514929,0.8613312681166206,804,638,1442,+
chr6,12514946,1.456989708404803,1113,847,1960,+
chr6,13618005,2.0592870544090056,783,532,1315,+
chr6,13618006,1.1458890518505738,1602,1210,2812,+
chr6,13618008,1.1458890518505738,1602,1210,2812,+
chr6,13618366,2.770071073765783,735,418,1153,+
chr6,13620441,1.659467974524283,2257,1337,3594,+
chr6,13620443,1.5118920541651497,1913,1200,3113,+
chr6,13620468,2.113511267575719,1131,757,1888,+
chr6,13620644,1.97979797979798,629,404,1033,+
chr6,13620662,1.9769357495881383,799,606,1405,+
chr6,13977347,2.403792390907986,823,432,1255,+
chr6,13977613,0.562037037037037,606,404,1010,+
chr6,13977657,1.6980308785331228,948,551,1499,+
chr6,13977955,1.8527777777777776,695,431,1126,+
chr6,13978593,1.9700571404858171,885,659,1544,+
chr6,13978672,0.553014553014553,702,480,1182,+
chr6,13978700,0.9315750114799427,1312,989,2301,+
chr6,13978818,1.198899455919881,1040,760,1800,+
chr6,13979258,0.6215931863727455,652,498,1150,+
chr6,13979690,0.3063973063973064,636,440,1076,+
chr6,14118273,0.3354867788461538,608,415,1023,+
chr6,14118275,1.7330320742629743,1192,728,1920,+
chr6,14131778,3.476795595740941,1232,984,2216,+
chr6,14131779,3.687994034302759,561,446,1007,+
chr6,14131830,1.7706216037640585,1429,932,2361,+
chr6,14131833,1.8697552447552448,712,571,1283,+
chr6,14133898,0.5355954757152362,689,500,1189,+
chr6,14135339,1.6247191011235953,722,533,1255,+
chr6,14135370,1.6138698630136985,753,583,1336,+
chr6,14135888,1.8228754946745545,1519,1015,2534,+
chr6,14135891,1.6326234970302766,643,530,1173,+
chr6,14135964,1.687873692077728,622,445,1067,+
chr6,14135965,1.5564103973182395,832,586,1418,+
chr6,14136002,1.8144897157081097,553,448,1001,+
chr6,14136135,2.292899408284024,774,506,1280,+
chr6,14136255,3.1147105682421667,781,537,1318,+
chr6,14136257,3.1147105682421667,781,537,1318,+
chr6,14136370,2.421311900440757,565,531,1096,+
chr6,17608704,1.0201155731109648,733,440,1173,+
chr6,17608706,1.0201155731109648,733,440,1173,+
chr6,17608744,2.6083532292523994,1249,689,1938,+
chr6,21598495,0.980083857442348,659,423,1082,+
chr6,21598497,0.980083857442348,659,423,1082,+
chr6,24667389,2.279491292694881,840,541,1381,+
chr6,24667420,1.119008054487291,1095,747,1842,+
chr6,24667475,1.7963308095515436,1340,1009,2349,+
chr6,24667476,1.7963308095515436,1340,1009,2349,+
chr6,24667477,1.7548934695998613,613,501,1114,+
chr6,24667488,1.5785611510791364,827,694,1521,+
chr6,24667497,1.9220220966997048,916,852,1768,+
chr6,24667502,1.858545292280232,979,995,1974,+
chr6,24667522,1.9167771004505696,903,685,1588,+
chr6,24667524,1.885195530726257,1190,894,2084,+
chr6,24698110,2.490745568300313,1969,1917,3886,+
chr6,24698282,2.0813431284845527,3775,2990,6765,+
chr6,24698284,1.9039301340966615,9535,7381,16916,+
chr6,24698285,1.9603356152903144,8325,6521,14846,+
chr6,24698287,2.086250597021406,4024,3411,7435,+
chr6,24698290,1.1727479873301188,3962,3471,7433,+
chr6,24701690,1.9836722701420808,2362,2268,4630,+
chr6,24701713,2.090154373927959,1791,1324,3115,+
chr6,24701719,1.4308016571800704,5076,4016,9092,+
chr6,24701723,2.224658910186658,2191,1837,4028,+
chr6,24701728,1.800504687106738,5893,5016,10909,+
chr6,24701733,1.639173746107567,3858,3409,7267,+
chr6,24701755,1.4949128192091927,12405,12824,25229,+
chr6,24701761,1.0977628872882408,13465,14118,27583,+
chr6,24777476,1.7682528409090912,578,439,1017,+
chr6,24777480,3.2321353065539107,587,472,1059,+
chr6,24780920,1.9481216457960644,725,558,1283,+
chr6,24781755,1.5495700681619384,1144,1062,2206,+
chr6,24781757,1.7154635261439841,2064,1543,3607,+
chr6,24781808,1.7080249318270355,947,603,1550,+
chr6,24784348,0.5914918414918414,811,527,1338,+
chr6,24784350,2.731812169312169,750,566,1316,+
chr6,24785963,1.6591251885369531,1077,662,1739,+
chr6,24785966,1.5722416246281203,1104,858,1962,+
chr6,26545572,2.1756125464772618,1140,616,1756,+
chr6,26545573,2.1756125464772618,1140,616,1756,+
chr6,26545615,2.007650705711648,760,360,1120,+
chr6,26545632,1.9388365529788363,3533,1872,5405,+
chr6,26545633,1.941874619598296,2126,1112,3238,+
chr6,26546033,1.7220271040102018,714,508,1222,+
chr6,26546187,3.5460206263643,780,507,1287,+
chr6,26546663,3.264646464646465,605,404,1009,+
chr6,29693308,2.296533367133532,770,508,1278,+
chr6,29693309,2.296533367133532,770,508,1278,+
chr6,29798154,0.818095305852019,1298,958,2256,+
chr6,29798156,0.9064640617462617,988,690,1678,+
chr6,29798159,0.5852642501043739,2296,1661,3957,+
chr6,29798161,0.5852642501043739,2296,1661,3957,+
chr6,29798164,1.6887254901960784,2066,1801,3867,+
chr6,29798166,1.5928720245064913,3604,2909,6513,+
chr6,29798169,1.0975154535435334,2742,2544,5286,+
chr6,29798171,1.167000213366657,4634,3929,8563,+
chr6,29855748,0.9394637620444072,689,433,1122,+
chr6,29855750,0.9394637620444072,689,433,1122,+
chr6,29855751,2.20919452887538,880,469,1349,+
chr6,29855752,2.20919452887538,880,469,1349,+
chr6,29857365,1.4825975648983019,1124,861,1985,+
chr6,29857366,1.9712059195188072,1334,894,2228,+
chr6,29857369,1.2565247300208189,1814,1014,2828,+
chr6,29857371,1.3257631257631255,2135,1079,3214,+
chr6,29857372,1.8814458988831515,1477,756,2233,+
chr6,29857374,1.4417021276595745,615,563,1178,+
chr6,29857596,1.4290159072643633,567,467,1034,+
chr6,29858041,0.4926153455626176,907,683,1590,+
chr6,29858797,1.8568688431368767,551,491,1042,+
chr6,29910307,0.9149331865810812,18037,5508,23545,+
chr6,29910308,0.9327677834764326,35912,13146,49058,+
chr6,29910596,1.540463437492579,5694,3596,9290,+
chr6,29910619,1.4655662834021073,2344,1144,3488,+
chr6,29910622,1.4781347988806095,2191,1560,3751,+
chr6,29910626,1.4537701553958264,2661,1362,4023,+
chr6,29910640,1.9851270022478122,5185,4146,9331,+
chr6,29910641,1.8065960333061242,11015,8239,19254,+
chr6,29910643,1.9927932373449884,5506,4754,10260,+
chr6,29910703,1.4656088033293335,5389,2955,8344,+
chr6,29910704,1.4656088033293335,5389,2955,8344,+
chr6,29910725,1.5138433029194214,2050,1720,3770,+
chr6,29910744,1.3631421925566345,2629,2303,4932,+
chr6,29910782,1.5697645941623353,4000,2439,6439,+
chr6,29910784,1.348427411677139,3074,2645,5719,+
chr6,29911135,1.5813050924689283,3920,2052,5972,+
chr6,29911137,1.6385577838639471,9345,5678,15023,+
chr6,29911139,1.6273422697730315,12127,8468,20595,+
chr6,29911140,1.5898860440122695,6330,5046,11376,+
chr6,29911149,1.9347872470129237,1606,1366,2972,+
chr6,29911194,1.5099508050089447,1849,1039,2888,+
chr6,29911199,1.4427087699687953,1701,1262,2963,+
chr6,29911208,1.5766411903706985,1876,1463,3339,+
chr6,29911280,1.338027034662888,10695,6477,17172,+
chr6,29911281,1.3580145154503218,7279,3906,11185,+
chr6,29911282,1.3580145154503218,7279,3906,11185,+
chr6,29911289,1.5025729075905898,4556,3269,7825,+
chr6,29911290,1.4782023511023643,7338,4815,12153,+
chr6,29912061,2.4297373528044552,909,375,1284,+
chr6,29912075,1.7830460918483844,2115,1276,3391,+
chr6,29912076,0.5993279899979906,1012,952,1964,+
chr6,29912077,1.2327040703161998,2498,1780,4278,+
chr6,29912103,1.7013866231647639,1226,612,1838,+
chr6,29912111,1.6038531553398059,1577,1029,2606,+
chr6,29912113,0.6663987548479281,1684,851,2535,+
chr6,29912114,0.8306677932321126,7153,5001,12154,+
chr6,29912116,1.2134528792035435,13296,8349,21645,+
chr6,29912117,1.3451815924094277,14027,9013,23040,+
chr6,29912118,1.1679776136303233,16983,12196,29179,+
chr6,29912119,1.178513631661274,14849,10767,25616,+
chr6,29912120,1.4146443807173295,10121,7308,17429,+
chr6,29912280,1.5341069669849698,5970,3473,9443,+
chr6,29912281,1.5341069669849698,5970,3473,9443,+
chr6,29912290,1.6002022190533893,6591,4184,10775,+
chr6,29912292,1.0873056195321598,6515,5560,12075,+
chr6,29912294,1.4232090138414013,22335,16144,38479,+
chr6,29912296,1.4905595660540327,20403,13731,34134,+
chr6,29912298,1.162244292410218,17831,12850,30681,+
chr6,29912299,1.5598150832179398,8564,5986,14550,+
chr6,29912300,1.3707571638491556,18094,12604,30698,+
chr6,29912327,1.1356631006372702,14281,11042,25323,+
chr6,29912856,1.573603532571298,3787,2482,6269,+
chr6,29912857,1.4933186813186812,2563,1624,4187,+
chr6,29912859,0.6291267093698262,2849,2279,5128,+
chr6,29912863,1.266420310046371,5021,3488,8509,+
chr6,29912864,1.0811429017526055,3483,2328,5811,+
chr6,29913012,1.3272497768915976,2797,2038,4835,+
chr6,29913033,1.4162865558856064,3121,2637,5758,+
chr6,29913047,1.5037534571315687,3459,2530,5989,+
chr6,29913051,1.235061249046653,3656,2742,6398,+
chr6,29913386,1.6368719965050242,3229,2179,5408,+
chr6,29913392,1.42714827643081,3379,2349,5728,+
chr6,29913395,1.4142888286717519,19372,13258,32630,+
chr6,29913396,1.461498758931218,16358,10622,26980,+
chr6,29913405,1.561790961772038,5054,3100,8154,+
chr6,29913450,1.3827391797586717,4151,3061,7212,+
chr6,29913479,1.2703371830611976,4190,3239,7429,+
chr6,29913486,0.9981883804783307,12035,9126,21161,+
chr6,30029132,1.6163113623336272,592,452,1044,+
chr6,30029398,1.990055472862532,1061,797,1858,+
chr6,30030043,2.5616939771065597,578,425,1003,+
chr6,30035057,4.198075012782336,810,750,1560,+
chr6,30035058,3.5674919187511933,1110,948,2058,+
chr6,30035072,4.2374718052633575,555,494,1049,+
chr6,30037571,4.02948694931049,694,449,1143,+
chr6,30037867,5.826425484230746,1818,1257,3075,+
chr6,30037868,5.826425484230746,1818,1257,3075,+
chr6,30037990,1.3281817538259564,546,463,1009,+
chr6,30229249,2.140816206429815,922,724,1646,+
chr6,30458931,0.5099915831998211,591,431,1022,+
chr6,30458932,1.3794847328244275,1184,654,1838,+
chr6,30458934,1.3794847328244275,1184,654,1838,+
chr6,30539220,0.824104117664001,476,530,1006,+
chr6,30546314,0.642309370003295,1033,735,1768,+
chr6,30546315,0.7308145318985924,788,556,1344,+
chr6,30546347,2.536032388663968,782,454,1236,+
chr6,30546348,2.536032388663968,782,454,1236,+
chr6,30550210,2.9158264129092397,2453,1765,4218,+
chr6,30550211,2.5561465721040197,864,563,1427,+
chr6,30550214,2.7420280769706067,3162,2688,5850,+
chr6,30550216,7.049284822192512,5421,5843,11264,+
chr6,30550217,8.007873222125957,4305,4944,9249,+
chr6,30550220,1.7563878289236472,1277,1837,3114,+
chr6,30550224,0.599311846271127,1211,1890,3101,+
chr6,30550229,0.6194586256289712,936,1432,2368,+
chr6,30550231,0.4973050115280007,2245,2971,5216,+
chr6,30554277,2.383218030631753,597,489,1086,+
chr6,30558095,3.161641127039051,655,475,1130,+
chr6,30558684,2.142192918623568,1258,804,2062,+
chr6,30558686,2.142192918623568,1258,804,2062,+
chr6,30585637,2.6548082329699527,809,492,1301,+
chr6,30585652,1.952928297755884,1114,608,1722,+
chr6,30585653,1.952928297755884,1114,608,1722,+
chr6,30585654,1.952928297755884,1114,608,1722,+
chr6,30587358,1.6692443359110025,768,566,1334,+
chr6,30587485,0.5233019853709509,625,434,1059,+
chr6,30587549,2.3044982698961936,665,475,1140,+
chr6,30587702,2.9370146678170834,1479,1158,2637,+
chr6,30587703,2.9370146678170834,1479,1158,2637,+
chr6,30590627,2.0086847337030447,710,502,1212,+
chr6,30590657,1.9786910197869099,649,510,1159,+
chr6,30593354,4.840978852555445,727,466,1193,+
chr6,30593427,2.0680042613636367,612,511,1123,+
chr6,30593429,2.0680042613636367,612,511,1123,+
chr6,30593517,1.2165957915990349,804,680,1484,+
chr6,30593697,0.5093378607809846,599,493,1092,+
chr6,30593763,0.5221900089206066,668,471,1139,+
chr6,30593916,1.1821499168625218,980,633,1613,+
chr6,30593986,0.4680021566919662,867,512,1379,+
chr6,30594040,12.428292563693686,2977,1829,4806,+
chr6,30594043,7.564569603406639,2979,1986,4965,+
chr6,30594058,22.13547477707762,2650,2131,4781,+
chr6,30594082,0.586366262276141,769,576,1345,+
chr6,30688120,1.5416101135805789,649,355,1004,+
chr6,30688121,1.4754305103370613,612,407,1019,+
chr6,30688126,0.9884796090860514,1632,882,2514,+
chr6,30688128,0.9236077069716777,1498,764,2262,+
chr6,30688132,1.0734355220433283,8425,5198,13623,+
chr6,30688133,1.064166089987019,7215,4281,11496,+
chr6,30688136,0.8404142513784816,6447,3857,10304,+
chr6,30688245,1.968167165553765,3798,2407,6205,+
chr6,30690323,1.6405462864162361,6052,4617,10669,+
chr6,30690333,1.459358827479951,1918,1488,3406,+
chr6,30690383,1.4276870530472836,4223,2428,6651,+
chr6,30690398,1.2595901208617972,3242,2767,6009,+
chr6,30690409,0.8464622641509433,3588,2649,6237,+
chr6,30690699,1.3795393440027575,9741,6487,16228,+
chr6,30690700,0.7814106507609596,4233,3051,7284,+
chr6,30690731,1.2881813275769023,5083,4468,9551,+
chr6,30691202,1.995485893416928,1525,1014,2539,+
chr6,30691203,1.2979855893477554,2879,1472,4351,+
chr6,30691210,1.525708398109181,7614,5140,12754,+
chr6,30691310,1.5642195721994738,10322,6390,16712,+
chr6,30691311,1.4945990919447962,8336,4683,13019,+
chr6,30691328,1.7019962659773091,1692,1054,2746,+
chr6,30691331,1.1593222829300789,5617,3764,9381,+
chr6,30691417,0.7813634301270419,2994,2319,5313,+
chr6,30691513,0.8068487244450606,12775,9012,21787,+
chr6,30691592,0.7708741208935,4797,3945,8742,+
chr6,30691593,0.9426041640874239,6869,5450,12319,+
chr6,30691746,1.1319861119350445,28468,17272,45740,+
chr6,30691747,1.16107602093544,32734,20092,52826,+
chr6,30691764,1.3727228128823592,4626,2980,7606,+
chr6,30691839,1.2710572844226649,9307,6748,16055,+
chr6,30691841,1.346416344066773,2734,1942,4676,+
chr6,30691934,1.6221814026815546,2548,1665,4213,+
chr6,30692051,1.476450373964019,2074,1648,3722,+
chr6,30692140,1.6224,4055,2499,6554,+
chr6,30692202,1.0266318205758984,4421,3391,7812,+
chr6,30692203,1.1846421232547868,4611,3062,7673,+
chr6,30692461,1.4928391959798994,1164,994,2158,+
chr6,30692611,3.542758997601489,6762,4535,11297,+
chr6,30692865,10.252213240474212,10998,10853,21851,+
chr6,30692866,8.384176424327825,14767,15450,30217,+
chr6,30692867,8.384176424327825,14767,15450,30217,+
chr6,30692868,4.815523321895691,12581,13873,26454,+
chr6,30692870,1.9319802931242838,2795,2734,5529,+
chr6,30692886,0.3014220505617977,1745,2669,4414,+
chr6,30692887,0.28237691668950243,5226,6643,11869,+
chr6,30692890,0.5213013587397824,962,1420,2382,+
chr6,30692911,0.5533947368421052,1236,1424,2660,+
chr6,30693124,1.639651984267125,1230,843,2073,+
chr6,31378557,0.5010909090909091,1377,749,2126,+
chr6,31378558,0.5010909090909091,1377,749,2126,+
chr6,31378568,0.898107700314932,2384,1164,3548,+
chr6,31378569,0.9943918975475016,1979,918,2897,+
chr6,31378916,3.023354564755839,711,470,1181,+
chr6,31378917,3.023354564755839,711,470,1181,+
chr6,31379003,3.1014056224899598,3088,1493,4581,+
chr6,31379004,3.1014056224899598,3088,1493,4581,+
chr6,31379005,2.9514057525227995,4174,2058,6232,+
chr6,31379007,2.8880538827784137,3253,1697,4950,+
chr6,31379009,2.751318240661804,2205,1172,3377,+
chr6,31430961,0.708902569438162,1038,154,1192,+
chr6,31430965,9.992002931497499,999,200,1199,+
chr6,31430970,15.873964543441641,863,160,1023,+
chr6,31473631,1.71097627207521,1773,1046,2819,+
chr6,31473632,1.71097627207521,1773,1046,2819,+
chr6,31473633,1.71097627207521,1773,1046,2819,+
chr6,31590609,2.248513907645006,781,556,1337,+
chr6,31601703,1.9104916490237591,438,653,1091,+
chr6,31601704,3.2461457549267183,516,783,1299,+
chr6,31601705,1.9104916490237591,438,653,1091,+
chr6,31603776,6.280172413793103,563,463,1026,+
chr6,31603777,6.280172413793103,563,463,1026,+
chr6,31634605,1.8342562906829885,1179,656,1835,+
chr6,31634606,1.8342562906829885,1179,656,1835,+
chr6,31635679,1.385552100998681,904,731,1635,+
chr6,31635705,1.7126436781609196,1191,695,1886,+
chr6,31636384,1.8750962763646088,2695,1986,4681,+
chr6,31636925,1.806020066889632,719,597,1316,+
chr6,31637097,3.9536423263552343,1253,933,2186,+
chr6,31637134,2.0298849683969875,1355,933,2288,+
chr6,31637626,1.7758398764319734,672,456,1128,+
chr6,31637746,1.9363719791985319,632,466,1098,+
chr6,31637778,0.6505576208178439,755,537,1292,+
chr6,31783471,6.27300100368016,749,426,1175,+
chr6,31783473,6.27300100368016,749,426,1175,+
chr6,31783500,0.40036938322679755,582,536,1118,+
chr6,31785234,3.181019332161687,904,568,1472,+
chr6,31785235,2.5825546445272187,1111,653,1764,+
chr6,31785341,1.358215010141988,743,339,1082,+
chr6,31785342,1.358215010141988,743,339,1082,+
chr6,31785343,1.358215010141988,743,339,1082,+
chr6,31785423,4.946859561929319,758,509,1267,+
chr6,31785485,2.6972170470046133,713,589,1302,+
chr6,31795513,0.961327417196494,963,658,1621,+
chr6,31795677,3.469334778726627,944,672,1616,+
chr6,31795678,3.453129866085332,692,493,1185,+
chr6,31797388,4.060150375939849,719,341,1060,+
chr6,31797396,3.144338685441876,756,443,1199,+
chr6,31797407,2.088680990324417,826,501,1327,+
chr6,31797408,2.088680990324417,826,501,1327,+
chr6,31797428,1.5727272727272728,691,439,1130,+
chr6,31797617,3.8614169006643992,720,563,1283,+
chr6,31797620,2.6473563759005185,637,510,1147,+
chr6,31797622,3.56219035202086,718,589,1307,+
chr6,31797623,7.564207246743747,663,561,1224,+
chr6,31797774,0.5065999999999999,893,599,1492,+
chr6,31797787,1.9997377736987016,1115,788,1903,+
chr6,31802692,0.9650932323971397,1939,817,2756,+
chr6,31802693,0.962392139258816,934,488,1422,+
chr6,31802694,0.9679725085910652,1005,329,1334,+
chr6,31802698,2.473256065078108,1226,478,1704,+
chr6,31802700,1.9856179741981177,3158,1536,4694,+
chr6,31802701,1.6422536718308864,2647,1675,4322,+
chr6,31802702,1.8126434416409056,2758,1477,4235,+
chr6,31802714,2.225634802091113,882,411,1293,+
chr6,31802721,2.346743295019157,1028,782,1810,+
chr6,31802768,15.124134447932313,1703,1470,3173,+
chr6,31802773,3.2500985667218156,3625,2970,6595,+
chr6,31802835,1.9979177247333673,1268,894,2162,+
chr6,31802836,1.8705310663446422,1950,1391,3341,+
chr6,31802844,8.22426512632077,3849,3246,7095,+
chr6,31802845,7.774447932431335,4437,3622,8059,+
chr6,31802848,6.530863312418732,2567,2394,4961,+
chr6,31802853,0.47327409432672596,576,626,1202,+
chr6,31802858,0.6631935830645828,801,833,1634,+
chr6,31802886,0.4518683819025116,897,878,1775,+
chr6,31802966,1.7792153589315527,1623,1197,2820,+
chr6,31803187,1.8399781085293452,3361,2546,5907,+
chr6,31803188,1.8399781085293452,3361,2546,5907,+
chr6,31803212,1.7377487281859747,1740,1171,2911,+
chr6,31804852,1.0971866349866468,1100,873,1973,+
chr6,31807319,1.4783472216225553,3199,2013,5212,+
chr6,31807320,1.4783472216225553,3199,2013,5212,+
chr6,31917259,1.9256137969523657,762,565,1327,+
chr6,31928298,2.294573643410853,1405,816,2221,+
chr6,31928300,2.294573643410853,1405,816,2221,+
chr6,32130345,1.2215165702485185,2539,1158,3697,+
chr6,32130346,1.5738553095111827,3572,1710,5282,+
chr6,32130347,1.5738553095111827,3572,1710,5282,+
chr6,32148389,1.4210834401225119,605,410,1015,+
chr6,32825794,0.32969906656993325,594,413,1007,+
chr6,32825807,0.681126901022189,682,381,1063,+
chr6,32940236,2.4636484500734728,977,460,1437,+
chr6,32940328,2.6831526378247834,800,464,1264,+
chr6,32943175,2.2389828464238737,742,524,1266,+
chr6,32944485,1.7861807071017546,541,472,1013,+
chr6,32945267,2.3882733148661126,738,721,1459,+
chr6,32945268,2.3882733148661126,738,721,1459,+
chr6,32945714,8.422427985484916,1013,990,2003,+
chr6,32945909,0.3767090994813767,798,605,1403,+
chr6,32945910,0.3767090994813767,798,605,1403,+
chr6,32945915,1.8302752293577986,683,653,1336,+
chr6,32945946,3.0223785166240407,1792,1517,3309,+
chr6,32945947,3.0223785166240407,1792,1517,3309,+
chr6,32947762,0.4278665246716365,708,625,1333,+
chr6,32947763,0.9331083042973288,1093,983,2076,+
chr6,32947765,1.2380481371579295,750,673,1423,+
chr6,32948431,2.201071910593192,715,530,1245,+
chr6,32948766,15.247795309224886,929,537,1466,+
chr6,32948922,8.699565406671177,1064,629,1693,+
chr6,32948930,20.350703673879355,2322,2166,4488,+
chr6,32948931,20.350703673879355,2322,2166,4488,+
chr6,32948932,21.33128620871608,2160,2031,4191,+
chr6,33168912,3.6530207711625096,830,623,1453,+
chr6,33169178,0.3684586278289426,793,608,1401,+
chr6,33169179,0.3684586278289426,793,608,1401,+
chr6,33169555,0.4100091827364555,845,725,1570,+
chr6,33169556,0.4100091827364555,845,725,1570,+
chr6,33169629,0.5523660650845531,597,453,1050,+
chr6,33170076,2.490666899035668,908,602,1510,+
chr6,33170105,0.5807276067249709,660,490,1150,+
chr6,33170373,1.2298425639400723,1090,726,1816,+
chr6,33170461,1.0606433696525972,1174,810,1984,+
chr6,33170722,0.4951456310679611,560,514,1074,+
chr6,33170726,0.5650657968732425,627,522,1149,+
chr6,33170733,1.819718309859155,679,567,1246,+
chr6,33170783,2.8548860302414805,1011,843,1854,+
chr6,33170790,4.465420702179177,1072,943,2015,+
chr6,33171380,2.6957778775052383,672,479,1151,+
chr6,33171443,0.4935597155271542,889,535,1424,+
chr6,33171552,4.971689461487546,559,475,1034,+
chr6,33171685,0.9513009243409793,584,507,1091,+
chr6,33171686,0.9513009243409793,584,507,1091,+
chr6,33171722,3.3135,845,749,1594,+
chr6,33171723,3.3135,845,749,1594,+
chr6,33171934,0.5578785211267605,584,425,1009,+
chr6,33172080,4.786143326986324,1144,164,1308,+
chr6,33172087,7.658660814967937,1508,161,1669,+
chr6,33172089,10.629614286196272,2481,300,2781,+
chr6,33172090,32.422498483873035,2589,906,3495,+
chr6,33172091,33.475349397471916,4522,1765,6287,+
chr6,33172092,35.298657013453564,3696,1674,5370,+
chr6,33172097,10.797677717111526,3561,5300,8861,+
chr6,33172098,10.797677717111526,3561,5300,8861,+
chr6,33172099,5.713979909555934,1410,1926,3336,+
chr6,33177740,1.117564418957956,613,455,1068,+
chr6,33177777,1.2529137348635406,716,548,1264,+
chr6,33239851,0.9872805399559356,1825,1353,3178,+
chr6,33239852,0.8480587701321233,2781,1686,4467,+
chr6,33239853,0.9282369000792383,5999,3661,9660,+
chr6,33239854,1.0275744646387248,4461,3051,7512,+
chr6,33239855,1.0133818360889926,5425,3648,9073,+
chr6,33239857,1.1849704747095644,12895,7914,20809,+
chr6,33239858,0.6608217529270161,1665,1405,3070,+
chr6,33239859,1.225130957788012,21306,12550,33856,+
chr6,33239860,1.2515915385370915,23109,14060,37169,+
chr6,33239861,1.2650080563371553,16189,8655,24844,+
chr6,33239862,1.254510777488011,12862,6974,19836,+
chr6,33239864,1.0297087062872108,6879,5553,12432,+
chr6,33239867,1.384348588775771,15934,10100,26034,+
chr6,33239868,1.26579355104864,24067,15160,39227,+
chr6,33239870,1.2649060963903924,22846,13591,36437,+
chr6,33239871,1.0300313773947807,13673,12036,25709,+
chr6,33239872,1.200210216931183,34154,23137,57291,+
chr6,33239873,1.222418906836717,17856,10822,28678,+
chr6,33239884,1.29415535655259,22098,15637,37735,+
chr6,33240403,0.8616680621747125,636,470,1106,+
chr6,33240411,1.3246924940349645,23955,19831,43786,+
chr6,33240432,0.8975929760511188,18591,14648,33239,+
chr6,33240434,1.1812403474578208,35600,24395,59995,+
chr6,33243584,1.141312313824305,144995,99876,244871,+
chr6,33243585,1.141312313824305,144995,99876,244871,+
chr6,33243586,1.325435412483441,53061,36795,89856,+
chr6,33243740,0.73313040405167,1093,851,1944,+
chr6,33243751,1.3898625876162474,92770,68908,161678,+
chr6,33243783,1.0958612796308207,28296,18158,46454,+
chr6,33243784,1.0919037965451817,18980,14513,33493,+
chr6,33257373,0.3783041583155823,943,780,1723,+
chr6,33257374,0.5569292358412811,945,893,1838,+
chr6,33257375,0.3105931652177281,1885,1450,3335,+
chr6,33257377,0.4208543660749165,3581,2127,5708,+
chr6,33257380,1.6722109344190739,2721,1679,4400,+
chr6,33257643,1.938859078484296,1501,951,2452,+
chr6,33257649,1.8153153153153156,743,443,1186,+
chr6,33257999,1.72987012987013,971,692,1663,+
chr6,33258208,2.129188710637047,1154,775,1929,+
chr6,33258221,0.920338441890166,1152,755,1907,+
chr6,33258223,0.7569842644775377,1697,1205,2902,+
chr6,33258650,8.714447991904068,2039,1112,3151,+
chr6,33258651,8.05788016014917,2397,1298,3695,+
chr6,33258652,7.879880786513776,2579,1446,4025,+
chr6,33258653,7.431408448402796,1619,906,2525,+
chr6,33258654,7.60615740941368,1464,1408,2872,+
chr6,33258655,7.276824720469726,2110,2432,4542,+
chr6,33258656,7.167169685696122,1752,2246,3998,+
chr6,33623564,0.6027984924107901,643,394,1037,+
chr6,33655839,10.195623160867378,674,342,1016,+
chr6,33655900,2.835738068812431,875,635,1510,+
chr6,33655901,2.835738068812431,875,635,1510,+
chr6,34204649,0.7994353125883898,693,401,1094,+
chr6,34204650,0.9573413646720059,645,390,1035,+
chr6,34204653,0.7871742462953499,584,569,1153,+
chr6,34204655,0.5705567010309279,1152,969,2121,+
chr6,34204656,0.5757449975923786,2930,1858,4788,+
chr6,34204680,1.0135171839351031,2194,1041,3235,+
chr6,34204681,1.5093897229610416,1999,1406,3405,+
chr6,34204682,1.2678012193843984,4193,2447,6640,+
chr6,34204707,1.656887475090798,3310,2424,5734,+
chr6,34204708,1.6023792357606343,1777,875,2652,+
chr6,34204709,1.7179534201357052,2341,1728,4069,+
chr6,34205054,0.4712449596774193,812,639,1451,+
chr6,34208537,1.847368421052632,998,702,1700,+
chr6,34208543,1.5721574344023324,2156,1623,3779,+
chr6,34208545,1.6067093409198674,3332,2564,5896,+
chr6,34208547,1.5241334001342322,2286,1792,4078,+
chr6,34208554,1.532392011523043,3306,2519,5825,+
chr6,34208606,1.4361980806528805,1480,1368,2848,+
chr6,34208647,1.9786619806702648,2251,1284,3535,+
chr6,34208661,1.5306451612903225,3795,2207,6002,+
chr6,34208662,1.3091087125393515,4844,3046,7890,+
chr6,34210545,1.3012255859161823,2771,2239,5010,+
chr6,34211286,1.8537144927285667,6987,4454,11441,+
chr6,34211287,1.8537144927285667,6987,4454,11441,+
chr6,34212632,1.3800444279896331,1774,1459,3233,+
chr6,34212760,2.175,1043,599,1642,+
chr6,34212761,2.175,1043,599,1642,+
chr6,34212763,2.4399634380689066,776,639,1415,+
chr6,34212790,0.574343607305936,574,437,1011,+
chr6,34212794,1.4634102541079284,561,517,1078,+
chr6,34212817,1.7143146714233592,1725,1450,3175,+
chr6,34212819,1.7143146714233592,1725,1450,3175,+
chr6,34212903,3.22485549132948,796,345,1141,+
chr6,34212904,2.913736275656045,1173,545,1718,+
chr6,34212907,2.2433842182973667,852,434,1286,+
chr6,34212913,1.919849203049203,956,669,1625,+
chr6,34212931,1.956082786471479,999,565,1564,+
chr6,34212936,1.7458064516129033,692,650,1342,+
chr6,34212941,0.5714809720311783,778,726,1504,+
chr6,34212942,1.1505354053426993,3504,2213,5717,+
chr6,34212943,1.4493670575656363,2037,1386,3423,+
chr6,34212945,1.3931009143196305,1642,918,2560,+
chr6,34212949,1.4452654535985157,1775,990,2765,+
chr6,34212950,1.489980732177264,1220,864,2084,+
chr6,34213156,8.24119798811157,1242,485,1727,+
chr6,34213158,8.24119798811157,1242,485,1727,+
chr6,34213186,1.7867841409691634,844,453,1297,+
chr6,34213194,1.6969416785206262,722,379,1101,+
chr6,34213195,1.522879684418146,1102,649,1751,+
chr6,34213197,1.86026936026936,844,467,1311,+
chr6,34213206,0.8680175141729046,3213,2050,5263,+
chr6,34213207,2.3469616005964955,993,618,1611,+
chr6,34213208,0.795992253454945,4243,2855,7098,+
chr6,34213217,1.447393168563587,4065,2716,6781,+
chr6,34213236,1.7497292614251678,1962,1481,3443,+
chr6,34213316,1.4602687786804853,3327,1899,5226,+
chr6,34213324,1.4947115828334103,1445,984,2429,+
chr6,34213493,1.7317259854573288,1085,803,1888,+
chr6,34213561,0.2529616724738676,725,614,1339,+
chr6,34213562,0.3310028207277439,1048,911,1959,+
chr6,34213565,1.7363083164300204,641,492,1133,+
chr6,34213588,0.6848142904730179,888,631,1519,+
chr6,34213591,1.989149607988361,1439,1088,2527,+
chr6,34213593,1.4057987532775802,2765,2216,4981,+
chr6,34213594,1.523018703172393,2360,1999,4359,+
chr6,34213597,0.507027027027027,1205,887,2092,+
chr6,34213600,0.9928060246800257,3641,2912,6553,+
chr6,34213601,1.0054671420948766,3440,2337,5777,+
chr6,34213602,1.06612450205341,5705,4257,9962,+
chr6,34213603,0.7352980964344383,1855,1309,3164,+
chr6,34213738,1.4212917529894955,1663,1018,2681,+
chr6,34213868,0.5269223842967765,797,616,1413,+
chr6,34213874,1.6159244027171804,2945,1778,4723,+
chr6,34213876,1.6719769119769117,1744,1124,2868,+
chr6,34213930,1.6407773851590108,1307,1131,2438,+
chr6,34725291,1.4695236114000416,882,417,1299,+
chr6,34725293,1.4114635447628485,2574,1662,4236,+
chr6,34725294,1.4047436523544008,2010,1473,3483,+
chr6,34725318,1.6275084813984246,975,526,1501,+
chr6,34725689,0.9745013385562565,2002,1479,3481,+
chr6,34725692,1.80353767215771,721,528,1249,+
chr6,34725712,1.63256092504722,1507,885,2392,+
chr6,34730377,1.7370619396903015,1002,817,1819,+
chr6,34730383,1.521008461285602,2954,2123,5077,+
chr6,34741251,2.399210921807488,1491,839,2330,+
chr6,34741252,2.112193362193362,1170,615,1785,+
chr6,34741279,1.6568752660706683,833,485,1318,+
chr6,34741302,1.5575232862667432,1418,1129,2547,+
chr6,34741323,1.610472972972973,907,739,1646,+
chr6,34741404,1.671264367816092,726,554,1280,+
chr6,34741467,1.9778687000185975,708,565,1273,+
chr6,35436179,0.8029283287315107,2598,1876,4474,+
chr6,35436180,0.8010719089431685,12687,5832,18519,+
chr6,35436181,0.9128740582278158,23523,13470,36993,+
chr6,35436182,0.9408500135090805,21735,10735,32470,+
chr6,35436183,1.0321206078712983,9973,6881,16854,+
chr6,35436184,0.9907568983497406,11670,5680,17350,+
chr6,35436189,1.7319085102667096,5002,2151,7153,+
chr6,35436616,1.2213763435139613,15307,8988,24295,+
chr6,35436746,1.275281389108363,11137,7205,18342,+
chr6,35436751,1.3168569203593612,4415,3096,7511,+
chr6,35436765,1.3934594390111723,8274,5457,13731,+
chr6,35437155,0.8812547710362959,890,599,1489,+
chr6,35437156,0.9420792784637178,672,436,1108,+
chr6,35437160,1.3751570018758663,10537,8173,18710,+
chr6,35437161,1.2936141740297997,26961,19483,46444,+
chr6,35438000,1.1926175069938283,10828,6929,17757,+
chr6,35438395,0.8414456794843785,11813,8755,20568,+
chr6,36063822,2.8779148391555958,591,483,1074,+
chr6,36077337,1.2148337595907928,674,390,1064,+
chr6,36077338,1.2148337595907928,674,390,1064,+
chr6,36442804,3.4880956615094814,650,455,1105,+
chr6,36447367,1.3761432139213217,630,430,1060,+
chr6,36455923,5.057828993298322,1239,938,2177,+
chr6,36456850,1.1988832045624602,634,461,1095,+
chr6,36457404,1.3183912804143505,762,561,1323,+
chr6,36458454,3.114712827907775,868,521,1389,+
chr6,36458455,2.5573383084577115,708,401,1109,+
chr6,36458456,2.5573383084577115,708,401,1109,+
chr6,36562161,2.673436376707405,594,427,1021,+
chr6,36562195,1.2772295779329006,1766,1265,3031,+
chr6,36562200,3.954440683430045,2052,1879,3931,+
chr6,36562201,2.584262851132352,6169,5409,11578,+
chr6,36562202,2.3756951792033942,9389,7859,17248,+
chr6,36562203,1.9081916427572296,6686,5483,12169,+
chr6,36562240,1.446045120956782,1063,848,1911,+
chr6,36562250,0.46814541191650744,3933,3258,7191,+
chr6,36562252,0.46814541191650744,3933,3258,7191,+
chr6,36564590,0.6996839015579137,1630,1029,2659,+
chr6,36564611,1.2999274311468199,8869,5396,14265,+
chr6,36564636,1.473149711823385,4368,2200,6568,+
chr6,36564664,1.1004649580679025,41886,25487,67373,+
chr6,36564665,1.0944793709784555,53112,30625,83737,+
chr6,36564666,1.538132642929858,17822,9509,27331,+
chr6,36564692,1.3189576462624657,8877,5391,14268,+
chr6,36564699,1.5461655025906444,104204,59759,163963,+
chr6,36564700,1.5182390192322595,108460,61745,170205,+
chr6,36566677,1.6348753565670344,1013,732,1745,+
chr6,36566725,2.0756830785119327,3133,1817,4950,+
chr6,36566727,2.0756830785119327,3133,1817,4950,+
chr6,36568934,1.5006567164179103,1570,1004,2574,+
chr6,36568938,2.446341463414634,884,614,1498,+
chr6,36569494,0.5126466824580032,990,692,1682,+
chr6,36569530,1.812468193384224,837,654,1491,+
chr6,36569532,1.3306639111340737,1716,1105,2821,+
chr6,36569745,0.666773387974643,1988,1648,3636,+
chr6,36569760,1.6921204588415029,1921,1225,3146,+
chr6,36569873,2.054655870445344,1014,721,1735,+
chr6,36569945,1.375920120747707,2278,1484,3762,+
chr6,36570102,2.192582417582418,1040,779,1819,+
chr6,36570257,2.3411078717201166,1605,1028,2633,+
chr6,36653574,1.1082809376471157,802,576,1378,+
chr6,41755424,0.5707893034817453,1173,779,1952,+
chr6,41755426,0.7037433155080213,1409,934,2343,+
chr6,41755427,1.473338277678347,1838,1270,3108,+
chr6,41755429,1.9790218933470596,1539,1044,2583,+
chr6,41755431,2.05009633911368,683,345,1028,+
chr6,41755435,1.6685082872928174,1358,723,2081,+
chr6,41755491,1.545977011494253,1075,869,1944,+
chr6,41757005,1.4489603024574669,1824,1149,2973,+
chr6,41757297,0.5876068376068376,549,467,1016,+
chr6,41757307,1.4096788897096963,1211,1042,2253,+
chr6,41757339,1.3261209876160511,2138,1417,3555,+
chr6,41757403,1.438391989837854,1749,1486,3235,+
chr6,41900521,4.157643922328207,751,655,1406,+
chr6,42852424,1.876849511409264,1329,889,2218,+
chr6,42852426,0.9946676562004635,1491,947,2438,+
chr6,42852427,1.0231072145033064,917,625,1542,+
chr6,42852449,2.122677046710196,804,542,1346,+
chr6,42852450,2.122677046710196,804,542,1346,+
chr6,42854853,0.5522886228426203,658,423,1081,+
chr6,42856614,0.2345052081097213,1119,768,1887,+
chr6,42857335,0.560897435897436,624,399,1023,+
chr6,42985682,0.7651589413247445,682,578,1260,+
chr6,42985683,0.7651589413247445,682,578,1260,+
chr6,42985946,1.2473760269471863,577,484,1061,+
chr6,42986138,0.8836450357725618,639,513,1152,+
chr6,42986140,0.8836450357725618,639,513,1152,+
chr6,42986188,0.9538483796296297,693,511,1204,+
chr6,42986189,1.8496366493401164,1221,834,2055,+
chr6,42986385,1.821292922804952,641,447,1088,+
chr6,42986615,0.8051038843721771,712,491,1203,+
chr6,42986617,0.7078319350962882,1166,767,1933,+
chr6,42987074,0.5720432115856724,920,688,1608,+
chr6,42988779,5.145904243249375,781,338,1119,+
chr6,42988780,6.051888854590617,1075,525,1600,+
chr6,42988781,6.051888854590617,1075,525,1600,+
chr6,42988835,1.470715835140998,677,460,1137,+
chr6,42988836,1.0572003748568255,922,612,1534,+
chr6,42988837,1.0572003748568255,922,612,1534,+
chr6,42988838,0.7795709703287891,706,463,1169,+
chr6,42997254,2.6498800959232613,594,416,1010,+
chr6,42997255,2.6498800959232613,594,416,1010,+
chr6,43278100,0.5470351841220372,919,547,1466,+
chr6,43278101,0.5470351841220372,919,547,1466,+
chr6,43278109,0.4864499687390429,1024,619,1643,+
chr6,43487502,1.8647355489460755,823,406,1229,+
chr6,43487503,2.204565568223229,1302,673,1975,+
chr6,43487504,1.0454481672080418,1130,744,1874,+
chr6,43487505,2.23125,902,479,1381,+
chr6,43487508,1.6155303030303028,852,591,1443,+
chr6,43738210,2.5580474088399163,590,503,1093,+
chr6,43738989,0.8218648277224132,613,470,1083,+
chr6,43745227,4.04030576720707,1139,823,1962,+
chr6,43745229,5.1134105960264895,638,452,1090,+
chr6,43745252,1.936514437845587,590,513,1103,+
chr6,43752609,1.639433551198257,644,404,1048,+
chr6,43752940,1.7815197248320471,589,460,1049,+
chr6,43752983,3.313421550094518,625,528,1153,+
chr6,43753255,1.852083690089711,632,453,1085,+
chr6,43753516,0.5994043186895011,919,631,1550,+
chr6,43753707,1.9727867241827264,911,671,1582,+
chr6,43971101,6.360208966034838,650,411,1061,+
chr6,43972113,2.453195944943526,999,713,1712,+
chr6,43972114,2.5331905781584583,675,466,1141,+
chr6,44214834,0.9901037203302216,1575,972,2547,+
chr6,44214835,0.7318324673585848,3830,1965,5795,+
chr6,44214836,0.7414887702540675,3547,1771,5318,+
chr6,44214837,0.803800554652909,6821,3272,10093,+
chr6,44214839,0.8892438712321244,11358,5134,16492,+
chr6,44214840,1.3402395875150914,11875,5425,17300,+
chr6,44214841,1.3182552275135648,13627,5981,19608,+
chr6,44214842,1.5241340027507344,11271,5038,16309,+
chr6,44214843,1.4992014853259472,8833,4043,12876,+
chr6,44214847,2.138932197838192,3548,1774,5322,+
chr6,44214883,1.1821795989537924,4664,3440,8104,+
chr6,44216422,1.398840893925888,21105,16222,37327,+
chr6,44216424,1.4471551437307382,31934,22963,54897,+
chr6,44216426,1.4236900479898436,19182,12704,31886,+
chr6,44217123,1.0765020247273518,18057,13591,31648,+
chr6,44217427,1.3148389967447833,15468,10890,26358,+
chr6,44217478,1.4421620048690946,9218,7453,16671,+
chr6,44217490,1.6221351033375673,9496,8115,17611,+
chr6,44217531,1.5721792318850591,17907,15096,33003,+
chr6,44217534,1.6334474762638302,4581,3845,8426,+
chr6,44217798,0.6230308066063737,22876,20074,42950,+
chr6,44217799,0.8704675200217753,29684,26476,56160,+
chr6,44217862,1.5318116295969788,17297,8804,26101,+
chr6,44217868,0.8178494849999071,20022,10962,30984,+
chr6,44218124,1.2852725961564948,64373,40686,105059,+
chr6,44218221,1.6002994712460816,7124,4969,12093,+
chr6,44218223,1.6002994712460816,7124,4969,12093,+
chr6,44218828,1.5027081408739449,5052,4158,9210,+
chr6,44219155,1.2725860155382909,3968,3059,7027,+
chr6,44219232,1.4695023185362945,5520,3030,8550,+
chr6,44219249,1.651781941118467,2705,1602,4307,+
chr6,44219258,1.3147189144397433,8276,5056,13332,+
chr6,44219563,1.2643473128251674,10485,7790,18275,+
chr6,44219784,1.2330233349255932,6022,3622,9644,+
chr6,44219806,0.8570439002382354,8070,4432,12502,+
chr6,44219820,1.7675056042064892,76698,44595,121293,+
chr6,44219821,1.767505604206489,76698,44595,121293,+
chr6,44219863,1.3463011401162774,48837,31002,79839,+
chr6,44219864,1.3463011401162774,48837,31002,79839,+
chr6,44219873,1.0381681671155383,31737,21691,53428,+
chr6,44219877,1.7294864022172183,12882,9035,21917,+
chr6,44219892,1.388678592415605,21160,13895,35055,+
chr6,44219927,1.278631918794943,4002,3110,7112,+
chr6,44220833,1.581596505138881,5117,3705,8822,+
chr6,44220916,0.821354085603113,3339,2499,5838,+
chr6,44220999,1.2640926623830817,6344,4754,11098,+
chr6,44221022,1.2372875154790048,3208,2519,5727,+
chr6,44221091,1.2630505775032372,10912,8058,18970,+
chr6,44221448,1.2127956062841412,3441,2757,6198,+
chr6,44221483,1.2448560207896795,11417,8272,19689,+
chr6,44221484,1.3330398415144178,3027,2463,5490,+
chr6,44371604,2.915410439770213,644,505,1149,+
chr6,44387241,1.629086763341385,586,441,1027,+
chr6,44390461,0.9961075725406936,562,470,1032,+
chr6,44390462,0.9961075725406936,562,470,1032,+
chr6,44390491,2.446108180309988,762,499,1261,+
chr6,44414526,2.58975229046488,635,420,1055,+
chr6,44414589,1.2519649010332419,783,521,1304,+
chr6,52860577,1.0011711560983771,1121,416,1537,+
chr6,52860579,1.0011711560983771,1121,416,1537,+
chr6,52860580,1.5435982145995149,975,768,1743,+
chr6,52860585,1.5975901253918494,1116,927,2043,+
chr6,52860605,1.2902865674913018,1828,1586,3414,+
chr6,52860632,0.8196354807176868,3660,2882,6542,+
chr6,52860633,1.4677009727816774,2374,1298,3672,+
chr6,52860641,1.4709012032413848,2395,1285,3680,+
chr6,52860646,0.8334953508979623,6069,4736,10805,+
chr6,52860654,2.0661497326203206,953,679,1632,+
chr6,52860655,2.0661497326203206,953,679,1632,+
chr6,52935908,6.804004144319843,668,504,1172,+
chr6,52945804,1.0914291158773588,686,456,1142,+
chr6,52947313,0.733764210629,1196,842,2038,+
chr6,52947314,0.733764210629,1196,842,2038,+
chr6,57015521,2.2639704283539897,821,510,1331,+
chr6,57015522,2.2639704283539897,821,510,1331,+
chr6,57034274,2.3623348956401298,617,404,1021,+
chr6,57046886,0.507762312633833,541,466,1007,+
chr6,57048719,1.7193795199664603,1438,1014,2452,+
chr6,57048756,1.5651006711409394,1165,744,1909,+
chr6,57048767,1.5378376749872524,5099,3138,8237,+
chr6,57048769,1.4908744203679656,3763,2222,5985,+
chr6,57048784,0.7405615467190636,3226,2332,5558,+
chr6,57048794,1.8481945895739,2053,1565,3618,+
chr6,57048811,1.3018325003786158,3683,2200,5883,+
chr6,57049193,1.0320583891687336,1231,963,2194,+
chr6,57049322,2.3347701149425286,649,434,1083,+
chr6,57049402,0.2978524743230625,637,377,1014,+
chr6,57049406,2.418183583321198,1606,980,2586,+
chr6,57049407,2.486374171442825,1935,1286,3221,+
chr6,57049429,2.332230576441103,726,474,1200,+
chr6,57049430,1.9866028708133967,691,626,1317,+
chr6,64237892,0.2963038560021837,742,502,1244,+
chr6,64237965,3.7572665920512653,656,469,1125,+
chr6,64282533,3.0588235294117645,971,458,1429,+
chr6,64282534,3.0588235294117645,971,458,1429,+
chr6,64282557,2.540085078534032,674,381,1055,+
chr6,64282582,1.6929906312846417,884,550,1434,+
chr6,64282591,2.14491129296329,1851,1272,3123,+
chr6,64282603,1.5579279753402,796,565,1361,+
chr6,64286463,1.5043192189323995,1221,1046,2267,+
chr6,64286773,1.5311128460499663,1934,1480,3414,+
chr6,64286845,1.5906730221969263,2304,1756,4060,+
chr6,64288839,0.7851069733852402,4761,3486,8247,+
chr6,64290078,1.3940642139263184,7022,4705,11727,+
chr6,64290169,0.5802538703363189,1819,1465,3284,+
chr6,64290431,1.4499624182124609,9039,6498,15537,+
chr6,64290477,1.284533728142751,2864,2330,5194,+
chr6,64290830,2.0524984662404835,36259,12918,49177,+
chr6,64290831,2.040332394669913,49145,17775,66920,+
chr6,64290832,2.040332394669913,49145,17775,66920,+
chr6,64290833,1.9716343503598464,50567,18743,69310,+
chr6,64290835,1.9777237234871237,41554,16060,57614,+
chr6,64290836,1.9833201503312237,28668,11203,39871,+
chr6,64290837,2.104412815299225,6537,2934,9471,+
chr6,64290847,41.5139958896147,30859,24520,55379,+
chr6,64290848,41.5139958896147,30859,24520,55379,+
chr6,64290849,30.14760673068418,17394,12700,30094,+
chr6,64291052,1.2089625177779124,6399,4588,10987,+
chr6,64291123,1.162641557995882,8558,5827,14385,+
chr6,64291579,2.160204991087344,830,611,1441,+
chr6,64292111,1.600578034682081,922,691,1613,+
chr6,64292170,1.939910166520596,786,651,1437,+
chr6,64292173,1.666765140324963,805,676,1481,+
chr6,64292248,2.5256124721603563,566,448,1014,+
chr6,64292387,1.7634277591633671,667,468,1135,+
chr6,64292925,1.7501998401278975,603,416,1019,+
chr6,80741195,2.194690265486725,799,451,1250,+
chr6,80741197,1.7125617873399057,1016,609,1625,+
chr6,83075995,2.0640552238467578,922,694,1616,+
chr6,83076385,0.7529973338146445,862,627,1489,+
chr6,83076386,0.9438520718045621,665,477,1142,+
chr6,83904308,3.462813562029141,1708,1205,2913,+
chr6,83904310,4.294520268816471,1776,1151,2927,+
chr6,89793492,0.3484592399697079,575,519,1094,+
chr6,89793975,3.1436898851813027,616,497,1113,+
chr6,89794170,1.6971052476507835,585,420,1005,+
chr6,89794242,1.704564315352697,631,481,1112,+
chr6,90431261,1.2414646691956537,1678,1132,2810,+
chr6,90431262,1.2799312593454062,2594,1851,4445,+
chr6,90431263,1.301811171358884,2983,2091,5074,+
chr6,90431264,1.2403350515463918,2144,1551,3695,+
chr6,90431269,1.76587834372374,1304,1007,2311,+
chr6,96054166,2.709483793517407,670,538,1208,+
chr6,96054168,2.709483793517407,670,538,1208,+
chr6,96990800,10.501547330649714,731,557,1288,+
chr6,96990801,12.226621119863788,1456,1115,2571,+
chr6,96990802,11.055769754936922,1200,929,2129,+
chr6,96990803,11.451179504567552,1045,828,1873,+
chr6,110540966,2.345834628201465,731,431,1162,+
chr6,111214220,0.3624881291547958,693,584,1277,+
chr6,111214831,0.3135287033319952,780,529,1309,+
chr6,111214833,0.30553090811820616,1098,805,1903,+
chr6,111214999,3.125448028673835,871,464,1335,+
chr6,111215000,2.981075977995785,1192,707,1899,+
chr6,111216226,2.874986210162123,682,530,1212,+
chr6,111216722,2.340036821979889,805,613,1418,+
chr6,111216723,2.340036821979889,805,613,1418,+
chr6,116892729,2.8865769660865808,622,427,1049,+
chr6,116892730,3.0459142787278113,623,428,1051,+
chr6,116905920,1.4765680639116805,1666,1140,2806,+
chr6,116905921,1.1376068376068376,1209,779,1988,+
chr6,116905925,1.6708370161128567,1535,1026,2561,+
chr6,116910018,1.9359326018808776,963,637,1600,+
chr6,116910122,2.1132707782644533,1694,1202,2896,+
chr6,116914161,2.178191489361702,629,469,1098,+
chr6,116914179,0.9978835978835978,942,839,1781,+
chr6,116914181,0.9978835978835978,942,839,1781,+
chr6,118320441,2.2723285486443383,694,569,1263,+
chr6,118320443,2.443329658213892,1067,906,1973,+
chr6,118320444,2.462167020755025,728,632,1360,+
chr6,118320466,1.822294298395357,1524,706,2230,+
chr6,118320467,1.822294298395357,1524,706,2230,+
chr6,118320468,0.6726853630426431,617,547,1164,+
chr6,118320470,1.4259297612355395,944,462,1406,+
chr6,118320471,1.6360225140712943,871,532,1403,+
chr6,118320476,1.6096130094689174,801,693,1494,+
chr6,118320489,2.146448087431694,981,914,1895,+
chr6,125541260,1.6762003195695354,689,541,1230,+
chr6,125569441,1.9810502080935093,657,490,1147,+
chr6,125569464,1.8208442800692732,1902,1487,3389,+
chr6,125584202,2.384814152256013,856,558,1414,+
chr6,125584203,2.5609941990815495,1486,1055,2541,+
chr6,126236579,2.414252193429913,1006,753,1759,+
chr6,126236581,2.3487575661038544,1531,1167,2698,+
chr6,126236582,2.625570776255708,1034,802,1836,+
chr6,126236586,0.5739455782312924,766,587,1353,+
chr6,126236587,2.2494791666666667,616,479,1095,+
chr6,126236588,2.3352199033132885,1164,770,1934,+
chr6,126236590,2.3352199033132885,1164,770,1934,+
chr6,126240557,2.097569978622385,1511,1207,2718,+
chr6,126240558,1.8905966381767507,2315,1852,4167,+
chr6,126240559,1.7097571959042963,1987,1556,3543,+
chr6,126240560,1.684612239334878,1647,1333,2980,+
chr6,126240561,1.4161409069737723,2375,2180,4555,+
chr6,126240562,1.2665535806703245,1258,1286,2544,+
chr6,126242195,0.5928479352755078,869,637,1506,+
chr6,126242196,0.2914693934818036,628,395,1023,+
chr6,126243921,1.8564190036622683,840,642,1482,+
chr6,126243922,1.8564190036622683,840,642,1482,+
chr6,126243923,1.8564190036622683,840,642,1482,+
chr6,126250294,1.8395604395604397,620,454,1074,+
chr6,126250298,1.783734939759036,657,497,1154,+
chr6,126250436,1.005179430262671,1044,764,1808,+
chr6,126250438,1.005179430262671,1044,764,1808,+
chr6,126251821,1.5372220129536758,618,420,1038,+
chr6,126251978,2.9464809646100525,836,449,1285,+
chr6,126319422,5.1572722257771275,613,539,1152,+
chr6,126669612,1.204964410182223,1854,1094,2948,+
chr6,133135706,0.8172396676347852,2473,1675,4148,+
chr6,133135707,0.9043943526594,29927,14942,44869,+
chr6,133135708,0.9034831211468309,25981,11411,37392,+
chr6,133135709,0.9211445988801564,26527,10703,37230,+
chr6,133135710,1.6351169184891994,8430,4732,13162,+
chr6,133135711,1.2418773699998793,21352,9630,30982,+
chr6,133135875,1.593134266608787,8897,5646,14543,+
chr6,133135877,1.2852572580883856,55861,35402,91263,+
chr6,133135878,1.34188304788308,34124,19279,53403,+
chr6,133135879,1.3061892662459678,25470,17597,43067,+
chr6,133135894,1.7172254059086354,12528,9677,22205,+
chr6,133136137,1.095193700613709,31674,22161,53835,+
chr6,133136196,1.216248109105755,17061,13459,30520,+
chr6,133136322,1.8246515040352167,828,563,1391,+
chr6,133137696,1.217038666184109,9681,5657,15338,+
chr6,133138110,1.2748338975893192,32814,22487,55301,+
chr6,133138111,1.2896539176979085,19201,14069,33270,+
chr6,133138617,0.40069176185615113,1173,929,2102,+
chr6,142384395,2.6356580699798906,731,462,1193,+
chr6,142384397,1.3382838834982365,1502,937,2439,+
chr6,142384398,1.1313671741699918,1104,729,1833,+
chr6,142384399,1.4761269792696619,1660,1044,2704,+
chr6,142384413,3.6481339609682184,810,507,1317,+
chr6,142384419,0.3839040687268822,584,492,1076,+
chr6,142468402,2.5362753203803226,1066,471,1537,+
chr6,142468403,2.5362753203803226,1066,471,1537,+
chr6,142468409,1.719588677264876,1198,592,1790,+
chr6,142468416,2.660626122082585,1008,556,1564,+
chr6,142468417,2.3969940194254282,1883,1043,2926,+
chr6,142490725,2.225061410113801,1322,857,2179,+
chr6,142490726,2.9520028870443884,817,488,1305,+
chr6,142519676,1.1509597895087862,524,486,1010,+
chr6,146870837,2.0188796745930735,929,521,1450,+
chr6,146875631,0.5462989863667713,2357,1394,3751,+
chr6,146875633,0.5570866141732284,1697,1015,2712,+
chr6,146875641,1.7238627294493216,863,536,1399,+
chr6,146875645,1.450548750044956,1877,1136,3013,+
chr6,146875649,2.0999833175777125,1048,733,1781,+
chr6,146875723,3.196955126794532,667,436,1103,+
chr6,147612235,1.0766104998531552,1033,582,1615,+
chr6,147707332,3.9701028926422057,817,302,1119,+
chr6,149342564,1.9015946947712001,597,465,1062,+
chr6,149396428,2.217018750883999,944,748,1692,+
chr6,149901819,3.5920655125269647,635,409,1044,+
chr6,149911984,0.7326735508408982,869,588,1457,+
chr6,150070953,3.4686961943681927,1513,1074,2587,+
chr6,150070954,3.9319016127011155,1372,983,2355,+
chr6,150070957,3.9601859996872313,532,476,1008,+
chr6,150070960,5.794218331155727,558,551,1109,+
chr6,150070974,0.4387312186978298,510,598,1108,+
chr6,150070975,0.964984967314243,840,834,1674,+
chr6,150071045,0.46075788871924583,1053,918,1971,+
chr6,150071069,0.2024804583729837,1678,1293,2971,+
chr6,150071071,0.26369365690649277,3211,2097,5308,+
chr6,150071074,2.3860869565217397,832,390,1222,+
chr6,150092311,1.7391304347826086,699,459,1158,+
chr6,150094279,2.8130141190914677,715,542,1257,+
chr6,150094283,0.3701310043668122,977,686,1663,+
chr6,150111112,2.2475806451612903,928,619,1547,+
chr6,150111120,2.56203288490284,856,668,1524,+
chr6,150117569,0.6136977058029689,748,531,1279,+
chr6,150117589,2.0130994152046786,661,474,1135,+
chr6,150123336,1.6573208722741433,759,534,1293,+
chr6,150123340,1.916381387092684,816,477,1293,+
chr6,150123345,1.922262396694215,826,483,1309,+
chr6,150123399,0.539683275754133,1057,730,1787,+
chr6,150123439,0.46403075233388236,675,606,1281,+
chr6,150123443,2.3897049239109474,1374,1233,2607,+
chr6,150123488,2.9028046421663447,620,516,1136,+
chr6,150123523,2.4840182648401825,679,437,1116,+
chr6,150123566,1.9283422459893047,600,439,1039,+
chr6,151197271,2.125506072874494,734,545,1279,+
chr6,151197299,1.9003831417624517,1363,956,2319,+
chr6,151197300,1.9003831417624517,1363,956,2319,+
chr6,151198791,1.6510678025440542,1047,835,1882,+
chr6,151198796,1.916682926829268,892,614,1506,+
chr6,151198803,0.8955730746383498,3873,2983,6856,+
chr6,151198804,0.651025435550411,2674,2041,4715,+
chr6,151198915,1.5653638828103218,4508,3561,8069,+
chr6,151198918,1.4746716697936213,1964,1559,3523,+
chr6,151198943,1.6253912847652292,2237,2139,4376,+
chr6,151203926,1.8451211525867717,804,508,1312,+
chr6,151209044,1.80118979857626,1382,980,2362,+
chr6,151209060,0.616842105263158,585,449,1034,+
chr6,151243372,2.981965440055908,607,485,1092,+
chr6,151247285,0.4382608061812085,924,537,1461,+
chr6,151247298,2.6919881305637983,1133,673,1806,+
chr6,151247346,1.9103830242780102,3163,1997,5160,+
chr6,151247349,1.55444562621866,7829,5295,13124,+
chr6,151247350,1.6031827473408047,9428,6060,15488,+
chr6,151247361,1.478398480772274,1902,978,2880,+
chr6,151247404,1.6722367738425137,4375,2926,7301,+
chr6,151247411,1.602480097231876,9696,6284,15980,+
chr6,151334942,2.5002569668505483,702,507,1209,+
chr6,151336794,1.1506143242433322,661,354,1015,+
chr6,151336795,1.1506143242433322,661,354,1015,+
chr6,151336803,1.1357787703208422,1113,809,1922,+
chr6,151355644,1.6461347503975798,1146,888,2034,+
chr6,151355671,1.6216118684843626,1988,1739,3727,+
chr6,151646790,1.323671497584541,410,620,1030,+
chr6,151646792,1.800673179375728,827,1109,1936,+
chr6,151646808,0.3477287103998905,472,602,1074,+
chr6,151646810,0.4005900116959068,1628,1753,3381,+
chr6,151646812,0.40988647757340746,810,964,1774,+
chr6,151646889,1.7723676202069385,623,476,1099,+
chr6,151646952,1.8928138528138527,642,461,1103,+
chr6,151646959,1.9545411407421467,1372,1027,2399,+
chr6,151646960,1.6691158102646049,2544,1849,4393,+
chr6,151646964,2.5,734,587,1321,+
chr6,151646972,1.707664025911498,866,736,1602,+
chr6,151670171,1.552874743326489,1209,973,2182,+
chr6,151670194,1.8384410801963995,1230,1039,2269,+
chr6,151670208,1.5301973586585549,1288,1171,2459,+
chr6,151670337,1.4957264957264955,1812,1442,3254,+
chr6,151670344,1.1008501279360206,3241,2579,5820,+
chr6,151670345,0.8244577470263547,1514,1353,2867,+
chr6,151670346,1.479996492151188,1360,904,2264,+
chr6,151670368,1.7878844292203433,1548,1032,2580,+
chr6,151670459,1.7136363636363636,1507,959,2466,+
chr6,151670610,1.5956584111524892,1967,1331,3298,+
chr6,151670641,1.845601851851852,937,539,1476,+
chr6,151670643,0.5090474564697849,1135,807,1942,+
chr6,151670649,1.6333992094861662,797,505,1302,+
chr6,151670652,1.3657520325203252,1660,1352,3012,+
chr6,151670707,1.9751916095199675,1398,803,2201,+
chr6,151670728,1.3376777567300766,2864,2025,4889,+
chr6,151670742,0.9741953630011736,7795,5586,13381,+
chr6,151670743,1.06468716825417,12105,8630,20735,+
chr6,151670745,1.074002379914483,10503,7255,17758,+
chr6,151670748,1.2863369957657005,7213,4987,12200,+
chr6,151670749,1.3934104157943894,2703,1526,4229,+
chr6,151670760,1.5593969418497649,12622,9382,22004,+
chr6,151670761,1.5593969418497649,12622,9382,22004,+
chr6,151670804,2.077043577646556,1637,1141,2778,+
chr6,151670832,1.6397637795275593,587,507,1094,+
chr6,151670859,1.5045095413046952,5254,4194,9448,+
chr6,151670860,1.562594843461446,6411,4957,11368,+
chr6,151670861,1.5045095413046952,5254,4194,9448,+
chr6,151670871,1.3979956012638275,3692,2883,6575,+
chr6,151670881,1.7613265306122448,841,699,1540,+
chr6,151670965,2.0275111476811234,2701,1895,4596,+
chr6,151671025,1.5336093936127968,1501,1155,2656,+
chr6,151671101,1.0977722332006068,4597,3279,7876,+
chr6,151671204,1.7607458912768648,618,451,1069,+
chr6,151671264,1.5799320056265482,2344,1785,4129,+
chr6,151671326,1.5672709923664125,1094,785,1879,+
chr6,151671327,1.6922077386354262,1344,1053,2397,+
chr6,151671328,0.8080941966554002,1828,1145,2973,+
chr6,151671330,0.8080941966554002,1828,1145,2973,+
chr6,151671335,1.5658307210031346,998,637,1635,+
chr6,151671365,0.9575396901728438,3885,2587,6472,+
chr6,151671366,0.9324611852370255,4134,2755,6889,+
chr6,151671368,1.6648648648648652,857,584,1441,+
chr6,151671465,1.4303785329450944,1802,1381,3183,+
chr6,151671525,2.9368181818181816,922,659,1581,+
chr6,151671560,0.7265291873425929,1820,1347,3167,+
chr6,151671590,1.803202614379085,1173,764,1937,+
chr6,151671591,1.5985604661897068,1704,1237,2941,+
chr6,151671637,2.0583403780122524,2215,1680,3895,+
chr6,151671681,1.5529536639026265,2095,1752,3847,+
chr6,151671723,0.6835212201591512,1301,927,2228,+
chr6,151671759,2.4308943089430897,827,491,1318,+
chr6,151671808,3.007511637748624,916,555,1471,+
chr6,151671810,1.541908013693406,2705,2082,4787,+
chr6,151671811,1.9420817824239065,1935,1241,3176,+
chr6,151671812,1.7015151830376318,4640,3323,7963,+
chr6,151671834,0.6176470588235294,1917,1369,3286,+
chr6,151671892,1.3907388502819245,3636,2553,6189,+
chr6,151672090,1.9096050038557104,1310,1060,2370,+
chr6,151672169,1.771924908938078,1427,1161,2588,+
chr6,151672197,1.635047458848973,1600,1188,2788,+
chr6,151672245,0.5080210472279261,608,486,1094,+
chr6,151672246,1.405266584677711,1553,1201,2754,+
chr6,151672397,1.698148148148148,916,557,1473,+
chr6,151672525,1.5346283056249463,962,610,1572,+
chr6,151672617,2.108873579461815,1234,998,2232,+
chr6,151672621,1.6407118061083246,2099,1624,3723,+
chr6,151672666,0.6498702772823091,1172,880,2052,+
chr6,151672864,5.740967851774656,4737,3642,8379,+
chr6,151672937,0.5792151162790699,796,607,1403,+
chr6,151673102,0.6752158996805868,1501,1069,2570,+
chr6,151673103,1.2549372177892657,2727,1604,4331,+
chr6,151673152,0.6985344473359815,1784,1042,2826,+
chr6,151673163,1.3415593428483947,10950,6306,17256,+
chr6,151673164,1.293342432899773,8869,5132,14001,+
chr6,151673166,1.3983075889858965,5147,2977,8124,+
chr6,151673167,1.4744436388414834,10130,5922,16052,+
chr6,151673168,1.531483488279245,2651,1575,4226,+
chr6,151673200,1.5491008667034292,28846,19086,47932,+
chr6,151673201,1.5956120689651787,53363,35338,88701,+
chr6,151673202,1.3365338740458017,8321,4863,13184,+
chr6,151673203,1.6981866655180458,30992,21323,52315,+
chr6,151673363,1.4811351505520924,2667,1943,4610,+
chr6,151673627,1.5568120945181836,1508,950,2458,+
chr6,151673696,1.6329059721417596,1705,1368,3073,+
chr6,151673739,2.160968358462519,635,553,1188,+
chr6,151673753,1.4967878120411158,1387,907,2294,+
chr6,151673934,1.5671547054840895,4114,3375,7489,+
chr6,151673935,1.6596737839744509,5003,4026,9029,+
chr6,151673969,1.957085253456221,1358,867,2225,+
chr6,151673986,1.5908690141621202,1990,1577,3567,+
chr6,151674002,1.7036455929856942,1464,984,2448,+
chr6,151674119,1.5941469489414697,1254,802,2056,+
chr6,151674133,1.327997735269139,2026,1564,3590,+
chr6,151674219,0.6906009439793224,2621,1923,4544,+
chr6,151674349,1.6775967013548008,1423,925,2348,+
chr6,151674539,1.4877979568671964,1390,880,2270,+
chr6,151674715,1.292037933817595,2520,2359,4879,+
chr6,151674828,1.5021008403361342,1286,1070,2356,+
chr6,151676992,1.0252845825741854,6248,4543,10791,+
chr6,151677598,2.1984002469072297,2513,1976,4489,+
chr6,151677646,1.4528581809682894,4501,3347,7848,+
chr6,151677926,2.0469552457813647,929,657,1586,+
chr6,151678490,2.429650949927312,767,499,1266,+
chr6,151678575,0.6120466550856171,1078,841,1919,+
chr6,151678669,1.894396551724138,878,637,1515,+
chr6,151678900,1.6346308062426744,802,558,1360,+
chr6,151679448,2.00812887969258,646,397,1043,+
chr6,151790119,0.7162860172308084,664,463,1127,+
chr6,151790218,2.3825072886297374,680,342,1022,+
chr6,151790220,2.3886662468980333,901,486,1387,+
chr6,152085008,2.805380973669763,690,440,1130,+
chr6,152085444,1.5659370522259004,772,546,1318,+
chr6,152085445,0.8806461382980294,2147,1526,3673,+
chr6,152085447,0.980529937051676,1575,1187,2762,+
chr6,152085449,0.6297244211654068,919,633,1552,+
chr6,152085455,2.0072992700729926,959,821,1780,+
chr6,158365013,2.844259567387687,813,600,1413,+
chr6,158365015,2.6622450092278322,808,599,1407,+
chr6,160163130,5.004366812227074,572,457,1029,+
chr6,160163131,5.004366812227074,572,457,1029,+
chr6,160169363,2.2020768484729194,748,471,1219,+
chr6,160169368,1.449430534972387,1088,712,1800,+
chr6,160169370,1.232703488372093,770,515,1285,+
chr6,160169372,2.353896103896104,724,461,1185,+
chr6,160169374,2.353896103896104,724,461,1185,+
chr6,160176857,0.4103322072072072,582,443,1025,+
chr6,160176858,0.4103322072072072,582,443,1025,+
chr6,160188202,1.3092165357097936,974,652,1626,+
chr6,160189575,0.9739776951672865,1571,1075,2646,+
chr6,160189576,0.9739776951672865,1571,1075,2646,+
chr6,160189585,2.6859205776173285,743,553,1296,+
chr6,160189625,1.8409364146406624,1224,787,2011,+
chr6,160189652,1.9893789947797238,5071,3375,8446,+
chr6,160189653,2.156678279494096,2840,2077,4917,+
chr6,160196202,1.7466546577457538,904,535,1439,+
chr6,160196238,2.437137330754352,734,516,1250,+
chr6,160198336,1.7298387096774197,626,495,1121,+
chr6,160198368,2.246777163904236,609,542,1151,+
chr6,160198369,1.961565502695102,619,501,1120,+
chr6,160198456,0.5765589497601615,608,465,1073,+
chr6,160199832,3.25447499548062,3391,3095,6486,+
chr6,160199833,3.25447499548062,3391,3095,6486,+
chr6,160199927,0.5597722960151803,589,441,1030,+
chr6,160199942,2.441025641025641,594,454,1048,+
chr6,160200010,0.6197052947052947,1837,1455,3292,+
chr6,160200011,0.6197052947052947,1837,1455,3292,+
chr6,160200025,2.103734439834025,1169,1204,2373,+
chr6,160211537,2.8453961927980433,877,771,1648,+
chr6,160211540,0.5273568029162589,743,558,1301,+
chr6,160211542,0.5273568029162589,743,558,1301,+
chr6,160218411,0.4285930790603687,706,534,1240,+
chr6,160218412,2.054586129753915,655,446,1101,+
chr6,160218457,1.8524368231046933,820,553,1373,+
chr6,160219084,2.2619088776392147,1346,1156,2502,+
chr6,160219085,2.2619088776392147,1346,1156,2502,+
chr6,160219369,1.841010867908876,1426,1069,2495,+
chr6,160693663,2.403271983640082,903,488,1391,+
chr6,160693703,0.5781007751937985,627,515,1142,+
chr6,160696967,4.633301857097891,735,352,1087,+
chr6,160697101,0.5760869565217391,741,482,1223,+
chr6,160697405,4.912130191253699,602,435,1037,+
chr6,160697651,0.5976419878907031,704,589,1293,+
chr6,160829942,0.7168826515105241,1416,893,2309,+
chr6,160829944,1.1906976744186046,719,429,1148,+
chr6,163984626,1.131683335199069,716,510,1226,+
chr6,163984661,0.8308316947213206,882,602,1484,+
chr6,163984731,2.784636488340192,724,485,1209,+
chr6,163991993,2.3850164898390167,595,421,1016,+
chr6,163992057,2.323128664840001,940,725,1665,+
chr6,163993506,2.4087352281603636,870,615,1485,+
chr6,163993897,0.2681101001957848,581,456,1037,+
chr6,163993997,1.952802359882006,661,451,1112,+
chr6,163994194,2.423645320197044,614,434,1048,+
chr7,914042,1.6445940890385335,627,395,1022,+
chr7,914140,0.4831741081595025,681,489,1170,+
chr7,1578788,1.0360993905297704,934,710,1644,+
chr7,1578789,1.2803472062683787,1256,1004,2260,+
chr7,1578824,1.9821321620495354,944,733,1677,+
chr7,1578848,1.4392915736055991,1164,955,2119,+
chr7,1578857,1.585269316812941,939,744,1683,+
chr7,1579694,1.808641975308642,585,449,1034,+
chr7,1579717,1.9069823051171688,549,491,1040,+
chr7,1580064,5.983622169827075,574,598,1172,+
chr7,1580065,5.767357219090002,705,618,1323,+
chr7,1580076,0.4099749330106318,526,502,1028,+
chr7,1580078,0.4099749330106318,526,502,1028,+
chr7,1580280,0.9463812492184203,624,560,1184,+
chr7,1580369,2.088823067522542,935,682,1617,+
chr7,1580403,2.44689333986761,1445,999,2444,+
chr7,1580729,3.0974294699721043,1188,923,2111,+
chr7,1581005,5.649038461538462,949,415,1364,+
chr7,1581006,4.466284430438843,1761,687,2448,+
chr7,1581007,4.8598853577814545,1946,762,2708,+
chr7,1581033,8.482941801632721,2321,986,3307,+
chr7,1581034,5.946877510762849,2621,1165,3786,+
chr7,1581035,6.523946261301041,3670,1576,5246,+
chr7,1581036,6.284287922791388,2338,1083,3421,+
chr7,1581047,5.805812691681571,2299,1524,3823,+
chr7,1581048,5.363304099498548,3091,1925,5016,+
chr7,1581049,5.363304099498548,3091,1925,5016,+
chr7,1581107,4.579486341788807,1679,642,2321,+
chr7,1581110,3.861095954187951,795,387,1182,+
chr7,1581116,15.454253035138695,1036,521,1557,+
chr7,1581225,60.88385269121813,795,352,1147,+
chr7,1581226,18.870268528398427,2991,1313,4304,+
chr7,1581227,18.230771191842585,3070,1532,4602,+
chr7,1581228,17.464905423032768,2802,1472,4274,+
chr7,1581330,2.733882383219663,606,408,1014,+
chr7,1581331,2.733882383219663,606,408,1014,+
chr7,1581617,1.1154232055849733,665,506,1171,+
chr7,1581683,1.5080548168756607,877,613,1490,+
chr7,1581700,0.6502590673575129,752,578,1330,+
chr7,1581709,2.4407252440725244,559,477,1036,+
chr7,1581755,0.6122943595769682,793,591,1384,+
chr7,1581807,1.7836317135549873,633,390,1023,+
chr7,1581822,1.9532854209445587,760,486,1246,+
chr7,1582073,1.1875525620507281,672,497,1169,+
chr7,1582144,1.96317594834544,670,471,1141,+
chr7,1582241,3.178751387800329,1488,1080,2568,+
chr7,1582256,1.3318412908930153,1251,927,2178,+
chr7,1582320,1.932074652777778,1534,1151,2685,+
chr7,1582321,1.932074652777778,1534,1151,2685,+
chr7,1582430,0.437061521856449,588,435,1023,+
chr7,1582457,2.409200851393189,1276,645,1921,+
chr7,1582458,2.409200851393189,1276,645,1921,+
chr7,1582465,1.9166666666666667,855,641,1496,+
chr7,1582469,2.227122109055521,2565,1887,4452,+
chr7,1582470,2.0222416890617807,1815,1432,3247,+
chr7,1582474,1.9963031423290205,827,540,1367,+
chr7,1582476,2.0695464482486647,1700,1483,3183,+
chr7,1582477,1.5920956804609234,973,678,1651,+
chr7,1582484,1.421237375810822,1412,1281,2693,+
chr7,2394946,3.661485117656226,645,375,1020,+
chr7,2395030,3.5174563591022445,650,400,1050,+
chr7,2400366,2.680210972567923,976,743,1719,+
chr7,2400446,2.009880848590526,1091,836,1927,+
chr7,2400447,2.009880848590526,1091,836,1927,+
chr7,2402328,1.8857680250783697,1670,869,2539,+
chr7,2402329,2.04305177727283,2316,1351,3667,+
chr7,2402355,1.8055555555555556,649,449,1098,+
chr7,2402738,2.0324430901595267,985,796,1781,+
chr7,2403366,0.4772243507875691,1238,782,2020,+
chr7,2404102,2.483764705882353,608,424,1032,+
chr7,2406190,1.9858960367027674,1254,999,2253,+
chr7,2406191,2.0408163265306123,803,468,1271,+
chr7,2409135,1.5253173321024691,805,618,1423,+
chr7,2411429,1.9985465116279073,874,601,1475,+
chr7,2411448,0.5052130674223386,858,633,1491,+
chr7,2412335,1.6670588235294117,544,509,1053,+
chr7,2412402,1.5716039736577745,703,577,1280,+
chr7,2414211,0.463615749330035,691,538,1229,+
chr7,2415105,1.4634064284939827,1152,794,1946,+
chr7,2416633,2.504494083496625,913,661,1574,+
chr7,2418329,2.310507674144038,1029,769,1798,+
chr7,2418330,2.0630058033244425,1628,1277,2905,+
chr7,2419102,0.5321671872464273,1827,1162,2989,+
chr7,2419103,0.5181518151815181,1255,807,2062,+
chr7,2419960,3.225260812728857,769,584,1353,+
chr7,2420070,1.1005763163850442,1064,751,1815,+
chr7,2420201,1.823576798480301,1171,776,1947,+
chr7,2420219,0.4297892493488041,659,411,1070,+
chr7,5239225,1.6950181852906263,1349,875,2224,+
chr7,5632613,2.1264916467780437,647,418,1065,+
chr7,5632628,1.6369797793087995,834,540,1374,+
chr7,5632630,1.5544711668796716,853,905,1758,+
chr7,5632631,1.580364656381487,938,619,1557,+
chr7,5632632,1.5544711668796716,853,905,1758,+
chr7,5632897,2.7073999918878005,673,385,1058,+
chr7,5632969,2.3472037037037037,1062,618,1680,+
chr7,5632970,2.1533333333333333,835,439,1274,+
chr7,5642887,0.4410138248847927,695,433,1128,+
chr7,5642889,1.5997968160871385,1522,1118,2640,+
chr7,5642891,2.464285714285714,827,685,1512,+
chr7,5642902,2.179692307692308,505,499,1004,+
chr7,5642958,1.154196186855596,931,642,1573,+
chr7,5642960,1.154196186855596,931,642,1573,+
chr7,5643025,1.2942784518852066,678,423,1101,+
chr7,5643146,3.568584114257079,737,513,1250,+
chr7,5643610,2.75,734,419,1153,+
chr7,5644974,0.8298008991650611,645,518,1163,+
chr7,5644976,0.8298008991650611,645,518,1163,+
chr7,5645619,8.517125983654072,2980,2025,5005,+
chr7,5645620,5.385287955527345,4900,3429,8329,+
chr7,5645622,4.6302373960748415,2971,2160,5131,+
chr7,5645777,12.768821730594986,1661,239,1900,+
chr7,5645779,6.529247984779586,2285,263,2548,+
chr7,5645780,8.052149272055754,3250,453,3703,+
chr7,5645781,6.078338839075035,1287,162,1449,+
chr7,5645782,10.01306632143128,3147,480,3627,+
chr7,5645783,8.508060145186148,1666,315,1981,+
chr7,5645784,8.991906474820144,1110,277,1387,+
chr7,5645785,8.054089034759848,2425,400,2825,+
chr7,5645786,7.4092741532462565,3799,622,4421,+
chr7,5645787,7.966842682834872,2825,374,3199,+
chr7,5645788,7.028943000483087,2763,457,3220,+
chr7,5645791,29.35830367418076,2354,1006,3360,+
chr7,5645792,28.891155128502614,4374,4040,8414,+
chr7,5645793,17.0300368449038,5624,6582,12206,+
chr7,5645794,16.706858405692383,4848,6462,11310,+
chr7,5645795,15.211862305335208,3651,6022,9673,+
chr7,5645802,0.25840743864425697,596,1352,1948,+
chr7,5645812,0.4168010752688172,442,619,1061,+
chr7,5645813,0.22807415815361332,273,880,1153,+
chr7,5645816,0.24613259668508283,296,904,1200,+
chr7,5645817,0.2914044865264377,520,1220,1740,+
chr7,5645819,0.39062751728714507,849,2179,3028,+
chr7,5645842,0.2658267295877481,852,1020,1872,+
chr7,5646048,2.9383336795830157,728,572,1300,+
chr7,5646141,0.7597760591575082,731,382,1113,+
chr7,5646192,1.981608784929917,715,486,1201,+
chr7,6054779,3.328591749644381,831,591,1422,+
chr7,6054783,1.8133735269936968,1017,711,1728,+
chr7,6054784,2.642903489599107,1432,972,2404,+
chr7,6054950,2.637,585,499,1084,+
chr7,6057535,3.8499162393910686,649,433,1082,+
chr7,6057586,1.1643527204502817,534,532,1066,+
chr7,6057587,0.7035266714315359,1400,1220,2620,+
chr7,6057589,0.5436120401337793,601,574,1175,+
chr7,6062948,1.9873617693522905,628,421,1049,+
chr7,6062949,0.606750075673494,632,582,1214,+
chr7,6062951,2.046204620462046,1084,605,1689,+
chr7,6063107,1.034101733663555,1356,1085,2441,+
chr7,6063108,1.034101733663555,1356,1085,2441,+
chr7,6063172,0.4740550928891736,739,445,1184,+
chr7,6063174,1.8259181605987853,1379,971,2350,+
chr7,6063176,0.5754123795525069,828,470,1298,+
chr7,6063218,2.413888677028803,892,573,1465,+
chr7,6185785,0.4460425440017277,694,440,1134,+
chr7,6441560,1.9803025334994644,745,581,1326,+
chr7,6442784,4.067815232888234,1253,972,2225,+
chr7,6442997,1.9348628691983123,666,473,1139,+
chr7,6624818,2.676002486587613,996,825,1821,+
chr7,6628457,0.3164882298650467,586,433,1019,+
chr7,6628497,1.2947716546923156,602,444,1046,+
chr7,10493035,2.098371607515657,697,478,1175,+
chr7,10493036,2.098371607515657,697,478,1175,+
chr7,10493063,1.8704473685168959,1934,1319,3253,+
chr7,10493065,1.22531442679317,2330,1622,3952,+
chr7,10493066,1.0451583325146545,1615,1130,2745,+
chr7,11080305,7.162978238090549,694,503,1197,+
chr7,12275066,2.547950287516231,807,598,1405,+
chr7,12275067,2.547950287516231,807,598,1405,+
chr7,16685863,2.2461700462013474,847,533,1380,+
chr7,16705069,2.2923066133669963,1107,678,1785,+
chr7,16705070,2.2923066133669963,1107,678,1785,+
chr7,16705074,1.655931293612453,616,413,1029,+
chr7,16720963,2.169918699186992,941,491,1432,+
chr7,16725571,1.925973068935486,776,648,1424,+
chr7,16729468,0.5744549568078979,587,571,1158,+
chr7,16729501,1.4501748251748252,1105,714,1819,+
chr7,16734473,1.536529389264312,926,758,1684,+
chr7,16734500,1.5569819229761594,1131,693,1824,+
chr7,16734569,2.112280701754386,601,512,1113,+
chr7,16734604,2.610169491525424,734,412,1146,+
chr7,16736558,1.731368383784741,630,537,1167,+
chr7,16736648,1.8582290900171698,946,603,1549,+
chr7,16737721,1.6649054063574786,1257,893,2150,+
chr7,16737771,0.6765095338983051,1309,943,2252,+
chr7,16745879,0.5948685460880583,625,450,1075,+
chr7,16818679,1.9348014722822828,560,469,1029,+
chr7,17384532,0.2951599451171837,803,454,1257,+
chr7,20421401,0.7959930175550614,705,493,1198,+
chr7,20449849,2.477777777777778,891,719,1610,+
chr7,22767199,2.104615024898165,572,431,1003,+
chr7,22767205,0.421013570822731,626,523,1149,+
chr7,22767206,1.2216555247632221,1274,1083,2357,+
chr7,22767236,1.640176600441501,742,603,1345,+
chr7,22768358,1.6249249249249247,772,665,1437,+
chr7,22768380,1.524611598215659,921,787,1708,+
chr7,22771187,2.3148,642,499,1141,+
chr7,22771190,1.6494082840236686,668,506,1174,+
chr7,22771293,1.6395563770794825,886,540,1426,+
chr7,22771434,4.274739583333333,1004,767,1771,+
chr7,23224750,2.8296122487675395,871,594,1465,+
chr7,23339188,14.758056461826932,1598,1091,2689,+
chr7,23339189,14.75805646182693,1598,1091,2689,+
chr7,23339190,9.036317567567568,822,591,1413,+
chr7,23339203,3.697656813848105,1405,1299,2704,+
chr7,23339204,3.837142835573576,1258,1143,2401,+
chr7,23339210,0.5240464344941957,552,535,1087,+
chr7,23339211,0.5240464344941957,552,535,1087,+
chr7,23340508,2.6136853448275863,538,463,1001,+
chr7,23340518,1.165382967300536,1105,846,1951,+
chr7,23340574,2.940886699507389,795,579,1374,+
chr7,23340601,2.429195804195804,793,623,1416,+
chr7,23340631,1.1157624444127487,1765,1309,3074,+
chr7,23347487,2.374770642201834,667,544,1211,+
chr7,23347490,1.5312399355877615,1027,689,1716,+
chr7,23348987,2.314814814814815,639,383,1022,+
chr7,23349002,1.7588796720870656,1285,979,2264,+
chr7,26241375,1.5951234479119512,1060,692,1752,+
chr7,26241400,1.18403455517451,1210,885,2095,+
chr7,26241410,1.7208264462809915,1076,549,1625,+
chr7,26241442,1.838813382701816,1480,850,2330,+
chr7,26241443,1.5628310062590274,1081,803,1884,+
chr7,26242590,1.6419963481436397,1721,1059,2780,+
chr7,26242594,1.311939133827546,2958,1863,4821,+
chr7,26242602,1.546445497630332,3262,2109,5371,+
chr7,26242603,0.5961205749268033,1747,1155,2902,+
chr7,26242613,1.7906774580335731,2541,1667,4208,+
chr7,26242616,1.3646920228879167,4283,2970,7253,+
chr7,26246006,0.8113375802980708,8519,5177,13696,+
chr7,26246024,1.75328771470679,12668,9452,22120,+
chr7,26246025,1.3064083499314982,25010,16464,41474,+
chr7,26248045,1.874277406280653,2963,1876,4839,+
chr7,26251371,1.4643415572712437,2757,2160,4917,+
chr7,26251704,1.2715205148833468,3131,2033,5164,+
chr7,26251868,1.554952762015431,2179,1197,3376,+
chr7,26251869,1.6757712772299238,3072,1637,4709,+
chr7,26251871,1.6444268693502775,5071,2581,7652,+
chr7,26251872,1.8382499060660464,2717,1408,4125,+
chr7,26251873,1.72554850654072,4179,2170,6349,+
chr7,26251883,1.830640482029143,2697,1736,4433,+
chr7,26251884,1.8835026112588515,2260,1356,3616,+
chr7,26251889,1.6272040804898182,3687,2371,6058,+
chr7,26251890,1.664922209855786,2603,1744,4347,+
chr7,26251894,2.007703435804701,1290,789,2079,+
chr7,26251911,1.7698961937716264,1022,832,1854,+
chr7,26251915,1.6225817712647557,3194,2480,5674,+
chr7,26252229,3.604144367203368,2178,1688,3866,+
chr7,26252230,4.317615935262994,894,713,1607,+
chr7,26252282,0.3975993998499625,1165,945,2110,+
chr7,26252565,2.0892408730925247,1247,1001,2248,+
chr7,27138876,3.634444956942684,598,483,1081,+
chr7,27139461,3.479634739843637,855,286,1141,+
chr7,27139462,4.003112880315437,1151,370,1521,+
chr7,27139463,4.003112880315437,1151,370,1521,+
chr7,27139475,21.57487361847007,1163,652,1815,+
chr7,27139476,19.288434059694417,1432,867,2299,+
chr7,27139489,8.676200423249073,1126,1205,2331,+
chr7,27139490,8.479694020528697,1366,1414,2780,+
chr7,27139534,1.2223267886310372,511,621,1132,+
chr7,27779776,1.8004698977937894,626,442,1068,+
chr7,27779799,2.417293656398614,753,595,1348,+
chr7,27788259,2.185345890242098,1080,1192,2272,+
chr7,27788260,2.185345890242098,1080,1192,2272,+
chr7,27788261,2.0234035258566205,2045,2052,4097,+
chr7,27788263,1.9062472464534317,745,872,1617,+
chr7,27809359,2.986111111111111,644,467,1111,+
chr7,27809448,2.5007125890736344,657,420,1077,+
chr7,27832736,0.6839447102604997,663,527,1190,+
chr7,27832769,3.3077174623937213,594,555,1149,+
chr7,27834005,2.133434804667681,579,437,1016,+
chr7,27834010,2.38133102852204,573,444,1017,+
chr7,27868587,2.2635790280261157,664,560,1224,+
chr7,27868637,0.5527868063079331,655,425,1080,+
chr7,27868704,2.1517447199265383,720,483,1203,+
chr7,30634553,1.7282732447817837,620,464,1084,+
chr7,30634729,2.823792729245795,770,387,1157,+
chr7,30634731,2.823792729245795,770,387,1157,+
chr7,30638492,1.8084265410814901,767,516,1283,+
chr7,30639581,2.122661122661123,1020,702,1722,+
chr7,30639612,1.5952455536077819,2790,1708,4498,+
chr7,30639631,0.6792452830188679,1385,1006,2391,+
chr7,30649280,0.5580357142857143,1414,1131,2545,+
chr7,30651844,1.8268613607188704,1154,778,1932,+
chr7,30655569,1.457610484080478,1051,706,1757,+
chr7,30655644,1.7833333333333334,855,524,1379,+
chr7,30655657,1.9017909188528823,2593,1861,4454,+
chr7,30655658,1.9400313971742544,1836,1273,3109,+
chr7,30656746,1.6502782137252108,1070,814,1884,+
chr7,30656775,1.565839243498818,1018,704,1722,+
chr7,30661018,2.149794238683128,652,485,1137,+
chr7,30661045,2.467408585055644,775,591,1366,+
chr7,30661079,0.4845557543231961,716,644,1360,+
chr7,30661096,0.9311628568939833,1733,1391,3124,+
chr7,30662048,0.6653939604304061,1277,945,2222,+
chr7,30671121,0.6354725659840105,1054,793,1847,+
chr7,30672010,1.9521776290674266,1622,1267,2889,+
chr7,30673369,1.83781512605042,728,679,1407,+
chr7,35872464,1.711684210526316,706,379,1085,+
chr7,35872467,2.0138209635442452,977,647,1624,+
chr7,35919457,1.7796252309316445,612,420,1032,+
chr7,35925482,2.1484803188839066,615,445,1060,+
chr7,35937956,2.40092914520591,1704,1098,2802,+
chr7,35937957,2.621173469387755,1232,783,2015,+
chr7,35937958,2.621173469387755,1232,783,2015,+
chr7,35942734,2.38012987012987,893,699,1592,+
chr7,35942736,2.38012987012987,893,699,1592,+
chr7,35943883,1.713159824046921,718,495,1213,+
chr7,35944063,1.3755892766359135,1047,723,1770,+
chr7,36435917,0.9855261018051716,605,472,1077,+
chr7,36435919,0.9855261018051716,605,472,1077,+
chr7,36438800,2.267523364485981,1293,855,2148,+
chr7,36438802,2.267523364485981,1293,855,2148,+
chr7,36438808,2.0106951871657754,751,441,1192,+
chr7,36438823,1.631468932710188,1724,1098,2822,+
chr7,36438826,2.040901213171577,919,576,1495,+
chr7,36438835,1.9665543168265491,1024,664,1688,+
chr7,36438837,0.671820426351921,1274,721,1995,+
chr7,36438844,1.5592053606803447,2720,1672,4392,+
chr7,36438856,1.02481506944084,2965,2079,5044,+
chr7,36438865,1.9142351900972587,1731,1391,3122,+
chr7,36445967,2.1610177665125225,723,552,1275,+
chr7,36447480,1.9420950306093878,901,723,1624,+
chr7,36450182,2.323687913801762,959,596,1555,+
chr7,36458906,2.3598638257909257,934,630,1564,+
chr7,36458907,0.6583512544802868,1311,774,2085,+
chr7,36458911,1.6464425690945028,2280,1628,3908,+
chr7,36458913,1.415925804290261,4875,3299,8174,+
chr7,36458914,1.8089842973563903,2394,1754,4148,+
chr7,36459854,1.7171201814058956,698,440,1138,+
chr7,36459914,2.995654108906863,1139,869,2008,+
chr7,36466619,1.635016835016835,606,395,1001,+
chr7,36466624,2.278645833333333,629,431,1060,+
chr7,36492157,1.7682072829131654,605,475,1080,+
chr7,36492454,1.6383082158483224,1010,560,1570,+
chr7,36492462,0.5534031967820472,1306,704,2010,+
chr7,36492469,0.5094722598105548,1505,738,2243,+
chr7,36492918,3.493203883495145,770,514,1284,+
chr7,39726340,11.801879493121453,1032,559,1591,+
chr7,39726341,24.879310344827584,591,579,1170,+
chr7,39726342,19.215443328817443,2999,2695,5694,+
chr7,39726343,19.922062034776914,2490,2476,4966,+
chr7,39726344,6.632686980609417,729,721,1450,+
chr7,39726363,0.3609937849435011,554,668,1222,+
chr7,39736417,2.644453090262339,970,691,1661,+
chr7,39745785,1.2821279777801518,705,406,1111,+
chr7,39745787,1.2821279777801518,705,406,1111,+
chr7,39746160,6.298151001540831,544,471,1015,+
chr7,39746161,6.298151001540831,544,471,1015,+
chr7,39746162,12.963290608850128,639,651,1290,+
chr7,42974615,0.47742537792195766,924,666,1590,+
chr7,42974668,2.098105263157895,905,569,1474,+
chr7,42974671,2.0651465798045603,950,613,1563,+
chr7,42974685,1.835901635391581,1330,875,2205,+
chr7,42976989,1.6367711573741726,2182,1790,3972,+
chr7,42977038,1.603045692634263,2029,1422,3451,+
chr7,42977039,1.603045692634263,2029,1422,3451,+
chr7,42977051,1.6169162995594717,591,453,1044,+
chr7,42977052,1.8684654300168635,1107,592,1699,+
chr7,43659218,2.512118018967334,595,510,1105,+
chr7,43830879,0.3806818181818182,602,439,1041,+
chr7,43830880,0.3806818181818182,602,439,1041,+
chr7,43843287,0.9882263891679548,715,501,1216,+
chr7,43843358,0.4127131963443739,708,418,1126,+
chr7,43843360,0.4127131963443739,708,418,1126,+
chr7,43846592,1.8558678518731784,972,750,1722,+
chr7,43846593,1.8558678518731784,972,750,1722,+
chr7,44507771,0.984900163775037,676,541,1217,+
chr7,44507918,0.6592496304225927,738,502,1240,+
chr7,44685034,0.9032153032153032,583,454,1037,+
chr7,44685035,0.9032153032153032,583,454,1037,+
chr7,44685043,1.1023066245628788,729,608,1337,+
chr7,44685064,2.2842505495538394,1113,776,1889,+
chr7,44714060,1.303668755684885,582,474,1056,+
chr7,44733573,0.3052601322219028,943,496,1439,+
chr7,44733574,0.3052601322219028,943,496,1439,+
chr7,44735640,2.0364741641337387,602,422,1024,+
chr7,44737338,2.178920993907509,614,441,1055,+
chr7,44748027,1.6645169036614784,1011,687,1698,+
chr7,44748028,1.6054446723664864,871,599,1470,+
chr7,44748509,51.6035300263195,880,532,1412,+
chr7,44748510,49.968717790213326,1110,855,1965,+
chr7,44748528,6.786330931852243,362,680,1042,+
chr7,44748539,0.18528346305022034,991,1378,2369,+
chr7,44748540,0.1792443739749656,886,1139,2025,+
chr7,44836277,0.8365252052872408,15947,4899,20846,+
chr7,44836278,0.9005090863265166,31937,13269,45206,+
chr7,44836279,0.9005090863265166,31937,13269,45206,+
chr7,44836282,1.9379055656518243,16338,6248,22586,+
chr7,44836348,1.6394547954727474,8281,2450,10731,+
chr7,44836366,1.8105851860939892,11249,4611,15860,+
chr7,44836380,1.581782310350254,26835,14425,41260,+
chr7,44836381,1.6542606591072357,15984,6930,22914,+
chr7,44836384,1.2255042699456469,8180,5593,13773,+
chr7,44838382,1.8206896551724137,639,463,1102,+
chr7,44838846,1.4008843294695024,32718,21928,54646,+
chr7,44839346,1.2294293699802235,37861,25759,63620,+
chr7,44840982,1.421889898647626,3505,1814,5319,+
chr7,44840986,1.3351886865256986,2196,1363,3559,+
chr7,44840991,1.5582374384595319,6353,3871,10224,+
chr7,44840992,1.6389569537053787,9351,5679,15030,+
chr7,44840994,1.7849748237663643,5103,3309,8412,+
chr7,44841010,1.445120313507268,5118,3504,8622,+
chr7,44841019,1.4423416347086817,7373,3763,11136,+
chr7,44841020,1.3693263922105063,17893,11465,29358,+
chr7,44841032,1.290095210383105,12197,7088,19285,+
chr7,44841033,1.3074191832662663,16144,10833,26977,+
chr7,44841035,1.3778668448007123,7292,4490,11782,+
chr7,44841040,1.2883843955024024,24038,14424,38462,+
chr7,44841041,1.1699859347837454,15905,11422,27327,+
chr7,44841042,1.344977312886813,15146,8662,23808,+
chr7,55223536,2.266109422492401,1146,699,1845,+
chr7,55223538,2.266109422492401,1146,699,1845,+
chr7,55225416,0.6765908831908831,585,468,1053,+
chr7,55274198,3.0603492131029104,2113,1331,3444,+
chr7,55274204,1.883613462560831,2349,1286,3635,+
chr7,55274205,1.883613462560831,2349,1286,3635,+
chr7,55274215,2.068210862619808,1176,625,1801,+
chr7,55274228,1.6300982366336487,4579,2801,7380,+
chr7,55274230,1.6974824120603011,3156,1989,5145,+
chr7,55274245,1.9067499106598558,2045,1412,3457,+
chr7,55274249,2.3100349696781906,2151,1557,3708,+
chr7,55274253,1.479653238143804,2417,1854,4271,+
chr7,55274621,2.031307686627778,785,466,1251,+
chr7,55274627,1.8406177348589128,2563,1552,4115,+
chr7,55274628,1.7084883923967005,2861,1701,4562,+
chr7,55274638,1.605745186296574,1092,743,1835,+
chr7,55274866,1.8422419614565475,864,620,1484,+
chr7,55274884,2.550570228091237,738,391,1129,+
chr7,55277684,2.898995362987123,1012,631,1643,+
chr7,55493094,1.5422750743865186,1278,945,2223,+
chr7,55840918,0.9695223549014164,797,553,1350,+
chr7,55840919,0.9695223549014164,797,553,1350,+
chr7,55840925,2.283878075651854,690,388,1078,+
chr7,55840927,3.6003800201601246,990,614,1604,+
chr7,55840974,2.213376835236541,847,612,1459,+
chr7,56020948,0.764890678385338,936,723,1659,+
chr7,56022604,1.6602498215986612,956,661,1617,+
chr7,56045837,0.4535278994203138,778,627,1405,+
chr7,56045861,4.485718915450024,629,521,1150,+
chr7,56046052,0.3941898476531179,580,522,1102,+
chr7,56049193,1.671008089965001,808,600,1408,+
chr7,56049918,2.6890380313199107,600,446,1046,+
chr7,56049920,2.638483965014577,904,685,1589,+
chr7,56049921,2.58974358974359,605,467,1072,+
chr7,56062605,0.5297719594594594,578,443,1021,+
chr7,56062609,1.7980597680642283,644,471,1115,+
chr7,56062631,1.0760526715957162,2788,2058,4846,+
chr7,56062632,1.0403816023866246,1446,1001,2447,+
chr7,56067070,2.239145183175034,942,736,1678,+
chr7,56067245,1.0873383908537237,1070,840,1910,+
chr7,56119480,1.713861264726559,959,546,1505,+
chr7,56119486,0.4470083487940631,770,351,1121,+
chr7,56119504,1.873098786295898,1015,565,1580,+
chr7,56119605,1.3636298387309178,1435,811,2246,+
chr7,56119608,1.5296442687747036,1061,505,1566,+
chr7,56119643,0.5402146001467351,560,463,1023,+
chr7,56119646,1.927019597410659,700,536,1236,+
chr7,56119661,2.0448529411764707,617,479,1096,+
chr7,56119667,1.827942132639792,881,768,1649,+
chr7,56119670,1.2060724874733575,1639,1224,2863,+
chr7,56120138,2.1643779463004718,879,696,1575,+
chr7,56120140,1.2896164264289895,3183,2087,5270,+
chr7,56125737,1.2186403451498706,3706,2672,6378,+
chr7,56126346,1.537894923677671,1332,938,2270,+
chr7,56128091,1.5730602742715798,960,742,1702,+
chr7,56128550,1.5138951209813312,4140,2949,7089,+
chr7,56128554,1.432955242879549,1575,1188,2763,+
chr7,56130768,1.9173510016175188,1162,845,2007,+
chr7,56130805,1.4917152542372882,1641,1249,2890,+
chr7,56130954,1.372755373202363,9521,6902,16423,+
chr7,56136174,2.057084607543323,1008,653,1661,+
chr7,56136175,2.057084607543323,1008,653,1661,+
chr7,56136215,3.057739360204484,1134,858,1992,+
chr7,56136232,0.5641211681480137,621,446,1067,+
chr7,56136283,2.0885913687508904,610,412,1022,+
chr7,56136304,2.7282608695652177,752,482,1234,+
chr7,56140703,0.6146240438253666,919,586,1505,+
chr7,56140797,1.1087906750849923,760,567,1327,+
chr7,56140798,1.1087906750849923,760,567,1327,+
chr7,56147300,1.5058198362939743,604,440,1044,+
chr7,56147361,0.551296093464768,754,497,1251,+
chr7,56147637,0.5951923773639591,1132,745,1877,+
chr7,56147824,0.9776666189785198,2484,1731,4215,+
chr7,56147825,0.9776666189785198,2484,1731,4215,+
chr7,56148070,0.2792803263589788,904,690,1594,+
chr7,56148077,0.7071762222091552,766,418,1184,+
chr7,56148079,0.9749033698078284,813,470,1283,+
chr7,56148080,2.258425373758522,1290,856,2146,+
chr7,56148084,1.7588087039841946,1889,1442,3331,+
chr7,56148085,1.474271579475341,2521,1924,4445,+
chr7,56148225,0.6108590810728803,1148,685,1833,+
chr7,56148226,0.7043104030967224,1171,656,1827,+
chr7,66420747,3.97603570867775,855,634,1489,+
chr7,66420756,4.37,620,599,1219,+
chr7,66420758,4.37,620,599,1219,+
chr7,66420762,2.3938397892823806,636,655,1291,+
chr7,66420765,1.901006923526584,772,747,1519,+
chr7,66420774,2.8253242111227888,732,690,1422,+
chr7,66420775,0.497393117831074,529,547,1076,+
chr7,66420790,1.5969477107830872,490,570,1060,+
chr7,73101029,0.5154954465135245,1516,1050,2566,+
chr7,73101030,0.5852017937219731,1214,891,2105,+
chr7,73101031,0.5469088185695691,2730,1941,4671,+
chr7,73101042,1.7395447165782068,1626,1065,2691,+
chr7,73101045,1.6379577101598763,793,553,1346,+
chr7,73101209,2.482084170126728,1668,1266,2934,+
chr7,73105277,2.711417713152677,886,711,1597,+
chr7,73105279,1.9662508121337643,1388,1049,2437,+
chr7,73107665,1.226461568775034,825,632,1457,+
chr7,73111959,3.978069446751952,583,462,1045,+
chr7,73111960,3.9707519141325545,929,724,1653,+
chr7,73111995,0.44348789905962643,747,606,1353,+
chr7,73602004,1.2344551777692891,1821,1185,3006,+
chr7,73602005,1.337426201604167,2741,1789,4530,+
chr7,73602007,1.81351555611538,1328,933,2261,+
chr7,73602009,1.5472620946305158,855,494,1349,+
chr7,73602018,1.507309090909091,1010,624,1634,+
chr7,73602021,1.861235806707156,761,540,1301,+
chr7,73602022,0.545352016404648,1181,835,2016,+
chr7,73602027,1.4236887894606014,1184,893,2077,+
chr7,73604011,2.964533111665281,822,400,1222,+
chr7,73604015,1.7307209557966172,1656,1015,2671,+
chr7,73604225,0.4755484740777056,775,397,1172,+
chr7,73609079,2.00131221719457,1922,974,2896,+
chr7,73609081,2.1165168448331717,2930,1511,4441,+
chr7,73609082,2.104037432585108,3036,1645,4681,+
chr7,73609084,1.9552921158667322,4204,2362,6566,+
chr7,73609085,2.2080306698950767,2117,1238,3355,+
chr7,73609088,2.4786367623104875,1098,693,1791,+
chr7,73609101,1.7214345052561488,3120,1806,4926,+
chr7,73609123,1.7610194317119385,2437,1324,3761,+
chr7,73609127,1.5624053775812996,1289,673,1962,+
chr7,73609128,1.8681136916014045,1676,1287,2963,+
chr7,73609135,1.8335301062573792,1552,846,2398,+
chr7,73609154,1.7519464775342595,10523,7025,17548,+
chr7,73609155,1.7519464775342595,10523,7025,17548,+
chr7,73609161,2.3320553984389747,8716,6462,15178,+
chr7,73609162,2.7244749296818416,5553,4397,9950,+
chr7,73609166,1.6091847769211987,7331,5231,12562,+
chr7,73609167,1.6091847769211987,7331,5231,12562,+
chr7,73609498,1.942684766214178,597,506,1103,+
chr7,73609557,2.68945945945946,641,369,1010,+
chr7,73609630,0.3233160621761657,623,385,1008,+
chr7,73609631,0.37099602701168727,1366,695,2061,+
chr7,73609875,1.0693374422187982,693,471,1164,+
chr7,73609876,1.0693374422187982,693,471,1164,+
chr7,73609890,2.1757084636608552,1427,959,2386,+
chr7,73609891,1.4788604771108127,1625,1025,2650,+
chr7,73609990,1.386252019732185,2055,1543,3598,+
chr7,73609991,0.5115656530990459,1027,856,1883,+
chr7,73609999,2.0173353509533074,1283,1008,2291,+
chr7,73610003,0.5100190407108531,749,537,1286,+
chr7,73610008,0.5035260670506573,1090,887,1977,+
chr7,73610010,0.5656155808022258,573,453,1026,+
chr7,73610015,1.6025,640,543,1183,+
chr7,73610352,4.071341463414634,606,409,1015,+
chr7,73610386,1.3416697017047126,1108,703,1811,+
chr7,73610521,8.319520881001438,3413,1751,5164,+
chr7,73610523,7.66103710632448,3927,2085,6012,+
chr7,73610526,18.802038284186313,2267,1694,3961,+
chr7,73610544,3.4445422535211274,601,567,1168,+
chr7,73610624,0.8511783618525357,1083,789,1872,+
chr7,73610664,2.077679669162848,640,388,1028,+
chr7,73610667,1.1065550999544398,1531,908,2439,+
chr7,73610669,1.1065550999544398,1531,908,2439,+
chr7,73610678,0.6448170731707318,845,655,1500,+
chr7,73610679,1.5573698658246493,2226,1631,3857,+
chr7,73610680,1.67920059215396,1193,964,2157,+
chr7,73610710,0.7629670191565379,2072,1525,3597,+
chr7,73611148,1.745369341200842,988,660,1648,+
chr7,73611169,1.7981499202551836,828,474,1302,+
chr7,73611172,2.369145569620253,650,394,1044,+
chr7,73611173,3.0373406193078325,919,548,1467,+
chr7,73611188,3.4830252100840333,941,594,1535,+
chr7,73611205,1.3906577062906245,1941,1251,3192,+
chr7,74105355,1.9773175542406312,801,506,1307,+
chr7,74105357,1.9773175542406312,801,506,1307,+
chr7,74131248,2.1036217303822937,614,496,1110,+
chr7,74131249,2.905920359345562,931,702,1633,+
chr7,74146959,2.943714303252262,702,479,1181,+
chr7,75583375,1.286720024525637,753,558,1311,+
chr7,75583451,1.778794813119756,635,413,1048,+
chr7,75583454,1.109703669342353,1011,699,1710,+
chr7,75583456,0.2576374126935924,706,444,1150,+
chr7,75609787,1.8160221354565604,591,482,1073,+
chr7,75611542,0.34452517430783275,666,427,1093,+
chr7,75611633,2.7639404143966053,588,431,1019,+
chr7,75612945,2.110919873833002,780,574,1354,+
chr7,75613121,2.658672884674154,1035,782,1817,+
chr7,75614470,3.090185676392573,698,347,1045,+
chr7,75614472,2.4014082469254885,886,489,1375,+
chr7,75615294,2.3350138886730956,602,417,1019,+
chr7,75615341,2.4289843909340907,715,459,1174,+
chr7,75615349,0.4192107222635889,562,473,1035,+
chr7,75615753,0.7692585895117541,708,473,1181,+
chr7,75615754,0.7692585895117541,708,473,1181,+
chr7,75684158,1.7798833819241984,725,538,1263,+
chr7,75684186,0.4430558424567927,756,617,1373,+
chr7,75684196,1.032567084078712,1722,1299,3021,+
chr7,75684197,1.854914933837429,784,643,1427,+
chr7,75684198,1.032567084078712,1722,1299,3021,+
chr7,75684202,0.6990972442191955,1192,769,1961,+
chr7,75684209,1.5601639059925418,1410,886,2296,+
chr7,75684211,2.2882548573429022,1256,984,2240,+
chr7,75684213,1.3690016083731429,1652,1081,2733,+
chr7,75684214,1.789134115723711,1750,1037,2787,+
chr7,75684219,0.7391891891891892,1640,1294,2934,+
chr7,75684284,0.5658730158730159,850,739,1589,+
chr7,75684289,1.5881185376661746,982,676,1658,+
chr7,75687358,0.5392035233546306,914,657,1571,+
chr7,75689692,1.0058748023696193,2053,1731,3784,+
chr7,75692899,2.498069271107032,1732,1385,3117,+
chr7,75693741,2.958333333333333,638,485,1123,+
chr7,75694130,2.569948186528497,867,578,1445,+
chr7,75694183,1.8492377663606503,997,765,1762,+
chr7,75695596,1.4927279874213837,1084,847,1931,+
chr7,75695693,1.7506628531694373,1742,1326,3068,+
chr7,75695755,0.5040262745180778,1747,1280,3027,+
chr7,75931991,0.7905970343985248,1926,1162,3088,+
chr7,75932089,2.49057075059323,766,470,1236,+
chr7,75932216,0.509815977391372,2165,1117,3282,+
chr7,75932217,0.509815977391372,2165,1117,3282,+
chr7,75932218,2.3433246988199503,1095,736,1831,+
chr7,75932219,2.3433246988199503,1095,736,1831,+
chr7,75932229,2.037914188615123,618,427,1045,+
chr7,75932243,2.355769230769231,734,493,1227,+
chr7,75932245,2.355769230769231,734,493,1227,+
chr7,75932299,0.5284064231383229,661,462,1123,+
chr7,75932318,1.752344877344877,1004,503,1507,+
chr7,75932327,1.8415131753386025,3554,2421,5975,+
chr7,75932328,1.9038465120610968,1596,1192,2788,+
chr7,75932330,3.435648148148148,904,674,1578,+
chr7,75932384,1.587550054605024,889,669,1558,+
chr7,75933157,1.5491420337946993,886,618,1504,+
chr7,75933173,1.281808015098898,2486,1981,4467,+
chr7,75933174,1.4824774427140592,3081,2137,5218,+
chr7,75933175,1.617068988260124,1065,721,1786,+
chr7,75933315,1.6999962168501497,1095,800,1895,+
chr7,75933404,1.8062224232646846,835,582,1417,+
chr7,75933413,1.8579166666666664,636,399,1035,+
chr7,75933421,1.793103448275862,727,461,1188,+
chr7,75933427,2.1921553398058253,1007,514,1521,+
chr7,77261668,2.521951219512195,751,409,1160,+
chr7,77261680,1.9191050779286072,930,662,1592,+
chr7,77261700,3.617304264363088,1146,857,2003,+
chr7,77261704,1.877661344858107,4097,2815,6912,+
chr7,77261705,2.0244005209530376,2577,2060,4637,+
chr7,77261707,1.5768076294692048,1659,848,2507,+
chr7,77261713,1.5505193523475125,6940,3883,10823,+
chr7,77261714,1.5505193523475125,6940,3883,10823,+
chr7,79828611,0.9626928471248248,571,459,1030,+
chr7,79828613,1.6528085724984793,831,701,1532,+
chr7,79828614,0.7514156029110688,968,688,1656,+
chr7,79828616,1.2822770239171726,995,783,1778,+
chr7,79828622,3.08875128998968,948,740,1688,+
chr7,79828623,3.08875128998968,948,740,1688,+
chr7,79847290,0.6357333333333334,595,524,1119,+
chr7,79847292,0.7158640817177402,605,532,1137,+
chr7,86824433,1.6253043346384592,667,430,1097,+
chr7,86824741,0.9090734739843774,1539,1039,2578,+
chr7,86824751,1.3731399272086444,3698,2633,6331,+
chr7,86824752,1.3731399272086444,3698,2633,6331,+
chr7,86824753,2.0391113082695647,1969,1523,3492,+
chr7,87536959,0.5008802782558582,1089,532,1621,+
chr7,87536969,2.0078952284788913,2621,1346,3967,+
chr7,87536971,2.0078952284788913,2621,1346,3967,+
chr7,87537420,3.994729683781027,660,462,1122,+
chr7,92087763,1.6103080066409683,809,536,1345,+
chr7,92087766,1.0413630406290957,763,544,1307,+
chr7,92087768,0.8869751931414801,1082,754,1836,+
chr7,93438340,2.8287800775888607,1035,741,1776,+
chr7,93438382,1.8782542022724897,1270,994,2264,+
chr7,93551184,1.6138745588364176,734,503,1237,+
chr7,93551354,6.1708477806310995,875,478,1353,+
chr7,93551355,6.1708477806310995,875,478,1353,+
chr7,93551363,0.526691242249437,784,420,1204,+
chr7,93551365,0.6039245984292252,2079,1064,3143,+
chr7,93551417,1.8987760680864523,2148,1131,3279,+
chr7,93551419,2.066149597795708,2781,1531,4312,+
chr7,93551445,1.60343594836147,1582,1324,2906,+
chr7,93551446,2.080588180714897,2947,1920,4867,+
chr7,93551447,1.9022008930242937,4529,3244,7773,+
chr7,93551527,1.722091987860946,1722,1078,2800,+
chr7,94297824,2.163102582323814,1365,848,2213,+
chr7,94297825,2.301545692850041,877,480,1357,+
chr7,94297832,1.0274952876307548,1131,795,1926,+
chr7,94297837,2.246525990735975,1163,803,1966,+
chr7,94297839,2.246525990735975,1163,803,1966,+
chr7,94297876,1.5265195104090383,1215,868,2083,+
chr7,98931035,2.185483870967742,541,464,1005,+
chr7,98935803,2.705521472392638,566,488,1054,+
chr7,98946493,2.0378852134577325,635,392,1027,+
chr7,98951620,2.89868182597409,581,466,1047,+
chr7,98955980,0.3805060251039803,602,482,1084,+
chr7,98957188,1.6339507306796914,1370,982,2352,+
chr7,98957189,1.6339507306796914,1370,982,2352,+
chr7,98983383,0.5621847939861072,843,677,1520,+
chr7,98983385,0.5621847939861072,843,677,1520,+
chr7,98983389,1.9501179245283018,718,423,1141,+
chr7,98984324,1.7875,896,551,1447,+
chr7,98984346,1.5568905013977283,817,730,1547,+
chr7,98985814,2.204974949459436,677,366,1043,+
chr7,98985819,2.1036795930566528,1293,879,2172,+
chr7,98985861,1.6666921606118543,680,522,1202,+
chr7,98987546,0.5425788580109016,827,588,1415,+
chr7,98988576,1.0945630359423464,1046,718,1764,+
chr7,98988597,1.8455175497429022,634,496,1130,+
chr7,98988715,0.4577522559474979,588,436,1024,+
chr7,98988819,2.481099022681173,584,492,1076,+
chr7,98988824,1.1883800312258332,1721,1147,2868,+
chr7,98990342,2.5398316062176165,681,385,1066,+
chr7,98991724,0.4886770428015564,660,513,1173,+
chr7,98991725,0.5953125,761,543,1304,+
chr7,98992171,19.532499483340562,5954,4018,9972,+
chr7,98992172,19.53249948334056,5954,4018,9972,+
chr7,98992173,5.908534173610379,3122,1995,5117,+
chr7,98992175,4.658827047437413,3513,2977,6490,+
chr7,98992194,0.6387694638123455,924,846,1770,+
chr7,98992263,4.813975258308222,3352,3129,6481,+
chr7,99007656,2.6617999596485786,546,483,1029,+
chr7,99008690,1.074514519964751,2792,2089,4881,+
chr7,99013823,0.532260377462247,1155,836,1991,+
chr7,99013829,1.6575692126448067,602,462,1064,+
chr7,99013847,2.6857762627827704,641,460,1101,+
chr7,99686639,2.2783049204158425,571,448,1019,+
chr7,99686680,4.64836979562331,1102,1055,2157,+
chr7,99687237,2.2885034379048426,956,796,1752,+
chr7,99687249,2.288171992689681,964,799,1763,+
chr7,99687270,0.5393323874425112,1297,899,2196,+
chr7,99687271,0.5664488017429193,584,458,1042,+
chr7,99687285,1.9294964028776975,893,555,1448,+
chr7,99688075,0.499099494838568,1747,784,2531,+
chr7,99688078,1.5959929359780618,5126,3328,8454,+
chr7,99688079,1.5381607727277977,11639,6644,18283,+
chr7,99688080,1.5464732960772092,9120,5214,14334,+
chr7,99688230,1.7839140916063994,813,675,1488,+
chr7,99688251,2.089746368957295,722,658,1380,+
chr7,99688895,0.9912536443148688,1036,853,1889,+
chr7,99688896,1.4241877247825252,1697,1216,2913,+
chr7,99689052,2.507086235887581,993,723,1716,+
chr7,99689053,2.507086235887581,993,723,1716,+
chr7,99689056,0.5857643903445431,675,654,1329,+
chr7,99689325,1.8396076352067865,770,491,1261,+
chr7,99689350,0.6100840336134454,692,509,1201,+
chr7,99689403,1.666021790041747,605,426,1031,+
chr7,99689469,2.466136002916095,909,678,1587,+
chr7,99689573,2.6669711985528317,651,422,1073,+
chr7,99689591,1.1596582420688433,1073,691,1764,+
chr7,99751491,1.3029314390713527,965,639,1604,+
chr7,99751508,2.7254731724257684,653,442,1095,+
chr7,99751579,0.9876479670612455,807,535,1342,+
chr7,99751581,0.9876479670612455,807,535,1342,+
chr7,99751616,2.7928286852589643,700,501,1201,+
chr7,99751618,2.7928286852589643,700,501,1201,+
chr7,100199979,1.2273545522571672,828,571,1399,+
chr7,100199985,0.7125542786390667,680,400,1080,+
chr7,100199986,0.4584335739107191,685,644,1329,+
chr7,100200139,2.555292965307606,1059,734,1793,+
chr7,100200142,1.9980062802870677,1112,803,1915,+
chr7,100200143,1.8414473173383028,846,476,1322,+
chr7,100201057,2.364765100671141,782,595,1377,+
chr7,100201086,1.6348399588552067,1317,786,2103,+
chr7,100201134,0.6353669641231107,1067,866,1933,+
chr7,100201150,1.8790477937803876,1153,990,2143,+
chr7,100201708,2.126829268292683,653,491,1144,+
chr7,100201735,2.0914798206278027,582,445,1027,+
chr7,100202719,0.5792592592592593,781,404,1185,+
chr7,100202785,1.6713538045101246,1604,1091,2695,+
chr7,100202815,1.6908457396262275,627,573,1200,+
chr7,100203308,1.7282608695652175,635,463,1098,+
chr7,100203320,1.3918802726824324,2806,1984,4790,+
chr7,100203409,2.505736337088027,774,563,1337,+
chr7,100203426,2.03298909925416,745,580,1325,+
chr7,100204046,1.6083419421487604,1174,703,1877,+
chr7,100204061,1.455754412130251,1325,893,2218,+
chr7,100204089,0.6100073071436029,1491,990,2481,+
chr7,100204190,2.0625,923,543,1466,+
chr7,100205119,1.5555555555555558,935,701,1636,+
chr7,100205324,0.5790864477161193,1120,882,2002,+
chr7,100205325,1.5783330050088642,2171,1617,3788,+
chr7,100205423,1.5109911530964162,1071,854,1925,+
chr7,100205667,2.210551948051948,800,615,1415,+
chr7,100274384,3.4488964925067545,595,433,1028,+
chr7,100276174,5.187319884726224,809,346,1155,+
chr7,100276175,5.187319884726224,809,346,1155,+
chr7,100304462,2.830181136833504,647,469,1116,+
chr7,100304463,2.830181136833504,647,469,1116,+
chr7,100465581,28.65846569211804,1308,1103,2411,+
chr7,100465582,27.640274282648882,1764,1719,3483,+
chr7,100465583,28.666625840853897,1563,1667,3230,+
chr7,100468241,9.34925804285983,2170,1742,3912,+
chr7,100468242,9.34925804285983,2170,1742,3912,+
chr7,100468243,7.608917136323822,1169,1127,2296,+
chr7,100468249,5.732760331753974,905,885,1790,+
chr7,100470257,0.5644044902050291,1239,984,2223,+
chr7,100470933,1.6121583538105586,571,505,1076,+
chr7,100481825,1.2345228843342029,847,717,1564,+
chr7,100481832,3.3126355611601515,692,528,1220,+
chr7,100485082,0.9407758958524994,526,521,1047,+
chr7,100804070,0.7360022443865804,627,481,1108,+
chr7,100804412,9.483768828856322,1155,693,1848,+
chr7,100804413,9.483768828856322,1155,693,1848,+
chr7,100804502,5.755927464787066,505,822,1327,+
chr7,100804503,5.712567343313595,564,986,1550,+
chr7,100865968,1.9862839614373355,1041,814,1855,+
chr7,100865969,1.9862839614373355,1041,814,1855,+
chr7,100865970,1.5632490545360247,1501,1051,2552,+
chr7,100866761,2.6274054865565715,620,430,1050,+
chr7,100867113,0.9151771805582434,1097,1051,2148,+
chr7,100867115,0.7815576498616122,1286,1172,2458,+
chr7,100867116,1.2613063831094522,1370,1146,2516,+
chr7,100867294,2.6174029451137883,610,497,1107,+
chr7,100867296,1.710405694536095,1331,1138,2469,+
chr7,100867297,0.8116124336310926,1192,988,2180,+
chr7,100867352,2.461538461538461,573,532,1105,+
chr7,100867354,2.461538461538461,573,532,1105,+
chr7,100953781,3.332435889962166,801,401,1202,+
chr7,102937976,0.5098692033293698,1071,869,1940,+
chr7,102937982,1.606353260435789,1040,736,1776,+
chr7,102940686,1.684854994629431,712,398,1110,+
chr7,102944339,2.415763546798029,612,405,1017,+
chr7,102952678,1.7966834895457822,622,437,1059,+
chr7,102988110,0.5618181818181819,617,439,1056,+
chr7,102988111,0.5894305194047604,1189,909,2098,+
chr7,102988125,1.9769107785772972,1531,1093,2624,+
chr7,102988156,0.6377520759193357,781,561,1342,+
chr7,102988188,2.065296106772513,988,710,1698,+
chr7,102994383,2.038331600831601,580,480,1060,+
chr7,102996216,3.057871729753517,1475,1000,2475,+
chr7,103003153,1.585167837626854,922,548,1470,+
chr7,103004680,1.8241255312193525,557,482,1039,+
chr7,103006539,2.6885467314964884,806,616,1422,+
chr7,103006541,2.6885467314964884,806,616,1422,+
chr7,103006550,1.7284169770100766,1334,938,2272,+
chr7,103006583,1.756916996047431,761,505,1266,+
chr7,103007956,0.5704365079365079,1494,863,2357,+
chr7,103007957,1.5938875206911862,1066,526,1592,+
chr7,103007966,1.4660012964660123,1900,1077,2977,+
chr7,103007967,1.990651113884632,2703,1738,4441,+
chr7,103007969,1.584733788164569,5513,3277,8790,+
chr7,103007979,1.5778301308007558,1168,866,2034,+
chr7,103008245,1.6077434966727162,1207,724,1931,+
chr7,104310889,1.0242148581556885,680,573,1253,+
chr7,106842144,2.8757334734764046,1039,789,1828,+
chr7,107557406,0.345206776807324,728,441,1169,+
chr7,107557780,1.833988439306358,660,345,1005,+
chr7,107557845,2.357125799980896,1672,1101,2773,+
chr7,107559462,1.228377121599628,717,525,1242,+
chr7,111967866,2.63265306122449,644,489,1133,+
chr7,111967868,2.63265306122449,644,489,1133,+
chr7,111981035,3.310468521852185,575,435,1010,+
chr7,112101946,0.6285140562248996,625,497,1122,+
chr7,112108039,1.843843843843844,613,406,1019,+
chr7,115892420,2.290562036055143,674,409,1083,+
chr7,115892421,2.290562036055143,674,409,1083,+
chr7,116166714,1.4611704882426875,672,583,1255,+
chr7,116339549,0.7129407747164832,1029,547,1576,+
chr7,116528195,0.3154171364436917,672,435,1107,+
chr7,116544234,2.1567236375362784,626,442,1068,+
chr7,116552175,0.408785799522673,608,418,1026,+
chr7,116556143,2.984375,763,511,1274,+
chr7,116556144,2.984375,763,511,1274,+
chr7,116557964,0.5485714285714286,663,414,1077,+
chr7,116558379,1.887515356265356,792,591,1383,+
chr7,117831979,3.6087297848955884,675,578,1253,+
chr7,127230162,3.4846153846153847,754,649,1403,+
chr7,127230163,3.4846153846153847,754,649,1403,+
chr7,127230170,3.113406195064249,869,707,1576,+
chr7,127231681,14.558263555204878,765,386,1151,+
chr7,127231682,12.618659715273319,975,466,1441,+
chr7,127231693,11.627055211038169,1511,981,2492,+
chr7,127231694,12.031684916530892,1624,1041,2665,+
chr7,127231700,15.225162365611002,1366,1246,2612,+
chr7,127231701,15.225162365611002,1366,1246,2612,+
chr7,127231704,7.767609183243385,532,552,1084,+
chr7,127326757,2.277640228271186,1229,954,2183,+
chr7,127326758,2.6068965517241383,671,579,1250,+
chr7,127334954,1.6722620599739246,661,471,1132,+
chr7,127334975,2.148908857509628,647,491,1138,+
chr7,127338951,1.9865591397849462,738,557,1295,+
chr7,127339004,1.7399202481169695,1121,731,1852,+
chr7,127341266,2.2009981851179674,692,463,1155,+
chr7,127341315,0.6095965103598692,558,523,1081,+
chr7,127341369,0.540381187440011,562,441,1003,+
chr7,127342488,1.8971224853577795,595,461,1056,+
chr7,127342544,1.961697308819611,1201,833,2034,+
chr7,127342545,1.961697308819611,1201,833,2034,+
chr7,127343223,1.0289458929072048,1938,1188,3126,+
chr7,127343224,0.911484664492624,2678,1750,4428,+
chr7,127343252,0.2723225806451613,937,619,1556,+
chr7,127343253,2.151557824326703,718,597,1315,+
chr7,127343259,1.5694426892455455,1128,771,1899,+
chr7,127343274,0.5784766029564071,1279,816,2095,+
chr7,127344898,2.032285882956393,1804,1269,3073,+
chr7,127344977,1.929099152047569,1838,1336,3174,+
chr7,127447541,0.6299823633156966,892,647,1539,+
chr7,127447579,1.9958847736625516,678,566,1244,+
chr7,127528034,1.8911934716082963,617,518,1135,+
chr7,127569246,2.1986778631409685,1171,771,1942,+
chr7,127569287,3.864010989010989,581,545,1126,+
chr7,127714569,2.725015247887079,694,498,1192,+
chr7,127714571,3.3599124020272253,1640,1185,2825,+
chr7,127714578,3.4176117108817823,1143,882,2025,+
chr7,127714591,0.2706095791001451,677,529,1206,+
chr7,127714593,0.2706095791001451,677,529,1206,+
chr7,127714665,1.1798740718026455,762,572,1334,+
chr7,127714694,1.765595617692748,616,452,1068,+
chr7,127721538,2.50645292759136,737,432,1169,+
chr7,127724844,2.742399784772666,702,530,1232,+
chr7,127724893,1.940052700922266,588,505,1093,+
chr7,127729579,0.9063374090945416,1030,872,1902,+
chr7,127729580,0.9063374090945416,1030,872,1902,+
chr7,127729649,1.3415094365237055,1062,752,1814,+
chr7,127729724,1.044049291968436,1232,956,2188,+
chr7,127729725,1.044049291968436,1232,956,2188,+
chr7,127729736,1.7774603174603176,508,524,1032,+
chr7,127732265,7.471397746467269,1000,395,1395,+
chr7,127732274,26.834760163626097,3278,2047,5325,+
chr7,127732275,26.834760163626097,3278,2047,5325,+
chr7,127732294,8.642880059409126,3334,3158,6492,+
chr7,127732295,8.642880059409126,3334,3158,6492,+
chr7,127732481,0.5551724876335682,893,696,1589,+
chr7,127732555,1.9229079497907953,592,477,1069,+
chr7,128119454,0.8762761476404656,721,482,1203,+
chr7,128119456,0.8762761476404656,721,482,1203,+
chr7,128379461,1.2222850018971736,1017,714,1731,+
chr7,128379479,1.8465631929046558,693,450,1143,+
chr7,128379480,0.6361780030981552,694,525,1219,+
chr7,128388631,1.6318252730109206,1045,640,1685,+
chr7,128388676,2.662483191393994,1187,872,2059,+
chr7,128388695,1.9245036572622773,1250,956,2206,+
chr7,128388702,1.4009131797737495,1347,1011,2358,+
chr7,128394329,1.7779485209373802,1067,821,1888,+
chr7,128394440,1.719038588390501,1016,757,1773,+
chr7,128394483,1.4077773055673608,1249,723,1972,+
chr7,128394748,2.7420494699646643,678,565,1243,+
chr7,128398925,1.4638296403672262,1742,1316,3058,+
chr7,128398990,1.2741206156589002,1625,1230,2855,+
chr7,128407654,1.5091587944219524,2020,1424,3444,+
chr7,128407689,1.223774387574172,5522,3457,8979,+
chr7,128409138,1.4925692083535693,1969,1449,3418,+
chr7,128409198,1.8632017950343882,1388,1078,2466,+
chr7,128409199,1.8527752363525465,1278,1092,2370,+
chr7,128409486,1.2740053718314588,3372,2219,5591,+
chr7,128409520,1.432701873652794,1749,1303,3052,+
chr7,128409808,2.299753289473684,1315,911,2226,+
chr7,128409823,1.4762026612077788,1281,976,2257,+
chr7,128410148,1.8508735868448098,1304,972,2276,+
chr7,128410630,0.16938189457734107,647,469,1116,+
chr7,128410632,0.3587837674752505,976,727,1703,+
chr7,128410637,1.3737416777629827,991,750,1741,+
chr7,128410638,1.3737416777629827,991,750,1741,+
chr7,128410639,1.57685031079083,2813,2020,4833,+
chr7,128410641,1.1026009639769465,2488,1977,4465,+
chr7,128410642,1.2422859542918707,2145,1934,4079,+
chr7,128410643,0.9400279260151873,2193,1412,3605,+
chr7,128410644,1.0493164330284697,3716,2790,6506,+
chr7,128410646,1.0131751687921982,2400,1332,3732,+
chr7,128410647,1.1792961711952363,6241,4052,10293,+
chr7,128410649,1.1214092331493266,2585,1433,4018,+
chr7,128410653,1.5321357285429142,1671,1001,2672,+
chr7,128410655,1.99515716374269,1984,1367,3351,+
chr7,128410709,0.636317907444668,1264,1007,2271,+
chr7,128410890,1.8001310494222396,3011,2092,5103,+
chr7,128411007,2.183750038165805,5476,4102,9578,+
chr7,128411009,1.7291368071593984,4952,3675,8627,+
chr7,128411230,1.440030268634128,1037,880,1917,+
chr7,128411315,1.5586640022837568,1399,1129,2528,+
chr7,128502908,0.9944134433669448,1169,966,2135,+
chr7,128502909,0.8728403553834102,1975,1404,3379,+
chr7,128502914,0.6044315837173875,1949,1151,3100,+
chr7,128502917,0.5252475319973183,1391,896,2287,+
chr7,128502918,1.362055768179333,1383,707,2090,+
chr7,128502943,2.0734264867704506,1616,1164,2780,+
chr7,128502944,1.4862442040185473,2403,1293,3696,+
chr7,128502969,2.7509334260025686,12750,7660,20410,+
chr7,128502970,2.7372494010245085,14180,8678,22858,+
chr7,128502971,2.0716190477568643,5863,3319,9182,+
chr7,128502986,1.6926467641755158,2303,1952,4255,+
chr7,128502995,1.682244028798279,4543,2876,7419,+
chr7,128502998,1.8833160454968167,3694,1996,5690,+
chr7,128503000,1.8833160454968167,3694,1996,5690,+
chr7,128503008,1.3318530128874957,4369,2551,6920,+
chr7,128503009,1.1312030212868882,9844,6873,16717,+
chr7,128503012,1.4225968148906247,5058,3274,8332,+
chr7,128503029,1.3833488011080384,7288,4945,12233,+
chr7,128503037,1.677856032023274,23994,19198,43192,+
chr7,128503038,1.778772831214061,4100,3317,7417,+
chr7,128503039,1.1436892764851796,15366,10942,26308,+
chr7,128503041,0.8225441952506597,10718,7579,18297,+
chr7,128503042,1.2004514251512126,10996,8873,19869,+
chr7,128503043,1.2988878274976603,17185,14049,31234,+
chr7,128503045,1.34940967457338,33271,25993,59264,+
chr7,128503046,1.3401589990253173,27660,21439,49099,+
chr7,128503052,1.654228598365221,15028,13847,28875,+
chr7,128503053,0.961063639238806,57133,46725,103858,+
chr7,128503054,0.6718582434629814,46323,36015,82338,+
chr7,128503059,1.1960661714343708,18454,15161,33615,+
chr7,128503060,0.6250089157921266,9919,6932,16851,+
chr7,128505606,3.482739559538452,608,476,1084,+
chr7,128505718,1.9146370870508798,793,637,1430,+
chr7,128505821,1.8782470169703311,984,738,1722,+
chr7,132959803,3.777659021277947,652,412,1064,+
chr7,133002089,3.599856204717352,591,439,1030,+
chr7,133749529,38.089491432443765,1146,485,1631,+
chr7,133749530,30.68147666841517,1435,969,2404,+
chr7,133749533,7.967601062043752,756,1112,1868,+
chr7,134363977,2.116253101736973,921,519,1440,+
chr7,134363978,2.106791236719366,1344,795,2139,+
chr7,134364010,3.40725178960473,754,458,1212,+
chr7,134364012,3.3695408734602466,648,516,1164,+
chr7,134364017,2.165546844066503,2233,1698,3931,+
chr7,134364018,2.210549258936356,1382,1146,2528,+
chr7,134625979,3.114353206867528,674,443,1117,+
chr7,134632470,2.3450744278708884,715,382,1097,+
chr7,134632493,3.7509829619921367,635,435,1070,+
chr7,134632494,3.123743742180023,1255,780,2035,+
chr7,134632503,1.6677243001152289,1416,823,2239,+
chr7,134635143,1.6414728682170543,2309,1504,3813,+
chr7,134635145,1.6414728682170543,2309,1504,3813,+
chr7,134635149,1.6299284797359253,1110,797,1907,+
chr7,134635153,1.764636282179746,1902,1281,3183,+
chr7,134635174,1.7830162668872342,891,467,1358,+
chr7,134635178,1.755103176443311,2056,1134,3190,+
chr7,134635179,1.755103176443311,2056,1134,3190,+
chr7,134635191,1.576745014245014,1264,863,2127,+
chr7,134635198,1.8590840711238257,1395,988,2383,+
chr7,134635209,0.6542561469839366,2717,2160,4877,+
chr7,134635211,1.6776925453047775,1649,1213,2862,+
chr7,134635221,2.622488945041061,1886,1582,3468,+
chr7,134653256,2.932616446233468,667,508,1175,+
chr7,134653374,1.5879261884846259,860,603,1463,+
chr7,134654448,2.6103338355117844,687,516,1203,+
chr7,134655243,2.5068791771094405,669,547,1216,+
chr7,135272650,2.938900438900439,726,480,1206,+
chr7,135287696,2.515914137675796,617,385,1002,+
chr7,135287697,2.624799525830516,1094,775,1869,+
chr7,135303198,0.939704440397815,704,532,1236,+
chr7,135304594,5.861139721287323,639,445,1084,+
chr7,135307526,3.4153002202887848,628,449,1077,+
chr7,135307589,1.6944918352425056,1544,745,2289,+
chr7,135307590,1.6944918352425056,1544,745,2289,+
chr7,135359074,2.8928571428571432,647,367,1014,+
chr7,135359076,2.8928571428571432,647,367,1014,+
chr7,137198563,0.946554589350131,88977,72946,161923,+
chr7,137198564,0.9465545893501309,88977,72946,161923,+
chr7,139083358,2.6147686885230543,713,511,1224,+
chr7,139086904,1.0274347033812512,596,448,1044,+
chr7,139086906,1.0274347033812512,596,448,1044,+
chr7,139086940,2.91548055005629,556,447,1003,+
chr7,139094334,2.1470063846098606,913,696,1609,+
chr7,139094388,2.155033382467701,730,606,1336,+
chr7,139102393,2.253567328194194,915,468,1383,+
chr7,139102395,2.253567328194194,915,468,1383,+
chr7,139102403,2.6000081753994797,787,455,1242,+
chr7,139102423,2.21366550895004,1440,787,2227,+
chr7,139102425,2.21366550895004,1440,787,2227,+
chr7,139102436,2.401178125549499,880,516,1396,+
chr7,139102445,1.683941058941059,898,571,1469,+
chr7,139102461,1.8605514958213893,1123,798,1921,+
chr7,139106921,1.4060943112038002,1516,958,2474,+
chr7,139106927,1.5234305923961098,1722,1130,2852,+
chr7,139106947,1.6941997063142438,2484,1815,4299,+
chr7,139106992,1.8984962406015042,1009,839,1848,+
chr7,139107005,2.220113851992409,1169,1053,2222,+
chr7,139107238,3.7634776256237448,979,686,1665,+
chr7,139107793,10.81406022381425,1587,1461,3048,+
chr7,139107794,11.455778652525499,1408,1341,2749,+
chr7,140396536,5.020982030951415,763,642,1405,+
chr7,140396537,4.769148547602588,873,738,1611,+
chr7,140396543,0.23254404009300683,663,519,1182,+
chr7,140402682,1.0213675213675213,1194,701,1895,+
chr7,140402684,1.0213675213675213,1194,701,1895,+
chr7,140402696,2.021649582071866,1171,836,2007,+
chr7,140402703,2.0456078368395696,771,478,1249,+
chr7,140402720,1.5395256916996043,819,505,1324,+
chr7,140402790,1.6143249468462082,984,663,1647,+
chr7,141438169,1.524981536624606,699,495,1194,+
chr7,141438170,1.3372057550050631,694,499,1193,+
chr7,141438178,0.5082814930015552,768,642,1410,+
chr7,141438200,0.7836470877788371,2083,1551,3634,+
chr7,141438224,2.4784602158754416,836,550,1386,+
chr7,141438225,25.716594816044307,1444,964,2408,+
chr7,141442024,1.923852357320099,826,623,1449,+
chr7,141443733,1.7106382978723407,669,563,1232,+
chr7,141443738,1.8356539095281772,1913,1618,3531,+
chr7,141443780,1.6118604651162791,1194,999,2193,+
chr7,142960637,3.463306505030916,905,627,1532,+
chr7,142962144,2.410215311375299,711,530,1241,+
chr7,142962182,1.2848506550538266,818,463,1281,+
chr7,142962375,2.594959488048542,1095,588,1683,+
chr7,142964715,2.763234438627109,874,572,1446,+
chr7,142964716,2.763234438627109,874,572,1446,+
chr7,142965962,0.5733085289650024,563,454,1017,+
chr7,143080226,2.2636075161526152,647,423,1070,+
chr7,148464739,1.598899653279707,1187,797,1984,+
chr7,148481077,2.8144629189759827,687,420,1107,+
chr7,148481078,2.8144629189759827,687,420,1107,+
chr7,148481098,2.4591893271577274,976,576,1552,+
chr7,148481117,0.406015037593985,629,379,1008,+
chr7,148481118,0.9275354446194795,682,448,1130,+
chr7,148481119,0.9275354446194795,682,448,1130,+
chr7,148485663,2.0366773874319644,2532,1879,4411,+
chr7,148485664,1.827389958293914,3992,2802,6794,+
chr7,148485667,1.8349124460538717,1369,1060,2429,+
chr7,148485676,1.5206828235213745,2094,1345,3439,+
chr7,148495755,2.372804767768717,626,461,1087,+
chr7,148497726,2.4803976879827663,837,573,1410,+
chr7,148638579,0.993568760583693,1664,1486,3150,+
chr7,148638625,0.8576917482851847,4497,3422,7919,+
chr7,148638626,1.0001933123707685,3243,2208,5451,+
chr7,150070296,0.4597883118122612,620,487,1107,+
chr7,150070297,0.4597883118122612,620,487,1107,+
chr7,150070320,3.821465756123361,708,491,1199,+
chr7,150070379,1.6723981900452491,846,714,1560,+
chr7,150070380,1.6932088241086545,1342,1044,2386,+
chr7,150070514,1.2052964042759962,725,503,1228,+
chr7,150070515,1.2052964042759962,725,503,1228,+
chr7,150070543,0.3547418967587035,590,475,1065,+
chr7,150070550,1.8573619631901843,691,325,1016,+
chr7,150070556,2.088572655339508,1361,958,2319,+
chr7,150070557,2.088572655339508,1361,958,2319,+
chr7,150784094,0.7434616406391723,728,493,1221,+
chr7,151791523,1.026439393939394,796,439,1235,+
chr7,151791525,0.8192789001122336,1119,636,1755,+
chr7,151791531,2.092400822678795,709,485,1194,+
chr7,155090000,1.2415834493952538,707,482,1189,+
chr7,155090268,2.2402082614501686,786,528,1314,+
chr7,155093290,1.8413318875567892,1547,1194,2741,+
chr7,155093307,0.6255173999693393,858,592,1450,+
chr7,155093331,1.6771373536820269,1077,793,1870,+
chr7,155094099,1.6154966168700557,1776,1268,3044,+
chr7,155094111,1.9232906764168192,796,546,1342,+
chr7,155094545,1.948585200392752,1179,658,1837,+
chr7,155099960,1.4555190744215134,1298,737,2035,+
chr7,155099995,2.4867150507619464,1794,986,2780,+
chr7,155100001,1.3919974258183463,2388,1291,3679,+
chr7,155100018,1.3863718600135562,5726,3283,9009,+
chr7,155100019,1.3811397477990448,8962,5188,14150,+
chr7,155100021,1.0536302097764676,23157,13047,36204,+
chr7,155100022,0.8843208691818039,29813,16782,46595,+
chr7,155100023,0.9143997147155805,37223,21254,58477,+
chr7,155100024,0.6599344325933251,14273,7328,21601,+
chr7,155100025,0.9734797775629452,14066,8544,22610,+
chr7,155100031,1.868386861895173,9459,6224,15683,+
chr7,155100032,1.868386861895173,9459,6224,15683,+
chr7,155100037,1.6517219207734617,10415,6291,16706,+
chr7,155100042,1.65851358519479,12662,6497,19159,+
chr7,155100044,1.65851358519479,12662,6497,19159,+
chr7,155100079,1.683761930876259,1962,1505,3467,+
chr7,155100146,1.8966841399487995,840,630,1470,+
chr7,155100227,0.560431654676259,778,555,1333,+
chr7,155100456,2.091173361522199,771,687,1458,+
chr7,155100458,2.091173361522199,771,687,1458,+
chr7,155100466,0.6092221704704238,653,451,1104,+
chr7,155100560,2.1265813618136478,1294,900,2194,+
chr7,155100642,1.0594311880127367,1430,1236,2666,+
chr7,155100777,1.85831856166118,1128,717,1845,+
chr7,155100808,0.5474867965762157,1949,1291,3240,+
chr7,155100809,1.1501822262042276,3628,2106,5734,+
chr7,155100815,2.062259348691509,1999,1392,3391,+
chr7,155100857,1.5325526647837553,6888,3393,10281,+
chr7,155100884,2.273714230595938,19081,10567,29648,+
chr7,155100886,2.273714230595938,19081,10567,29648,+
chr7,155101190,1.482860358305198,1107,842,1949,+
chr7,155101313,2.5720502901353965,590,516,1106,+
chr7,155101518,2.009807126511932,635,398,1033,+
chr7,155101529,2.2681397432069272,632,393,1025,+
chr7,155101556,1.803425774877651,736,612,1348,+
chr7,155101647,0.6905621096460793,962,654,1616,+
chr7,155101861,2.0429495073891624,576,447,1023,+
chr7,156967665,1.9201307189542485,793,449,1242,+
chr7,156967669,1.9045998442816972,1702,961,2663,+
chr7,156974923,2.9094771772466452,631,577,1208,+
chr7,157023958,2.5359032501889645,670,440,1110,+
chr7,157023959,1.9381394799241154,931,644,1575,+
chr7,157060692,0.3560577528205409,1114,754,1868,+
chr7,157061183,8.27370673929542,1167,812,1979,+
chr7,157061184,9.547158446792904,1280,935,2215,+
chr8,1874555,0.3096851261517184,672,341,1013,+
chr8,1874582,2.6285162618301507,1179,735,1914,+
chr8,6614976,2.5805916696154507,614,419,1033,+
chr8,11660305,1.393360433604336,790,491,1281,+
chr8,11660306,2.4952380952380957,654,349,1003,+
chr8,11660307,1.848013801268871,1193,681,1874,+
chr8,11660374,1.989733399569465,750,548,1298,+
chr8,11660399,1.9850074074074082,816,674,1490,+
chr8,11660429,0.5030623608017817,555,448,1003,+
chr8,11660431,1.7016470588235295,790,594,1384,+
chr8,11666335,0.5723229706390328,963,578,1541,+
chr8,11666391,3.073737373737374,1073,659,1732,+
chr8,11667191,0.5292420161600615,785,677,1462,+
chr8,11667199,1.5643888016855583,2007,1480,3487,+
chr8,11667225,2.491004366812228,1096,686,1782,+
chr8,11667251,1.419632632495076,1191,765,1956,+
chr8,11667255,2.7759740259740258,1394,1022,2416,+
chr8,11683617,1.4437843858642454,1449,1117,2566,+
chr8,11683640,2.0785066733820194,1394,1082,2476,+
chr8,11683656,1.4247262773722629,1387,1095,2482,+
chr8,11687825,1.50317738791423,1306,949,2255,+
chr8,11687858,2.147573399819456,1280,1081,2361,+
chr8,11687862,1.3537800383037708,3400,2818,6218,+
chr8,11689036,1.465758378103615,5433,4034,9467,+
chr8,11689045,0.43700079244882867,4783,3365,8148,+
chr8,11689090,0.6053901850362028,1504,903,2407,+
chr8,11695906,1.5895058122553891,1490,1291,2781,+
chr8,11695992,2.0589549339549342,1246,935,2181,+
chr8,11696020,1.6420964174075678,2532,1818,4350,+
chr8,11696059,1.876134356430719,3863,2832,6695,+
chr8,11696115,2.661497124701078,2075,1463,3538,+
chr8,17143912,1.1235491339147607,673,540,1213,+
chr8,17406255,3.1381591381591383,592,480,1072,+
chr8,17406256,2.709898446103022,903,742,1645,+
chr8,17406258,2.458605664488017,609,509,1118,+
chr8,17423490,1.6791791791791792,989,665,1654,+
chr8,17423503,1.7379297242683571,2140,1630,3770,+
chr8,17423504,1.862843111461896,3267,2533,5800,+
chr8,17423506,1.928272154245458,2212,1739,3951,+
chr8,17423517,2.144464720194647,1281,1095,2376,+
chr8,17425363,1.4445913289643764,614,420,1034,+
chr8,17425896,3.3436225895316816,801,519,1320,+
chr8,17427669,1.9541130709114,587,459,1046,+
chr8,17794841,2.546117263113281,1175,626,1801,+
chr8,19192356,0.950560316413975,720,517,1237,+
chr8,19192358,0.950560316413975,720,517,1237,+
chr8,19253363,1.9617572254335258,1073,864,1937,+
chr8,19253364,2.210439340308284,1394,1069,2463,+
chr8,19253367,2.8305264754968897,582,506,1088,+
chr8,19253370,1.9892424921559835,1267,1163,2430,+
chr8,19253371,2.0136897657492927,1657,1426,3083,+
chr8,19677965,2.6755852842809364,639,459,1098,+
chr8,19681458,0.5740822644847412,825,645,1470,+
chr8,19688015,1.7142857142857142,626,398,1024,+
chr8,19689539,2.145532490974729,770,553,1323,+
chr8,19694614,2.0120956901110163,1023,700,1723,+
chr8,19700387,2.3722986247544204,689,508,1197,+
chr8,19797000,5.384321912779303,669,445,1114,+
chr8,19810823,1.2123052728880215,718,545,1263,+
chr8,19810910,0.482421875,645,511,1156,+
chr8,19811800,1.6922953451043339,810,444,1254,+
chr8,19813422,2.3342594889605555,1000,694,1694,+
chr8,19813423,2.3342594889605555,1000,694,1694,+
chr8,19816795,1.5098261526832957,1019,755,1774,+
chr8,19816881,2.5052116236393576,1253,865,2118,+
chr8,19818424,0.5012094823415579,776,584,1360,+
chr8,19818493,1.6381486953600484,1932,1321,3253,+
chr8,19818560,1.9729209062542397,1191,818,2009,+
chr8,19818566,1.858454977857963,1258,870,2128,+
chr8,19818567,1.730537634408602,1237,774,2011,+
chr8,19818580,2.078505881707324,3123,2229,5352,+
chr8,19822945,1.6616411270390508,746,577,1323,+
chr8,19823072,2.1761991816836423,861,546,1407,+
chr8,19823157,2.208864118895966,573,470,1043,+
chr8,19823238,1.9749565217391305,834,574,1408,+
chr8,19823420,1.8476837865055389,894,661,1555,+
chr8,19823479,2.9191146881287726,805,496,1301,+
chr8,19823518,2.6700531580120552,1352,1051,2403,+
chr8,19823758,3.491578947368421,641,569,1210,+
chr8,19823777,1.7869759143621766,625,589,1214,+
chr8,19823868,1.938094134013448,642,453,1095,+
chr8,19823933,2.1416826380790335,1599,1154,2753,+
chr8,19823940,2.0435922330097087,678,514,1192,+
chr8,19823946,3.6246980676328495,685,551,1236,+
chr8,19824075,0.6263106388927723,895,621,1516,+
chr8,19824127,2.160864345738295,1199,832,2031,+
chr8,19824128,1.4380962824871146,995,828,1823,+
chr8,19824136,2.2939778129952457,964,630,1594,+
chr8,19824183,2.066532258064516,614,464,1078,+
chr8,19824226,1.8946445372848915,1246,938,2184,+
chr8,22103065,4.805733603805073,720,441,1161,+
chr8,22103067,3.7101563229731456,628,393,1021,+
chr8,22103070,2.701766176618978,731,445,1176,+
chr8,22103082,2.8502879078694816,629,520,1149,+
chr8,22103084,2.327509757896185,793,676,1469,+
chr8,22103090,0.6097209241758902,1497,1242,2739,+
chr8,22103091,0.6573724007561437,1283,1057,2340,+
chr8,22103092,0.6573724007561437,1283,1057,2340,+
chr8,22103099,0.6063965884861408,631,468,1099,+
chr8,22103104,1.6819134743663045,705,582,1287,+
chr8,22103106,1.0132615441742037,1660,1018,2678,+
chr8,22103107,1.0132615441742037,1660,1018,2678,+
chr8,22103116,1.9321822342417307,2063,1770,3833,+
chr8,22103117,1.6623789371042317,2589,2165,4754,+
chr8,22103118,0.580414428972007,976,793,1769,+
chr8,22103121,1.726426110530114,2223,1769,3992,+
chr8,22106078,0.525342511979483,555,448,1003,+
chr8,22106079,0.525342511979483,555,448,1003,+
chr8,22106090,3.921363040629096,883,762,1645,+
chr8,22106091,3.921363040629096,883,762,1645,+
chr8,22106123,2.3774748458292763,585,473,1058,+
chr8,25101192,2.347826086956521,839,643,1482,+
chr8,25101193,2.073667394190311,1151,906,2057,+
chr8,25101194,2.073667394190311,1151,906,2057,+
chr8,25101195,1.3684047496111493,1820,1344,3164,+
chr8,25101197,1.3736720256308983,1953,1222,3175,+
chr8,25101198,1.9564172985905948,1591,1025,2616,+
chr8,28019573,2.7645944741532973,708,527,1235,+
chr8,28019575,2.5327982713381694,1093,835,1928,+
chr8,28019577,2.339732792854214,1185,842,2027,+
chr8,30013884,0.8984090285809404,1069,818,1887,+
chr8,30021630,1.2471162038891048,1100,742,1842,+
chr8,30034670,0.4201769690927218,612,471,1083,+
chr8,30040873,2.076655261420253,934,616,1550,+
chr8,33357981,0.97419995038452,747,555,1302,+
chr8,33357983,0.97419995038452,747,555,1302,+
chr8,33358011,1.7175324675324677,712,433,1145,+
chr8,33358020,1.6785547785547785,757,571,1328,+
chr8,33358021,2.098672566371681,836,564,1400,+
chr8,37888059,1.963132142439464,1103,887,1990,+
chr8,37888061,1.3580004145450868,2429,2089,4518,+
chr8,37888062,0.8816506762105094,1326,1202,2528,+
chr8,37888085,1.992119089316988,584,570,1154,+
chr8,37888091,1.640290519877676,612,435,1047,+
chr8,37888187,2.8512846168561277,638,403,1041,+
chr8,37914607,1.8424070901914054,650,462,1112,+
chr8,37914613,0.7681153251323088,807,572,1379,+
chr8,37914619,1.9189034540158136,996,711,1707,+
chr8,37914736,0.492560144625226,758,458,1216,+
chr8,37914749,1.7880758210271106,1769,1046,2815,+
chr8,37914751,1.7880758210271106,1769,1046,2815,+
chr8,37914761,1.40316849274504,1052,613,1665,+
chr8,37917448,1.4151801554788557,1370,1068,2438,+
chr8,37917510,2.4462474645030428,937,492,1429,+
chr8,37917537,1.7197518817953723,1049,843,1892,+
chr8,37917584,2.3744591275874165,751,502,1253,+
chr8,37917592,1.6591591591591592,1954,1034,2988,+
chr8,37917593,1.6876337224831701,2730,1601,4331,+
chr8,37917710,1.8194680249009625,642,464,1106,+
chr8,37917726,2.565187239944521,1369,1029,2398,+
chr8,37917728,2.565187239944521,1369,1029,2398,+
chr8,37917759,1.6283849918433935,712,612,1324,+
chr8,38865404,3.309474709864448,664,509,1173,+
chr8,38865405,1.4955168052886576,653,480,1133,+
chr8,38873673,1.2776977874493518,986,710,1696,+
chr8,38874844,2.185955137907809,1015,767,1782,+
chr8,38874845,2.628865979381444,883,775,1658,+
chr8,38874847,2.895344506517691,597,536,1133,+
chr8,38876374,2.4743824924198976,824,599,1423,+
chr8,38912028,1.0151403409830375,899,622,1521,+
chr8,38912029,1.3820030923374373,1126,800,1926,+
chr8,38913198,1.2354652101823478,914,748,1662,+
chr8,38940502,1.6349572389775036,734,542,1276,+
chr8,38947568,3.3282828282828287,658,527,1185,+
chr8,38947569,3.3282828282828287,658,527,1185,+
chr8,38961292,2.3548087899543377,942,583,1525,+
chr8,38961294,2.3548087899543377,942,583,1525,+
chr8,38961681,1.580574912891986,763,573,1336,+
chr8,38962295,0.4950700570835495,635,375,1010,+
chr8,40011000,0.9875612371796672,871,259,1130,+
chr8,40011001,1.0591341148122293,1085,326,1411,+
chr8,40011010,2.587689669228083,813,335,1148,+
chr8,40011011,2.508979287379748,741,450,1191,+
chr8,40011014,6.007692307692307,709,324,1033,+
chr8,40011016,6.007692307692307,709,324,1033,+
chr8,40011025,0.8909757214841961,777,766,1543,+
chr8,40011027,0.8909757214841961,777,766,1543,+
chr8,40011147,1.5200671140939597,780,595,1375,+
chr8,40011148,0.6022143698468786,1161,848,2009,+
chr8,40011162,1.9174854779890413,4886,4012,8898,+
chr8,40011163,1.9174854779890413,4886,4012,8898,+
chr8,40011166,1.750154334597407,881,781,1662,+
chr8,40011169,1.4179803425804423,4089,3676,7765,+
chr8,40011170,1.4939068100358424,2083,1952,4035,+
chr8,40011172,1.2198982888001724,2556,2277,4833,+
chr8,40011177,2.203512396694215,947,725,1672,+
chr8,40011181,1.5078544009147583,1748,1596,3344,+
chr8,40011184,1.1893547786186778,10217,8958,19175,+
chr8,40011185,1.2239247275281535,7816,7049,14865,+
chr8,40011186,1.0701245487951612,2401,1909,4310,+
chr8,40011191,0.6767862930795856,2918,2530,5448,+
chr8,40011193,1.200638309356311,12598,11634,24232,+
chr8,40011194,1.276151168624287,10949,10394,21343,+
chr8,40011550,1.414904783325836,1347,987,2334,+
chr8,40011811,5.126740301968433,4942,1563,6505,+
chr8,40011812,5.126740301968434,4942,1563,6505,+
chr8,40011817,18.052422657181,5105,2565,7670,+
chr8,40011818,18.052422657181,5105,2565,7670,+
chr8,40011821,3.066643777281781,2674,1742,4416,+
chr8,40011826,16.086231789825977,5618,7634,13252,+
chr8,40011827,16.08623178982598,5618,7634,13252,+
chr8,40011832,0.4867405693052342,4219,8191,12410,+
chr8,40011833,0.46024766329484323,1922,4050,5972,+
chr8,40011836,0.21625905797101452,954,2207,3161,+
chr8,40011871,0.5024946543121881,1268,2012,3280,+
chr8,40012003,1.8014343974124596,853,546,1399,+
chr8,40012074,2.1369651142808044,828,528,1356,+
chr8,42026913,2.3091575091575094,1181,935,2116,+
chr8,42026914,2.3091575091575094,1181,935,2116,+
chr8,42026915,2.3091575091575094,1181,935,2116,+
chr8,42026999,3.4901954777802238,650,475,1125,+
chr8,42186688,2.0038230884557717,675,482,1157,+
chr8,42251375,2.106211869107044,774,600,1374,+
chr8,42251376,2.106211869107044,774,600,1374,+
chr8,42256285,2.09312693498452,625,424,1049,+
chr8,42256379,3.0608249825215568,795,612,1407,+
chr8,42260922,2.726851851851852,797,503,1300,+
chr8,42260946,1.6264876632801162,722,529,1251,+
chr8,42262912,2.321266968325792,683,571,1254,+
chr8,42263000,1.9218708254847177,1268,847,2115,+
chr8,42263022,1.8757505773672056,654,432,1086,+
chr8,42263027,3.031578633899309,1106,790,1896,+
chr8,42263084,1.8471635150166847,873,619,1492,+
chr8,42939975,2.0287232682097835,627,490,1117,+
chr8,48875563,3.0708333333333333,736,479,1215,+
chr8,48879979,2.2785431653843804,963,641,1604,+
chr8,48880004,2.0528326897847795,842,617,1459,+
chr8,48883206,1.836027387077448,718,479,1197,+
chr8,48883250,2.0796559325536617,1159,648,1807,+
chr8,48883252,2.538429771027394,921,588,1509,+
chr8,48883255,2.0335871025526195,955,637,1592,+
chr8,48883258,2.6403162055335967,1001,712,1713,+
chr8,48883269,0.2889414236931967,824,485,1309,+
chr8,48883276,0.5085673959068455,1125,544,1669,+
chr8,48883277,1.5667893931245602,1305,1050,2355,+
chr8,48883282,1.5641189918511234,4844,3165,8009,+
chr8,48883294,1.867749419953596,1679,861,2540,+
chr8,48883309,0.5796193425006829,2447,2084,4531,+
chr8,48883324,0.9794078258408017,5110,3586,8696,+
chr8,48883334,1.8653557806950198,5616,3984,9600,+
chr8,48883335,1.8653557806950198,5616,3984,9600,+
chr8,48883344,1.240957924864121,10910,7881,18791,+
chr8,48883347,1.4119006431129923,7905,4735,12640,+
chr8,48883349,1.4119006431129923,7905,4735,12640,+
chr8,48888363,1.6886343105855304,874,593,1467,+
chr8,48889861,1.357001512218602,819,537,1356,+
chr8,48890336,3.4742942050520056,865,672,1537,+
chr8,48890337,3.4742942050520056,865,672,1537,+
chr8,48890347,1.7784034034034033,1630,1035,2665,+
chr8,48890349,1.7784034034034033,1630,1035,2665,+
chr8,48962447,1.8855128541313033,971,653,1624,+
chr8,48973719,1.7563232160744902,684,582,1266,+
chr8,55049102,1.3463387061744114,673,411,1084,+
chr8,55049181,1.2611873838615142,829,638,1467,+
chr8,55055299,2.247107810572269,661,419,1080,+
chr8,55060229,2.3441295546558703,578,436,1014,+
chr8,55060345,2.464873879508026,738,532,1270,+
chr8,56864656,1.9137313580044548,633,506,1139,+
chr8,59477577,2.279220779220779,701,373,1074,+
chr8,59477578,2.3858502086350186,913,530,1443,+
chr8,59477587,0.4469254443816343,748,548,1296,+
chr8,59477588,0.4350018282246313,1041,768,1809,+
chr8,59483480,2.0609418282548475,650,531,1181,+
chr8,59484767,1.6232332155477032,734,565,1299,+
chr8,59490723,1.779281220896885,1728,1225,2953,+
chr8,59494424,1.8306390262457206,712,477,1189,+
chr8,59494426,2.5448275862068965,737,463,1200,+
chr8,59494443,1.2164666931728865,2169,1523,3692,+
chr8,59494456,1.5956367326230338,739,656,1395,+
chr8,61533331,3.2753736642280606,821,495,1316,+
chr8,62490701,0.8432134894712442,766,1011,1777,+
chr8,62490702,0.8432134894712442,766,1011,1777,+
chr8,62490705,0.5324435229636391,584,600,1184,+
chr8,67342878,27.401767131883492,1500,1726,3226,+
chr8,67342879,27.401767131883492,1500,1726,3226,+
chr8,73944341,3.3859090909090908,572,439,1011,+
chr8,73944342,3.3859090909090908,572,439,1011,+
chr8,74209568,0.6271418816083782,921,664,1585,+
chr8,74235226,1.8435203094777561,705,469,1174,+
chr8,74235493,1.5367606412382533,833,602,1435,+
chr8,74235746,1.66875,978,659,1637,+
chr8,74236155,1.3743254219930092,756,537,1293,+
chr8,74893827,2.2937193160656846,672,402,1074,+
chr8,82195700,0.8143478509474995,664,426,1090,+
chr8,82665444,1.9660484342777829,780,443,1223,+
chr8,82665467,2.5216614482516753,830,526,1356,+
chr8,90936786,1.100172289085673,745,629,1374,+
chr8,90936787,0.5162790697674419,776,664,1440,+
chr8,90936788,0.5162790697674419,776,664,1440,+
chr8,90936789,0.1885263157894736,596,499,1095,+
chr8,90938348,6.478661997453429,1289,476,1765,+
chr8,90938349,6.478661997453429,1289,476,1765,+
chr8,90938352,22.786379694983868,1313,1295,2608,+
chr8,90938354,10.657240396846264,2012,2187,4199,+
chr8,90938355,4.995942003194958,1366,1584,2950,+
chr8,94934477,0.5573430692876272,670,382,1052,+
chr8,96057864,2.344094094094094,985,665,1650,+
chr8,96057865,2.344094094094094,985,665,1650,+
chr8,97307436,1.588450748866518,647,492,1139,+
chr8,97311967,2.2196854659389524,692,433,1125,+
chr8,97311998,1.58285461776403,596,437,1033,+
chr8,97345762,0.3090704285067264,750,553,1303,+
chr8,97345804,1.763504101532271,843,496,1339,+
chr8,97345827,3.54066985645933,591,455,1046,+
chr8,97345830,1.6888446215139443,627,501,1128,+
chr8,97345893,2.9360410830999064,661,356,1017,+
chr8,97346208,1.122396015352137,668,477,1145,+
chr8,97346494,3.081456953642384,845,603,1448,+
chr8,97506131,3.2356140027145024,947,651,1598,+
chr8,97614730,0.5739850427350427,613,467,1080,+
chr8,97620672,2.461446503287508,567,477,1044,+
chr8,97622494,2.067289719626168,631,427,1058,+
chr8,98703227,0.984817372907722,832,486,1318,+
chr8,98703229,0.984817372907722,832,486,1318,+
chr8,98718925,1.367634882066146,820,565,1385,+
chr8,98718926,2.5428202894851637,971,633,1604,+
chr8,98718944,2.3830094673685616,664,481,1145,+
chr8,98735158,1.5830272142959514,842,724,1566,+
chr8,98735159,0.4479259391134057,591,547,1138,+
chr8,98736876,0.5186528497409326,636,385,1021,+
chr8,98736911,0.6219751471550033,633,416,1049,+
chr8,98737016,1.5055702917771885,1055,753,1808,+
chr8,98788241,2.0254616909851255,764,499,1263,+
chr8,98827594,2.701978545887962,1317,838,2155,+
chr8,98827624,0.5053288582700347,612,458,1070,+
chr8,98828286,1.804246841761041,1417,1135,2552,+
chr8,98828391,2.477821610699509,695,546,1241,+
chr8,98831455,1.8614066020600202,1823,1229,3052,+
chr8,98863700,3.672751859364435,581,492,1073,+
chr8,98863734,1.062852242097525,1387,1165,2552,+
chr8,98863736,1.2565536522897736,1851,1513,3364,+
chr8,98863765,0.4633421289956244,866,636,1502,+
chr8,98864060,1.4149963475944254,1342,966,2308,+
chr8,101162865,0.9350036310820624,617,458,1075,+
chr8,101162866,0.7894288082221846,820,582,1402,+
chr8,101162883,1.7760992488817622,914,696,1610,+
chr8,101162884,1.7845107677190117,1380,1014,2394,+
chr8,101162904,3.128340365682138,573,473,1046,+
chr8,101163593,1.701112877583466,534,517,1051,+
chr8,101164074,1.8048454350603162,1262,932,2194,+
chr8,101164100,2.6223776223776225,799,571,1370,+
chr8,101165869,2.305005990242211,651,459,1110,+
chr8,101165879,2.272024729520865,734,646,1380,+
chr8,101165880,2.272024729520865,734,646,1380,+
chr8,104433242,1.2367057936027852,1560,1076,2636,+
chr8,104438292,2.39936638915494,2881,1938,4819,+
chr8,104438293,2.39936638915494,2881,1938,4819,+
chr8,104447917,0.7471654189123252,762,577,1339,+
chr8,104447983,2.5033858337757926,743,554,1297,+
chr8,104453783,0.4205419032512335,890,749,1639,+
chr8,107752659,3.526309912127182,683,517,1200,+
chr8,107764480,2.119838678328134,762,529,1291,+
chr8,109455885,3.7237580479471672,675,371,1046,+
chr8,109462129,0.4414481897627965,815,533,1348,+
chr8,109465343,0.5142730796895965,790,598,1388,+
chr8,109482134,2.44794019511511,797,568,1365,+
chr8,109488126,2.37890625,695,511,1206,+
chr8,109489034,1.1528682170542637,857,644,1501,+
chr8,109489035,1.1528682170542637,857,644,1501,+
chr8,109498810,2.544016762542462,1495,1008,2503,+
chr8,109498812,2.9568764568764565,943,623,1566,+
chr8,110346568,2.0311237997051284,674,374,1048,+
chr8,110346607,1.1261694109227742,876,776,1652,+
chr8,110346659,0.5816642823080591,696,465,1161,+
chr8,110348359,0.5167427701674276,581,437,1018,+
chr8,110348363,1.8036437246963564,593,415,1008,+
chr8,110348366,2.0436241610738257,608,446,1054,+
chr8,110351552,2.008393544758361,1054,796,1850,+
chr8,110352729,1.4941430711426538,1192,946,2138,+
chr8,110355676,2.7186507936507938,662,503,1165,+
chr8,110563093,4.314290175130042,676,382,1058,+
chr8,110563097,2.3481818546354742,710,420,1130,+
chr8,110566148,0.4829924348557018,662,414,1076,+
chr8,110566958,2.727817047817048,1561,924,2485,+
chr8,110566959,2.8681946624803767,2403,1469,3872,+
chr8,110566961,2.826011335745107,2270,1329,3599,+
chr8,110566965,1.854878048780488,675,327,1002,+
chr8,118543035,1.2773137566561554,560,488,1048,+
chr8,118552261,0.5,582,423,1005,+
chr8,120256035,1.0897878212868726,664,373,1037,+
chr8,120256036,1.0897878212868726,664,373,1037,+
chr8,120257536,3.2667553451089244,791,580,1371,+
chr8,121530215,2.2168264693575415,966,551,1517,+
chr8,121530216,2.077601954105119,819,488,1307,+
chr8,124113047,1.0814398330628332,690,453,1143,+
chr8,124113048,1.0814398330628332,690,453,1143,+
chr8,124113060,1.498469540773072,924,691,1615,+
chr8,124113065,1.575648148148148,1121,1079,2200,+
chr8,124113066,1.7299212414605332,1714,1459,3173,+
chr8,124113078,1.588292810116681,785,528,1313,+
chr8,124194913,0.4967641958556904,582,424,1006,+
chr8,124194935,0.6716930236824803,1513,1016,2529,+
chr8,124194938,0.8431115287914663,730,576,1306,+
chr8,124195023,1.2383956992181877,1468,907,2375,+
chr8,124195028,1.887702387702388,1222,857,2079,+
chr8,124195029,1.887702387702388,1222,857,2079,+
chr8,124195046,2.0436084150536042,1260,827,2087,+
chr8,124195140,1.838284600389864,841,512,1353,+
chr8,124195148,2.123328204521245,689,496,1185,+
chr8,124195236,2.588726513569937,619,478,1097,+
chr8,124195301,2.025709434877516,575,433,1008,+
chr8,124195365,1.5457169396233117,1014,581,1595,+
chr8,124195381,3.2014435695538057,696,380,1076,+
chr8,124195446,1.1200268621400538,1394,1018,2412,+
chr8,124195449,0.536063285248953,639,613,1252,+
chr8,124195468,1.3307618229686082,2499,1977,4476,+
chr8,124195469,1.6234564070741544,1777,1464,3241,+
chr8,124195487,0.6186411427612507,3634,2426,6060,+
chr8,124195489,0.5843591697074195,2185,1466,3651,+
chr8,124195567,1.718233774367807,1290,722,2012,+
chr8,124204085,1.3618794717220248,2673,1866,4539,+
chr8,124204098,1.7805118994162552,861,654,1515,+
chr8,124204125,1.6405614587432769,1013,692,1705,+
chr8,124204187,1.6127805424940715,2188,1461,3649,+
chr8,124204193,0.6700949367088608,846,631,1477,+
chr8,124206294,1.8509316770186333,1787,1287,3074,+
chr8,124206383,0.7054096777026434,1889,1157,3046,+
chr8,124219520,2.3714865256447406,743,405,1148,+
chr8,124219579,3.051282051282051,730,386,1116,+
chr8,124219888,0.47685884933940154,736,390,1126,+
chr8,124219980,0.6172869497619279,604,501,1105,+
chr8,124219984,0.8736126029359113,1219,930,2149,+
chr8,124219986,0.7595356946359237,1645,1344,2989,+
chr8,124220041,1.705985146352119,780,653,1433,+
chr8,124220061,1.9733015139085688,734,582,1316,+
chr8,124220109,2.621466099574681,675,570,1245,+
chr8,124220122,1.4442176201485564,850,700,1550,+
chr8,124220235,2.160076919469068,1509,926,2435,+
chr8,124220247,1.613583138173302,1013,853,1866,+
chr8,124220258,1.5130941483780225,1188,952,2140,+
chr8,124220288,1.5275542801785298,3428,2476,5904,+
chr8,124220460,1.8574766355140186,1324,962,2286,+
chr8,124220520,1.4389275074478651,965,759,1724,+
chr8,124220599,2.215299708344189,2620,2136,4756,+
chr8,124220620,1.195748422748905,2168,1580,3748,+
chr8,124220738,1.6878358573522227,690,533,1223,+
chr8,124220746,3.078683035714286,612,447,1059,+
chr8,124220767,0.6841294298921418,1055,648,1703,+
chr8,124220796,2.077960204414483,658,540,1198,+
chr8,124220816,2.0685151697809925,709,552,1261,+
chr8,124220826,2.223843572158178,761,622,1383,+
chr8,124220850,1.5339187051298482,2520,1971,4491,+
chr8,124220935,1.9676895725438663,1183,760,1943,+
chr8,124220975,0.41847590953594244,2125,1360,3485,+
chr8,124220985,2.1228512079570745,1748,1121,2869,+
chr8,124221025,2.6871559633027524,706,544,1250,+
chr8,124221067,2.289344895681291,807,612,1419,+
chr8,124221086,0.3240098333788582,658,522,1180,+
chr8,124221092,0.7080789946140036,1478,1113,2591,+
chr8,124221095,1.765419501133787,1353,881,2234,+
chr8,124221265,10.874148380426682,1910,1873,3783,+
chr8,124221266,8.67839784980217,3686,3275,6961,+
chr8,124221290,0.6649897063168966,1704,1524,3228,+
chr8,124221337,2.1122573876551844,754,601,1355,+
chr8,124221462,1.615070643642072,642,454,1096,+
chr8,124221522,1.759733606557377,686,487,1173,+
chr8,124221523,1.5965338213872184,1095,652,1747,+
chr8,124221541,0.6608294930875576,716,650,1366,+
chr8,124221554,0.635091629519564,891,672,1563,+
chr8,124221584,3.712726596922084,1864,1601,3465,+
chr8,124221625,2.5318613869826523,1187,808,1995,+
chr8,124221628,1.4934933925148792,1259,861,2120,+
chr8,124221662,0.4582713293650793,777,767,1544,+
chr8,124221784,1.2633174530619062,2582,1824,4406,+
chr8,124222119,2.536296915396151,1479,1027,2506,+
chr8,124222122,2.048669537409937,1487,1093,2580,+
chr8,124222182,2.392957893637029,618,562,1180,+
chr8,124222196,2.695108695652174,550,459,1009,+
chr8,124222265,0.6052848399246704,604,471,1075,+
chr8,124448832,2.4992546879333495,573,495,1068,+
chr8,124449551,1.548582995951417,611,493,1104,+
chr8,124449561,0.6434442270058708,547,510,1057,+
chr8,124449569,1.735194691094658,2471,2322,4793,+
chr8,124449570,1.6896042924211936,2067,1987,4054,+
chr8,124454047,3.495935866444305,787,599,1386,+
chr8,125551383,2.1927570757739843,734,370,1104,+
chr8,125551455,1.709847383163701,1321,890,2211,+
chr8,125551464,2.4139693694353364,2212,1527,3739,+
chr8,125551465,2.8451140405942663,1213,884,2097,+
chr8,125551481,2.20679012345679,714,539,1253,+
chr8,125551484,0.5360181508791831,944,730,1674,+
chr8,125551503,1.7241384260399566,2355,1579,3934,+
chr8,125555331,1.4816589557171185,1763,1067,2830,+
chr8,126011496,3.8707942712538412,800,626,1426,+
chr8,126017825,1.5874785591766722,616,529,1145,+
chr8,126104167,12.25503773385195,1176,1504,2680,+
chr8,126104168,12.25503773385195,1176,1504,2680,+
chr8,126163475,1.0536693191865605,700,389,1089,+
chr8,126163476,1.0536693191865605,700,389,1089,+
chr8,128748313,0.9833462486791124,982,834,1816,+
chr8,128748314,0.9145083331873791,3730,2654,6384,+
chr8,128748396,1.9298245614035086,769,512,1281,+
chr8,128748416,1.759823406297022,3702,2393,6095,+
chr8,128748417,1.64774443157253,5300,3251,8551,+
chr8,128748418,1.64774443157253,5300,3251,8551,+
chr8,128748421,1.3899851079672374,1309,789,2098,+
chr8,128748436,5.571033282066258,4285,3156,7441,+
chr8,128748449,1.482168473728107,1531,1089,2620,+
chr8,128748476,0.7888347825333082,3363,2525,5888,+
chr8,128748537,1.69077513628605,2657,1968,4625,+
chr8,128748538,1.9608671171171168,1392,767,2159,+
chr8,128748582,1.552979504048583,1326,831,2157,+
chr8,128748629,1.2667879587398185,2849,1936,4785,+
chr8,128748631,1.035538885550283,1611,1176,2787,+
chr8,128748635,2.785383086774122,840,646,1486,+
chr8,128748668,0.7202872622536891,1773,1133,2906,+
chr8,128748673,1.7404572269977794,3363,2351,5714,+
chr8,128748717,1.520135650699449,1140,1010,2150,+
chr8,128748757,1.696603898385663,5129,2873,8002,+
chr8,128748758,1.696603898385663,5129,2873,8002,+
chr8,128748759,1.696603898385663,5129,2873,8002,+
chr8,128748778,1.8106745185636446,1999,1205,3204,+
chr8,128748808,1.7895031944874804,3031,2336,5367,+
chr8,128748809,1.5255979039166951,7857,5506,13363,+
chr8,128748810,1.348461874090106,4826,3170,7996,+
chr8,128750539,1.6917943837309792,1885,1450,3335,+
chr8,128750662,1.859317815839555,976,758,1734,+
chr8,128750689,1.569597905822908,1356,698,2054,+
chr8,128750696,1.6450857072388705,1449,764,2213,+
chr8,128750739,2.20437898089172,838,627,1465,+
chr8,128750761,1.8900343642611683,824,678,1502,+
chr8,128750787,2.6700680272108843,784,636,1420,+
chr8,128750805,1.8309067688378036,895,724,1619,+
chr8,128750806,1.1867415395391838,2376,1768,4144,+
chr8,128750839,2.407767569502446,1222,985,2207,+
chr8,128750857,1.3699908287169713,5673,4342,10015,+
chr8,128750883,1.4158919466153066,1570,1420,2990,+
chr8,128750886,1.350081361157898,1688,1522,3210,+
chr8,128750992,1.9203227433182049,951,660,1611,+
chr8,128751030,0.6098631771876731,1532,808,2340,+
chr8,128751034,1.3722049981210072,1578,886,2464,+
chr8,128751037,1.680554872349845,948,700,1648,+
chr8,128751043,1.9536257853671706,3439,2333,5772,+
chr8,128751156,2.516144414168937,858,733,1591,+
chr8,128751192,2.12919438285292,1107,901,2008,+
chr8,128751229,0.6989552539639883,1066,975,2041,+
chr8,128752650,0.7204518741021287,2243,1611,3854,+
chr8,128752662,1.311298720006585,2682,1868,4550,+
chr8,128752665,1.3717406624383373,1602,1504,3106,+
chr8,128752721,1.759903296822031,1784,1396,3180,+
chr8,128752826,1.573871878393051,2058,1534,3592,+
chr8,128752830,1.35905604719764,2214,1694,3908,+
chr8,128752938,1.698566312928015,2014,1627,3641,+
chr8,128753022,1.4684514637904469,2327,1887,4214,+
chr8,128753044,1.2612842950437533,4106,2829,6935,+
chr8,128753072,1.9828884325804244,2896,2434,5330,+
chr8,128753073,0.6906283476783274,4673,3102,7775,+
chr8,128753282,1.2397180520257227,5301,3560,8861,+
chr8,128753565,4.018034027342342,3776,3053,6829,+
chr8,133024183,3.4346507122278322,626,444,1070,+
chr8,133024194,2.862823061630219,575,502,1077,+
chr8,133024195,2.388659390355264,885,792,1677,+
chr8,133024196,1.0175282234105765,684,458,1142,+
chr8,133024197,2.4875031637560117,924,877,1801,+
chr8,133024198,1.6453328210565206,1319,1077,2396,+
chr8,133024201,1.8262611495877217,954,711,1665,+
chr8,141525314,2.339571381552788,679,486,1165,+
chr8,141525454,3.6859236203880954,599,413,1012,+
chr8,141525933,2.4613026462362106,950,671,1621,+
chr8,143783056,3.3339084804098023,613,498,1111,+
chr8,143783077,1.235112592567138,1028,688,1716,+
chr8,143784511,3.2289393280060716,804,550,1354,+
chr8,144099945,0.7429841799730313,1121,669,1790,+
chr8,144099946,0.8214688064618982,677,484,1161,+
chr8,144099979,3.223123732251522,907,463,1370,+
chr8,144102303,1.6833541927409263,806,422,1228,+
chr8,144102359,1.6947383891828334,886,728,1614,+
chr8,144102366,1.6964074955999584,930,742,1672,+
chr8,144102757,1.5724815724815728,1439,1220,2659,+
chr8,144102763,2.218759501368197,833,597,1430,+
chr8,144102989,1.4662236987818382,992,773,1765,+
chr8,144103104,0.6563342677880122,1890,1134,3024,+
chr8,144103231,0.8110957151236979,1358,1172,2530,+
chr8,144103245,2.359550561797753,719,533,1252,+
chr8,144103350,1.7806034482758621,917,479,1396,+
chr8,144103359,0.5683461909353905,942,487,1429,+
chr8,144103390,1.7946843853820598,1094,644,1738,+
chr8,144103411,0.6237816764132553,735,620,1355,+
chr8,144103413,1.645486555697823,893,780,1673,+
chr8,144103642,0.568771561421929,789,564,1353,+
chr8,144103772,1.2997381460641164,941,752,1693,+
chr8,144733586,2.3401869158878505,625,427,1052,+
chr8,144733587,2.5320876962461867,1006,785,1791,+
chr8,145065909,1.9567146519424174,734,460,1194,+
chr8,145066067,3.129739336492891,586,421,1007,+
chr8,145066076,2.0121527933853045,1146,930,2076,+
chr8,145066102,1.7823403113258185,686,485,1171,+
chr8,145066127,2.4022770398481974,632,526,1158,+
chr8,145066136,1.6901582112259224,1389,1175,2564,+
chr8,145066181,0.6678122315082402,949,650,1599,+
chr8,145066457,2.1876906336814708,878,656,1534,+
chr8,145066524,2.8037276531000384,566,477,1043,+
chr8,145067057,2.9188373891333006,752,445,1197,+
chr8,145067123,2.3057711693140632,1286,1063,2349,+
chr8,145067124,2.206150681750324,874,700,1574,+
chr8,145067136,3.182741116751269,626,393,1019,+
chr8,145067459,3.6905399537765207,612,407,1019,+
chr8,145138744,2.6072821976974265,672,477,1149,+
chr8,145138859,0.9591778475592347,671,564,1235,+
chr8,145138860,0.9591778475592347,671,564,1235,+
chr8,145138862,0.4432989690721649,644,484,1128,+
chr8,145139335,1.828512396694215,707,439,1146,+
chr8,145139736,1.3601408006375877,585,490,1075,+
chr8,145140369,1.5071766117932683,1116,703,1819,+
chr8,145140371,0.9888039170041983,937,696,1633,+
chr8,145150082,1.9399274443402201,856,560,1416,+
chr8,145150121,1.635083853592851,721,388,1109,+
chr8,145150753,1.7520288206295032,982,585,1567,+
chr8,145150840,1.8484453062680097,1584,949,2533,+
chr8,145150884,2.114509803921569,673,524,1197,+
chr8,145151043,0.6559226430298146,813,729,1542,+
chr8,145151046,0.5524262380801632,3818,2541,6359,+
chr8,145151047,0.6522158068106276,2267,1612,3879,+
chr8,145151049,1.455290138808919,2610,1712,4322,+
chr8,145151124,1.5713631156930128,721,581,1302,+
chr8,145151135,0.5390674123837574,1252,901,2153,+
chr8,145151273,1.7011764705882353,963,849,1812,+
chr8,145151574,1.6438131209458904,1000,640,1640,+
chr8,145151617,1.6254129606099108,1065,786,1851,+
chr8,145152018,0.6411320754716981,1698,1324,3022,+
chr8,145152034,1.439021492473476,1572,1152,2724,+
chr8,145152134,1.6137040714995032,1169,953,2122,+
chr8,145152339,3.651673855001027,634,540,1174,+
chr8,145160592,2.206353591160221,1466,904,2370,+
chr8,145160593,2.206353591160221,1466,904,2370,+
chr8,145160599,1.9696732419816287,1676,1144,2820,+
chr8,145160601,1.8403045737510928,2554,1766,4320,+
chr8,145160602,1.8433375904640272,1731,1214,2945,+
chr8,145161492,3.290713153652644,1537,1196,2733,+
chr8,145532624,5.571721143405562,684,449,1133,+
chr8,145533575,4.1847670347557075,624,447,1071,+
chr8,145535060,2.325591106494565,661,533,1194,+
chr8,145538279,3.786666666666666,567,629,1196,+
chr8,145538281,3.786666666666666,567,629,1196,+
chr8,145584772,3.1716721669854744,801,462,1263,+
chr8,145736092,1.8384639100366693,688,554,1242,+
chr8,146279634,3.035460348763547,1224,831,2055,+
chr8,146279635,2.8162410706954595,926,640,1566,+
chr8,146279715,2.1948529411764706,596,441,1037,+
chr8,146280453,1.198748074565155,1042,804,1846,+
chr8,146280793,3.6605783866057844,739,437,1176,+
chr8,146280795,3.6605783866057844,739,437,1176,+
chr9,6639128,0.4285422278145259,688,582,1270,+
chr9,15423963,3.7245696400625974,679,425,1104,+
chr9,15433553,1.615653365810174,1126,825,1951,+
chr9,15433554,2.1013436973249093,1010,750,1760,+
chr9,19049713,3.499633817817853,1227,773,2000,+
chr9,19049827,2.906707742741151,716,475,1191,+
chr9,19050548,2.4588178294573644,579,515,1094,+
chr9,19050549,2.4588178294573644,579,515,1094,+
chr9,32431793,3.825694966190834,535,483,1018,+
chr9,32431794,3.825694966190834,535,483,1018,+
chr9,32431795,3.825694966190834,535,483,1018,+
chr9,33025272,0.8574673464814038,923,536,1459,+
chr9,33025282,1.8284541723666208,651,429,1080,+
chr9,33026486,3.157036613272312,848,436,1284,+
chr9,33026493,0.6121951219512195,752,479,1231,+
chr9,33026496,1.3519246511915062,3273,2247,5520,+
chr9,33026549,0.6340622371740959,717,579,1296,+
chr9,33029907,1.678051678051678,564,480,1044,+
chr9,33030452,1.8027771240291832,765,606,1371,+
chr9,33030578,0.7252157164643868,3420,1780,5200,+
chr9,33030590,1.5765069551777435,959,646,1605,+
chr9,33030595,1.5822960616371387,4387,2242,6629,+
chr9,33030598,1.6892045454545457,2972,1484,4456,+
chr9,33030601,1.6136457729568598,1739,928,2667,+
chr9,33030619,1.6450434462856824,7914,4346,12260,+
chr9,33030620,1.6450434462856824,7914,4346,12260,+
chr9,33030645,1.4700353825740822,2658,1595,4253,+
chr9,33030658,1.3196779017997502,13213,9112,22325,+
chr9,33030659,1.3196779017997502,13213,9112,22325,+
chr9,33030662,1.493896124845389,11786,7543,19329,+
chr9,33034219,1.293895452427291,4688,2864,7552,+
chr9,33034235,1.097386716381717,20998,13554,34552,+
chr9,33034253,1.5314654102595924,7028,5175,12203,+
chr9,33034258,1.3607936854621885,42638,28756,71394,+
chr9,33034259,1.3418682938003046,55083,37387,92470,+
chr9,33037083,1.9360834518729253,703,554,1257,+
chr9,33037084,1.5914407595981837,1284,844,2128,+
chr9,33037096,1.7797300738477209,722,560,1282,+
chr9,33038715,1.6261451132467823,850,658,1508,+
chr9,33038910,2.275051124744376,889,651,1540,+
chr9,33265037,1.597575003735844,619,437,1056,+
chr9,33265099,0.5280452827321594,1111,762,1873,+
chr9,33265100,0.5280452827321594,1111,762,1873,+
chr9,33266009,1.181738734114056,3932,3024,6956,+
chr9,33266010,0.5747812622427849,2053,1771,3824,+
chr9,33266013,1.3651832460732984,1042,763,1805,+
chr9,33270658,1.9232770922521616,1431,1082,2513,+
chr9,33270667,1.5306453376896414,2678,1593,4271,+
chr9,33270705,1.9033478078162211,1895,1297,3192,+
chr9,33270709,0.6123636363636363,2946,1924,4870,+
chr9,33271158,2.5989311929892813,2328,1842,4170,+
chr9,33276485,2.1493115318416525,998,580,1578,+
chr9,33276491,1.8063898975531472,1736,1277,3013,+
chr9,33280959,1.5990755516425466,1452,1068,2520,+
chr9,33281162,1.841873347601662,1063,675,1738,+
chr9,33281305,1.5864510799008615,1033,686,1719,+
chr9,33348046,6.918641603139556,1493,2135,3628,+
chr9,33348047,6.2056718950949605,1456,2268,3724,+
chr9,33348048,6.223667209700267,1340,2079,3419,+
chr9,33348051,0.17520744010821382,528,788,1316,+
chr9,33348087,0.2583333333333333,991,1319,2310,+
chr9,33348089,0.2583333333333333,991,1319,2310,+
chr9,33367607,2.1077405857740588,619,477,1096,+
chr9,34234242,2.2097077646311223,707,481,1188,+
chr9,34241457,0.8145662847790507,710,469,1179,+
chr9,34241458,1.281668124398509,975,674,1649,+
chr9,34241464,2.9618906669133285,780,568,1348,+
chr9,34241465,2.9618906669133285,780,568,1348,+
chr9,34241471,2.166382568179422,870,721,1591,+
chr9,34241479,1.675943698016635,675,520,1195,+
chr9,34241484,1.651127819548872,548,474,1022,+
chr9,34241490,1.4280239153763603,674,592,1266,+
chr9,34241503,1.855593852471897,1825,1800,3625,+
chr9,34241505,1.7271789473684207,2828,2849,5677,+
chr9,34241507,1.6057096181961352,4321,4267,8588,+
chr9,34241508,1.5919413344998203,3161,3412,6573,+
chr9,34241510,1.519008835365716,4897,5042,9939,+
chr9,34241511,1.4920510815741463,2289,2557,4846,+
chr9,34249950,0.8393093021869982,594,485,1079,+
chr9,34251705,6.474327833928784,968,629,1597,+
chr9,34251706,7.1817713919342605,1457,1089,2546,+
chr9,34251707,5.970646790240565,992,686,1678,+
chr9,34251717,9.817587506679441,618,484,1102,+
chr9,34251882,8.565725783353383,908,150,1058,+
chr9,34251896,34.81351377195968,1112,1377,2489,+
chr9,34251897,34.81351377195967,1112,1377,2489,+
chr9,34251936,0.13966735796089644,388,724,1112,+
chr9,34251967,0.29351200827947144,541,644,1185,+
chr9,34252373,1.8885448916408667,609,436,1045,+
chr9,36197554,2.292215544089454,1642,1019,2661,+
chr9,36197555,2.610483551327784,1436,840,2276,+
chr9,36197556,2.610483551327784,1436,840,2276,+
chr9,36197576,2.102514791470098,1438,1004,2442,+
chr9,36198977,0.667925418928487,848,668,1516,+
chr9,36198989,1.4780701754385963,1010,809,1819,+
chr9,36199053,2.1288209606986896,824,686,1510,+
chr9,36199069,1.5075411606663565,2416,2114,4530,+
chr9,36211620,2.327532858540032,1576,1088,2664,+
chr9,36211770,1.58974358974359,836,467,1303,+
chr9,36211771,1.9524127017470034,1252,978,2230,+
chr9,36211982,31.52808988764045,1517,978,2495,+
chr9,36211983,31.52808988764045,1517,978,2495,+
chr9,37090284,1.327666792286285,863,670,1533,+
chr9,37126385,3.214675324675325,668,384,1052,+
chr9,37126386,3.576266482900513,653,381,1034,+
chr9,37126490,3.977609851665268,645,396,1041,+
chr9,37126493,4.443207126948775,664,448,1112,+
chr9,37429752,1.2533800374822412,891,736,1627,+
chr9,72961984,2.189010989010989,995,636,1631,+
chr9,72961985,2.189010989010989,995,636,1631,+
chr9,73216791,3.6102864297283617,827,652,1479,+
chr9,73216792,3.745543875685557,668,546,1214,+
chr9,73216809,0.6986131186805207,664,441,1105,+
chr9,73216887,2.169486358011283,790,622,1412,+
chr9,73216905,1.6332703213610587,755,528,1283,+
chr9,73216934,2.580228514654744,847,731,1578,+
chr9,73216938,1.8205150513311288,929,820,1749,+
chr9,73218295,1.8521341463414633,674,491,1165,+
chr9,73218606,2.909893992932862,731,565,1296,+
chr9,73218773,1.7616736959889825,2598,2367,4965,+
chr9,73218774,1.7782270682768673,3242,2864,6106,+
chr9,73218867,2.0929312901631243,583,475,1058,+
chr9,73219032,2.5097035991531405,568,435,1003,+
chr9,73222051,1.2745889095385627,857,639,1496,+
chr9,73222074,1.8607954545454544,654,527,1181,+
chr9,73222075,2.1778965451422025,1140,844,1984,+
chr9,73222076,2.1778965451422025,1140,844,1984,+
chr9,73222287,0.9363518212792864,1747,1371,3118,+
chr9,73222288,0.9363518212792864,1747,1371,3118,+
chr9,73222320,1.5183354171211267,1454,1185,2639,+
chr9,73222462,1.7049467898491402,716,502,1218,+
chr9,73222464,1.7465462074157727,1117,804,1921,+
chr9,73222465,1.5902641878669275,787,583,1370,+
chr9,73222555,2.043268727082242,590,414,1004,+
chr9,73222556,0.4686990428925913,600,454,1054,+
chr9,74810446,1.3512188477228526,1127,901,2028,+
chr9,74817617,1.5399786780383795,962,803,1765,+
chr9,74825646,2.069592586116454,1075,816,1891,+
chr9,74840617,1.618279984009514,3080,2214,5294,+
chr9,74840629,0.9940656020716444,2489,1654,4143,+
chr9,74840630,0.6028060503251343,1382,1047,2429,+
chr9,74840631,0.9940656020716444,2489,1654,4143,+
chr9,74840651,1.8237316990125978,3693,2936,6629,+
chr9,74846093,2.0963118947500448,916,690,1606,+
chr9,74860123,1.8811292719167902,843,672,1515,+
chr9,74860159,0.5431013431013432,694,524,1218,+
chr9,74863653,1.8718502519798415,699,462,1161,+
chr9,74863897,0.5246458087367178,789,615,1404,+
chr9,74864187,2.4783362218370883,714,576,1290,+
chr9,74864222,0.6278039420896564,817,636,1453,+
chr9,74864456,0.39675421365076585,914,613,1527,+
chr9,74864466,2.632601880877743,987,637,1624,+
chr9,74864747,1.8013204141730788,924,725,1649,+
chr9,74864807,1.5684463562753037,1126,831,1957,+
chr9,74865522,1.8820010704232015,1071,799,1870,+
chr9,74865527,1.5413824347264606,1450,1246,2696,+
chr9,74865528,1.5907100640571303,1845,1580,3425,+
chr9,74865818,1.804839391377853,898,727,1625,+
chr9,74865984,1.5153719008264463,763,604,1367,+
chr9,74866136,2.3858741049006915,1427,880,2307,+
chr9,74866188,1.5272240170199354,880,685,1565,+
chr9,75766781,2.386615979405313,610,692,1302,+
chr9,75766783,1.293261868300153,562,652,1214,+
chr9,75766784,1.8276332924957677,787,707,1494,+
chr9,75766794,0.8759266123054114,1232,851,2083,+
chr9,75766796,0.8759266123054114,1232,851,2083,+
chr9,75766799,1.3578139589169,1134,713,1847,+
chr9,75766808,0.6224110167138653,1018,666,1684,+
chr9,75766810,0.507037137641709,1312,1220,2532,+
chr9,75766816,1.8313133320087422,708,718,1426,+
chr9,75766833,0.3948895449455359,1292,1033,2325,+
chr9,75773669,0.653399281414773,3818,2216,6034,+
chr9,75773685,1.315680166147456,3800,1925,5725,+
chr9,75773698,0.7810068325046415,3766,2773,6539,+
chr9,75773705,1.3086418618331557,5694,3687,9381,+
chr9,75774332,1.70076726342711,1994,1529,3523,+
chr9,75775196,1.3873497289227623,3152,1957,5109,+
chr9,75784991,1.4142836033969697,5785,4658,10443,+
chr9,77761681,0.37169768095719086,685,472,1157,+
chr9,80912148,1.638359749890941,592,528,1120,+
chr9,80912150,1.0624581013258003,1178,937,2115,+
chr9,80912171,1.0756984239803804,1734,1334,3068,+
chr9,80915527,0.6518134715025907,1410,964,2374,+
chr9,80919703,1.8715315315315315,1221,924,2145,+
chr9,80919796,1.6057614639207094,2621,2152,4773,+
chr9,80919821,0.6928137651821863,1368,805,2173,+
chr9,80921236,1.727914438502674,1730,1274,3004,+
chr9,80921263,1.496118560338744,1907,1416,3323,+
chr9,80923449,0.6114752626380534,680,601,1281,+
chr9,80923474,1.0359988856848323,2029,1505,3534,+
chr9,80923477,1.638306292045904,1079,797,1876,+
chr9,80923479,1.5446960667461265,959,838,1797,+
chr9,80932596,1.7009108344070034,2526,2000,4526,+
chr9,80944019,1.4903437885221202,1394,744,2138,+
chr9,80944032,1.6761904761904762,1847,1294,3141,+
chr9,80944052,1.4313625204582652,1998,1221,3219,+
chr9,80944134,1.4481900452488687,1902,1429,3331,+
chr9,80944228,1.3699342105263157,1892,1519,3411,+
chr9,80944382,1.4865244639294048,2234,1226,3460,+
chr9,80944389,1.54946949602122,1668,753,2421,+
chr9,80944395,1.2790689984871493,5610,2978,8588,+
chr9,80944403,1.7320345571800932,2971,1678,4649,+
chr9,80944430,1.4174058742361522,2560,1156,3716,+
chr9,80944440,1.423527677142135,4628,2859,7487,+
chr9,80944442,0.646040713837324,1800,1133,2933,+
chr9,80944443,1.416529993366943,11359,7308,18667,+
chr9,80944445,1.485528749612866,17468,11400,28868,+
chr9,80944446,1.6741520447503155,11997,7933,19930,+
chr9,80944449,1.074209693317019,13410,7616,21026,+
chr9,82006738,1.8169236813208844,997,679,1676,+
chr9,82006740,2.491148642934562,1557,1074,2631,+
chr9,82006741,3.9951734539969843,615,441,1056,+
chr9,82006755,1.864129372679304,586,601,1187,+
chr9,82006757,0.8907248910971584,3754,2950,6704,+
chr9,82006758,0.6657638136511376,2457,1845,4302,+
chr9,82006761,1.4580138192656822,911,670,1581,+
chr9,82006766,1.9744917529727655,709,473,1182,+
chr9,90341099,1.904985153930301,1271,971,2242,+
chr9,90341146,0.6501630232966208,2528,1762,4290,+
chr9,90341147,0.6501630232966208,2528,1762,4290,+
chr9,90341196,1.7044088176352703,629,498,1127,+
chr9,90341242,16.605519772809895,772,630,1402,+
chr9,90342510,1.9400023277467413,900,715,1615,+
chr9,90342512,0.6210618977020015,1148,911,2059,+
chr9,90342519,1.6980877996229462,1163,947,2110,+
chr9,90342526,1.4846041055718475,1274,1053,2327,+
chr9,90343021,2.389855072463768,1163,919,2082,+
chr9,90343172,1.7687939426717143,1265,1031,2296,+
chr9,90343521,1.3398058252427183,2460,1544,4004,+
chr9,90343581,1.432623931074391,2320,1509,3829,+
chr9,90343593,1.4738077769625826,1487,1362,2849,+
chr9,90343625,1.1850200652401301,4892,3345,8237,+
chr9,90346133,1.255124884772398,2823,2070,4893,+
chr9,91926146,1.6426055121917522,579,466,1045,+
chr9,91926147,1.501507457949857,756,547,1303,+
chr9,91926178,1.2854727852960066,2155,1809,3964,+
chr9,91926179,1.672265571053722,1326,1113,2439,+
chr9,91926184,1.5126362735381569,1442,1008,2450,+
chr9,91926204,1.4529471062618595,1484,1053,2537,+
chr9,91926220,1.5845050215208034,1254,1024,2278,+
chr9,91931485,1.5253979797979798,2775,1874,4649,+
chr9,91973048,4.383024342109282,619,431,1050,+
chr9,95142065,1.402318420473824,1302,890,2192,+
chr9,96259792,1.1148325358851674,698,417,1115,+
chr9,96259794,1.1148325358851674,698,417,1115,+
chr9,96278500,2.6335946837570425,639,392,1031,+
chr9,96278545,2.6751494328266827,700,589,1289,+
chr9,96289449,3.2996959266018933,778,655,1433,+
chr9,96294438,1.2886035313001605,668,444,1112,+
chr9,96294440,1.2886035313001605,668,444,1112,+
chr9,96323487,5.364222589778529,559,564,1123,+
chr9,96323488,4.403306110828856,811,833,1644,+
chr9,96326862,2.3885017421602788,913,573,1486,+
chr9,96326863,2.3885017421602788,913,573,1486,+
chr9,96326882,2.204723199511025,853,595,1448,+
chr9,96327227,2.5378670734596187,717,451,1168,+
chr9,97222185,1.7842723004694838,690,425,1115,+
chr9,97222193,2.081246546007184,612,400,1012,+
chr9,100426701,1.3639521677677375,607,465,1072,+
chr9,100429054,4.003790570954751,649,468,1117,+
chr9,100429056,4.003790570954751,649,468,1117,+
chr9,100745834,2.4293147294546835,586,457,1043,+
chr9,100745838,3.724660040346726,757,522,1279,+
chr9,100745859,1.0467313588479707,1246,840,2086,+
chr9,100756975,2.016212338593974,610,409,1019,+
chr9,100757009,3.6512667660208646,909,670,1579,+
chr9,100760855,1.7618096189524761,1645,1077,2722,+
chr9,100760862,1.72951612225165,1209,880,2089,+
chr9,100767253,1.7921492921492923,1113,671,1784,+
chr9,100767391,1.5567814854682454,1334,928,2262,+
chr9,100767429,4.30398422074235,2621,1988,4609,+
chr9,100773567,2.6221532091097317,744,643,1387,+
chr9,100777837,2.217679348854817,807,586,1393,+
chr9,100777838,2.0947614819501292,1350,962,2312,+
chr9,100777844,0.49912022150055,1609,1093,2702,+
chr9,100777845,0.5825633105477976,1471,1028,2499,+
chr9,100777849,1.91430138488962,606,428,1034,+
chr9,100777850,2.070539754363284,624,441,1065,+
chr9,100777895,1.7096836810270943,2066,1447,3513,+
chr9,100777901,1.4904589371980677,902,620,1522,+
chr9,100819134,34.00825682308,1853,1411,3264,+
chr9,100819135,34.008256823079996,1853,1411,3264,+
chr9,100819184,0.4438732926754242,547,500,1047,+
chr9,100823109,2.2134395028160805,785,541,1326,+
chr9,100823116,1.829644014484841,1929,1346,3275,+
chr9,100823253,1.4731852654387865,665,425,1090,+
chr9,100839204,0.7227775840469087,2034,1228,3262,+
chr9,100839206,1.8849668761678275,1260,840,2100,+
chr9,100839279,1.5698721200266155,11525,7067,18592,+
chr9,100839280,1.5014400991035943,7211,4369,11580,+
chr9,100839281,1.36953575230608,14733,9510,24243,+
chr9,100839291,1.5873768932264751,5740,3948,9688,+
chr9,100839293,1.5069040904432573,16231,10851,27082,+
chr9,100839294,1.521987782296987,13423,8955,22378,+
chr9,100840492,1.014792263526379,10550,7853,18403,+
chr9,100843145,2.4511139109069564,681,448,1129,+
chr9,100843206,0.3759398496240601,629,440,1069,+
chr9,100843208,0.3759398496240601,629,440,1069,+
chr9,100843357,3.703859649122808,608,474,1082,+
chr9,100843358,3.703859649122808,608,474,1082,+
chr9,101765788,3.6894858248905944,717,428,1145,+
chr9,101765790,4.727769193103416,648,371,1019,+
chr9,101765829,2.271413557540725,1234,864,2098,+
chr9,101765830,2.557027225901398,1667,1207,2874,+
chr9,101765831,1.847929221363997,3090,2295,5385,+
chr9,101765832,1.7657043433746566,2766,2015,4781,+
chr9,101765833,1.5091420638133959,2808,2079,4887,+
chr9,101914824,2.6441470890836682,938,689,1627,+
chr9,101914829,1.6680221811460254,845,540,1385,+
chr9,101914831,2.0839250213007667,586,502,1088,+
chr9,101984558,0.8206593434763316,722,425,1147,+
chr9,101984564,2.7059679767103346,571,457,1028,+
chr9,101984566,2.7059679767103346,571,457,1028,+
chr9,101984606,1.796547314578005,668,390,1058,+
chr9,101984640,1.4846170337904205,1605,1140,2745,+
chr9,101990183,2.5665419788628117,725,545,1270,+
chr9,101992677,2.6874160322436187,705,637,1342,+
chr9,108536407,2.142026752820061,657,485,1142,+
chr9,108536523,3.1370843020081858,737,521,1258,+
chr9,110045907,2.3483057525610715,744,422,1166,+
chr9,110045909,2.2299756834426354,1141,661,1802,+
chr9,110045910,2.154911744991435,781,462,1243,+
chr9,110045928,2.039855072463768,562,505,1067,+
chr9,110062422,1.7806772962291222,1264,900,2164,+
chr9,110062423,1.7806772962291222,1264,900,2164,+
chr9,110062451,0.6915620180656533,875,800,1675,+
chr9,110062452,1.7325,818,623,1441,+
chr9,110068860,0.4410912658910121,1013,834,1847,+
chr9,110068879,2.2114898989898992,677,527,1204,+
chr9,110068905,1.5775075987841949,1037,657,1694,+
chr9,110068913,0.5957199734571997,755,547,1302,+
chr9,110073998,1.700727103960396,1046,807,1853,+
chr9,110084361,1.9379679837464774,1785,1294,3079,+
chr9,110087200,11.31697035359007,1279,502,1781,+
chr9,110087202,17.440625509040558,1845,876,2721,+
chr9,110087203,11.39140718426874,4637,2107,6744,+
chr9,110087204,11.594122026780958,3237,1595,4832,+
chr9,110087209,9.333751762238682,5736,6799,12535,+
chr9,110087211,9.429771205020137,8759,13123,21882,+
chr9,110087212,8.175081205504176,6016,10878,16894,+
chr9,110087218,0.28483450940979527,1648,4107,5755,+
chr9,110087244,0.33448130900188444,2381,4783,7164,+
chr9,110087250,0.4538941478340435,8182,12959,21141,+
chr9,110087251,0.42402230421558146,5686,9796,15482,+
chr9,110091864,0.7036715617591305,3689,3308,6997,+
chr9,110091880,2.1308793277969458,5483,5814,11297,+
chr9,110091881,2.1308793277969458,5483,5814,11297,+
chr9,110092063,8.64155007772596,2058,154,2212,+
chr9,110092065,13.439732177316275,4991,350,5341,+
chr9,110092066,10.341176470588236,1171,67,1238,+
chr9,110092067,12.407662653879527,6034,419,6453,+
chr9,110092069,9.242976625290902,7556,588,8144,+
chr9,110092070,14.246758751859849,7596,710,8306,+
chr9,110092071,32.78837617226108,9550,2238,11788,+
chr9,110092072,32.524835071647686,7673,2104,9777,+
chr9,110092073,31.706257529817634,5796,1962,7758,+
chr9,110092077,5.554344384329374,2170,5384,7554,+
chr9,110092082,0.163951473136915,515,1153,1668,+
chr9,110092092,1.871257447789282,4923,12431,17354,+
chr9,110092093,1.8712574477892818,4923,12431,17354,+
chr9,110092094,0.9538182244895189,4051,11758,15809,+
chr9,110092116,0.3096439297859166,4031,7517,11548,+
chr9,110092117,0.30938417172060223,5394,11342,16736,+
chr9,110092118,0.2659894996249866,2386,4574,6960,+
chr9,110092133,0.4423101881894873,851,1674,2525,+
chr9,110092246,1.5047345767575322,1025,764,1789,+
chr9,110092405,2.1703333333333337,765,499,1264,+
chr9,110092501,12.0625,964,159,1123,+
chr9,110092508,13.066666666666666,930,170,1100,+
chr9,110092509,5.985286294682415,6986,1237,8223,+
chr9,110092510,5.985286294682415,6986,1237,8223,+
chr9,110092511,6.212679222763099,10448,1884,12332,+
chr9,110092513,5.9568603003979135,4861,900,5761,+
chr9,110092514,11.250315210880204,7892,1715,9607,+
chr9,110092516,28.392977892677635,15728,16056,31784,+
chr9,110092517,27.698116884247145,12398,15412,27810,+
chr9,110092518,27.698116884247142,12398,15412,27810,+
chr9,110092551,0.5496568577239936,1317,1846,3163,+
chr9,110092564,0.29714812194895013,1495,4093,5588,+
chr9,110092788,3.807792207792208,732,538,1270,+
chr9,112931675,3.68585563000953,739,528,1267,+
chr9,112931697,0.4261806981519507,592,486,1078,+
chr9,112931699,0.4577141763093113,879,763,1642,+
chr9,112931732,0.46959243327374767,976,709,1685,+
chr9,112931742,2.005265671913384,1780,1515,3295,+
chr9,112931743,2.005265671913384,1780,1515,3295,+
chr9,112931744,2.005265671913384,1780,1515,3295,+
chr9,114431713,2.0819112627986347,914,585,1499,+
chr9,114431715,1.928289204279447,1624,982,2606,+
chr9,114431940,1.6029038112522684,827,569,1396,+
chr9,114432349,1.5993055555555549,986,674,1660,+
chr9,114659533,3.851658767772512,601,421,1022,+
chr9,114676978,2.985951468710089,667,521,1188,+
chr9,114693626,1.0892620906527866,669,483,1152,+
chr9,114695453,1.8159454691773638,944,602,1546,+
chr9,114695503,1.7768835640985279,1798,1201,2999,+
chr9,114695575,1.5386467976217355,1075,617,1692,+
chr9,114695576,1.4137473460721868,760,470,1230,+
chr9,114696150,9.281876955837015,2940,2119,5059,+
chr9,114696151,9.281876955837015,2940,2119,5059,+
chr9,114696155,0.6216216216216215,781,628,1409,+
chr9,114696489,1.0005757052389177,631,578,1209,+
chr9,114696491,1.0005757052389177,631,578,1209,+
chr9,114697022,1.79771144278607,622,401,1023,+
chr9,114697047,1.5933232169954479,1007,658,1665,+
chr9,114697329,1.7713414634146338,746,503,1249,+
chr9,115233637,0.8845314953760252,750,520,1270,+
chr9,115233638,0.8845314953760252,750,520,1270,+
chr9,115233660,0.5937744794887652,757,769,1526,+
chr9,115233661,0.5937744794887652,757,769,1526,+
chr9,117350082,1.4355914050428022,632,465,1097,+
chr9,117350103,0.6085357703796641,1902,1307,3209,+
chr9,117354833,2.0423516439454694,866,687,1553,+
chr9,117354834,1.9197815591846439,1433,1033,2466,+
chr9,117354880,2.528756957328386,798,538,1336,+
chr9,117359934,0.6090733590733591,630,591,1221,+
chr9,117359998,0.6091081593927894,962,712,1674,+
chr9,117360071,1.871249318057829,979,610,1589,+
chr9,117360073,1.9905876951331496,666,483,1149,+
chr9,117360139,1.9051948051948053,651,461,1112,+
chr9,117360144,3.4413273001508298,712,509,1221,+
chr9,117360343,1.9723752786674629,807,540,1347,+
chr9,117360433,1.5973936108868647,728,597,1325,+
chr9,117360444,1.735046521931768,1245,853,2098,+
chr9,117360511,0.4358182358182358,666,480,1146,+
chr9,124088982,1.4639782326185833,610,607,1217,+
chr9,124088983,1.26811244393624,1209,1115,2324,+
chr9,124089585,3.006026707592432,1867,1490,3357,+
chr9,124089586,3.006026707592432,1867,1490,3357,+
chr9,124095041,3.619846384552267,774,552,1326,+
chr9,125054060,2.778434023577409,590,439,1029,+
chr9,125075599,1.9897090004241893,703,457,1160,+
chr9,125075600,3.7240873762951687,662,485,1147,+
chr9,127076204,0.6187827606290041,786,504,1290,+
chr9,127076205,0.6230603962759609,869,530,1399,+
chr9,127637393,1.6404091327742498,704,420,1124,+
chr9,127639305,2.179190751445087,740,518,1258,+
chr9,127639376,1.856353591160221,643,361,1004,+
chr9,127639410,0.4448717948717948,693,389,1082,+
chr9,127639412,2.6733067729083664,670,501,1171,+
chr9,127639526,5.169677393321304,1316,972,2288,+
chr9,127639550,2.973609319762365,820,643,1463,+
chr9,129595897,2.79456740442656,730,496,1226,+
chr9,129595899,2.1824732001640204,1128,793,1921,+
chr9,129595901,2.0861023796851934,1364,1027,2391,+
chr9,129595902,1.603775425763089,1138,802,1940,+
chr9,130374607,2.5972222222222223,594,419,1013,+
chr9,130374608,3.080559757942511,904,660,1564,+
chr9,130374610,2.6085597029509486,939,730,1669,+
chr9,130374611,2.709946396664681,636,510,1146,+
chr9,130569735,2.416687009682861,1011,762,1773,+
chr9,130569737,2.1205251520966955,708,530,1238,+
chr9,130922685,0.7428527344368929,781,633,1414,+
chr9,130922733,4.707674815275435,756,396,1152,+
chr9,130922744,2.8883174533191993,755,488,1243,+
chr9,130922747,5.136993277900584,758,522,1280,+
chr9,130922759,2.865110347853145,1284,970,2254,+
chr9,131051175,15.778104735576994,1205,694,1899,+
chr9,131051176,14.3604413830074,1372,835,2207,+
chr9,131133647,0.4286694853429292,803,596,1399,+
chr9,131133649,0.4925257731958762,636,479,1115,+
chr9,131140331,2.2370300251630657,634,464,1098,+
chr9,131152730,3.685534450006018,1852,1381,3233,+
chr9,131152731,3.685534450006018,1852,1381,3233,+
chr9,131221846,2.944045609153121,705,592,1297,+
chr9,131221848,6.29681647940075,537,533,1070,+
chr9,131221849,4.695309055309188,584,557,1141,+
chr9,131377951,0.47490059642147103,636,502,1138,+
chr9,131377978,3.272651473040577,784,513,1297,+
chr9,131377979,3.272651473040577,784,513,1297,+
chr9,131377980,3.272651473040577,784,513,1297,+
chr9,131451879,0.2438383673836515,925,571,1496,+
chr9,131451886,0.5830164765525983,574,525,1099,+
chr9,131451888,0.5830164765525983,574,525,1099,+
chr9,131451900,1.8703659695817487,593,525,1118,+
chr9,131451925,0.6276556776556776,744,649,1393,+
chr9,131453460,1.5360927565141504,1368,1233,2601,+
chr9,131453461,1.571556205328135,1758,1295,3053,+
chr9,131455242,1.8757948283170829,1415,1010,2425,+
chr9,131456014,1.9141342570723772,1041,656,1697,+
chr9,131457031,1.4351341174385894,727,446,1173,+
chr9,131457032,1.4351341174385894,727,446,1173,+
chr9,131457049,2.347336163008781,1008,772,1780,+
chr9,131457052,1.9089991849329633,1072,749,1821,+
chr9,131457058,1.650223257028617,2201,1570,3771,+
chr9,131457060,1.5472718851320058,1795,1269,3064,+
chr9,131457074,1.966842686970404,571,478,1049,+
chr9,131457206,0.48937310233970344,684,508,1192,+
chr9,131457210,1.8428571428571427,902,489,1391,+
chr9,131457482,5.283422459893049,987,186,1173,+
chr9,131457485,8.061749955558376,1663,302,1965,+
chr9,131457494,48.62782782782783,1785,554,2339,+
chr9,131457495,34.52944695096687,8347,2193,10540,+
chr9,131457496,33.92298931909068,12151,3681,15832,+
chr9,131457497,32.78087916432604,11254,3535,14789,+
chr9,131457498,29.76665856453349,3428,928,4356,+
chr9,131457505,9.506682252698782,7191,5164,12355,+
chr9,131457506,9.506682252698782,7191,5164,12355,+
chr9,131457550,0.5919025073581429,4812,5190,10002,+
chr9,131457692,1.5049180327868854,1121,609,1730,+
chr9,131457917,1.920560348509439,802,508,1310,+
chr9,131457970,1.555505927231464,746,612,1358,+
chr9,131458132,0.5307807807807807,706,503,1209,+
chr9,131458174,1.533693369380685,1174,894,2068,+
chr9,131458191,1.7757847533632287,560,445,1005,+
chr9,131458241,0.5086659663865546,595,447,1042,+
chr9,131458257,1.6755219985085756,718,446,1164,+
chr9,131458390,1.823104265402844,668,421,1089,+
chr9,131458568,1.7271138593897029,875,518,1393,+
chr9,131580777,1.510408955325203,1087,651,1738,+
chr9,131671399,1.5672235481304695,787,418,1205,+
chr9,131671412,1.137216137993616,1368,1112,2480,+
chr9,131720290,2.0163261797533636,807,522,1329,+
chr9,131721297,0.5843442890237486,1138,728,1866,+
chr9,131721305,1.701923076923077,1415,987,2402,+
chr9,131721306,1.701923076923077,1415,987,2402,+
chr9,131721310,2.9902426820115084,746,570,1316,+
chr9,131721314,2.409018987341772,782,631,1413,+
chr9,131721317,1.9851617728045952,3386,2491,5877,+
chr9,131730859,0.3678495762711864,925,511,1436,+
chr9,131730860,1.033653931414817,1653,915,2568,+
chr9,131730868,0.7316763007197149,2087,1161,3248,+
chr9,131730869,0.7316763007197149,2087,1161,3248,+
chr9,131730875,2.1389689401216776,667,346,1013,+
chr9,131730913,1.7600796416127429,1104,573,1677,+
chr9,131730917,1.622230531924839,937,562,1499,+
chr9,131730934,1.7072217881459983,1329,866,2195,+
chr9,131730945,1.7539693632246882,2126,1153,3279,+
chr9,131730946,1.7648845244589924,1590,1169,2759,+
chr9,131755679,2.547625104404706,883,633,1516,+
chr9,131755824,0.5673560108233475,617,397,1014,+
chr9,131756669,3.2386236954215035,623,502,1125,+
chr9,131757743,3.6545918482811692,660,473,1133,+
chr9,131873841,4.859071572476577,486,531,1017,+
chr9,131898858,2.474069936241499,723,531,1254,+
chr9,131899960,2.1794924624074263,592,456,1048,+
chr9,131904793,2.0101112234580385,979,804,1783,+
chr9,131904794,2.0101112234580385,979,804,1783,+
chr9,131904819,0.6537149885391625,1062,576,1638,+
chr9,131909877,3.7916995260658357,1649,699,2348,+
chr9,131909878,4.180614225368193,1076,460,1536,+
chr9,131909879,3.7278760918665923,1691,748,2439,+
chr9,131909883,12.011197224490761,2032,1159,3191,+
chr9,131909884,12.011197224490761,2032,1159,3191,+
chr9,131909892,7.050855736099485,2872,2198,5070,+
chr9,131909893,7.050855736099485,2872,2198,5070,+
chr9,131909894,7.559038958749589,2375,1821,4196,+
chr9,131909901,0.33093527244357224,869,751,1620,+
chr9,131909902,0.9272679097845119,791,722,1513,+
chr9,131909927,1.6556055942177874,972,976,1948,+
chr9,131909929,1.107981220657277,707,638,1345,+
chr9,131910021,2.6758620689655173,581,434,1015,+
chr9,131910022,2.6758620689655173,581,434,1015,+
chr9,131910294,14.483628010250571,734,663,1397,+
chr9,131910299,7.350822005293379,504,810,1314,+
chr9,131910374,1.0585403265597395,584,540,1124,+
chr9,131910571,3.514344262295082,1028,487,1515,+
chr9,131910572,3.514344262295082,1028,487,1515,+
chr9,131910573,3.514344262295082,1028,487,1515,+
chr9,131910587,12.587921661707687,2495,1446,3941,+
chr9,131910588,12.587921661707687,2495,1446,3941,+
chr9,131910589,14.390516039051604,736,477,1213,+
chr9,131910595,14.00015505113829,2261,2354,4615,+
chr9,131910596,14.00015505113829,2261,2354,4615,+
chr9,132251479,2.8245666483457046,563,555,1118,+
chr9,132636856,2.0909738555647177,1245,920,2165,+
chr9,132636858,2.100259201658891,861,642,1503,+
chr9,132900080,1.1515199333716561,1529,949,2478,+
chr9,132900084,1.846503367746603,1329,847,2176,+
chr9,132900089,2.8333992876929166,715,360,1075,+
chr9,132901050,1.5225609946405294,668,506,1174,+
chr9,132901052,0.8403483634067509,661,522,1183,+
chr9,132980175,0.5781486880869503,764,491,1255,+
chr9,132995514,2.608962553713935,749,542,1291,+
chr9,132995516,2.9639553502985043,1280,895,2175,+
chr9,132995748,5.643620273578141,799,456,1255,+
chr9,132995749,4.910561400885504,1010,591,1601,+
chr9,132995757,7.292722268925988,2399,2016,4415,+
chr9,132995758,5.891817989271209,2550,2183,4733,+
chr9,132995759,5.891817989271208,2550,2183,4733,+
chr9,132996438,4.071230020194264,624,437,1061,+
chr9,132997630,3.280992707193192,614,461,1075,+
chr9,133320346,1.1423841059602649,809,431,1240,+
chr9,133320347,1.1423841059602649,809,431,1240,+
chr9,133320353,1.3468564614307295,1374,958,2332,+
chr9,133320358,1.6900574300071791,656,596,1252,+
chr9,133327612,0.7260105448154657,2915,1706,4621,+
chr9,133327614,0.6903504452408497,6659,5413,12072,+
chr9,133327615,1.202050959789421,3579,2156,5735,+
chr9,133327646,1.313972506246079,6090,3769,9859,+
chr9,133329730,1.4549976936873452,15820,10788,26608,+
chr9,133329731,1.5305102550213403,9961,7126,17087,+
chr9,133333913,0.7722865625967686,5637,4222,9859,+
chr9,133333914,1.4453864537435586,6454,3975,10429,+
chr9,133333923,1.3804004455746106,17663,13607,31270,+
chr9,133333946,1.2552610026393822,26247,19053,45300,+
chr9,133333947,1.2552610026393822,26247,19053,45300,+
chr9,133333969,1.302344978699363,7964,4973,12937,+
chr9,133339546,0.7009698889405174,5436,4789,10225,+
chr9,133342135,1.2270567546679512,6295,4891,11186,+
chr9,133342142,1.5264110704753218,6984,5561,12545,+
chr9,133346250,1.2262054221918146,11338,8470,19808,+
chr9,133346251,1.302568242713864,18572,12528,31100,+
chr9,133346870,1.2141944029740994,843,571,1414,+
chr9,133352256,0.41389210464245835,1439,1144,2583,+
chr9,133352279,1.3274389923076113,6781,5378,12159,+
chr9,133352284,1.0909839913683765,14415,11635,26050,+
chr9,133352330,1.2014286845910385,6513,4672,11185,+
chr9,133352336,1.0824377367852869,14278,10723,25001,+
chr9,133355806,1.3193721095587383,9045,5577,14622,+
chr9,133364725,1.1882440204936988,21784,16247,38031,+
chr9,133364728,1.5532780217992517,6943,5463,12406,+
chr9,133364827,1.1543088327064814,9034,5619,14653,+
chr9,133370300,1.2801000172443524,7813,5798,13611,+
chr9,133370393,0.8728974887823245,8123,6086,14209,+
chr9,133376385,1.2046316322013533,7411,5019,12430,+
chr9,133376402,1.160756062290258,17094,12619,29713,+
chr9,133376544,1.5190538641393614,18170,11465,29635,+
chr9,133376613,38.57189251773715,29390,16593,45983,+
chr9,133376615,38.57189251773715,29390,16593,45983,+
chr9,133493195,3.0583082934697763,1293,859,2152,+
chr9,133493196,3.003516242518428,1359,880,2239,+
chr9,133506122,1.9378123985718922,877,394,1271,+
chr9,133506123,1.9378123985718922,877,394,1271,+
chr9,133513022,33.01789505229849,3487,2461,5948,+
chr9,133513023,33.01789505229849,3487,2461,5948,+
chr9,133574731,1.096426001439194,652,378,1030,+
chr9,133574732,1.096426001439194,652,378,1030,+
chr9,133578501,1.2214535481494782,1095,649,1744,+
chr9,133578518,1.8278377589728625,695,446,1141,+
chr9,133578521,2.286893349954864,1519,1081,2600,+
chr9,133578523,2.378658561133701,2316,1683,3999,+
chr9,133578524,2.2363625737725856,2340,1570,3910,+
chr9,133762902,3.7042472661381574,650,447,1097,+
chr9,135894808,0.9824507182831114,20215,13891,34106,+
chr9,135932261,2.414473684210526,733,479,1212,+
chr9,135932262,2.295937008602349,1001,706,1707,+
chr9,135933296,5.502065903987128,1094,531,1625,+
chr9,135933298,5.352322377127586,1193,586,1779,+
chr9,135933299,8.304664517591766,1105,636,1741,+
chr9,135933302,5.895846887198157,704,546,1250,+
chr9,135933305,6.624066476470885,975,1658,2633,+
chr9,135933325,0.23475981218420447,577,1329,1906,+
chr9,135933327,0.2103329950219902,543,1253,1796,+
chr9,135933328,0.2886937452979368,1199,2271,3470,+
chr9,135933329,0.28265221518522143,741,1335,2076,+
chr9,135933335,0.32999666904087566,504,990,1494,+
chr9,135933449,4.104115074540319,667,441,1108,+
chr9,136215059,1.0464079400062691,989,542,1531,+
chr9,136215060,1.180020753732983,739,429,1168,+
chr9,136215071,0.9638692038049007,4020,1931,5951,+
chr9,136215072,1.0078632671889503,5471,2552,8023,+
chr9,136215073,1.1605236659162186,6066,2795,8861,+
chr9,136215074,0.905344938996342,6226,2571,8797,+
chr9,136215075,1.4038110142784053,1250,1042,2292,+
chr9,136215076,1.1315970123473642,8867,5227,14094,+
chr9,136215078,1.1424782405586151,1504,1311,2815,+
chr9,136215080,1.385396694607742,5142,2263,7405,+
chr9,136215082,1.4434246270983322,8006,3969,11975,+
chr9,136215086,1.8940246244211,1420,1134,2554,+
chr9,136215088,0.6776986621053609,1344,1092,2436,+
chr9,136215093,1.553554072442169,1775,1402,3177,+
chr9,136215095,1.3048292648863262,8501,5576,14077,+
chr9,136215096,1.2610321296592832,12920,7817,20737,+
chr9,136215097,0.6809358693569655,2482,1942,4424,+
chr9,136215098,1.990542760589422,2611,2192,4803,+
chr9,136215800,1.240337077903041,3528,3031,6559,+
chr9,136215830,1.2675568934461274,13152,7016,20168,+
chr9,136215831,1.2560329876736638,18984,10737,29721,+
chr9,136215845,1.2750749920192568,39527,25072,64599,+
chr9,136215846,1.3217781416739192,31001,18734,49735,+
chr9,136215856,1.2607217625032192,8776,5713,14489,+
chr9,136216488,1.7497832558425015,14441,6683,21124,+
chr9,136216490,1.6216726185269694,22302,10430,32732,+
chr9,136216492,1.394443706406459,29117,16637,45754,+
chr9,136216500,1.7922001158608476,7436,5952,13388,+
chr9,136216517,1.3154851571539237,26846,17639,44485,+
chr9,136216525,1.1878067668100227,9901,6676,16577,+
chr9,136216819,1.1863439347574558,51509,41070,92579,+
chr9,136216820,1.3452848874176762,26001,20076,46077,+
chr9,136217126,1.3627746995001528,31499,20767,52266,+
chr9,136217449,1.0169713582307802,741,624,1365,+
chr9,136217479,0.881658594188776,32411,25404,57815,+
chr9,136217480,1.1652489436805908,63023,47715,110738,+
chr9,136217482,1.3480052047058766,65530,47922,113452,+
chr9,136218114,1.066159178094012,857,729,1586,+
chr9,136218115,0.7745190653347138,1071,687,1758,+
chr9,136218137,0.8119339658892468,17054,13385,30439,+
chr9,136218138,1.5796566820908429,25280,19270,44550,+
chr9,137735238,1.7351464435146442,571,477,1048,+
chr9,137735305,2.2473229824193273,1529,1249,2778,+
chr9,137979767,0.8207706802717678,866,477,1343,+
chr9,137979768,0.9751815301320754,1435,796,2231,+
chr9,137979793,0.2835989767807949,1152,527,1679,+
chr9,137979795,0.2835989767807949,1152,527,1679,+
chr9,137979803,2.118703358208955,1816,937,2753,+
chr9,137979804,2.0047317889170504,2652,1266,3918,+
chr9,137979815,1.794577205882353,2254,1311,3565,+
chr9,137979816,1.3322981808446213,3512,2134,5646,+
chr9,137979818,1.0694273004030208,2418,1280,3698,+
chr9,137979853,2.47684482235044,1449,711,2160,+
chr9,137979884,1.7970173041894353,573,487,1060,+
chr9,137979898,1.5876436781609198,849,695,1544,+
chr9,137979931,2.2674897119341564,607,485,1092,+
chr9,137979969,2.440253975111194,1060,661,1721,+
chr9,137982064,2.696954314720812,758,393,1151,+
chr9,137982131,1.8394196744515217,552,470,1022,+
chr9,137982139,3.2552888043736625,829,600,1429,+
chr9,137982142,1.6136967607555843,1044,662,1706,+
chr9,137982160,1.4937912964228754,1048,797,1845,+
chr9,137982162,0.5665476797552269,1413,1035,2448,+
chr9,137987779,1.867142857142857,1306,1119,2425,+
chr9,137987785,2.0854927404359693,1621,1098,2719,+
chr9,137989822,1.6176470588235294,824,611,1435,+
chr9,137990200,1.6400102524670002,1527,1223,2750,+
chr9,137990231,0.6611656843483956,1892,1526,3418,+
chr9,137998687,2.532715376226826,928,523,1451,+
chr9,138011418,1.765481577246283,1137,662,1799,+
chr9,138011479,1.700009627418889,980,610,1590,+
chr9,138011491,2.0139476334340385,1080,661,1741,+
chr9,138011497,1.4388920293951384,978,724,1702,+
chr9,138011502,1.5038991601923906,2380,1630,4010,+
chr9,138011505,1.5893311504485146,2197,1684,3881,+
chr9,138011506,1.6593377067692534,2980,2345,5325,+
chr9,138011512,1.601225934559268,1090,890,1980,+
chr9,138011673,1.7472035794183445,780,446,1226,+
chr9,138011728,2.4748040313549837,679,375,1054,+
chr9,138011734,2.140806561859193,695,398,1093,+
chr9,138011785,2.129943502824859,701,530,1231,+
chr9,138011791,1.9339375149057956,953,598,1551,+
chr9,138011839,1.6795415805316791,841,706,1547,+
chr9,138011881,1.539424280350438,989,798,1787,+
chr9,138011893,1.8967083391862152,987,790,1777,+
chr9,138011914,0.6354400316664467,687,688,1375,+
chr9,138011992,3.0984555984555984,534,517,1051,+
chr9,138012062,1.788698985505769,2047,1357,3404,+
chr9,138012095,0.5225478756263299,992,856,1848,+
chr9,138012167,1.5701884920634919,1947,1279,3226,+
chr9,138012204,1.589574360982158,1420,940,2360,+
chr9,138012215,1.0780858676207512,2126,1559,3685,+
chr9,138012216,1.0780858676207512,2126,1559,3685,+
chr9,138012263,1.921540312876053,997,553,1550,+
chr9,138012293,0.5729248939815546,1024,798,1822,+
chr9,138012297,0.7312252964426877,1183,879,2062,+
chr9,138012454,2.2535559678416823,910,692,1602,+
chr9,138012460,1.6344849400766177,1010,768,1778,+
chr9,138012509,1.3642801455301454,1264,1039,2303,+
chr9,138012637,1.9839980893240983,1916,1184,3100,+
chr9,138012688,0.7843191964285714,2810,1663,4473,+
chr9,138012699,1.931949141926594,2517,1773,4290,+
chr9,138012709,0.8285913946291306,4149,2861,7010,+
chr9,138012768,1.5202496641371868,14563,9026,23589,+
chr9,138012770,1.3865030347936782,31919,19483,51402,+
chr9,138012870,1.5356290520714104,3449,2775,6224,+
chr9,138012874,2.1036385230706105,3483,2932,6415,+
chr9,138012959,2.070594224279989,3768,3351,7119,+
chr9,138393694,0.3219323150643906,802,523,1325,+
chr9,138395401,3.0407751648354173,587,437,1024,+
chr9,138395515,1.7665022659844005,700,512,1212,+
chr9,138395734,2.4507592108476426,735,562,1297,+
chr9,139306973,1.8517094017094016,618,389,1007,+
chr9,139311623,1.8187439659420008,828,509,1337,+
chr9,139313364,1.5663286478607061,621,403,1024,+
chr9,139313501,2.812724210523914,545,497,1042,+
chr9,139316301,3.3485043959434253,619,399,1018,+
chr9,139686440,1.819671143124779,641,569,1210,+
chr9,139686746,1.1605027227226055,1785,1018,2803,+
chr9,139686747,1.0739582282312583,886,560,1446,+
chr9,139686748,1.252723311546841,899,458,1357,+
chr9,139687602,9.148354705747654,648,543,1191,+
chr9,139743895,4.987681650488829,553,507,1060,+
chr9,139744472,2.4482330135692627,1047,648,1695,+
chr9,139744473,2.4482330135692627,1047,648,1695,+
chr9,139744564,1.7728465759961822,742,380,1122,+
chr9,140001895,2.2686695403792276,753,653,1406,+
chr9,140083203,0.8851761416135734,549,530,1079,+
chr9,140083639,2.6632882882882885,644,443,1087,+
chr9,140083640,2.6632882882882885,644,443,1087,+
chr9,140083657,0.49450549450549447,599,454,1053,+
chr9,140135819,2.091384195776908,751,475,1226,+
chr9,140136367,0.3975530628187317,970,561,1531,+
chr9,140136393,1.6307431749948935,1049,603,1652,+
chr9,140136964,3.2413650749965592,672,558,1230,+
chr9,140136965,3.2413650749965592,672,558,1230,+
chr9,140137123,2.3018538487060387,942,565,1507,+
chr9,140137130,1.9970902885235728,945,621,1566,+
chr9,140137142,1.5837695272874823,696,464,1160,+
chr9,140137248,1.5902358099300866,1319,872,2191,+
chr9,140137249,1.6572535991140642,729,644,1373,+
chr9,140137445,1.2283496732026142,581,543,1124,+
chr9,140137446,1.2283496732026142,581,543,1124,+
chr9,140137558,2.06,720,419,1139,+
chr9,140137616,2.0016860906760816,1126,758,1884,+
chr9,140137889,2.0572385871841408,920,493,1413,+
chr9,140137891,2.0572385871841408,920,493,1413,+
chr9,140137912,1.806903181425015,878,589,1467,+
chr9,140137940,3.3101549053356285,600,414,1014,+
chr9,140137997,3.503929501967274,1014,715,1729,+
chr9,140138000,3.438063610659859,792,590,1382,+
chr9,140138003,2.72540593129331,1474,1259,2733,+
chr9,140138005,2.520123242826882,568,576,1144,+
chr9,140138010,2.3910753021382085,642,460,1102,+
chr9,140138015,0.4698236651351971,1044,822,1866,+
chr9,140138053,0.5068516042780749,673,543,1216,+
chr9,140151283,4.33742727860375,670,356,1026,+
chr9,140151284,4.33742727860375,670,356,1026,+
chr9,140446832,2.217857142857143,620,489,1109,+
chr9,140446833,2.217857142857143,620,489,1109,+
chr9,140446877,0.41647713170863787,821,556,1377,+
chr10,1038446,2.3542729591836737,641,391,1032,+
chr10,1041897,2.3198431372549018,642,424,1066,+
chr10,1042054,1.8039659543643607,686,501,1187,+
chr10,1042152,2.3917893183520693,825,640,1465,+
chr10,1044987,1.0571896835104297,849,572,1421,+
chr10,1046764,2.18529046287667,715,590,1305,+
chr10,1051761,2.644194756554307,705,444,1149,+
chr10,1053062,2.560678925035361,875,504,1379,+
chr10,1053063,2.560678925035361,875,504,1379,+
chr10,1055479,1.764904163912756,620,444,1064,+
chr10,1056385,0.5622454065760301,1127,796,1923,+
chr10,1058597,2.48510101010101,756,494,1250,+
chr10,1060197,1.5702159508089826,1839,1195,3034,+
chr10,1060205,1.8738376476501635,698,518,1216,+
chr10,1060211,1.6353739573024175,806,642,1448,+
chr10,1060218,1.6125565103039228,3372,2497,5869,+
chr10,1060227,1.6400337837837835,1021,887,1908,+
chr10,1061737,2.2986894492368948,748,547,1295,+
chr10,1061739,1.7395527544584923,1071,780,1851,+
chr10,1063090,5.4221249804009926,1346,1010,2356,+
chr10,1063103,1.94167698019802,1140,807,1947,+
chr10,1063105,1.94167698019802,1140,807,1947,+
chr10,1063165,0.5590928602088997,520,481,1001,+
chr10,1063226,0.4877802973041067,725,566,1291,+
chr10,1063238,2.9066353493834414,549,523,1072,+
chr10,3109739,0.8697565028526968,1119,400,1519,+
chr10,3124582,2.106504116427649,692,497,1189,+
chr10,3143623,3.958458653371685,904,574,1478,+
chr10,3143715,4.350606780709967,583,442,1025,+
chr10,3145996,1.7931805157593124,1078,697,1775,+
chr10,3145997,1.7931805157593124,1078,697,1775,+
chr10,3146039,1.36440418510373,856,735,1591,+
chr10,3146132,2.0987230594277393,853,584,1437,+
chr10,3147329,1.417608116408349,683,528,1211,+
chr10,3147650,1.682762492981471,665,410,1075,+
chr10,3147680,1.6555349794238683,1318,899,2217,+
chr10,3147682,1.6555349794238683,1318,899,2217,+
chr10,3149418,2.2773614776219144,3644,1951,5595,+
chr10,3149420,2.4149659863945576,2484,1322,3806,+
chr10,3149449,2.485858713509415,1666,964,2630,+
chr10,3150977,3.099663832311647,626,388,1014,+
chr10,3151667,1.9580246913580248,792,644,1436,+
chr10,3151669,1.9078607820644702,1376,1037,2413,+
chr10,3154447,0.5133333333333334,615,419,1034,+
chr10,3154453,1.6580850898343313,835,558,1393,+
chr10,3154454,0.5401416765053129,609,483,1092,+
chr10,3155678,1.5095009700772928,1349,787,2136,+
chr10,3158971,1.71152630066111,826,496,1322,+
chr10,3158974,2.182026710164135,750,576,1326,+
chr10,3159019,2.153390522875817,2432,1988,4420,+
chr10,3159020,1.6089730492560304,7037,5218,12255,+
chr10,3159022,1.4801250890173236,7261,5111,12372,+
chr10,3160999,2.190021810250818,830,523,1353,+
chr10,3172134,1.7176000307053498,1027,751,1778,+
chr10,3174593,1.050259216589862,1572,991,2563,+
chr10,3174594,0.9061128126530257,2090,1404,3494,+
chr10,3176694,0.5937194286832322,713,537,1250,+
chr10,3177930,0.6087262491203378,864,666,1530,+
chr10,3177933,0.6862641376357087,1111,801,1912,+
chr10,3178786,2.2212982832618025,636,465,1101,+
chr10,3178835,1.6038492381716118,1124,782,1906,+
chr10,5005605,0.9949956895645409,598,497,1095,+
chr10,5005606,0.7750768564863516,1170,925,2095,+
chr10,5005607,0.6419137751375446,1353,1158,2511,+
chr10,5008135,0.3997665673336171,656,559,1215,+
chr10,5009183,1.8106624558237463,687,428,1115,+
chr10,5014829,5.668175840769658,1105,602,1707,+
chr10,5014856,1.438931246494112,801,574,1375,+
chr10,5020029,2.4893643719684437,589,508,1097,+
chr10,5020032,0.3270440251572327,687,515,1202,+
chr10,5136645,0.4649202001105596,1243,787,2030,+
chr10,5138642,1.2259890966671136,1563,1034,2597,+
chr10,5138719,1.465802250231156,1119,815,1934,+
chr10,5138720,0.3974842767295597,631,529,1160,+
chr10,5147793,2.196306544667917,842,718,1560,+
chr10,5149793,0.6073256127120926,901,631,1532,+
chr10,5766471,3.543833580980684,794,672,1466,+
chr10,5788690,1.0351212063370874,637,402,1039,+
chr10,5788691,1.0351212063370874,637,402,1039,+
chr10,5791865,3.1467567131311633,579,429,1008,+
chr10,6143250,2.1233755611383662,710,547,1257,+
chr10,6147057,1.2584439316985065,695,552,1247,+
chr10,6154231,8.632694238577043,1361,1164,2525,+
chr10,6154232,9.331683529156756,1187,1099,2286,+
chr10,6156036,11.7706348954656,1423,1216,2639,+
chr10,6157242,0.38862760196365154,792,582,1374,+
chr10,6157457,3.264336737403159,800,551,1351,+
chr10,7830150,0.657361113115651,1078,709,1787,+
chr10,7830209,1.833707406651704,816,675,1491,+
chr10,7838089,1.4193877551020406,1390,874,2264,+
chr10,7840961,1.0378080394918807,4161,2843,7004,+
chr10,7841022,1.6018978882651698,1222,869,2091,+
chr10,7841088,1.97025171624714,860,588,1448,+
chr10,7841135,1.7242624868912437,3908,2859,6767,+
chr10,7841777,2.3689631494621195,1149,770,1919,+
chr10,7844247,1.5707832208858905,1216,973,2189,+
chr10,7844336,1.571542356488593,1200,836,2036,+
chr10,7844786,1.8402500000000002,1298,999,2297,+
chr10,12238215,1.4649872448979595,740,783,1523,+
chr10,12238216,2.4043956043004386,1533,1508,3041,+
chr10,12238217,2.4043956043004386,1533,1508,3041,+
chr10,12238247,0.5409739982949702,780,815,1595,+
chr10,12238248,0.5409739982949702,780,815,1595,+
chr10,12240737,0.5367373638087641,1120,898,2018,+
chr10,12240748,2.1370716510903427,734,534,1268,+
chr10,12259392,2.6237236215112323,570,451,1021,+
chr10,12277071,2.0193046895020075,787,508,1295,+
chr10,12291638,1.9388335704125177,657,517,1174,+
chr10,12292437,2.1426616738219777,653,517,1170,+
chr10,12292485,1.8521560574948663,615,486,1101,+
chr10,13161032,1.5371938581569202,575,536,1111,+
chr10,13161034,1.0198807157057654,512,502,1014,+
chr10,13652071,2.2145441811602664,917,658,1575,+
chr10,13652072,1.5364127195428436,1628,1055,2683,+
chr10,14881972,0.2380300957592339,579,429,1008,+
chr10,14881974,0.2380300957592339,579,429,1008,+
chr10,14909259,3.424048312309132,910,551,1461,+
chr10,14909740,2.6169297701034133,1545,862,2407,+
chr10,14909748,3.283245453802454,1300,759,2059,+
chr10,14909758,2.302631578947368,1574,1101,2675,+
chr10,14909759,2.302631578947368,1574,1101,2675,+
chr10,16547142,1.8419771780866367,1047,901,1948,+
chr10,16547143,1.8419771780866367,1047,901,1948,+
chr10,16547147,2.7297794117647056,584,543,1127,+
chr10,16547154,1.8033864954432481,892,567,1459,+
chr10,17271281,0.5248381602562793,750,684,1434,+
chr10,17271282,1.608855291036198,1054,754,1808,+
chr10,17271457,1.7026949889649001,1509,927,2436,+
chr10,17271578,0.6235521235521235,911,517,1428,+
chr10,17271673,1.6638240574506284,1010,556,1566,+
chr10,17271680,2.4791666666666665,1070,593,1663,+
chr10,17271695,2.2537539814955254,1142,693,1835,+
chr10,17271697,1.5148181635523408,568,473,1041,+
chr10,17271704,1.5174386194527254,1203,808,2011,+
chr10,17271707,1.800610295506277,1708,1416,3124,+
chr10,17271709,1.6337479439747375,3101,2367,5468,+
chr10,17271724,0.5345911949685535,849,749,1598,+
chr10,17271766,1.4677737481707709,1356,1208,2564,+
chr10,17271912,1.0591382957462816,1821,1310,3131,+
chr10,17271919,1.6948730711796909,1134,783,1917,+
chr10,17271920,1.781595019967113,1318,791,2109,+
chr10,17272694,2.1459246275197192,1410,1140,2550,+
chr10,17272696,1.0226764550180276,4110,2854,6964,+
chr10,17275874,1.49686420971038,1633,1233,2866,+
chr10,17275908,2.231449442522107,1450,1223,2673,+
chr10,17276761,1.318708477278767,1945,1419,3364,+
chr10,17277167,0.6657649253731344,2339,1674,4013,+
chr10,17277186,1.4025209203803493,2707,1605,4312,+
chr10,17277195,1.4177934018388316,1925,1547,3472,+
chr10,17277345,1.3402113739305486,2662,1986,4648,+
chr10,17278293,1.4634323629573216,5849,4245,10094,+
chr10,17278294,1.5464471903185601,3418,2572,5990,+
chr10,17278302,1.2777451556077508,1954,1494,3448,+
chr10,17278320,1.730960351501203,2134,1737,3871,+
chr10,17279383,1.5359116022099448,3419,2714,6133,+
chr10,17279407,1.519292970707485,3334,2438,5772,+
chr10,22607217,1.4467193415022408,756,498,1254,+
chr10,22615360,3.506275630669815,626,618,1244,+
chr10,22615362,3.95887595592597,1308,1227,2535,+
chr10,22615363,4.576984126984128,875,1007,1882,+
chr10,22615364,4.576984126984128,875,1007,1882,+
chr10,22615365,3.5630865352800063,928,992,1920,+
chr10,22616896,2.439933205469924,712,517,1229,+
chr10,27448674,3.367446592342289,604,401,1005,+
chr10,27454379,2.0705398680082228,1366,1026,2392,+
chr10,27454380,1.9662794466178846,2060,1377,3437,+
chr10,27459041,0.8192112076396102,835,424,1259,+
chr10,27459113,2.2226333641689795,635,422,1057,+
chr10,27459114,0.6219630709426628,679,356,1035,+
chr10,27459119,2.318036475481714,1514,937,2451,+
chr10,27459127,1.5436590436590438,854,480,1334,+
chr10,27459128,1.1713529519666677,1787,1230,3017,+
chr10,27459130,1.1713529519666677,1787,1230,3017,+
chr10,27459133,1.52890086852351,1020,741,1761,+
chr10,27459136,1.5929719626168224,2225,1749,3974,+
chr10,27459137,1.5580817659514072,3471,2449,5920,+
chr10,27459146,1.8945964684301613,4305,3332,7637,+
chr10,27459147,1.9078904343889125,2708,2394,5102,+
chr10,27475472,0.9317673378076062,594,446,1040,+
chr10,27475473,0.9317673378076062,594,446,1040,+
chr10,27827343,2.8382024208173995,837,547,1384,+
chr10,27827952,1.0206919945725916,1002,736,1738,+
chr10,27827954,1.0206919945725916,1002,736,1738,+
chr10,28824579,1.4786166830151308,952,594,1546,+
chr10,28872415,2.323636363636364,638,384,1022,+
chr10,28897274,1.6249891589247067,708,525,1233,+
chr10,28899682,2.733991652244732,745,516,1261,+
chr10,28899698,1.4624488193392788,1525,1022,2547,+
chr10,28899743,1.4500501875429237,1167,822,1989,+
chr10,28899747,1.945923589929173,940,666,1606,+
chr10,28900705,1.644981412639405,1439,1075,2514,+
chr10,28900710,2.1617295228152598,3105,2606,5711,+
chr10,28900712,1.95428252372976,4822,4178,9000,+
chr10,28900713,1.511482271657289,5962,4876,10838,+
chr10,28905198,1.6348711206244488,937,709,1646,+
chr10,28906669,2.0125,601,429,1030,+
chr10,28909032,2.4976395730265635,683,505,1188,+
chr10,28909235,1.699189882504315,1390,1068,2458,+
chr10,28909315,2.980272108843537,673,489,1162,+
chr10,28909371,2.1860674111983207,944,754,1698,+
chr10,28909409,6.433470507544581,669,728,1397,+
chr10,28909410,6.072687202946656,1580,1458,3038,+
chr10,28909479,0.5108225108225108,589,419,1008,+
chr10,35484060,0.9257991157900467,1262,502,1764,+
chr10,35484065,4.725628442278212,1021,404,1425,+
chr10,35500223,2.1672738312082576,648,487,1135,+
chr10,35500224,2.3123718666297703,1166,836,2002,+
chr10,35500254,1.7259056732740945,605,417,1022,+
chr10,35500543,2.922201138519924,699,526,1225,+
chr10,35500545,2.922201138519924,699,526,1225,+
chr10,35500626,1.8984969214052883,722,501,1223,+
chr10,35500668,2.493506493506494,767,538,1305,+
chr10,38346903,5.753826428060428,1483,966,2449,+
chr10,38346904,5.52662736400736,1614,1044,2658,+
chr10,43280986,2.0739795918367347,541,489,1030,+
chr10,43312900,0.6417061577727631,657,458,1115,+
chr10,43315966,0.9198898737577222,720,291,1011,+
chr10,43315987,0.39425549976847657,675,348,1023,+
chr10,43316013,0.4043970686209194,1213,645,1858,+
chr10,43316014,0.4043970686209194,1213,645,1858,+
chr10,43680097,0.8187890477602962,624,391,1015,+
chr10,51579181,3.891945313786856,715,466,1181,+
chr10,51579182,3.891945313786856,715,466,1181,+
chr10,51580596,3.722089631397507,637,418,1055,+
chr10,51580602,2.3646017699115043,834,564,1398,+
chr10,51582220,0.5942458587619878,638,464,1102,+
chr10,51582928,1.9023021426796007,951,678,1629,+
chr10,51584670,2.2445842068483577,802,476,1278,+
chr10,51585159,0.6309772343175266,576,478,1054,+
chr10,51585160,1.8261964735516367,624,396,1020,+
chr10,51585407,2.017132934508752,722,592,1314,+
chr10,51585412,3.16831091180867,756,445,1201,+
chr10,51585586,0.884053216940024,1317,791,2108,+
chr10,51585587,1.8496368230987463,1631,992,2623,+
chr10,51585588,3.0769230769230766,619,433,1052,+
chr10,51586271,0.4825337438406133,903,573,1476,+
chr10,51586280,0.5221811460258781,790,540,1330,+
chr10,51586281,1.882465819141281,653,378,1031,+
chr10,51589484,1.6563667851608788,648,476,1124,+
chr10,51589607,0.530169419058308,619,566,1185,+
chr10,51589770,2.6535644509259093,888,701,1589,+
chr10,51589859,1.5854870775347911,1507,1005,2512,+
chr10,51589994,1.7796730632551527,625,535,1160,+
chr10,51590070,1.7139868499701139,739,477,1216,+
chr10,51590089,1.714285714285714,759,524,1283,+
chr10,51590414,2.65393567498942,864,555,1419,+
chr10,51829447,0.6585394118287531,639,379,1018,+
chr10,54074828,0.5500112892300745,608,411,1019,+
chr10,54074829,0.5000052332517908,808,617,1425,+
chr10,54076173,2.072597864768684,909,561,1470,+
chr10,54076177,1.989953632148377,1029,646,1675,+
chr10,54076181,1.9489436619718306,737,567,1304,+
chr10,54076440,0.5373525306157114,1617,1113,2730,+
chr10,54076458,0.4913200723327306,626,473,1099,+
chr10,54076460,1.9474244750255292,2065,1347,3412,+
chr10,54076771,1.6322501028383383,767,560,1327,+
chr10,60028921,1.0846721388811198,1912,2909,4821,+
chr10,60028922,1.0082776877234996,2874,4296,7170,+
chr10,60028924,0.6381756074341044,2145,3089,5234,+
chr10,60028929,0.36802510171523856,2033,2462,4495,+
chr10,60028930,0.2971491228070175,1354,1519,2873,+
chr10,60028937,0.48992373452497195,13038,9088,22126,+
chr10,60028938,0.4890589744412934,14442,10056,24498,+
chr10,60028939,0.5411332780737153,23219,14614,37833,+
chr10,60028941,0.6928497618544184,21287,11953,33240,+
chr10,60028943,1.0629028780319203,11349,6785,18134,+
chr10,60029041,1.6287650602409638,720,414,1134,+
chr10,60029048,2.06760147601476,823,541,1364,+
chr10,60036949,1.9096774193548383,943,589,1532,+
chr10,60036965,1.0551286709286676,1888,1384,3272,+
chr10,60047408,1.696882690730107,1378,794,2172,+
chr10,60047416,2.673924731182796,1420,839,2259,+
chr10,60147953,2.3437083415307893,818,553,1371,+
chr10,60154799,2.2012830139810933,664,507,1171,+
chr10,60380654,2.656763925729443,1251,1014,2265,+
chr10,60380655,2.391345935243371,1423,1113,2536,+
chr10,60380656,2.656763925729443,1251,1014,2265,+
chr10,60461843,2.291838842975207,917,967,1884,+
chr10,60461844,3.4240509073483,1315,1250,2565,+
chr10,62538314,0.5889965474997216,852,614,1466,+
chr10,62538315,0.6190729651807496,820,500,1320,+
chr10,62539948,1.0530908604313733,2387,1979,4366,+
chr10,62544523,0.6450172940250485,3540,2500,6040,+
chr10,62551748,2.1239645258746718,1281,992,2273,+
chr10,62551951,0.6766838655696557,1940,1419,3359,+
chr10,62552022,2.123915199603273,1268,871,2139,+
chr10,62552025,1.6598824569493367,3092,2094,5186,+
chr10,62553674,1.5051010337840844,6000,4527,10527,+
chr10,62553909,1.8001167201634083,596,446,1042,+
chr10,62554175,5.561375899280576,852,555,1407,+
chr10,62554296,1.9088743125254284,4921,3653,8574,+
chr10,62554297,1.4330749240998817,11236,7454,18690,+
chr10,64566495,0.8762491933246991,615,397,1012,+
chr10,64566723,4.303104077609585,589,420,1009,+
chr10,64566731,1.0780898679603523,1077,829,1906,+
chr10,64913589,1.855077605321508,580,450,1030,+
chr10,65370060,2.037913067324832,724,373,1097,+
chr10,65370061,2.037913067324832,724,373,1097,+
chr10,65379451,1.951901809912464,1061,682,1743,+
chr10,65379453,1.951901809912464,1061,682,1743,+
chr10,65379456,2.0170987313844457,1218,850,2068,+
chr10,65379457,1.96529424171279,2256,1311,3567,+
chr10,65379463,2.1109022556390977,1122,531,1653,+
chr10,69676902,2.7690532553760314,970,656,1626,+
chr10,69926277,4.754610815879962,584,456,1040,+
chr10,69935230,2.9675725875694337,724,395,1119,+
chr10,69935251,1.0852177347684409,784,493,1277,+
chr10,69935253,1.0852177347684409,784,493,1277,+
chr10,69935292,2.3573369565217392,693,367,1060,+
chr10,69948847,1.3189812007277135,649,441,1090,+
chr10,69948850,1.9375,510,510,1020,+
chr10,69948859,1.6972085385878486,911,629,1540,+
chr10,69948860,0.6173717342379073,675,712,1387,+
chr10,69961620,0.681760826473188,759,512,1271,+
chr10,69966580,3.5368086096353633,941,617,1558,+
chr10,69970961,3.0181511849946765,899,581,1480,+
chr10,69971078,1.70389511107727,1066,744,1810,+
chr10,70097689,2.4955522314176943,1398,929,2327,+
chr10,70097710,1.8773830750240024,1415,950,2365,+
chr10,70097711,1.8052950910093768,2181,1469,3650,+
chr10,70097713,1.6881047239612976,1482,1003,2485,+
chr10,70097738,1.707889510742011,859,572,1431,+
chr10,70097739,1.9869655891553706,1029,684,1713,+
chr10,70098397,1.649386845039019,1075,597,1672,+
chr10,70098906,4.100531944226753,6030,4024,10054,+
chr10,70098924,2.242272347535505,1803,1196,2999,+
chr10,70098927,1.889343374641213,3635,2262,5897,+
chr10,70098930,1.665189975170147,4052,3025,7077,+
chr10,70098931,1.5759949656825762,6108,4223,10331,+
chr10,70099227,2.7527289985761745,724,601,1325,+
chr10,70099294,0.5090830382956355,1175,910,2085,+
chr10,70101025,1.9956543967280165,1054,651,1705,+
chr10,70101559,3.4197016068211474,1487,1119,2606,+
chr10,70101756,2.492008395776651,2012,1492,3504,+
chr10,70101758,2.410855400163803,2067,1448,3515,+
chr10,70101789,4.274699161410169,1001,705,1706,+
chr10,70101792,7.307101727447217,563,520,1083,+
chr10,70101801,6.204844418989579,5058,5006,10064,+
chr10,70101802,6.204844418989579,5058,5006,10064,+
chr10,70101803,4.489384435533544,1940,1500,3440,+
chr10,70101806,0.5563389227642277,460,655,1115,+
chr10,70101808,0.43266072770204994,1492,1209,2701,+
chr10,70101809,0.4559469284167088,2695,2884,5579,+
chr10,70101811,0.5733605587121212,774,703,1477,+
chr10,70101812,0.5548387096774193,773,1022,1795,+
chr10,70101815,0.4780186032613808,1877,1422,3299,+
chr10,70101817,0.4780186032613808,1877,1422,3299,+
chr10,70101824,0.6582298136645962,1098,804,1902,+
chr10,70102015,1.6906729634002362,1073,725,1798,+
chr10,70102258,1.8130002425418383,649,433,1082,+
chr10,70508976,2.3446054750402574,727,431,1158,+
chr10,70508977,2.3446054750402574,727,431,1158,+
chr10,70509005,2.267248509740168,1168,898,2066,+
chr10,70509006,2.267248509740168,1168,898,2066,+
chr10,70673234,2.8998890869479106,644,478,1122,+
chr10,70673937,1.0528469381442538,854,673,1527,+
chr10,70694007,0.4640264727436087,698,513,1211,+
chr10,70706194,2.0905210937097225,594,470,1064,+
chr10,70706341,2.393050173869846,722,498,1220,+
chr10,70715987,1.066605359957961,705,691,1396,+
chr10,70715988,1.5225255424462285,1049,1039,2088,+
chr10,70716033,1.53614249371781,1801,1437,3238,+
chr10,70719572,2.119697121652793,1030,766,1796,+
chr10,70719580,2.5075107296137342,854,698,1552,+
chr10,70719588,0.6616680349042594,2196,1740,3936,+
chr10,70719697,1.6196266968325794,1244,883,2127,+
chr10,70721856,2.190869086908691,1137,807,1944,+
chr10,70723115,0.4641746733057484,1167,678,1845,+
chr10,70723117,2.045876288659794,944,775,1719,+
chr10,70723147,2.2931556279827725,960,780,1740,+
chr10,70723205,1.7687326549491211,716,563,1279,+
chr10,70725169,1.777777777777778,951,611,1562,+
chr10,70725170,2.0513823682837766,714,638,1352,+
chr10,70726839,1.6576578762197198,2095,1370,3465,+
chr10,70726863,1.7687937062937062,1348,879,2227,+
chr10,70728817,3.2225425053742427,928,730,1658,+
chr10,70730055,1.689900153609831,676,495,1171,+
chr10,70730086,2.631205673758865,741,563,1304,+
chr10,70731789,3.352856629536471,601,505,1106,+
chr10,70733369,2.2569864356921063,1022,843,1865,+
chr10,70733371,2.0143028095694584,1739,1356,3095,+
chr10,70733386,0.6069444444444445,873,629,1502,+
chr10,70733389,1.7015494435792102,1332,1052,2384,+
chr10,70733394,1.7275280898876402,614,533,1147,+
chr10,70733412,0.6104954034729316,1225,889,2114,+
chr10,70737314,1.9125434287768064,613,490,1103,+
chr10,70737323,1.6525283018867927,781,529,1310,+
chr10,70737393,1.7362773029439698,777,539,1316,+
chr10,70737438,0.2119198199163897,658,490,1148,+
chr10,70738631,2.52740848661446,770,577,1347,+
chr10,70738645,2.3857524682266957,1150,678,1828,+
chr10,70741321,0.6030115395440473,856,645,1501,+
chr10,70741327,1.7238024743576184,1429,964,2393,+
chr10,70741329,1.7238024743576184,1429,964,2393,+
chr10,70742301,2.2884283246977546,794,578,1372,+
chr10,70742431,4.608060493104805,675,549,1224,+
chr10,70742507,1.665415330011603,609,636,1245,+
chr10,70742514,0.6803135888501742,638,573,1211,+
chr10,70742533,0.609117698041255,1003,640,1643,+
chr10,70742863,1.6211453744493391,1031,680,1711,+
chr10,70742932,1.648254529385771,745,583,1328,+
chr10,70743050,0.6060603846278133,3949,2801,6750,+
chr10,70743051,0.3369568987888813,3380,2326,5706,+
chr10,70743052,0.8674141749723147,1842,1259,3101,+
chr10,70743267,1.7039297046619477,1073,722,1795,+
chr10,70743350,1.5727124183006533,824,611,1435,+
chr10,70743480,1.4546045263657021,631,475,1106,+
chr10,70743488,2.014308499153491,1593,1205,2798,+
chr10,70743489,0.8579638752052545,714,608,1322,+
chr10,70743490,1.6754490860049045,1996,1641,3637,+
chr10,70743492,2.495221712538226,745,653,1398,+
chr10,70743494,0.5952088452088452,569,439,1008,+
chr10,70743498,0.9404794294582446,2260,1736,3996,+
chr10,70743677,2.213175230566535,907,689,1596,+
chr10,70744007,2.4549528949053325,1219,753,1972,+
chr10,70744088,2.9990167158308747,914,677,1591,+
chr10,70744106,1.8991051214310286,1664,1351,3015,+
chr10,70744419,1.5617899373985629,841,680,1521,+
chr10,70744573,1.875,919,735,1654,+
chr10,70744633,1.751012379960662,1315,803,2118,+
chr10,70744708,1.5351003553250746,694,533,1227,+
chr10,70775935,2.9971181556195963,779,693,1472,+
chr10,70775936,3.2014715969320946,1193,1105,2298,+
chr10,70775938,2.8273366418527712,1242,1239,2481,+
chr10,70775940,2.2333296703975876,1251,1176,2427,+
chr10,70775945,1.3967869190828759,785,747,1532,+
chr10,70884001,1.8930265162750517,700,351,1051,+
chr10,70884002,1.8489777425326146,687,379,1066,+
chr10,70884010,4.517818937438227,677,460,1137,+
chr10,70884012,4.81019656019656,572,443,1015,+
chr10,70884024,6.372108843537415,645,629,1274,+
chr10,70884025,7.983564164898783,1135,982,2117,+
chr10,70928257,2.6722073615652415,614,491,1105,+
chr10,70931092,2.7274605989597505,823,576,1399,+
chr10,70931320,3.101413010051234,823,453,1276,+
chr10,71151984,5.523246051620535,960,1237,2197,+
chr10,71151985,5.523246051620534,960,1237,2197,+
chr10,71154758,2.037706823324599,692,514,1206,+
chr10,72183376,0.2401934799893983,724,307,1031,+
chr10,72183378,0.2401934799893983,724,307,1031,+
chr10,73975874,6.679890500689672,953,1185,2138,+
chr10,73975875,6.189818129733527,1777,1854,3631,+
chr10,73975876,5.575557827366514,1945,2030,3975,+
chr10,73983670,2.0102564102564107,636,506,1142,+
chr10,73990131,1.9676519799219188,755,488,1243,+
chr10,73990153,0.49699087555814403,639,605,1244,+
chr10,73992824,1.852105778648384,1341,1020,2361,+
chr10,73992825,1.852105778648384,1341,1020,2361,+
chr10,73992826,2.5133767985611515,770,555,1325,+
chr10,73992835,1.2707879067530212,1537,1154,2691,+
chr10,73992842,1.616916646176543,821,580,1401,+
chr10,73992881,1.0167862871248807,1860,1383,3243,+
chr10,73992884,0.6398490566037736,1412,1059,2471,+
chr10,73992906,1.833265488636013,3178,2401,5579,+
chr10,73992907,1.776993217613672,4899,3768,8667,+
chr10,73992909,1.7520375237018062,3343,2613,5956,+
chr10,73992910,1.4331928292209144,3490,2434,5924,+
chr10,73992961,1.6988991842876378,691,548,1239,+
chr10,73993015,2.034080717488789,809,668,1477,+
chr10,73993234,2.511760752688172,1494,929,2423,+
chr10,73993235,2.511760752688172,1494,929,2423,+
chr10,73993407,2.008672659968271,1186,914,2100,+
chr10,74033685,0.5143788199415931,762,582,1344,+
chr10,74033691,0.9699647025704324,1017,732,1749,+
chr10,74033692,0.9699647025704324,1017,732,1749,+
chr10,74033697,0.3944795859689476,685,469,1154,+
chr10,74033698,1.7272861761158864,1278,922,2200,+
chr10,74033705,1.69017094017094,903,623,1526,+
chr10,74033709,1.6470747317740493,1740,1311,3051,+
chr10,74033723,1.7590082199164532,1331,904,2235,+
chr10,74033733,1.7591085742045176,1472,1073,2545,+
chr10,74033743,1.453283269297939,1512,1226,2738,+
chr10,74033757,1.5930874325180204,2057,1400,3457,+
chr10,74033937,1.4495672574288374,3010,2338,5348,+
chr10,74034051,1.2853599116874548,1966,1486,3452,+
chr10,74034122,1.2858101238635944,4103,3144,7247,+
chr10,74034465,0.6977954394928565,1999,1625,3624,+
chr10,74034513,1.597422317541976,5798,4506,10304,+
chr10,74034576,1.7327696830004757,5297,3686,8983,+
chr10,74034631,0.7247396584738873,2166,1137,3303,+
chr10,74034709,1.4869883437245863,2066,1053,3119,+
chr10,74034710,1.7071200805571873,1749,1401,3150,+
chr10,74034767,1.054461120897935,3424,2932,6356,+
chr10,74034770,1.3821328679687312,1605,1417,3022,+
chr10,74034790,1.439575559841616,2469,1912,4381,+
chr10,74034809,1.2713643178410794,2447,2000,4447,+
chr10,74034898,1.2554447414308199,22770,15946,38716,+
chr10,74034899,1.4309044261487232,17557,12150,29707,+
chr10,74034900,1.018742785551395,8666,6457,15123,+
chr10,74034901,1.509367490761744,6733,5122,11855,+
chr10,74035082,1.386350598454074,10600,7409,18009,+
chr10,74035083,1.3501645051684532,7210,5223,12433,+
chr10,74035178,3.2839336912603714,7588,7319,14907,+
chr10,74035243,1.4532548240635643,4433,4404,8837,+
chr10,74035267,1.4864688400899444,4407,4676,9083,+
chr10,74035312,0.7220676262214204,9757,3451,13208,+
chr10,74035352,3.036709200954919,17898,5183,23081,+
chr10,74035355,5.747876202494453,18401,5731,24132,+
chr10,74035359,2.758840892418389,19294,6492,25786,+
chr10,74035362,5.442354139590526,19649,6978,26627,+
chr10,74035368,3.4746887735268346,21809,8605,30414,+
chr10,74035371,3.8900208722411422,49109,34101,83210,+
chr10,74035372,4.493631387080751,76279,59072,135351,+
chr10,74035374,3.013780772354264,61620,51106,112726,+
chr10,74035375,2.046720595931057,27447,24758,52205,+
chr10,74035377,0.4189849555229326,29812,25543,55355,+
chr10,74035378,0.449783305264067,15138,10374,25512,+
chr10,74035379,0.36016761540731856,45728,36080,81808,+
chr10,74035385,0.4373142273644406,33237,23925,57162,+
chr10,74035394,0.3238701510569368,14916,9625,24541,+
chr10,74035431,0.8849082876737182,7916,6222,14138,+
chr10,74035523,15.782333657389614,6597,4020,10617,+
chr10,74035524,11.948605436862563,18783,11419,30202,+
chr10,74035534,8.71907839385949,15147,11431,26578,+
chr10,74035538,3.419289006789373,16063,15865,31928,+
chr10,74035635,10.082340522002625,11650,8213,19863,+
chr10,74035655,1.7563408556871474,12607,10704,23311,+
chr10,74035658,1.4095677905308464,3164,2787,5951,+
chr10,74035668,0.9852126734508707,8734,6892,15626,+
chr10,75529237,2.8376874674087804,643,405,1048,+
chr10,75541902,0.4785867237687366,893,466,1359,+
chr10,75541903,0.8421031027011376,1095,659,1754,+
chr10,75542846,1.7084606798354387,1502,999,2501,+
chr10,75542851,1.8749781735638207,825,497,1322,+
chr10,75543041,3.803231907433087,1628,1226,2854,+
chr10,75802846,2.708141690922974,754,467,1221,+
chr10,75802851,6.532338308457711,605,401,1006,+
chr10,75802853,6.532338308457711,605,401,1006,+
chr10,75802887,0.22232890497297875,717,580,1297,+
chr10,75849086,0.5317460317460317,602,458,1060,+
chr10,75849853,1.7791262135922332,732,411,1143,+
chr10,75855466,3.944140315372291,703,503,1206,+
chr10,75855608,2.4480653573766693,602,403,1005,+
chr10,75874069,0.3909256691584277,752,640,1392,+
chr10,75877787,1.2449151014459623,697,468,1165,+
chr10,75877861,3.1591397849462366,677,464,1141,+
chr10,75877862,3.1591397849462366,677,464,1141,+
chr10,75877964,1.06553911205074,734,472,1206,+
chr10,75877965,1.06553911205074,734,472,1206,+
chr10,75878342,1.8195740185563463,653,499,1152,+
chr10,75878858,0.35888930449983253,852,768,1620,+
chr10,75879155,0.40056235054782807,814,622,1436,+
chr10,75879223,0.4135433871172659,650,462,1112,+
chr10,75879289,1.7077759197324416,816,551,1367,+
chr10,75879359,1.789998281491665,743,528,1271,+
chr10,75960545,2.2171048563016598,956,845,1801,+
chr10,76074450,1.9590617715617715,790,571,1361,+
chr10,76158235,2.165167095115681,1122,777,1899,+
chr10,76158237,2.165167095115681,1122,777,1899,+
chr10,76158264,1.81301652892562,584,483,1067,+
chr10,76158327,0.6765476580412709,1376,945,2321,+
chr10,76360181,2.358561967833491,553,452,1005,+
chr10,76360182,0.9919289324776208,2529,1745,4274,+
chr10,76360214,6.183783783783784,571,480,1051,+
chr10,76468104,1.8363636363636364,1110,604,1714,+
chr10,76468153,0.47273264401772525,888,676,1564,+
chr10,76970634,1.0098919090294685,688,555,1243,+
chr10,76970635,1.0098919090294685,688,555,1243,+
chr10,76970647,2.443947224097404,667,515,1182,+
chr10,76970652,2.1154005427658413,583,455,1038,+
chr10,76970659,4.0510786796836245,647,531,1178,+
chr10,76978820,1.956315289648623,1029,782,1811,+
chr10,76978822,1.713685770750988,990,505,1495,+
chr10,76978838,2.58715845756491,1097,760,1857,+
chr10,76978841,2.098950524737631,1079,620,1699,+
chr10,76978843,0.4531656937584195,1391,1047,2438,+
chr10,76978844,1.3722693669923225,1254,757,2011,+
chr10,76978861,1.3766959297685557,1624,1252,2876,+
chr10,76978918,1.5170342300126596,2781,2001,4782,+
chr10,76982082,1.6134257905161955,964,528,1492,+
chr10,76982083,1.916474083856058,773,465,1238,+
chr10,76982087,0.3899751230874632,1082,613,1695,+
chr10,76982120,1.9755713159968478,1634,845,2479,+
chr10,76982121,1.669565217391304,2551,1333,3884,+
chr10,76982123,1.6162010030109413,4324,2533,6857,+
chr10,76982124,1.3858203644083917,5602,3235,8837,+
chr10,76982126,1.3145362606330686,6885,3932,10817,+
chr10,76982127,1.61361338358305,2987,1977,4964,+
chr10,76982128,0.6860696119525163,3433,1621,5054,+
chr10,76982130,0.9001001153227133,2088,906,2994,+
chr10,76982134,1.9472154676472333,1823,1296,3119,+
chr10,76982137,1.686128526645768,661,463,1124,+
chr10,76982144,0.6120284157352667,4022,1820,5842,+
chr10,76990826,2.325752508361204,731,459,1190,+
chr10,76990827,2.2857789855539212,1033,622,1655,+
chr10,76990852,1.829343466131252,1367,862,2229,+
chr10,76990858,2.028193226749184,693,553,1246,+
chr10,76990865,0.6150863108492238,2595,1782,4377,+
chr10,76990880,1.3912687904042371,1428,1040,2468,+
chr10,79793596,0.5969468386467562,1986,1183,3169,+
chr10,79793616,1.6981132075471697,719,423,1142,+
chr10,79793618,0.867491799750895,1754,1152,2906,+
chr10,79793619,0.8136254039790948,6374,2836,9210,+
chr10,79793620,0.8126905317100892,8569,4302,12871,+
chr10,79793622,1.2002884324535323,24099,16041,40140,+
chr10,79793623,1.4180854651578514,33513,19291,52804,+
chr10,79793624,1.4274443819210165,31287,17734,49021,+
chr10,79793626,1.0550364724202934,5148,3734,8882,+
chr10,79793627,1.7273670029055543,9237,4891,14128,+
chr10,79793630,1.5813661049042753,11915,6536,18451,+
chr10,79793634,1.5355976594590413,9651,5308,14959,+
chr10,79793636,1.4822019515130187,5328,4096,9424,+
chr10,79793638,1.548436085682295,15572,9811,25383,+
chr10,79793640,1.6835929216051273,8573,6881,15454,+
chr10,79793641,1.7380996138743168,25325,15604,40929,+
chr10,79793643,1.5432366808852929,31768,18217,49985,+
chr10,79793644,1.2965843876364411,27024,16581,43605,+
chr10,79793645,1.0534082838417431,14641,11774,26415,+
chr10,79793646,1.1623883637107033,9177,8094,17271,+
chr10,79793647,1.2736780131913474,38468,26076,64544,+
chr10,79793648,1.2434306693330204,42867,30331,73198,+
chr10,79795170,1.2111761813180926,43065,29732,72797,+
chr10,79795267,0.9686532715149524,675,464,1139,+
chr10,79795323,1.214564274814091,30084,18745,48829,+
chr10,79797056,1.2625666318719782,39219,26850,66069,+
chr10,79800371,1.4303118858875106,767,544,1311,+
chr10,79800379,0.9250183601063333,24647,17756,42403,+
chr10,81108847,5.4155548590994425,617,440,1057,+
chr10,81113532,1.1956949386512334,1006,762,1768,+
chr10,81113541,0.597216803225387,573,465,1038,+
chr10,82168335,0.7784184424479114,1543,805,2348,+
chr10,82168336,0.810302707512885,1413,632,2045,+
chr10,82168370,2.151482653888485,756,377,1133,+
chr10,82180347,1.352885898297216,618,521,1139,+
chr10,82180385,2.9953390960218234,735,554,1289,+
chr10,82187224,1.419662530936611,630,543,1173,+
chr10,82191766,1.2601555981942316,960,701,1661,+
chr10,82191822,2.2005988023952097,587,500,1087,+
chr10,82192149,0.6376670004628263,1628,1300,2928,+
chr10,82192433,0.825533346146454,746,483,1229,+
chr10,82192510,0.5143939393939394,775,479,1254,+
chr10,85899316,1.164749876119248,798,810,1608,+
chr10,85901256,0.7392614155637546,1259,952,2211,+
chr10,85901288,1.9078858677649422,2646,1791,4437,+
chr10,85901356,0.6637129180474842,2368,1771,4139,+
chr10,85902427,1.407117398289904,4130,2816,6946,+
chr10,85902428,1.407117398289904,4130,2816,6946,+
chr10,85902468,1.7576381737040851,2815,1941,4756,+
chr10,85903763,1.7987645882382726,1732,1385,3117,+
chr10,85903787,2.037851809304997,2086,1740,3826,+
chr10,85903790,1.955831608005521,2209,1954,4163,+
chr10,85903793,1.510686508299571,6283,4781,11064,+
chr10,85908586,0.5714641434262948,1223,1003,2226,+
chr10,85909933,0.6593979933110368,1271,919,2190,+
chr10,85909935,1.436853486866572,1428,918,2346,+
chr10,85910469,0.7455458137127896,3119,2228,5347,+
chr10,85910508,1.6295190131748107,2253,1790,4043,+
chr10,85910519,1.6600841944125526,1885,1169,3054,+
chr10,85910521,1.643337066069429,1173,892,2065,+
chr10,85910529,1.4510166901739538,4293,2835,7128,+
chr10,85910530,1.7066965810958588,7180,5356,12536,+
chr10,85910569,1.465206506494698,1414,1210,2624,+
chr10,85912033,1.411784914495114,1706,1227,2933,+
chr10,85912144,1.4475656811423234,1859,1506,3365,+
chr10,85912609,2.481278538812785,857,729,1586,+
chr10,88911106,1.1031786503484615,648,443,1091,+
chr10,88911107,1.1031786503484615,648,443,1091,+
chr10,88911126,1.5129606850159143,1137,808,1945,+
chr10,88911133,2.187486278814489,939,910,1849,+
chr10,88911134,1.8472279260780289,691,486,1177,+
chr10,88911135,2.187486278814489,939,910,1849,+
chr10,88911137,1.556455240665767,1037,701,1738,+
chr10,88912214,2.344325699745547,742,392,1134,+
chr10,88912216,2.638310339925699,928,489,1417,+
chr10,88912225,2.976970258348056,637,386,1023,+
chr10,88912248,5.066830988634489,1059,702,1761,+
chr10,89312014,3.314167932306357,610,418,1028,+
chr10,89312037,2.1052631578947367,679,356,1035,+
chr10,89312056,0.6790623465881199,1005,775,1780,+
chr10,89312080,0.6096942783086373,2232,1547,3779,+
chr10,89312087,1.5635521885521884,1485,863,2348,+
chr10,89312088,1.967241265438214,1123,720,1843,+
chr10,89312673,2.6246094331200718,629,516,1145,+
chr10,89312710,1.9074335322843192,650,484,1134,+
chr10,89312724,0.6695081967213116,1020,949,1969,+
chr10,89312725,1.9082125603864732,789,683,1472,+
chr10,89312728,1.6379769299023956,1195,1126,2321,+
chr10,89312746,1.6323238973008558,869,979,1848,+
chr10,89312751,1.5535289452815229,1958,2424,4382,+
chr10,89312752,1.6594637540082453,3010,3775,6785,+
chr10,89312754,1.8264729620661824,2045,2595,4640,+
chr10,89312757,1.3448526070212603,3475,3489,6964,+
chr10,89624198,2.439057156814851,950,711,1661,+
chr10,89624200,1.6428802111930896,2437,1652,4089,+
chr10,89720743,2.9811616954474096,632,440,1072,+
chr10,90665238,3.6664162283997,731,725,1456,+
chr10,90665240,3.6664162283997,731,725,1456,+
chr10,90665265,1.6966599738402532,892,672,1564,+
chr10,90665280,2.0584615467863956,1115,921,2036,+
chr10,90665294,0.5925943829458113,1885,1509,3394,+
chr10,90665295,0.880086186876545,2505,2094,4599,+
chr10,90668467,2.3202274131641785,837,597,1434,+
chr10,90672989,1.641025641025641,735,597,1332,+
chr10,90672999,1.917374080362196,846,588,1434,+
chr10,90774094,0.6929025753298381,623,398,1021,+
chr10,93614789,1.685185185185185,571,431,1002,+
chr10,93614825,2.3076974447351484,1476,904,2380,+
chr10,93624836,12.594073272593652,408,804,1212,+
chr10,93624837,8.852355004193544,674,1380,2054,+
chr10,93624868,0.067578125,345,767,1112,+
chr10,93624870,0.067578125,345,767,1112,+
chr10,93726413,1.7735600864417929,967,733,1700,+
chr10,93726417,1.7475232198142416,1064,849,1913,+
chr10,93749311,6.766131628258432,625,464,1089,+
chr10,94353180,1.8609018685308505,947,888,1835,+
chr10,94353181,1.7999479843953188,843,768,1611,+
chr10,94353183,2.542615930509197,1060,1079,2139,+
chr10,94353184,3.308465608465608,480,539,1019,+
chr10,94368832,2.9215760132459616,749,492,1241,+
chr10,94413481,0.4945827715062113,906,486,1392,+
chr10,94413490,2.254042775169536,893,638,1531,+
chr10,94413492,2.349457725986879,1271,863,2134,+
chr10,94413496,2.194151840760965,1020,810,1830,+
chr10,94413498,2.194151840760965,1020,810,1830,+
chr10,94733861,2.6398709315375983,606,395,1001,+
chr10,94733862,2.6398709315375983,606,395,1001,+
chr10,94733868,2.6581359049584874,708,402,1110,+
chr10,95276848,1.9450561925303669,658,382,1040,+
chr10,95276861,2.710583153347732,752,462,1214,+
chr10,95276896,1.797730390322983,900,593,1493,+
chr10,95276914,2.0703961102397224,2666,1879,4545,+
chr10,95276915,2.485415431067019,1486,1090,2576,+
chr10,95276996,1.6271315784704785,611,446,1057,+
chr10,96350429,0.7584415584415585,729,439,1168,+
chr10,98510632,1.9574468085106385,1195,845,2040,+
chr10,98510633,1.9574468085106385,1195,845,2040,+
chr10,99190354,1.6693059299191375,733,370,1103,+
chr10,99190404,0.6074287842115063,724,523,1247,+
chr10,99192318,1.9442432147564583,1249,594,1843,+
chr10,99192319,2.679900744416873,863,402,1265,+
chr10,99192320,2.679900744416873,863,402,1265,+
chr10,99192358,2.087769565547505,1696,1076,2772,+
chr10,99192369,1.769875478927203,1166,695,1861,+
chr10,99192376,0.5302369900750972,1518,875,2393,+
chr10,99192377,1.8655053503750156,1681,1085,2766,+
chr10,99192386,1.4622319956019791,1143,679,1822,+
chr10,99192752,2.3758642784566657,1136,591,1727,+
chr10,99192753,2.8870864228870508,972,527,1499,+
chr10,99192774,3.560621584699454,718,365,1083,+
chr10,99192775,3.560621584699454,718,365,1083,+
chr10,99192776,3.560621584699454,718,365,1083,+
chr10,99192785,1.6914831398503047,1282,949,2231,+
chr10,99192792,1.7305640620369456,686,381,1067,+
chr10,101502934,1.7391304347826086,759,493,1252,+
chr10,102106964,1.5309096732863552,868,445,1313,+
chr10,102106989,0.6942167110746738,738,573,1311,+
chr10,102106990,2.3619047619047624,619,449,1068,+
chr10,102107000,1.7581069237510951,1179,651,1830,+
chr10,102107003,1.3421218766613503,754,607,1361,+
chr10,102107084,1.53995370595038,2691,1727,4418,+
chr10,102107177,2.421010101010101,641,494,1135,+
chr10,102107237,2.317394578313253,1230,746,1976,+
chr10,102107832,1.4936049970255802,912,655,1567,+
chr10,102107849,0.667087967644085,1130,859,1989,+
chr10,102107850,1.4503194536241464,1134,889,2023,+
chr10,102107888,1.9064173192586877,3706,3146,6852,+
chr10,102107889,1.6465089709968064,2291,2026,4317,+
chr10,102107893,1.5589513719098071,1496,1226,2722,+
chr10,102108012,1.4584072890782156,1478,938,2416,+
chr10,102108015,1.3404429860541427,2235,1377,3612,+
chr10,102112193,0.9282131434751024,3894,3072,6966,+
chr10,102112194,1.2746017114248063,7694,5616,13310,+
chr10,102112238,1.3248627953596896,2208,1322,3530,+
chr10,102114255,0.9689112834693573,4233,3315,7548,+
chr10,102114333,1.8088313727151073,3381,2692,6073,+
chr10,102120556,1.978049062774176,3220,2295,5515,+
chr10,102120561,1.8824250681198909,1010,733,1743,+
chr10,102120577,0.7655325443786983,1655,1351,3006,+
chr10,102120581,1.395512762048703,1390,1080,2470,+
chr10,102121017,1.6670588800307367,1901,1435,3336,+
chr10,102121130,1.3605442176870748,2887,1994,4881,+
chr10,102121224,1.572550831792976,3402,2163,5565,+
chr10,102121379,1.750595021749071,1658,1272,2930,+
chr10,102121380,0.6623034878968831,2713,1988,4701,+
chr10,102121408,1.87095753433327,1597,1373,2970,+
chr10,102121510,1.2578477057178885,3018,1971,4989,+
chr10,102121537,1.602204992605208,1649,1262,2911,+
chr10,102121609,1.5031424248250724,4706,3232,7938,+
chr10,102121611,1.7163509211474848,8189,5809,13998,+
chr10,102121626,2.1398951473545544,3462,2732,6194,+
chr10,102121924,1.919014303482587,1602,1339,2941,+
chr10,102121931,0.8397244636322578,3007,2022,5029,+
chr10,102121944,1.5704950266018969,2088,1571,3659,+
chr10,102122081,1.6071087429506075,3298,2278,5576,+
chr10,102122098,1.893339481379913,1695,1350,3045,+
chr10,102122228,1.4878119057223536,1654,1294,2948,+
chr10,102122234,1.341211411723899,2890,1921,4811,+
chr10,102122625,1.020611982244032,2887,2084,4971,+
chr10,102122639,1.372429855388669,3709,2773,6482,+
chr10,102122640,1.4005491570067217,5743,4335,10078,+
chr10,102122642,1.4508474998638738,5839,4093,9932,+
chr10,102122786,1.4910835597826086,1950,1407,3357,+
chr10,102122787,1.4560690810848107,3368,2232,5600,+
chr10,102122851,1.349395843659173,4778,3224,8002,+
chr10,102122894,0.9230618829647486,6452,3601,10053,+
chr10,102122895,0.9230618829647486,6452,3601,10053,+
chr10,102122904,1.4308105266552815,6484,3962,10446,+
chr10,102122917,1.6418567376821651,9691,5195,14886,+
chr10,102122922,1.822168387862081,10381,5692,16073,+
chr10,102122926,1.5334828001518108,17323,10251,27574,+
chr10,102122927,1.5017094815506773,17174,10704,27878,+
chr10,102122929,1.5071054912238568,11702,7366,19068,+
chr10,102122934,1.542891368486435,6623,4433,11056,+
chr10,102122980,1.2104356011865256,13304,7419,20723,+
chr10,102122988,0.9609917774003139,30651,19232,49883,+
chr10,102122993,0.8446314739817717,18952,10921,29873,+
chr10,102123000,1.2278433965538436,39060,23582,62642,+
chr10,102123395,0.47547072956730335,2158,1244,3402,+
chr10,102123400,0.8122579486080239,2969,1556,4525,+
chr10,102123469,7.259016393442623,1106,304,1410,+
chr10,102123475,4.826506640304908,2280,645,2925,+
chr10,102123478,65.4573486828294,8635,5086,13721,+
chr10,102123479,65.4573486828294,8635,5086,13721,+
chr10,102123482,2.1166783363674555,1127,964,2091,+
chr10,102123492,0.6019841269841268,1024,1049,2073,+
chr10,102123499,1.650505050505051,1538,1457,2995,+
chr10,102123611,0.657348665080624,2029,1454,3483,+
chr10,102123724,1.8821000848921339,3902,2704,6606,+
chr10,102123746,1.7776779266629223,1815,1132,2947,+
chr10,102123891,4.801147227533461,809,522,1331,+
chr10,102123897,1.4108550785052845,2539,1736,4275,+
chr10,102123898,2.1889862327909886,635,563,1198,+
chr10,102124098,2.145391903531438,957,644,1601,+
chr10,102124192,1.448489010989011,1368,1035,2403,+
chr10,102133666,1.8387944629402488,635,438,1073,+
chr10,102141115,2.238141737359944,953,634,1587,+
chr10,102141147,1.9843362282878407,852,623,1475,+
chr10,102141154,1.642581392356196,1041,817,1858,+
chr10,102141198,2.0992625117382047,1236,845,2081,+
chr10,102147887,2.0624024221611124,816,521,1337,+
chr10,102799473,1.951036460547139,770,411,1181,+
chr10,102799474,1.951036460547139,770,411,1181,+
chr10,102799491,7.35913029246972,989,664,1653,+
chr10,102799496,4.6054404162834786,2094,1878,3972,+
chr10,102799497,4.392988544594718,1987,1799,3786,+
chr10,103912192,3.8175702413929566,876,360,1236,+
chr10,103912193,3.8175702413929566,876,360,1236,+
chr10,103912208,2.080769230769231,1081,571,1652,+
chr10,103912209,2.080769230769231,1081,571,1652,+
chr10,103912210,0.4382282996432818,701,579,1280,+
chr10,103912211,0.4382282996432818,701,579,1280,+
chr10,103912259,1.954394854804132,871,732,1603,+
chr10,103912261,1.954394854804132,871,732,1603,+
chr10,103916775,2.084990548204159,810,574,1384,+
chr10,103916782,2.003086419753086,589,539,1128,+
chr10,103916809,0.5994059595669254,735,496,1231,+
chr10,103916815,0.5729806821972464,1535,1152,2687,+
chr10,103917074,1.8777652793400823,625,380,1005,+
chr10,103917191,3.3588643790849675,714,407,1121,+
chr10,103918964,2.238899803536346,813,508,1321,+
chr10,103919059,1.69729216152019,615,420,1035,+
chr10,103919198,1.1314670593731866,1143,887,2030,+
chr10,103919735,2.7778795683620965,963,800,1763,+
chr10,103919749,1.8177623990772784,590,458,1048,+
chr10,103919993,1.974811934358007,1401,1006,2407,+
chr10,103920050,1.7425742574257426,1063,706,1769,+
chr10,103920066,1.048537047977364,1296,1108,2404,+
chr10,103920067,1.048537047977364,1296,1108,2404,+
chr10,103920271,1.3353486874471494,1470,1020,2490,+
chr10,103920308,2.7350689127105663,892,652,1544,+
chr10,103920327,0.6750018399941121,1333,1293,2626,+
chr10,103920349,1.7203634861627426,1189,1075,2264,+
chr10,103920504,2.515557867277256,1206,901,2107,+
chr10,103920567,1.558696505692972,793,565,1358,+
chr10,103920733,1.7675095506639986,693,477,1170,+
chr10,103920789,1.011713746376323,1176,1140,2316,+
chr10,103920790,1.011713746376323,1176,1140,2316,+
chr10,103920816,0.44812344289962225,696,540,1236,+
chr10,103920836,1.5827010622154778,893,658,1551,+
chr10,103921375,2.7006783493499147,974,609,1583,+
chr10,103921594,2.227742448330684,884,628,1512,+
chr10,103921913,1.867940373714046,573,432,1005,+
chr10,103921927,2.848951048951049,678,428,1106,+
chr10,103921982,1.9827276652984471,1263,917,2180,+
chr10,103922003,0.580172987358616,653,500,1153,+
chr10,103922039,0.49437111801242234,848,643,1491,+
chr10,103922766,1.8144,647,374,1021,+
chr10,103923198,2.046843830244292,1262,978,2240,+
chr10,103923247,2.9429280397022333,592,433,1025,+
chr10,103923268,0.5678665616330445,828,678,1506,+
chr10,103923270,1.7250207296849087,978,602,1580,+
chr10,103923276,0.6486158183617767,1108,865,1973,+
chr10,103923278,1.5152027027027029,896,665,1561,+
chr10,103923279,1.5095548914753063,1145,747,1892,+
chr10,103923374,2.344698261166042,597,418,1015,+
chr10,103923403,1.4302252816020025,652,475,1127,+
chr10,104158000,2.501518279637379,689,452,1141,+
chr10,104159388,3.0974603459269887,1161,743,1904,+
chr10,104159390,3.0195532983319135,844,458,1302,+
chr10,104159401,2.010263580783425,768,459,1227,+
chr10,105752792,1.381428423160209,788,532,1320,+
chr10,106014658,0.6830848570241218,967,539,1506,+
chr10,106014967,1.5966683136867366,753,456,1209,+
chr10,106014973,2.440556660039761,791,502,1293,+
chr10,106019337,0.487864406779661,1027,749,1776,+
chr10,106019338,2.5232432432432432,777,739,1516,+
chr10,106019346,0.3783037974683544,878,789,1667,+
chr10,106019440,1.7111640166652493,874,618,1492,+
chr10,106019471,3.359722222222222,884,674,1558,+
chr10,106019488,1.5205150513311292,992,820,1812,+
chr10,106019539,0.6714380306925295,1498,1166,2664,+
chr10,106022750,2.263515016685206,1196,929,2125,+
chr10,106022776,1.5257301249347206,2109,1363,3472,+
chr10,106025887,2.180543903803132,1176,893,2069,+
chr10,106027052,2.025270758122744,824,553,1377,+
chr10,111893219,2.420307309316646,630,465,1095,+
chr10,112337228,2.339578454332553,593,426,1019,+
chr10,112337229,2.339578454332553,593,426,1019,+
chr10,112338424,2.555570586820587,807,678,1485,+
chr10,112352911,2.3416881230852455,652,389,1041,+
chr10,112359450,1.6272896164716906,2093,1213,3306,+
chr10,112359456,1.2014173394728072,4258,2201,6459,+
chr10,112359468,1.8539455641752915,2436,1531,3967,+
chr10,112359472,2.2424451441316995,5490,3106,8596,+
chr10,112360279,2.288830175408871,817,603,1420,+
chr10,112361410,2.1772418413245287,1749,1547,3296,+
chr10,112361412,2.1772418413245287,1749,1547,3296,+
chr10,112361413,0.415527950310559,668,524,1192,+
chr10,112361442,0.6516541562413122,1171,1198,2369,+
chr10,112361447,1.1507554021804498,2366,2231,4597,+
chr10,112361461,0.593094944512947,1146,810,1956,+
chr10,112361464,1.506040084195113,1241,891,2132,+
chr10,112361472,1.541111111111111,1459,1079,2538,+
chr10,112361475,1.753253260284236,3342,3094,6436,+
chr10,112361476,1.753253260284236,3342,3094,6436,+
chr10,112361479,2.4565630944831955,1787,1742,3529,+
chr10,112361615,2.604803270311702,707,514,1221,+
chr10,112361616,2.604803270311702,707,514,1221,+
chr10,112361924,1.4052186486991993,1397,1006,2403,+
chr10,112642823,4.378500397133595,1245,989,2234,+
chr10,112642825,1.268618387262455,779,648,1427,+
chr10,112642827,1.2831878009219189,805,626,1431,+
chr10,112654232,2.130938003220612,682,431,1113,+
chr10,112655808,0.8099168782454598,1640,1318,2958,+
chr10,112655809,0.3145917678812415,1096,911,2007,+
chr10,112655833,2.1345707656612527,599,430,1029,+
chr10,112658251,2.221447868758266,860,654,1514,+
chr10,112658399,1.7610748002904866,678,458,1136,+
chr10,112745402,0.5370045248868778,734,626,1360,+
chr10,112760183,3.2304297289193777,637,392,1029,+
chr10,114911533,0.7937240897388158,887,699,1586,+
chr10,121436315,0.34076311520083147,579,443,1022,+
chr10,121436381,2.686299081035923,544,629,1173,+
chr10,121436382,2.232324267883,1378,1485,2863,+
chr10,121436384,1.9172281401739002,834,856,1690,+
chr10,121436386,2.9256554393839034,585,456,1041,+
chr10,121436922,0.30320427523581184,1008,837,1845,+
chr10,122668853,2.634977064220184,620,435,1055,+
chr10,122668855,2.634977064220184,620,435,1055,+
chr10,124266908,1.1349929316035687,1066,690,1756,+
chr10,124271493,5.153049193877192,625,461,1086,+
chr10,124914485,1.961474099064649,1267,857,2124,+
chr10,124914494,2.4892703862660945,579,465,1044,+
chr10,124914515,1.5474441833137484,902,551,1453,+
chr10,124914593,0.6281227694503926,659,466,1125,+
chr10,124914623,3.1807902556594887,1388,898,2286,+
chr10,124917335,0.5303899478871487,1278,990,2268,+
chr10,124917354,1.7138534014225029,1769,1364,3133,+
chr10,124919924,1.5161035614844367,985,616,1601,+
chr10,124920039,2.1174852270853397,1474,1104,2578,+
chr10,124920043,1.6454536594873794,937,661,1598,+
chr10,124920071,0.627753086419753,907,809,1716,+
chr10,124921758,1.8074074074074076,1341,890,2231,+
chr10,124921791,0.5993265244885031,1283,1138,2421,+
chr10,124922165,1.4588477366255144,1417,971,2388,+
chr10,124922168,0.696662656189365,3147,2373,5520,+
chr10,124922307,1.568125,964,749,1713,+
chr10,124924092,3.53882959146117,640,493,1133,+
chr10,124924094,3.53882959146117,640,493,1133,+
chr10,124924506,1.3397995617377931,825,712,1537,+
chr10,126172867,5.92018779342723,581,425,1006,+
chr10,126495453,3.9902769041532338,714,462,1176,+
chr10,126507953,1.8221403113100572,1766,1139,2905,+
chr10,127512214,2.9399260982897917,1282,1104,2386,+
chr10,127512215,2.2631225806451614,755,774,1529,+
chr10,127515216,1.790385964912281,822,569,1391,+
chr10,127520082,1.1000298342070494,1779,1421,3200,+
chr10,127520083,1.408881886984961,2313,1896,4209,+
chr10,127522360,1.7014028056112225,565,498,1063,+
chr10,127522368,1.362809544353599,1061,767,1828,+
chr10,127522461,0.6881652037417546,3384,2114,5498,+
chr10,127522464,1.962979323110578,1608,896,2504,+
chr10,127522465,0.6930611272192874,2357,1480,3837,+
chr10,127524837,1.6125553097345133,832,564,1396,+
chr10,128594119,1.0478247721086966,723,585,1308,+
chr10,128594120,1.229715797677124,1301,911,2212,+
chr10,128768965,0.5080660776429748,847,642,1489,+
chr10,128768968,0.570731351981352,1566,1187,2753,+
chr10,128768969,0.570731351981352,1566,1187,2753,+
chr10,128768970,2.2534779274838423,555,536,1091,+
chr10,128768973,1.7190801673958456,2318,1942,4260,+
chr10,128768974,1.911247130833971,1248,1306,2554,+
chr10,128829921,3.039938033854573,752,473,1225,+
chr10,128829933,2.605559729526672,866,604,1470,+
chr10,128829935,2.605559729526672,866,604,1470,+
chr10,129217934,4.320438099486332,786,484,1270,+
chr10,131934767,1.0261413243920534,567,441,1008,+
chr10,131943527,2.012993098617781,1236,947,2183,+
chr10,131959110,1.6619961753456896,1050,823,1873,+
chr10,131959195,0.7038216560509554,1325,941,2266,+
chr10,131964771,2.839717741935484,625,495,1120,+
chr10,131969888,1.682505580357143,1282,895,2177,+
chr10,131977663,1.6928270042194091,1002,789,1791,+
chr10,131977719,2.0863636363636364,917,549,1466,+
chr11,247324,1.7888198757763976,543,482,1025,+
chr11,251885,1.9206290367386625,990,704,1694,+
chr11,252585,2.6712281686189243,638,422,1060,+
chr11,252621,4.014807411284414,594,431,1025,+
chr11,252689,0.4709639188459182,637,420,1057,+
chr11,308193,1.8011976941695875,1085,865,1950,+
chr11,308196,0.9286794987649278,2894,2368,5262,+
chr11,308199,1.3744740532959328,1035,712,1747,+
chr11,308322,2.7650704812231583,768,444,1212,+
chr11,308372,2.6772068511198945,507,551,1058,+
chr11,308373,2.6772068511198945,507,551,1058,+
chr11,309040,1.8044258373205746,861,417,1278,+
chr11,309042,1.8044258373205746,861,417,1278,+
chr11,309063,1.743288506728465,3232,2301,5533,+
chr11,309064,1.6464156716646232,4584,3791,8375,+
chr11,309066,1.6011939931400991,5528,4382,9910,+
chr11,309067,1.6317427385892114,1572,963,2535,+
chr11,309070,2.152211998364144,2955,2585,5540,+
chr11,309073,1.387654535704451,1495,1265,2760,+
chr11,309074,2.6191478820906613,1006,733,1739,+
chr11,309078,0.6326587367008212,2566,2900,5466,+
chr11,309079,1.348557708234248,9794,8570,18364,+
chr11,309080,1.1527331524110334,18383,17362,35745,+
chr11,309081,1.1865131459768121,17244,16054,33298,+
chr11,309082,1.2714930295229967,11054,10018,21072,+
chr11,309094,0.6742305714220025,35743,32143,67886,+
chr11,309095,0.6705696599645301,43183,38354,81537,+
chr11,309096,0.6705696599645301,43183,38354,81537,+
chr11,309097,0.6372781242598502,20641,17731,38372,+
chr11,309105,0.5858114674441205,3835,2939,6774,+
chr11,309109,0.7491855334240588,5891,4778,10669,+
chr11,309176,1.840506620610248,1507,964,2471,+
chr11,314014,1.5219923585872706,555,587,1142,+
chr11,314015,1.1394886307415248,956,1013,1969,+
chr11,314016,0.9639940038403209,4204,4137,8341,+
chr11,314017,0.9151535073914651,3442,3112,6554,+
chr11,314018,0.9384737860856702,3897,3850,7747,+
chr11,314039,0.5193236714975846,849,611,1460,+
chr11,314064,0.5589376915219612,797,622,1419,+
chr11,314116,1.732857117472502,2437,1442,3879,+
chr11,314118,1.732857117472502,2437,1442,3879,+
chr11,314131,1.490289338089576,1119,840,1959,+
chr11,314240,2.185131798144246,2005,1521,3526,+
chr11,314242,2.1969042193761297,1164,978,2142,+
chr11,314245,1.451121512826009,2878,1818,4696,+
chr11,314246,1.2233381199777362,2528,1810,4338,+
chr11,314296,1.9540983606557376,1042,792,1834,+
chr11,314972,2.295956498930188,846,757,1603,+
chr11,314988,1.607713052858684,726,411,1137,+
chr11,314990,0.6585365853658536,863,719,1582,+
chr11,314991,1.8565994338287328,676,470,1146,+
chr11,315003,1.556541807207527,1095,654,1749,+
chr11,315163,2.283843241583956,1239,673,1912,+
chr11,315215,1.1445963752947712,2581,1878,4459,+
chr11,747463,1.0080251571864596,2576,1404,3980,+
chr11,747464,1.0242859496960484,2404,1319,3723,+
chr11,747465,1.0492865513200524,1415,651,2066,+
chr11,747481,1.7968900574427131,927,659,1586,+
chr11,747539,0.508235294117647,647,449,1096,+
chr11,755936,1.6449447077409165,594,421,1015,+
chr11,755977,1.7580935251798562,804,555,1359,+
chr11,758964,1.741225573894896,1058,752,1810,+
chr11,760174,1.7400846003722075,3201,2201,5402,+
chr11,760176,1.7315463026090427,2313,1561,3874,+
chr11,760177,1.507696033016087,2016,1531,3547,+
chr11,760179,1.54486540204415,5064,3955,9019,+
chr11,760180,1.7011316107938261,3204,2545,5749,+
chr11,760181,1.7011316107938261,3204,2545,5749,+
chr11,760184,1.4626556016597512,1174,963,2137,+
chr11,760191,0.5609328617444577,1224,891,2115,+
chr11,760202,1.4251828047767534,3737,3192,6929,+
chr11,760204,1.4251828047767534,3737,3192,6929,+
chr11,760208,0.9925239966910475,10318,7753,18071,+
chr11,760209,1.3925116524826908,7315,6714,14029,+
chr11,760210,0.8773264727389941,9084,5730,14814,+
chr11,760211,1.340962104742971,10820,10258,21078,+
chr11,760212,1.243365103971721,18388,14412,32800,+
chr11,760213,1.3751903877749498,15370,12532,27902,+
chr11,763369,0.5864131213293224,654,536,1190,+
chr11,763435,2.4273087473331305,723,385,1108,+
chr11,763463,1.8375461516614597,646,502,1148,+
chr11,763490,1.482577379793654,1189,933,2122,+
chr11,763491,0.5856348754759925,1114,736,1850,+
chr11,763770,1.4740772349050566,1127,871,1998,+
chr11,763836,1.63428334910123,746,603,1349,+
chr11,764302,1.796875,689,479,1168,+
chr11,764303,1.814550225980464,1015,721,1736,+
chr11,764305,1.814550225980464,1015,721,1736,+
chr11,764346,1.693127608825283,648,558,1206,+
chr11,764392,1.5047943746004686,641,493,1134,+
chr11,764873,0.4870503086638756,1039,828,1867,+
chr11,764896,1.661078557327735,854,678,1532,+
chr11,764912,2.8910864803876017,989,792,1781,+
chr11,764916,1.6190476190476188,1223,827,2050,+
chr11,809966,0.9511924318077044,762,660,1422,+
chr11,809967,0.4759096641599327,714,315,1029,+
chr11,809968,0.9511924318077044,762,660,1422,+
chr11,809969,1.0687677455990914,648,586,1234,+
chr11,809971,1.0687677455990914,648,586,1234,+
chr11,809985,1.7872534835909542,651,570,1221,+
chr11,809989,2.0652263850185824,2000,1132,3132,+
chr11,810004,1.0726599809815411,2315,1426,3741,+
chr11,810005,1.712464046021093,1010,744,1754,+
chr11,810007,1.6666073968705548,1441,702,2143,+
chr11,810011,2.356142456982793,1103,832,1935,+
chr11,810233,1.9905263157894741,731,569,1300,+
chr11,810250,1.718982275586049,1717,923,2640,+
chr11,810253,1.501195600191296,875,696,1571,+
chr11,810303,1.656481029432278,4301,3215,7516,+
chr11,810305,1.5642377923693689,6662,5058,11720,+
chr11,810306,1.409012154767481,8660,6266,14926,+
chr11,810313,1.0608251042651764,5393,3842,9235,+
chr11,810351,1.4636824676057658,6047,4278,10325,+
chr11,811617,1.346318367594285,7127,5683,12810,+
chr11,836769,2.322089650378534,713,561,1274,+
chr11,838386,5.265818422281007,1466,298,1764,+
chr11,838388,3.3078370705437576,1963,492,2455,+
chr11,838389,2.7673636494763967,1501,389,1890,+
chr11,838397,13.260188364764309,1211,662,1873,+
chr11,838398,8.125645541263884,3117,1933,5050,+
chr11,838399,7.423248238980913,3361,2254,5615,+
chr11,838400,6.752725448080805,2965,2112,5077,+
chr11,838401,4.820369560095587,708,802,1510,+
chr11,838411,10.325941380947885,3118,3818,6936,+
chr11,838412,10.325941380947885,3118,3818,6936,+
chr11,838413,10.325941380947885,3118,3818,6936,+
chr11,838501,1.2274241727941175,928,511,1439,+
chr11,838502,1.2274241727941175,928,511,1439,+
chr11,838503,1.2274241727941175,928,511,1439,+
chr11,866878,22.53632059766422,1960,2434,4394,+
chr11,866879,22.536320597664215,1960,2434,4394,+
chr11,866880,23.77407665408181,1813,2357,4170,+
chr11,866891,0.4141761255163316,627,872,1499,+
chr11,866893,0.4538175871350209,443,598,1041,+
chr11,866912,0.1697912400684107,533,1013,1546,+
chr11,970258,3.146461187214612,640,583,1223,+
chr11,970260,2.7834656237017343,1093,883,1976,+
chr11,2417149,1.8543307086614171,627,380,1007,+
chr11,2417152,1.728510638297872,676,422,1098,+
chr11,2418196,1.5602734234946007,777,579,1356,+
chr11,2418340,4.192850838874988,647,458,1105,+
chr11,2870104,3.477090007467327,703,438,1141,+
chr11,2870105,5.368421052631579,645,360,1005,+
chr11,2870107,3.7131715282742577,708,431,1139,+
chr11,2946388,5.178818612064685,673,473,1146,+
chr11,4104511,2.080680031446541,682,423,1105,+
chr11,4104513,2.167686714680973,1048,691,1739,+
chr11,4116056,2.6048447049118915,1126,396,1522,+
chr11,4116057,2.493833393436711,973,294,1267,+
chr11,4116058,2.3717558340530456,1168,406,1574,+
chr11,4116062,1.9619513782089197,869,1263,2132,+
chr11,4116063,2.051169494363203,5952,7508,13460,+
chr11,4116064,2.051169494363203,5952,7508,13460,+
chr11,4116065,2.040538609390465,5779,7372,13151,+
chr11,4116069,0.5354441184484708,5096,7263,12359,+
chr11,4116070,0.5354441184484708,5096,7263,12359,+
chr11,4116091,0.6182859738705039,4203,4999,9202,+
chr11,4116092,0.6091505979460984,5765,7121,12886,+
chr11,4116232,1.7341365461847391,1396,912,2308,+
chr11,4123242,1.964167493656048,2136,1686,3822,+
chr11,4123243,1.7734745122815858,3477,2832,6309,+
chr11,4123263,1.6815670517327974,1673,1085,2758,+
chr11,4127294,1.6065645260810515,3522,2523,6045,+
chr11,4127419,1.4857403808236245,3074,2105,5179,+
chr11,4130895,1.4031130532696674,4288,3073,7361,+
chr11,4139680,1.727180033970638,3435,2610,6045,+
chr11,4142851,0.7239456917475727,2120,1647,3767,+
chr11,4142869,1.9688662461588227,3513,3205,6718,+
chr11,4142870,1.3585607475410697,10182,8384,18566,+
chr11,4142871,1.391584086461105,15616,13013,28629,+
chr11,4142873,1.4604846294114724,22136,19078,41214,+
chr11,4142874,1.607069596786215,20743,18532,39275,+
chr11,4142875,1.4764003797640035,16932,14745,31677,+
chr11,4143390,1.3711431009330874,2459,1545,4004,+
chr11,4143428,2.483634574851461,4144,2766,6910,+
chr11,4144417,1.3418083792573439,14945,10852,25797,+
chr11,4144418,1.4064860346024357,9620,6264,15884,+
chr11,4144419,1.2303984700324997,10737,8454,19191,+
chr11,4144420,1.264034942001774,16734,12470,29204,+
chr11,4144436,1.6656073798712638,7073,6543,13616,+
chr11,4144438,1.6375010241023225,10824,10146,20970,+
chr11,4144439,1.6892262358739198,7388,7030,14418,+
chr11,4144442,1.4702339091881975,4006,4008,8014,+
chr11,4147963,1.647794490451242,1624,1357,2981,+
chr11,4148307,2.3721925125087275,2934,2371,5305,+
chr11,4148326,1.3824895531983286,1932,1463,3395,+
chr11,4148453,2.028844721237224,1153,906,2059,+
chr11,4153596,1.967728963506585,1586,1420,3006,+
chr11,4153619,1.2573277967757694,3189,2046,5235,+
chr11,4153638,1.6690071181264918,2265,2547,4812,+
chr11,4156431,1.374963503649635,1862,1643,3505,+
chr11,4159909,1.6803496081977096,1370,1105,2475,+
chr11,4160003,1.7105248259072638,1118,1038,2156,+
chr11,4160055,1.9534748049296289,723,652,1375,+
chr11,5655891,2.8632061298076925,846,511,1357,+
chr11,5655893,2.8632061298076925,846,511,1357,+
chr11,5655899,2.2620585701981053,954,773,1727,+
chr11,5655901,1.8953086029884199,1227,958,2185,+
chr11,5655910,2.911514445299604,1692,1286,2978,+
chr11,5655911,3.27465187365561,1156,802,1958,+
chr11,6625509,0.2522281639928699,565,461,1026,+
chr11,6625510,0.2522281639928699,565,461,1026,+
chr11,6629373,1.5796629609979835,786,462,1248,+
chr11,6629708,1.4062188643469435,694,489,1183,+
chr11,6630552,4.344698544698545,773,480,1253,+
chr11,6630554,4.344698544698545,773,480,1253,+
chr11,6630853,2.6453325838491493,702,533,1235,+
chr11,6631020,2.324575053977329,805,642,1447,+
chr11,6631188,0.44373949319186284,566,488,1054,+
chr11,6631221,1.2165222802032087,858,549,1407,+
chr11,8008888,2.4069959375304557,709,492,1201,+
chr11,8008892,2.0284772724204143,1958,966,2924,+
chr11,8008893,2.034914483816428,2295,1175,3470,+
chr11,8008894,2.0284772724204143,1958,966,2924,+
chr11,8009031,1.2841474445952057,830,602,1432,+
chr11,8009032,1.2841474445952057,830,602,1432,+
chr11,8014471,1.5561560547204867,812,572,1384,+
chr11,8014528,1.0941560028375938,2694,1757,4451,+
chr11,8014529,1.6106534090909093,1478,879,2357,+
chr11,8014530,0.5127881009564742,1216,878,2094,+
chr11,8014537,1.9488656195462477,858,572,1430,+
chr11,8014548,2.380806533945891,741,652,1393,+
chr11,8014557,0.546826453617399,879,750,1629,+
chr11,8014558,1.8182258419546555,1058,648,1706,+
chr11,8016007,2.5649329097719407,1150,916,2066,+
chr11,8016852,1.7994291019551936,2318,1782,4100,+
chr11,8704337,1.0005140099040934,2255,1805,4060,+
chr11,8704338,0.9817050690082556,8991,6785,15776,+
chr11,8704339,0.9751871191928663,6736,4980,11716,+
chr11,8704356,0.6858947658044274,2848,1732,4580,+
chr11,8704754,0.5513269330366406,5959,4810,10769,+
chr11,8704760,1.2930158426052558,3645,2740,6385,+
chr11,8704763,1.1878893740902474,4039,2999,7038,+
chr11,8704771,1.3101942609402852,16456,12465,28921,+
chr11,8704773,1.3562719399959398,10526,8000,18526,+
chr11,8704777,1.457798384538422,6145,4764,10909,+
chr11,8705609,1.4955891011273728,14026,10185,24211,+
chr11,8705614,1.378796614599039,9825,5526,15351,+
chr11,8705623,0.8803908234850544,8878,7616,16494,+
chr11,8706349,1.2785959733774406,10937,5441,16378,+
chr11,8706367,1.3260514930136889,6231,3064,9295,+
chr11,8706383,1.1436390294001724,45628,30329,75957,+
chr11,8706384,1.0862146975139408,39296,25253,64549,+
chr11,8706392,1.2052146999427933,29424,16702,46126,+
chr11,8706393,1.1281156730840523,62650,41051,103701,+
chr11,8706394,1.128968312530735,56872,34009,90881,+
chr11,8706396,0.9787820545639798,45870,28463,74333,+
chr11,8706397,0.9952634944666028,23863,13711,37574,+
chr11,8707234,1.095598121444499,73286,53578,126864,+
chr11,8707415,4.565600036310821,617,463,1080,+
chr11,9406238,3.2355924901393927,996,590,1586,+
chr11,9406256,1.373254945518218,844,553,1397,+
chr11,9406272,1.4848139667775706,613,446,1059,+
chr11,9406287,0.774230105937423,826,614,1440,+
chr11,9406288,0.774230105937423,826,614,1440,+
chr11,9406311,0.8285396472270777,1421,898,2319,+
chr11,9406313,0.8285396472270777,1421,898,2319,+
chr11,9406317,2.0045045045045047,711,369,1080,+
chr11,9406318,0.6438692612884943,1135,631,1766,+
chr11,9406319,0.6209475949111178,999,562,1561,+
chr11,9406326,1.4919917383063712,2314,1383,3697,+
chr11,9406386,1.671010296010296,610,443,1053,+
chr11,9424889,2.016637740140044,863,681,1544,+
chr11,9424894,0.4616690240452617,815,504,1319,+
chr11,9424898,0.6313617287671868,1555,1002,2557,+
chr11,9424899,2.150118203309693,1121,1033,2154,+
chr11,9424912,1.719232188999631,1913,1289,3202,+
chr11,9430072,1.9838663276833517,5171,4150,9321,+
chr11,9430074,2.3617555785429287,7990,6766,14756,+
chr11,9430075,2.0063667989567455,12311,10047,22358,+
chr11,9430077,1.9316690002125867,9688,7904,17592,+
chr11,9430080,1.8090555960184511,2128,1372,3500,+
chr11,9430082,1.800100753233447,6666,6932,13598,+
chr11,9430084,1.8235013245554585,9019,8508,17527,+
chr11,9431564,1.7092592592592593,1206,917,2123,+
chr11,9442049,1.5604399528621935,1180,682,1862,+
chr11,9444671,1.7210227792516697,1074,642,1716,+
chr11,9445327,1.9772296015180264,1041,679,1720,+
chr11,9446756,0.6953873712494402,1293,1014,2307,+
chr11,9446759,1.1032547247705309,2330,1754,4084,+
chr11,9450116,0.6906158860868074,1183,869,2052,+
chr11,9451243,1.6119909502262444,1025,883,1908,+
chr11,9452440,1.711255751318595,1988,1272,3260,+
chr11,9452497,2.345948687741344,5734,4166,9900,+
chr11,9452498,1.991503807712586,11398,7232,18630,+
chr11,9452499,1.5895560056181184,5664,3066,8730,+
chr11,9452502,2.402025020332447,2986,1736,4722,+
chr11,9455369,1.1357673082570832,1918,1418,3336,+
chr11,9459310,1.913871951219512,1115,819,1934,+
chr11,9459329,1.990034257240735,1064,844,1908,+
chr11,9459405,1.8210748859463668,1168,816,1984,+
chr11,9462055,1.402834008097166,2051,1481,3532,+
chr11,9463634,1.5186985986584536,4175,2859,7034,+
chr11,9463640,1.467242971475477,1216,885,2101,+
chr11,9466748,1.708373428105458,1665,1130,2795,+
chr11,9466858,1.996367369501698,789,602,1391,+
chr11,9466939,19.24806530466679,3324,285,3609,+
chr11,9466940,24.602716954058796,5420,763,6183,+
chr11,9466941,19.120309010135376,6875,1308,8183,+
chr11,9466942,16.31838327749548,6505,1545,8050,+
chr11,9466943,15.019143642093855,5837,1771,7608,+
chr11,9466944,9.1502040392369,2535,931,3466,+
chr11,9466945,5.7937021304761895,2793,1109,3902,+
chr11,9466947,12.637885396140032,4565,5797,10362,+
chr11,9466948,11.936268737529407,3784,5474,9258,+
chr11,9466949,6.685162151503201,1494,1938,3432,+
chr11,9466957,0.1904961649089166,373,1191,1564,+
chr11,9466983,0.3514265381380604,678,1130,1808,+
chr11,9466984,0.1999030711151923,460,1451,1911,+
chr11,9466987,0.4413309160840055,2611,4455,7066,+
chr11,9466988,0.5469565217391303,1529,2249,3778,+
chr11,9466991,0.4720535852963126,1712,3264,4976,+
chr11,9466992,0.4172386751545688,1511,3628,5139,+
chr11,9467238,1.6073305484436058,993,723,1716,+
chr11,9467436,28.612326761973566,5512,2980,8492,+
chr11,9467437,23.29239177891846,4250,2087,6337,+
chr11,9467462,1.9733133086876158,588,540,1128,+
chr11,9467469,1.7009222661396577,1290,896,2186,+
chr11,9467477,1.8012575039191117,1392,1236,2628,+
chr11,9467534,1.7723684210526316,897,759,1656,+
chr11,9467655,1.628517980790708,1240,813,2053,+
chr11,9467711,1.6770172732253432,2284,1643,3927,+
chr11,9467862,3.9349533627884146,942,581,1523,+
chr11,9467907,2.059188374977849,1244,1025,2269,+
chr11,9468024,3.163531723750702,726,547,1273,+
chr11,9468104,1.4475983796296297,1020,719,1739,+
chr11,9468192,2.2868574946137272,742,512,1254,+
chr11,9468330,2.699789078978205,719,501,1220,+
chr11,9468472,1.802145922746781,645,465,1110,+
chr11,9468499,0.3756796836381611,759,577,1336,+
chr11,9468662,1.754367201426025,702,509,1211,+
chr11,9468672,2.3884892086330933,829,694,1523,+
chr11,9519260,1.8921246428438763,1106,793,1899,+
chr11,9519262,2.0567431014380104,647,497,1144,+
chr11,9769505,1.151078267378153,687,399,1086,+
chr11,9769520,2.278948721244056,864,501,1365,+
chr11,9769522,2.3344996316952544,1810,1117,2927,+
chr11,9769523,2.2358276643990926,1391,881,2272,+
chr11,9769524,2.0250339946305917,1919,1246,3165,+
chr11,9769526,2.016883116883117,1552,1077,2629,+
chr11,9769527,2.0030863008353395,1687,1121,2808,+
chr11,10789479,2.0109375000000003,692,447,1139,+
chr11,10794074,3.5096177406375717,794,373,1167,+
chr11,10794131,1.3600694191423621,1499,921,2420,+
chr11,10794152,1.551793244540938,952,556,1508,+
chr11,10794155,1.8547001008097226,2447,1681,4128,+
chr11,10794156,1.92381089145246,2133,1606,3739,+
chr11,10794158,1.8589743589743593,1449,1104,2553,+
chr11,10794161,1.8602292294446836,1212,807,2019,+
chr11,10794172,1.0786108263615564,2531,1847,4378,+
chr11,11969513,1.3372828597644975,672,491,1163,+
chr11,11969514,1.2752577868317074,1290,837,2127,+
chr11,11969515,1.097769028871391,716,507,1223,+
chr11,11969604,0.4204664114166377,603,441,1044,+
chr11,11969611,1.7338649654439127,708,569,1277,+
chr11,11969629,2.2655217965653898,874,756,1630,+
chr11,11969631,0.6787948902124558,3268,2578,5846,+
chr11,11969632,1.0843788583473737,4705,3784,8489,+
chr11,11969639,1.1897665103097033,4406,3594,8000,+
chr11,12963782,1.7600467289719626,728,427,1155,+
chr11,12963794,1.8912280701754385,1735,1177,2912,+
chr11,12963795,1.8912280701754385,1735,1177,2912,+
chr11,12965721,3.499838053873917,1062,412,1474,+
chr11,12965726,7.682716286207557,800,400,1200,+
chr11,12965727,5.3877559329900695,2334,1045,3379,+
chr11,12965729,4.2018326977242575,2013,868,2881,+
chr11,12965730,2.4128397375820057,812,290,1102,+
chr11,12965794,19.066909894102622,681,797,1478,+
chr11,12965795,13.460364335752299,1019,1631,2650,+
chr11,13729457,2.8640805545350125,738,497,1235,+
chr11,13750327,1.9166666666666663,781,543,1324,+
chr11,13750340,0.6944444444444444,999,719,1718,+
chr11,13750342,2.263605509281837,1637,1033,2670,+
chr11,13750346,2.7386546038231434,1563,978,2541,+
chr11,13750348,2.7386546038231434,1563,978,2541,+
chr11,13750351,2.222247504783576,2085,1584,3669,+
chr11,13750353,2.222247504783576,2085,1584,3669,+
chr11,13750381,2.4041095890410955,1520,1240,2760,+
chr11,13750382,0.6752408596837944,1772,1055,2827,+
chr11,16760209,1.8690271680346122,762,337,1099,+
chr11,16760210,1.9665873446353397,933,474,1407,+
chr11,16760255,0.5488558352402746,737,436,1173,+
chr11,16760300,0.9778326364048566,1492,862,2354,+
chr11,16760301,1.2479837458301075,2652,1764,4416,+
chr11,16760302,1.5563909774436089,1160,902,2062,+
chr11,16769678,1.6710485133020343,842,709,1551,+
chr11,16774418,2.716415229885057,604,463,1067,+
chr11,16776506,3.4045586340206184,1030,775,1805,+
chr11,16776807,1.833759590792839,716,390,1106,+
chr11,16776824,1.087733361776231,1537,1180,2717,+
chr11,16776960,1.65121412803532,1297,905,2202,+
chr11,16777127,1.4921115963989662,1115,862,1977,+
chr11,16777237,2.829620263033423,2406,1546,3952,+
chr11,16777238,2.955481233742103,1347,896,2243,+
chr11,17323309,2.0164473684210527,612,447,1059,+
chr11,17323322,2.1332873627022586,1111,807,1918,+
chr11,17336950,1.0789692993598583,701,479,1180,+
chr11,18363117,2.184817546589759,643,519,1162,+
chr11,18416107,0.9300538751995346,3312,2850,6162,+
chr11,18416108,0.8456365749981137,3916,3394,7310,+
chr11,18416109,0.9772443991632616,1938,1798,3736,+
chr11,18416111,0.8750096913176869,1462,798,2260,+
chr11,18416112,1.065128205128205,2277,1274,3551,+
chr11,18416114,1.6600188812839272,1562,891,2453,+
chr11,18416123,1.5300070028011206,1180,713,1893,+
chr11,18416129,0.7142857142857142,1374,1209,2583,+
chr11,18416141,0.8410274522261046,2709,1711,4420,+
chr11,18418380,1.6350996840119119,3210,2364,5574,+
chr11,18418386,0.9140663351534556,12711,9154,21865,+
chr11,18418500,0.8075138599457398,4769,3507,8276,+
chr11,18418506,0.8120037190774573,10946,7847,18793,+
chr11,18418507,1.0139842767098102,15312,11271,26583,+
chr11,18421045,1.297478645672533,5130,3238,8368,+
chr11,18424395,1.6195182090146856,8415,5298,13713,+
chr11,18424462,1.227348372781065,3716,2911,6627,+
chr11,18424512,1.314958330702696,1830,1347,3177,+
chr11,18424541,2.3340051676439724,7186,4853,12039,+
chr11,18424542,2.150127737506039,17603,13565,31168,+
chr11,18424543,1.8858074833462188,7357,5780,13137,+
chr11,18424545,1.5372066034016514,4987,3957,8944,+
chr11,18424549,1.4332519597434494,11445,9352,20797,+
chr11,18427085,1.2050366903045344,14738,10685,25423,+
chr11,18428724,1.361209417039159,4689,3413,8102,+
chr11,18428730,1.2845310196338149,12092,9409,21501,+
chr11,18428788,0.8244202196148782,6638,4907,11545,+
chr11,18429227,1.1589005635589769,8347,7425,15772,+
chr11,20385792,1.8562873423722395,1294,917,2211,+
chr11,20385819,0.5643077436025673,676,557,1233,+
chr11,20385820,0.6240249609984401,1049,640,1689,+
chr11,20385836,1.7096392128279885,1250,783,2033,+
chr11,20385919,0.5336717186159565,1492,1075,2567,+
chr11,20398128,7.529948008682046,2382,1800,4182,+
chr11,20398129,5.589627025158966,7771,5885,13656,+
chr11,20398130,5.589627025158966,7771,5885,13656,+
chr11,20398196,0.6423430548690064,1510,1189,2699,+
chr11,20404741,1.6175893207695329,823,565,1388,+
chr11,20404762,1.9893899204244032,999,753,1752,+
chr11,20404771,1.6541095890410955,1448,875,2323,+
chr11,20404798,1.5366679338691853,4500,2933,7433,+
chr11,20404821,1.0493834577962815,4181,2916,7097,+
chr11,20404822,1.0493834577962815,4181,2916,7097,+
chr11,20404876,1.4037162012819568,4715,3877,8592,+
chr11,20404879,1.4463472060536424,16359,14330,30689,+
chr11,20404880,1.1651583768598621,44312,35707,80019,+
chr11,20404881,1.4468290806986088,22364,19838,42202,+
chr11,20404882,1.2186025646011434,40696,34088,74784,+
chr11,20404884,1.4833557473433587,12498,11676,24174,+
chr11,20404929,1.5573837468429654,1552,1015,2567,+
chr11,20404977,1.559672161114342,2371,1752,4123,+
chr11,20405087,1.7933817594834542,807,530,1337,+
chr11,20405120,1.6132167152575316,829,685,1514,+
chr11,20411302,1.1679683873330207,651,582,1233,+
chr11,20419177,1.1501194456382633,598,423,1021,+
chr11,20483572,2.033030798988246,1119,714,1833,+
chr11,20483574,1.8370479297381306,4140,2833,6973,+
chr11,20483575,1.7998019611348726,2357,1690,4047,+
chr11,20483576,1.7998019611348726,2357,1690,4047,+
chr11,20483587,0.6799001814882033,887,550,1437,+
chr11,20483606,1.7393600497048771,1017,695,1712,+
chr11,20483608,1.61570493753718,1163,737,1900,+
chr11,20483609,0.6779138042126853,1659,1090,2749,+
chr11,20483620,0.7427379131868407,3674,2215,5889,+
chr11,20483632,2.047861288431387,7894,5044,12938,+
chr11,20483633,1.8247525696010936,12276,7989,20265,+
chr11,20483635,1.5913695778000074,13017,8712,21729,+
chr11,20483636,1.3366824920495688,15028,9676,24704,+
chr11,20483638,1.0192286947141316,5398,3089,8487,+
chr11,20530024,6.284089286480808,949,706,1655,+
chr11,20530143,3.821860593767287,789,545,1334,+
chr11,20530524,0.986373369671014,562,466,1028,+
chr11,20530526,0.986373369671014,562,466,1028,+
chr11,28135024,3.8248276478888603,926,493,1419,+
chr11,30352558,1.8180411579189055,595,454,1049,+
chr11,30352817,5.084893393279936,564,454,1018,+
chr11,32112691,3.109987515605493,858,533,1391,+
chr11,32112693,3.109987515605493,858,533,1391,+
chr11,32112898,0.7766057279458372,950,459,1409,+
chr11,32112899,1.376486098284938,1333,615,1948,+
chr11,32112901,2.2458844606699797,1207,518,1725,+
chr11,32112902,2.2350421897495285,1094,593,1687,+
chr11,32112913,1.1036149283604677,961,772,1733,+
chr11,32112914,1.4278401991156577,1413,1080,2493,+
chr11,32112937,1.6091039966900647,3109,2167,5276,+
chr11,32112938,2.1636963696369635,1340,1009,2349,+
chr11,32118690,0.656221198156682,1423,929,2352,+
chr11,32118691,1.6390451517394524,1321,964,2285,+
chr11,32118698,1.7594876798822698,3725,2689,6414,+
chr11,32118784,1.7745861733203507,2186,1816,4002,+
chr11,32118785,1.6221120294293019,3571,2904,6475,+
chr11,32118799,1.468638604474782,1235,878,2113,+
chr11,32118811,0.6184848484848484,2040,1539,3579,+
chr11,32118874,1.4639570666090984,5351,3880,9231,+
chr11,32119966,1.1817847557060468,2929,2036,4965,+
chr11,32119980,1.6570457516339872,1891,1124,3015,+
chr11,32124928,1.6488845121594375,2111,1249,3360,+
chr11,32124929,1.1592502037489811,888,408,1296,+
chr11,32124940,1.3119241954174845,1412,800,2212,+
chr11,32124941,1.6745762711864403,857,648,1505,+
chr11,32124949,1.7657538431083446,1531,1085,2616,+
chr11,32124959,2.7912920554141927,1203,654,1857,+
chr11,32124964,1.4788586635127143,1428,800,2228,+
chr11,32124970,2.16047032474804,1307,939,2246,+
chr11,32126164,2.75,767,383,1150,+
chr11,32126177,1.9958419958419957,863,467,1330,+
chr11,32126191,1.9990384615384609,1462,1039,2501,+
chr11,32126214,1.4472608024691356,1630,1079,2709,+
chr11,32126236,1.7073164873174476,1652,1300,2952,+
chr11,32126323,1.607190412782956,2413,1501,3914,+
chr11,32126365,5.336934384131762,2008,1472,3480,+
chr11,32126407,1.1871262031585832,3126,2213,5339,+
chr11,32126565,1.7155080213903742,801,560,1361,+
chr11,32126587,2.041835357624832,711,493,1204,+
chr11,32126602,1.8213457076566124,784,430,1214,+
chr11,32126639,0.7272165585418597,1711,1078,2789,+
chr11,32126641,1.5283863804589195,1353,964,2317,+
chr11,32126642,0.7391203869723557,2649,1718,4367,+
chr11,32126795,1.3879411764705882,1715,1189,2904,+
chr11,32605370,1.1641838908352535,666,429,1095,+
chr11,32605374,1.419514671356714,887,475,1362,+
chr11,32605377,2.0646930165870105,963,740,1703,+
chr11,32605391,1.9682272158070393,1119,609,1728,+
chr11,32605404,1.0976601727227235,1506,1296,2802,+
chr11,32605433,1.5341445955619184,911,634,1545,+
chr11,32605449,1.5657260525746441,2343,1634,3977,+
chr11,32605460,1.7845053102291784,2216,1788,4004,+
chr11,32605462,1.7967121103404289,3393,2774,6167,+
chr11,32605464,1.7926674575237111,3970,2934,6904,+
chr11,32608562,1.9040223606505924,4938,3843,8781,+
chr11,32608587,0.9577476400439425,6006,4392,10398,+
chr11,32610178,1.5535056691215436,7236,5539,12775,+
chr11,32610226,2.284416826003824,2300,1568,3868,+
chr11,32610599,1.8677022178734501,1501,1167,2668,+
chr11,32610610,1.364722720375224,2138,1317,3455,+
chr11,32610658,1.466312626650828,1565,1300,2865,+
chr11,33054296,1.8891224382553864,718,518,1236,+
chr11,33054310,1.8984375,674,383,1057,+
chr11,33054314,2.296511627906977,710,429,1139,+
chr11,33054333,1.8332472006890608,938,644,1582,+
chr11,33358703,2.027596223674655,697,458,1155,+
chr11,34074158,0.5458984375,601,447,1048,+
chr11,34074174,0.5273134674324568,1411,946,2357,+
chr11,34074176,0.8443742317797124,2902,1929,4831,+
chr11,34074178,1.1464406107475709,1491,983,2474,+
chr11,34097918,2.75588048315321,577,483,1060,+
chr11,34097921,2.4063366336633663,587,504,1091,+
chr11,34098117,1.825997531879885,578,428,1006,+
chr11,34098162,1.7079415117371386,1285,1006,2291,+
chr11,34101261,2.4994403681134183,772,472,1244,+
chr11,34107654,2.9363532110091746,568,435,1003,+
chr11,34107868,1.771014492753623,610,459,1069,+
chr11,34107869,1.0077654960123128,1339,1020,2359,+
chr11,34107871,1.0077654960123128,1339,1020,2359,+
chr11,34110948,4.46821900566394,567,453,1020,+
chr11,34111796,1.2205097154180655,1166,981,2147,+
chr11,34111798,1.2205097154180655,1166,981,2147,+
chr11,34112190,3.050965250965251,877,517,1394,+
chr11,34113458,1.6039741679085944,1008,609,1617,+
chr11,34118792,1.7096454743513565,663,611,1274,+
chr11,34118795,2.9311475409836065,893,609,1502,+
chr11,34118804,2.319311663479924,1212,1045,2257,+
chr11,34118805,2.1194242155886913,1855,1524,3379,+
chr11,34120866,2.0728528455388595,1102,624,1726,+
chr11,34120868,2.622219842756363,962,635,1597,+
chr11,34121192,1.7873303167420809,789,526,1315,+
chr11,34121735,1.601272669424117,698,448,1146,+
chr11,34121750,2.286360698125404,654,454,1108,+
chr11,34121988,2.258597724741795,1276,1116,2392,+
chr11,34121989,2.2216084177729662,2690,2032,4722,+
chr11,34122654,56.014679010545315,858,349,1207,+
chr11,34158532,4.488955672426746,765,604,1369,+
chr11,34158533,4.488955672426746,765,604,1369,+
chr11,34158541,1.3203511537742674,1062,780,1842,+
chr11,34158544,1.6792873051224944,666,448,1114,+
chr11,34470850,2.2592095465236137,892,694,1586,+
chr11,34472575,2.3997602828744595,778,567,1345,+
chr11,34475451,1.843612334801762,681,453,1134,+
chr11,34477569,3.016434366548783,579,436,1015,+
chr11,34477570,3.016434366548783,579,436,1015,+
chr11,34477640,1.135245215675832,839,584,1423,+
chr11,34477684,2.871775751830011,1026,817,1843,+
chr11,34482893,1.7384162829305538,731,475,1206,+
chr11,34492510,1.672121212121212,800,593,1393,+
chr11,34493010,1.3894703091041152,639,537,1176,+
chr11,34493307,1.867430970450508,770,562,1332,+
chr11,34493355,1.987169861429584,4607,3068,7675,+
chr11,34493356,2.08193289129998,3622,2369,5991,+
chr11,34493359,1.4446178720076635,8768,6092,14860,+
chr11,34493360,1.4446178720076635,8768,6092,14860,+
chr11,34493361,1.334771789582259,6510,4431,10941,+
chr11,34493374,1.5412355447352404,1446,1165,2611,+
chr11,34493446,2.1364592619005167,2932,2484,5416,+
chr11,34493447,2.1364592619005167,2932,2484,5416,+
chr11,34493448,2.108207596404755,3968,3448,7416,+
chr11,34493450,2.0015036566765723,3177,2481,5658,+
chr11,34978945,2.6489989462592205,1092,729,1821,+
chr11,34978947,2.6489989462592205,1092,729,1821,+
chr11,34978950,2.0121749408983454,586,422,1008,+
chr11,34991713,1.0574282147315854,769,533,1302,+
chr11,34991714,1.0574282147315854,769,533,1302,+
chr11,34991751,2.187250289635265,868,571,1439,+
chr11,35013871,0.4988235294117647,635,449,1084,+
chr11,35160848,1.6460040983606559,832,426,1258,+
chr11,35160851,1.605477198868539,2154,1309,3463,+
chr11,35160852,0.5835586449494335,1807,1200,3007,+
chr11,35160853,0.5835586449494335,1807,1200,3007,+
chr11,35160854,1.7754800785176377,3356,2443,5799,+
chr11,35160856,1.569891774891775,5306,3959,9265,+
chr11,35160857,1.4898058899302624,3743,2873,6616,+
chr11,35160911,0.5949174744563793,810,693,1503,+
chr11,35198149,0.4868296096366272,973,740,1713,+
chr11,35198150,0.9760536654461875,1856,1206,3062,+
chr11,35198151,0.9760536654461875,1856,1206,3062,+
chr11,35198166,0.6652038146679043,1125,696,1821,+
chr11,35198253,1.7774390243902438,1253,983,2236,+
chr11,35201880,1.8420365681455053,1989,1333,3322,+
chr11,35201883,1.2373866913064953,2127,1530,3657,+
chr11,35201885,1.2373866913064953,2127,1530,3657,+
chr11,35201897,1.780399274047187,653,550,1203,+
chr11,35208407,0.7103897246415062,1699,1262,2961,+
chr11,35211428,0.6617755312361977,1394,860,2254,+
chr11,35211450,1.7653890824622531,949,860,1809,+
chr11,35211528,0.6194569855897087,938,850,1788,+
chr11,35236409,1.7396633961891108,1256,940,2196,+
chr11,35236451,1.4324596210808698,1443,1233,2676,+
chr11,35240925,0.6632403533686413,2484,1711,4195,+
chr11,35243215,0.6135789119483405,3601,2347,5948,+
chr11,35250773,1.496161548731642,1303,855,2158,+
chr11,35250818,1.6323779313470037,1600,1260,2860,+
chr11,35250897,1.8452868165045289,1718,1354,3072,+
chr11,35251242,1.6705,770,499,1269,+
chr11,35251267,3.1666666666666665,740,503,1243,+
chr11,35251295,1.6570561456752655,951,658,1609,+
chr11,35251301,1.2509126763238225,1391,890,2281,+
chr11,35251343,2.256523205050277,1678,1202,2880,+
chr11,35251346,4.444444444444444,559,449,1008,+
chr11,35251349,1.7175102599179208,836,601,1437,+
chr11,35251361,1.4156142365097588,1232,870,2102,+
chr11,35251363,1.6021335807050092,908,615,1523,+
chr11,35251680,2.7499860090868724,787,886,1673,+
chr11,35252897,3.0128604935477683,649,474,1123,+
chr11,35747670,1.7740039879432683,593,563,1156,+
chr11,35747687,2.1732140089880674,862,955,1817,+
chr11,35747688,2.1732140089880674,862,955,1817,+
chr11,35747692,1.6972972972972973,470,554,1024,+
chr11,35828417,1.306075918245345,997,681,1678,+
chr11,35828457,1.4386028877145642,1761,1334,3095,+
chr11,35828462,2.1194743130227,886,495,1381,+
chr11,35830726,2.8330210563882936,976,933,1909,+
chr11,35830727,2.8330210563882936,976,933,1909,+
chr11,35830728,2.8330210563882936,976,933,1909,+
chr11,36669575,3.8340248962655603,793,412,1205,+
chr11,36669655,1.925331173993752,1454,1056,2510,+
chr11,43340208,2.7875717080312996,660,466,1126,+
chr11,43340233,4.270703840791901,717,482,1199,+
chr11,43343679,2.0852209878324435,1140,716,1856,+
chr11,43343681,2.0852209878324435,1140,716,1856,+
chr11,43345104,1.2094721329806557,616,528,1144,+
chr11,43351551,1.521672233141279,809,623,1432,+
chr11,43364113,2.237686041727075,770,483,1253,+
chr11,43364238,2.800224674984605,747,489,1236,+
chr11,43364890,3.5514221753351647,708,500,1208,+
chr11,43365599,2.2062203665943554,1097,807,1904,+
chr11,43365710,2.773338904403261,738,474,1212,+
chr11,43365960,5.038037276531,882,477,1359,+
chr11,43418304,4.473465125852497,957,693,1650,+
chr11,43421516,0.3674611479335884,904,769,1673,+
chr11,43421523,2.1762987570880346,1287,1026,2313,+
chr11,43421524,2.1762987570880346,1287,1026,2313,+
chr11,43429113,4.703025571976781,605,459,1064,+
chr11,43464970,1.6940615058324495,638,491,1129,+
chr11,43877599,0.9083286672734444,695,519,1214,+
chr11,43878031,0.9755732284790954,788,686,1474,+
chr11,44129641,1.216840664059935,737,492,1229,+
chr11,44148372,1.6255921746585917,751,574,1325,+
chr11,44148461,2.709498819936138,581,448,1029,+
chr11,44151619,2.3614190687361423,638,450,1088,+
chr11,44151640,3.177609427609428,603,431,1034,+
chr11,44193221,1.458709526677953,700,538,1238,+
chr11,44255669,1.2854944540203257,761,600,1361,+
chr11,46694063,1.561927577129724,719,582,1301,+
chr11,46694070,2.677814790139907,692,394,1086,+
chr11,47587484,0.930749815963824,570,513,1083,+
chr11,47587485,1.496074187249161,1224,948,2172,+
chr11,47587486,0.930749815963824,570,513,1083,+
chr11,47591416,2.1811414067253936,764,577,1341,+
chr11,47600636,1.1387979514894875,566,467,1033,+
chr11,47600686,2.444785382031639,686,354,1040,+
chr11,47600841,3.296016409100168,838,581,1419,+
chr11,47600862,2.2424351981332986,719,587,1306,+
chr11,47602479,0.44221619458401884,764,522,1286,+
chr11,47603959,0.5587752870420996,1021,743,1764,+
chr11,47605931,0.5017158707074167,1081,752,1833,+
chr11,47606001,3.1171084337349395,587,414,1001,+
chr11,47606013,1.558019216555802,619,450,1069,+
chr11,47606027,1.9745159453302965,602,438,1040,+
chr11,57467976,4.33653067979635,417,656,1073,+
chr11,57467980,4.017374993942152,456,931,1387,+
chr11,57505888,0.351743556421919,1043,728,1771,+
chr11,57505890,0.351743556421919,1043,728,1771,+
chr11,57506143,1.6890337032888707,637,426,1063,+
chr11,57507935,2.656902356902357,606,494,1100,+
chr11,57508018,2.421875,619,383,1002,+
chr11,57508130,0.5281306715063521,581,463,1044,+
chr11,57509090,0.2941291585127201,834,510,1344,+
chr11,57509091,1.358812734539159,775,466,1241,+
chr11,57509164,7.764434427609213,932,587,1519,+
chr11,57509167,4.910306728069019,1163,807,1970,+
chr11,57509670,0.4931165686613628,593,412,1005,+
chr11,57509672,1.0173468346755523,1286,998,2284,+
chr11,57509701,1.6227956989247312,685,557,1242,+
chr11,57510392,1.5894186458702586,1054,805,1859,+
chr11,58387742,2.970989010989011,750,454,1204,+
chr11,58387744,2.8890768115133594,968,608,1576,+
chr11,60618081,1.1581935483870966,611,464,1075,+
chr11,60618083,1.1581935483870966,611,464,1075,+
chr11,60618452,1.818841359839483,800,667,1467,+
chr11,60618453,1.2110655737704918,590,487,1077,+
chr11,60687250,2.8676192891521213,602,514,1116,+
chr11,60688452,3.4730440499671262,632,395,1027,+
chr11,60689724,0.3317270709339869,601,444,1045,+
chr11,60689739,3.2255765736584148,553,459,1012,+
chr11,60689791,2.6271663663213682,619,537,1156,+
chr11,60690175,21.063545626042366,1072,356,1428,+
chr11,60690182,3.892387059683209,847,309,1156,+
chr11,60690196,6.729198399168265,2711,1932,4643,+
chr11,60690197,6.840789948678779,3673,3225,6898,+
chr11,60690198,6.840789948678779,3673,3225,6898,+
chr11,60690199,7.0931881277383875,2805,2896,5701,+
chr11,60690234,3.6099519331771464,1879,3349,5228,+
chr11,60690235,3.6099519331771464,1879,3349,5228,+
chr11,60690242,1.179976165783584,601,923,1524,+
chr11,60690249,0.19649694684752778,568,1195,1763,+
chr11,60703810,8.296572823112843,488,641,1129,+
chr11,61110092,0.17702765922584454,726,527,1253,+
chr11,61113389,2.9214171598372363,904,549,1453,+
chr11,61213704,0.7057513914656772,633,538,1171,+
chr11,61213705,1.1665484848420657,1228,976,2204,+
chr11,61563005,6.235365103419852,1724,1438,3162,+
chr11,61563006,7.583326709791457,2887,2270,5157,+
chr11,61563052,0.5732075471698113,650,529,1179,+
chr11,61563109,2.6818214377282974,910,679,1589,+
chr11,61563204,2.318623130575148,810,631,1441,+
chr11,61563232,0.5954202446005725,672,426,1098,+
chr11,61563291,2.0726600985221677,560,503,1063,+
chr11,61563421,3.133712285216184,863,516,1379,+
chr11,61563434,2.2064544650751547,712,376,1088,+
chr11,61563510,1.6384848261094291,633,466,1099,+
chr11,61563541,2.0703250487530527,1714,1151,2865,+
chr11,61563592,2.130820399113082,650,450,1100,+
chr11,61563628,1.4760344659190692,903,777,1680,+
chr11,61563645,1.2084921423998805,2382,1984,4366,+
chr11,61563646,0.9738977196534377,2965,2492,5457,+
chr11,61563648,1.2664212635027143,1882,1510,3392,+
chr11,61563735,0.5085560329134202,581,442,1023,+
chr11,61563817,2.7222222222222223,587,431,1018,+
chr11,61563986,0.5210399831549992,7855,4461,12316,+
chr11,61563987,0.5560564701833596,8933,4992,13925,+
chr11,61563988,0.5807669449599965,6373,3408,9781,+
chr11,61563989,0.6549189824822315,3155,1501,4656,+
chr11,61564006,2.0152830188679247,970,635,1605,+
chr11,61564010,1.6189633519808195,2153,1382,3535,+
chr11,61564011,1.6488644138127218,4504,2847,7351,+
chr11,61564071,2.011417432470064,698,512,1210,+
chr11,61564177,1.2516541845415547,1358,808,2166,+
chr11,61564178,1.2516541845415547,1358,808,2166,+
chr11,61564288,5.189882436765229,606,400,1006,+
chr11,61564303,1.7901346281174133,1422,984,2406,+
chr11,61564304,1.7901346281174133,1422,984,2406,+
chr11,61564457,0.6117162914548536,531,485,1016,+
chr11,61564470,1.1576275574510477,1555,1104,2659,+
chr11,61897253,0.26654231276608503,839,509,1348,+
chr11,61906229,3.484476211748939,623,406,1029,+
chr11,61906230,3.484476211748939,623,406,1029,+
chr11,61906365,2.120178695022966,863,690,1553,+
chr11,61906366,1.9290014645839655,1785,1338,3123,+
chr11,61915964,1.721456692913386,1271,1015,2286,+
chr11,61915966,1.721456692913386,1271,1015,2286,+
chr11,61915982,2.2245222929936306,1523,1412,2935,+
chr11,61915984,2.2245222929936306,1523,1412,2935,+
chr11,61919662,1.9790210068872274,1592,4316,5908,+
chr11,61919663,1.9790210068872274,1592,4316,5908,+
chr11,61919664,1.6584406457120529,1703,4369,6072,+
chr11,61919666,0.299882493681957,820,2322,3142,+
chr11,62505815,2.1407016322888204,652,474,1126,+
chr11,62529051,0.7936907548796643,864,425,1289,+
chr11,62529065,1.7842089448578278,1050,632,1682,+
chr11,62530366,1.27830395723969,672,542,1214,+
chr11,62530415,1.2498952390268219,1447,1031,2478,+
chr11,62530416,0.926641810570382,976,727,1703,+
chr11,62530452,4.2887029288702925,655,477,1132,+
chr11,62532862,2.229347826086957,585,459,1044,+
chr11,62623592,1.2869438803131772,743,474,1217,+
chr11,62623715,2.2188449848024314,729,657,1386,+
chr11,62623806,2.487347349867808,858,610,1468,+
chr11,62638291,1.5630826026765112,1167,787,1954,+
chr11,62648371,1.3160867407965626,837,565,1402,+
chr11,62648375,3.6341853035143767,727,312,1039,+
chr11,62648380,1.8678170167166037,2004,1310,3314,+
chr11,62648382,2.0068553737284387,1154,930,2084,+
chr11,62648409,1.5760969521807673,1296,691,1987,+
chr11,62648441,3.5609065155807365,2094,1764,3858,+
chr11,62648442,2.3626725919069713,5227,4040,9267,+
chr11,62648443,1.5080254339233543,3133,2276,5409,+
chr11,62648449,1.7051161330822346,1024,884,1908,+
chr11,62648553,1.617510245901639,1948,1599,3547,+
chr11,62648609,2.038620515571262,3639,3091,6730,+
chr11,62648610,2.038620515571262,3639,3091,6730,+
chr11,62648625,1.4714905544463217,1761,1531,3292,+
chr11,62648670,1.389494311372162,2465,2031,4496,+
chr11,62648798,1.5126324923014105,1433,1108,2541,+
chr11,62648799,1.324923412277601,2533,1967,4500,+
chr11,62648907,1.532835599827492,3982,2505,6487,+
chr11,62649363,0.47409766274307136,749,725,1474,+
chr11,62649374,1.5472595292167286,11168,8780,19948,+
chr11,62649376,1.5472595292167286,11168,8780,19948,+
chr11,62649380,1.278757077189328,3023,1785,4808,+
chr11,62649424,1.5598322344483893,12983,11224,24207,+
chr11,62649425,1.3356118684428442,19361,15783,35144,+
chr11,62649432,1.473205697406518,31344,24710,56054,+
chr11,62649433,1.4014488643844463,40806,31630,72436,+
chr11,62651987,1.396133160900065,4264,2762,7026,+
chr11,62651993,1.2235026319533362,3439,2626,6065,+
chr11,62652132,1.1990516076137294,6763,4911,11674,+
chr11,62652649,1.1448828173471495,17853,14113,31966,+
chr11,62652650,1.1448828173471495,17853,14113,31966,+
chr11,62652653,1.2976786505817821,9739,7714,17453,+
chr11,62652681,0.8196383509460597,6458,4687,11145,+
chr11,62655609,2.120250998288648,2322,1752,4074,+
chr11,62655889,1.3693739990238805,6037,4389,10426,+
chr11,62655928,1.8611965630635408,2227,1713,3940,+
chr11,62655947,0.8072244719481358,3567,2669,6236,+
chr11,62655973,1.4226865890631062,6240,4402,10642,+
chr11,62656020,1.0155745115011718,4368,3361,7729,+
chr11,62656113,1.4876897852544024,2625,1530,4155,+
chr11,62656185,1.339204458695984,2677,2182,4859,+
chr11,63448982,2.4211820330969265,691,422,1113,+
chr11,63449042,1.157447901653235,1070,761,1831,+
chr11,63449230,3.158614718614719,628,524,1152,+
chr11,63449232,3.1369045387429755,1574,1105,2679,+
chr11,63517611,2.391160347190498,996,795,1791,+
chr11,63517612,2.610508728859793,1419,1025,2444,+
chr11,63517618,1.3277998282969725,1460,985,2445,+
chr11,63517619,1.6924333036433814,1450,812,2262,+
chr11,63517620,1.6961037338234624,2438,1420,3858,+
chr11,63517642,1.518740264797508,760,641,1401,+
chr11,63517649,1.5664893617021276,1177,751,1928,+
chr11,63517651,1.6323500810372773,762,616,1378,+
chr11,63520561,1.7385758736852932,1251,1050,2301,+
chr11,63523591,2.8395023616213377,1459,1116,2575,+
chr11,63525657,2.203091707614037,2840,1768,4608,+
chr11,63525658,1.5784435751541015,1086,911,1997,+
chr11,63525659,1.5797772395864418,5337,3649,8986,+
chr11,63525792,1.666173715863157,1351,965,2316,+
chr11,63525823,0.529595015576324,1359,855,2214,+
chr11,63525824,0.5230234443197406,1156,890,2046,+
chr11,63525827,0.487312030075188,1036,759,1795,+
chr11,63526165,1.862339297406429,3577,2759,6336,+
chr11,63526402,1.921470342522974,689,566,1255,+
chr11,63526430,0.5947678400219149,943,744,1687,+
chr11,63526650,0.6154353896928155,712,504,1216,+
chr11,63526902,1.6796875,515,511,1026,+
chr11,63527206,1.911007025761124,611,426,1037,+
chr11,63527207,1.2365462807940684,1033,790,1823,+
chr11,63527208,1.2365462807940684,1033,790,1823,+
chr11,63527209,1.2365462807940684,1033,790,1823,+
chr11,63594641,9.119224335346466,375,672,1047,+
chr11,63594663,0.24739950221571352,495,1090,1585,+
chr11,63594664,0.24739950221571352,495,1090,1585,+
chr11,63594665,0.226281208935611,286,760,1046,+
chr11,63668112,2.105534105534105,817,650,1467,+
chr11,63668114,2.105534105534105,817,650,1467,+
chr11,63742068,1.200496546623879,942,644,1586,+
chr11,63742069,1.200496546623879,942,644,1586,+
chr11,63742070,1.5847081849683393,1350,946,2296,+
chr11,63742090,0.8499247232928854,7824,5401,13225,+
chr11,63742091,0.8899288067025597,6834,4793,11627,+
chr11,63742211,1.5726237423064164,1254,630,1884,+
chr11,63742224,1.37711408142878,3598,2259,5857,+
chr11,63742225,1.6221548494712696,5056,3246,8302,+
chr11,63742252,1.5360441166699887,1515,1037,2552,+
chr11,63743696,1.448706315818417,1183,897,2080,+
chr11,63743851,1.6985070647298963,2391,2021,4412,+
chr11,63743861,1.4022401200889123,1942,1282,3224,+
chr11,63755827,1.7269857188329476,701,418,1119,+
chr11,63756207,1.9502487562189057,636,401,1037,+
chr11,63764010,0.5481695568400771,568,518,1086,+
chr11,63764397,2.2501025452691987,886,642,1528,+
chr11,63764654,1.9326558702281385,1154,827,1981,+
chr11,63764656,2.6507936507936507,834,524,1358,+
chr11,63764660,1.343179843434296,640,539,1179,+
chr11,63765097,3.6667462119578675,566,435,1001,+
chr11,63953652,0.5815903379599576,1589,972,2561,+
chr11,63953675,1.1134751320435914,1329,792,2121,+
chr11,63953696,1.87467362924282,717,382,1099,+
chr11,63960550,1.7789162112932604,600,487,1087,+
chr11,63960564,1.7907950414424894,1278,1062,2340,+
chr11,63960565,1.5882352941176472,890,560,1450,+
chr11,63960576,0.6408333333333334,768,624,1392,+
chr11,63960601,1.5508330412126021,1835,1288,3123,+
chr11,63960629,1.9843834141087775,736,618,1354,+
chr11,63960682,2.230985915492958,593,425,1018,+
chr11,63960739,1.8931669010782928,922,631,1553,+
chr11,63961694,1.7339453068268824,1539,1244,2783,+
chr11,63962032,1.869559092829976,947,686,1633,+
chr11,63962065,2.684450524395805,840,644,1484,+
chr11,63963237,2.367567567567568,656,517,1173,+
chr11,63963272,2.021750663129973,1029,649,1678,+
chr11,63964752,1.2334880307938756,1754,1311,3065,+
chr11,63967502,2.0044004400440043,910,706,1616,+
chr11,63967695,1.6402662229617306,794,600,1394,+
chr11,63970604,1.46758368603309,802,677,1479,+
chr11,63970945,1.815303430079156,687,378,1065,+
chr11,63970948,1.927851291745432,632,413,1045,+
chr11,63970983,1.750419161676647,811,500,1311,+
chr11,63971049,0.8137008859027804,1786,1379,3165,+
chr11,63971051,0.9345579793340988,1220,896,2116,+
chr11,63971069,2.1404761904761904,695,503,1198,+
chr11,63971527,1.6985188724319158,710,545,1255,+
chr11,63971714,1.937639198218263,569,448,1017,+
chr11,63971833,2.0221307083129543,1137,720,1857,+
chr11,63971907,3.6529080675422145,1061,368,1429,+
chr11,63971908,3.428294925300913,1416,500,1916,+
chr11,63971909,3.8973648757988544,2765,975,3740,+
chr11,63971910,3.5950960043628246,1721,611,2332,+
chr11,63971911,3.7474747474747474,1059,395,1454,+
chr11,63971917,7.3301244627301365,945,307,1252,+
chr11,63971920,16.952273267644202,3584,1435,5019,+
chr11,63971921,15.641763971269196,4157,1630,5787,+
chr11,63971922,11.327404528402194,3359,1258,4617,+
chr11,63971925,14.557909989483864,2974,2877,5851,+
chr11,63971926,9.597933293208394,5985,7328,13313,+
chr11,63971927,9.597933293208394,5985,7328,13313,+
chr11,63971928,9.224303440389013,5019,6884,11903,+
chr11,63971965,0.4584795321637427,440,569,1009,+
chr11,64006185,3.229346123209934,948,616,1564,+
chr11,64006197,2.376672104404568,856,612,1468,+
chr11,64006199,1.8645856325629326,1153,829,1982,+
chr11,64009883,1.6128725269221136,720,435,1155,+
chr11,64009887,1.9392209336901578,1018,589,1607,+
chr11,64009888,1.9392209336901578,1018,589,1607,+
chr11,64009890,2.130976295701085,662,392,1054,+
chr11,64009893,1.141822181660248,963,608,1571,+
chr11,64009905,2.721857142857143,656,499,1155,+
chr11,64009908,2.0224183162413545,1059,598,1657,+
chr11,64010923,3.622325133796412,1063,554,1617,+
chr11,64010934,5.02076004309097,3405,2929,6334,+
chr11,64010935,4.543833621504153,3677,3264,6941,+
chr11,64010936,4.543833621504153,3677,3264,6941,+
chr11,64010937,3.5175655930372915,790,953,1743,+
chr11,64074850,7.01012285012285,742,406,1148,+
chr11,64074851,10.435198223144722,1287,927,2214,+
chr11,64074852,10.713791565596699,1199,971,2170,+
chr11,64082647,7.452045536008717,812,595,1407,+
chr11,64082648,9.845899725906296,1027,819,1846,+
chr11,64082712,0.3756083758428096,662,574,1236,+
chr11,64083301,6.617686889293753,868,414,1282,+
chr11,64083302,6.204201242474039,1204,684,1888,+
chr11,64083760,7.270373445646414,751,406,1157,+
chr11,64083764,7.078501173936146,1456,796,2252,+
chr11,64083765,9.04470664288859,2222,1282,3504,+
chr11,64083766,7.5360444989161985,1567,832,2399,+
chr11,64083770,3.4431783299743244,1117,774,1891,+
chr11,64083790,5.159086792464758,1727,1494,3221,+
chr11,64083791,4.9226238489672784,2073,1821,3894,+
chr11,64084008,3.234477270594209,886,621,1507,+
chr11,64084010,3.4024324085759283,754,594,1348,+
chr11,64084126,0.48052493438320215,795,634,1429,+
chr11,64084128,0.48052493438320215,795,634,1429,+
chr11,64085654,0.4012657572456581,768,324,1092,+
chr11,64085666,1.8775839644020478,1660,1003,2663,+
chr11,64085667,1.761878639547641,970,696,1666,+
chr11,64085669,1.907590759075908,866,403,1269,+
chr11,64085672,1.730811253755805,666,522,1188,+
chr11,64085685,5.743260698796747,6939,5170,12109,+
chr11,64085686,5.743260698796747,6939,5170,12109,+
chr11,64085691,4.226846913546727,8488,9800,18288,+
chr11,64085692,4.226846913546728,8488,9800,18288,+
chr11,64085695,0.5182803589129624,1102,1917,3019,+
chr11,64085713,0.6997152520115542,2459,4120,6579,+
chr11,64085728,0.6501300587423077,5166,8160,13326,+
chr11,64085729,0.6456746048794411,13510,17799,31309,+
chr11,64085730,0.6375526953876081,12076,15546,27622,+
chr11,64085731,0.5076228855069498,7150,10097,17247,+
chr11,64085786,0.534791510936332,1096,1060,2156,+
chr11,64085819,0.7040119425265908,1571,1164,2735,+
chr11,64087210,1.6823505810095525,2395,1506,3901,+
chr11,64087254,2.275735024561918,1394,1185,2579,+
chr11,64087275,1.563411078717201,1704,1518,3222,+
chr11,64087286,1.2838238198696426,2999,1991,4990,+
chr11,64087331,1.3113535055810115,2776,1800,4576,+
chr11,64088211,1.4023225806451614,3210,2014,5224,+
chr11,64088350,1.6173284687019787,11786,8801,20587,+
chr11,64088356,0.6605288480442298,5668,4581,10249,+
chr11,64088488,0.6977854371281691,4197,3056,7253,+
chr11,64088495,1.482957669048928,3070,2515,5585,+
chr11,64088518,1.4747218315093715,2975,2546,5521,+
chr11,64089152,0.6736101559884676,3460,2128,5588,+
chr11,64089174,1.3582144119061421,5211,3749,8960,+
chr11,64089202,1.4110870987707758,4877,3295,8172,+
chr11,64781661,2.194538894144535,721,590,1311,+
chr11,64781666,2.8647785299385062,1510,1052,2562,+
chr11,64781674,2.1176507150026525,1415,1023,2438,+
chr11,64781676,2.181671015848871,1700,1140,2840,+
chr11,64781683,6.285120147874307,1406,1081,2487,+
chr11,64781684,10.353533750598237,2563,2019,4582,+
chr11,64781685,10.058055281120138,2700,2325,5025,+
chr11,64785854,2.322070049393804,590,523,1113,+
chr11,64787918,1.5816820096738962,653,376,1029,+
chr11,64787923,0.5357229746168195,733,417,1150,+
chr11,64787954,2.899179864253394,706,441,1147,+
chr11,64789296,0.4111137273369437,872,684,1556,+
chr11,64789297,0.4111137273369437,872,684,1556,+
chr11,64789577,2.7169280132984763,957,782,1739,+
chr11,64789578,2.8244631185807654,604,503,1107,+
chr11,64789581,4.774346431414524,1573,1215,2788,+
chr11,64876368,2.5776824034334767,692,465,1157,+
chr11,64876370,2.5776824034334767,692,465,1157,+
chr11,64878200,1.2243622134409569,847,577,1424,+
chr11,64878906,0.9988115412170044,639,503,1142,+
chr11,64878907,1.0620083444096295,564,502,1066,+
chr11,64893419,5.572189477363046,982,719,1701,+
chr11,64893457,3.1619392969902016,859,888,1747,+
chr11,64893546,3.487028921998247,643,498,1141,+
chr11,64894066,2.644995725503925,625,431,1056,+
chr11,65029452,2.363368428509558,712,452,1164,+
chr11,65043442,1.0710033066392497,590,490,1080,+
chr11,65057291,4.035822895255714,590,442,1032,+
chr11,65111475,7.362380418828902,789,520,1309,+
chr11,65119988,6.847372859493874,748,324,1072,+
chr11,65120018,11.381121502476717,701,501,1202,+
chr11,65120019,11.381121502476717,701,501,1202,+
chr11,65190304,1.5955174983770632,885,572,1457,+
chr11,65190314,3.399434213244004,3292,2238,5530,+
chr11,65190315,3.4978108949350237,3009,2056,5065,+
chr11,65190318,12.064631205877832,1921,1949,3870,+
chr11,65190394,13.732887893123506,4294,2576,6870,+
chr11,65190395,14.715409893609898,3796,2371,6167,+
chr11,65190396,13.732887893123506,4294,2576,6870,+
chr11,65190400,1.7451657966326002,1375,811,2186,+
chr11,65190402,1.4612372214915368,1724,1077,2801,+
chr11,65190420,2.214721982321864,1119,802,1921,+
chr11,65190436,3.2066451012396375,2046,1838,3884,+
chr11,65190533,3.0733863837312114,868,753,1621,+
chr11,65190535,2.7409241215512714,2121,1792,3913,+
chr11,65190623,2.621127239824682,1360,818,2178,+
chr11,65190635,13.144754409431957,1751,1404,3155,+
chr11,65190638,6.018266007645894,1841,1750,3591,+
chr11,65190645,1.9102787456445995,730,573,1303,+
chr11,65190647,2.9470006858609583,1195,1283,2478,+
chr11,65190648,2.9810554872162744,2261,2559,4820,+
chr11,65190671,0.3379524886877827,716,543,1259,+
chr11,65190672,0.5002590224361809,1277,1308,2585,+
chr11,65190718,2.873623737502329,1831,1406,3237,+
chr11,65190721,6.759528843537036,2894,2559,5453,+
chr11,65190722,6.923823698277783,3710,3306,7016,+
chr11,65190815,0.6736986383004082,1291,1016,2307,+
chr11,65190927,2.797433628318584,770,564,1334,+
chr11,65190928,2.797433628318584,770,564,1334,+
chr11,65190929,2.385010937341268,1186,805,1991,+
chr11,65190970,2.9123630598599006,608,411,1019,+
chr11,65191073,1.5808823529411764,564,451,1015,+
chr11,65191074,2.823821339950372,568,526,1094,+
chr11,65191087,0.621429237512045,713,606,1319,+
chr11,65191088,1.2496508972624871,1629,1276,2905,+
chr11,65191322,2.048040201005025,885,397,1282,+
chr11,65191346,8.097789116457413,6452,5346,11798,+
chr11,65191347,8.097789116457413,6452,5346,11798,+
chr11,65191348,7.076106816516048,6903,5932,12835,+
chr11,65191350,1.5053416149068322,875,1149,2024,+
chr11,65191352,0.5497969991173874,1073,1029,2102,+
chr11,65191371,12.25108775122024,2914,4194,7108,+
chr11,65191372,13.02821020839427,4125,5811,9936,+
chr11,65191385,0.40729164794023465,2371,3240,5611,+
chr11,65191396,0.6990903924866189,5434,6200,11634,+
chr11,65191397,0.7063374119623316,7441,8414,15855,+
chr11,65191398,0.6872670779273808,9552,10695,20247,+
chr11,65191399,0.6594673012758595,10002,11582,21584,+
chr11,65191400,0.7165828625572793,6039,6644,12683,+
chr11,65191549,1.5058846865908488,910,795,1705,+
chr11,65191646,1.6332090923408051,1173,885,2058,+
chr11,65191653,2.2620070436162387,1123,890,2013,+
chr11,65191677,1.1364375298851526,3062,2390,5452,+
chr11,65191780,2.1588377723970944,742,412,1154,+
chr11,65191860,1.5756302521008403,1499,1189,2688,+
chr11,65191932,2.0094251720183487,1192,871,2063,+
chr11,65192049,1.53748932822204,1412,1270,2682,+
chr11,65192165,1.6938281901584653,882,544,1426,+
chr11,65192230,2.527381822716405,2509,1966,4475,+
chr11,65192355,6.2151870510578116,4960,1212,6172,+
chr11,65192356,5.901970788541353,7199,1670,8869,+
chr11,65192357,5.769340617846343,8299,1900,10199,+
chr11,65192359,4.111511123419182,2226,470,2696,+
chr11,65192363,16.112361475264773,4124,1226,5350,+
chr11,65192364,17.09626243173276,6583,2413,8996,+
chr11,65192365,17.09626243173276,6583,2413,8996,+
chr11,65192410,3.6502512037564863,4530,2966,7496,+
chr11,65192411,3.937472419161912,5029,3167,8196,+
chr11,65192412,3.6502512037564863,4530,2966,7496,+
chr11,65192441,5.243469959069102,1389,757,2146,+
chr11,65192458,4.670647846543613,889,306,1195,+
chr11,65192459,3.7019011854462773,1377,502,1879,+
chr11,65192474,2.1086807063250834,1332,360,1692,+
chr11,65192490,6.1871921182266005,941,202,1143,+
chr11,65192493,15.197022720098651,6885,2232,9117,+
chr11,65192494,16.380090213203445,9153,3589,12742,+
chr11,65192495,10.974302597116434,11199,4981,16180,+
chr11,65192496,11.428317803219969,8999,4385,13384,+
chr11,65192497,13.610856014025511,9095,5778,14873,+
chr11,65192499,5.115347067250988,7339,6152,13491,+
chr11,65192500,5.483836358804589,5036,4705,9741,+
chr11,65192501,3.447779206128499,1162,810,1972,+
chr11,65192503,1.883408071748879,608,445,1053,+
chr11,65192520,2.2960757818940345,2443,2502,4945,+
chr11,65192531,2.647265123109061,2633,2885,5518,+
chr11,65192539,3.042753021174828,9111,11858,20969,+
chr11,65192540,3.042753021174828,9111,11858,20969,+
chr11,65192555,1.9328317469450622,5212,7061,12273,+
chr11,65192582,0.5761954949000554,3359,3144,6503,+
chr11,65192754,0.7251304666150191,1637,1162,2799,+
chr11,65192804,1.6187290969899666,791,597,1388,+
chr11,65192815,2.3061978892187973,3272,2807,6079,+
chr11,65192816,2.3208727476417805,5394,4486,9880,+
chr11,65193009,1.3818993506493504,3404,2407,5811,+
chr11,65193049,1.428616136919315,5075,4089,9164,+
chr11,65193050,1.2214582442690411,10661,8531,19192,+
chr11,65193051,1.2214582442690411,10661,8531,19192,+
chr11,65193052,1.6060414539679453,5215,4297,9512,+
chr11,65193150,0.5660224135130745,819,523,1342,+
chr11,65193429,1.7392261717521234,1163,866,2029,+
chr11,65193506,3.307378896517494,8035,2003,10038,+
chr11,65193507,3.2973263993537123,6794,1715,8509,+
chr11,65193515,17.33331793610192,15464,9073,24537,+
chr11,65193516,17.33331793610192,15464,9073,24537,+
chr11,65193517,17.33331793610192,15464,9073,24537,+
chr11,65193526,10.920778995186788,10305,9828,20133,+
chr11,65193527,10.920778995186788,10305,9828,20133,+
chr11,65193532,10.34806376277768,5015,5509,10524,+
chr11,65193555,0.5408487537138509,5380,6518,11898,+
chr11,65193689,0.5526860629835458,633,436,1069,+
chr11,65193741,1.871641791044776,683,401,1084,+
chr11,65266522,2.7200245797653038,605,446,1051,+
chr11,65266569,1.8335827876357553,783,656,1439,+
chr11,65266572,1.0458433590170935,1262,1107,2369,+
chr11,65266713,1.6173399014778325,1151,1014,2165,+
chr11,65266821,1.451279505217814,5898,4147,10045,+
chr11,65266853,1.9828125,2537,2039,4576,+
chr11,65266854,1.9828125,2537,2039,4576,+
chr11,65267581,1.7975385496046652,1068,846,1914,+
chr11,65267613,1.948362235067437,789,518,1307,+
chr11,65267615,1.0758636361536267,2981,2014,4995,+
chr11,65267696,1.3390010626992563,2645,1881,4526,+
chr11,65267917,2.0631578947368423,727,519,1246,+
chr11,65267988,2.056064083398768,3051,2420,5471,+
chr11,65267992,1.6180438618960544,8078,6916,14994,+
chr11,65267993,1.612174870747855,9543,8298,17841,+
chr11,65267994,1.612174870747855,9543,8298,17841,+
chr11,65267995,1.6391357369601849,9891,8804,18695,+
chr11,65267997,1.7408089815938976,7812,7194,15006,+
chr11,65267998,1.8211307764315745,7394,6513,13907,+
chr11,65268075,2.39405959752322,706,607,1313,+
chr11,65268179,2.430473884469042,610,412,1022,+
chr11,65268319,1.9419496166484118,590,497,1087,+
chr11,65268345,1.7326467231499156,1012,822,1834,+
chr11,65268443,0.5118243243243243,605,480,1085,+
chr11,65268454,1.936122802673929,919,576,1495,+
chr11,65268698,2.4124362934022705,4060,1391,5451,+
chr11,65268699,2.4056915143862025,5144,1735,6879,+
chr11,65268700,2.757546417171397,5515,1876,7391,+
chr11,65268709,11.66446904703124,2097,769,2866,+
chr11,65268714,9.047999595364786,6605,6390,12995,+
chr11,65268715,7.801633105326332,9036,10119,19155,+
chr11,65268716,7.801633105326332,9036,10119,19155,+
chr11,65268717,6.263315014132845,6952,8867,15819,+
chr11,65268756,0.6687468979142289,2812,3876,6688,+
chr11,65268933,0.433624295326423,752,422,1174,+
chr11,65268934,0.5715345111508229,1468,898,2366,+
chr11,65268946,0.4886211512717537,1240,746,1986,+
chr11,65268958,1.948328599519336,614,397,1011,+
chr11,65269030,15.07551919205524,7723,5091,12814,+
chr11,65269031,8.114005576771536,5364,3509,8873,+
chr11,65269360,3.3837441059094964,3385,1046,4431,+
chr11,65269365,3.672553127806046,817,256,1073,+
chr11,65269370,11.537893483308977,1889,457,2346,+
chr11,65269374,24.973874671457885,11777,6827,18604,+
chr11,65269375,25.95941446452771,13359,8415,21774,+
chr11,65269376,25.959414464527715,13359,8415,21774,+
chr11,65269397,0.5359426546367116,1843,2129,3972,+
chr11,65269404,0.7722620053464825,3303,3357,6660,+
chr11,65269673,2.090531561461794,838,687,1525,+
chr11,65270066,3.4832160102011622,7770,1688,9458,+
chr11,65270068,3.406643899637794,10362,2376,12738,+
chr11,65270069,3.722869446351365,4438,1189,5627,+
chr11,65270071,4.4844124700239805,1495,416,1911,+
chr11,65270072,4.453613892365457,5789,1127,6916,+
chr11,65270074,4.453613892365457,5789,1127,6916,+
chr11,65270084,22.358417345743785,9492,2486,11978,+
chr11,65270085,22.358417345743785,9492,2486,11978,+
chr11,65270095,1.857817869415808,7784,2735,10519,+
chr11,65270096,1.857817869415808,7784,2735,10519,+
chr11,65270097,1.857817869415808,7784,2735,10519,+
chr11,65270106,3.083213083213083,640,377,1017,+
chr11,65270134,1.6607773851590104,704,565,1269,+
chr11,65270503,1.7215563878485227,1008,800,1808,+
chr11,65270621,1.5779297765617877,843,644,1487,+
chr11,65270734,1.6517121860605495,1319,905,2224,+
chr11,65270815,2.105592347314201,775,603,1378,+
chr11,65270898,2.256363219445081,819,622,1441,+
chr11,65271133,1.9441260744985671,1120,697,1817,+
chr11,65271150,2.101707262693272,1748,1300,3048,+
chr11,65271171,1.7589959060547296,562,545,1107,+
chr11,65271194,1.4094547338427663,1783,1102,2885,+
chr11,65271284,1.3718060261928748,2604,1789,4393,+
chr11,65271578,17.25143408293715,7787,6523,14310,+
chr11,65271579,16.999365001567813,7960,6768,14728,+
chr11,65271580,16.999365001567813,7960,6768,14728,+
chr11,65271750,7.786445689542549,1853,320,2173,+
chr11,65271751,12.44891304347826,880,183,1063,+
chr11,65271756,6.570348738379543,1752,236,1988,+
chr11,65271758,16.935483870967744,1224,216,1440,+
chr11,65271759,50.132229126423105,2146,347,2493,+
chr11,65271761,27.84444171175602,1628,1069,2697,+
chr11,65271762,15.484422344578576,5055,4948,10003,+
chr11,65271763,15.484422344578576,5055,4948,10003,+
chr11,65271764,14.836359411671934,4657,4874,9531,+
chr11,65271786,0.44603401684946753,1011,1397,2408,+
chr11,65271789,0.339867871463239,1526,2449,3975,+
chr11,65271796,0.2837118378436485,558,1305,1863,+
chr11,65271805,0.5223970974780381,1841,2472,4313,+
chr11,65271848,0.6922511935365406,1739,1555,3294,+
chr11,65271919,1.9515151515151516,827,539,1366,+
chr11,65272076,1.373439236874079,2236,1531,3767,+
chr11,65272139,2.125978090766823,857,638,1495,+
chr11,65272618,9.123266666028213,2768,730,3498,+
chr11,65272619,9.139292063590494,2915,784,3699,+
chr11,65272622,2.40921875,906,319,1225,+
chr11,65272625,6.832544070394047,1547,525,2072,+
chr11,65272628,18.189425602848694,3198,2046,5244,+
chr11,65272629,18.189425602848694,3198,2046,5244,+
chr11,65272641,0.63625,1017,959,1976,+
chr11,65272948,19.633641055754044,2406,1110,3516,+
chr11,65272949,14.294692144373672,1051,470,1521,+
chr11,65272956,14.266509384881495,3601,2641,6242,+
chr11,65272957,14.266509384881491,3601,2641,6242,+
chr11,65273054,0.512218963831867,654,464,1118,+
chr11,65273176,0.8974686232635735,1278,851,2129,+
chr11,65273389,15.285513094243974,5612,5083,10695,+
chr11,65273390,15.440815768369841,5511,4924,10435,+
chr11,65273471,0.45855410080133113,747,556,1303,+
chr11,65273548,0.65226426948915,963,626,1589,+
chr11,65293137,0.8870024694797651,577,564,1141,+
chr11,65293392,0.4210030609842242,595,410,1005,+
chr11,65293393,0.4643323893856721,1218,955,2173,+
chr11,65293417,3.5325647516186605,858,465,1323,+
chr11,65293813,2.6646868250539955,704,462,1166,+
chr11,65293814,2.6646868250539955,704,462,1166,+
chr11,65294453,1.9013841180675486,780,554,1334,+
chr11,65294513,0.6013456686291,934,696,1630,+
chr11,65294514,1.905962059620596,1622,1214,2836,+
chr11,65294516,1.613386678225792,3926,2748,6674,+
chr11,65294538,1.4860043381267358,4468,3867,8335,+
chr11,65294539,1.4860043381267358,4468,3867,8335,+
chr11,65294540,1.4844058212949616,6710,5305,12015,+
chr11,65294543,1.652326576805328,1751,1680,3431,+
chr11,65294551,1.6245831348261075,3099,2098,5197,+
chr11,65299052,2.796168582375479,622,434,1056,+
chr11,65299053,2.796168582375479,622,434,1056,+
chr11,65300201,0.2740404298623503,727,546,1273,+
chr11,65302750,1.6793747034296533,868,485,1353,+
chr11,65302751,1.6368387025229723,1224,691,1915,+
chr11,65302753,2.402808400558222,891,508,1399,+
chr11,65303533,1.2195876288659793,675,484,1159,+
chr11,65303535,1.6113648573696895,991,706,1697,+
chr11,65303591,0.4522796352583586,836,657,1493,+
chr11,65303593,0.4522796352583586,836,657,1493,+
chr11,65305532,2.8502074460865594,663,397,1060,+
chr11,65384359,0.7521805737228399,811,579,1390,+
chr11,65659059,4.843090939181686,676,342,1018,+
chr11,65686970,0.8482335889171388,558,487,1045,+
chr11,65686981,2.084145591851071,682,875,1557,+
chr11,65686982,1.3534427615223155,1831,2180,4011,+
chr11,65686983,0.4807323006017155,750,748,1498,+
chr11,65686984,1.9826553317738345,749,1030,1779,+
chr11,65686987,1.500379291650317,1934,2565,4499,+
chr11,65686988,1.507593037214886,1051,1665,2716,+
chr11,65686991,1.4528099420200768,1378,1894,3272,+
chr11,65687418,2.447796903622849,680,388,1068,+
chr11,65688924,1.8739551493817959,2448,2040,4488,+
chr11,65688925,1.8544594659150624,2230,1902,4132,+
chr11,65688926,2.1102643675166908,4032,3887,7919,+
chr11,65688927,2.1327001195970485,2703,2794,5497,+
chr11,65733567,9.60981680444145,715,553,1268,+
chr11,65745263,0.4436884127718312,1582,987,2569,+
chr11,65745264,0.3611408199643493,1012,662,1674,+
chr11,65745275,1.8352941176470587,701,458,1159,+
chr11,65745280,3.1552598225602027,765,525,1290,+
chr11,65745284,1.990023823704586,809,583,1392,+
chr11,65769961,0.8384284678312717,3082,2383,5465,+
chr11,65769962,0.9925756375267776,1007,920,1927,+
chr11,65769963,0.8120348882795816,3594,2752,6346,+
chr11,65769967,0.5859618501433737,704,616,1320,+
chr11,65769973,0.5905723182647911,999,555,1554,+
chr11,65769981,1.5691264588298972,2294,1332,3626,+
chr11,65769983,1.5691264588298972,2294,1332,3626,+
chr11,65770794,2.042546571424595,950,634,1584,+
chr11,65770799,2.351096694470188,981,497,1478,+
chr11,65770801,1.9245520927431496,2086,1106,3192,+
chr11,65770802,1.875494714014638,1608,867,2475,+
chr11,65770803,1.875494714014638,1608,867,2475,+
chr11,65770804,0.5876872021783527,726,451,1177,+
chr11,65770814,1.9611951882033372,1329,858,2187,+
chr11,65770815,1.4173924181726891,2062,1434,3496,+
chr11,65770824,1.61437908496732,792,548,1340,+
chr11,65771133,1.019722214991311,2575,2148,4723,+
chr11,65771261,1.6740761598882474,2301,1724,4025,+
chr11,65771262,1.7374840085287846,925,669,1594,+
chr11,65771328,1.4508226691042048,1407,1093,2500,+
chr11,65771329,0.9745480294126987,2933,1986,4919,+
chr11,65771522,1.7560224521483083,1395,1014,2409,+
chr11,65771523,1.9438632410754715,1238,986,2224,+
chr11,65771526,2.0586025399131884,914,673,1587,+
chr11,65819903,0.6484176700802953,646,379,1025,+
chr11,65819907,0.6371560008103854,1307,680,1987,+
chr11,65819908,0.612808126376014,1086,610,1696,+
chr11,65819916,1.697433822679459,1365,843,2208,+
chr11,65819917,1.7823509209551178,2131,1365,3496,+
chr11,65819919,1.7923213685070394,1491,990,2481,+
chr11,65819922,1.8161094224924013,716,328,1044,+
chr11,65819925,1.8568360342626415,1646,1027,2673,+
chr11,65824381,1.5645159240160864,733,507,1240,+
chr11,65825565,0.9379509379509379,649,461,1110,+
chr11,65825567,0.9379509379509379,649,461,1110,+
chr11,65825793,1.9275093370173848,837,639,1476,+
chr11,65826324,2.034773507555766,630,486,1116,+
chr11,65826327,1.3853022155608299,668,511,1179,+
chr11,65826332,2.0815430340396706,740,542,1282,+
chr11,65826430,1.903837099811676,646,471,1117,+
chr11,65826455,1.98399085191538,693,476,1169,+
chr11,65827363,2.2342857142857144,804,489,1293,+
chr11,65827364,2.2342857142857144,804,489,1293,+
chr11,65828110,2.003119151590768,740,457,1197,+
chr11,65828122,3.4618498909996887,793,493,1286,+
chr11,65829435,0.4726345278165765,1589,1064,2653,+
chr11,65829436,0.42037969779155354,774,444,1218,+
chr11,65829437,0.5169874079353766,815,620,1435,+
chr11,65830958,2.002362390739428,651,497,1148,+
chr11,65830994,1.6175653356650148,1935,1409,3344,+
chr11,65830996,1.6175653356650148,1935,1409,3344,+
chr11,65831101,2.1242463247747443,870,508,1378,+
chr11,65831103,2.701350471851611,1144,877,2021,+
chr11,65831108,1.014422808274794,1970,1407,3377,+
chr11,65831123,1.4839545901492803,1276,1016,2292,+
chr11,65835714,0.9924607588678778,802,521,1323,+
chr11,65835715,1.550535426140531,1207,801,2008,+
chr11,65835717,3.3961468147939806,804,546,1350,+
chr11,65836273,1.4860449203648267,779,638,1417,+
chr11,66039628,2.0340848094471284,688,413,1101,+
chr11,66039633,3.401528703854285,746,472,1218,+
chr11,66039641,1.8146496815286624,1775,1255,3030,+
chr11,66039642,1.8146496815286624,1775,1255,3030,+
chr11,66039675,1.6899621430925817,4311,2564,6875,+
chr11,66039676,1.9574977519851164,4240,2850,7090,+
chr11,66043578,0.3822152373457485,700,481,1181,+
chr11,66043605,0.8574052541393898,2023,1229,3252,+
chr11,66043606,1.0657456882434626,3942,2268,6210,+
chr11,66043607,1.058826827126119,1716,906,2622,+
chr11,66043608,0.8751990085323419,1555,944,2499,+
chr11,66043610,0.9223111939065246,2416,1294,3710,+
chr11,66043611,1.2266158468951076,5430,3249,8679,+
chr11,66043612,1.03184165232358,1961,1244,3205,+
chr11,66043616,1.6954221093372035,1192,847,2039,+
chr11,66043737,15.286534413047804,1265,855,2120,+
chr11,66043738,6.483694180125629,1121,757,1878,+
chr11,66043739,18.295775667035457,975,628,1603,+
chr11,66044303,0.22374406581151288,1220,292,1512,+
chr11,66044304,0.2294158344611635,1054,244,1298,+
chr11,66044327,30.18218590128384,1633,633,2266,+
chr11,66044328,20.749229524641866,2489,1815,4304,+
chr11,66044329,20.749229524641866,2489,1815,4304,+
chr11,66044330,18.06327721848352,1276,1125,2401,+
chr11,66394188,17.05171389248383,819,777,1596,+
chr11,66394189,17.05171389248383,819,777,1596,+
chr11,66394193,6.05931873048816,1020,1518,2538,+
chr11,66394194,6.05931873048816,1020,1518,2538,+
chr11,66394211,0.2522553603365864,598,814,1412,+
chr11,66394212,0.2450322580645161,421,619,1040,+
chr11,66406176,0.7829498637545006,832,425,1257,+
chr11,66406177,0.7829498637545006,832,425,1257,+
chr11,66407354,2.5143287931099616,655,481,1136,+
chr11,66411414,0.32775813062212894,604,458,1062,+
chr11,66413514,2.3357046070460705,787,491,1278,+
chr11,66413515,3.028565171070677,1106,725,1831,+
chr11,66413619,2.067772170151406,716,656,1372,+
chr11,66413621,1.487382159931108,1074,912,1986,+
chr11,66743957,2.8494134871734116,771,559,1330,+
chr11,66743958,2.963250568101178,636,522,1158,+
chr11,66744087,1.5546826569163639,890,581,1471,+
chr11,66744176,2.5700532195956,740,579,1319,+
chr11,66744281,0.6347103697704113,720,447,1167,+
chr11,66744288,1.385890610480755,582,434,1016,+
chr11,66744312,3.144827741817149,621,471,1092,+
chr11,66817130,36.42641484893681,710,421,1131,+
chr11,67022452,1.8451527776791776,682,442,1124,+
chr11,67049996,1.0797352663094864,570,500,1070,+
chr11,67049997,1.0797352663094864,570,500,1070,+
chr11,67250636,2.1471691200063847,1999,1657,3656,+
chr11,67250638,1.7518199678768576,1319,1140,2459,+
chr11,67250648,3.456485120718697,683,410,1093,+
chr11,67258428,2.919718309859155,690,354,1044,+
chr11,67258430,2.919718309859155,690,354,1044,+
chr11,67352157,2.5293089886829945,685,446,1131,+
chr11,67352700,1.9398553100340645,1389,1054,2443,+
chr11,67352701,1.8888155922038978,1015,724,1739,+
chr11,67374434,1.9866713607426345,753,543,1296,+
chr11,67375868,1.9028384279475985,580,457,1037,+
chr11,67375877,2.3569731081926206,672,532,1204,+
chr11,67375878,0.4956745950734351,1529,1035,2564,+
chr11,67376024,1.7851037851037852,730,467,1197,+
chr11,67376168,2.2018204645323287,914,707,1621,+
chr11,67376170,1.7033073297410755,1974,1495,3469,+
chr11,67377062,2.0535821496750413,855,620,1475,+
chr11,67377080,1.852235772357724,700,491,1191,+
chr11,67377870,1.9491262537483203,649,508,1157,+
chr11,67377882,1.8125937031484256,1013,597,1610,+
chr11,67377890,1.632084188679528,3432,2308,5740,+
chr11,67377891,1.5456204925636652,2065,1268,3333,+
chr11,67377957,0.5338118201188741,679,481,1160,+
chr11,67378521,0.9543720657276996,1300,767,2067,+
chr11,67378523,0.7672783801463064,2277,1543,3820,+
chr11,67378586,1.7713829608469165,726,540,1266,+
chr11,67378936,2.607782086790197,1066,727,1793,+
chr11,67379376,2.5976262222495534,959,706,1665,+
chr11,67379377,2.5976262222495534,959,706,1665,+
chr11,67379602,5.269598470363289,688,522,1210,+
chr11,67379611,1.5929194861233698,877,617,1494,+
chr11,67379680,1.3291338916088362,1034,756,1790,+
chr11,67798194,2.683307533539732,670,455,1125,+
chr11,67798195,2.683307533539732,670,455,1125,+
chr11,67799618,2.1817439761400204,711,489,1200,+
chr11,67799781,1.9366418944451447,614,466,1080,+
chr11,67800395,2.169748124330118,789,621,1410,+
chr11,67800419,1.719479166666667,970,599,1569,+
chr11,67800422,1.694022679223525,677,472,1149,+
chr11,67800618,0.6127572408536585,676,511,1187,+
chr11,67803743,1.5294368860960283,582,442,1024,+
chr11,67803936,0.5903149276643253,704,580,1284,+
chr11,67804046,1.901595744680851,549,469,1018,+
chr11,68318591,0.6848064052042284,1172,656,1828,+
chr11,68318601,2.9473684210526314,881,683,1564,+
chr11,68318605,0.5911039657020364,1102,621,1723,+
chr11,68318606,1.4038504540911985,3649,2760,6409,+
chr11,68318607,1.889723461651559,2010,1818,3828,+
chr11,68321720,2.0126936925944827,731,493,1224,+
chr11,68358136,3.0592383089187103,623,416,1039,+
chr11,68359129,0.5457555939777291,1553,1367,2920,+
chr11,68458415,0.9586710897992984,1428,938,2366,+
chr11,68458433,1.748076923076923,706,389,1095,+
chr11,69466319,8.88090527683832,1301,1009,2310,+
chr11,69466320,8.88090527683832,1301,1009,2310,+
chr11,70049843,3.001507348323075,809,418,1227,+
chr11,70049844,2.8254559473025,1447,802,2249,+
chr11,70049845,2.6186170286804744,1495,903,2398,+
chr11,70052249,2.2602108036890645,802,758,1560,+
chr11,70052251,2.2602108036890645,802,758,1560,+
chr11,70052255,1.739749430523918,704,438,1142,+
chr11,70052269,2.3013676821632094,1559,1217,2776,+
chr11,70052277,2.3641902136457618,1465,1450,2915,+
chr11,70052278,2.3641902136457618,1465,1450,2915,+
chr11,70052281,1.565419365837027,1596,1675,3271,+
chr11,70052282,1.565419365837027,1596,1675,3271,+
chr11,70052287,1.7735861610113108,873,1001,1874,+
chr11,70052345,1.9146405919661733,1126,945,2071,+
chr11,70052346,1.7816269319462523,1835,1456,3291,+
chr11,70053160,2.2006256216891322,258,981,1239,+
chr11,70053161,2.0599691248070298,208,801,1009,+
chr11,70053165,0.19990820001633777,442,653,1095,+
chr11,70053166,0.19990820001633777,442,653,1095,+
chr11,70053325,0.7731693363844393,794,459,1253,+
chr11,70053326,0.7731693363844393,794,459,1253,+
chr11,70221137,0.3824833702882483,620,491,1111,+
chr11,70221139,1.3568607571054678,1504,1157,2661,+
chr11,70221140,2.7515328019619867,618,465,1083,+
chr11,70244646,0.523356514532574,634,404,1038,+
chr11,70255965,1.058560879271853,803,646,1449,+
chr11,70255966,1.058560879271853,803,646,1449,+
chr11,70260725,1.4380090497737554,680,441,1121,+
chr11,70260738,1.6030497043155272,799,552,1351,+
chr11,70260746,1.1487614321453472,1898,1317,3215,+
chr11,70260747,1.1487614321453472,1898,1317,3215,+
chr11,70260751,0.5781144781144781,706,494,1200,+
chr11,70261817,0.6431755829903978,2045,1700,3745,+
chr11,70263141,1.3823429541595926,1769,1139,2908,+
chr11,70263142,0.9972553944613588,6794,4804,11598,+
chr11,70263164,1.806570205614348,3968,3032,7000,+
chr11,70275166,2.6097638873943696,855,564,1419,+
chr11,70275185,1.1282059222303125,1005,815,1820,+
chr11,70281428,0.8588272785213512,538,522,1060,+
chr11,70281430,0.8588272785213512,538,522,1060,+
chr11,70281750,1.369065958394182,664,540,1204,+
chr11,70282385,1.3928435196120916,639,511,1150,+
chr11,71194000,1.6515007351423052,736,573,1309,+
chr11,71194001,2.026143790849673,557,458,1015,+
chr11,71194007,2.0394981412639406,797,806,1603,+
chr11,71194008,1.961612184791805,1896,1579,3475,+
chr11,71194010,1.8949181739879413,1099,773,1872,+
chr11,71194017,2.371008403361345,626,475,1101,+
chr11,71707324,1.1420989560676875,534,489,1023,+
chr11,71903183,0.6227732197819101,1350,858,2208,+
chr11,71903210,1.4764091776727146,3174,2292,5466,+
chr11,71903211,1.4375977191207576,2232,1742,3974,+
chr11,71906326,1.9333553282744969,585,432,1017,+
chr11,71906329,1.5099887976101567,1293,823,2116,+
chr11,71906347,1.704347826086957,650,464,1114,+
chr11,71906398,1.965057915057915,753,517,1270,+
chr11,71906675,2.1649658766115203,1121,792,1913,+
chr11,71906684,0.5810635538261998,895,770,1665,+
chr11,71906731,1.9387234042553194,870,610,1480,+
chr11,71906754,1.8614718614718613,945,692,1637,+
chr11,71906755,1.8614718614718613,945,692,1637,+
chr11,71906988,2.317241379310345,575,434,1009,+
chr11,71907047,0.47102040816326535,1153,1049,2202,+
chr11,71907129,1.1768083929460391,951,676,1627,+
chr11,71907225,0.640129434438126,1120,688,1808,+
chr11,71907226,1.7798521904582922,1110,895,2005,+
chr11,71907246,2.05000744942452,1897,1353,3250,+
chr11,71907282,1.7663451232583065,1338,932,2270,+
chr11,71941046,2.087996174079388,589,696,1285,+
chr11,71941047,2.1966823108716,1210,1393,2603,+
chr11,71941049,2.2326404245908886,630,797,1427,+
chr11,71941418,1.138955081604537,680,446,1126,+
chr11,71942042,1.8152593871477523,594,421,1015,+
chr11,71949907,3.233471313235856,759,305,1064,+
chr11,71949943,21.474366521345896,1844,1383,3227,+
chr11,71949944,21.474366521345893,1844,1383,3227,+
chr11,71949945,18.95031282521599,1596,1152,2748,+
chr11,73574259,1.9920277839810883,1087,772,1859,+
chr11,73611426,0.8610426504455108,741,445,1186,+
chr11,73627599,0.6479537188344541,978,674,1652,+
chr11,73627600,0.724794988248811,825,512,1337,+
chr11,73627666,0.9938598191583389,2620,1760,4380,+
chr11,73627668,1.0997074381630665,2188,1481,3669,+
chr11,73627669,1.0642303257605517,1263,765,2028,+
chr11,73627673,0.49692782017361636,1032,550,1582,+
chr11,73627674,1.0607632076553748,2748,1893,4641,+
chr11,73627678,1.6319134277297347,1738,1237,2975,+
chr11,73965146,2.160277589398983,833,580,1413,+
chr11,74352694,0.4950229193071398,574,461,1035,+
chr11,74660386,8.857466185607851,1026,794,1820,+
chr11,74660387,7.863433702919101,1388,1089,2477,+
chr11,74660388,7.863433702919101,1388,1089,2477,+
chr11,74660395,4.384780749954566,570,451,1021,+
chr11,74680715,2.095863836496224,818,640,1458,+
chr11,74688174,4.3877424118310415,664,530,1194,+
chr11,74688183,0.44478487855509746,597,477,1074,+
chr11,74720146,3.4584341103181155,1001,734,1735,+
chr11,74720158,1.2933414915893826,570,435,1005,+
chr11,75110557,0.8481581311769991,1002,476,1478,+
chr11,75110558,0.8577800822035675,2536,1192,3728,+
chr11,75110559,1.2846859880466752,2304,1410,3714,+
chr11,75110560,0.9827227347504919,5958,3206,9164,+
chr11,75110561,1.1725936873747282,18097,11635,29732,+
chr11,75110562,1.1570425685562287,14625,9449,24074,+
chr11,75110563,1.1868001414610063,14728,9444,24172,+
chr11,75110566,1.2191673896856754,9039,5302,14341,+
chr11,75110568,1.225122444243594,14660,8709,23369,+
chr11,75110570,1.2384379944795296,23046,15155,38201,+
chr11,75110572,1.230466298169651,9127,6097,15224,+
chr11,75110575,1.279966951537528,5163,3520,8683,+
chr11,75110577,1.3059945746431272,4022,3389,7411,+
chr11,75110588,1.197082104205651,22864,16132,38996,+
chr11,75110589,1.1999597676772504,24075,17063,41138,+
chr11,75110600,1.198228138037708,24553,16518,41071,+
chr11,75110601,1.0842604927322455,65098,44490,109588,+
chr11,75110602,0.9004508303687881,34712,25473,60185,+
chr11,75110603,1.1986230708562278,36068,26422,62490,+
chr11,75110612,1.0221354526510178,33770,25176,58946,+
chr11,75110615,1.2868724846532311,13146,11905,25051,+
chr11,75111736,0.8713683421199623,1751,1198,2949,+
chr11,75111858,1.2179312220945444,24652,19872,44524,+
chr11,75115153,1.06586167250391,69226,52034,121260,+
chr11,75115154,1.121705767030299,73616,53167,126783,+
chr11,75115163,1.2277791329322396,34471,24056,58527,+
chr11,75115765,1.331716143627099,48275,29588,77863,+
chr11,75115766,1.2418032004381032,57588,37707,95295,+
chr11,75115777,1.2518721146911185,77133,55339,132472,+
chr11,75115778,1.3833336106038665,54641,37059,91700,+
chr11,75115847,1.1735365855825335,31774,24073,55847,+
chr11,75115848,1.2867440380848412,45564,32925,78489,+
chr11,75115853,1.2538237943471513,11723,8916,20639,+
chr11,75115893,1.2387406075896514,18485,11623,30108,+
chr11,75115907,1.1350368200294865,20718,13474,34192,+
chr11,75116656,1.0532826727404536,14487,11440,25927,+
chr11,75116658,1.0532826727404536,14487,11440,25927,+
chr11,75273225,0.1315547998718645,955,319,1274,+
chr11,75273226,0.237037037037037,815,254,1069,+
chr11,75273227,0.15185983755309057,1719,503,2222,+
chr11,75273228,0.19234429058922162,1650,437,2087,+
chr11,75273254,30.3608265696427,1071,120,1191,+
chr11,75273256,32.51539575495057,1833,445,2278,+
chr11,75273257,14.612605464303728,3745,1919,5664,+
chr11,75273258,13.975470604291553,3494,1894,5388,+
chr11,75273259,10.373017449378006,2407,1648,4055,+
chr11,75273271,0.5135962711165964,781,816,1597,+
chr11,75273295,2.461604534225641,2749,3004,5753,+
chr11,75273296,1.434782608695652,619,619,1238,+
chr11,75273297,2.2807820715349743,1746,1909,3655,+
chr11,75273303,0.4687426854679336,1587,1493,3080,+
chr11,75277376,1.8202748975162766,1540,930,2470,+
chr11,75277377,1.8025078369905956,1149,637,1786,+
chr11,75277457,0.5547230572874521,797,701,1498,+
chr11,75277554,1.5825588511230617,1022,678,1700,+
chr11,75277770,0.3859375,569,479,1048,+
chr11,75277791,0.443701226309922,596,467,1063,+
chr11,75277792,2.641210374639769,704,346,1050,+
chr11,75277841,2.3821772319946897,989,523,1512,+
chr11,75277871,1.3467781760254878,1320,774,2094,+
chr11,75277990,2.0657476683406784,1492,886,2378,+
chr11,75277992,2.2274124458380142,2283,1372,3655,+
chr11,75277993,0.6405180388529139,576,459,1035,+
chr11,75277994,2.069421078673924,1548,939,2487,+
chr11,75278010,2.615987827715356,720,533,1253,+
chr11,75279787,0.5163837396192035,1491,1138,2629,+
chr11,75279801,1.8094440456249503,1046,596,1642,+
chr11,75279802,2.06308045137229,1550,1176,2726,+
chr11,75279840,1.056417514206692,1870,1379,3249,+
chr11,75279991,0.378698224852071,959,844,1803,+
chr11,75280117,1.9320327249842668,920,680,1600,+
chr11,75280120,0.5857840819542948,807,674,1481,+
chr11,75280121,1.6596736596736599,978,714,1692,+
chr11,75280147,1.4835956255001332,1235,814,2049,+
chr11,75282922,1.87012987012987,759,664,1423,+
chr11,75282953,1.6561645974028258,1980,1360,3340,+
chr11,75282960,2.018781425613724,802,643,1445,+
chr11,75283043,0.3132467532467533,669,549,1218,+
chr11,75283071,0.4669748024452065,1295,1058,2353,+
chr11,75283072,1.4143221172895974,4694,3335,8029,+
chr11,75283073,1.807047316695667,3399,2277,5676,+
chr11,75283121,0.5754189944134078,720,536,1256,+
chr11,75283206,6.009142367142891,1444,524,1968,+
chr11,75283210,4.70807453416149,757,321,1078,+
chr11,75283211,2.690674421793861,2101,808,2909,+
chr11,75283212,3.2361365038435985,2858,1129,3987,+
chr11,75283223,2.4833596783084046,1310,721,2031,+
chr11,75283225,2.7301939058171745,879,474,1353,+
chr11,75283227,1.8163979663497716,1138,610,1748,+
chr11,75283242,13.369419967967952,3152,2267,5419,+
chr11,75283243,9.900382495761068,3412,2669,6081,+
chr11,75283245,4.8320574042652735,2809,2080,4889,+
chr11,75283247,2.1480730223123734,1411,1070,2481,+
chr11,75283248,2.7925015663409125,2887,2765,5652,+
chr11,75283251,0.5637551909592212,636,793,1429,+
chr11,75283262,5.659251352258929,5174,5703,10877,+
chr11,75283263,6.096395874583062,4520,4739,9259,+
chr11,75283294,0.5450900152815256,3152,3537,6689,+
chr11,75283295,0.5778348194579659,5011,5355,10366,+
chr11,75283323,0.4942097745128048,774,890,1664,+
chr11,75283395,1.0207234825260576,2080,1630,3710,+
chr11,75283396,1.0207234825260576,2080,1630,3710,+
chr11,75283505,1.4810629675810474,1266,801,2067,+
chr11,75283594,1.6354078670068892,2790,1690,4480,+
chr11,75283596,1.6261195700850877,2104,1159,3263,+
chr11,75283623,1.8333333333333333,929,743,1672,+
chr11,75283665,1.4910407239819006,1372,883,2255,+
chr11,75283732,1.4261133603238865,1408,968,2376,+
chr11,75283743,3.5407209612817088,815,748,1563,+
chr11,75283750,3.441918327811516,6728,5705,12433,+
chr11,75283752,3.5316756846781194,7987,6734,14721,+
chr11,76162951,0.91284674404879,695,390,1085,+
chr11,76162953,0.91284674404879,695,390,1085,+
chr11,76162957,0.8626571586464634,1535,913,2448,+
chr11,76162959,1.3087860700300349,1529,906,2435,+
chr11,76162960,0.9799044585987261,1060,627,1687,+
chr11,76162964,1.5691107427171074,1344,856,2200,+
chr11,76162971,2.2674002504920376,684,413,1097,+
chr11,76262310,7.191945136168314,355,745,1100,+
chr11,76507997,1.608713866778383,639,433,1072,+
chr11,76508064,34.22110049706921,1539,1147,2686,+
chr11,76508065,34.22110049706921,1539,1147,2686,+
chr11,76508081,6.153605157284744,787,1017,1804,+
chr11,76508104,0.3418940609951846,567,711,1278,+
chr11,76508106,0.3418940609951846,567,711,1278,+
chr11,76508815,3.061929510320962,601,540,1141,+
chr11,82400832,0.8402953240360952,791,574,1365,+
chr11,82400834,0.9876080387945485,1405,1168,2573,+
chr11,82400840,1.620954755597112,789,620,1409,+
chr11,82400843,1.875800711743772,752,561,1313,+
chr11,82400848,1.3402394106813993,1475,1628,3103,+
chr11,82400849,1.3402394106813993,1475,1628,3103,+
chr11,82400852,1.783347084708471,700,605,1305,+
chr11,82876816,2.359073359073359,610,517,1127,+
chr11,85339645,0.37452970430702326,1233,795,2028,+
chr11,85339648,0.6847142466502598,625,476,1101,+
chr11,85342777,0.5852999882587766,996,667,1663,+
chr11,85342841,1.7688301282051284,882,575,1457,+
chr11,85345156,2.798387096774193,1040,650,1690,+
chr11,85346801,1.666019417475728,1143,926,2069,+
chr11,85347165,1.7889990982867452,1983,1108,3091,+
chr11,85347186,2.260320324836454,1669,1022,2691,+
chr11,85347189,2.134516933578367,1781,1171,2952,+
chr11,85347191,1.5465091492488752,2901,1605,4506,+
chr11,85359049,1.2356222492052646,733,512,1245,+
chr11,85359052,2.2226014649558157,935,794,1729,+
chr11,85365112,1.156249592595447,1393,1049,2442,+
chr11,85367500,3.41397533763946,645,392,1037,+
chr11,86013461,2.5217319206864013,709,447,1156,+
chr11,86017291,3.081481481481481,727,440,1167,+
chr11,86017292,3.081481481481481,727,440,1167,+
chr11,86017340,0.8082095601240548,1138,819,1957,+
chr11,86048509,2.207661290322581,656,464,1120,+
chr11,86055757,2.0523594053005816,634,454,1088,+
chr11,86511584,1.0888298958546048,687,663,1350,+
chr11,86511585,1.0888298958546048,687,663,1350,+
chr11,86511605,0.3141629385448552,592,547,1139,+
chr11,86511609,0.3259911894273128,813,453,1266,+
chr11,86511636,1.705448489174399,895,466,1361,+
chr11,86511645,1.572953505726615,1211,628,1839,+
chr11,86518672,1.574643670834873,2736,1942,4678,+
chr11,86518675,1.6976127320954908,1279,1104,2383,+
chr11,86518685,1.4898264144763775,1993,1356,3349,+
chr11,86518692,1.430672268907563,1134,951,2085,+
chr11,86518713,1.587854349951124,2529,1935,4464,+
chr11,86518768,1.272210743801653,2462,1935,4397,+
chr11,86518995,1.0744509457200182,10021,6702,16723,+
chr11,86519025,1.5748646593223963,12038,9339,21377,+
chr11,86519047,1.464462997400132,5303,3316,8619,+
chr11,86519441,1.2894445096581495,4534,3650,8184,+
chr11,86519691,1.1939747294270522,4987,3574,8561,+
chr11,86519701,1.2727332555218114,3735,3056,6791,+
chr11,86519726,1.4597126257127766,4962,3198,8160,+
chr11,86519967,1.1301335759728872,9618,6887,16505,+
chr11,86519990,1.251120562848658,6604,5259,11863,+
chr11,86520478,1.892494426554372,1145,733,1878,+
chr11,86520528,2.1796174536760318,560,477,1037,+
chr11,86520588,2.278463280022023,1150,872,2022,+
chr11,86520798,1.9942348008385742,760,476,1236,+
chr11,86520872,1.995004873294347,654,431,1085,+
chr11,86520895,2.2764668367346936,648,391,1039,+
chr11,86520996,0.43197057552455376,1284,1026,2310,+
chr11,86521114,1.7697216710462806,749,642,1391,+
chr11,86521559,2.028050883663354,1125,778,1903,+
chr11,86521815,1.4416075214305466,1563,1141,2704,+
chr11,86521847,1.4908951210142143,923,684,1607,+
chr11,86522034,1.8313953488372092,629,429,1058,+
chr11,86522043,2.3732712765957444,660,469,1129,+
chr11,93454927,13.052696985417333,623,398,1021,+
chr11,93454946,2.3784844837833248,590,450,1040,+
chr11,93454964,3.368317683241896,1230,1039,2269,+
chr11,93454972,1.7609702182572542,633,515,1148,+
chr11,93454994,0.7338429338429339,1982,1484,3466,+
chr11,93495251,1.4625517021510999,608,399,1007,+
chr11,93535127,0.9755909755909756,723,480,1203,+
chr11,93535128,0.8186862151897694,1212,857,2069,+
chr11,93535132,1.2574762847657093,809,547,1356,+
chr11,93540701,1.7442698100851344,760,508,1268,+
chr11,93545138,0.9073771201740047,669,400,1069,+
chr11,94563305,1.3599806802853303,1089,782,1871,+
chr11,94563306,0.7677000216166988,1060,728,1788,+
chr11,94604090,2.2432323070415636,1061,892,1953,+
chr11,94604091,1.650285602855839,1062,889,1951,+
chr11,94801323,2.4747308612440198,612,417,1029,+
chr11,94801325,1.8474581002699706,860,592,1452,+
chr11,94802007,1.9856245391174687,583,444,1027,+
chr11,94802039,1.9540278444281867,557,462,1019,+
chr11,95532410,1.0823079481210507,848,581,1429,+
chr11,95532412,1.0823079481210507,848,581,1429,+
chr11,95532511,2.3484835164835163,721,454,1175,+
chr11,95546097,2.6337792642140467,874,597,1471,+
chr11,95546123,1.8020240883238543,694,426,1120,+
chr11,95546230,2.8218344965104687,912,589,1501,+
chr11,95555701,1.770779556014455,734,446,1180,+
chr11,95561093,2.270550161812298,876,617,1493,+
chr11,95562350,1.8582653595749459,775,580,1355,+
chr11,95562434,2.934478371501272,658,392,1050,+
chr11,95562469,2.057356608478803,674,400,1074,+
chr11,95564602,1.7160286046677353,1217,868,2085,+
chr11,95564819,1.5772282388370882,800,556,1356,+
chr11,101985117,5.623919480085757,664,540,1204,+
chr11,102100700,3.4284263959390864,613,393,1006,+
chr11,102101203,1.7989536621823616,663,445,1108,+
chr11,102101445,5.1876027466238614,439,649,1088,+
chr11,102101478,0.15975259062396216,455,619,1074,+
chr11,102102784,3.171530369867662,602,420,1022,+
chr11,102102785,2.590738077553961,1161,817,1978,+
chr11,102103034,8.941379562148484,1066,1066,2132,+
chr11,102103035,11.379296862277544,2456,3272,5728,+
chr11,102103036,9.951263184426589,3042,4447,7489,+
chr11,102103037,9.939837574813161,2691,4158,6849,+
chr11,102103038,11.659898572714406,1736,2870,4606,+
chr11,102103836,1.3738007170769653,1543,873,2416,+
chr11,102103838,0.47994208329784505,804,397,1201,+
chr11,102103914,2.134567901234568,1000,659,1659,+
chr11,102103928,1.3753327791437098,2016,1393,3409,+
chr11,102103965,1.9163364156759135,1087,756,1843,+
chr11,102103972,1.8050202839756593,1694,1159,2853,+
chr11,102103975,1.5187572843822843,1812,1286,3098,+
chr11,102103977,1.8211781805745553,1468,1087,2555,+
chr11,105950403,3.471979020451069,600,409,1009,+
chr11,107992295,0.715666287166724,794,210,1004,+
chr11,107992312,2.7205505296689085,1240,596,1836,+
chr11,108002633,1.403174603174603,662,404,1066,+
chr11,108002634,2.7612354994908017,1072,692,1764,+
chr11,108004956,1.8605780908428464,765,536,1301,+
chr11,108005029,2.2268178104575163,622,407,1029,+
chr11,108005898,0.5693129528745967,597,510,1107,+
chr11,108005920,0.2620563612781512,634,513,1147,+
chr11,108005922,0.5525525525525526,804,554,1358,+
chr11,108010816,1.8215402102870133,640,458,1098,+
chr11,108010934,1.9191781670863013,1699,1251,2950,+
chr11,108017037,0.5570075978959673,1082,724,1806,+
chr11,108018048,3.0461538461538464,659,399,1058,+
chr11,110333266,3.1959892231867233,685,473,1158,+
chr11,111957622,0.5619078254172007,997,567,1564,+
chr11,111965554,2.0287498926930096,675,483,1158,+
chr11,111965661,3.574441225429037,741,427,1168,+
chr11,112099370,1.6578604044357468,781,510,1291,+
chr11,112100940,1.992857142857143,899,499,1398,+
chr11,112101374,1.5586890243902443,1226,655,1881,+
chr11,112101383,1.5232027499555505,1317,717,2034,+
chr11,112101389,0.5379781217722193,3689,1857,5546,+
chr11,112103891,1.503366143560219,2088,978,3066,+
chr11,112103898,1.7175896957604808,2384,1192,3576,+
chr11,112104289,2.467303822937626,653,496,1149,+
chr11,114167139,1.0791689955961015,1376,1051,2427,+
chr11,114167281,1.978698224852071,1101,844,1945,+
chr11,114167313,1.0338199536956572,3206,2341,5547,+
chr11,114167322,0.7395111624326406,1739,1298,3037,+
chr11,114167384,0.7190300474433315,2375,1625,4000,+
chr11,114168723,1.6969580284944163,1468,1126,2594,+
chr11,114168868,1.6538243626062323,972,705,1677,+
chr11,114182789,2.549431166769556,802,666,1468,+
chr11,114182791,0.49649595687331544,613,529,1142,+
chr11,114182862,1.8422619047619049,618,447,1065,+
chr11,114182887,2.2632964718272777,613,421,1034,+
chr11,114183014,2.010944395410415,711,514,1225,+
chr11,114183032,2.7092161016949152,824,589,1413,+
chr11,114183077,1.8647690655209452,642,489,1131,+
chr11,114183079,0.5213337757133378,826,684,1510,+
chr11,114183080,0.4430894308943089,544,491,1035,+
chr11,114183100,0.6697871339527226,1016,772,1788,+
chr11,114183119,0.5456296962301715,1061,676,1737,+
chr11,114272434,2.866174184910848,836,460,1296,+
chr11,114272446,3.2801985111662533,1295,805,2100,+
chr11,114272447,3.2801985111662533,1295,805,2100,+
chr11,114272451,1.7747446610956361,1508,1076,2584,+
chr11,114272452,1.7747446610956361,1508,1076,2584,+
chr11,114272474,2.281964903014821,1420,787,2207,+
chr11,114272487,0.6316646869166808,1187,1064,2251,+
chr11,114272489,1.7389547730971309,1783,1087,2870,+
chr11,114272495,1.9670272289116955,2042,1327,3369,+
chr11,114310394,0.5736602299848124,660,418,1078,+
chr11,114311383,2.097902097902098,647,428,1075,+
chr11,114311392,2.7407733509428422,982,648,1630,+
chr11,114311405,1.6560165975103736,920,481,1401,+
chr11,114311439,2.027481166066164,1316,709,2025,+
chr11,114311445,0.6332210353334177,3744,2218,5962,+
chr11,114314588,1.1658241713625117,4260,2714,6974,+
chr11,114314590,1.6043536386720372,5961,3146,9107,+
chr11,114314591,1.6043536386720372,5961,3146,9107,+
chr11,114314627,0.9717750887545855,2561,2658,5219,+
chr11,114315366,4.265734265734266,670,428,1098,+
chr11,114316734,1.8858921161825728,605,481,1086,+
chr11,114316775,0.5867050195979264,806,718,1524,+
chr11,114320673,0.4874000301795685,645,563,1208,+
chr11,114320675,2.1241021309823074,3270,2436,5706,+
chr11,114320676,2.1241021309823074,3270,2436,5706,+
chr11,114320677,2.1241021309823074,3270,2436,5706,+
chr11,114320692,0.31071964017991,828,666,1494,+
chr11,114320737,0.6913317137809187,1526,1131,2657,+
chr11,114320752,1.5824404761904762,1226,959,2185,+
chr11,114320756,1.980072231025081,1429,1228,2657,+
chr11,114320760,2.558383182939606,1513,1408,2921,+
chr11,114320765,1.4214330082921238,5776,4493,10269,+
chr11,114320866,2.304481082027689,1217,860,2077,+
chr11,114320879,3.0370902129696105,667,596,1263,+
chr11,118255378,2.09590180986062,649,417,1066,+
chr11,118255379,2.09590180986062,649,417,1066,+
chr11,118272386,1.5613382899628252,699,537,1236,+
chr11,118272388,2.0123456790123457,1303,809,2112,+
chr11,118277659,2.258901713885974,1317,952,2269,+
chr11,118277662,1.395466906830543,2164,1286,3450,+
chr11,118277683,0.9881338946401497,8008,6248,14256,+
chr11,118277684,0.6259128809660724,4582,3551,8133,+
chr11,118277685,1.4692613655222777,3426,2697,6123,+
chr11,118279759,1.5900897976847344,1266,1026,2292,+
chr11,118453901,2.575507066871865,899,624,1523,+
chr11,118453921,2.300904977375566,677,441,1118,+
chr11,118453966,2.5424908424908423,630,419,1049,+
chr11,118455273,1.962503583954641,1041,672,1713,+
chr11,118455320,2.3913104810269434,651,416,1067,+
chr11,118455323,2.411626541397534,1368,916,2284,+
chr11,118455324,2.411626541397534,1368,916,2284,+
chr11,118455327,1.5905260707764366,2314,1693,4007,+
chr11,118455328,1.570301510610972,1571,1181,2752,+
chr11,118461123,12.105183046256812,553,474,1027,+
chr11,118461201,1.5742119781717936,934,631,1565,+
chr11,118463554,0.4465617232808616,587,425,1012,+
chr11,118464305,2.235881271342264,607,422,1029,+
chr11,118464329,2.2254157827175036,753,587,1340,+
chr11,118468485,0.4326530612244899,688,489,1177,+
chr11,118468486,0.4326530612244899,688,489,1177,+
chr11,118472779,1.8771619594920759,604,422,1026,+
chr11,118473261,0.8743071696763811,814,657,1471,+
chr11,118473262,1.147958578715879,1003,809,1812,+
chr11,118960756,2.4177104495306905,648,435,1083,+
chr11,120100386,1.9219780219780225,900,454,1354,+
chr11,120100387,1.9219780219780225,900,454,1354,+
chr11,120312823,1.7054357144185235,918,521,1439,+
chr11,120312855,3.085470085470085,721,389,1110,+
chr11,123465519,4.510978715863439,842,684,1526,+
chr11,123993677,1.897077844176566,913,799,1712,+
chr11,123993678,1.897077844176566,913,799,1712,+
chr11,123995139,1.1793409817368463,776,563,1339,+
chr11,125445159,1.7072642967542504,788,646,1434,+
chr11,125445160,1.4901002506265664,2067,1259,3326,+
chr11,125445161,1.4901002506265664,2067,1259,3326,+
chr11,125445162,1.4901002506265664,2067,1259,3326,+
chr11,125445241,1.6959144528657533,3486,2197,5683,+
chr11,125445242,1.935330728194771,2820,1803,4623,+
chr11,125454370,25.75641025641026,573,467,1040,+
chr11,125454371,30.222483974721648,1489,1128,2617,+
chr11,125454376,2.617578624330992,597,481,1078,+
chr11,125465857,1.2173925842664397,589,483,1072,+
chr11,125465894,0.39624155776993014,610,513,1123,+
chr11,125474131,1.0460526315789471,794,531,1325,+
chr11,125474132,1.0460526315789471,794,531,1325,+
chr11,125476289,1.3262126226623343,580,479,1059,+
chr11,125479446,0.3433199899924943,498,570,1068,+
chr11,125479447,0.3433199899924943,498,570,1068,+
chr11,125484305,2.073127753303965,723,453,1176,+
chr11,125484306,0.5514678558156818,1059,620,1679,+
chr11,125484308,1.2016003316079371,1337,892,2229,+
chr11,125484313,1.5613445378151258,928,594,1522,+
chr11,125497506,2.756942456341254,534,498,1032,+
chr11,126215452,0.3775337837837838,446,1109,1555,+
chr11,126215453,0.3865786852589641,620,1505,2125,+
chr11,126215454,0.39417057902973396,805,1916,2721,+
chr11,126215455,0.3980836644075718,667,1555,2222,+
chr11,126215456,0.4373423044575273,519,1188,1707,+
chr11,126215463,3.0004310397111644,761,1253,2014,+
chr11,126215558,25.22052448788538,664,984,1648,+
chr11,126278206,3.117250332728987,607,426,1033,+
chr11,126278280,0.9981376060501277,837,627,1464,+
chr11,126278382,2.24569086925796,808,581,1389,+
chr11,126284294,0.2057406663990365,819,423,1242,+
chr11,126284295,0.2057406663990365,819,423,1242,+
chr11,126284314,0.3612232332215913,879,310,1189,+
chr11,126284316,0.3495095948827292,1365,468,1833,+
chr11,126284317,0.398750150222329,947,313,1260,+
chr11,126284379,3.9508881922675023,1193,197,1390,+
chr11,126284380,4.385710798757085,5626,832,6458,+
chr11,126284381,3.7514856086628945,10303,1736,12039,+
chr11,126284382,3.8536287199115224,12200,2213,14413,+
chr11,126284383,3.5882103103855574,11873,2351,14224,+
chr11,126284384,3.622973953212459,9385,2003,11388,+
chr11,126284385,3.731843255435093,7426,1938,9364,+
chr11,126284386,3.7975497251108905,10135,2716,12851,+
chr11,126284387,2.9177922125563205,14070,4054,18124,+
chr11,126284388,2.827339812387514,14987,4583,19570,+
chr11,126284389,2.897252956713464,10095,3331,13426,+
chr11,126284390,2.6333793067147253,7772,2668,10440,+
chr11,126284392,2.5748420763526503,1124,330,1454,+
chr11,126284395,6.62408516300732,1571,500,2071,+
chr11,126284396,4.320155735250075,1153,370,1523,+
chr11,126284398,31.537764350453173,948,330,1278,+
chr11,126284399,56.89096537468139,4915,2044,6959,+
chr11,129939788,0.6867245147573088,1303,690,1993,+
chr11,129939789,0.7630219339480244,911,430,1341,+
chr11,129939911,2.6799188640973632,733,289,1022,+
chr11,129939913,3.4897959183673475,1082,440,1522,+
chr11,129939915,4.281727574750831,715,300,1015,+
chr11,129939918,2.696095458081367,1003,520,1523,+
chr11,129939919,1.1013489527866525,729,312,1041,+
chr11,129979332,2.362769485903814,694,602,1296,+
chr11,129979333,1.4494618576782003,1548,1240,2788,+
chr11,129979335,0.7694140398919618,985,851,1836,+
chr11,129979369,1.5028775948460988,728,634,1362,+
chr11,129980522,3.415258576548899,579,433,1012,+
chr11,129990678,1.8751430533302813,564,513,1077,+
chr11,129991516,1.6066763425253991,1214,794,2008,+
chr11,129991566,1.9117639012528793,3683,2222,5905,+
chr11,129991586,1.483556416934165,2069,1253,3322,+
chr11,129991647,1.5305381313965003,2195,1397,3592,+
chr11,129991671,1.4343113462539032,11572,7383,18955,+
chr11,129991672,1.569507817933015,6553,4571,11124,+
chr11,129991677,1.898977777576706,7545,5973,13518,+
chr11,129991678,1.898977777576706,7545,5973,13518,+
chr11,129992282,3.4404831510832947,3415,2179,5594,+
chr11,129992291,5.51294098580167,3251,2407,5658,+
chr11,129992294,6.847714504804264,3260,2654,5914,+
chr11,129992309,1.6315756315756316,1125,857,1982,+
chr11,129997728,0.5497870381029124,596,510,1106,+
chr11,129999032,2.013071895424837,835,645,1480,+
chr11,129999079,1.7315192743764172,1701,1294,2995,+
chr11,129999080,1.7315192743764172,1701,1294,2995,+
chr11,129999081,2.546455938697318,1226,695,1921,+
chr11,129999939,0.6587612238776097,3449,2399,5848,+
chr11,129999942,0.5894896364604262,2250,1651,3901,+
chr11,130000033,1.4277905638665132,1417,868,2285,+
chr11,130000034,2.5955479452054795,688,583,1271,+
chr11,130000047,2.310244470314319,1322,858,2180,+
chr11,130003542,1.4381551362683438,1371,989,2360,+
chr11,130003602,2.620037807183365,692,528,1220,+
chr11,130010319,2.6537852418920647,2368,1840,4208,+
chr11,130010320,2.4150785568810007,1164,981,2145,+
chr11,130010336,0.5512873754152824,884,601,1485,+
chr11,130011849,0.5398939449993834,795,635,1430,+
chr11,130013243,2.0150094254179525,1007,873,1880,+
chr11,130013281,2.46027633851468,615,578,1193,+
chr11,130013287,2.431930580536001,1340,1030,2370,+
chr11,130013317,2.011742341292839,1690,1141,2831,+
chr11,130013390,2.02098801976642,1749,1154,2903,+
chr11,130013417,0.6120600414078675,859,482,1341,+
chr11,130013446,1.7324688404884805,833,610,1443,+
chr11,130013447,1.996378879420621,1748,1036,2784,+
chr11,130013448,1.996378879420621,1748,1036,2784,+
chr11,130013456,2.36036036036036,785,554,1339,+
chr11,130013480,0.711958292603454,1494,1022,2516,+
chr11,130013515,2.070785597381342,722,563,1285,+
chr11,130013516,1.4833519818261962,1482,1016,2498,+
chr11,130013889,0.4633642930856553,897,569,1466,+
chr11,130013979,1.8756137479541726,763,610,1373,+
chr11,130013989,1.469606413994169,857,685,1542,+
chr11,130014008,2.024605250411702,1099,665,1764,+
chr11,130014336,2.326119604430545,888,675,1563,+
chr12,542412,3.1004493787998944,629,372,1001,+
chr12,547503,0.3976708754914593,855,503,1358,+
chr12,551607,0.4830999517141478,666,435,1101,+
chr12,551617,0.6025581753737094,781,514,1295,+
chr12,551618,3.2512179374302987,1350,1261,2611,+
chr12,551619,3.2512179374302987,1350,1261,2611,+
chr12,551622,2.026834936348573,1630,1343,2973,+
chr12,1018068,0.18676336336650082,541,782,1323,+
chr12,1018070,0.16558171689145498,467,637,1104,+
chr12,1895771,22.973768288920283,1417,162,1579,+
chr12,1895772,29.40016652195,1147,125,1272,+
chr12,1895780,11.328141969831412,1127,98,1225,+
chr12,1895781,17.318681318681318,1181,116,1297,+
chr12,1895782,36.50029086678301,1487,381,1868,+
chr12,1895783,28.560471628810493,2024,898,2922,+
chr12,1895784,24.40632010910528,1881,1116,2997,+
chr12,1896701,0.7187622983077528,768,483,1251,+
chr12,1896702,0.7187622983077528,768,483,1251,+
chr12,1896703,1.0565780934901587,950,652,1602,+
chr12,1897095,2.647058823529412,749,449,1198,+
chr12,1897096,3.0726591486202417,981,670,1651,+
chr12,1897123,1.6385594323753374,1302,974,2276,+
chr12,1897124,0.6264264264264264,744,554,1298,+
chr12,1897125,0.6264264264264264,744,554,1298,+
chr12,1897522,1.1692066891141073,656,510,1166,+
chr12,2906329,0.579298418972332,669,367,1036,+
chr12,2906339,1.879660704407155,1617,934,2551,+
chr12,2906340,1.879660704407155,1617,934,2551,+
chr12,2906394,1.929573804573805,549,480,1029,+
chr12,2906923,2.2963842702560044,790,420,1210,+
chr12,2906954,1.8308884201550872,1030,604,1634,+
chr12,2906957,1.829643319180465,1033,695,1728,+
chr12,2906971,1.7136907860489328,822,451,1273,+
chr12,2906973,2.790606653620352,712,510,1222,+
chr12,2906974,2.6441748379591155,739,546,1285,+
chr12,2906981,0.6327185244587008,788,550,1338,+
chr12,2906998,0.7355479727017261,1046,751,1797,+
chr12,2907002,0.6169942669942671,1158,813,1971,+
chr12,2907005,1.464137665092066,1214,901,2115,+
chr12,2907007,0.6288344085528653,3006,1917,4923,+
chr12,2907009,0.6288344085528653,3006,1917,4923,+
chr12,2907010,1.309196980096088,1525,1127,2652,+
chr12,2907914,1.6276169265033409,608,448,1056,+
chr12,2907964,2.483870967741935,1000,619,1619,+
chr12,2908270,1.3203167634522324,1079,863,1942,+
chr12,2908325,1.5885947046843176,819,490,1309,+
chr12,2908380,1.0233623475869242,1713,1272,2985,+
chr12,2908382,0.485748502994012,1091,834,1925,+
chr12,2909038,1.5210128922009352,1999,1414,3413,+
chr12,2909050,0.46894132653061216,773,639,1412,+
chr12,2909283,3.220660599932592,1240,988,2228,+
chr12,2910433,3.050121978265691,808,500,1308,+
chr12,2910445,1.7658407079646017,906,564,1470,+
chr12,2910452,1.8485979939966317,1009,470,1479,+
chr12,2910469,1.3553698952116633,3588,2110,5698,+
chr12,2910470,0.8218328932606553,1542,1116,2658,+
chr12,2910471,1.7105141090065714,2602,1392,3994,+
chr12,2910472,0.9753455822349714,1065,762,1827,+
chr12,2910477,1.522304070028723,1469,838,2307,+
chr12,2910489,0.8237634543703146,2313,1515,3828,+
chr12,2910514,1.7206531834498116,5548,3508,9056,+
chr12,2910516,1.7225101669860006,8537,5275,13812,+
chr12,2912568,4.109217359583338,1291,331,1622,+
chr12,2912569,4.804655017751815,1922,476,2398,+
chr12,2912575,4.670619260953242,1071,253,1324,+
chr12,2912578,5.062552408581964,1027,232,1259,+
chr12,2912585,7.341087177204502,2977,659,3636,+
chr12,2912586,8.570851136725693,6368,1862,8230,+
chr12,2912587,8.570851136725693,6368,1862,8230,+
chr12,2912588,8.951221620262642,5396,1691,7087,+
chr12,2912596,6.764956011730206,1182,439,1621,+
chr12,2912598,12.942469818685675,6112,9121,15233,+
chr12,2912599,12.60124764866446,5533,8937,14470,+
chr12,2912600,11.148764171161144,6002,9785,15787,+
chr12,2912602,1.3662706388175136,1917,3417,5334,+
chr12,2912603,0.3796845378963411,2015,3508,5523,+
chr12,2912604,0.42480340926963744,2700,4681,7381,+
chr12,2912605,0.408868846298384,1546,2660,4206,+
chr12,4662297,0.41415217039868274,605,420,1025,+
chr12,4763472,2.907780979827089,1008,693,1701,+
chr12,4763474,2.6557137366807,1405,1040,2445,+
chr12,4764031,0.5180272984805563,893,705,1598,+
chr12,4764032,0.5180272984805563,893,705,1598,+
chr12,4766954,2.331748193890471,1156,1012,2168,+
chr12,4768300,0.9340712653898336,1267,965,2232,+
chr12,4771708,1.925017696430377,1028,681,1709,+
chr12,4771740,2.009591886608016,888,681,1569,+
chr12,4791401,0.5792682926829269,797,491,1288,+
chr12,4796121,2.164766081871345,870,569,1439,+
chr12,4796267,1.7463657759933546,741,465,1206,+
chr12,4796272,1.9054435483870968,726,495,1221,+
chr12,6309695,0.941910055713195,1763,1287,3050,+
chr12,6309711,1.6195300579798597,855,564,1419,+
chr12,6309716,0.5607235142118863,650,515,1165,+
chr12,6334658,1.8346938775510202,712,489,1201,+
chr12,6341809,1.7367149758454106,718,413,1131,+
chr12,6342591,3.10986328125,578,511,1089,+
chr12,6342593,3.10986328125,578,511,1089,+
chr12,6344684,0.6140408341522,591,425,1016,+
chr12,6344713,1.8501349806043863,1326,969,2295,+
chr12,6346944,0.43171809138816597,1533,1112,2645,+
chr12,6346991,2.8084168336673345,538,498,1036,+
chr12,6347090,1.7475822050290135,833,516,1349,+
chr12,6347201,1.7138818207520496,865,654,1519,+
chr12,6347253,1.4587440157702056,1294,937,2231,+
chr12,6347254,1.849894291754757,594,472,1066,+
chr12,6347261,1.6712194055944054,804,703,1507,+
chr12,6493808,1.4778083643031243,771,547,1318,+
chr12,6494487,1.9633911171533882,1435,1110,2545,+
chr12,6494489,1.9633911171533882,1435,1110,2545,+
chr12,6494493,2.073837502459661,830,706,1536,+
chr12,6495513,2.2555622119815673,735,515,1250,+
chr12,6495515,1.7631295278951173,922,664,1586,+
chr12,6500655,4.771756183297704,1459,921,2380,+
chr12,6500656,4.03628268027098,1956,1191,3147,+
chr12,6500672,17.70597146392618,1398,969,2367,+
chr12,6500673,15.433696292706015,2088,1634,3722,+
chr12,6500676,10.055053239325273,1408,1462,2870,+
chr12,6604277,1.4484837680938312,689,452,1141,+
chr12,6619833,2.465830969568723,646,448,1094,+
chr12,6619858,2.401639344262295,585,487,1072,+
chr12,6619859,2.401639344262295,585,487,1072,+
chr12,6620345,2.833205369076403,657,452,1109,+
chr12,6623533,2.384786053882726,989,630,1619,+
chr12,6623534,2.384786053882726,989,630,1619,+
chr12,6623661,1.9260442260442256,602,406,1008,+
chr12,6623681,1.9022289766970615,750,469,1219,+
chr12,6623701,2.7148148148148143,732,413,1145,+
chr12,6623705,1.8831470153975955,743,430,1173,+
chr12,6626992,1.1799559235549257,631,489,1120,+
chr12,6626994,0.34481032979229426,590,470,1060,+
chr12,6632118,0.7837638376383764,707,541,1248,+
chr12,6632119,0.7837638376383764,707,541,1248,+
chr12,6632120,0.7837638376383764,707,541,1248,+
chr12,6635235,1.2191120873829573,926,584,1510,+
chr12,6635236,1.4737520128824475,831,459,1290,+
chr12,6635644,1.48690253753652,645,442,1087,+
chr12,6635697,1.5745736761522624,931,610,1541,+
chr12,6635710,1.571839816108283,2265,1439,3704,+
chr12,6636157,2.2131525242165084,807,650,1457,+
chr12,6639857,0.256424106242618,628,417,1045,+
chr12,6640535,1.512576272045708,872,618,1490,+
chr12,6643681,0.9968356712855692,13326,9351,22677,+
chr12,6643682,0.9758020226952699,37669,27243,64912,+
chr12,6643683,0.9781583663181274,56768,39854,96622,+
chr12,6643685,0.6444331022761903,36505,24250,60755,+
chr12,6643712,1.0445254866269718,15159,11283,26442,+
chr12,6643713,1.14877477942265,57480,39731,97211,+
chr12,6643715,1.187172089943821,119112,78141,197253,+
chr12,6643716,1.149563427354558,115227,74796,190023,+
chr12,6643718,1.0512170249228898,63483,41635,105118,+
chr12,6643719,1.0540423715100304,82492,53965,136457,+
chr12,6645658,1.0291537591666753,1443,1040,2483,+
chr12,6645731,1.4148269729921785,35517,23258,58775,+
chr12,6646098,1.5423893158922335,20080,14839,34919,+
chr12,6646287,1.0650538685176691,34275,23772,58047,+
chr12,6646303,1.1878401116806983,26154,15784,41938,+
chr12,6646327,1.585050488393325,9778,7690,17468,+
chr12,6646473,1.0226056957307228,1499,1173,2672,+
chr12,6646529,1.0174646234361737,30621,20179,50800,+
chr12,6646834,1.1595802509024837,30607,24002,54609,+
chr12,6646837,1.1830465088416076,11374,8712,20086,+
chr12,6646902,0.8138757916795301,10204,7991,18195,+
chr12,6646903,1.1656546360748798,21855,17837,39692,+
chr12,6646969,1.4152482515833738,7906,6300,14206,+
chr12,6647052,1.1364389653571652,38503,25513,64016,+
chr12,6647076,1.3099222208832086,8036,6061,14097,+
chr12,6647423,1.2941693017867304,9826,5400,15226,+
chr12,6647428,1.2687819857827851,21737,12520,34257,+
chr12,6647430,1.353377304495758,33125,19290,52415,+
chr12,6647431,1.4188604190517728,22500,13259,35759,+
chr12,6647448,0.8353101022683261,7443,5754,13197,+
chr12,6647455,1.110464681550524,26519,19699,46218,+
chr12,6838479,5.551275595142636,948,639,1587,+
chr12,6838481,0.922635905228984,702,466,1168,+
chr12,6840300,2.62987012987013,809,714,1523,+
chr12,6840301,2.2507558578987155,553,503,1056,+
chr12,6840937,19.0876956915513,810,500,1310,+
chr12,6840938,16.526646548876442,1151,738,1889,+
chr12,6879090,2.9409990100141523,1228,640,1868,+
chr12,6879092,4.374677953625322,1131,626,1757,+
chr12,6879093,3.088166327024447,2070,1150,3220,+
chr12,6879108,3.2605848721148467,1797,1200,2997,+
chr12,6879111,8.235789149638066,1895,1709,3604,+
chr12,6879664,16.986687700683934,1757,1059,2816,+
chr12,6879665,19.204949949653635,2195,1382,3577,+
chr12,6879666,19.204949949653635,2195,1382,3577,+
chr12,6879667,17.05046765467236,1316,883,2199,+
chr12,6879715,0.4525059141558575,595,451,1046,+
chr12,6879800,1.091694737086354,1124,717,1841,+
chr12,6879946,1.9186046511627908,604,429,1033,+
chr12,6965184,2.694503497248433,883,649,1532,+
chr12,6965186,2.756357388316151,616,484,1100,+
chr12,6965236,0.5928385416666667,941,639,1580,+
chr12,6965239,0.554983388704319,770,419,1189,+
chr12,6965244,0.6309705993554543,1297,828,2125,+
chr12,6965253,0.6562181122448979,1582,979,2561,+
chr12,6965254,0.455157271729273,1191,573,1764,+
chr12,6965255,1.780388198045244,969,702,1671,+
chr12,6965264,1.1600319485215984,3121,2041,5162,+
chr12,6976701,1.9611578185242526,1008,717,1725,+
chr12,6976722,1.225083369580977,2035,1209,3244,+
chr12,6976724,1.225083369580977,2035,1209,3244,+
chr12,6976728,1.6588776661939628,2513,1584,4097,+
chr12,6976730,1.6588776661939628,2513,1584,4097,+
chr12,6976734,1.9327699829931972,886,783,1669,+
chr12,6976743,1.603904282115869,848,793,1641,+
chr12,6976745,0.6403946962688868,1297,1080,2377,+
chr12,6976746,1.361174416195578,2189,1468,3657,+
chr12,6976763,1.7169185450819673,1740,1279,3019,+
chr12,6976770,1.6151103384659051,1957,1657,3614,+
chr12,6978079,1.5045838799116185,6775,4493,11268,+
chr12,6978087,1.054678200770537,3670,2623,6293,+
chr12,6978431,1.4904212306108946,1512,1114,2626,+
chr12,6978434,1.3000499251123314,2603,2002,4605,+
chr12,6978924,1.4697478044357524,5454,3390,8844,+
chr12,6979216,1.579172218520986,2038,1579,3617,+
chr12,6979219,1.3007101449275362,2188,1724,3912,+
chr12,6979220,1.386666666666667,4623,2889,7512,+
chr12,6979290,1.3095584526037998,3271,1830,5101,+
chr12,6979585,1.554681587888752,10497,6680,17177,+
chr12,6979586,1.5540376289925488,8581,5019,13600,+
chr12,6979598,2.1127471169686984,1733,1213,2946,+
chr12,6979606,1.2095965458006408,3157,2379,5536,+
chr12,6979854,1.4052614052614052,4219,2969,7188,+
chr12,6979855,1.4052614052614052,4219,2969,7188,+
chr12,7053184,0.6651073492094409,1404,536,1940,+
chr12,7053207,1.7298744342034629,5395,2733,8128,+
chr12,7053208,1.7298744342034629,5395,2733,8128,+
chr12,7053212,2.165478312537136,984,560,1544,+
chr12,7053239,1.8433143140659884,1031,694,1725,+
chr12,7053240,0.48646601685985247,868,583,1451,+
chr12,7053248,1.475625277123931,2753,1687,4440,+
chr12,7053653,1.839892665474061,725,558,1283,+
chr12,7053684,1.7981981981981985,997,554,1551,+
chr12,7053709,2.1724137931034484,647,521,1168,+
chr12,7053730,1.1308408084516288,2083,1320,3403,+
chr12,7053731,1.1308408084516288,2083,1320,3403,+
chr12,7053764,0.6004464285714285,806,629,1435,+
chr12,7053779,1.4522779906953869,1336,826,2162,+
chr12,7055031,1.7372134038800704,984,566,1550,+
chr12,7055085,2.1773541776519223,1144,756,1900,+
chr12,7055106,0.4642159563279411,712,486,1198,+
chr12,7080074,1.4720374707259951,581,426,1007,+
chr12,7080076,1.0374046018372236,1085,720,1805,+
chr12,7080078,0.9587208092268866,913,601,1514,+
chr12,7080080,2.9510489510489517,843,168,1011,+
chr12,7080082,2.311016120748215,1437,340,1777,+
chr12,7080083,1.7364814689497805,1805,890,2695,+
chr12,7080100,2.2003045707985813,1679,704,2383,+
chr12,7080103,1.8823696790348279,2133,763,2896,+
chr12,7080104,1.8710450756836616,3355,1236,4591,+
chr12,7080105,0.7623705891236137,1164,976,2140,+
chr12,7080106,1.7514502560022147,3288,1428,4716,+
chr12,7080118,1.3590643906655144,3257,1423,4680,+
chr12,7080120,1.4067986590381294,4453,2163,6616,+
chr12,7080147,1.7487077067669174,1831,1215,3046,+
chr12,7083586,2.1485148514851486,615,403,1018,+
chr12,7083767,0.4777708800916861,666,486,1152,+
chr12,7083792,1.8682341650671783,720,520,1240,+
chr12,7084397,1.3540791569404,2203,1735,3938,+
chr12,7084398,1.522094156316119,2616,1953,4569,+
chr12,7084867,2.1680780029480085,972,695,1667,+
chr12,7084990,2.1540327471194662,591,484,1075,+
chr12,7172476,3.355294117647059,743,424,1167,+
chr12,7172478,3.355294117647059,743,424,1167,+
chr12,7172547,0.5212863355458915,910,513,1423,+
chr12,7172562,2.0224531024531025,946,692,1638,+
chr12,7172574,0.48909289552534485,2309,1217,3526,+
chr12,7174406,1.932860520094562,583,422,1005,+
chr12,7177187,0.7022186037044575,599,577,1176,+
chr12,7177189,0.7090322580645162,627,599,1226,+
chr12,7177790,8.946345628903927,931,702,1633,+
chr12,7363512,4.595793755775886,1311,128,1439,+
chr12,7363542,93.80062615524288,1763,98,1861,+
chr12,7363543,122.23728813559323,1201,58,1259,+
chr12,7363547,202.49115113539955,4217,618,4835,+
chr12,7363548,202.49115113539955,4217,618,4835,+
chr12,8242865,0.5977170529228641,647,412,1059,+
chr12,8242883,2.1166306695464363,664,462,1126,+
chr12,8242891,2.426465300251708,963,617,1580,+
chr12,10365620,3.166144050433265,732,504,1236,+
chr12,10365708,0.8222722000023389,1617,1023,2640,+
chr12,10365710,1.2518990007904525,2255,1318,3573,+
chr12,10365711,2.2079062957540265,1130,682,1812,+
chr12,10365725,3.0227471566054245,690,380,1070,+
chr12,10365729,2.229271809661139,772,437,1209,+
chr12,10365732,1.534839924670433,814,530,1344,+
chr12,10365738,0.6129478086924895,886,584,1470,+
chr12,10365795,2.004060324825986,690,430,1120,+
chr12,10370681,2.512036843207033,749,561,1310,+
chr12,10370713,1.633459595959596,760,659,1419,+
chr12,10373109,1.6991710014941117,1370,1190,2560,+
chr12,10374498,12.584,967,124,1091,+
chr12,10374499,8.246682743444834,2250,383,2633,+
chr12,10374502,18.745508563809533,3074,682,3756,+
chr12,10374503,17.180633393537924,4091,962,5053,+
chr12,10374504,16.19297389859265,2860,622,3482,+
chr12,10374505,17.939872199487503,1969,483,2452,+
chr12,10374508,3.944520282741537,1798,577,2375,+
chr12,10374513,5.968103448275863,902,289,1191,+
chr12,10374515,3.8121714698784017,2372,883,3255,+
chr12,10374516,3.4926131024839386,1826,722,2548,+
chr12,10374519,6.698275862068967,887,347,1234,+
chr12,10374521,9.788173374613004,1816,968,2784,+
chr12,10374522,7.514760579873603,4949,5339,10288,+
chr12,10374523,6.638731537540763,5435,6053,11488,+
chr12,10374524,6.434834913839483,4990,5875,10865,+
chr12,10374525,3.34812862928805,1347,1862,3209,+
chr12,10374532,6.749761853024612,1705,3003,4708,+
chr12,10374570,0.533963369275918,1560,2173,3733,+
chr12,10374728,0.455524861878453,1066,723,1789,+
chr12,10374851,1.8141354369160068,1591,1080,2671,+
chr12,10374993,0.5962419209861747,994,765,1759,+
chr12,10375034,0.65885523308807,1347,1036,2383,+
chr12,10375419,5.152413793103449,963,579,1542,+
chr12,10375421,2.264897579143389,694,536,1230,+
chr12,10375457,2.2463768115942027,929,557,1486,+
chr12,10375473,0.6281182710992069,1039,576,1615,+
chr12,10375554,12.603483451780006,2106,450,2556,+
chr12,10375555,6.97189422316506,2865,598,3463,+
chr12,10375560,29.352775222662995,8046,5127,13173,+
chr12,10375561,29.352775222662995,8046,5127,13173,+
chr12,10375562,29.352775222662995,8046,5127,13173,+
chr12,10375568,8.21081081081081,619,924,1543,+
chr12,10375633,1.9867102151143148,489,682,1171,+
chr12,11324441,2.0936828672926264,614,388,1002,+
chr12,12874270,37.76142096896814,1054,59,1113,+
chr12,12874271,98.04938271604938,1082,80,1162,+
chr12,12874272,115.71724137931037,1070,173,1243,+
chr12,12874273,45.17223431023775,2105,1143,3248,+
chr12,12874274,39.98507342301308,2097,1437,3534,+
chr12,12874275,31.328902510134984,2054,1660,3714,+
chr12,12874298,2.9181720968111713,847,1249,2096,+
chr12,12874299,2.2317806739779167,817,1373,2190,+
chr12,12874300,0.6080009872951578,877,1767,2644,+
chr12,12874301,0.49671997235423426,869,1607,2476,+
chr12,12874302,0.1546038069942452,507,1003,1510,+
chr12,12874331,0.22126716008982816,742,726,1468,+
chr12,12874376,2.70863490994782,595,456,1051,+
chr12,12875093,1.726218097447796,619,430,1049,+
chr12,12966294,1.1588951934523672,677,569,1246,+
chr12,12967121,0.5454727116702801,1125,733,1858,+
chr12,12974291,3.2051772319458744,680,522,1202,+
chr12,12974293,3.2051772319458744,680,522,1202,+
chr12,12974921,1.986264932050104,1109,712,1821,+
chr12,12974960,2.5969679300291544,1141,685,1826,+
chr12,12974987,0.6304635380722337,2630,1511,4141,+
chr12,12974995,1.5495701019057562,1919,1272,3191,+
chr12,12975001,2.267545393409549,2055,1486,3541,+
chr12,12975009,1.835320150556996,5639,3178,8817,+
chr12,12975011,2.0779728012388747,7992,5077,13069,+
chr12,12975660,2.3528422533036313,868,680,1548,+
chr12,12976193,0.5418973791066813,733,558,1291,+
chr12,12977498,1.6794132029339854,635,408,1043,+
chr12,12982490,0.5846549028367211,697,483,1180,+
chr12,12982719,2.1468926553672314,607,471,1078,+
chr12,12982747,1.9224588188027318,579,523,1102,+
chr12,13044496,1.4406569760956178,1640,1007,2647,+
chr12,13044497,1.4406569760956178,1640,1007,2647,+
chr12,13061620,2.214728727403586,1032,836,1868,+
chr12,13061632,0.5416785206258891,713,569,1282,+
chr12,13065467,2.381851329467582,1250,761,2011,+
chr12,13065517,1.5736608015151203,782,606,1388,+
chr12,13066105,2.328134747348721,621,457,1078,+
chr12,13066165,3.193608672890853,944,704,1648,+
chr12,13066347,1.2040821516619218,1116,899,2015,+
chr12,13066433,2.2655122655122657,784,461,1245,+
chr12,13067213,7.067737761220101,813,601,1414,+
chr12,13067233,1.8842479818500926,1111,954,2065,+
chr12,13067307,0.5322665464653293,544,458,1002,+
chr12,13067408,2.587719298245614,589,436,1025,+
chr12,13067810,1.05294629267232,744,377,1121,+
chr12,13067811,0.7991111963295847,1050,630,1680,+
chr12,13067812,1.05294629267232,744,377,1121,+
chr12,13068173,3.8766207552805034,1061,821,1882,+
chr12,13068741,0.4651936326918507,711,551,1262,+
chr12,13068742,0.4651936326918507,711,551,1262,+
chr12,13068743,0.5058548009367682,575,426,1001,+
chr12,13069051,2.07587890625,732,511,1243,+
chr12,13069115,0.488637105670454,878,603,1481,+
chr12,13069195,3.378339052252096,601,400,1001,+
chr12,13069576,1.6294411076046016,905,626,1531,+
chr12,13069627,2.5170981839553037,804,594,1398,+
chr12,13069935,0.4750490196078432,880,679,1559,+
chr12,13069937,0.4750490196078432,880,679,1559,+
chr12,13070642,0.4163417803768681,698,485,1183,+
chr12,13070785,1.6464665299272794,882,691,1573,+
chr12,14927626,1.9920373434097491,901,537,1438,+
chr12,14927635,2.671881035533753,960,602,1562,+
chr12,14927681,1.7372929430451556,874,677,1551,+
chr12,14927684,1.7840375586854462,778,425,1203,+
chr12,14927699,1.9745604190048633,811,485,1296,+
chr12,14927702,1.5558954393770856,1864,1146,3010,+
chr12,14927703,1.5558954393770856,1864,1146,3010,+
chr12,14927707,2.4111210762331843,1033,668,1701,+
chr12,14927717,1.789528055676381,1218,835,2053,+
chr12,14927734,1.313055726418094,6543,4335,10878,+
chr12,14927735,1.625136915505777,2827,2107,4934,+
chr12,16035414,0.3992063948494066,904,683,1587,+
chr12,16035415,0.3752426975018337,668,472,1140,+
chr12,16035470,0.7776767013367525,811,556,1367,+
chr12,16035482,3.49670510708402,848,606,1454,+
chr12,16035650,0.5042355788624445,624,401,1025,+
chr12,16036598,1.9047438330170776,716,594,1310,+
chr12,16036599,0.5257975260416666,922,767,1689,+
chr12,16047015,2.109469289232475,1114,928,2042,+
chr12,16050869,1.8145925129237068,1136,778,1914,+
chr12,16053932,2.249867629362214,1086,830,1916,+
chr12,16056142,1.4438063986874488,1759,1218,2977,+
chr12,16109887,0.8694881889763779,630,380,1010,+
chr12,16109888,1.0892840975982012,722,437,1159,+
chr12,16189182,2.317996721292347,647,395,1042,+
chr12,16189825,2.5711846800732054,957,642,1599,+
chr12,16189826,3.1474747474747478,778,494,1272,+
chr12,16500585,0.7680038875727835,850,358,1208,+
chr12,16500586,0.7297598147799559,1378,651,2029,+
chr12,16500587,0.740110459317498,1985,998,2983,+
chr12,16500608,1.855134898324267,940,558,1498,+
chr12,16500609,1.8153404064011107,1368,900,2268,+
chr12,16500610,1.8510615069543253,1836,1125,2961,+
chr12,16500611,1.9637462235649543,724,330,1054,+
chr12,16500613,1.4623017001194063,634,408,1042,+
chr12,16500614,2.36096256684492,1765,883,2648,+
chr12,16500615,2.36096256684492,1765,883,2648,+
chr12,16507164,0.4954445563593077,940,651,1591,+
chr12,16507172,2.3256767842493846,944,688,1632,+
chr12,16507175,1.4296128611441508,1241,777,2018,+
chr12,16507179,1.74604702764903,2779,1832,4611,+
chr12,16507181,1.6190586676499703,4263,2912,7175,+
chr12,16507184,1.2527863058141262,3337,2431,5768,+
chr12,16507262,1.433187103272534,11275,8430,19705,+
chr12,16516853,1.2621653252299607,1834,1521,3355,+
chr12,16516960,1.0697340481697262,4924,4053,8977,+
chr12,16516978,1.3691759722757026,2585,2119,4704,+
chr12,19436537,2.4833025261860757,915,540,1455,+
chr12,19436538,2.4833025261860757,915,540,1455,+
chr12,19436544,2.0974057520404195,1052,663,1715,+
chr12,19436546,2.0974057520404195,1052,663,1715,+
chr12,19436557,3.11001386001386,618,443,1061,+
chr12,20790144,1.8448017200191114,690,506,1196,+
chr12,20806993,1.075845974329055,921,856,1777,+
chr12,20806995,1.075845974329055,921,856,1777,+
chr12,20807003,1.9228023203926816,555,497,1052,+
chr12,20807004,0.547008547008547,671,629,1300,+
chr12,20807016,1.697682344921609,878,651,1529,+
chr12,20807025,1.5739509251562451,1732,1603,3335,+
chr12,20807027,1.5637239057746697,2781,2376,5157,+
chr12,20807037,2.8210084033613447,1118,849,1967,+
chr12,20833195,1.729974202488119,766,570,1336,+
chr12,20833493,2.399365354060772,687,478,1165,+
chr12,20833620,3.162779338136524,739,430,1169,+
chr12,20833621,3.162779338136524,739,430,1169,+
chr12,20834048,9.190396880087652,710,438,1148,+
chr12,20834494,4.363636363636363,671,384,1055,+
chr12,20834504,3.4835680751173714,688,425,1113,+
chr12,20834542,3.710762331838565,661,445,1106,+
chr12,20834580,2.399676315886269,1164,876,2040,+
chr12,20834585,2.8327181018935983,2544,2217,4761,+
chr12,20834587,2.8327181018935983,2544,2217,4761,+
chr12,20835684,3.686143572621035,1034,598,1632,+
chr12,20835685,3.686143572621035,1034,598,1632,+
chr12,20836027,2.342647058823529,589,424,1013,+
chr12,20836210,1.545674971206886,592,422,1014,+
chr12,20836263,1.7735294117647058,602,458,1060,+
chr12,20836880,1.8054889421795897,615,416,1031,+
chr12,21661464,1.8893997445721584,568,434,1002,+
chr12,21661479,0.5473372781065089,924,649,1573,+
chr12,21665258,2.435643564356436,819,706,1525,+
chr12,21668607,1.9554242749731472,661,391,1052,+
chr12,21668835,1.9113175675675675,802,591,1393,+
chr12,21669018,1.4603563970200901,990,675,1665,+
chr12,21670109,2.688469601677149,686,476,1162,+
chr12,21670110,2.688469601677149,686,476,1162,+
chr12,21670119,2.5257755603327956,814,575,1389,+
chr12,21670363,1.4682967000908538,848,531,1379,+
chr12,21670638,2.2461556073029407,1386,984,2370,+
chr12,22208162,3.3192023865599,603,578,1181,+
chr12,22208163,3.3192023865599,603,578,1181,+
chr12,22213828,3.4782608695652173,575,459,1034,+
chr12,22213829,3.4782608695652173,575,459,1034,+
chr12,22218479,1.1238095238095238,648,524,1172,+
chr12,22218481,1.1238095238095238,648,524,1172,+
chr12,22840560,2.7434524665834545,845,496,1341,+
chr12,25356891,1.7786346886082343,946,494,1440,+
chr12,25357052,1.606896551724138,931,579,1510,+
chr12,25357079,2.3604494382022474,605,444,1049,+
chr12,26217915,2.985931919236096,930,806,1736,+
chr12,26217917,2.324397325892132,1245,1024,2269,+
chr12,26218165,3.8161177644710578,873,667,1540,+
chr12,27181243,0.9818718015439326,1131,731,1862,+
chr12,27181244,0.9818718015439326,1131,731,1862,+
chr12,27181416,1.0553772618641175,671,504,1175,+
chr12,27181418,1.0553772618641175,671,504,1175,+
chr12,27181443,2.12768296973962,1124,783,1907,+
chr12,27181444,2.1234820928499776,1439,1000,2439,+
chr12,27182386,2.373968855218856,704,451,1155,+
chr12,27182520,3.078323782543394,775,528,1303,+
chr12,27553555,2.191380569758948,674,332,1006,+
chr12,27553556,2.191380569758948,674,332,1006,+
chr12,27553557,2.191380569758948,674,332,1006,+
chr12,27867719,1.3372541077240112,807,600,1407,+
chr12,27867729,0.40732879078949324,622,518,1140,+
chr12,27867746,2.0884117539382436,719,526,1245,+
chr12,27869295,2.4490705177446617,838,565,1403,+
chr12,27869297,2.4490705177446617,838,565,1403,+
chr12,27869298,0.5677217519322783,616,493,1109,+
chr12,27869339,1.9523602033405956,610,404,1014,+
chr12,27872776,0.4238417518095586,810,538,1348,+
chr12,27877059,2.0136521739130435,746,459,1205,+
chr12,27877088,1.955818965517241,604,463,1067,+
chr12,27890513,1.2277918376619175,3895,3100,6995,+
chr12,27908172,1.520943668753009,1052,743,1795,+
chr12,27909020,1.947114577433006,1127,816,1943,+
chr12,27909042,1.7823971693940734,619,475,1094,+
chr12,27909046,0.476044226044226,619,406,1025,+
chr12,27909094,1.9148514851485148,966,706,1672,+
chr12,27909095,1.9148514851485148,966,706,1672,+
chr12,32884056,4.214033529784,798,650,1448,+
chr12,32884058,3.300237650334573,828,662,1490,+
chr12,32898233,0.8078946143462271,804,582,1386,+
chr12,32898234,0.3009092041350106,603,433,1036,+
chr12,42787399,2.0417024029888444,698,508,1206,+
chr12,42787475,1.3524347862096207,901,615,1516,+
chr12,42835224,1.822567783094099,652,395,1047,+
chr12,42835240,2.2545863031904374,1899,1522,3421,+
chr12,42835241,2.185799763605341,2568,2110,4678,+
chr12,42835242,2.185799763605341,2568,2110,4678,+
chr12,42835243,2.0937178848926927,3459,2793,6252,+
chr12,42835245,1.8714038321881457,2143,1988,4131,+
chr12,42835247,1.9089458128078818,2252,2174,4426,+
chr12,42835249,1.8575903754805947,2452,2125,4577,+
chr12,45823176,1.8427350970084384,3572,2276,5848,+
chr12,45823240,3.7387692010433775,1547,940,2487,+
chr12,48357407,1.450094043882095,981,607,1588,+
chr12,48358029,1.6361050760418727,1592,829,2421,+
chr12,48358031,1.6361050760418727,1592,829,2421,+
chr12,48358071,1.484113712374582,709,597,1306,+
chr12,48358074,1.732394366197183,1139,709,1848,+
chr12,48358113,2.057450331125828,866,754,1620,+
chr12,48359624,1.653112968353836,1466,925,2391,+
chr12,48359895,1.3889115952098745,1969,1137,3106,+
chr12,48359918,1.3956583921818317,3416,2305,5721,+
chr12,48361010,1.8116814159292036,852,564,1416,+
chr12,48361926,1.4182302850796005,1450,924,2374,+
chr12,48361927,1.9014539579967689,855,618,1473,+
chr12,48362126,1.7354852232236428,1241,733,1974,+
chr12,48362130,1.5313353454824619,2096,1337,3433,+
chr12,48362137,1.6146782727427889,1411,836,2247,+
chr12,48362198,2.9875269848884622,939,757,1696,+
chr12,48362238,1.4812587023113335,1307,1196,2503,+
chr12,48362432,0.6779188948306595,1216,917,2133,+
chr12,48513141,1.177048332902559,689,529,1218,+
chr12,48513143,1.177048332902559,689,529,1218,+
chr12,48513151,2.069982198486872,609,641,1250,+
chr12,48513153,2.069982198486872,609,641,1250,+
chr12,48525132,1.0807267025331857,974,786,1760,+
chr12,48525134,1.3359764479002112,1496,1233,2729,+
chr12,48525135,1.8860132134110308,2117,1689,3806,+
chr12,48526756,1.8528951486697964,591,425,1016,+
chr12,48526779,1.7723076923076924,683,493,1176,+
chr12,48527133,1.7704128440366973,746,544,1290,+
chr12,48527138,3.887330316742082,780,509,1289,+
chr12,48528525,1.970858134920635,690,383,1073,+
chr12,48528728,2.389426837877162,1118,735,1853,+
chr12,48533072,1.832461873638344,646,458,1104,+
chr12,48533667,1.9929470757267087,907,718,1625,+
chr12,48535147,0.2934782608695652,689,459,1148,+
chr12,48535155,1.6546762589928057,827,555,1382,+
chr12,48535574,1.8022801713277905,922,587,1509,+
chr12,48536691,2.1997095391590804,1241,762,2003,+
chr12,48536692,2.062130796062419,1801,1167,2968,+
chr12,48537559,1.3648683531233867,704,595,1299,+
chr12,48537560,1.3648683531233867,704,595,1299,+
chr12,48537566,1.6840197110935873,1523,1384,2907,+
chr12,48537568,1.080152671755725,1131,1047,2178,+
chr12,48538837,0.48664232173745925,632,472,1104,+
chr12,48538839,0.5348314606741573,611,444,1055,+
chr12,48538852,1.6229923922231615,575,506,1081,+
chr12,48538853,2.0097642269189735,1073,832,1905,+
chr12,48539014,0.6299751243781094,1012,623,1635,+
chr12,48539042,0.3966551893753074,671,534,1205,+
chr12,48539351,2.449812454212454,913,712,1625,+
chr12,48539394,2.151159951159951,765,584,1349,+
chr12,48539396,2.057032171201529,1416,1049,2465,+
chr12,48539478,2.4042882793882576,725,568,1293,+
chr12,48539512,0.4390415785764623,622,472,1094,+
chr12,48539544,0.555282590701975,1756,1181,2937,+
chr12,48539578,1.640457733480989,1009,644,1653,+
chr12,48539595,1.52075725542956,1054,725,1779,+
chr12,48539661,6.750608363265376,4369,3256,7625,+
chr12,48539662,6.750608363265376,4369,3256,7625,+
chr12,48539677,1.6659556313993171,780,585,1365,+
chr12,48539704,1.1543402733098285,1294,1002,2296,+
chr12,48539805,1.5646630236794177,858,548,1406,+
chr12,49658863,0.921894186175427,5177,2240,7417,+
chr12,49658864,0.9108178321032665,6684,2801,9485,+
chr12,49658867,3.4483933787731256,1573,631,2204,+
chr12,49658883,2.489177489177489,1724,769,2493,+
chr12,49658889,2.227832512315271,1875,927,2802,+
chr12,49658904,2.472222646899218,9778,5579,15357,+
chr12,49663340,2.2946564885496183,834,392,1226,+
chr12,49663347,2.06235238545111,887,437,1324,+
chr12,49663354,1.7481146929642828,2057,1096,3153,+
chr12,49663356,1.7481146929642828,2057,1096,3153,+
chr12,49663358,1.4192439862542956,1189,969,2158,+
chr12,49663359,1.9287634408602152,1434,774,2208,+
chr12,49663361,1.8815749579646992,2525,1816,4341,+
chr12,49663377,1.579304778533152,3756,2550,6306,+
chr12,49663378,1.9428428595234126,1571,1058,2629,+
chr12,49663380,1.330412200361223,2393,1365,3758,+
chr12,49663382,1.37638760833487,1842,1275,3117,+
chr12,49663455,1.1154859901458511,5849,3508,9357,+
chr12,49663614,1.5739236978666151,2673,1891,4564,+
chr12,49666133,1.4785867237687365,1380,933,2313,+
chr12,49666146,1.432368538820104,4458,3051,7509,+
chr12,49666510,1.146816465239727,1515,766,2281,+
chr12,49666511,1.5533200799673774,1931,914,2845,+
chr12,49666513,1.5083844011085419,1680,902,2582,+
chr12,49666526,0.5002477564279029,648,442,1090,+
chr12,49666569,1.6204369224232555,1867,925,2792,+
chr12,49666590,1.700808913308913,2370,1247,3617,+
chr12,49666612,2.102518936057777,2237,1621,3858,+
chr12,49666722,2.171511207519884,1876,1382,3258,+
chr12,49666724,0.7258551307847082,2404,2029,4433,+
chr12,49666797,1.4688405584989606,2894,1613,4507,+
chr12,49666900,1.950418286791564,1426,942,2368,+
chr12,49666903,1.7480438618387408,7138,5310,12448,+
chr12,49666970,1.6331331201343053,5733,4943,10676,+
chr12,49667004,1.0103172551798891,8327,5779,14106,+
chr12,49667005,1.1042143738973296,11639,8843,20482,+
chr12,49717054,0.7231033166627525,1029,729,1758,+
chr12,49717087,0.8063268987193525,1773,973,2746,+
chr12,49717088,0.8899660461304297,1225,656,1881,+
chr12,49717453,2.087999037999038,924,770,1694,+
chr12,49717525,1.881811361931392,672,472,1144,+
chr12,49717637,1.8912488800378309,1089,824,1913,+
chr12,49718032,2.5633738613113572,740,615,1355,+
chr12,49854621,2.19435736677116,699,318,1017,+
chr12,49854708,1.7719665271966527,1088,716,1804,+
chr12,49854711,0.6062301483229886,1485,836,2321,+
chr12,49854712,1.441949217498183,3216,2283,5499,+
chr12,49854728,1.6217317487266558,1591,1177,2768,+
chr12,49854732,1.341543053545586,3573,2763,6336,+
chr12,49854733,1.3612094347567316,5934,4234,10168,+
chr12,50135337,1.077892051343379,1169,1016,2185,+
chr12,50135338,0.8613723306116278,1995,982,2977,+
chr12,50135339,0.9780943110523823,2698,1727,4425,+
chr12,50135344,1.874673910120216,1531,721,2252,+
chr12,50135351,1.4479900288813987,3757,1888,5645,+
chr12,50135352,1.747491638795987,1044,597,1641,+
chr12,50135353,1.4479900288813987,3757,1888,5645,+
chr12,50135355,1.720412682979528,1364,1088,2452,+
chr12,50135356,1.3105484527466564,4008,2265,6273,+
chr12,50135388,1.3938294010889292,2327,1842,4169,+
chr12,50146295,0.8120249853841657,4094,2825,6919,+
chr12,50152197,1.3965887051707702,2904,2097,5001,+
chr12,50152203,0.8508549597556904,3621,2788,6409,+
chr12,50152471,1.3424221968945989,11789,8792,20581,+
chr12,50152516,0.8254022678846954,4931,3683,8614,+
chr12,50153070,1.3944455231021404,7181,4666,11847,+
chr12,50156916,1.4787797588374727,1938,1564,3502,+
chr12,50157030,1.537548742258582,1595,1188,2783,+
chr12,50157129,1.6266997815824702,2337,1493,3830,+
chr12,50157280,1.498468973123585,2128,1497,3625,+
chr12,50157374,0.791367224642328,3111,2205,5316,+
chr12,50157510,1.4223338348839014,7597,5777,13374,+
chr12,50157511,1.4134498062999634,11069,7849,18918,+
chr12,50157514,1.399616146800443,4230,3372,7602,+
chr12,50157643,1.7003835582373388,5398,4162,9560,+
chr12,50158006,1.3681494190344674,1581,1038,2619,+
chr12,50158038,2.097718969092525,1685,1234,2919,+
chr12,50158049,1.7087994989609134,1714,1300,3014,+
chr12,50158310,1.6980108831531728,2029,1510,3539,+
chr12,50158339,1.3188864296302312,3006,2034,5040,+
chr12,50158517,1.7937927478015416,2462,1463,3925,+
chr12,50158518,1.7937927478015416,2462,1463,3925,+
chr12,50158519,1.056858348219376,1208,950,2158,+
chr12,50158520,0.6799782690252634,3340,2552,5892,+
chr12,50158521,0.8620136814542004,2424,2030,4454,+
chr12,50158543,1.657066403774382,1960,1290,3250,+
chr12,50158571,1.2929936305732483,3002,2040,5042,+
chr12,50158595,1.5830977533105193,2431,2067,4498,+
chr12,50480408,0.8600502289731682,645,507,1152,+
chr12,50494048,7.313840961510843,1124,770,1894,+
chr12,50494049,5.231458832277085,863,572,1435,+
chr12,50494050,7.778938315918396,868,600,1468,+
chr12,50506016,0.5394748313868435,1088,518,1606,+
chr12,50506018,0.7197016320539272,1535,896,2431,+
chr12,50506047,1.5914512156823852,744,546,1290,+
chr12,50513832,1.720253164556962,754,473,1227,+
chr12,50513851,1.7306992891387003,721,525,1246,+
chr12,50513859,1.9240874215298767,612,505,1117,+
chr12,50513929,1.956296296296296,555,449,1004,+
chr12,50513932,1.7880174291938995,565,458,1023,+
chr12,50513934,0.627049782172402,914,658,1572,+
chr12,50513969,2.25342743571023,816,586,1402,+
chr12,50514067,1.9188326493388053,2103,1461,3564,+
chr12,50514068,1.9188326493388053,2103,1461,3564,+
chr12,50514118,2.9400837257980115,660,587,1247,+
chr12,50831595,2.565209161461291,846,586,1432,+
chr12,50831596,2.565209161461291,846,586,1432,+
chr12,50847424,0.8040681685322832,651,517,1168,+
chr12,50850444,0.5150399520030543,993,718,1711,+
chr12,50869645,0.5798728694937161,709,525,1234,+
chr12,50869646,0.4926016926016927,693,494,1187,+
chr12,50869647,0.4926016926016927,693,494,1187,+
chr12,50870648,3.010283687943262,652,469,1121,+
chr12,50870649,3.010283687943262,652,469,1121,+
chr12,50870922,3.9412345788218404,610,441,1051,+
chr12,50871665,2.672854785478548,626,403,1029,+
chr12,50871666,2.672854785478548,626,403,1029,+
chr12,50872042,3.0923415756263712,899,644,1543,+
chr12,51157922,0.2298611111111111,992,479,1471,+
chr12,51157923,0.9679442444981003,976,490,1466,+
chr12,51157978,1.2689129052765418,997,285,1282,+
chr12,51157979,1.2689129052765418,997,285,1282,+
chr12,51158007,2.248632205927432,4335,1298,5633,+
chr12,51158009,2.2069556442451015,3216,936,4152,+
chr12,51158013,2.311886174767061,2134,721,2855,+
chr12,51158014,2.6064174443249546,3530,1100,4630,+
chr12,51158016,2.1945195041249383,6960,2310,9270,+
chr12,51158017,2.1928383231684743,10810,3820,14630,+
chr12,51158018,2.0050815960873365,14488,5282,19770,+
chr12,51158019,1.7865555677912528,12603,4802,17405,+
chr12,51158020,1.8179594469974294,15203,6004,21207,+
chr12,51158021,1.6938657114297553,10822,4274,15096,+
chr12,51158022,1.8663622902270485,2749,1012,3761,+
chr12,51158026,1.7852620355370787,3248,1453,4701,+
chr12,51158029,2.1601336807152847,3320,1546,4866,+
chr12,51158032,1.6642471171828175,3932,1967,5899,+
chr12,51158043,6.108578513642776,20657,14802,35459,+
chr12,51158044,5.695104507296504,28264,23656,51920,+
chr12,51158045,5.115394407590109,33309,29584,62893,+
chr12,51158046,4.676994585214002,26739,25884,52623,+
chr12,51158047,3.8843162835346616,16651,17421,34072,+
chr12,51158049,3.620888900807438,16158,22531,38689,+
chr12,51158050,3.167627616974493,22344,47299,69643,+
chr12,51158051,3.0413857357978986,31867,61102,92969,+
chr12,51158052,3.1967588735964143,26770,55622,82392,+
chr12,51173941,1.545134818288394,658,852,1510,+
chr12,51173943,1.7268727373990531,837,664,1501,+
chr12,51173946,1.6776251226692838,788,1018,1806,+
chr12,51203242,2.330131004366812,666,457,1123,+
chr12,51203260,1.5052166791297228,1030,758,1788,+
chr12,51203278,1.5925,727,639,1366,+
chr12,51207899,1.6051178143076572,1044,826,1870,+
chr12,51208089,1.6820871884637825,1008,773,1781,+
chr12,51208145,1.828414010232192,807,725,1532,+
chr12,51213540,2.023602484472049,1085,804,1889,+
chr12,51213706,2.458864795918368,700,587,1287,+
chr12,51213848,0.7123287671232876,1143,802,1945,+
chr12,51214431,2.2900485436893203,628,411,1039,+
chr12,51214571,1.81234096692112,813,654,1467,+
chr12,51442834,2.163285369597657,719,540,1259,+
chr12,51442846,2.1636001770804025,872,600,1472,+
chr12,51442926,0.6117684939225629,799,605,1404,+
chr12,51450159,1.8961456821987979,963,739,1702,+
chr12,51450279,1.6604494638375542,676,486,1162,+
chr12,51451905,3.249110699327246,1050,658,1708,+
chr12,51453211,1.832967032967033,555,454,1009,+
chr12,51453215,1.9245135366257453,1257,861,2118,+
chr12,51453404,1.1535845466874821,1012,885,1897,+
chr12,51453459,1.955851522999137,609,476,1085,+
chr12,51453466,1.5332482993197276,948,734,1682,+
chr12,51453493,0.492439184746877,534,506,1040,+
chr12,51453795,0.6437869822485207,1155,883,2038,+
chr12,51453944,0.6044083237234775,1568,1177,2745,+
chr12,51453974,0.486470051687443,639,428,1067,+
chr12,51453979,0.589603055970769,709,445,1154,+
chr12,51454017,1.9176515908042506,5125,2885,8010,+
chr12,51632612,0.750877175897168,728,505,1233,+
chr12,51632617,2.687866661189089,729,442,1171,+
chr12,51632644,1.9391251746328872,1190,879,2069,+
chr12,51632647,0.3167951726449882,1133,941,2074,+
chr12,51632648,0.3167951726449882,1133,941,2074,+
chr12,51634129,1.0625446591323369,1517,1054,2571,+
chr12,51634130,1.0625446591323369,1517,1054,2571,+
chr12,51634175,1.5622158300083513,1402,828,2230,+
chr12,51634178,2.0326797385620914,932,730,1662,+
chr12,51634658,1.7561581920903957,817,707,1524,+
chr12,51634737,1.431982313927782,1040,689,1729,+
chr12,51634741,1.742427786223833,692,502,1194,+
chr12,51634778,1.8432207553968616,1562,1245,2807,+
chr12,51634779,1.8432207553968616,1562,1245,2807,+
chr12,51634864,1.4276563744135145,2157,1395,3552,+
chr12,51634891,2.0390081348622955,742,536,1278,+
chr12,51636265,2.3994017068632827,1315,1019,2334,+
chr12,51636335,0.6222127890386406,1551,1046,2597,+
chr12,51636732,1.6371729161046669,1155,673,1828,+
chr12,51636789,1.6002140754616,909,706,1615,+
chr12,51636828,2.2200038767202948,880,736,1616,+
chr12,51636846,1.8152812762384551,919,793,1712,+
chr12,51636894,1.823996221067548,897,729,1626,+
chr12,51636899,0.7290759554910498,1506,1130,2636,+
chr12,51636964,2.380202474690664,1103,888,1991,+
chr12,51637015,1.9853407723443828,1046,830,1876,+
chr12,51637222,1.8098415346121766,929,762,1691,+
chr12,51637394,1.5964276273554625,1690,1260,2950,+
chr12,51637395,1.5639187987028897,3103,2143,5246,+
chr12,52445224,1.0073099097611735,1017,1833,2850,+
chr12,52448736,3.9749822797329597,642,461,1103,+
chr12,52448782,1.703090242669363,578,454,1032,+
chr12,52450418,2.417069701280228,707,369,1076,+
chr12,52450420,2.417069701280228,707,369,1076,+
chr12,52452648,1.9151382243487503,1252,1367,2619,+
chr12,52452650,2.100819671999563,2499,2655,5154,+
chr12,52452651,2.214003726335813,1353,1632,2985,+
chr12,52452654,1.4061393152302244,793,725,1518,+
chr12,52452705,1.2392803718476033,738,623,1361,+
chr12,52453076,5.115315934065935,918,538,1456,+
chr12,52453080,13.501903367317777,1227,895,2122,+
chr12,52463859,12.132275155143791,1594,1237,2831,+
chr12,52463860,12.132275155143791,1594,1237,2831,+
chr12,52463865,0.5628114953365367,1062,1123,2185,+
chr12,52464144,3.78679706601467,703,408,1111,+
chr12,52464146,3.437582459720252,957,580,1537,+
chr12,52464216,4.47260713745324,1057,861,1918,+
chr12,52467486,5.272857792122394,1057,534,1591,+
chr12,52467489,10.720496331344233,774,534,1308,+
chr12,52467492,7.942735289361284,774,680,1454,+
chr12,52470982,1.6363425850603186,591,431,1022,+
chr12,52471145,1.816326861019035,1225,899,2124,+
chr12,52627026,0.7601746532850253,926,481,1407,+
chr12,52627040,2.069380166923777,1188,476,1664,+
chr12,52627042,2.477116476772664,1471,698,2169,+
chr12,52627057,2.0129154795821464,756,350,1106,+
chr12,52627080,2.1644374366343824,1387,869,2256,+
chr12,52627090,0.5610128400826075,780,517,1297,+
chr12,52627103,1.7241632413388135,782,523,1305,+
chr12,52627235,2.017568827599745,1141,496,1637,+
chr12,52627236,2.017568827599745,1141,496,1637,+
chr12,52627239,1.856319588205673,1251,585,1836,+
chr12,52627240,1.856319588205673,1251,585,1836,+
chr12,52627275,1.6631090487238978,783,430,1213,+
chr12,52627276,1.551066847296897,1450,1026,2476,+
chr12,52627278,1.5396611310009165,2101,1439,3540,+
chr12,52627281,1.226458463648627,1029,766,1795,+
chr12,52627288,1.0359677716430014,2372,1810,4182,+
chr12,52627290,1.053545503307706,3167,1597,4764,+
chr12,52627291,1.053545503307706,3167,1597,4764,+
chr12,52627360,0.748191027496382,845,690,1535,+
chr12,52627374,0.5657979082321187,1368,1039,2407,+
chr12,52627377,0.6725021349274124,1574,1170,2744,+
chr12,52628957,1.3751762182041067,1703,1254,2957,+
chr12,52629035,1.683150725496002,2087,1227,3314,+
chr12,52629142,0.5838359469240049,1011,828,1839,+
chr12,52631294,1.9214206845785793,1181,987,2168,+
chr12,52631301,1.0746544519447123,4042,2651,6693,+
chr12,52631302,1.1648733257916097,6362,4244,10606,+
chr12,52632518,1.768196952100452,4031,2905,6936,+
chr12,52632521,1.4082777365797832,4669,3257,7926,+
chr12,52635283,1.3431409936091312,2652,1617,4269,+
chr12,52635294,1.315363161642535,2061,1531,3592,+
chr12,52636858,2.1393848729807994,1900,1486,3386,+
chr12,52636912,1.5269505586726133,1480,1323,2803,+
chr12,52636913,1.6686798351570271,1829,1361,3190,+
chr12,52639307,1.659592529711375,1172,911,2083,+
chr12,52639308,1.4212767097440422,3992,2537,6529,+
chr12,52639309,1.7025763793889648,2986,1719,4705,+
chr12,52639310,1.6531054823039557,1291,1047,2338,+
chr12,52639327,0.6668990833213708,2709,2045,4754,+
chr12,52639329,0.6668990833213708,2709,2045,4754,+
chr12,52639340,1.5696013722638622,1856,1276,3132,+
chr12,52641986,1.4405286343612334,1416,907,2323,+
chr12,52642374,0.7548725637181408,1557,942,2499,+
chr12,52642397,1.474301242236025,1116,965,2081,+
chr12,52642436,1.6240601503759398,1295,740,2035,+
chr12,52642445,1.537819136244333,1288,761,2049,+
chr12,52642496,1.6633815999559545,1161,885,2046,+
chr12,52642574,1.839002267573696,810,636,1446,+
chr12,52642578,2.8303495311167945,1244,764,2008,+
chr12,52642587,1.5473799275807882,780,713,1493,+
chr12,52642594,1.5667538192775323,1908,1272,3180,+
chr12,53342904,0.487833908831676,4050,2844,6894,+
chr12,53342918,1.111872146118721,973,656,1629,+
chr12,53342919,1.111872146118721,973,656,1629,+
chr12,53342942,1.7778685570106936,1297,1014,2311,+
chr12,53343043,3.442127965492452,854,534,1388,+
chr12,53343059,2.1650874946649594,2237,1064,3301,+
chr12,53343061,1.6619978758082437,3800,1917,5717,+
chr12,53343063,1.675813815724124,4293,2598,6891,+
chr12,53343090,1.858499234303216,1311,652,1963,+
chr12,53343113,0.5828810020876826,1395,957,2352,+
chr12,53343140,4.554103539886551,1474,732,2206,+
chr12,53343154,1.8508090614886732,930,720,1650,+
chr12,53343164,10.29754037409815,6019,4952,10971,+
chr12,53343165,9.877314942766125,7593,5927,13520,+
chr12,53343189,0.9069449832202523,2138,2061,4199,+
chr12,53343308,2.385884509624198,1506,1090,2596,+
chr12,53343309,1.7917047084909352,2168,1352,3520,+
chr12,53343344,1.7436792898977773,2083,1616,3699,+
chr12,53344115,0.8023327604108322,6833,5009,11842,+
chr12,53344151,1.3707717605431249,2715,1788,4503,+
chr12,53344580,1.255213768776987,3462,2174,5636,+
chr12,53345268,0.7666392153926782,4607,3248,7855,+
chr12,53345286,1.250496962141328,8839,5572,14411,+
chr12,53345333,1.2874418133980976,7269,5367,12636,+
chr12,53345345,1.0147718073055558,30626,19366,49992,+
chr12,53345346,1.075885692348306,35545,22222,57767,+
chr12,53345370,0.8897893323975153,10791,5880,16671,+
chr12,53345390,1.4590185156628517,86483,54021,140504,+
chr12,53345391,1.4590185156628515,86483,54021,140504,+
chr12,53345512,0.8412950783558241,850,637,1487,+
chr12,53345513,0.796276485742906,1017,770,1787,+
chr12,53345915,2.0137208646755598,3810,2492,6302,+
chr12,53346038,1.5365673479438562,1715,1440,3155,+
chr12,53346055,1.659189295552932,1053,692,1745,+
chr12,53346079,1.6797647842485652,2441,1491,3932,+
chr12,53346088,1.1971519446900665,4153,2614,6767,+
chr12,53346089,1.056338028169014,2391,1632,4023,+
chr12,53346107,1.298114452145261,8276,5876,14152,+
chr12,53346108,1.2789119742499844,4580,2788,7368,+
chr12,53346123,1.4375388151440907,8683,6724,15407,+
chr12,53400239,0.8326141408546643,1234,395,1629,+
chr12,53410329,1.7257275167078885,862,612,1474,+
chr12,53410331,1.8314181248367718,934,546,1480,+
chr12,53410333,2.037735849056604,1475,614,2089,+
chr12,53410336,2.112981630319004,2605,1349,3954,+
chr12,53410341,1.5613736628124912,1804,877,2681,+
chr12,53410347,1.891841696011732,3430,2125,5555,+
chr12,53410348,0.7468149658836268,1944,1470,3414,+
chr12,53410365,1.3473275993173257,2070,1425,3495,+
chr12,53412702,1.45378916854553,1273,1054,2327,+
chr12,53412703,1.502557134307453,1977,1375,3352,+
chr12,53412713,1.9862637362637363,722,363,1085,+
chr12,53412723,1.9962406015037597,530,474,1004,+
chr12,53412729,0.9805949676395722,2043,1507,3550,+
chr12,53412732,0.5136898850900837,1206,1006,2212,+
chr12,53412786,1.2465132781281945,5421,4023,9444,+
chr12,53413759,0.7504633204633204,2925,1812,4737,+
chr12,53413802,1.6211814823802202,3757,2535,6292,+
chr12,53421617,11.060048674715292,7352,4467,11819,+
chr12,53421618,11.757053414732153,9581,5831,15412,+
chr12,53421625,11.664204557199836,8664,5738,14402,+
chr12,53421824,0.6624035652760093,1414,1351,2765,+
chr12,53421855,2.5788195621695422,2287,1788,4075,+
chr12,53421949,1.3714430995633011,3526,2133,5659,+
chr12,53427617,1.2887579030558485,5590,4263,9853,+
chr12,53427725,1.845164173863074,1992,1026,3018,+
chr12,53427731,1.528164435185308,3655,2430,6085,+
chr12,53427733,1.5175240810932993,5537,3724,9261,+
chr12,53427734,1.475720489538097,3737,2532,6269,+
chr12,53427737,1.299642019682045,8935,6477,15412,+
chr12,53427739,1.299642019682045,8935,6477,15412,+
chr12,53427740,1.6234111107176996,1833,1388,3221,+
chr12,53427751,1.414191071210591,2381,1857,4238,+
chr12,53427760,1.5227399442453204,2685,2294,4979,+
chr12,53427765,1.6318850496065682,3059,2685,5744,+
chr12,53428446,1.5424683953041922,3352,1837,5189,+
chr12,53428456,1.5930762222897057,2927,2135,5062,+
chr12,53431319,1.5652674552496595,786,465,1251,+
chr12,53431327,1.5443803821890596,3921,2097,6018,+
chr12,53431328,1.2061938832772163,2022,989,3011,+
chr12,53431331,1.6433328170977233,1178,586,1764,+
chr12,53431339,1.837160751565762,2639,1436,4075,+
chr12,53431340,1.7415524942050016,4076,2257,6333,+
chr12,53431342,1.642257115944269,4152,2362,6514,+
chr12,53431346,1.4829503522900562,4759,3242,8001,+
chr12,53431347,1.2346582164626985,4908,3639,8547,+
chr12,53431353,1.6336022915809922,2399,1453,3852,+
chr12,53431372,1.4198738227372152,2755,2067,4822,+
chr12,53433020,0.6844988552033041,734,524,1258,+
chr12,53434032,2.893725992317542,903,425,1328,+
chr12,53434052,1.7806980656013456,940,655,1595,+
chr12,53434063,1.7302713047393898,2029,1268,3297,+
chr12,53434064,1.5324875305450094,4916,3425,8341,+
chr12,53434068,1.435740731469381,2312,1688,4000,+
chr12,53434075,2.022360444059523,1426,976,2402,+
chr12,53434082,1.4566099523029827,2211,1276,3487,+
chr12,53434092,1.4251172825349883,8179,5044,13223,+
chr12,53434094,1.4045862952680233,6189,3591,9780,+
chr12,53434095,1.3282810499359794,2242,1703,3945,+
chr12,53434207,1.604319627998042,2016,1361,3377,+
chr12,53434316,0.5099820744437805,1706,1236,2942,+
chr12,53434372,5.590600543260949,11243,7775,19018,+
chr12,53434375,5.152189410566224,11321,8792,20113,+
chr12,53434580,1.4385007517261608,7290,4850,12140,+
chr12,53434581,1.4385007517261608,7290,4850,12140,+
chr12,53434661,1.4890756302521009,885,594,1479,+
chr12,53434677,1.5075406831869538,2674,1639,4313,+
chr12,53434759,1.6898020798389797,1736,1083,2819,+
chr12,53434794,1.4929464805119257,2932,1718,4650,+
chr12,53434795,0.85156015580912,4686,3394,8080,+
chr12,53434962,1.4249358253440718,3294,2388,5682,+
chr12,53435040,1.4959173908344219,6738,4647,11385,+
chr12,53435167,1.618989154900757,4084,2564,6648,+
chr12,53435366,1.6931009253281688,2137,1548,3685,+
chr12,53435553,1.76039119804401,719,408,1127,+
chr12,53435577,1.4126274107208332,1375,1048,2423,+
chr12,53435596,1.4933644777427042,2684,1527,4211,+
chr12,53435608,1.6355585186959856,3274,1977,5251,+
chr12,53435615,1.5979993281009335,3016,2215,5231,+
chr12,53435618,1.5139283230139455,1561,1270,2831,+
chr12,53435622,1.4344505454009433,2638,1695,4333,+
chr12,53435625,1.6203161592505857,2024,1463,3487,+
chr12,53574547,4.607209005850615,693,397,1090,+
chr12,53574548,4.607209005850615,693,397,1090,+
chr12,53574557,4.083203899682339,847,614,1461,+
chr12,53574558,4.083203899682339,847,614,1461,+
chr12,53574566,7.311712796553077,1432,1124,2556,+
chr12,53574567,8.450627810852724,1920,1640,3560,+
chr12,53574568,8.450627810852724,1920,1640,3560,+
chr12,53574576,4.032286972503288,1098,1221,2319,+
chr12,53580258,1.7839938625496583,1774,1323,3097,+
chr12,53580259,1.7514863780730383,2426,1856,4282,+
chr12,53580260,1.2468739667244142,4369,2804,7173,+
chr12,53580261,1.2114194842692583,3521,2269,5790,+
chr12,53583826,8.237441672220484,369,810,1179,+
chr12,53689325,0.8239440006190412,3608,2140,5748,+
chr12,53689327,0.8072598145590847,1022,739,1761,+
chr12,53689331,0.733668041360349,1472,857,2329,+
chr12,53689334,1.4307885306966555,3944,2244,6188,+
chr12,53689341,1.442916098204529,5850,3825,9675,+
chr12,53689348,1.3655401202571014,2135,1091,3226,+
chr12,53689351,1.519531491597177,4800,2833,7633,+
chr12,53689360,1.2835814370341223,2935,1954,4889,+
chr12,53689362,1.3243577736151997,2889,1615,4504,+
chr12,53689367,1.60526042747458,2133,1951,4084,+
chr12,53689395,1.4479822098045645,3876,2418,6294,+
chr12,53691827,0.66253594158793,712,454,1166,+
chr12,53691892,1.2596274329686958,7819,5557,13376,+
chr12,53693139,1.4536749613386162,4656,3390,8046,+
chr12,53808313,13.789941941475343,726,542,1268,+
chr12,53835521,1.1010427542216499,1295,712,2007,+
chr12,53835522,1.0107046221149878,1596,902,2498,+
chr12,53835523,1.1177337520174664,1747,992,2739,+
chr12,53835524,1.3969241343758054,796,514,1310,+
chr12,53835543,1.8721379994552985,1136,851,1987,+
chr12,53835545,1.7267773425179291,1649,1206,2855,+
chr12,53837536,1.813771347764604,793,633,1426,+
chr12,53837537,1.7554157931516423,627,476,1103,+
chr12,53839972,2.9192982456140357,639,474,1113,+
chr12,53839999,1.8787733843537415,666,447,1113,+
chr12,53840006,2.292834890965732,735,534,1269,+
chr12,53840033,1.1119627271873724,1663,1239,2902,+
chr12,53840158,2.4023419203747074,668,426,1094,+
chr12,53840160,2.886067708333333,681,383,1064,+
chr12,53846128,1.5787773558803186,941,654,1595,+
chr12,53846130,1.4008215962441315,650,425,1075,+
chr12,53846134,1.1965520659967281,1752,1337,3089,+
chr12,53846136,0.9414731844818632,1001,792,1793,+
chr12,53848517,2.645422088460063,1600,1026,2626,+
chr12,53848518,2.143075117370892,960,709,1669,+
chr12,53848561,1.6924844404428137,3907,3114,7021,+
chr12,53848569,1.356513455584663,2559,1614,4173,+
chr12,53849139,1.3017864923747278,3200,2039,5239,+
chr12,53849140,1.7623734845957069,2880,2429,5309,+
chr12,53849249,0.9165890132881125,9541,7454,16995,+
chr12,53849250,1.210415701616202,13175,10581,23756,+
chr12,53849255,1.502064498050883,3796,3621,7417,+
chr12,53849713,1.3350796110646352,5309,4107,9416,+
chr12,53853129,1.8846925948856492,3463,1955,5418,+
chr12,53854878,1.452259707192871,1858,1570,3428,+
chr12,53854910,0.6405117602596594,1986,1665,3651,+
chr12,53856337,1.3115237103165522,3838,2616,6454,+
chr12,53858604,0.9502755065766085,1832,1391,3223,+
chr12,53858606,1.2906447578176947,3070,2096,5166,+
chr12,53858632,1.5141114776748645,2756,1822,4578,+
chr12,53859724,0.661469006147541,2546,1951,4497,+
chr12,53861041,1.0742543745944944,5706,4401,10107,+
chr12,53865434,1.2207518796992478,4058,2974,7032,+
chr12,53865550,0.508450306460738,1738,1139,2877,+
chr12,53865570,1.914679207255627,911,457,1368,+
chr12,53865576,1.6449001618996222,1015,544,1559,+
chr12,53865578,1.638048812839899,1050,717,1767,+
chr12,53865579,1.6440062272963156,1079,614,1693,+
chr12,53865584,2.769989047097481,1123,663,1786,+
chr12,53873217,1.819791269538696,1440,975,2415,+
chr12,53873224,1.537299759524991,3689,2586,6275,+
chr12,53873227,1.2809173281090191,2279,1476,3755,+
chr12,53873234,1.3072400200072054,2727,1820,4547,+
chr12,53873274,1.6551324200913238,3045,2189,5234,+
chr12,53873275,1.4740374301417916,6189,4976,11165,+
chr12,53873460,1.6165276329509906,1695,1095,2790,+
chr12,53873461,1.6795917285339759,3151,2128,5279,+
chr12,53873462,1.7834428945540053,2981,2078,5059,+
chr12,53873463,1.4983038429308349,3608,2518,6126,+
chr12,53873464,1.4977869567194417,3046,2160,5206,+
chr12,53873472,1.132736518039307,1315,1086,2401,+
chr12,53873484,2.0800320586214798,981,793,1774,+
chr12,53873486,1.4837712519319937,1279,1293,2572,+
chr12,53873493,0.7004558558302683,1297,1050,2347,+
chr12,53873498,1.450982425389088,6929,6782,13711,+
chr12,53873500,1.3539349609248852,4917,5160,10077,+
chr12,53873501,1.3448616153477044,3375,3562,6937,+
chr12,53873502,0.7609584916011235,2526,2502,5028,+
chr12,53873508,0.568045197740113,3141,2949,6090,+
chr12,53873512,0.7298071702155761,3649,3283,6932,+
chr12,53873530,1.6849585087484489,2884,3160,6044,+
chr12,53898542,1.294278147842458,679,343,1022,+
chr12,54382955,1.0478108639536525,1657,1124,2781,+
chr12,54382956,0.9947737926786527,1699,1136,2835,+
chr12,54383008,2.0917391227797673,1038,753,1791,+
chr12,54383029,0.49636363636363623,629,499,1128,+
chr12,54383054,0.5301646862622473,747,584,1331,+
chr12,54383055,2.4884230287859825,722,563,1285,+
chr12,54383361,2.3187327438953993,708,473,1181,+
chr12,54383411,0.5071827436388184,1112,651,1763,+
chr12,54383450,13.993041515454022,820,375,1195,+
chr12,54383458,3.228015903657124,1254,632,1886,+
chr12,54383459,2.908174833102406,887,466,1353,+
chr12,54383475,9.264078279634125,1977,1283,3260,+
chr12,54383476,8.627930389863321,2791,1885,4676,+
chr12,54383506,1.5113670039371745,1699,1494,3193,+
chr12,54383507,1.1746348726325115,2756,2241,4997,+
chr12,54383509,0.4030168034388433,1356,852,2208,+
chr12,54383510,0.4030168034388433,1356,852,2208,+
chr12,54383613,1.8116407554927405,1409,1085,2494,+
chr12,54383615,1.8116407554927405,1409,1085,2494,+
chr12,54383633,2.133720485978452,715,568,1283,+
chr12,54674522,1.3263675975172222,2063,1679,3742,+
chr12,54674527,1.3716631230805574,1857,1410,3267,+
chr12,54674530,0.8884232575778218,4968,4101,9069,+
chr12,54674531,0.5333624637309187,4663,3559,8222,+
chr12,54674555,1.549988269763522,3622,2279,5901,+
chr12,54674597,1.5768598873534456,3792,2578,6370,+
chr12,54675655,1.288957068151147,2494,1823,4317,+
chr12,54675660,1.4658957307075924,4651,3039,7690,+
chr12,54675982,1.4691474092240873,3989,2367,6356,+
chr12,54675995,1.533187400271315,3184,1973,5157,+
chr12,54676023,1.3931964988724534,3088,2294,5382,+
chr12,54676025,1.7070320883243648,2359,1296,3655,+
chr12,54676407,11.559120079403618,25312,17722,43034,+
chr12,54676408,11.529592516297544,31049,21166,52215,+
chr12,54676409,11.529592516297546,31049,21166,52215,+
chr12,54676629,5.32935804878871,24071,22783,46854,+
chr12,54676630,5.329358048788709,24071,22783,46854,+
chr12,54676631,5.32935804878871,24071,22783,46854,+
chr12,54676635,4.310521645214605,10157,11219,21376,+
chr12,54676637,1.8229109205489529,3183,3127,6310,+
chr12,54676642,0.6006878749727452,2587,2137,4724,+
chr12,54676960,3.3474759940692773,1071,765,1836,+
chr12,54676981,2.0405476566614005,619,421,1040,+
chr12,54677013,8.728011098462567,2350,1551,3901,+
chr12,54677617,3.209014670008622,13962,13957,27919,+
chr12,54678461,1.815782716049383,1371,674,2045,+
chr12,54678462,1.4844595409440975,1793,905,2698,+
chr12,54678463,1.8860946745562133,1835,935,2770,+
chr12,54678465,1.9499740989003898,1149,574,1723,+
chr12,54678468,1.5797122627955567,1178,817,1995,+
chr12,54678470,1.8982899237042885,838,542,1380,+
chr12,54678484,1.0020325203252034,679,491,1170,+
chr12,54678485,0.6013636363636363,587,439,1026,+
chr12,54678486,1.4201704880337271,1063,684,1747,+
chr12,54678492,1.7929292929292926,709,557,1266,+
chr12,54678496,2.3175665399239542,1603,1314,2917,+
chr12,54678497,2.3175665399239542,1603,1314,2917,+
chr12,54678507,1.2277131782945736,1266,863,2129,+
chr12,54678508,1.2277131782945736,1266,863,2129,+
chr12,54678512,1.7002692429521695,1262,1147,2409,+
chr12,54678527,1.5679135081396796,1146,618,1764,+
chr12,54678531,1.4315789473684213,1291,721,2012,+
chr12,54678537,1.5780359172927831,1963,1856,3819,+
chr12,54678551,1.3046316557257476,2154,1370,3524,+
chr12,54678573,0.7575124187831594,3585,2470,6055,+
chr12,54678868,1.7913193446392643,759,496,1255,+
chr12,54678869,1.7913193446392643,759,496,1255,+
chr12,54678881,1.5991209037383507,1076,697,1773,+
chr12,54678887,2.467462456680786,711,370,1081,+
chr12,54678889,1.7720847823145043,1082,594,1676,+
chr12,54678892,2.960509754562618,606,453,1059,+
chr12,54678894,0.8780555555555556,1307,719,2026,+
chr12,54678895,0.8780555555555556,1307,719,2026,+
chr12,54678896,0.8780555555555556,1307,719,2026,+
chr12,54678897,2.180499325236167,1404,1139,2543,+
chr12,54678898,2.180499325236167,1404,1139,2543,+
chr12,54678900,0.4389156056834898,1179,754,1933,+
chr12,54678904,2.1450617283950617,694,512,1206,+
chr12,54678908,1.874577337422348,768,470,1238,+
chr12,54678935,0.9781346990984038,2631,2017,4648,+
chr12,54679689,2.0791252603214434,394,1933,2327,+
chr12,54679690,2.0711035556677864,267,1126,1393,+
chr12,54679691,1.7449844806505088,355,1764,2119,+
chr12,54679692,0.06174316756808499,214,1228,1442,+
chr12,54679699,0.974356194579475,387,2092,2479,+
chr12,54679700,0.8197833126968559,481,2596,3077,+
chr12,54679701,0.7002780260152914,216,1118,1334,+
chr12,54679702,0.26675064877614174,378,1754,2132,+
chr12,54679703,0.24066797642436147,195,1017,1212,+
chr12,54679709,0.17066074863941205,533,1610,2143,+
chr12,54679745,0.16655201137409045,608,1267,1875,+
chr12,54679747,0.17766003559163984,896,2035,2931,+
chr12,54679748,0.1711003093239063,483,1094,1577,+
chr12,54680363,12.59051644907945,850,313,1163,+
chr12,54680374,9.095591590488006,780,544,1324,+
chr12,54680383,8.025765287966474,1304,1658,2962,+
chr12,54680384,7.739073194462035,2328,3100,5428,+
chr12,54680385,7.739073194462035,2328,3100,5428,+
chr12,54680386,7.381306574390943,1904,2707,4611,+
chr12,54680410,0.29334508994759445,726,1399,2125,+
chr12,54680411,0.3417989875827456,394,796,1190,+
chr12,54680489,1.64082874529122,754,713,1467,+
chr12,54718918,1.3245299064537466,622,556,1178,+
chr12,54718922,1.0542036963658363,2107,1647,3754,+
chr12,54718944,0.9519405504105694,2962,2666,5628,+
chr12,54741612,1.4090237317038512,1436,1134,2570,+
chr12,54743408,1.579460951962599,1417,1098,2515,+
chr12,54743421,1.4126031086919926,1534,1254,2788,+
chr12,54743425,1.9983159998519557,1564,1317,2881,+
chr12,54744306,1.768692550418439,1171,984,2155,+
chr12,54744362,0.6887644982349975,1452,1321,2773,+
chr12,54744424,1.571210734980177,1287,1092,2379,+
chr12,54744770,6.230189732142858,1653,447,2100,+
chr12,54744771,7.5055176037835,2483,691,3174,+
chr12,54744772,7.545998669917977,1479,346,1825,+
chr12,54744773,8.825668216861006,5181,1426,6607,+
chr12,54744774,4.560059317844785,2049,577,2626,+
chr12,54744776,17.92491014429005,5391,4582,9973,+
chr12,54744777,15.533802852277427,7750,8073,15823,+
chr12,54744778,13.556256467440102,8603,9409,18012,+
chr12,54744780,7.691727272727272,1658,2624,4282,+
chr12,54744791,0.5296478755808021,3727,7170,10897,+
chr12,54744941,1.4121979286536248,1039,789,1828,+
chr12,54745318,0.3498181818181818,1035,699,1734,+
chr12,54745337,1.5591721427255418,1153,856,2009,+
chr12,54745405,2.2221140322406145,892,710,1602,+
chr12,56112897,1.0524493942358342,1889,1454,3343,+
chr12,56112898,1.8565169575705973,1260,971,2231,+
chr12,56112899,1.3742783741066371,3149,2425,5574,+
chr12,56113397,4.146449916543881,656,435,1091,+
chr12,56212832,0.43234464150232116,566,463,1029,+
chr12,56213213,2.3403980804999565,648,443,1091,+
chr12,56214212,10.09437944041027,927,566,1493,+
chr12,56214214,9.213474156426082,1291,858,2149,+
chr12,56360603,6.1233901863850395,640,531,1171,+
chr12,56360622,0.3046815145190249,2253,1636,3889,+
chr12,56360630,0.6416874587742694,894,590,1484,+
chr12,56360683,1.95237322515213,1233,724,1957,+
chr12,56360695,1.5345465496472208,1345,893,2238,+
chr12,56360718,2.037135278514589,1223,492,1715,+
chr12,56360724,1.688105322607589,3152,1867,5019,+
chr12,56360733,1.5992825490609832,1572,676,2248,+
chr12,56360740,1.3973100585682543,3944,1964,5908,+
chr12,56360769,1.7976170963412892,20000,12703,32703,+
chr12,56360770,1.9407633962897628,14256,8607,22863,+
chr12,56360776,1.6069780830620184,4678,2569,7247,+
chr12,56360847,2.5801282051282053,629,431,1060,+
chr12,56361696,2.0326851851851853,756,539,1295,+
chr12,56362569,2.0980982383842535,1188,854,2042,+
chr12,56362637,1.2442159651637288,1364,1049,2413,+
chr12,56362644,1.7709532640393897,1428,970,2398,+
chr12,56362647,1.7327389117512575,582,485,1067,+
chr12,56363306,1.6937888198757762,605,459,1064,+
chr12,56364840,0.24153396872149746,1254,940,2194,+
chr12,56364841,0.4946112414217641,3099,2231,5330,+
chr12,56364843,0.85777353537764,1105,866,1971,+
chr12,56364853,1.5907869481765835,591,520,1111,+
chr12,56364861,1.7845761631612491,909,522,1431,+
chr12,56364922,0.6355041573460516,716,550,1266,+
chr12,56364928,0.5523540284875503,634,540,1174,+
chr12,56364957,1.4127736717333705,920,605,1525,+
chr12,56365547,1.9281376518218627,634,493,1127,+
chr12,56365795,2.666770186335404,830,482,1312,+
chr12,56365815,2.00964884530212,1088,653,1741,+
chr12,56365845,2.216800804828974,677,496,1173,+
chr12,56365966,1.9450418160095584,791,557,1348,+
chr12,56365994,0.3699019607843137,685,509,1194,+
chr12,56366019,2.387234561874542,630,481,1111,+
chr12,56366086,2.200306689668392,882,563,1445,+
chr12,56366142,1.453997809419496,1124,829,1953,+
chr12,56366179,3.2740422984836397,886,715,1601,+
chr12,56366401,1.0554545454545456,755,559,1314,+
chr12,56366402,1.0554545454545456,755,559,1314,+
chr12,56366418,2.9901037780340367,719,572,1291,+
chr12,56384499,2.558254976663117,633,386,1019,+
chr12,56386423,0.9583213749639062,1103,814,1917,+
chr12,56386731,2.6253295562907053,639,406,1045,+
chr12,56386829,2.273324027423474,613,472,1085,+
chr12,56386989,2.5703474161813444,577,509,1086,+
chr12,56387377,0.488632507634883,599,420,1019,+
chr12,56435923,0.437985548975933,555,465,1020,+
chr12,56435924,0.48907774218801575,2245,1394,3639,+
chr12,56435926,0.5182800853152989,1555,825,2380,+
chr12,56435929,1.6154085119602362,799,347,1146,+
chr12,56435941,1.675700090334237,688,532,1220,+
chr12,56435945,1.6411130039750144,934,586,1520,+
chr12,56435949,0.4792068667243329,1107,790,1897,+
chr12,56435950,1.6502716532037829,1247,808,2055,+
chr12,56436274,1.862218999274837,1069,590,1659,+
chr12,56436299,1.4994040628991536,2587,1700,4287,+
chr12,56436309,1.370914465651308,1591,1234,2825,+
chr12,56436310,1.5083410565338278,1301,580,1881,+
chr12,56436313,1.334533216271583,1470,669,2139,+
chr12,56436316,1.518341307814992,2175,1187,3362,+
chr12,56436317,1.9043419837070632,1813,881,2694,+
chr12,56436324,1.4830734326294475,4214,2753,6967,+
chr12,56436329,1.4140138747940316,7831,4406,12237,+
chr12,56436331,1.3028147231673368,5615,3232,8847,+
chr12,56436334,0.6251049809419212,2418,1345,3763,+
chr12,56436361,1.3602469998834903,4669,2860,7529,+
chr12,56437264,1.3322382829610162,2771,1521,4292,+
chr12,56498388,1.0837894736842106,584,474,1058,+
chr12,56498390,1.0837894736842106,584,474,1058,+
chr12,56498490,3.237670968617419,3878,3233,7111,+
chr12,56498491,3.281560986383689,3535,2965,6500,+
chr12,56498492,2.830403187998125,1557,1421,2978,+
chr12,56498511,1.9021463189476118,633,618,1251,+
chr12,56498518,1.6787014988093572,840,648,1488,+
chr12,56498551,1.737319587628866,765,581,1346,+
chr12,56498585,1.6101632172303548,1017,848,1865,+
chr12,56498605,1.5450202131569275,1050,906,1956,+
chr12,56500417,1.714629258517034,712,498,1210,+
chr12,56500432,2.331684698608964,793,646,1439,+
chr12,56500494,2.052183014354067,1124,835,1959,+
chr12,56501369,3.6850202429149794,737,569,1306,+
chr12,56503020,2.1121387283236994,1014,864,1878,+
chr12,56503027,1.0022717996331663,1889,1413,3302,+
chr12,56503037,2.050734800902494,884,712,1596,+
chr12,56504358,1.5511064278187563,1471,1167,2638,+
chr12,56504360,1.357026540582236,1899,1206,3105,+
chr12,56504368,1.8994909637525197,1111,886,1997,+
chr12,56504966,1.9690168965134769,1267,730,1997,+
chr12,56505279,1.8905705229793979,722,630,1352,+
chr12,56505307,2.540973941752153,861,770,1631,+
chr12,56506686,1.912087912087912,695,545,1240,+
chr12,56506723,0.6306080645628735,1700,1316,3016,+
chr12,56506826,1.399273104880581,685,427,1112,+
chr12,56506829,0.6988836662749706,609,459,1068,+
chr12,56506830,2.598195488721805,977,664,1641,+
chr12,56506832,2.598195488721805,977,664,1641,+
chr12,56506836,1.9557334587079926,1481,1066,2547,+
chr12,56506842,1.5356649358859913,1279,1014,2293,+
chr12,56507056,0.44211131902362505,1191,751,1942,+
chr12,56507058,0.488704216682056,933,569,1502,+
chr12,56510387,2.519623953546809,1016,546,1562,+
chr12,56510388,2.304580812304276,1294,627,1921,+
chr12,56510410,1.6452173913043482,1418,674,2092,+
chr12,56510411,1.6933610624767812,2628,1387,4015,+
chr12,56510412,1.2923018144233158,5681,3215,8896,+
chr12,56510413,1.3293057061712659,8170,4799,12969,+
chr12,56510414,1.2177414524795511,5859,3903,9762,+
chr12,56510415,1.246158433120319,7210,4649,11859,+
chr12,56510416,1.0788774306631383,11620,8415,20035,+
chr12,56510419,1.3517185663924791,2862,1701,4563,+
chr12,56510423,1.5480942700166473,12376,7399,19775,+
chr12,56510424,1.6842540802396797,6409,4070,10479,+
chr12,56510427,1.1745169396996895,17398,11991,29389,+
chr12,56510435,1.003095836592126,27259,20783,48042,+
chr12,56510437,1.0830979286698972,36788,26515,63303,+
chr12,56510450,1.0151168542460054,1319,829,2148,+
chr12,56510451,0.875706618962433,843,429,1272,+
chr12,56510555,1.7705199524236197,606,520,1126,+
chr12,56510557,0.8521791064585165,913,762,1675,+
chr12,56510599,1.7283809523809521,697,499,1196,+
chr12,56510802,9.119096544789526,805,1069,1874,+
chr12,56510803,9.119096544789526,805,1069,1874,+
chr12,56510971,0.6973799396440713,994,643,1637,+
chr12,56510978,1.4092367145999913,18138,15193,33331,+
chr12,56552145,0.9076329772797112,1669,1172,2841,+
chr12,56552153,1.0125254183832726,10657,8042,18699,+
chr12,56552154,1.0455813463129324,14509,10675,25184,+
chr12,56552155,1.0455813463129322,14509,10675,25184,+
chr12,56552156,1.0648597707527412,5454,4541,9995,+
chr12,56553414,1.4654099282926871,2757,1981,4738,+
chr12,56553415,1.4654099282926871,2757,1981,4738,+
chr12,56553460,1.3974922131356728,6320,4754,11074,+
chr12,56553817,1.6350131971723882,7241,5713,12954,+
chr12,56553818,1.706577670867321,8300,5793,14093,+
chr12,56553882,1.398564912203096,6770,4508,11278,+
chr12,56553903,1.8930401914270842,5476,4611,10087,+
chr12,56554098,1.4658418254834142,2603,1872,4475,+
chr12,56619258,4.018928571428571,681,559,1240,+
chr12,56619259,4.018928571428571,681,559,1240,+
chr12,56622970,3.514745638639444,566,446,1012,+
chr12,56623221,4.036536760160954,630,494,1124,+
chr12,56623425,0.4404250188129969,1211,814,2025,+
chr12,57623501,1.2977095417831355,710,579,1289,+
chr12,57623502,1.121580840481047,835,666,1501,+
chr12,57623504,1.121580840481047,835,666,1501,+
chr12,57623517,0.5769763348393794,1875,1248,3123,+
chr12,57623523,1.534757897910298,2002,1554,3556,+
chr12,57623570,1.4079448299867297,1376,1068,2444,+
chr12,57624022,3.2583658541431646,703,561,1264,+
chr12,57624707,1.6380075669718417,3808,2754,6562,+
chr12,57625632,1.524753094136767,1556,841,2397,+
chr12,57626027,2.234220613172094,3204,2221,5425,+
chr12,57626046,1.3094562233514395,1983,1316,3299,+
chr12,57626496,1.5233140655105974,1473,1037,2510,+
chr12,57626529,1.8933869930702738,1558,856,2414,+
chr12,57626557,1.6030395136778115,1464,874,2338,+
chr12,57626604,1.436960771625887,3301,2351,5652,+
chr12,57626976,1.4744464597567135,3262,2373,5635,+
chr12,57627050,1.4801353115996418,2942,2194,5136,+
chr12,57627358,2.0759612378868395,1602,913,2515,+
chr12,57627387,1.036372153124579,5840,4255,10095,+
chr12,57627388,1.4085318815983778,2882,2306,5188,+
chr12,57627586,2.740995270242956,1540,852,2392,+
chr12,57627595,1.9415531195574225,1306,907,2213,+
chr12,57627632,0.7099567099567099,1735,1077,2812,+
chr12,57627798,1.7074010327022375,1455,1078,2533,+
chr12,57627809,1.3883246902909825,2028,1247,3275,+
chr12,57628100,1.5459156089900368,1667,1252,2919,+
chr12,57628155,1.5617224330228814,1912,1337,3249,+
chr12,57628212,1.3883139983666897,1824,1258,3082,+
chr12,57628213,1.4710503068070575,1687,1213,2900,+
chr12,57628254,1.4495339975736197,4249,3026,7275,+
chr12,57628263,1.3771384825631423,2072,1717,3789,+
chr12,57850937,33.24422677207243,450,664,1114,+
chr12,57851138,0.24243637692449588,497,529,1026,+
chr12,57881877,0.2847841581076875,589,503,1092,+
chr12,57881958,1.409268292682927,641,491,1132,+
chr12,57881960,1.9390170286410513,1064,704,1768,+
chr12,57881979,1.8589913445056503,1244,919,2163,+
chr12,57882864,1.7524000000000002,673,499,1172,+
chr12,57883078,1.4742551122169372,1103,823,1926,+
chr12,57883225,1.949190384206512,1201,771,1972,+
chr12,57883249,1.6428571428571428,551,479,1030,+
chr12,57883683,2.095657381005183,1682,1256,2938,+
chr12,57883684,2.1307322485207103,1001,831,1832,+
chr12,57883734,2.18904958677686,814,483,1297,+
chr12,57884027,1.5535081502480512,684,414,1098,+
chr12,57884056,2.85771382893685,649,416,1065,+
chr12,57884344,0.5711332670773132,731,645,1376,+
chr12,57884387,1.4336766672569325,1832,1526,3358,+
chr12,57884388,0.7674380704041721,830,766,1596,+
chr12,57891954,1.6737689393939394,706,395,1101,+
chr12,57891955,3.1,526,475,1001,+
chr12,57892295,1.851188157382158,593,452,1045,+
chr12,57892312,0.5241779497098645,541,469,1010,+
chr12,57892314,1.7195652173913043,790,459,1249,+
chr12,57892317,1.7100149476831092,615,445,1060,+
chr12,57892324,3.085454484201503,1576,1025,2601,+
chr12,57894116,0.5369973632168754,685,591,1276,+
chr12,57905484,0.5328793360289423,625,380,1005,+
chr12,57905513,10.58953437173649,2006,2084,4090,+
chr12,57905540,0.46451289984551214,968,1201,2169,+
chr12,57905547,0.47165997932154785,952,1222,2174,+
chr12,57905594,0.6012759170653907,766,648,1414,+
chr12,57905608,1.9521676266325343,1159,1028,2187,+
chr12,57905609,1.8530918450749774,1860,1503,3363,+
chr12,57905842,2.7226666666666666,1020,674,1694,+
chr12,57906031,1.810241305086666,840,678,1518,+
chr12,57906099,2.14425087108014,723,573,1296,+
chr12,57906647,2.06063338217063,652,466,1118,+
chr12,57906699,3.306912442396313,623,433,1056,+
chr12,57908537,1.9126506024096388,634,497,1131,+
chr12,57908606,4.890829694323144,559,457,1016,+
chr12,57908609,1.9696078431372548,573,479,1052,+
chr12,57908767,1.9532829522033566,641,442,1083,+
chr12,57908790,1.893139293139293,784,480,1264,+
chr12,57909108,1.6419253261358526,729,683,1412,+
chr12,57909744,1.1411151786540925,1644,1250,2894,+
chr12,57910029,1.7479441575827117,913,580,1493,+
chr12,58088035,1.4901348199066415,889,617,1506,+
chr12,58088062,1.7897260273972602,602,437,1039,+
chr12,58088668,3.0492733282977182,902,697,1599,+
chr12,58089807,1.7137404580152673,897,523,1420,+
chr12,58109709,2.085605740818911,771,514,1285,+
chr12,58109711,2.085605740818911,771,514,1285,+
chr12,58109895,1.6561679790026247,630,380,1010,+
chr12,58109920,0.5606350775189644,1506,1086,2592,+
chr12,58109967,2.370103557505796,930,601,1531,+
chr12,58111936,1.6765799256505578,737,537,1274,+
chr12,58112064,4.749767745540894,1246,979,2225,+
chr12,58112065,5.3966702859211,805,613,1418,+
chr12,58112880,2.728794819143895,616,486,1102,+
chr12,58112933,2.159089026915114,840,524,1364,+
chr12,58113951,1.530921766978068,771,545,1316,+
chr12,58113991,0.4675260472729066,1213,722,1935,+
chr12,58114031,10.0517151730731,2718,1766,4484,+
chr12,58114032,7.283281733746131,940,645,1585,+
chr12,58114660,8.127692391631756,1205,775,1980,+
chr12,58114667,11.395454336618007,2124,1586,3710,+
chr12,58114668,10.800862560604829,3375,2667,6042,+
chr12,58114669,10.800862560604829,3375,2667,6042,+
chr12,58114677,0.4459076360310928,847,728,1575,+
chr12,58114678,0.4459076360310928,847,728,1575,+
chr12,58114786,0.5368139443014844,645,506,1151,+
chr12,58114915,1.869019138755981,624,439,1063,+
chr12,58114927,4.167548500881834,555,503,1058,+
chr12,58115104,2.791381400181478,857,676,1533,+
chr12,58115182,0.5544217687074829,651,503,1154,+
chr12,58115183,1.792820296873355,654,412,1066,+
chr12,58115229,1.761527829277656,1094,802,1896,+
chr12,58176931,2.0402802046424617,826,641,1467,+
chr12,58180014,3.298889539967555,717,527,1244,+
chr12,62688022,4.109529646267443,612,433,1045,+
chr12,62696617,1.2413988688292983,608,408,1016,+
chr12,64195949,1.9213400364466904,596,475,1071,+
chr12,64798345,3.7207064715961513,664,460,1124,+
chr12,64798477,2.226597325408618,1052,672,1724,+
chr12,64798479,2.3119554426148388,1495,990,2485,+
chr12,64798513,1.979091128837321,654,393,1047,+
chr12,64798515,0.5237073170731708,670,499,1169,+
chr12,64798519,1.4350067411306147,1276,867,2143,+
chr12,64798533,2.0410598257477552,1789,1261,3050,+
chr12,64798545,0.5826247638850821,2158,1300,3458,+
chr12,64798552,2.528946791282034,2462,1565,4027,+
chr12,64803789,0.6811505229649841,1032,732,1764,+
chr12,64803799,1.8018212045643465,1108,801,1909,+
chr12,64803812,2.336045772409409,966,714,1680,+
chr12,64803847,2.2103420745562854,1160,856,2016,+
chr12,64812691,1.5444741984511834,1066,673,1739,+
chr12,64812807,0.6502803131296951,2242,1748,3990,+
chr12,64813912,2.3135097001763665,862,566,1428,+
chr12,64814210,1.640484470560019,911,537,1448,+
chr12,64814217,2.689093219705465,1057,636,1693,+
chr12,64815055,1.5605461555462783,1198,946,2144,+
chr12,64815164,1.7328402571369326,1165,781,1946,+
chr12,64818484,1.412997095420805,1898,1411,3309,+
chr12,64818892,1.543646380260197,1217,942,2159,+
chr12,64819135,0.6515151515151515,1375,1055,2430,+
chr12,64819605,1.6376399241020383,3710,2452,6162,+
chr12,64819635,0.7292118093174431,1957,1419,3376,+
chr12,64823829,1.5980419151741883,2643,1924,4567,+
chr12,64823877,2.474164133738602,1220,986,2206,+
chr12,64825339,0.7144133644133644,1812,1364,3176,+
chr12,64825477,1.6793480116060762,1612,1084,2696,+
chr12,64825536,1.6192153065117236,1173,920,2093,+
chr12,64825583,1.6226942678031842,1798,1166,2964,+
chr12,64827273,1.579208516993039,1771,1317,3088,+
chr12,64827276,1.8000710732054015,1177,803,1980,+
chr12,64827367,1.566445012787724,1275,849,2124,+
chr12,64829409,1.978613155549688,1198,738,1936,+
chr12,64833088,0.5362758620689655,1133,874,2007,+
chr12,64841898,1.559854994629431,1138,930,2068,+
chr12,64841917,0.6891003326371161,1047,833,1880,+
chr12,64842289,1.93455890854434,1067,836,1903,+
chr12,67691219,1.0515371137605967,664,479,1143,+
chr12,67691300,2.0383658373242532,759,495,1254,+
chr12,67696144,1.3760876998218998,712,561,1273,+
chr12,67699059,1.4779256739381645,712,555,1267,+
chr12,67699576,0.4685779202493509,816,562,1378,+
chr12,67699882,1.0949026226985905,702,452,1154,+
chr12,67700056,3.545629707479418,697,518,1215,+
chr12,67700057,3.545629707479418,697,518,1215,+
chr12,69042517,1.5652449352271205,1412,1071,2483,+
chr12,69044242,1.6674886565397515,1126,821,1947,+
chr12,69047895,0.549150958093161,704,523,1227,+
chr12,69053532,2.197290255341324,726,504,1230,+
chr12,69053552,1.8278008298755188,880,481,1361,+
chr12,69053580,2.088089982129717,2291,1358,3649,+
chr12,69053581,2.066894818123167,3909,2563,6472,+
chr12,69053582,2.0394980227069777,1618,1205,2823,+
chr12,69080813,2.8734276933024034,610,398,1008,+
chr12,69082753,0.29363787424580035,630,497,1127,+
chr12,69082756,0.8783248943009185,969,678,1647,+
chr12,69096549,3.0653753026634387,632,412,1044,+
chr12,69096550,2.0125852734364686,1081,664,1745,+
chr12,69113167,3.4118681725606366,818,490,1308,+
chr12,69113361,1.2756869206214763,3705,2486,6191,+
chr12,69113362,1.539010067114094,1222,744,1966,+
chr12,69113363,2.073958393583589,3469,2033,5502,+
chr12,69113365,1.7553154298426823,5020,3044,8064,+
chr12,69113366,1.6766640750490047,6574,4121,10695,+
chr12,69113367,1.6766640750490047,6574,4121,10695,+
chr12,69113403,2.021988063622605,4675,3890,8565,+
chr12,69113405,1.9240773655358567,8278,6734,15012,+
chr12,69113406,2.111803874092009,4811,4129,8940,+
chr12,69113409,1.6536211038640583,8329,6731,15060,+
chr12,69113410,1.7754806512960242,5217,4798,10015,+
chr12,69633450,1.4270253555967842,709,461,1170,+
chr12,69646916,1.8860422196162585,913,642,1555,+
chr12,69653869,2.5110294117647056,682,458,1140,+
chr12,69653884,2.151219512195122,1385,819,2204,+
chr12,69653891,2.310874704491726,1444,917,2361,+
chr12,69653915,1.8487179487179488,1029,649,1678,+
chr12,69653917,1.4760690789473685,1736,1215,2951,+
chr12,69653928,1.4605733872443802,1438,896,2334,+
chr12,69653929,1.5035211267605637,1322,851,2173,+
chr12,69663367,0.4553787923590987,699,456,1155,+
chr12,69663373,0.6787517986626415,890,528,1418,+
chr12,69663375,1.8259109311740889,655,415,1070,+
chr12,69663381,0.7047068077440309,2547,1358,3905,+
chr12,69663382,0.8372679988708016,4166,2349,6515,+
chr12,69663383,1.2299766139399508,2360,1680,4040,+
chr12,69663443,0.4467455621301776,754,519,1273,+
chr12,69753761,2.458929517753047,927,628,1555,+
chr12,69753762,2.4522353233583587,1120,753,1873,+
chr12,69759653,3.334669959472982,651,499,1150,+
chr12,69784202,1.2841987716359575,899,596,1495,+
chr12,69784203,1.2841987716359575,899,596,1495,+
chr12,69979238,1.1858236825177164,776,383,1159,+
chr12,69979270,1.6350181984526657,2463,1745,4208,+
chr12,69979271,1.39066598659283,930,751,1681,+
chr12,69979285,1.064892154057721,1922,1116,3038,+
chr12,69979287,1.064892154057721,1922,1116,3038,+
chr12,69980078,2.153866079523377,1662,1102,2764,+
chr12,69980080,1.550040325537063,728,592,1320,+
chr12,69981352,1.6829426864717771,3869,2639,6508,+
chr12,69982033,1.6631210120800541,3624,2444,6068,+
chr12,69983375,1.5880996309963098,938,812,1750,+
chr12,69983425,1.7133655394524963,895,735,1630,+
chr12,69986801,1.4922220088342617,2330,1523,3853,+
chr12,69987301,1.4497566503759018,2017,1250,3267,+
chr12,69990952,1.8462176165803108,785,578,1363,+
chr12,69991806,0.5752920067966587,1512,1038,2550,+
chr12,69991808,2.7350427350427347,687,558,1245,+
chr12,69992120,2.368231046931408,1393,830,2223,+
chr12,69992173,1.7364476885644768,810,684,1494,+
chr12,69993688,1.5218726365148991,1596,1201,2797,+
chr12,69993765,4.179575444635685,704,580,1284,+
chr12,69995086,1.9856474184458133,1138,996,2134,+
chr12,69995099,1.3214697044484278,1860,1268,3128,+
chr12,69995100,0.6295863550899813,1266,1019,2285,+
chr12,72097503,1.9907373208385228,628,485,1113,+
chr12,72290534,1.0712680573116669,1116,601,1717,+
chr12,72290546,2.277166071835371,1763,1012,2775,+
chr12,72290547,2.277166071835371,1763,1012,2775,+
chr12,72290554,0.3935458480913026,624,384,1008,+
chr12,72291639,1.8884947225506945,879,530,1409,+
chr12,72291644,3.0446680080482897,872,496,1368,+
chr12,72291657,1.9867586206896557,1107,724,1831,+
chr12,72291670,1.5657957813998082,1607,1191,2798,+
chr12,72291684,1.6869009584664536,1695,1251,2946,+
chr12,72316808,1.0305127398553005,755,577,1332,+
chr12,72316809,1.0305127398553005,755,577,1332,+
chr12,72317064,2.172445110248382,837,631,1468,+
chr12,74932689,1.2323108577475665,611,561,1172,+
chr12,74933880,0.9883720930232558,747,515,1262,+
chr12,74933881,0.9883720930232558,747,515,1262,+
chr12,88436630,2.45166310293226,600,444,1044,+
chr12,93863079,1.3809687392648573,1439,983,2422,+
chr12,93870787,1.598391555667253,2399,1383,3782,+
chr12,93873210,1.9741963699978131,2439,1344,3783,+
chr12,93873225,1.312531983458501,3649,1877,5526,+
chr12,93873231,1.8235299182092124,4152,2322,6474,+
chr12,93873234,1.4930554949494843,16412,9919,26331,+
chr12,93873235,1.393963311940506,22220,13928,36148,+
chr12,93873237,1.6064677779508747,7278,4703,11981,+
chr12,93873242,1.2469416525917505,25567,16484,42051,+
chr12,93873243,1.2939176509548516,13023,9058,22081,+
chr12,93873244,1.1835738050908216,28275,18449,46724,+
chr12,93894975,1.6602110971240438,634,448,1082,+
chr12,93895048,0.5584634077951209,1194,822,2016,+
chr12,93895785,2.826063829787234,692,375,1067,+
chr12,93895786,2.826063829787234,692,375,1067,+
chr12,93895818,5.918905308416277,682,412,1094,+
chr12,95867996,1.8578733982880953,709,559,1268,+
chr12,95868014,0.5803762916747904,566,445,1011,+
chr12,95868025,1.6445358474897962,1072,793,1865,+
chr12,95869863,0.3784029038112523,694,434,1128,+
chr12,95869867,1.6855283377022507,642,480,1122,+
chr12,95877031,2.1989087301587302,805,503,1308,+
chr12,95879655,0.6417723332616949,778,593,1371,+
chr12,95879735,0.7226312419974391,1203,851,2054,+
chr12,95879750,1.5729050027671596,2019,1601,3620,+
chr12,95879751,1.5729050027671596,2019,1601,3620,+
chr12,95887834,2.2708719851576995,1087,923,2010,+
chr12,95888837,1.6854979944635895,764,570,1334,+
chr12,95889813,1.6586977779276395,1117,630,1747,+
chr12,95889834,1.6918000220726188,2642,1598,4240,+
chr12,95889868,1.4807840493161242,2492,1431,3923,+
chr12,95897849,1.5015902734698177,5963,3422,9385,+
chr12,95897853,0.9864103128141419,8355,5096,13451,+
chr12,95897866,1.9405035255197165,7970,5417,13387,+
chr12,95897868,1.9405035255197165,7970,5417,13387,+
chr12,95897882,2.004987231711138,4645,3726,8371,+
chr12,95905689,1.7260606060606063,711,624,1335,+
chr12,95907683,2.839177219822853,901,718,1619,+
chr12,95907848,2.047292586567511,838,661,1499,+
chr12,95908046,1.6465939110475942,4905,3611,8516,+
chr12,95908047,1.6465939110475942,4905,3611,8516,+
chr12,96252742,0.8546049267693606,1527,902,2429,+
chr12,96252744,0.8190977297086621,887,494,1381,+
chr12,96252780,1.883561643835616,626,437,1063,+
chr12,96252784,2.31879375194875,2409,1633,4042,+
chr12,96252828,2.4959514170040484,684,493,1177,+
chr12,96252831,0.9988580269652988,1869,1107,2976,+
chr12,96252832,0.9988580269652988,1869,1107,2976,+
chr12,96252848,2.294259962049336,1028,679,1707,+
chr12,98909681,0.4002060776729407,727,547,1274,+
chr12,98909711,1.564996725605763,868,508,1376,+
chr12,98909712,2.7535211267605635,611,425,1036,+
chr12,98909789,1.9564446459749691,1026,613,1639,+
chr12,98909905,2.9294590643274856,686,455,1141,+
chr12,98909907,2.9294590643274856,686,455,1141,+
chr12,98921663,0.48624425220169903,733,610,1343,+
chr12,98921669,2.2122291362372195,1364,1218,2582,+
chr12,98921670,2.2122291362372195,1364,1218,2582,+
chr12,98921674,2.382342105739333,2966,2400,5366,+
chr12,98921675,1.925743046762155,2608,2040,4648,+
chr12,98921677,2.1343283582089554,1770,1406,3176,+
chr12,98921713,1.3797221016066,1024,657,1681,+
chr12,98927028,2.1720841300191203,1135,522,1657,+
chr12,98927030,2.076926476300755,2227,1033,3260,+
chr12,98927040,1.6651027703306522,770,372,1142,+
chr12,98927047,2.1839480813970606,1852,892,2744,+
chr12,98927375,0.4410087070835613,655,426,1081,+
chr12,98931258,2.0699730872741253,672,458,1130,+
chr12,98941788,1.1089627088115594,1115,814,1929,+
chr12,98942915,0.2240761478163493,666,469,1135,+
chr12,98942916,0.2240761478163493,666,469,1135,+
chr12,98943475,0.5370585202371745,640,430,1070,+
chr12,98943567,0.5506393490264458,688,371,1059,+
chr12,98943663,2.2483316577222707,1032,710,1742,+
chr12,98987482,0.549079754601227,536,488,1024,+
chr12,98987500,1.4264421816110007,1805,1537,3342,+
chr12,98987796,1.6934400373853613,1114,1006,2120,+
chr12,98987889,0.6932473423878884,905,850,1755,+
chr12,98989504,1.4453125,1664,927,2591,+
chr12,98989508,1.7948503299788758,3354,2184,5538,+
chr12,98989530,1.0791495332653869,4987,3227,8214,+
chr12,98989531,1.492803539426523,1796,1487,3283,+
chr12,98989534,1.292324966183817,7021,5250,12271,+
chr12,98989610,1.4370791706166897,2955,1958,4913,+
chr12,98991645,1.5118552777940402,2151,1797,3948,+
chr12,98991674,1.2357247270893232,3387,2152,5539,+
chr12,98992313,1.5390572835266754,3466,2390,5856,+
chr12,98993767,1.2649122807017543,2883,2279,5162,+
chr12,98995008,0.7711739802432632,4447,3234,7681,+
chr12,98995009,1.2552070074448909,3242,2710,5952,+
chr12,98995214,1.255073230710016,7587,5331,12918,+
chr12,98995262,1.2451605908207604,3611,2350,5961,+
chr12,100594669,1.8120412561006551,778,589,1367,+
chr12,100603884,3.1316214160370444,936,672,1608,+
chr12,100612326,1.8532954865261768,619,444,1063,+
chr12,102315317,2.307375469485348,641,440,1081,+
chr12,102315395,2.0181272822117893,618,425,1043,+
chr12,102315404,0.5801910507792861,576,467,1043,+
chr12,102315487,2.288961038961039,854,797,1651,+
chr12,102315489,2.259782608695652,692,459,1151,+
chr12,102315815,4.543022677779713,829,674,1503,+
chr12,102317111,3.059440559440559,699,439,1138,+
chr12,102317112,3.059440559440559,699,439,1138,+
chr12,102317115,2.7234347551430393,1457,996,2453,+
chr12,102317116,2.8840653357531765,763,550,1313,+
chr12,102317121,1.9866297833102808,833,722,1555,+
chr12,102317122,1.9866297833102808,833,722,1555,+
chr12,104324217,2.2931902346691784,740,377,1117,+
chr12,104324239,2.6110074626865667,932,535,1467,+
chr12,104324240,2.6110074626865667,932,535,1467,+
chr12,104324241,3.743824719922996,2280,1340,3620,+
chr12,104324244,3.308339268990715,1309,871,2180,+
chr12,104324248,3.5332967032967035,868,699,1567,+
chr12,104324250,3.400978897872738,1606,1243,2849,+
chr12,104324252,2.8276175022963606,1328,960,2288,+
chr12,104324261,0.5211010265917938,1015,774,1789,+
chr12,104324267,2.9770723894463758,4825,5007,9832,+
chr12,104324268,2.9770723894463753,4825,5007,9832,+
chr12,104324293,0.5683342880494638,2662,2698,5360,+
chr12,104324317,0.5855090253843854,1062,1076,2138,+
chr12,104325319,1.0261536237644504,5965,4929,10894,+
chr12,104325346,1.4961837341757558,3414,2550,5964,+
chr12,104325355,0.632725369214143,8076,6104,14180,+
chr12,104327888,1.4971090746483615,4002,2608,6610,+
chr12,104327889,1.4971090746483615,4002,2608,6610,+
chr12,104327902,1.7363452128086803,4967,3976,8943,+
chr12,104331497,1.5304893139704767,3276,2122,5398,+
chr12,104336327,1.4181716748525983,3014,2426,5440,+
chr12,104336328,1.3079834073211556,3993,2566,6559,+
chr12,104337561,0.9885524851722133,6002,4272,10274,+
chr12,104337608,1.4465160237133774,2561,1581,4142,+
chr12,104340428,1.3208424459817527,7819,5637,13456,+
chr12,104341416,1.5006695595071011,3282,2098,5380,+
chr12,104373685,1.58296980468189,581,474,1055,+
chr12,104659412,0.5580616013576588,733,388,1121,+
chr12,104659584,1.9873554819030987,642,409,1051,+
chr12,104659608,1.9805558943016126,750,376,1126,+
chr12,104680799,0.9869677633141594,6097,3561,9658,+
chr12,104680809,1.335285505124451,2431,1365,3796,+
chr12,104712727,1.357970437570056,2422,2097,4519,+
chr12,104712777,0.844531323157599,6499,4719,11218,+
chr12,104719181,1.6622889305816133,3543,2131,5674,+
chr12,104721406,1.4805985015807024,2030,1610,3640,+
chr12,104732948,1.6169989964658142,2039,1762,3801,+
chr12,104733003,0.7160471670521922,4864,3581,8445,+
chr12,104742197,1.5869544902345576,1212,1043,2255,+
chr12,104742344,1.7960927960927962,1470,1196,2666,+
chr12,104742365,1.6836579847698927,1584,1393,2977,+
chr12,104742984,1.3418338185821528,2820,2306,5126,+
chr12,104743261,1.3305008944543828,3624,2235,5859,+
chr12,104743457,1.2728932124392462,8458,6193,14651,+
chr12,104743642,1.3231078174363111,2668,2051,4719,+
chr12,104743694,1.5495723788406717,1222,1000,2222,+
chr12,104743700,0.697577180823644,1281,1026,2307,+
chr12,104743715,1.402499249091826,5523,3514,9037,+
chr12,104743717,1.409528958330377,7157,4870,12027,+
chr12,104743795,0.725007080147267,1535,1176,2711,+
chr12,104743819,1.3803757828810022,1826,1436,3262,+
chr12,107365282,1.7838443167520825,1428,1034,2462,+
chr12,107365284,1.8829952042982445,1895,1317,3212,+
chr12,107365285,2.1608656627106813,921,541,1462,+
chr12,107366566,2.920672717693266,640,400,1040,+
chr12,107366680,5.569575889448261,580,719,1299,+
chr12,107366695,0.497643374612879,750,861,1611,+
chr12,107366696,0.497643374612879,750,861,1611,+
chr12,107367617,2.090721649484536,675,484,1159,+
chr12,107367631,0.6052287581699346,925,764,1689,+
chr12,107367642,1.5319865319865318,909,725,1634,+
chr12,107367646,1.9440474522441733,967,792,1759,+
chr12,107367658,2.162896566064638,2406,2103,4509,+
chr12,107367660,2.162896566064638,2406,2103,4509,+
chr12,107367664,1.2774404253272622,4258,4037,8295,+
chr12,107367665,1.6864348590340432,2698,2696,5394,+
chr12,108096792,3.805951279817428,670,506,1176,+
chr12,109536325,1.684796736142813,1324,827,2151,+
chr12,109536327,1.0536584251352676,1087,669,1756,+
chr12,109536353,1.3757157127600357,718,502,1220,+
chr12,109541338,2.40343347639485,1119,931,2050,+
chr12,109541339,2.40343347639485,1119,931,2050,+
chr12,109541340,2.40343347639485,1119,931,2050,+
chr12,109547698,3.786163522012578,1031,635,1666,+
chr12,109547699,3.786163522012578,1031,635,1666,+
chr12,109548489,4.437622483017565,1920,1452,3372,+
chr12,109548490,4.007392285496422,2889,2138,5027,+
chr12,109548491,2.9552495718838103,2421,1803,4224,+
chr12,109548523,3.162506984953217,1399,1308,2707,+
chr12,109967812,2.1797658862876257,868,643,1511,+
chr12,109967814,2.1124094768808592,1440,1085,2525,+
chr12,109967822,1.7432921169889748,1189,816,2005,+
chr12,110719434,3.6221984291808345,409,744,1153,+
chr12,110719600,1.8412928697619202,633,382,1015,+
chr12,110719681,1.573461729094385,541,486,1027,+
chr12,110720421,1.7046831955922863,818,604,1422,+
chr12,110734452,1.634999711477428,1370,1060,2430,+
chr12,110734531,1.9268066539405502,2815,2122,4937,+
chr12,110734533,1.9268066539405502,2815,2122,4937,+
chr12,110765401,1.6174280724331282,1907,1418,3325,+
chr12,110765406,1.5968709762765676,4133,3334,7467,+
chr12,110765407,1.6396928675705464,5656,4381,10037,+
chr12,110765411,2.250125565042692,2239,1990,4229,+
chr12,110765452,1.7824566737610215,669,597,1266,+
chr12,110765462,1.6428110896196,979,704,1683,+
chr12,110765520,1.5235978112175097,890,687,1577,+
chr12,110765616,1.5582608695652174,895,712,1607,+
chr12,110765669,2.826954850848341,1384,939,2323,+
chr12,110765708,1.570642605633803,792,567,1359,+
chr12,110765711,1.5444255319148936,788,499,1287,+
chr12,110765712,1.8911290322580645,937,703,1640,+
chr12,110765805,3.0832219251336896,899,747,1646,+
chr12,110770486,1.9849206033144147,2003,1378,3381,+
chr12,110770990,1.5141412457631829,1089,856,1945,+
chr12,110777341,1.6148253741981469,707,609,1316,+
chr12,110777482,0.5640089267599919,555,476,1031,+
chr12,110778508,1.6263969631812272,1801,1298,3099,+
chr12,110778509,1.889983643413626,2542,1815,4357,+
chr12,110778580,1.715910234739047,1159,891,2050,+
chr12,110778605,1.5361161116111612,737,403,1140,+
chr12,110778623,1.668965517241379,725,434,1159,+
chr12,110778721,1.70864200224058,1743,1280,3023,+
chr12,110778722,0.9874907109239534,937,733,1670,+
chr12,110778735,1.6581119923628282,1532,1164,2696,+
chr12,110780065,2.197667280540209,894,542,1436,+
chr12,110780066,2.055606617647059,638,511,1149,+
chr12,110780139,2.6148185739659984,686,562,1248,+
chr12,110780207,2.048744460856721,802,676,1478,+
chr12,110781156,0.5011080332409972,602,474,1076,+
chr12,110781164,0.6132943341038827,649,516,1165,+
chr12,110781165,1.5684830633284237,851,678,1529,+
chr12,110781195,0.5383787661406025,552,475,1027,+
chr12,110781214,1.467964629227428,756,585,1341,+
chr12,110782765,1.984547461368653,681,452,1133,+
chr12,110783068,0.5960006955312119,778,638,1416,+
chr12,110783812,0.5791481328652004,1429,1070,2499,+
chr12,110783846,2.210625,654,499,1153,+
chr12,110784118,0.4517087667161961,873,672,1545,+
chr12,110784183,2.037225042301184,687,393,1080,+
chr12,110784207,1.9211463776866753,2316,1791,4107,+
chr12,110784208,0.7950041558774296,2064,1588,3652,+
chr12,110784209,1.8978185993111365,797,468,1265,+
chr12,110784222,2.04368597320725,964,751,1715,+
chr12,110784234,1.3775863421701728,2080,1507,3587,+
chr12,110784248,0.6268512361723992,1219,931,2150,+
chr12,110784574,1.5278450363196123,1261,825,2086,+
chr12,110784660,1.5675190329797477,2821,1931,4752,+
chr12,110784916,2.549090909090909,700,439,1139,+
chr12,110784931,2.3438208955223883,912,669,1581,+
chr12,110784955,0.4917953041899079,1010,592,1602,+
chr12,110784961,1.4426877470355732,1167,919,2086,+
chr12,110784977,3.154522235576924,856,831,1687,+
chr12,110786295,19.642730080349793,1017,707,1724,+
chr12,110786613,6.7085415757498605,594,533,1127,+
chr12,110788698,1.9690433900025373,775,562,1337,+
chr12,110927990,8.497806536463472,763,607,1370,+
chr12,112327864,2.168672660735026,881,462,1343,+
chr12,112327891,0.3581932773109244,867,543,1410,+
chr12,112327917,1.839668615984405,2264,1214,3478,+
chr12,112327919,1.6997960218805641,3807,2081,5888,+
chr12,112327923,1.5954976781748436,1089,507,1596,+
chr12,112327932,2.167726872036785,1357,822,2179,+
chr12,112330789,8.558396464646464,1426,703,2129,+
chr12,112451243,1.2653869320709148,841,560,1401,+
chr12,112451255,0.6650998933738785,1746,1212,2958,+
chr12,112451295,2.1423215068430737,1465,950,2415,+
chr12,112451368,2.129886118805786,691,360,1051,+
chr12,112451371,0.5622837370242215,649,509,1158,+
chr12,112451391,1.7495424836601305,716,458,1174,+
chr12,112451407,1.6832228086795686,1165,820,1985,+
chr12,112451408,1.6832228086795686,1165,820,1985,+
chr12,112457589,1.5008507742045265,766,652,1418,+
chr12,112459965,2.221256038647343,626,413,1039,+
chr12,112459989,0.48569320961292084,833,598,1431,+
chr12,112460049,1.622067448680352,884,615,1499,+
chr12,112460118,1.9382362655510288,1005,585,1590,+
chr12,112460121,1.7388026647694912,1726,1214,2940,+
chr12,112460146,2.246232838486438,1117,866,1983,+
chr12,112460148,2.028047823193381,1803,1458,3261,+
chr12,112460169,1.4875283446712018,927,521,1448,+
chr12,112460172,1.6699633699633698,872,701,1573,+
chr12,112460211,2.160290948275862,593,463,1056,+
chr12,112460223,0.6277056277056278,2029,1616,3645,+
chr12,112460224,1.452987334801762,1110,680,1790,+
chr12,112460225,0.8971831786870083,2727,2183,4910,+
chr12,112460394,0.6992103374012922,1460,994,2454,+
chr12,112460454,0.49436383259383626,969,537,1506,+
chr12,112460455,0.4053938660784174,1265,610,1875,+
chr12,112460496,6.2039867608487,2936,852,3788,+
chr12,112460497,7.841127236592483,3735,1069,4804,+
chr12,112460500,12.207066273563193,9754,7143,16897,+
chr12,112460501,12.207066273563193,9754,7143,16897,+
chr12,112460502,12.207066273563193,9754,7143,16897,+
chr12,112460545,5.622170455388837,3479,3435,6914,+
chr12,112460553,3.915986791735065,6233,6776,13009,+
chr12,112460554,4.019376535484124,3854,4088,7942,+
chr12,112460563,0.4978712747307788,993,1451,2444,+
chr12,112460679,1.655250910562525,838,705,1543,+
chr12,112568316,6.549731946785402,585,417,1002,+
chr12,112572865,2.758470933202417,1330,964,2294,+
chr12,112578668,2.1972578505086244,647,398,1045,+
chr12,112578669,0.5850215289052022,591,456,1047,+
chr12,112578678,1.6959178006109412,787,553,1340,+
chr12,112578684,1.7219015280135823,921,588,1509,+
chr12,112578685,0.36491344873502,1043,750,1793,+
chr12,112578692,1.4709863210943126,1276,925,2201,+
chr12,112578698,1.774971031286211,1331,862,2193,+
chr12,112578811,1.9201974432668059,716,445,1161,+
chr12,112888278,1.5958646295706762,1294,900,2194,+
chr12,112888280,0.9608855086242022,848,596,1444,+
chr12,112892373,2.6743246233886047,841,571,1412,+
chr12,112893830,3.5490323449456107,689,479,1168,+
chr12,112915730,0.8779038235781818,837,609,1446,+
chr12,112926898,1.763255916420389,1072,742,1814,+
chr12,112940057,1.5119911456125925,812,631,1443,+
chr12,112942518,1.9381855723319137,652,368,1020,+
chr12,112944362,2.2827557907331535,1018,818,1836,+
chr12,112944677,2.9658793224952005,603,429,1032,+
chr12,112946195,2.3179223121470014,864,603,1467,+
chr12,112946619,1.4762773506499307,674,547,1221,+
chr12,112947273,2.7030129124820665,784,409,1193,+
chr12,112947275,2.7030129124820665,784,409,1193,+
chr12,118456880,3.158917820605506,765,501,1266,+
chr12,118462758,1.9443454429125229,952,596,1548,+
chr12,118462764,0.5859991901194573,680,448,1128,+
chr12,118465769,1.5182009778411516,1118,735,1853,+
chr12,118465771,1.035201793721973,728,445,1173,+
chr12,118469367,2.389309576837417,595,448,1043,+
chr12,118469368,4.219639278557114,657,498,1155,+
chr12,118469370,4.219639278557114,657,498,1155,+
chr12,118469739,1.4407894736842104,729,399,1128,+
chr12,118469740,1.4407894736842104,729,399,1128,+
chr12,118469741,1.4407894736842104,729,399,1128,+
chr12,118573928,0.5001564177790521,982,504,1486,+
chr12,118573930,1.0256410256410255,699,384,1083,+
chr12,118574001,2.1095700416088765,701,411,1112,+
chr12,118574029,2.6414414414414416,732,443,1175,+
chr12,118574091,2.2443762781186094,877,488,1365,+
chr12,118574129,1.8794933242040395,609,507,1116,+
chr12,118575861,0.6184190091629135,904,684,1588,+
chr12,118577292,1.5061537285479492,1486,917,2403,+
chr12,118577347,2.330679978413384,690,435,1125,+
chr12,118582402,1.793623188405797,662,449,1111,+
chr12,118582412,2.756868131868132,1337,839,2176,+
chr12,118582470,1.2206514192568143,891,666,1557,+
chr12,118582485,0.9160686315380736,3658,2710,6368,+
chr12,118582509,0.7032618979062976,1250,1056,2306,+
chr12,118582652,2.569217391304348,868,689,1557,+
chr12,118582660,1.6911260253542135,985,744,1729,+
chr12,118582682,1.442923000462717,1357,988,2345,+
chr12,118582805,2.1902912621359225,939,720,1659,+
chr12,118582875,1.9231154938993813,1045,964,2009,+
chr12,118582991,0.49333253984765374,729,504,1233,+
chr12,118583006,1.110483870967742,971,743,1714,+
chr12,118583008,1.4585526315789474,1477,1139,2616,+
chr12,118583009,1.10893387109048,1004,772,1776,+
chr12,118583022,1.539839218479699,775,633,1408,+
chr12,118583028,1.4257871064467764,950,781,1731,+
chr12,118583029,1.737519365139587,1248,810,2058,+
chr12,118583138,1.4902797534376482,897,665,1562,+
chr12,118583212,3.262125377324527,4792,3580,8372,+
chr12,118583258,3.669154228855721,1474,1339,2813,+
chr12,118583259,2.841210815154464,4200,3538,7738,+
chr12,118583306,1.624142661179698,739,728,1467,+
chr12,118684022,1.7470524889912558,487,687,1174,+
chr12,118684024,0.8472710845291701,1066,1364,2430,+
chr12,118684025,0.4353668114547383,1273,1574,2847,+
chr12,118684026,0.4083941281375134,1321,1548,2869,+
chr12,118684027,0.43569696381802303,590,844,1434,+
chr12,118684029,0.596706424505286,586,433,1019,+
chr12,118684030,0.45367684523074747,1058,889,1947,+
chr12,118684031,0.596706424505286,586,433,1019,+
chr12,118684035,0.49034531077292637,1530,1334,2864,+
chr12,118684037,0.4811320754716981,866,900,1766,+
chr12,118684044,1.6880533391627501,1187,1306,2493,+
chr12,118684045,1.6880533391627501,1187,1306,2493,+
chr12,118684059,0.6477121815767234,1304,752,2056,+
chr12,118684063,1.5855923306024269,2982,2602,5584,+
chr12,118684066,1.3492978179504052,2826,2233,5059,+
chr12,118684067,1.3492978179504052,2826,2233,5059,+
chr12,118684068,1.7987323851963077,4117,2543,6660,+
chr12,118684080,1.2411427978321976,10932,8471,19403,+
chr12,118684081,1.4059249927429052,8500,6074,14574,+
chr12,118684107,1.3486000691323885,4079,2892,6971,+
chr12,118684113,1.2998639170941066,4775,3494,8269,+
chr12,118684125,1.1901204182170948,6310,4661,10971,+
chr12,118684126,1.0952915479780865,10903,9575,20478,+
chr12,118684130,1.3690222756562411,7951,5866,13817,+
chr12,118684132,0.8085866485579652,15962,13544,29506,+
chr12,120720611,0.9286366533450774,1722,1167,2889,+
chr12,120720613,0.9286366533450774,1722,1167,2889,+
chr12,120720621,0.6467136150234742,1253,780,2033,+
chr12,120720629,2.4552711257913566,668,518,1186,+
chr12,120875915,0.6939201571289774,885,534,1419,+
chr12,120875920,0.7622142685882789,2249,1301,3550,+
chr12,120875923,1.5908426668943387,4281,2220,6501,+
chr12,120875924,1.523393810032017,3831,1873,5704,+
chr12,120875925,1.6184683022170228,5425,2717,8142,+
chr12,120875927,1.6403618100373905,2953,1528,4481,+
chr12,120875937,1.989067010625883,703,602,1305,+
chr12,120876020,1.8140423979892182,2354,1533,3887,+
chr12,120876186,0.6003197953309881,1082,794,1876,+
chr12,120878308,2.762978142076503,808,365,1173,+
chr12,120878309,2.762978142076503,808,365,1173,+
chr12,120878332,0.900210171343078,2048,1588,3636,+
chr12,120878333,0.900210171343078,2048,1588,3636,+
chr12,120878334,0.8342052774955098,2504,1883,4387,+
chr12,120878335,1.637297489276835,1843,881,2724,+
chr12,120878337,1.637297489276835,1843,881,2724,+
chr12,120878340,1.4690026954177895,1089,531,1620,+
chr12,120878342,0.6332332878581173,966,732,1698,+
chr12,120878354,1.4260434011307395,2146,1592,3738,+
chr12,120933915,0.861200060789148,3488,1245,4733,+
chr12,120933918,2.965845724907063,850,268,1118,+
chr12,120933925,3.5681475903614457,1052,331,1383,+
chr12,120933926,1.9686760152977607,939,322,1261,+
chr12,120933970,2.6916451335055984,1249,515,1764,+
chr12,120933982,2.2576548220657036,3763,1906,5669,+
chr12,120934003,1.5162113966118185,1968,948,2916,+
chr12,120934008,1.5757925869547504,4735,2477,7212,+
chr12,120934013,2.5332389245432725,4758,2552,7310,+
chr12,120934014,2.439746417313716,7285,4011,11296,+
chr12,120934016,2.005830699226287,8001,4543,12544,+
chr12,120934210,4.392923731852872,692,492,1184,+
chr12,120934314,1.8066808813077468,1639,1004,2643,+
chr12,120936000,0.5177311246936546,796,638,1434,+
chr12,120936039,1.8295279959030384,2065,1615,3680,+
chr12,120936076,1.4257263114669951,1239,954,2193,+
chr12,121001182,1.4397844402866165,633,500,1133,+
chr12,121134386,44.28101858784045,690,435,1125,+
chr12,121134387,40.0037230923163,782,544,1326,+
chr12,122326817,2.3886976139904395,1066,669,1735,+
chr12,122326856,3.052631578947368,749,474,1223,+
chr12,122326858,3.052631578947368,749,474,1223,+
chr12,122353769,2.214699515032134,767,524,1291,+
chr12,122354196,1.0262429200755192,708,453,1161,+
chr12,122354197,2.295145631067961,787,514,1301,+
chr12,122354198,1.6967719318550347,1495,967,2462,+
chr12,123089456,2.050574712643678,668,494,1162,+
chr12,123089457,2.0930120731170625,950,661,1611,+
chr12,123089464,3.0315421552759276,1137,864,2001,+
chr12,123089466,2.8099547511312224,809,662,1471,+
chr12,123089491,1.9741686151645386,1014,819,1833,+
chr12,123105118,1.449606721241143,944,709,1653,+
chr12,123105132,0.942515938871624,1568,1273,2841,+
chr12,123105133,0.942515938871624,1568,1273,2841,+
chr12,123105151,0.5427547363031234,635,557,1192,+
chr12,123253454,4.402588127053347,573,462,1035,+
chr12,123254799,1.2359439417682867,663,510,1173,+
chr12,123466167,1.7433143109400706,1065,793,1858,+
chr12,123466173,1.5732337470134066,1266,944,2210,+
chr12,123466605,0.4286481098075301,859,566,1425,+
chr12,123467016,1.762277182469148,806,678,1484,+
chr12,123467018,1.897196261682243,755,427,1182,+
chr12,123467027,2.498625193332188,1076,1057,2133,+
chr12,123467167,1.7981520966595597,659,401,1060,+
chr12,123467384,7.072369889234373,2013,1444,3457,+
chr12,123467385,6.327411709605602,2410,1729,4139,+
chr12,124069184,0.33592406650272877,648,600,1248,+
chr12,124069199,0.3793140341588879,1196,992,2188,+
chr12,124069200,1.3928494523407093,1077,938,2015,+
chr12,124071293,2.163909961447581,695,472,1167,+
chr12,124071308,1.6418748245860229,599,508,1107,+
chr12,124071395,1.6009271519889638,2269,1522,3791,+
chr12,124074891,1.9953007518796992,1350,979,2329,+
chr12,124074894,1.7291389627659577,1386,1023,2409,+
chr12,124074904,1.6551636680668935,3262,2293,5555,+
chr12,124074906,1.6765045673770014,4882,3567,8449,+
chr12,124074989,1.6293686583990978,1106,886,1992,+
chr12,124081164,0.6630825422868081,1578,1112,2690,+
chr12,124082086,1.4215239282317054,698,708,1406,+
chr12,124082199,1.671163475699558,787,678,1465,+
chr12,124082405,1.56231884057971,945,644,1589,+
chr12,124082410,1.577060931899642,799,557,1356,+
chr12,124082416,0.7455617945663887,955,652,1607,+
chr12,124496285,2.8138581168232912,691,479,1170,+
chr12,124496287,2.8138581168232912,691,479,1170,+
chr12,124496922,1.4129740383308413,605,446,1051,+
chr12,124498741,1.1241396933248593,337,1145,1482,+
chr12,124498742,1.064509048664496,418,1366,1784,+
chr12,124498743,0.4933507226545796,354,1062,1416,+
chr12,124498744,0.24571674096353183,304,865,1169,+
chr12,124498903,9.929298722999693,748,631,1379,+
chr12,124498904,7.438481464811011,1413,1172,2585,+
chr12,124498905,6.0009788309598004,1065,950,2015,+
chr12,124499157,1.9749542814934746,972,809,1781,+
chr12,124499219,0.5963963963963964,661,479,1140,+
chr12,124499246,1.7424242424242427,804,615,1419,+
chr12,124499253,2.469725343320849,964,800,1764,+
chr12,124499278,1.759797541277038,3762,3688,7450,+
chr12,124499279,1.759797541277038,3762,3688,7450,+
chr12,124499280,1.759797541277038,3762,3688,7450,+
chr12,124499389,27.592844372760425,1358,1099,2457,+
chr12,124499390,18.605678597900344,3406,2763,6169,+
chr12,124499391,18.605678597900344,3406,2763,6169,+
chr12,124499392,16.05062868231751,2417,2134,4551,+
chr12,125570907,2.7621573828470383,709,376,1085,+
chr12,125570909,2.7621573828470383,709,376,1085,+
chr12,130649799,0.41445973485997195,570,439,1009,+
chr12,130649930,0.37118101839509465,1070,604,1674,+
chr12,130649932,0.37118101839509465,1070,604,1674,+
chr12,130649937,2.7895545314900154,907,619,1526,+
chr12,130649938,2.7895545314900154,907,619,1526,+
chr12,130649955,0.9401222307104659,1662,849,2511,+
chr12,130649956,0.9401222307104659,1662,849,2511,+
chr12,130649972,0.5302871148459384,698,475,1173,+
chr12,130649994,2.1794839731566005,1375,726,2101,+
chr12,130650051,2.1373756481952033,7616,5228,12844,+
chr12,130650052,2.1835910636919995,8541,5739,14280,+
chr12,130650056,1.4471762097300118,1706,901,2607,+
chr12,130650059,2.0896618625277164,1773,983,2756,+
chr12,130650065,0.6486463871698771,2583,1924,4507,+
chr12,131356626,0.8384099122354155,671,446,1117,+
chr12,131356627,1.5312031765058436,996,567,1563,+
chr12,131356630,1.1647424192308073,4161,3002,7163,+
chr12,131357152,1.2426307287816232,5818,4478,10296,+
chr12,131357166,1.288620044498382,2754,2471,5225,+
chr12,131357603,1.2711850172167634,2815,1943,4758,+
chr12,131357604,1.2868001992555833,4608,3562,8170,+
chr12,131357661,1.4795762807836714,8039,5703,13742,+
chr12,131357663,1.4795762807836714,8039,5703,13742,+
chr12,131357664,1.227378973613131,7787,4812,12599,+
chr12,131359274,1.6744308808973938,3119,2164,5283,+
chr12,131360155,0.26289250500673156,615,428,1043,+
chr12,131360503,1.2019945138591703,7968,5817,13785,+
chr12,131360504,1.1920681100666417,13915,9350,23265,+
chr12,131360607,1.5550909908931536,2202,1498,3700,+
chr12,132425857,2.905936985751555,611,446,1057,+
chr12,132425859,3.474218319368743,951,708,1659,+
chr12,133298457,0.36301567490123604,1085,608,1693,+
chr12,133298458,0.36301567490123604,1085,608,1693,+
chr12,133299103,1.4357376306033938,1254,676,1930,+
chr12,133402795,1.464424286381832,729,454,1183,+
chr13,21715098,0.8463725341261745,1299,780,2079,+
chr13,21715099,0.8463725341261745,1299,780,2079,+
chr13,21715114,0.6436688311688311,792,483,1275,+
chr13,21715126,2.094740222252804,4427,2824,7251,+
chr13,21715128,1.755799652232919,2069,1240,3309,+
chr13,21720953,1.5731535204641682,1407,910,2317,+
chr13,21720958,1.7068399798081777,1622,1131,2753,+
chr13,21720961,1.8342775393419168,1704,1164,2868,+
chr13,21721001,1.7129943502824858,1894,1297,3191,+
chr13,21721004,1.6582974653275946,2043,1427,3470,+
chr13,21721005,1.3047891051441804,3563,2590,6153,+
chr13,21721029,1.8939985135637312,3218,2483,5701,+
chr13,21721408,1.8566283823243135,762,466,1228,+
chr13,21721428,4.624955116696588,830,556,1386,+
chr13,21721438,1.647900132275132,642,431,1073,+
chr13,21751275,2.5274111714587133,966,591,1557,+
chr13,21751277,2.6995416680726576,1293,855,2148,+
chr13,21751348,2.4405648837985097,707,528,1235,+
chr13,21751350,2.2392344497607657,1091,835,1926,+
chr13,21751352,2.2651051370774558,739,577,1316,+
chr13,25901073,1.6299405003619414,615,469,1084,+
chr13,25915824,1.647729520766025,562,455,1017,+
chr13,27825693,0.4734186453640386,1367,511,1878,+
chr13,27825694,0.5648704019842813,2657,1045,3702,+
chr13,27825696,0.928713288121322,897,472,1369,+
chr13,27825697,1.9741217219198415,1208,469,1677,+
chr13,27825698,1.9741217219198415,1208,469,1677,+
chr13,27825704,2.0352694939033418,1229,498,1727,+
chr13,27825705,2.5401884913033483,1791,420,2211,+
chr13,27825707,2.532302699759783,4282,1499,5781,+
chr13,27825708,2.045706497046797,2873,709,3582,+
chr13,27825710,2.4449366712996192,4460,1338,5798,+
chr13,27825711,2.307578368611533,5185,1855,7040,+
chr13,27825713,2.313008014551242,2358,963,3321,+
chr13,27825714,2.069921948015062,2724,984,3708,+
chr13,27825717,1.6300985462690498,4475,2220,6695,+
chr13,27827907,1.6315546227806283,9760,5192,14952,+
chr13,27827908,1.7202562929061784,5318,2374,7692,+
chr13,27827909,1.5165626193038315,10577,5245,15822,+
chr13,27827911,1.5315071390104378,17644,10113,27757,+
chr13,27827912,1.5318182612103914,15791,9261,25052,+
chr13,27827913,1.5299608706320151,13547,8550,22097,+
chr13,27827919,1.4247196052041275,5773,2971,8744,+
chr13,27827920,1.4618856109376146,14102,7614,21716,+
chr13,27827922,1.4521596051433665,11285,6178,17463,+
chr13,27830424,1.3818131813725418,14575,10590,25165,+
chr13,27999038,1.7149988018963778,764,495,1259,+
chr13,28001287,1.5544394968810453,694,612,1306,+
chr13,28009573,0.5309610535163911,757,497,1254,+
chr13,28197166,2.506256578177991,738,502,1240,+
chr13,28197355,0.46837753902884716,1540,964,2504,+
chr13,29233308,2.040751149718958,638,411,1049,+
chr13,29233318,1.7215277777777782,736,479,1215,+
chr13,29233321,2.842153284671533,800,547,1347,+
chr13,29236561,2.7167701863354035,728,574,1302,+
chr13,29236567,0.6154026904775892,775,586,1361,+
chr13,29236632,0.6096973484536782,2294,1588,3882,+
chr13,29242685,1.7772118742724097,1061,858,1919,+
chr13,29246510,1.523581597587489,1296,1163,2459,+
chr13,29246534,1.9530463946338732,1746,1788,3534,+
chr13,29246541,1.498257868472513,7684,7744,15428,+
chr13,29246542,1.3306369038581132,12915,13608,26523,+
chr13,29246544,1.675321843466585,4026,4908,8934,+
chr13,29246546,0.6159572998173062,3737,3714,7451,+
chr13,29246547,1.5907053197848176,2128,1911,4039,+
chr13,34398069,1.901174704309738,905,657,1562,+
chr13,34410372,1.9582059049816518,1263,888,2151,+
chr13,37574954,4.583450475392428,555,775,1330,+
chr13,37580114,0.9509885825675299,682,531,1213,+
chr13,37580115,0.9509885825675299,682,531,1213,+
chr13,37581124,2.0717488789237666,593,445,1038,+
chr13,38935701,1.485610019902658,6309,4488,10797,+
chr13,38935702,1.4786630278819777,8095,5602,13697,+
chr13,38936151,2.4075039082855656,659,504,1163,+
chr13,38936153,2.9638323679293115,805,626,1431,+
chr13,40293895,1.6443445692883896,783,444,1227,+
chr13,40293903,0.3876500857632933,903,582,1485,+
chr13,40293904,2.177631578947368,992,569,1561,+
chr13,40293910,1.706921944035346,1158,678,1836,+
chr13,40293915,1.6320608454000294,1267,794,2061,+
chr13,40293924,1.6406239682458696,6056,3962,10018,+
chr13,40293925,1.6406239682458696,6056,3962,10018,+
chr13,45725896,2.8736577598646567,802,590,1392,+
chr13,45781637,2.4549519386283447,1447,1072,2519,+
chr13,45827046,1.4711820851688695,1144,907,2051,+
chr13,45827065,1.6417974054696471,4158,3592,7750,+
chr13,45827066,1.6857027437013588,2941,2526,5467,+
chr13,45827083,2.298904538341158,2033,1916,3949,+
chr13,45857770,4.224579053741282,887,609,1496,+
chr13,45857807,1.6273904532449932,654,457,1111,+
chr13,45857959,11.30438299188822,1672,1174,2846,+
chr13,48827948,1.1755513109914917,676,442,1118,+
chr13,48827950,1.1755513109914917,676,442,1118,+
chr13,48827971,0.4681324625861675,734,618,1352,+
chr13,48828012,1.9388335704125177,657,517,1174,+
chr13,48830380,2.309120896365968,1704,1282,2986,+
chr13,48830449,3.017543859649123,859,531,1390,+
chr13,48832339,2.782399299474606,819,570,1389,+
chr13,48832961,1.5252280767082478,1023,654,1677,+
chr13,49749525,1.4769110962561072,748,560,1308,+
chr13,50098247,2.336805555555556,672,431,1103,+
chr13,50098249,2.336805555555556,672,431,1103,+
chr13,50098302,0.6268684603886396,609,445,1054,+
chr13,50098316,1.8615963124696748,2265,1831,4096,+
chr13,50098317,1.8111108566289866,3342,2728,6070,+
chr13,50098318,1.917967029145123,3079,2536,5615,+
chr13,50098319,1.8843795093795093,2358,1979,4337,+
chr13,53035920,0.8564397841665707,631,477,1108,+
chr13,53049034,3.48825272107203,940,599,1539,+
chr13,53049035,4.477886977886978,728,443,1171,+
chr13,53049036,4.477886977886978,728,443,1171,+
chr13,53231689,1.561686229002443,662,540,1202,+
chr13,53236793,1.2616487455197132,703,539,1242,+
chr13,53236794,1.2616487455197132,703,539,1242,+
chr13,53241013,0.3476841460926341,1703,844,2547,+
chr13,53241020,1.5653792939916027,2698,1367,4065,+
chr13,53250436,1.5356643356643356,975,519,1494,+
chr13,53250437,0.3999747251358524,632,385,1017,+
chr13,53250441,1.8680333119795005,728,445,1173,+
chr13,53250443,1.8277283575612933,647,418,1065,+
chr13,53254110,0.9578513238835348,3759,2048,5807,+
chr13,53254112,0.899287897331556,5023,2751,7774,+
chr13,53254114,2.1024498886414253,766,448,1214,+
chr13,73633241,4.037872953745117,976,2503,3479,+
chr13,73633242,3.4051091258369968,1116,3029,4145,+
chr13,73633243,2.8649536101966575,996,3230,4226,+
chr13,73633244,2.239528691781911,537,2096,2633,+
chr13,73633245,0.31489443597753053,598,1887,2485,+
chr13,73637989,1.118872549019608,912,503,1415,+
chr13,73637990,1.118872549019608,912,503,1415,+
chr13,73649846,1.8849709563936845,1279,718,1997,+
chr13,73649847,1.8849709563936845,1279,718,1997,+
chr13,73649848,0.5752453308008864,825,485,1310,+
chr13,73650120,2.2721960385594326,672,441,1113,+
chr13,76335110,2.695361263024374,635,438,1073,+
chr13,76370798,0.5372050816696915,591,463,1054,+
chr13,76391323,1.686974042906246,992,766,1758,+
chr13,76391329,2.2986857825567504,739,464,1203,+
chr13,76391395,1.9416209808860567,623,396,1019,+
chr13,76391402,1.8966210045662097,648,437,1085,+
chr13,76395733,1.7922794117647058,545,475,1020,+
chr13,76397889,1.1227468981564466,755,598,1353,+
chr13,76397946,0.6034285714285714,626,474,1100,+
chr13,76409448,1.7948780487804878,668,409,1077,+
chr13,76412302,1.0175467775467777,643,480,1123,+
chr13,76412304,1.0175467775467777,643,480,1123,+
chr13,76415947,2.9528023598820057,571,451,1022,+
chr13,76423229,4.405417607223476,573,442,1015,+
chr13,76423263,2.7942583732057416,583,512,1095,+
chr13,76427264,0.5496651785714286,590,447,1037,+
chr13,76429434,2.9880668257756566,625,418,1043,+
chr13,76429436,2.9880668257756566,625,418,1043,+
chr13,76432323,2.238457340382323,1067,793,1860,+
chr13,76432548,2.036136698869424,917,700,1617,+
chr13,76432554,0.6068281938325991,550,453,1003,+
chr13,80127205,0.4981542518127884,686,409,1095,+
chr13,80127364,1.9215344915679442,2144,948,3092,+
chr13,80127365,1.9695678636640288,1617,681,2298,+
chr13,80127419,0.4665548242784015,1495,755,2250,+
chr13,80127420,0.45544516347114256,2706,1206,3912,+
chr13,80127421,0.4665548242784015,1495,755,2250,+
chr13,80127484,1.7169702780441036,2419,1399,3818,+
chr13,80127486,1.2932958980836355,4395,2222,6617,+
chr13,80127489,0.9514157679107065,7857,3672,11529,+
chr13,80127490,1.366483276719174,2365,1600,3965,+
chr13,97874626,1.7024068072336507,593,419,1012,+
chr13,97927954,2.0438144329896906,609,484,1093,+
chr13,97927985,0.528331119964586,681,501,1182,+
chr13,97928007,3.7348244747414867,616,539,1155,+
chr13,97928458,2.1430940461094923,909,642,1551,+
chr13,98009773,2.975106189708964,579,437,1016,+
chr13,98009784,1.5243564885428664,716,562,1278,+
chr13,98043583,1.105746710937832,920,646,1566,+
chr13,98043587,1.6975206611570248,631,483,1114,+
chr13,98044232,0.5241218151665913,817,602,1419,+
chr13,98044274,2.6453263087843837,641,486,1127,+
chr13,98044458,1.3221764203702486,1251,928,2179,+
chr13,98044744,1.457253480517341,1381,994,2375,+
chr13,98045202,1.435504788507582,1085,715,1800,+
chr13,98045232,0.48730271576851975,1070,540,1610,+
chr13,98045242,0.5537854428529669,1262,621,1883,+
chr13,98045296,1.364054996381817,1884,1125,3009,+
chr13,98045383,0.4168550873586845,675,416,1091,+
chr13,98045931,2.1864551967921577,997,660,1657,+
chr13,98046067,4.007900207900208,713,480,1193,+
chr13,98046119,2.615384615384615,713,454,1167,+
chr13,98628974,1.072733167621312,708,486,1194,+
chr13,98628975,1.072733167621312,708,486,1194,+
chr13,98628977,1.9342028796286221,803,611,1414,+
chr13,98634769,1.513153961136024,763,668,1431,+
chr13,98634786,1.4965433805737989,1236,788,2024,+
chr13,98634787,1.688604353393086,941,780,1721,+
chr13,98637681,1.519002408323652,2847,2086,4933,+
chr13,98641326,0.7403846153846154,1847,895,2742,+
chr13,98641327,1.6608847497089638,1296,858,2154,+
chr13,98642390,1.304973610928449,7788,4884,12672,+
chr13,98642392,1.304973610928449,7788,4884,12672,+
chr13,98642416,0.7443626709681755,6644,3814,10458,+
chr13,98642417,0.7443626709681755,6644,3814,10458,+
chr13,98642421,1.4014053746828388,27669,16034,43703,+
chr13,98642759,1.566382978723404,1226,892,2118,+
chr13,98645149,1.7581013235965313,1283,938,2221,+
chr13,98645200,1.985480943738657,1093,816,1909,+
chr13,98645252,1.7185701830863125,1119,774,1893,+
chr13,98649818,0.7070989948776439,1542,1242,2784,+
chr13,98649854,2.1866394475090125,2075,1770,3845,+
chr13,98652863,2.006806028196402,1151,747,1898,+
chr13,98654726,1.7790097205346291,1104,822,1926,+
chr13,98654727,0.6672866775168566,1229,758,1987,+
chr13,98654743,1.47901376146789,1432,871,2303,+
chr13,98655193,0.6532873676434375,1136,785,1921,+
chr13,98655201,2.5330859616573904,1023,769,1792,+
chr13,98655260,0.6966416768665851,1400,911,2311,+
chr13,98660326,1.7252147315633168,1701,1060,2761,+
chr13,98662238,1.4359281437125748,1198,834,2032,+
chr13,98664583,1.6074561403508771,1465,892,2357,+
chr13,98666373,1.6839351323897112,2652,1945,4597,+
chr13,98666375,2.0009930486593843,1239,847,2086,+
chr13,98666383,0.6619666048237477,1560,1077,2637,+
chr13,98666419,1.1152943295330822,6747,4275,11022,+
chr13,98666425,0.726460619206208,3034,1666,4700,+
chr13,98667790,1.7981480308978093,10421,5959,16380,+
chr13,98667791,1.7981480308978093,10421,5959,16380,+
chr13,98667818,1.6132029157988694,5560,3360,8920,+
chr13,98667847,1.7932077169132348,8441,5247,13688,+
chr13,98667880,1.9634682989563959,26831,22077,48908,+
chr13,98667881,1.9634682989563959,26831,22077,48908,+
chr13,98669050,1.4761690647482013,1406,1111,2517,+
chr13,98669051,1.5263273278061225,1444,1023,2467,+
chr13,98670784,1.5480755243941466,1003,928,1931,+
chr13,98670947,0.693913606511886,1530,1137,2667,+
chr13,98672018,1.684972734586847,1153,906,2059,+
chr13,98673292,2.609151973131822,2259,1984,4243,+
chr13,98673294,2.609151973131822,2259,1984,4243,+
chr13,98673380,1.6498368805344106,1179,784,1963,+
chr13,98674060,1.81046949535526,1848,1137,2985,+
chr13,98674061,0.3096892138939671,846,546,1392,+
chr13,98674062,1.81046949535526,1848,1137,2985,+
chr13,98674064,2.2348569305091046,969,584,1553,+
chr13,98674073,1.551661802252321,2173,1415,3588,+
chr13,98674082,1.8023274608049131,1238,806,2044,+
chr13,98674105,0.7215423465423466,2184,1143,3327,+
chr13,98674120,1.184846592547255,11476,7165,18641,+
chr13,98674121,1.184846592547255,11476,7165,18641,+
chr13,98674125,0.5050712852527227,7793,4298,12091,+
chr13,98674126,0.5050712852527227,7793,4298,12091,+
chr13,98674165,1.9670225706176512,1531,1207,2738,+
chr13,98674274,2.0762628394540594,867,617,1484,+
chr13,98674311,0.6368526622902991,1269,913,2182,+
chr13,98674502,1.5978676872607982,834,707,1541,+
chr13,98674650,2.6526315789473687,755,569,1324,+
chr13,98674849,1.8487858719646797,669,452,1121,+
chr13,98674921,0.5022920759659463,766,508,1274,+
chr13,98674959,2.0493683639463693,852,560,1412,+
chr13,98996101,1.3801711381329216,691,470,1161,+
chr13,98996102,1.1848501138189118,842,580,1422,+
chr13,98996106,1.9393188046457,846,868,1714,+
chr13,98996107,1.9393188046457,846,868,1714,+
chr13,98996108,1.9393188046457,846,868,1714,+
chr13,98996110,0.9503454685069204,1240,846,2086,+
chr13,98996111,1.4087860873365379,1672,1654,3326,+
chr13,98996112,1.5565364267958444,866,1081,1947,+
chr13,99992594,1.7650816975485573,1175,716,1891,+
chr13,100020046,1.1652620782418623,961,752,1713,+
chr13,100020052,0.3453159041394335,633,485,1118,+
chr13,100020144,0.4302452146600114,626,462,1088,+
chr13,100037684,1.5724196990488604,1327,795,2122,+
chr13,100037685,0.9022843599886945,1030,609,1639,+
chr13,100037731,1.8979591836734693,712,489,1201,+
chr13,100037742,1.6385137163095027,852,616,1468,+
chr13,100037743,2.7678385416666664,732,511,1243,+
chr13,100037764,0.6799557032115172,1227,902,2129,+
chr13,100038023,1.7971887550200802,536,497,1033,+
chr13,100038074,0.5186915887850467,628,427,1055,+
chr13,100038537,6.721211505774483,1235,889,2124,+
chr13,100038538,6.280330392503469,1907,1305,3212,+
chr13,100038539,6.233529819694868,764,411,1175,+
chr13,100038541,4.653697998850445,1328,994,2322,+
chr13,100038557,0.5240706886045094,644,546,1190,+
chr13,100038558,1.958490566037736,864,529,1393,+
chr13,100038559,1.399459538720584,1325,940,2265,+
chr13,100154007,0.6856439393939393,786,549,1335,+
chr13,100154008,0.9232421095322829,1682,1075,2757,+
chr13,100154009,0.8534017077635252,2541,1604,4145,+
chr13,100154011,1.4002089222447798,1580,993,2573,+
chr13,100172329,1.7025739544594363,1201,940,2141,+
chr13,100172337,0.512280701754386,802,569,1371,+
chr13,100181733,2.5552797833935017,754,553,1307,+
chr13,100188954,0.5829776550338941,773,568,1341,+
chr13,100191717,2.72289480764057,697,412,1109,+
chr13,100191756,0.4288419913419913,633,447,1080,+
chr13,100191757,1.614129586260734,712,426,1138,+
chr13,100191776,0.4713748894783378,852,521,1373,+
chr13,100192993,2.666494668042656,837,611,1448,+
chr13,100192994,2.666494668042656,837,611,1448,+
chr13,100193902,2.695544554455445,604,504,1108,+
chr13,100199354,2.372693633486742,818,668,1486,+
chr13,100204475,0.6074052306788128,688,497,1185,+
chr13,100206585,1.7362825137649516,589,457,1046,+
chr13,100207846,2.743090243090243,658,461,1119,+
chr13,100211638,2.193362193362193,854,566,1420,+
chr13,100211641,3.0604547975596232,889,600,1489,+
chr13,100214983,1.883478260869565,721,459,1180,+
chr13,100215124,1.8764302059496565,614,436,1050,+
chr13,103506183,2.5826566125290022,684,430,1114,+
chr13,103506184,2.5826566125290022,684,430,1114,+
chr13,103506196,2.943597611500953,862,603,1465,+
chr13,109917942,2.372817008352316,624,438,1062,+
chr13,109917943,4.389361530127073,1013,722,1735,+
chr13,109917947,1.5255576723381699,678,405,1083,+
chr13,109920060,1.4499751737835154,636,428,1064,+
chr13,111086755,1.4555832959205557,690,472,1162,+
chr13,111138174,3.656441717791411,595,488,1083,+
chr13,111158883,1.50555667774156,892,573,1465,+
chr13,111164312,1.2673700442781206,546,511,1057,+
chr13,111165042,0.9927953890489912,953,693,1646,+
chr13,111165043,0.9927953890489912,953,693,1646,+
chr13,111165277,1.2541576811379276,633,507,1140,+
chr13,113730409,2.066285128555565,589,508,1097,+
chr13,113730411,2.066285128555565,589,508,1097,+
chr13,113864064,2.125275278255548,798,484,1282,+
chr13,113864286,1.7817632668729244,1066,742,1808,+
chr13,113873263,1.7310606060606062,913,527,1440,+
chr13,113873272,1.5746590562502722,1111,777,1888,+
chr13,113873280,2.1616345062429057,1241,880,2121,+
chr13,113873301,1.36796875,1750,1279,3029,+
chr13,113873325,1.5673061354027538,2868,1940,4808,+
chr13,113883808,1.8138329430132707,1095,914,2009,+
chr13,113884394,0.4707140666133726,684,535,1219,+
chr13,113884412,0.4100435180943655,650,471,1121,+
chr13,113884427,1.7005300353356891,769,565,1334,+
chr13,113898755,2.1626111761591726,1637,1319,2956,+
chr13,113898759,1.633756345177665,1098,787,1885,+
chr13,113899493,2.453191489361702,1152,845,1997,+
chr13,113899495,2.453191489361702,1152,845,1997,+
chr13,113909015,0.649232411389822,939,600,1539,+
chr13,113909273,2.185385037497713,884,496,1380,+
chr13,113909293,1.7485742105995272,810,552,1362,+
chr13,113909330,1.7653411197626994,928,695,1623,+
chr13,113917902,2.2804642166344293,785,516,1301,+
chr13,113917930,1.6533936651583712,755,509,1264,+
chr13,113918076,1.4491802013394457,1882,1301,3183,+
chr13,113918258,2.3900466562986,903,642,1545,+
chr13,113918283,1.50657309337237,1614,1105,2719,+
chr13,113918406,2.089028776978417,605,416,1021,+
chr13,113918777,0.3974473341110272,1085,740,1825,+
chr13,113960837,1.9681096845055484,1180,676,1856,+
chr13,113960839,1.9681096845055484,1180,676,1856,+
chr13,113960895,0.3126876876876877,713,431,1144,+
chr13,113964019,1.650943396226415,629,423,1052,+
chr13,113965023,1.586941843868475,1954,1373,3327,+
chr13,113965073,2.1643835616438354,710,583,1293,+
chr13,113976734,1.5713110758641249,784,563,1347,+
chr13,113977191,5.693396226415094,441,688,1129,+
chr13,113977192,5.631835021088496,2039,2697,4736,+
chr13,113977193,5.4965557303614245,2304,2966,5270,+
chr13,113977194,6.351620377416332,1013,1663,2676,+
chr13,113977195,5.528528528528529,525,517,1042,+
chr13,113977201,0.458593882034815,602,969,1571,+
chr13,113977202,0.4097081423911204,1389,2053,3442,+
chr13,113977203,0.458593882034815,602,969,1571,+
chr13,113977204,0.3053391465942391,533,822,1355,+
chr13,113977214,0.47908752884576905,906,823,1729,+
chr13,113977223,0.3931150476699627,1189,960,2149,+
chr13,113977225,0.166120218579235,455,548,1003,+
chr13,113977319,0.6078799249530957,737,532,1269,+
chr13,113977423,2.416326530612245,591,419,1010,+
chr13,113977499,2.3924391603195243,1197,768,1965,+
chr13,113977500,0.5111810872588354,1065,856,1921,+
chr13,113977501,2.3924391603195243,1197,768,1965,+
chr13,113977502,0.5111810872588354,1065,856,1921,+
chr13,113977568,1.6419927055702916,638,415,1053,+
chr13,113977576,1.6322528822528821,986,571,1557,+
chr13,114152827,1.251345640819083,864,593,1457,+
chr13,114240115,2.236966951726618,634,412,1046,+
chr13,114265356,1.4404747784868044,963,821,1784,+
chr13,114287444,1.3371377662807324,577,502,1079,+
chr13,114287586,1.292920648817465,897,654,1551,+
chr13,114288238,1.7195512820512817,702,493,1195,+
chr13,114288265,2.094778779618369,665,501,1166,+
chr13,114295051,1.3639147847245388,1092,737,1829,+
chr13,114295055,2.234437464306111,625,411,1036,+
chr13,114295218,1.0124610108185605,1100,944,2044,+
chr13,114295604,1.0832696715049657,708,461,1169,+
chr13,114295606,1.0832696715049657,708,461,1169,+
chr13,114295643,0.22865685394114324,3230,2109,5339,+
chr14,20822339,1.5696794815012398,683,459,1142,+
chr14,20823074,2.6836898037871504,971,731,1702,+
chr14,20923402,0.7743723704221059,1125,887,2012,+
chr14,20923405,2.581071428571428,802,559,1361,+
chr14,20923406,2.581071428571428,802,559,1361,+
chr14,20923433,1.0137767013859562,904,768,1672,+
chr14,20923458,0.5432476020711314,799,560,1359,+
chr14,20923513,1.6406124093473005,1017,656,1673,+
chr14,20923748,1.631484794275492,1139,714,1853,+
chr14,20923838,2.1156753238162826,1298,826,2124,+
chr14,20923845,5.78966301730091,5352,4504,9856,+
chr14,20923846,5.432673249311727,6869,5506,12375,+
chr14,20923847,5.432673249311727,6869,5506,12375,+
chr14,20924083,0.6691795231416549,693,712,1405,+
chr14,20924087,0.8950997202418554,1625,1582,3207,+
chr14,20924089,0.8950997202418554,1625,1582,3207,+
chr14,20924092,0.6052143858946103,894,867,1761,+
chr14,20924104,1.725663361567179,976,858,1834,+
chr14,20924105,1.0977268273564569,1806,1214,3020,+
chr14,20924106,1.0977268273564569,1806,1214,3020,+
chr14,20924107,1.801053590010406,1085,960,2045,+
chr14,20924164,2.1654352714423384,748,565,1313,+
chr14,20924165,1.36299421251138,2296,1863,4159,+
chr14,20924166,1.4825533219447982,3423,2533,5956,+
chr14,20924196,1.0545048394751386,2884,2029,4913,+
chr14,20924200,1.0008170016707894,3173,2182,5355,+
chr14,20924207,0.6485219221706567,3485,2348,5833,+
chr14,20924996,2.960064218342364,589,452,1041,+
chr14,20924999,2.8856292517006805,616,503,1119,+
chr14,20925162,2.054907975460123,1217,814,2031,+
chr14,20925290,0.6527093596059113,1059,753,1812,+
chr14,20925357,1.2256959704407622,3564,2648,6212,+
chr14,20925358,1.453944443572725,2481,1892,4373,+
chr14,20925484,1.587375899872959,1322,801,2123,+
chr14,20925535,2.622863247863248,981,719,1700,+
chr14,20925643,1.5864642305712815,684,535,1219,+
chr14,20925676,0.652020202020202,1290,989,2279,+
chr14,20925696,1.7554480214193178,2341,1703,4044,+
chr14,20925727,0.7286036235870318,2160,1550,3710,+
chr14,20937565,0.4039999600387871,10919,4654,15573,+
chr14,20937568,1.494889536678917,7199,3253,10452,+
chr14,20937588,2.6263054985931613,3164,1612,4776,+
chr14,20937591,1.7914288288967446,16950,8104,25054,+
chr14,20937592,1.7914288288967446,16950,8104,25054,+
chr14,20937595,1.560427148565287,35588,19224,54812,+
chr14,20937596,1.560427148565287,35588,19224,54812,+
chr14,20937634,0.7186395357410658,3538,2249,5787,+
chr14,20937639,1.9405003625815809,3436,1969,5405,+
chr14,20937641,1.9405003625815809,3436,1969,5405,+
chr14,20937644,2.163078786544073,1636,885,2521,+
chr14,20940572,3.2645403377110696,811,532,1343,+
chr14,20943047,0.40531286043829284,864,543,1407,+
chr14,20943048,1.8224186420249096,647,392,1039,+
chr14,20943052,0.6277865040530209,2970,1803,4773,+
chr14,20943055,0.647213759171054,3834,2073,5907,+
chr14,20943056,0.7116697727491299,2737,1496,4233,+
chr14,20943098,1.6177068145421516,4319,2460,6779,+
chr14,20943100,1.6601204581149331,7792,4330,12122,+
chr14,20943101,1.7042990440004688,5064,2759,7823,+
chr14,20943255,1.6322857296483495,1462,1093,2555,+
chr14,20943297,0.6037894736842105,955,664,1619,+
chr14,20943359,0.521091811414392,539,467,1006,+
chr14,20944635,0.504569351822448,649,602,1251,+
chr14,20944785,1.7431153367196623,1809,1247,3056,+
chr14,20944871,1.575510204081633,771,489,1260,+
chr14,20944872,1.6033970276008491,589,470,1059,+
chr14,20945065,0.6053566895151052,752,605,1357,+
chr14,20945116,2.448243992606285,882,540,1422,+
chr14,20945121,0.6363878465076866,1010,750,1760,+
chr14,20945155,1.1503430685391531,1729,1462,3191,+
chr14,21093566,0.27627684335717995,696,690,1386,+
chr14,21101221,1.034776980164751,1167,855,2022,+
chr14,21458398,0.4569475498499589,956,649,1605,+
chr14,21458400,0.6037850717965991,642,399,1041,+
chr14,21458738,0.44199850575754196,831,502,1333,+
chr14,21956891,2.936827956989247,569,495,1064,+
chr14,23079813,2.3309713226020197,601,470,1071,+
chr14,23081155,6.236178861788619,666,409,1075,+
chr14,23081156,6.236178861788619,666,409,1075,+
chr14,23081157,6.236178861788619,666,409,1075,+
chr14,23236514,1.48018438697318,574,521,1095,+
chr14,23236515,1.48018438697318,574,521,1095,+
chr14,23236599,2.5715807310578556,1083,764,1847,+
chr14,23236600,2.5715807310578556,1083,764,1847,+
chr14,23237328,1.737364620938628,769,553,1322,+
chr14,23237334,0.370843989769821,782,458,1240,+
chr14,23239020,2.310714285714285,646,489,1135,+
chr14,23239061,2.7057569296375266,610,468,1078,+
chr14,23239068,0.5781640099865566,668,507,1175,+
chr14,23239083,1.9714379613022537,2403,1952,4355,+
chr14,23239119,2.13348271446863,929,780,1709,+
chr14,23239404,1.6845612736023696,1049,875,1924,+
chr14,23239767,1.9735851311779122,687,576,1263,+
chr14,23240107,1.4840468078803142,1088,784,1872,+
chr14,23240272,0.542096536477524,1069,735,1804,+
chr14,23240344,1.6658089748867844,829,693,1522,+
chr14,23240383,2.128456279971432,906,725,1631,+
chr14,23240652,1.6083499005964217,808,502,1310,+
chr14,23240666,1.8206148641926176,630,528,1158,+
chr14,23240679,2.2005109862033723,768,514,1282,+
chr14,23240690,2.63922942206655,684,570,1254,+
chr14,23240704,1.6568503937007872,1502,1269,2771,+
chr14,23240705,1.6568503937007872,1502,1269,2771,+
chr14,23240738,1.5887166702796445,1065,658,1723,+
chr14,23240859,2.168330341113106,973,556,1529,+
chr14,23240889,2.1784332688588006,794,516,1310,+
chr14,23299433,1.8037279149602736,770,517,1287,+
chr14,23302664,1.905267151241467,1140,957,2097,+
chr14,23302666,2.0716783216783217,710,571,1281,+
chr14,23344733,0.35433131101448445,620,451,1071,+
chr14,23346014,1.6584229285745389,654,459,1113,+
chr14,23346414,22.13647818784403,711,296,1007,+
chr14,23346415,22.13647818784403,711,296,1007,+
chr14,23346896,1.9650383430116853,716,522,1238,+
chr14,23347208,3.719659411461574,715,493,1208,+
chr14,23567052,2.2155463946652363,664,434,1098,+
chr14,23567067,1.1122159090909092,782,623,1405,+
chr14,23567069,0.8704445433417396,1213,962,2175,+
chr14,23567071,1.0332438571133595,833,667,1500,+
chr14,23567480,2.620894160583941,765,547,1312,+
chr14,23790811,4.128754593427292,542,577,1119,+
chr14,23790998,2.121837198473821,936,569,1505,+
chr14,23791016,0.6153739612188366,1480,759,2239,+
chr14,23791017,0.6254010670740079,1829,989,2818,+
chr14,23791019,1.828571428571428,935,818,1753,+
chr14,23791021,1.828571428571428,935,818,1753,+
chr14,23791402,1.9716919025674788,598,433,1031,+
chr14,23792216,2.2373922413793106,768,463,1231,+
chr14,23792236,1.968582887700535,588,439,1027,+
chr14,23792264,0.7399154701970291,820,691,1511,+
chr14,23792641,1.698397435897436,756,479,1235,+
chr14,23794471,1.8260609683203821,704,477,1181,+
chr14,23794691,4.008830418779072,1420,497,1917,+
chr14,23794707,9.132795890737425,1332,475,1807,+
chr14,23794708,14.746176156659512,1843,599,2442,+
chr14,23794709,14.612831837694188,1435,488,1923,+
chr14,23794714,33.16248666339594,3010,1872,4882,+
chr14,23794715,29.503059965990264,3261,2003,5264,+
chr14,23794716,24.82065977795408,3570,2237,5807,+
chr14,23794717,12.158441558441556,754,349,1103,+
chr14,23794718,6.832923832923833,617,443,1060,+
chr14,23794734,3.132909781341615,1232,1171,2403,+
chr14,23794789,0.4223899289293683,908,679,1587,+
chr14,23794790,0.4506566315951156,651,448,1099,+
chr14,23794833,8.606723832874321,788,605,1393,+
chr14,23795091,0.4037945759713557,720,554,1274,+
chr14,23795237,0.22193264864675682,739,289,1028,+
chr14,23795264,12.822644129201327,1267,456,1723,+
chr14,23795265,11.809254500857119,2078,772,2850,+
chr14,23795272,6.046955949949571,1416,633,2049,+
chr14,23795277,15.252737226277372,686,547,1233,+
chr14,23795278,14.26112941585885,1797,1139,2936,+
chr14,23795279,18.096270210237847,2393,1728,4121,+
chr14,23945269,1.3914749961180912,763,522,1285,+
chr14,23946470,1.0572466488977448,1745,1213,2958,+
chr14,23946473,1.802346298388102,3303,2317,5620,+
chr14,23946474,2.071532623372822,2755,1902,4657,+
chr14,23946480,1.850686384809878,2281,1518,3799,+
chr14,23946535,1.3370738757119782,1965,1306,3271,+
chr14,23946549,1.4375366568914956,2450,1456,3906,+
chr14,23946557,1.4052933981428193,16828,12352,29180,+
chr14,23946558,1.4134832287098738,12551,8772,21323,+
chr14,24566137,3.8560411311053984,749,388,1137,+
chr14,24566138,3.8560411311053984,749,388,1137,+
chr14,24566145,1.924397327911705,1122,625,1747,+
chr14,24566146,1.924397327911705,1122,625,1747,+
chr14,24566162,1.3833570257872179,2240,1250,3490,+
chr14,24566163,2.2006779506779512,2125,1220,3345,+
chr14,24566165,2.4254333992242234,2922,1671,4593,+
chr14,24566166,2.8308866087871616,1473,904,2377,+
chr14,24566168,1.9452214452214447,1668,857,2525,+
chr14,24566169,1.9452214452214447,1668,857,2525,+
chr14,24566170,3.5714285714285725,789,552,1341,+
chr14,24568853,1.6251990689278157,587,445,1032,+
chr14,24586241,1.623488524745876,1961,1189,3150,+
chr14,24586243,2.407624360762436,1176,716,1892,+
chr14,24586475,2.0957319223985893,1460,944,2404,+
chr14,24586477,2.0957319223985893,1460,944,2404,+
chr14,24606223,1.1221585868127355,1311,928,2239,+
chr14,24606564,1.6845041322314052,1051,879,1930,+
chr14,24606626,2.064541622760801,921,583,1504,+
chr14,24606743,1.743715929739552,852,507,1359,+
chr14,24606767,1.7358288770053474,1081,659,1740,+
chr14,24606935,1.7151299775963669,2346,1552,3898,+
chr14,24607273,2.2135198744769875,626,477,1103,+
chr14,24607279,1.996521192852128,1248,969,2217,+
chr14,24607445,1.8265478198024567,668,592,1260,+
chr14,24607684,1.6469979296066253,687,551,1238,+
chr14,24608020,0.7630031138277015,1653,1130,2783,+
chr14,24705272,2.30275996654586,825,632,1457,+
chr14,24705273,2.086973218282308,1346,947,2293,+
chr14,24707841,1.3375168373689525,2253,1445,3698,+
chr14,24707842,1.5382427602662965,1903,1184,3087,+
chr14,24708201,1.3001954396888489,1224,843,2067,+
chr14,24708202,1.0075450450450452,777,479,1256,+
chr14,31087291,0.14876337999332923,795,396,1191,+
chr14,31107410,1.1615853658536586,634,409,1043,+
chr14,31107411,1.1615853658536586,634,409,1043,+
chr14,31107412,1.1615853658536586,634,409,1043,+
chr14,31142540,2.31541928005465,681,426,1107,+
chr14,31144210,0.9999031007751938,606,429,1035,+
chr14,31144212,0.9999031007751938,606,429,1035,+
chr14,31171560,2.1755343460085568,654,398,1052,+
chr14,31735476,1.1742185113532229,960,643,1603,+
chr14,31735477,1.1742185113532229,960,643,1603,+
chr14,31735478,1.1742185113532229,960,643,1603,+
chr14,35465912,3.3095238095238093,694,503,1197,+
chr14,35465913,2.630748467751755,1225,857,2082,+
chr14,35465936,1.8305809670904123,641,442,1083,+
chr14,35480849,2.4450368223983374,825,613,1438,+
chr14,35487945,1.8023789648136936,988,759,1747,+
chr14,35488264,1.935048155978388,658,472,1130,+
chr14,35492161,2.67698732718894,640,495,1135,+
chr14,35550259,1.967408585055644,809,665,1474,+
chr14,35550261,1.9374075735514564,1200,939,2139,+
chr14,35550269,0.3916371367824238,613,414,1027,+
chr14,35596705,1.3781380753138075,526,477,1003,+
chr14,35761609,1.073603506776968,1618,902,2520,+
chr14,35761610,1.2863466522305622,1249,690,1939,+
chr14,35761611,1.0344473219057015,718,458,1176,+
chr14,35761652,1.332236842105263,728,607,1335,+
chr14,35761657,0.6397555989846575,889,626,1515,+
chr14,35761658,0.5657764589515332,831,673,1504,+
chr14,35761662,1.0141247114945706,2628,1426,4054,+
chr14,35761663,1.0141247114945706,2628,1426,4054,+
chr14,35761676,1.652012040557668,1454,788,2242,+
chr14,35761679,2.002916224814422,1510,827,2337,+
chr14,35761682,1.429170519085986,1602,903,2505,+
chr14,35777215,1.5831706788115374,2189,1748,3937,+
chr14,35777216,1.5831706788115374,2189,1748,3937,+
chr14,35777239,1.4011552580436188,2684,1683,4367,+
chr14,35779978,0.7599051383399208,2252,1264,3516,+
chr14,35779989,1.2981106848040924,2508,1409,3917,+
chr14,35780001,1.3503564202700795,2522,1603,4125,+
chr14,35780002,1.4394791685878163,3121,1837,4958,+
chr14,35780036,0.6637645493847689,4338,2424,6762,+
chr14,35780040,0.9154584304913451,11766,6006,17772,+
chr14,35780041,1.00840127661857,6538,3295,9833,+
chr14,35783616,1.5361336946702804,1610,1106,2716,+
chr14,35783618,1.677118501012829,2037,1480,3517,+
chr14,35786463,1.3488572006472492,2424,1647,4071,+
chr14,36334928,2.042165933565903,747,346,1093,+
chr14,36334929,2.042165933565903,747,346,1093,+
chr14,36334930,2.042165933565903,747,346,1093,+
chr14,39644539,2.143977191732003,751,487,1238,+
chr14,39644540,2.143977191732003,751,487,1238,+
chr14,39646681,1.4208333333333334,681,524,1205,+
chr14,39646683,1.4208333333333334,681,524,1205,+
chr14,39649934,2.0424856065118124,642,437,1079,+
chr14,39650108,0.6187805872756933,866,612,1478,+
chr14,39650298,2.3492023928215358,724,471,1195,+
chr14,39650575,1.8118463723517577,983,767,1750,+
chr14,39650644,1.8559835995558214,775,508,1283,+
chr14,39650662,0.5946408860807674,918,558,1476,+
chr14,39650691,0.49046612784490395,1913,1105,3018,+
chr14,39650713,0.6212310843099328,909,516,1425,+
chr14,39650727,1.5625465229577853,4292,2411,6703,+
chr14,39650728,1.7142374901625725,4507,2419,6926,+
chr14,39650734,1.6098691931190428,1307,712,2019,+
chr14,39650740,1.6259750253594039,2065,1242,3307,+
chr14,39650751,1.6769244492016768,1174,605,1779,+
chr14,39650773,1.6074702886247878,2103,1177,3280,+
chr14,39650779,1.762566844919786,1647,934,2581,+
chr14,39650782,2.4040833333333333,1696,999,2695,+
chr14,39650911,2.9907918968692453,839,542,1381,+
chr14,39650935,1.8795721925133693,908,560,1468,+
chr14,39650971,1.7011016621569384,606,397,1003,+
chr14,39650973,2.4380952380952383,703,538,1241,+
chr14,39651055,0.497453310696095,585,417,1002,+
chr14,39651071,2.052994555353902,605,434,1039,+
chr14,39651143,2.0598529411764708,608,399,1007,+
chr14,39746180,2.531977923869816,1450,665,2115,+
chr14,39746181,2.330092932830747,2182,1051,3233,+
chr14,39746187,0.5413205308015967,668,402,1070,+
chr14,39746197,1.693670150987224,920,503,1423,+
chr14,39777687,2.2977389399339505,811,474,1285,+
chr14,39815120,1.2875045669628482,565,460,1025,+
chr14,50053296,0.9443617645669521,1131,718,1849,+
chr14,50053318,0.7874203138922496,100348,71130,171478,+
chr14,50053319,0.8520101745756301,103880,70765,174645,+
chr14,50053321,1.1463844090153985,58724,36465,95189,+
chr14,50053424,1.1673750510959813,10034,8384,18418,+
chr14,50053425,0.9082140164706518,20639,12004,32643,+
chr14,50053426,0.5726619647497858,10605,3620,14225,+
chr14,50053451,1.6703663454398794,17319,7392,24711,+
chr14,50053453,1.5897620729175113,25993,10212,36205,+
chr14,50053454,1.5041062157809808,23422,11226,34648,+
chr14,50053455,1.9376565959025935,21865,7311,29176,+
chr14,50053456,1.8730495719791465,20033,7345,27378,+
chr14,50053457,1.957675676557694,18386,6450,24836,+
chr14,50053459,1.8026472954024015,19472,8597,28069,+
chr14,50053460,1.2863001620726666,41342,26842,68184,+
chr14,50053462,1.132626538968861,52753,36368,89121,+
chr14,50053464,1.238939223590127,60974,37487,98461,+
chr14,50053465,1.2089444773987035,45171,22319,67490,+
chr14,50053466,1.25297528422981,33256,14039,47295,+
chr14,50053467,0.9657391115437021,95269,58381,153650,+
chr14,50053468,0.9739368252099954,90763,58605,149368,+
chr14,50053469,0.9466913164645343,73109,49771,122880,+
chr14,50053477,0.9969769167637129,85691,55342,141033,+
chr14,50053478,0.9399894034018961,81997,51814,133811,+
chr14,50053488,1.2003299589020855,26745,19773,46518,+
chr14,50053494,1.3764877999866383,44208,31146,75354,+
chr14,50053497,1.3685152321983,71340,48552,119892,+
chr14,50053504,1.347951016415275,171734,119597,291331,+
chr14,50053505,1.524437302088134,83251,41616,124867,+
chr14,50053506,1.2822059734320772,309570,227529,537099,+
chr14,50053507,1.2387798042486486,333597,249808,583405,+
chr14,50053508,1.2128465271181559,364698,277464,642162,+
chr14,50053509,1.1501948246470313,419355,320531,739886,+
chr14,50053511,1.1397164643370248,270517,202148,472665,+
chr14,50053512,1.3035177500080677,57558,32423,89981,+
chr14,50053522,1.2426160994990176,152534,117513,270047,+
chr14,50053527,1.437022960838917,28188,20237,48425,+
chr14,50053546,1.1070297462386856,562500,443371,1005871,+
chr14,50053547,1.1066584789039586,543819,426170,969989,+
chr14,50053551,1.8389783611658346,45611,40029,85640,+
chr14,50081208,2.8802504594169203,829,774,1603,+
chr14,50088732,1.062011011301072,732,475,1207,+
chr14,50088733,1.062011011301072,732,475,1207,+
chr14,50360935,3.3158498963809535,746,443,1189,+
chr14,50361232,2.2490553545307566,755,502,1257,+
chr14,51707026,1.532897472215813,569,434,1003,+
chr14,51707156,0.7194046459869244,1360,909,2269,+
chr14,51707157,1.0709036311757145,2914,2000,4914,+
chr14,51707158,1.0686023706622803,2416,1622,4038,+
chr14,51707159,1.3724352748026958,1554,1091,2645,+
chr14,51710574,3.0018018018018013,713,554,1267,+
chr14,51710575,3.0018018018018013,713,554,1267,+
chr14,51712070,2.072624086186995,742,451,1193,+
chr14,51713812,2.7514905149051496,780,491,1271,+
chr14,51713814,1.6450606585788563,677,576,1253,+
chr14,51713821,1.9134102874333736,1720,1153,2873,+
chr14,51713823,1.9134102874333736,1720,1153,2873,+
chr14,51713833,2.6638321995464853,888,685,1573,+
chr14,51713835,1.6892588786245046,1394,1342,2736,+
chr14,51716242,1.7052392565806072,750,516,1266,+
chr14,51721140,3.4159946236559144,781,495,1276,+
chr14,51721150,0.3863080684596577,631,408,1039,+
chr14,51721663,2.8443160444271594,941,673,1614,+
chr14,51721690,0.7507936507936507,945,779,1724,+
chr14,51721692,0.7507936507936507,945,779,1724,+
chr14,51721864,2.134495279593319,667,404,1071,+
chr14,51722358,2.5995145631067964,764,514,1278,+
chr14,51722525,2.6617022615814596,1245,825,2070,+
chr14,51722575,1.5260511882998171,741,546,1287,+
chr14,52456344,1.3252221324717286,874,618,1492,+
chr14,52456345,0.9111158016036203,1075,804,1879,+
chr14,52456346,1.0809499717492894,1406,1000,2406,+
chr14,52456369,1.1398023257127812,1205,788,1993,+
chr14,52456385,1.9061648659920476,1623,1200,2823,+
chr14,52456388,2.79317697228145,785,602,1387,+
chr14,52456391,1.6864973262032084,840,659,1499,+
chr14,52456411,1.7507265752150662,1020,781,1801,+
chr14,52458047,0.6618881448646611,1275,921,2196,+
chr14,52458055,1.7339310182417496,3972,2794,6766,+
chr14,52471149,0.5532130207454883,1759,1330,3089,+
chr14,52471308,1.8204775053433304,3591,2591,6182,+
chr14,53173926,1.0812679081006056,805,479,1284,+
chr14,53173944,1.7047586174062086,1812,943,2755,+
chr14,53173945,1.7047586174062086,1812,943,2755,+
chr14,53173948,1.8859021568624523,3506,2492,5998,+
chr14,53173949,1.629785378455755,4083,3202,7285,+
chr14,53173950,1.6664404680690983,4605,3866,8471,+
chr14,53173951,1.447321344032814,7069,5138,12207,+
chr14,53173952,1.5496113117914114,4268,3913,8181,+
chr14,53173954,1.581525787951759,7045,4878,11923,+
chr14,53173955,1.343448849249839,1870,1125,2995,+
chr14,53173956,1.6760975242823428,4690,2625,7315,+
chr14,53175061,1.799411269974769,777,491,1268,+
chr14,53175062,0.5036050156739812,755,579,1334,+
chr14,53175228,0.4761904761904762,989,692,1681,+
chr14,53177822,1.388124125967869,2852,1583,4435,+
chr14,53177823,1.388124125967869,2852,1583,4435,+
chr14,53177826,2.075459680992468,3568,2071,5639,+
chr14,53177827,2.0581453235653684,4488,2551,7039,+
chr14,53177865,1.6545546401367948,1702,918,2620,+
chr14,53177870,1.9461437908496733,1860,1070,2930,+
chr14,53178128,1.744657844341029,4159,3217,7376,+
chr14,53178129,1.744657844341029,4159,3217,7376,+
chr14,53178150,1.2908231687847245,5575,4473,10048,+
chr14,53178151,1.0417671464214129,10901,8532,19433,+
chr14,53178157,1.3891714627652425,4326,2887,7213,+
chr14,53184804,0.564759848893686,597,435,1032,+
chr14,53184855,1.6540447504302926,836,580,1416,+
chr14,53184955,1.5357089552238803,806,535,1341,+
chr14,53185740,2.052050919377652,805,504,1309,+
chr14,53187621,1.997835497835498,780,461,1241,+
chr14,53187900,2.00566091146682,1507,1169,2676,+
chr14,53190685,1.6696276696276695,630,480,1110,+
chr14,54875484,1.7302120669056154,798,557,1355,+
chr14,54878398,0.4877468957933176,1049,825,1874,+
chr14,54886737,1.7811447811447811,597,428,1025,+
chr14,54886739,1.589179701615817,831,586,1417,+
chr14,54886756,1.6438640132669984,792,535,1327,+
chr14,55529979,0.3158605664488018,658,449,1107,+
chr14,55529980,0.3158605664488018,658,449,1107,+
chr14,55529982,2.0281558685781285,734,544,1278,+
chr14,55531416,1.2076636818883115,1659,1130,2789,+
chr14,55532621,2.089908469470513,621,410,1031,+
chr14,55595999,2.6322352941176472,677,499,1176,+
chr14,55596000,2.6322352941176472,677,499,1176,+
chr14,55604088,0.5013195911380725,989,749,1738,+
chr14,55604093,0.4677511961722488,563,474,1037,+
chr14,55604101,0.5337019734960434,932,616,1548,+
chr14,55604766,2.115752581225727,697,620,1317,+
chr14,55604774,2.142630385487528,858,629,1487,+
chr14,55604858,16.668726645978825,850,581,1431,+
chr14,55604873,4.011537709406166,778,666,1444,+
chr14,55604874,11.159523044147681,1999,1551,3550,+
chr14,55605028,1.4112793706880424,1048,768,1816,+
chr14,55605063,1.8506472360029154,1276,902,2178,+
chr14,55607004,0.4876253751281696,1844,1453,3297,+
chr14,55607041,1.8837784941284823,1189,807,1996,+
chr14,55607064,1.8871345029239768,921,854,1775,+
chr14,55609310,0.5998134328358209,1285,1071,2356,+
chr14,55611837,1.7254019617757106,1624,1022,2646,+
chr14,56078760,1.95948051948052,737,524,1261,+
chr14,56078968,1.6049654497645691,1192,710,1902,+
chr14,56083244,1.9098427231780253,738,466,1204,+
chr14,56083357,2.006048387096774,994,619,1613,+
chr14,56084795,1.8954260953298028,1063,669,1732,+
chr14,56084799,1.824873988981362,555,448,1003,+
chr14,56094669,1.7109974867839504,1701,1048,2749,+
chr14,56094671,0.6279926335174953,1022,723,1745,+
chr14,56094737,1.3787247549894854,2379,1625,4004,+
chr14,56096675,2.211044759459761,2755,2107,4862,+
chr14,56101312,1.5742049469964663,890,565,1455,+
chr14,56101332,1.639344262295082,749,548,1297,+
chr14,56101340,0.6287213413938633,1059,796,1855,+
chr14,56101343,2.181646707900162,1714,1340,3054,+
chr14,56101344,2.0489074261908105,2773,2059,4832,+
chr14,56101353,2.53958622283865,934,823,1757,+
chr14,56101363,2.6794276856311465,2143,1733,3876,+
chr14,56103223,2.095816633266533,576,498,1074,+
chr14,56103941,1.5531870860927153,789,603,1392,+
chr14,56104054,0.4806803408926766,782,643,1425,+
chr14,56104539,1.8831043102000107,2018,1383,3401,+
chr14,56107113,1.39472638660748,9071,5049,14120,+
chr14,56107116,2.1808032624352283,4285,2594,6879,+
chr14,56107131,1.387889695442638,7598,3797,11395,+
chr14,56107133,1.387889695442638,7598,3797,11395,+
chr14,56107663,1.6119914624461418,10798,7966,18764,+
chr14,56107665,1.6119914624461418,10798,7966,18764,+
chr14,56107672,1.8377577874907662,12416,10479,22895,+
chr14,56107674,1.5919222320194144,22699,18754,41453,+
chr14,56107675,1.6711082874312477,23097,18057,41154,+
chr14,56115565,1.4248801856731443,3034,2131,5165,+
chr14,56115581,1.3712143749628132,2003,1371,3374,+
chr14,56118613,1.625077303648732,1370,881,2251,+
chr14,56119786,2.191252955082742,597,469,1066,+
chr14,56138313,1.8624503466002025,975,693,1668,+
chr14,56138346,1.9066554712769102,2552,1810,4362,+
chr14,56138348,1.9558196905135679,917,636,1553,+
chr14,56138349,1.7213458847474874,1454,1122,2576,+
chr14,56139671,1.7596034696406442,1064,806,1870,+
chr14,56139683,1.722892552673406,3132,2319,5451,+
chr14,56146317,1.9372901649703955,1639,978,2617,+
chr14,56146388,1.5923674434312731,942,657,1599,+
chr14,58669590,0.9759580629980176,560,486,1046,+
chr14,58690517,1.580033683236812,1882,1366,3248,+
chr14,58690532,3.329610888152155,657,520,1177,+
chr14,58690539,1.5810574229691874,820,671,1491,+
chr14,58690542,0.6302659340149777,1698,1306,3004,+
chr14,58690562,0.8754325629285469,5286,4119,9405,+
chr14,58690563,0.6241466791388078,4969,3613,8582,+
chr14,58711588,1.6530975137941746,1078,603,1681,+
chr14,58711606,1.4368856194521595,1275,729,2004,+
chr14,58711612,1.4224733800026537,1321,1040,2361,+
chr14,58711632,2.028321812596006,1141,671,1812,+
chr14,58714485,2.9714023551001683,669,502,1171,+
chr14,58714513,0.6693231521980874,1388,986,2374,+
chr14,58718852,1.825105574324324,1416,1183,2599,+
chr14,58724537,1.2653164088215931,1877,1567,3444,+
chr14,58730477,1.8094460641399417,861,685,1546,+
chr14,58734196,1.6975149957155098,1980,1166,3146,+
chr14,59951287,0.717972530276383,708,577,1285,+
chr14,59954422,1.126137613125507,816,603,1419,+
chr14,59961771,1.9906957247559984,923,603,1526,+
chr14,59961810,4.079041725252121,623,526,1149,+
chr14,61262977,2.0888211579561937,931,733,1664,+
chr14,61262995,1.9396226450828196,740,703,1443,+
chr14,61263014,5.166666666666667,508,508,1016,+
chr14,61263023,0.5414782769493524,1060,1009,2069,+
chr14,61435200,1.1439011402791035,671,414,1085,+
chr14,62162251,4.484848924247843,764,372,1136,+
chr14,62162262,1.8514833786745781,1014,677,1691,+
chr14,62162313,0.4668227946916471,597,426,1023,+
chr14,62162373,2.6041666666666665,584,431,1015,+
chr14,62162376,1.0507981220657276,1443,1135,2578,+
chr14,62162377,1.0507981220657276,1443,1135,2578,+
chr14,62162408,3.450584728273332,911,622,1533,+
chr14,62162497,0.5496011964107677,587,471,1058,+
chr14,62162500,2.0159838061801985,922,692,1614,+
chr14,62162514,2.5501267074547815,872,668,1540,+
chr14,62162516,2.371510152284264,649,393,1042,+
chr14,62162519,1.647058823529412,615,494,1109,+
chr14,62162522,0.6267694641051568,782,551,1333,+
chr14,62162543,0.5730773057407224,639,528,1167,+
chr14,62162546,2.339468302658487,703,488,1191,+
chr14,62187103,1.5351332022170572,953,657,1610,+
chr14,62187124,1.6428667450848595,1376,1081,2457,+
chr14,62187247,1.4375017607121727,2096,1382,3478,+
chr14,62188536,1.6295379537953796,1974,1615,3589,+
chr14,62194212,1.3486431216492565,1876,1466,3342,+
chr14,62194236,1.3827342098004964,1691,1340,3031,+
chr14,62203641,1.3644628099173557,2031,1759,3790,+
chr14,62204910,1.5818852248382742,3699,2568,6267,+
chr14,62207227,1.4808596992897334,1046,878,1924,+
chr14,62207325,1.463068783068783,1337,1133,2470,+
chr14,62207561,1.6486069248163622,3708,2461,6169,+
chr14,62207742,1.699811013135837,3125,2624,5749,+
chr14,62214100,1.4536477806538202,1541,1158,2699,+
chr14,62214483,1.370848943599154,1581,1188,2769,+
chr14,62242881,2.319576476219546,709,455,1164,+
chr14,62242965,2.766866207887497,750,435,1185,+
chr14,62245569,2.637415090875712,652,418,1070,+
chr14,64855158,1.8811521865678187,727,530,1257,+
chr14,64867512,0.9294320137693632,647,580,1227,+
chr14,64867513,0.9294320137693632,647,580,1227,+
chr14,64892509,3.822222222222222,687,647,1334,+
chr14,64892510,2.8251501398528216,996,842,1838,+
chr14,64892861,1.8453994063750163,714,368,1082,+
chr14,64892862,1.734162895927602,729,339,1068,+
chr14,64892883,2.3513612950699043,912,452,1364,+
chr14,64892888,2.282201882918208,1896,990,2886,+
chr14,64894091,6.336429740619491,667,416,1083,+
chr14,64898556,2.6666666666666665,607,398,1005,+
chr14,64906847,1.9512172040005118,834,595,1429,+
chr14,64906905,1.5628563583593402,1571,1123,2694,+
chr14,64906907,2.3290379915574317,952,642,1594,+
chr14,64906952,1.5961661625544827,639,445,1084,+
chr14,64908125,1.9855051722486725,848,545,1393,+
chr14,64908144,1.3453062610627,1062,661,1723,+
chr14,64908784,2.1571833648393195,786,459,1245,+
chr14,64911441,0.9859154929577466,587,496,1083,+
chr14,64911442,0.9859154929577466,587,496,1083,+
chr14,64924971,0.8962818003913895,915,510,1425,+
chr14,64924973,0.8962818003913895,915,510,1425,+
chr14,64926539,2.65561797752809,651,444,1095,+
chr14,65009070,1.687734382145797,658,376,1034,+
chr14,65009071,0.5250903251706143,653,469,1122,+
chr14,65009116,1.619774119347862,2170,1349,3519,+
chr14,65009256,3.08151200092585,620,555,1175,+
chr14,65009578,1.8865306487015356,754,561,1315,+
chr14,65009583,0.4146684645600046,642,460,1102,+
chr14,65009584,1.0510657451431935,891,647,1538,+
chr14,65194606,2.1283657894450463,972,467,1439,+
chr14,65194608,2.079697986577181,736,297,1033,+
chr14,65194668,3.5589179487922,751,356,1107,+
chr14,65194677,2.9599049090551155,1105,645,1750,+
chr14,65381191,2.4695362529349127,606,450,1056,+
chr14,65381236,0.4954137392661983,709,511,1220,+
chr14,65390711,0.5308335764379205,1038,778,1816,+
chr14,65390724,2.0234545815941165,1017,644,1661,+
chr14,65390725,2.0234545815941165,1017,644,1661,+
chr14,65390744,1.5889679715302492,892,561,1453,+
chr14,65390768,1.7520264681555007,1665,1364,3029,+
chr14,65390770,1.7520264681555007,1665,1364,3029,+
chr14,65399086,3.6149641524794407,695,403,1098,+
chr14,65399711,2.2509689190028253,546,458,1004,+
chr14,65400337,3.1986719351526314,621,513,1134,+
chr14,66209385,2.6932662900840527,811,537,1348,+
chr14,66209387,2.887808197618928,898,560,1458,+
chr14,66209455,0.9669278996865204,1193,869,2062,+
chr14,66209456,0.9669278996865204,1193,869,2062,+
chr14,66209472,1.5688073394495414,611,435,1046,+
chr14,66209475,2.001571622603788,1692,1053,2745,+
chr14,67827125,1.2887428375938808,950,701,1651,+
chr14,67831548,2.665773310999442,745,596,1341,+
chr14,67831569,1.6407752500244437,1573,1119,2692,+
chr14,67831604,2.332121212121212,591,439,1030,+
chr14,67831682,1.917420814479638,564,441,1005,+
chr14,67843255,1.5709859154929575,1013,709,1722,+
chr14,67847442,1.587769138755981,1147,703,1850,+
chr14,67849189,1.9802494802494803,634,480,1114,+
chr14,67850095,0.6302897071523907,891,541,1432,+
chr14,67850131,1.797608370702541,858,668,1526,+
chr14,67850349,1.7288438971327116,1559,1179,2738,+
chr14,67850409,1.89647577092511,573,453,1026,+
chr14,67850701,1.9463726691166456,1099,929,2028,+
chr14,67850702,1.7614575069029603,1742,1375,3117,+
chr14,67850719,3.346846846846847,742,406,1148,+
chr14,67850746,0.5745686713336952,2371,1485,3856,+
chr14,67850752,1.6958548479632818,1390,995,2385,+
chr14,67850755,1.9451001380242807,3122,2438,5560,+
chr14,67850757,1.7146872810946623,5664,4488,10152,+
chr14,67850758,1.7646175622542593,3312,2724,6036,+
chr14,67850804,3.0944821130830196,597,472,1069,+
chr14,69926986,2.0951233180749265,617,529,1146,+
chr14,69927975,1.0412603054446647,600,427,1027,+
chr14,70234932,2.138441890166028,643,434,1077,+
chr14,70234936,0.47099739914111155,598,500,1098,+
chr14,70235580,1.678624973227672,626,405,1031,+
chr14,70235601,1.0913738133336317,2618,2022,4640,+
chr14,70235922,1.8113357114546174,913,782,1695,+
chr14,70236608,1.2271057056269807,613,468,1081,+
chr14,70237917,2.437079596412556,1022,891,1913,+
chr14,70237919,2.437079596412556,1022,891,1913,+
chr14,70237935,1.9275900703269322,1155,887,2042,+
chr14,70238183,0.6511118070779831,923,617,1540,+
chr14,70238290,3.502960531517363,1286,350,1636,+
chr14,70238294,4.0139864705159845,1374,353,1727,+
chr14,70238302,10.043508770194437,3137,903,4040,+
chr14,70238303,14.979500891265594,1028,373,1401,+
chr14,70238304,11.808108460295662,1967,631,2598,+
chr14,70238308,22.868605463813765,3515,1386,4901,+
chr14,70238309,43.91033949736321,3155,1323,4478,+
chr14,70238313,17.861074349092085,3574,2422,5996,+
chr14,70238314,13.376174285342648,3934,2594,6528,+
chr14,70238315,12.148816234498309,1346,886,2232,+
chr14,70238316,7.784084585420145,1075,598,1673,+
chr14,70238318,7.503974367127385,2090,2212,4302,+
chr14,70238324,0.5318285817305275,1124,1375,2499,+
chr14,70238348,3.056367057952093,2028,2813,4841,+
chr14,70346432,1.110204081632653,647,566,1213,+
chr14,70346434,1.110204081632653,647,566,1213,+
chr14,70418856,2.0606925938131884,817,643,1460,+
chr14,70418921,0.6411673112662615,554,462,1016,+
chr14,70418979,2.074680306905371,779,424,1203,+
chr14,70419010,1.1004321191680992,1473,1171,2644,+
chr14,70420188,2.845218042298334,690,410,1100,+
chr14,70442512,0.5714984709480123,875,544,1419,+
chr14,70461116,1.3702215667327806,1335,1112,2447,+
chr14,70477545,1.8513543031891655,736,435,1171,+
chr14,70477655,3.720232708468002,871,594,1465,+
chr14,70477658,0.4605740419492193,648,372,1020,+
chr14,70478214,1.6577571520883512,829,586,1415,+
chr14,70478238,1.94692991668417,868,620,1488,+
chr14,70478254,2.20353488372093,845,644,1489,+
chr14,70480116,1.7013142174432494,711,495,1206,+
chr14,70480120,0.5809523048760924,1632,1187,2819,+
chr14,70480129,1.4772146793923917,1220,1037,2257,+
chr14,70489924,2.2622157716497338,1001,794,1795,+
chr14,70489925,1.7759687102055663,780,477,1257,+
chr14,70489951,1.7077625570776254,747,437,1184,+
chr14,70489972,1.9029333333333331,891,524,1415,+
chr14,70490010,1.5274898785425102,1300,987,2287,+
chr14,70490065,1.472836190869655,1084,720,1804,+
chr14,70496980,1.6775072008379155,1231,1004,2235,+
chr14,70497065,1.8583475821311775,1316,1020,2336,+
chr14,70497118,1.6353236223718564,1160,765,1925,+
chr14,70497145,0.7231012658227849,1827,1263,3090,+
chr14,70497164,1.3246354430155052,1695,1390,3085,+
chr14,70497268,45.24617847762035,5775,638,6413,+
chr14,70497269,38.432098520846125,8893,1157,10050,+
chr14,70497270,38.432098520846125,8893,1157,10050,+
chr14,70497271,37.390083313895964,5846,904,6750,+
chr14,70497275,14.427601254302125,5216,2349,7565,+
chr14,70497276,13.278282997100048,5805,2610,8415,+
chr14,70497278,9.879413176115719,1190,502,1692,+
chr14,70497285,24.738860562149718,7891,8026,15917,+
chr14,70497286,24.738860562149718,7891,8026,15917,+
chr14,70497287,24.738860562149718,7891,8026,15917,+
chr14,70497375,0.46461640211640204,561,566,1127,+
chr14,70497458,3.107292707292708,647,454,1101,+
chr14,70497520,2.6800046282586854,813,630,1443,+
chr14,70497721,1.498319880847764,655,406,1061,+
chr14,70497835,1.4694953335637748,894,788,1682,+
chr14,70498021,0.45862404206185114,764,543,1307,+
chr14,70498130,7.240802226267343,1393,161,1554,+
chr14,70498131,6.922446010278435,1676,205,1881,+
chr14,70498134,6.974632972397386,2895,357,3252,+
chr14,70498135,8.109433645434653,5052,641,5693,+
chr14,70498136,7.701039691736344,4984,617,5601,+
chr14,70498137,9.652662378144337,5051,680,5731,+
chr14,70498138,12.371230701075286,2889,422,3311,+
chr14,70498140,45.551111111111105,1107,359,1466,+
chr14,70498141,27.940669571956033,4655,2788,7443,+
chr14,70498142,20.292519933447533,6122,4489,10611,+
chr14,70498143,19.98194080065386,5758,4445,10203,+
chr14,70498144,18.73999740081397,4340,4192,8532,+
chr14,70498438,2.5489365526276906,651,433,1084,+
chr14,70498545,1.044747081712062,536,513,1049,+
chr14,70498547,1.044747081712062,536,513,1049,+
chr14,70498763,1.1034403041545724,1125,775,1900,+
chr14,70498885,2.0224489705627886,652,522,1174,+
chr14,73566120,1.1001918859649122,697,455,1152,+
chr14,73566121,1.1001918859649122,697,455,1152,+
chr14,73566379,2.1507590741433686,1938,1438,3376,+
chr14,73566381,2.0845985862286667,2961,2246,5207,+
chr14,73566382,2.0008519701810434,2012,1564,3576,+
chr14,73566393,2.785190510424155,1173,1069,2242,+
chr14,73570047,2.4070750095376323,811,352,1163,+
chr14,73570084,2.9042386185243325,739,363,1102,+
chr14,73570108,1.9254658385093166,743,482,1225,+
chr14,73570156,1.9555093751475936,940,682,1622,+
chr14,73570163,2.20905220048915,1592,1149,2741,+
chr14,73572662,2.3864193449315647,1763,1202,2965,+
chr14,73572664,2.320224376562405,1435,993,2428,+
chr14,73572766,1.6959531681886568,832,529,1361,+
chr14,73574596,1.8976405733186328,1365,906,2271,+
chr14,73574600,1.8206461141922123,1848,1302,3150,+
chr14,73576063,2.0308857808857805,1699,1319,3018,+
chr14,73614769,1.760437375745527,643,502,1145,+
chr14,73614782,1.9292237442922375,1182,948,2130,+
chr14,73614784,1.9292237442922375,1182,948,2130,+
chr14,74347911,2.8411629058833485,802,422,1224,+
chr14,75201876,9.574593970770392,986,1080,2066,+
chr14,75201877,8.004241962184853,1578,2477,4055,+
chr14,75201878,8.004241962184853,1578,2477,4055,+
chr14,75201879,4.532687651331719,485,825,1310,+
chr14,75201889,0.24285093588975684,446,584,1030,+
chr14,75265024,2.131824611032532,627,504,1131,+
chr14,75265026,2.131824611032532,627,504,1131,+
chr14,75265028,1.730341246290801,932,673,1605,+
chr14,75265029,1.730341246290801,932,673,1605,+
chr14,75265038,2.508960573476702,559,464,1023,+
chr14,75369657,22.308811832129425,1429,1047,2476,+
chr14,75369658,22.308811832129425,1429,1047,2476,+
chr14,75476035,1.6645933014354068,1490,835,2325,+
chr14,75476036,1.6645933014354068,1490,835,2325,+
chr14,75476039,2.120480838756327,808,460,1268,+
chr14,75476051,1.6032954419736696,1854,1103,2957,+
chr14,75476052,1.683885593901308,2623,1816,4439,+
chr14,75476088,2.6601399014778324,598,417,1015,+
chr14,75745769,1.4240389412166794,663,432,1095,+
chr14,75747392,0.27903106445062537,703,474,1177,+
chr14,75747528,1.0348424509800318,1688,1156,2844,+
chr14,75747590,0.4440275171982489,709,389,1098,+
chr14,75747652,0.6073867163252638,720,357,1077,+
chr14,75747812,2.9539365045286328,1166,828,1994,+
chr14,75748257,2.321718328420652,1128,780,1908,+
chr14,75748311,0.850993973384914,1638,1014,2652,+
chr14,75748313,1.0084161869876156,924,587,1511,+
chr14,75748327,1.6300778485491862,742,470,1212,+
chr14,75748466,1.0444238773372438,1506,1320,2826,+
chr14,75748512,2.073434125269978,575,462,1037,+
chr14,76455273,1.6437639544583909,722,522,1244,+
chr14,76488682,0.3598369021377366,759,542,1301,+
chr14,76549932,3.925104705592511,568,450,1018,+
chr14,76549934,4.569992053130499,761,577,1338,+
chr14,77795503,1.9501599715606115,668,484,1152,+
chr14,77795505,1.9501599715606115,668,484,1152,+
chr14,77924400,1.757143077698097,1282,1068,2350,+
chr14,77924401,1.757143077698097,1282,1068,2350,+
chr14,77924438,0.8983820122818189,1230,989,2219,+
chr14,77924465,2.2682370820668694,596,469,1065,+
chr14,77924466,1.451956085789062,805,466,1271,+
chr14,77924599,1.9375937031484256,1054,579,1633,+
chr14,77924601,1.9375937031484256,1054,579,1633,+
chr14,77926060,1.2709584388471926,2905,1849,4754,+
chr14,77926061,1.1156040928768205,2000,1187,3187,+
chr14,77928518,4.3359375,665,575,1240,+
chr14,77929019,1.586378737541528,954,601,1555,+
chr14,77931009,2.003325942350332,555,450,1005,+
chr14,77931897,1.6235368956743004,1822,1047,2869,+
chr14,77931898,1.8622125393367224,600,458,1058,+
chr14,77931899,1.6235368956743004,1822,1047,2869,+
chr14,77934493,1.7091548741106355,1301,928,2229,+
chr14,77934514,1.9263813527841676,3820,2463,6283,+
chr14,77934805,1.9970783081365722,1335,840,2175,+
chr14,77934806,0.6135207701207133,1080,750,1830,+
chr14,77934809,1.7709966201168015,3162,1983,5145,+
chr14,77934817,1.7520893725948905,1666,1112,2778,+
chr14,77934832,0.8037188184255519,10036,6648,16684,+
chr14,77934834,1.0978077571669478,4339,2964,7303,+
chr14,77934841,2.772727272727273,2378,1781,4159,+
chr14,77935556,0.5730088495575221,702,451,1153,+
chr14,77935584,0.5853018372703411,668,507,1175,+
chr14,77935731,3.6683168316831694,740,403,1143,+
chr14,77935763,32.02319138148124,1635,1489,3124,+
chr14,77935764,27.165543281355315,2962,2555,5517,+
chr14,78174434,1.12433890331666,823,726,1549,+
chr14,78174435,1.12433890331666,823,726,1549,+
chr14,78174440,0.3933445180278648,905,605,1510,+
chr14,78174448,0.9184144982630924,1098,802,1900,+
chr14,78174450,1.234653972392281,1738,1291,3029,+
chr14,78174451,1.125301666347443,1223,907,2130,+
chr14,78174492,1.6440397420765949,3455,2368,5823,+
chr14,78174493,1.6432015706775474,4051,2832,6883,+
chr14,78174495,1.5967103091649248,1160,893,2053,+
chr14,78174496,1.3936228363194656,1042,739,1781,+
chr14,78174528,0.7039689762398007,4033,2776,6809,+
chr14,78177228,1.3988795938470027,7922,5779,13701,+
chr14,78177234,0.7952402886534623,2725,2170,4895,+
chr14,89039207,0.38160225197684816,649,464,1113,+
chr14,89076132,1.2853736089030208,1077,739,1816,+
chr14,89076133,1.2853736089030208,1077,739,1816,+
chr14,89076137,2.490842490842491,645,493,1138,+
chr14,89077236,1.6541208949790283,588,445,1033,+
chr14,89291147,0.7674487587252807,1192,761,1953,+
chr14,89291149,1.0416374474053294,698,367,1065,+
chr14,89305808,1.184465974491007,3050,2269,5319,+
chr14,89305809,1.709583932422717,1552,1247,2799,+
chr14,89338722,1.976690193164933,989,672,1661,+
chr14,89338724,1.782535368774572,2021,1396,3417,+
chr14,89338725,1.6373410752277455,2485,1638,4123,+
chr14,89338727,1.5389331329827198,1383,824,2207,+
chr14,89338728,1.7478450191060162,1414,1209,2623,+
chr14,89338730,1.6266251133082932,2335,1761,4096,+
chr14,89343650,2.694476178901313,598,524,1122,+
chr14,90433723,2.8655621111662817,719,522,1241,+
chr14,90722920,0.7224771427185074,871,581,1452,+
chr14,90725543,2.5513450547138437,711,517,1228,+
chr14,90729772,1.9505995695398173,1247,886,2133,+
chr14,90729773,1.9505995695398173,1247,886,2133,+
chr14,90863410,1.4244674543385332,689,438,1127,+
chr14,90863535,1.285426878332655,767,524,1291,+
chr14,90866415,1.9519984326018809,737,463,1200,+
chr14,90866424,1.5287626331603388,635,522,1157,+
chr14,90867655,2.5879904397033,1602,1354,2956,+
chr14,90867692,1.6834581888450646,1222,1020,2242,+
chr14,90867702,0.4851166532582461,803,564,1367,+
chr14,90871186,1.8400375939849627,1003,607,1610,+
chr14,90871192,1.618915752476302,1139,686,1825,+
chr14,90871454,0.5317207341524857,984,733,1717,+
chr14,91233316,0.5654131355932204,609,471,1080,+
chr14,91233319,1.2116840738577455,743,510,1253,+
chr14,91233321,0.917801266466748,2885,2145,5030,+
chr14,91233322,0.8285584286087689,2657,1948,4605,+
chr14,91233323,0.43795372050816694,857,550,1407,+
chr14,92588458,15.55684881217302,1467,1079,2546,+
chr14,92588459,14.186558402604138,1082,703,1785,+
chr14,92588460,14.486281551353533,1340,975,2315,+
chr14,92592485,3.1135958258888277,531,570,1101,+
chr14,92628557,1.4083964517916367,650,396,1046,+
chr14,93273238,2.0424287472230174,1101,802,1903,+
chr14,93273239,2.2844151415255203,627,462,1089,+
chr14,93275842,2.14485046393149,576,500,1076,+
chr14,93290915,2.7156127770534546,876,766,1642,+
chr14,93290916,2.32156125698275,1421,1076,2497,+
chr14,93301931,0.7113848804339769,739,409,1148,+
chr14,96968748,0.7853380684241096,710,330,1040,+
chr14,96968749,1.2180470755185706,840,406,1246,+
chr14,96968896,4.443582206850414,1813,1556,3369,+
chr14,96968897,3.9578470763884788,1975,1769,3744,+
chr14,96968898,3.957847076388479,1975,1769,3744,+
chr14,96968899,2.213903743315508,458,577,1035,+
chr14,96986393,0.5855115737220578,1419,1690,3109,+
chr14,96986394,0.339098742929176,822,1109,1931,+
chr14,96986395,0.6693345624667522,1087,1212,2299,+
chr14,96986417,0.5644376804511396,922,754,1676,+
chr14,96986432,1.8023898698055998,651,533,1184,+
chr14,96986507,0.4868146260309369,808,656,1464,+
chr14,96987363,1.988459224416124,1321,777,2098,+
chr14,96987364,2.019239821484636,2829,1835,4664,+
chr14,96987366,2.625734549138804,1363,845,2208,+
chr14,96987392,2.1325680272108847,808,587,1395,+
chr14,96991661,0.3806949806949806,1172,850,2022,+
chr14,96991662,1.506931675568398,921,728,1649,+
chr14,96991666,1.6037123163018765,3748,2837,6585,+
chr14,96991667,1.7543661971830986,2075,1774,3849,+
chr14,96991706,1.6458594730238394,953,796,1749,+
chr14,96997829,1.9859520831328779,687,546,1233,+
chr14,96998692,5.1163153786104605,677,548,1225,+
chr14,97010487,2.8421052631578947,593,417,1010,+
chr14,97010488,2.8421052631578947,593,417,1010,+
chr14,97014227,2.446564885496183,640,392,1032,+
chr14,97022534,2.169281228266953,634,519,1153,+
chr14,97022563,2.097456336048038,694,497,1191,+
chr14,97022610,2.2300167398551345,638,445,1083,+
chr14,97031467,3.1565946691176467,784,543,1327,+
chr14,97031469,3.1565946691176467,784,543,1327,+
chr14,97032389,2.5677912862904346,965,666,1631,+
chr14,97032492,0.5130057803468208,638,518,1156,+
chr14,97032691,0.5782615026208503,610,403,1013,+
chr14,97032908,2.770656718007352,877,665,1542,+
chr14,97032909,2.928181619733683,705,508,1213,+
chr14,97033124,0.49970544153531327,927,643,1570,+
chr14,97313669,1.1726979638795645,622,458,1080,+
chr14,97319427,2.1055595141698125,603,469,1072,+
chr14,97322508,3.66404618043348,956,671,1627,+
chr14,97327008,2.542095871896148,739,507,1246,+
chr14,100705593,0.7871993880642078,839,543,1382,+
chr14,100705600,2.6549111697197634,1078,660,1738,+
chr14,100705602,3.3189249099473543,677,400,1077,+
chr14,100706237,1.3028037383177569,696,534,1230,+
chr14,100706239,2.0336089678283287,1427,1143,2570,+
chr14,100706241,2.005709992486852,751,604,1355,+
chr14,100706253,1.720527215035392,531,481,1012,+
chr14,100728640,1.231344844961691,1270,992,2262,+
chr14,100728641,1.574489287493772,631,668,1299,+
chr14,100728642,0.6030441400304414,848,656,1504,+
chr14,100728645,2.1242424242424245,1401,1589,2990,+
chr14,100728646,1.9195053581339276,2491,2503,4994,+
chr14,100728733,2.4543610547667343,725,434,1159,+
chr14,100743830,3.36070562545699,780,533,1313,+
chr14,100743882,1.9069458369828551,848,654,1502,+
chr14,100743922,2.302199371608112,619,388,1007,+
chr14,100743925,2.455357142857143,649,415,1064,+
chr14,100744147,2.3376054686391297,902,604,1506,+
chr14,100744153,1.3517247531061445,724,549,1273,+
chr14,100744510,2.31898345930551,729,536,1265,+
chr14,100744620,2.119298245614035,603,417,1020,+
chr14,100744653,1.4785714285714286,1241,755,1996,+
chr14,100744698,0.4419484558546779,969,638,1607,+
chr14,100744704,0.4685437856611263,1110,694,1804,+
chr14,100744721,1.5061079545454543,1382,879,2261,+
chr14,100744728,1.4275320632127508,1533,1018,2551,+
chr14,100744733,1.5370151974863306,6701,4448,11149,+
chr14,100744739,0.6974911190053286,2162,1688,3850,+
chr14,100744743,1.5612932095312675,1885,1276,3161,+
chr14,100744754,1.5857763675243153,2606,1462,4068,+
chr14,100744771,1.668559597752144,2946,2253,5199,+
chr14,100950363,1.5416666666666663,739,447,1186,+
chr14,102348604,1.8196423718880828,1038,759,1797,+
chr14,102349598,0.6272021629164487,756,545,1301,+
chr14,102349606,0.6391304347826087,846,604,1450,+
chr14,102360869,1.3895956377191991,1011,665,1676,+
chr14,102375943,0.5479678638941399,772,528,1300,+
chr14,102375972,2.0811783960720134,747,610,1357,+
chr14,102375978,2.6179935275080903,631,514,1145,+
chr14,102378812,2.599562363238512,593,456,1049,+
chr14,102449450,2.7935135135135134,645,369,1014,+
chr14,102449452,2.7935135135135134,645,369,1014,+
chr14,102495946,3.0074942437995786,725,404,1129,+
chr14,102502836,3.2514792899408285,627,519,1146,+
chr14,102502838,3.256637168141593,643,564,1207,+
chr14,103369599,3.3074844108495842,842,525,1367,+
chr14,103800875,1.4145411897021891,851,530,1381,+
chr14,103800876,1.0359042553191489,655,375,1030,+
chr14,103805987,2.266984822489842,1297,912,2209,+
chr14,103805990,2.880981595092025,586,488,1074,+
chr14,103806785,1.948463356973995,633,469,1102,+
chr14,103807913,2.4738290556552096,885,644,1529,+
chr14,103808669,2.869021803344331,638,429,1067,+
chr14,103808701,2.262822960835489,577,459,1036,+
chr14,103932343,0.36705455700580847,669,507,1176,+
chr14,104038108,1.6645422357106727,865,658,1523,+
chr14,104053616,0.5070246209486716,728,552,1280,+
chr14,104053634,1.652666226343412,1468,1334,2802,+
chr14,104053635,1.599704032556419,551,476,1027,+
chr14,104053637,1.637490551776266,676,734,1410,+
chr14,104053651,2.599431818181818,1524,1799,3323,+
chr14,104053652,2.599431818181818,1524,1799,3323,+
chr14,104135922,1.5839257330452656,594,456,1050,+
chr14,104139445,3.615569823434992,900,533,1433,+
chr14,104139447,3.615569823434992,900,533,1433,+
chr14,104139510,3.155253553834515,647,432,1079,+
chr14,104142070,4.171335726989436,688,533,1221,+
chr14,104143761,1.0309630327289854,833,547,1380,+
chr14,104143763,1.376586830609008,1116,753,1869,+
chr14,104195287,2.6195512706884,640,623,1263,+
chr14,105167746,1.1580241241217235,749,441,1190,+
chr14,105169467,3.181909104727162,713,448,1161,+
chr14,105181653,2.6181477384464107,794,562,1356,+
chr14,105222023,1.9975955454315366,901,438,1339,+
chr14,105222024,1.9975955454315366,901,438,1339,+
chr14,105225894,2.0470735268191063,865,636,1501,+
chr14,105920641,2.530621543489191,618,504,1122,+
chr15,22848240,2.011904761904762,857,692,1549,+
chr15,22848241,2.011904761904762,857,692,1549,+
chr15,22848242,2.2964509394572024,615,478,1093,+
chr15,23003514,1.9166666666666663,827,503,1330,+
chr15,25200164,3.949785708083527,622,424,1046,+
chr15,25207310,2.7052532242843665,687,373,1060,+
chr15,25207317,1.8966644865925437,724,416,1140,+
chr15,25213086,1.962854534526361,1637,1093,2730,+
chr15,25213114,1.32749039466551,1522,1022,2544,+
chr15,25213126,2.3228898830746667,1710,1095,2805,+
chr15,25213179,2.805462885738115,584,435,1019,+
chr15,25213210,1.784795862347944,1064,652,1716,+
chr15,25219466,1.7195579950888347,820,643,1463,+
chr15,25220546,1.490732251609948,2396,1640,4036,+
chr15,25221518,2.4524511747192275,795,668,1463,+
chr15,25223046,3.506222222222222,685,374,1059,+
chr15,25223048,3.506222222222222,685,374,1059,+
chr15,25223599,1.9440177823907023,1332,1122,2454,+
chr15,25223609,1.6490090090090088,571,554,1125,+
chr15,25223616,1.5955140402467856,937,737,1674,+
chr15,25351668,0.7818166525457771,1036,702,1738,+
chr15,25351669,0.8851334050289342,595,413,1008,+
chr15,25351687,1.463183839986401,1053,750,1803,+
chr15,26891078,1.0279075600995586,1218,777,1995,+
chr15,32897380,1.745005875440658,809,551,1360,+
chr15,32898970,0.5817082373340513,1436,980,2416,+
chr15,32908089,0.3769052352551358,524,502,1026,+
chr15,32908090,0.3769052352551358,524,502,1026,+
chr15,32908108,1.2387839611369025,672,518,1190,+
chr15,32930652,3.235576923076924,672,350,1022,+
chr15,32930653,3.235576923076924,672,350,1022,+
chr15,34519975,1.9369565217391305,593,459,1052,+
chr15,34521994,2.03110599078341,573,433,1006,+
chr15,38757513,1.713475274377866,869,631,1500,+
chr15,38757514,1.713475274377866,869,631,1500,+
chr15,38757520,2.6866697570689544,764,577,1341,+
chr15,40468772,1.2108812634614556,603,452,1055,+
chr15,40476035,1.6238341541469705,727,575,1302,+
chr15,40488955,1.7685906040268455,731,446,1177,+
chr15,40509833,0.8235882058970515,617,413,1030,+
chr15,40509835,1.24502089065719,805,561,1366,+
chr15,40513213,1.9822953711166444,655,575,1230,+
chr15,40678628,2.406832298136646,619,459,1078,+
chr15,40679361,1.899235140026666,1772,1432,3204,+
chr15,40679363,2.70789417989418,1102,944,2046,+
chr15,40682101,0.3779694570135747,593,441,1034,+
chr15,40682102,2.445414847161572,719,457,1176,+
chr15,40683736,1.8964342116199815,991,680,1671,+
chr15,40683751,1.4727015906159795,1307,856,2163,+
chr15,40684154,1.9229562707823573,3064,2276,5340,+
chr15,40684156,1.7955139672492086,4703,3548,8251,+
chr15,40684157,1.5495925790171146,3213,2445,5658,+
chr15,40685857,2.5,699,503,1202,+
chr15,40685869,2.022652232254727,1043,857,1900,+
chr15,40685881,1.734916682627849,646,453,1099,+
chr15,40685946,1.9156118143459915,680,473,1153,+
chr15,40685965,4.85111601667893,637,452,1089,+
chr15,40686035,2.2873800582075763,1142,882,2024,+
chr15,40686049,2.56993006993007,503,527,1030,+
chr15,40686112,2.599279571381036,861,792,1653,+
chr15,40686327,1.8491071428571424,762,559,1321,+
chr15,40939193,3.143879173290938,564,443,1007,+
chr15,40939194,3.143879173290938,564,443,1007,+
chr15,40939195,3.143879173290938,564,443,1007,+
chr15,40943691,2.277679796198315,787,485,1272,+
chr15,40943693,2.247368421052632,853,569,1422,+
chr15,41058051,1.1184806428049672,637,369,1006,+
chr15,41058052,1.1184806428049672,637,369,1006,+
chr15,41523585,2.1443665448800235,711,493,1204,+
chr15,41523586,1.8197559186505414,1525,826,2351,+
chr15,41523587,2.0191835098619375,960,475,1435,+
chr15,41591141,6.361732851985559,800,553,1353,+
chr15,41591142,5.926408425485303,1105,832,1937,+
chr15,41591143,5.373568392391921,908,707,1615,+
chr15,41591569,2.8411575196023326,637,494,1131,+
chr15,41596823,2.7735851292802214,896,610,1506,+
chr15,41596825,2.7735851292802214,896,610,1506,+
chr15,41634631,0.6161945443645084,714,555,1269,+
chr15,41641296,1.9064327485380117,651,588,1239,+
chr15,41641300,2.100633528265107,698,647,1345,+
chr15,41643208,0.5496116504854369,665,411,1076,+
chr15,41643211,1.7323981900452488,708,441,1149,+
chr15,41643300,2.082188489942429,2037,1416,3453,+
chr15,41657772,1.9514754098360656,929,609,1538,+
chr15,41663763,2.9139286434186658,555,450,1005,+
chr15,41663848,2.2072072072072078,559,443,1002,+
chr15,41663850,0.5305039787798408,759,550,1309,+
chr15,41667963,1.3915415761998704,5079,2973,8052,+
chr15,41667964,1.3359675352413498,4169,2340,6509,+
chr15,41667976,1.6322605462238746,1004,708,1712,+
chr15,41668008,2.47379232185862,3174,2171,5345,+
chr15,41669396,1.3809357985794437,2838,1722,4560,+
chr15,41669399,1.3629128209867274,3805,2085,5890,+
chr15,41669400,1.3186003759836298,3138,1938,5076,+
chr15,41669435,1.3398650885614962,8789,6040,14829,+
chr15,41669436,1.2705373985378652,15199,10206,25405,+
chr15,41672448,2.267374517374517,782,517,1299,+
chr15,41672694,2.476694915254237,667,471,1138,+
chr15,41771371,2.228992137252552,612,563,1175,+
chr15,41771382,1.1023227543264733,578,580,1158,+
chr15,41771390,1.2352778747707958,1004,931,1935,+
chr15,41772496,2.1888305956223393,605,454,1059,+
chr15,43678064,2.70747462200105,629,426,1055,+
chr15,44038752,0.9231556725435295,1083,492,1575,+
chr15,44038758,2.5106071807843264,840,423,1263,+
chr15,44038820,1.6216673719847654,957,555,1512,+
chr15,44038836,1.5199335548172763,1036,601,1637,+
chr15,44038894,1.8414932999735947,2417,1690,4107,+
chr15,44046024,2.085599753314832,913,704,1617,+
chr15,44046049,0.5362183235867446,1057,949,2006,+
chr15,44046070,0.6774605828953655,1318,1195,2513,+
chr15,44048872,1.6367267044467948,3494,2657,6151,+
chr15,44048873,1.283221918227446,5460,4207,9667,+
chr15,44048877,1.1589500687553655,8405,6264,14669,+
chr15,44048878,0.5345006993006993,4622,3249,7871,+
chr15,44048879,1.8198833208676133,5848,4774,10622,+
chr15,44048881,1.8259430549504136,4006,3357,7363,+
chr15,44048928,1.657327773434106,1760,1278,3038,+
chr15,44053711,1.3917710196779969,1555,1013,2568,+
chr15,44055276,1.732738588103315,1801,1290,3091,+
chr15,44057658,1.35270197187786,2000,1615,3615,+
chr15,44059054,0.5985806849737736,775,462,1237,+
chr15,44059059,1.687465640461792,876,534,1410,+
chr15,44059082,1.5238208261378423,3237,2002,5239,+
chr15,44059083,1.5238208261378423,3237,2002,5239,+
chr15,44061774,1.7491616364855802,651,496,1147,+
chr15,44061777,1.7157550257129501,733,557,1290,+
chr15,44061802,2.1320197044334974,1081,629,1710,+
chr15,44062751,1.4004314350192488,2088,1394,3482,+
chr15,44062752,1.4327440430438123,1863,1300,3163,+
chr15,44062759,1.2644803565475249,2251,1883,4134,+
chr15,44063337,1.656716754659086,2270,1601,3871,+
chr15,44063648,3.201413300221172,9055,1772,10827,+
chr15,44063649,3.148460865863778,13630,2706,16336,+
chr15,44063651,3.353901464159648,11068,2293,13361,+
chr15,44063652,3.528961036214709,3811,849,4660,+
chr15,44063665,9.554421768707485,3444,545,3989,+
chr15,44063666,6.261743119936367,14068,2690,16758,+
chr15,44063667,6.261743119936367,14068,2690,16758,+
chr15,44063668,5.214745121076803,17199,3483,20682,+
chr15,44063670,3.869688241123429,10778,2392,13170,+
chr15,44063671,3.5356643565770245,4299,1011,5310,+
chr15,44063677,48.83385980746089,2200,1107,3307,+
chr15,44063678,38.05866034237086,13004,6602,19606,+
chr15,44063679,38.05866034237086,13004,6602,19606,+
chr15,44063680,36.87689553351224,12269,6359,18628,+
chr15,44084522,0.9306712962962964,730,431,1161,+
chr15,44084523,0.9974795520355143,1289,834,2123,+
chr15,44084525,1.3934097817076538,876,657,1533,+
chr15,44084526,2.530720666421989,1090,772,1862,+
chr15,44084527,1.0268851997277275,2135,1323,3458,+
chr15,44084551,0.7100640786056689,11018,7990,19008,+
chr15,44085209,1.2583085173802533,4884,2854,7738,+
chr15,44085210,0.7238893014472373,8289,6110,14399,+
chr15,44085933,1.3247034461025953,4030,2509,6539,+
chr15,44085936,0.7123276779488936,3756,2818,6574,+
chr15,44086156,1.3047467066499998,5319,3717,9036,+
chr15,44086173,3.337682562397407,1219,1032,2251,+
chr15,44086174,1.8716220034392184,6433,4297,10730,+
chr15,44086175,1.8716220034392184,6433,4297,10730,+
chr15,44092816,0.8673867032047028,1105,714,1819,+
chr15,44092818,0.9084249084249085,839,545,1384,+
chr15,44092932,2.6670214506892127,1058,765,1823,+
chr15,44092956,1.8568388447572017,1707,1154,2861,+
chr15,44092975,0.5533916849015317,842,456,1298,+
chr15,44093332,0.638673647469459,1306,954,2260,+
chr15,44093339,1.524024024024024,1014,827,1841,+
chr15,44093350,1.6276539395276983,1208,984,2192,+
chr15,44093353,1.4123550401427298,2110,1415,3525,+
chr15,44093366,1.3089834958739686,1550,1239,2789,+
chr15,44127310,0.33084990447339113,654,490,1144,+
chr15,44581415,2.0939435968562186,675,514,1189,+
chr15,44581416,2.098175639343641,921,657,1578,+
chr15,44581417,2.099441097110057,654,494,1148,+
chr15,44620953,3.653497942386832,1157,809,1966,+
chr15,44620954,3.653497942386832,1157,809,1966,+
chr15,44707516,5.68806865445406,932,590,1522,+
chr15,44816469,1.8253560571205658,1297,930,2227,+
chr15,44816495,3.296751968503937,608,507,1115,+
chr15,44819614,1.732966955566734,799,682,1481,+
chr15,44849711,1.9498069498069497,1009,591,1600,+
chr15,44853279,2.0567798292634505,776,656,1432,+
chr15,44853280,2.0567798292634505,776,656,1432,+
chr15,44853386,2.0565987833906374,647,397,1044,+
chr15,44853788,1.2803596587858779,1175,855,2030,+
chr15,45003711,0.9979062840078972,5134,3876,9010,+
chr15,45003712,0.9380705946697064,3922,3436,7358,+
chr15,45003713,0.9508525877094655,10188,7274,17462,+
chr15,45003714,0.9452384279300418,8544,6465,15009,+
chr15,45003719,1.223173068059801,7918,5990,13908,+
chr15,45003720,1.088706363670552,11537,9134,20671,+
chr15,45003729,0.8396769362430466,4442,3689,8131,+
chr15,45003742,0.8672338445306039,6527,5588,12115,+
chr15,45007629,0.8683773311824391,23751,17454,41205,+
chr15,45008525,0.6181740800056049,709,416,1125,+
chr15,45009983,1.163277958473887,48999,34952,83951,+
chr15,45010050,1.2798842706897926,24694,16241,40935,+
chr15,45010069,1.196375320579016,74351,56934,131285,+
chr15,45365829,2.231501436781609,709,383,1092,+
chr15,45365830,1.6928991118948433,976,598,1574,+
chr15,45898960,1.524786324786325,668,404,1072,+
chr15,48624356,0.530384343194509,2264,1618,3882,+
chr15,48624357,0.5267037004256068,1697,1148,2845,+
chr15,48624358,0.5167159954654764,2354,1730,4084,+
chr15,48624363,0.5078221437779273,1373,1034,2407,+
chr15,48624589,1.0017789767951049,1113,866,1979,+
chr15,48624590,1.0017789767951049,1113,866,1979,+
chr15,48624593,2.200807739269277,1615,818,2433,+
chr15,48624595,1.864243843557329,2479,1292,3771,+
chr15,48624596,1.8271913253917844,2940,1904,4844,+
chr15,48626618,1.4440812283820463,5404,3412,8816,+
chr15,48626619,1.549331721405064,3791,2126,5917,+
chr15,48626620,1.549331721405064,3791,2126,5917,+
chr15,48626626,1.6351648351648354,1115,818,1933,+
chr15,48626627,2.4342105263157894,899,683,1582,+
chr15,48628272,0.6678675222282969,2035,1510,3545,+
chr15,48634335,1.625782227784731,1298,815,2113,+
chr15,48634340,1.6825270948982287,1272,872,2144,+
chr15,48634343,1.7660585620113445,719,592,1311,+
chr15,48634349,1.9887057789496811,1533,1109,2642,+
chr15,48634477,1.5229343978308352,1010,780,1790,+
chr15,49170334,1.4912731658058198,722,575,1297,+
chr15,49170488,2.324701490302932,588,475,1063,+
chr15,49170597,2.54556625826905,611,495,1106,+
chr15,49170646,2.1800214822771213,707,664,1371,+
chr15,49170647,2.1800214822771213,707,664,1371,+
chr15,49170741,0.5324438202247191,668,533,1201,+
chr15,49170758,1.5324041811846691,732,594,1326,+
chr15,49170769,1.911686334221545,1115,709,1824,+
chr15,49170815,1.6065531475748194,957,815,1772,+
chr15,49170852,0.6949029030606216,1856,1436,3292,+
chr15,49611829,2.095616092368753,527,481,1008,+
chr15,49611830,2.095616092368753,527,481,1008,+
chr15,49917316,2.2924322045904937,597,477,1074,+
chr15,49917529,2.3350111856823266,834,446,1280,+
chr15,49917530,1.4613029143433542,1483,915,2398,+
chr15,49917542,2.065889665889666,577,428,1005,+
chr15,49924405,1.9780952380952384,736,549,1285,+
chr15,49926938,2.05314371257485,632,500,1132,+
chr15,49926952,2.9937125748502997,908,500,1408,+
chr15,49926954,2.9937125748502997,908,500,1408,+
chr15,49935607,3.088815789473684,625,455,1080,+
chr15,49935724,2.3772876489984696,1163,817,1980,+
chr15,50741630,1.5282720204002125,929,567,1496,+
chr15,50741631,1.5670646906316728,867,501,1368,+
chr15,50763912,1.5483311495951364,1135,770,1905,+
chr15,51221240,0.4573145688588245,1284,881,2165,+
chr15,51221242,0.9763701190263449,1247,876,2123,+
chr15,51221253,2.3717595699272644,903,690,1593,+
chr15,52201633,0.2620106761565836,588,561,1149,+
chr15,52342231,0.9942643154891009,826,514,1340,+
chr15,52342315,2.0230782730782733,794,406,1200,+
chr15,52342317,2.129176945503476,1211,636,1847,+
chr15,52342318,2.0176255154062956,1342,760,2102,+
chr15,52350836,2.564358230601885,614,393,1007,+
chr15,52353575,6.510173011092919,582,470,1052,+
chr15,52356190,1.8221481305072638,1593,1291,2884,+
chr15,52356192,1.8221481305072638,1593,1291,2884,+
chr15,52356195,2.000708111328918,1795,1630,3425,+
chr15,52356197,2.0951562147320892,2642,2131,4773,+
chr15,52356200,1.6051144517497415,6618,5008,11626,+
chr15,52356202,1.5659050643523194,8011,5975,13986,+
chr15,52356203,1.4660082448396918,2719,1867,4586,+
chr15,57581573,3.5660654438403663,792,414,1206,+
chr15,57581575,3.168315410569129,606,399,1005,+
chr15,59397370,3.1401069952371734,896,483,1379,+
chr15,59397372,2.4518853695324285,1015,509,1524,+
chr15,59397374,2.927802778321268,1031,537,1568,+
chr15,59397375,3.37547381899701,894,534,1428,+
chr15,59397464,0.3370172764227642,757,383,1140,+
chr15,59397466,0.6794776676356805,1419,734,2153,+
chr15,59397467,1.0384736180904524,777,397,1174,+
chr15,59399564,2.100434572670208,724,435,1159,+
chr15,59406672,2.2065359477124185,843,611,1454,+
chr15,59406680,1.3486174107368445,2509,1861,4370,+
chr15,59406695,1.4585830325954825,5389,4187,9576,+
chr15,59406696,1.455648060365054,6780,5503,12283,+
chr15,59406697,0.7517571884984027,2352,1564,3916,+
chr15,59406698,1.5431625260248218,4155,3922,8077,+
chr15,59406700,1.4836071952045575,4455,4330,8785,+
chr15,59406702,1.524875621890547,3064,3014,6078,+
chr15,59406704,1.3853750753736087,2023,1426,3449,+
chr15,59406739,1.1527991002335245,6763,5000,11763,+
chr15,59408999,2.6414285714285715,902,587,1489,+
chr15,59409427,2.3342065868263475,692,500,1192,+
chr15,59409447,0.4924953095684803,769,571,1340,+
chr15,59409485,1.7856312485468495,719,560,1279,+
chr15,59409497,1.5519344387268916,957,635,1592,+
chr15,59417139,1.281315123980921,1433,1028,2461,+
chr15,60060815,2.724096796182686,694,325,1019,+
chr15,60060816,2.724096796182686,694,325,1019,+
chr15,63349205,1.5721238938053097,626,564,1190,+
chr15,63433951,1.2775878843277098,562,445,1007,+
chr15,64388340,5.031355154481493,764,466,1230,+
chr15,64388341,4.949634182045673,1404,947,2351,+
chr15,64388342,4.716234644111813,1614,1101,2715,+
chr15,64404771,0.41089131049593086,643,557,1200,+
chr15,64404774,0.5004217064365724,824,642,1466,+
chr15,64404788,0.45576767972708837,1857,1397,3254,+
chr15,64404789,0.4718266519993162,1640,1219,2859,+
chr15,64404790,0.4408786817528735,1266,927,2193,+
chr15,64404794,1.7276636826399858,634,421,1055,+
chr15,64410994,1.0296875,658,479,1137,+
chr15,64410996,1.0296875,658,479,1137,+
chr15,64419381,3.8728744878929517,1088,749,1837,+
chr15,64424025,2.770886182184403,591,455,1046,+
chr15,64428552,1.1049118873319435,725,561,1286,+
chr15,64706286,2.4777301862979777,674,399,1073,+
chr15,64970409,3.466201382021695,757,491,1248,+
chr15,64970411,3.6660732191757535,623,395,1018,+
chr15,65851029,0.4163967750826902,1150,906,2056,+
chr15,65851031,0.4782281488999392,1811,1358,3169,+
chr15,65851036,3.0930110352075677,653,518,1171,+
chr15,65855125,2.145898123283785,1516,1078,2594,+
chr15,65855148,2.549264155649788,875,632,1507,+
chr15,65855154,1.8679610018490505,888,660,1548,+
chr15,65855183,1.0851151779953305,1694,1359,3053,+
chr15,65856566,2.2107317073170734,617,409,1026,+
chr15,65862462,1.7714285714285714,711,444,1155,+
chr15,65862475,0.6778506649460515,609,546,1155,+
chr15,65862476,0.6959317148874848,875,557,1432,+
chr15,65862504,1.7495145631067963,688,514,1202,+
chr15,65862509,0.47136706770464737,1389,941,2330,+
chr15,65862512,0.599439079806873,1534,1005,2539,+
chr15,65868712,2.886993603411514,676,468,1144,+
chr15,65868909,4.064039408866996,604,405,1009,+
chr15,65869035,2.0934358367829686,707,444,1151,+
chr15,65869097,0.396649591582445,572,465,1037,+
chr15,65869101,0.4092795171633346,619,481,1100,+
chr15,65869868,2.3698959178451102,646,560,1206,+
chr15,65869953,1.7931308634123069,1252,661,1913,+
chr15,65869955,1.7931308634123069,1252,661,1913,+
chr15,65870120,2.701606425702811,650,497,1147,+
chr15,65870121,2.701606425702811,650,497,1147,+
chr15,65870300,2.3890763052208834,675,414,1089,+
chr15,66161880,0.7719077702825512,1008,615,1623,+
chr15,66169682,2.060042735042735,621,389,1010,+
chr15,66180167,2.438733125649013,670,427,1097,+
chr15,66180176,1.5305111803093905,1294,999,2293,+
chr15,66180197,2.274169921875,689,511,1200,+
chr15,66180691,0.3710245405524375,612,465,1077,+
chr15,66181283,4.33066874374096,868,462,1330,+
chr15,66618528,1.0409387257539884,705,575,1280,+
chr15,66618546,1.3509024612589977,586,450,1036,+
chr15,66679740,2.4550341835755916,919,641,1560,+
chr15,66679741,2.6464019851116625,631,402,1033,+
chr15,66727384,2.750924805136635,700,558,1258,+
chr15,66727433,2.1566666666666667,646,549,1195,+
chr15,66727516,2.3114370067394625,696,455,1151,+
chr15,66729084,1.714705882352941,582,526,1108,+
chr15,66735644,1.9900436215322146,1147,831,1978,+
chr15,66779588,1.746006622106199,731,524,1255,+
chr15,66783071,1.978700425567191,812,659,1471,+
chr15,66783586,1.6436212633721088,1012,712,1724,+
chr15,66797687,13.598346251885925,1416,1261,2677,+
chr15,66797688,13.598346251885925,1416,1261,2677,+
chr15,66807868,0.5806818181818182,583,439,1022,+
chr15,66841705,2.67549200994812,839,625,1464,+
chr15,67483228,0.6998492881206039,565,470,1035,+
chr15,68480138,1.0322912291536526,764,525,1289,+
chr15,68480157,2.9097744360902253,872,678,1550,+
chr15,68480158,2.6441566001422148,1358,912,2270,+
chr15,68585568,1.027568477971811,643,388,1031,+
chr15,68585570,2.2991735041664567,608,409,1017,+
chr15,69562705,3.375773809113108,577,465,1042,+
chr15,69563048,2.2337356118463294,624,497,1121,+
chr15,69563748,1.5585840809753853,638,402,1040,+
chr15,69718753,2.2123758575231967,705,587,1292,+
chr15,69721459,1.3950061948012829,954,702,1656,+
chr15,69732701,2.6873056057866185,863,552,1415,+
chr15,69732702,1.8153645098595816,1382,931,2313,+
chr15,69732741,2.604953145917001,670,497,1167,+
chr15,69732742,1.9748334566987413,695,385,1080,+
chr15,69745155,0.9571710380300074,4855,3664,8519,+
chr15,69745156,0.7173464959695163,41800,25003,66803,+
chr15,69745157,0.669720703962141,31511,18019,49530,+
chr15,69745158,0.6875097827178911,42427,22759,65186,+
chr15,69745160,0.9417405362949062,32580,12520,45100,+
chr15,69745162,1.7539036664270309,17153,5849,23002,+
chr15,69745167,1.4922826682645876,32257,18072,50329,+
chr15,69745229,1.1376378492307977,10023,7345,17368,+
chr15,69745318,1.182957540129881,54532,39181,93713,+
chr15,69745991,1.2069370441948124,73802,48521,122323,+
chr15,69745992,1.2069370441948124,73802,48521,122323,+
chr15,69745997,1.078818394101843,57438,40738,98176,+
chr15,69746006,0.8965418124689356,20453,15426,35879,+
chr15,69747542,1.354507046370084,15128,10228,25356,+
chr15,69747591,1.699167859025529,10617,7316,17933,+
chr15,69747594,1.6037159468924462,33189,22362,55551,+
chr15,69747765,1.2247804450460618,894,678,1572,+
chr15,69747772,1.118989568564837,52133,39927,92060,+
chr15,69747774,1.1928460496135955,112811,81793,194604,+
chr15,69747775,1.2018977891230684,101329,75417,176746,+
chr15,69747785,1.4164537059825986,16546,13547,30093,+
chr15,69747789,1.041037836438249,72496,63577,136073,+
chr15,69747790,1.0618454115367377,94943,78188,173131,+
chr15,69747793,1.1762990208842334,111864,86824,198688,+
chr15,69747794,1.1728235278982335,116380,86307,202687,+
chr15,71953004,2.356385722996107,1128,926,2054,+
chr15,71953005,2.356385722996107,1128,926,2054,+
chr15,72073477,1.129255376634605,773,486,1259,+
chr15,72073478,1.129255376634605,773,486,1259,+
chr15,72073497,1.821331595525144,817,593,1410,+
chr15,72073518,1.8386982526454396,3336,2728,6064,+
chr15,72073519,1.8386982526454396,3336,2728,6064,+
chr15,72073522,2.831033912324235,1336,1208,2544,+
chr15,72848226,0.9216885334923733,870,609,1479,+
chr15,72873300,2.6274928774928776,832,467,1299,+
chr15,72873301,2.6274928774928776,832,467,1299,+
chr15,72876175,7.4907306860489244,871,693,1564,+
chr15,72876176,6.502087494176557,1081,896,1977,+
chr15,73009123,1.3635544167437637,1142,831,1973,+
chr15,73009124,0.7346185776219907,723,585,1308,+
chr15,73009125,0.7346185776219907,723,585,1308,+
chr15,73009128,0.9327731092436976,554,509,1063,+
chr15,73009130,0.9327731092436976,554,509,1063,+
chr15,73009132,1.0018696581196582,725,575,1300,+
chr15,73009134,1.5020542671162276,1450,1205,2655,+
chr15,73023976,3.059794402610563,632,416,1048,+
chr15,74000737,2.6246687054026503,627,544,1171,+
chr15,74000739,2.3246654184869286,985,873,1858,+
chr15,74000741,2.083449390006128,679,618,1297,+
chr15,74005449,0.4439042498871628,517,485,1002,+
chr15,74006168,0.8620026525198939,618,519,1137,+
chr15,74006169,0.8620026525198939,618,519,1137,+
chr15,74912447,2.615758044971466,788,696,1484,+
chr15,75182920,0.9400484914404805,937,517,1454,+
chr15,75182927,8.93987341772152,564,473,1037,+
chr15,75182928,8.93987341772152,564,473,1037,+
chr15,75628402,0.8171042532817772,659,421,1080,+
chr15,75630451,2.444381330782063,1116,685,1801,+
chr15,76205545,1.6384092098377814,605,440,1045,+
chr15,76209667,3.906633906633907,635,406,1041,+
chr15,76225081,2.566620323009176,775,519,1294,+
chr15,76225225,1.876440756108806,659,481,1140,+
chr15,76225290,1.7124901806755697,544,468,1012,+
chr15,77224703,2.0281594668273435,835,717,1552,+
chr15,77224705,0.5577819198508854,683,463,1146,+
chr15,77224712,0.3614973262032085,753,492,1245,+
chr15,77224721,1.7239579117766086,1038,705,1743,+
chr15,77224736,0.6204721809476638,816,672,1488,+
chr15,77224741,1.8703771051125,2296,1779,4075,+
chr15,77240866,2.2213870843664,2234,1508,3742,+
chr15,77241421,0.7140646335912608,1271,844,2115,+
chr15,77241428,1.7898038980988291,2110,1616,3726,+
chr15,77241429,1.7898038980988291,2110,1616,3726,+
chr15,77241560,1.7549627791563274,1721,1301,3022,+
chr15,77769899,5.321066219434523,722,565,1287,+
chr15,78447585,1.1971803036648028,787,495,1282,+
chr15,78449904,0.3816895179124281,862,475,1337,+
chr15,78449912,1.7624584717607974,1060,601,1661,+
chr15,78449915,1.3507423115630213,3015,1811,4826,+
chr15,78449918,1.5515926835404317,4956,2997,7953,+
chr15,78449919,1.3190954377457917,4557,2808,7365,+
chr15,78449920,1.5570731707317074,4955,3074,8029,+
chr15,78449922,1.5816379653718091,3434,2147,5581,+
chr15,78449934,1.7909435040354258,1474,1076,2550,+
chr15,78449939,2.3463236917641863,1603,1293,2896,+
chr15,78449945,1.7483802011699008,2370,1630,4000,+
chr15,78454029,2.560212604403948,732,438,1170,+
chr15,78455874,2.2876939550048085,579,506,1085,+
chr15,78458582,0.9981995380808081,1547,1242,2789,+
chr15,78458583,1.6627027027027026,768,517,1285,+
chr15,78458585,4.124304267161409,701,538,1239,+
chr15,78458591,1.8842592592592593,923,647,1570,+
chr15,78461274,1.7095709570957094,739,504,1243,+
chr15,78461806,1.8137474821461268,1298,1015,2313,+
chr15,78461807,1.8137474821461268,1298,1015,2313,+
chr15,78462035,2.830835117773019,660,466,1126,+
chr15,78832784,0.5581268008120553,1967,1319,3286,+
chr15,78832785,0.5950190121163228,3968,2277,6245,+
chr15,78832786,0.5837679196142441,2387,1107,3494,+
chr15,78832787,0.7920503899765786,621,410,1031,+
chr15,78832790,1.2816351238985284,1222,618,1840,+
chr15,78832799,1.235787667119659,2118,1221,3339,+
chr15,78832834,1.6785442073170733,765,511,1276,+
chr15,78832835,1.5294502617801051,1196,763,1959,+
chr15,78832851,1.6184440800163362,2431,1820,4251,+
chr15,78834256,2.078047601788088,1031,800,1831,+
chr15,78834523,1.755331194565012,953,756,1709,+
chr15,78834524,0.6806555782248584,2098,1357,3455,+
chr15,78834536,1.6274259531991493,1057,872,1929,+
chr15,78834836,1.715597711532671,1289,971,2260,+
chr15,78837214,2.322860238353196,1071,851,1922,+
chr15,78838093,1.6604175302407955,2819,1783,4602,+
chr15,79165298,4.920716112531969,961,68,1029,+
chr15,79165299,5.091697168943074,2179,154,2333,+
chr15,79165300,5.268465241617014,2405,186,2591,+
chr15,79165301,4.316666666666666,998,80,1078,+
chr15,79165304,8.059890855087344,1668,124,1792,+
chr15,79165309,5.846803191677908,1194,123,1317,+
chr15,79165310,5.676085429928041,1618,155,1773,+
chr15,79165311,7.378484883480413,3516,345,3861,+
chr15,79165312,8.115369018653691,1600,136,1736,+
chr15,79165313,5.9923771269246995,4212,465,4677,+
chr15,79165314,7.035140534196058,2856,317,3173,+
chr15,79165315,7.260798250410059,1659,176,1835,+
chr15,79165316,6.433976634440312,1600,190,1790,+
chr15,79165319,23.278480370912366,3312,770,4082,+
chr15,79165320,20.790703398993326,4786,1389,6175,+
chr15,79165321,17.17209527921038,7198,2287,9485,+
chr15,79165322,16.095631476737772,6849,2505,9354,+
chr15,79165323,15.801934566815712,4454,1922,6376,+
chr15,79165324,11.275484979622664,3007,1438,4445,+
chr15,79165326,4.192403765084637,4460,2195,6655,+
chr15,79165327,3.626793400286944,1700,737,2437,+
chr15,79165328,7.81585033317714,6232,4731,10963,+
chr15,79165329,7.278433029357417,5949,4867,10816,+
chr15,79165330,7.390347168369424,5541,4705,10246,+
chr15,79165336,2.1848952194265023,1234,1472,2706,+
chr15,79165345,1.561098653451532,6487,8739,15226,+
chr15,79165346,1.1215873064338018,2547,4225,6772,+
chr15,79165347,1.2062219597567432,5798,7593,13391,+
chr15,79165348,0.4831964555867733,812,1321,2133,+
chr15,79165351,0.5603423372467364,3137,3764,6901,+
chr15,79165353,0.616522210184182,3593,3691,7284,+
chr15,79165354,0.5810801430482391,7945,10641,18586,+
chr15,79165355,0.5827125714387072,9262,12826,22088,+
chr15,79165356,0.5730418943533697,4234,6404,10638,+
chr15,79165357,0.6135235710611675,7606,10183,17789,+
chr15,79165386,0.6685595255958577,3285,3290,6575,+
chr15,79179649,1.0833255975057605,1544,899,2443,+
chr15,79179652,0.4730269160583942,1105,547,1652,+
chr15,79179654,1.836856981345393,1476,579,2055,+
chr15,79179656,1.279274326553051,2326,917,3243,+
chr15,79179657,1.8245081293097996,823,478,1301,+
chr15,79179658,1.3466098081023457,2492,1004,3496,+
chr15,79179659,1.1073923698745385,1729,700,2429,+
chr15,79179662,2.217435897435897,939,389,1328,+
chr15,79179675,1.4457598988628237,3541,1694,5235,+
chr15,79183336,0.6619404619348707,2254,1366,3620,+
chr15,79183337,1.277928013711674,4193,2064,6257,+
chr15,79183340,1.5010856352822188,4556,2292,6848,+
chr15,79183343,1.5755594591345687,4954,2565,7519,+
chr15,79183350,1.613377656895336,5862,3308,9170,+
chr15,79183848,1.6180547115634822,7508,4948,12456,+
chr15,79183879,1.2426328626785244,14814,8319,23133,+
chr15,79186432,1.0708306181237122,5947,3940,9887,+
chr15,79186436,1.114708572714358,6311,4182,10493,+
chr15,79186439,1.3990757780231464,2758,1880,4638,+
chr15,79186457,1.4866916536397332,3580,2677,6257,+
chr15,79186460,1.856459797033568,3804,2967,6771,+
chr15,79186558,1.6346910420425502,3152,1985,5137,+
chr15,79186566,1.4015911872705016,2081,1289,3370,+
chr15,79189440,1.0308745949791023,4763,3831,8594,+
chr15,79189605,1.4078151640272158,3449,2485,5934,+
chr15,79189799,1.8108963409152206,1706,1134,2840,+
chr15,79603485,1.0818447929382802,695,439,1134,+
chr15,79603486,0.5242350451348433,917,600,1517,+
chr15,79603494,1.359597279125152,844,586,1430,+
chr15,79603515,2.2685185185185186,741,476,1217,+
chr15,79603703,1.9452727435050443,806,486,1292,+
chr15,79603706,1.8405383671897768,1349,953,2302,+
chr15,79603736,3.057414194801764,2114,1572,3686,+
chr15,79603751,1.1166014554208552,2061,1609,3670,+
chr15,79606099,1.9928525173284577,1853,1361,3214,+
chr15,79606173,1.794080947048472,1218,892,2110,+
chr15,79614353,2.022110472541507,1077,782,1859,+
chr15,79614362,2.1480741036918567,1588,1280,2868,+
chr15,79614367,1.4964570635746497,1207,960,2167,+
chr15,79614425,1.5168072177616188,1407,860,2267,+
chr15,79614440,1.5085558949851794,3352,2167,5519,+
chr15,79614442,1.5085558949851794,3352,2167,5519,+
chr15,79614573,1.7195121951219514,704,614,1318,+
chr15,79614636,1.9871794871794872,664,545,1209,+
chr15,79614699,1.3147153203014603,1962,1543,3505,+
chr15,79614827,2.12252608852105,1003,793,1796,+
chr15,79614908,1.6290275761973876,1097,688,1785,+
chr15,79614925,2.1853377544438795,2222,1504,3726,+
chr15,79614972,1.4909872082804412,1293,1044,2337,+
chr15,79615087,1.4728935698447891,1041,879,1920,+
chr15,80390825,0.22583801651719923,587,425,1012,+
chr15,80390827,0.22583801651719923,587,425,1012,+
chr15,80412693,0.8548133595284874,686,508,1194,+
chr15,80412694,0.8548133595284874,686,508,1194,+
chr15,80414082,2.012687427912341,697,577,1274,+
chr15,80415084,2.867237507080947,1052,781,1833,+
chr15,80429914,1.5857854769814903,809,601,1410,+
chr15,80429948,2.438833993901093,1791,1473,3264,+
chr15,80429949,2.580462050233467,1261,1056,2317,+
chr15,80430129,0.537468982630273,911,619,1530,+
chr15,80430131,1.9743589743589745,615,389,1004,+
chr15,80873579,3.6033834586466167,638,531,1169,+
chr15,80873580,3.6033834586466167,638,531,1169,+
chr15,80873581,3.6033834586466167,638,531,1169,+
chr15,89011192,1.6000352112676055,1121,799,1920,+
chr15,89011194,1.6000352112676055,1121,799,1920,+
chr15,89011211,1.7845257903494176,769,600,1369,+
chr15,89011215,1.9463408293253608,901,784,1685,+
chr15,89011216,1.7467592592592591,685,404,1089,+
chr15,89011219,3.002785985647953,740,514,1254,+
chr15,89011235,0.7818435627497718,1325,1146,2471,+
chr15,89011243,0.5615774240231549,1193,690,1883,+
chr15,89011245,1.1117316134451691,3078,2424,5502,+
chr15,89011247,1.417656500802568,1471,889,2360,+
chr15,89011248,2.210526315789474,1247,987,2234,+
chr15,89015857,1.4842381786339751,1807,1141,2948,+
chr15,89015863,0.7519381961126885,3147,2431,5578,+
chr15,89015864,0.6547598520987796,2356,1523,3879,+
chr15,89015934,2.149774919614148,1012,621,1633,+
chr15,89015936,2.149774919614148,1012,621,1633,+
chr15,89020229,1.0260965489989462,583,512,1095,+
chr15,89021264,2.4632098828144855,1011,697,1708,+
chr15,89787241,2.1017997559330723,638,478,1116,+
chr15,89828384,3.9068878162250664,705,571,1276,+
chr15,89835960,2.5016064448547017,679,563,1242,+
chr15,89837192,0.9520958083832336,688,500,1188,+
chr15,89837193,0.9520958083832336,688,500,1188,+
chr15,89838281,0.4603898663372123,784,484,1268,+
chr15,89838313,1.9860579622086327,1474,1082,2556,+
chr15,89838315,1.8249297573435503,1798,1304,3102,+
chr15,89838316,1.7379406307977736,1248,923,2171,+
chr15,89838317,1.578468812511366,619,422,1041,+
chr15,89838319,1.3286412954134474,778,615,1393,+
chr15,89843039,1.978386529278713,767,691,1458,+
chr15,89843046,2.1882118451025057,869,877,1746,+
chr15,89843049,1.5192500174225458,2353,1967,4320,+
chr15,89850742,0.6257107852861361,1135,805,1940,+
chr15,89850744,0.41318407960199,603,401,1004,+
chr15,89850750,0.867105123505229,709,584,1293,+
chr15,89858557,1.6482834112847051,773,772,1545,+
chr15,89858558,1.6482834112847051,773,772,1545,+
chr15,89858567,1.88917373299152,957,921,1878,+
chr15,89858568,1.88917373299152,957,921,1878,+
chr15,90809276,2.4889228418640186,723,615,1338,+
chr15,90809278,2.4889228418640186,723,615,1338,+
chr15,90809385,0.5579237349572278,591,417,1008,+
chr15,90809557,0.8229823897820793,1932,1211,3143,+
chr15,90809558,0.9554654983570648,1406,829,2235,+
chr15,90814567,1.9230507088331512,854,523,1377,+
chr15,90814690,1.7307426636601126,1331,1008,2339,+
chr15,90814779,2.0884160393301583,876,565,1441,+
chr15,90814780,2.11087420042644,714,468,1182,+
chr15,90814957,1.7233263598326358,658,477,1135,+
chr15,90815157,2.0820860248936506,880,576,1456,+
chr15,90815172,1.5106085526315791,941,607,1548,+
chr15,90931532,1.197976620829372,648,412,1060,+
chr15,90969415,1.2248375653366044,736,534,1270,+
chr15,90969483,1.7513978049285566,994,877,1871,+
chr15,90969484,1.7513978049285566,994,877,1871,+
chr15,90972828,2.052865612648221,830,505,1335,+
chr15,90972833,1.8367634952369751,821,772,1593,+
chr15,90972837,1.7059270516717326,897,895,1792,+
chr15,90972841,0.7290855273407072,1259,916,2175,+
chr15,90972846,2.1188418019537565,1021,1053,2074,+
chr15,90984828,2.160260290556901,570,471,1041,+
chr15,90984837,1.5909431903430404,647,472,1119,+
chr15,90991948,2.03872,830,624,1454,+
chr15,90991949,2.03872,830,624,1454,+
chr15,91010769,2.5940004758708612,620,493,1113,+
chr15,91016125,0.9935321595400648,789,505,1294,+
chr15,91016126,0.9935321595400648,789,505,1294,+
chr15,91016163,2.429242082292902,1832,1225,3057,+
chr15,91016164,2.1923914865091336,1265,917,2182,+
chr15,91016167,1.505263157894737,701,539,1240,+
chr15,91016171,0.44937319189971064,931,487,1418,+
chr15,91016180,1.7023805895083366,1116,618,1734,+
chr15,91016194,2.1446516939474685,1251,709,1960,+
chr15,91016196,0.6459369461046375,2550,1788,4338,+
chr15,91016198,0.9038070432382117,3961,2623,6584,+
chr15,91016207,1.5471285763173106,4943,3285,8228,+
chr15,91016208,0.4466207006074401,1533,778,2311,+
chr15,91016209,1.5063896685546565,5095,3426,8521,+
chr15,91016210,1.3683701613525132,5690,3866,9556,+
chr15,91016213,1.4030310559006212,2171,1126,3297,+
chr15,91016214,1.5585007219800555,2231,1620,3851,+
chr15,91016216,1.6813621238425926,2596,1439,4035,+
chr15,91016223,0.7563079763401308,6363,3870,10233,+
chr15,91016228,1.487349195710456,3030,2237,5267,+
chr15,91020433,1.9187253848907984,698,440,1138,+
chr15,91020910,0.5419323979591837,617,391,1008,+
chr15,91020960,2.829577202458559,632,412,1044,+
chr15,91025289,0.5161982825917252,919,731,1650,+
chr15,91025291,0.5161982825917252,919,731,1650,+
chr15,91026610,2.3481537040650546,926,602,1528,+
chr15,91030262,1.7065384615384616,611,415,1026,+
chr15,91030291,0.5196587315792613,669,452,1121,+
chr15,91030807,2.484276729559748,631,423,1054,+
chr15,91034624,2.3409703504043127,578,423,1001,+
chr15,91034630,0.5111733377258002,664,466,1130,+
chr15,91034633,0.577690248952179,714,482,1196,+
chr15,91034637,2.212051868802441,695,436,1131,+
chr15,91035834,1.1506635072822526,782,608,1390,+
chr15,91035895,0.5580068467097756,651,477,1128,+
chr15,91040502,1.9858823529411764,632,374,1006,+
chr15,91040543,1.8848463440480399,666,446,1112,+
chr15,91044112,2.753630530226275,708,422,1130,+
chr15,91044418,2.840080233406273,622,456,1078,+
chr15,91044419,2.840080233406273,622,456,1078,+
chr15,91044637,0.43220925205360994,768,513,1281,+
chr15,91044892,1.4202175046895116,618,399,1017,+
chr15,91073342,2.408362369337979,863,368,1231,+
chr15,91073343,2.408362369337979,863,368,1231,+
chr15,91185272,0.7162230938819173,647,554,1201,+
chr15,91186657,13.499057540778816,662,599,1261,+
chr15,91186964,17.556874288501536,2184,620,2804,+
chr15,91186965,15.410007454481445,2977,1551,4528,+
chr15,91186966,12.640550156332,3448,2017,5465,+
chr15,91186967,9.335526959305374,2968,2076,5044,+
chr15,91186968,6.61847028086637,1838,1412,3250,+
chr15,91186969,4.419361936193619,663,504,1167,+
chr15,91186971,1.6654841374465248,616,796,1412,+
chr15,91186974,2.996520398435975,562,609,1171,+
chr15,91187001,5.004959969730923,1209,1876,3085,+
chr15,91187414,2.946428571428572,659,447,1106,+
chr15,91187416,2.946428571428572,659,447,1106,+
chr15,91187771,2.2143047597445094,1081,854,1935,+
chr15,91188082,1.0,645,493,1138,+
chr15,91188083,1.0,645,493,1138,+
chr15,91188422,2.9773764407875127,792,559,1351,+
chr15,91463031,3.4399480529012965,599,449,1048,+
chr15,91463033,2.442183657634107,921,758,1679,+
chr15,91504916,0.4344524380495603,1086,833,1919,+
chr15,91504918,0.4344524380495603,1086,833,1919,+
chr15,91504931,1.9414447346579007,1486,940,2426,+
chr15,93428754,0.6351400149227976,667,457,1124,+
chr15,93524609,2.7361957921692754,623,418,1041,+
chr15,93524662,1.6280256634587345,637,507,1144,+
chr15,93552448,2.621736796259907,778,491,1269,+
chr15,93558086,4.215776633233939,863,526,1389,+
chr15,93558088,4.215776633233939,863,526,1389,+
chr15,93558091,2.4575504623595545,650,449,1099,+
chr15,93558094,2.274024212588537,1560,1170,2730,+
chr15,93558095,2.274024212588537,1560,1170,2730,+
chr15,93558096,2.274024212588537,1560,1170,2730,+
chr15,95030531,1.5592841163310962,815,595,1410,+
chr15,95030545,1.4908707402280668,1051,777,1828,+
chr15,96880886,0.3315787755175832,597,451,1048,+
chr15,96881079,1.3568277318180033,846,767,1613,+
chr15,96881080,0.8964905203711175,925,924,1849,+
chr15,96881082,0.3936765127616863,645,633,1278,+
chr15,96881114,1.0850028273010857,1285,840,2125,+
chr15,99478118,6.1606622941408755,949,703,1652,+
chr15,99478119,6.1606622941408755,949,703,1652,+
chr15,99478120,6.3742767281517745,697,536,1233,+
chr15,99478129,5.415785985417888,568,468,1036,+
chr15,99478167,0.8942193649017933,697,653,1350,+
chr15,99482517,2.380819626428771,609,421,1030,+
chr15,99482519,2.8957822085889573,920,651,1571,+
chr15,99482520,2.8944515306122454,625,447,1072,+
chr15,99482548,3.403564899451554,676,546,1222,+
chr15,99482550,3.403564899451554,676,546,1222,+
chr15,99500317,2.141133557800224,586,485,1071,+
chr15,99500318,2.278564313036403,734,611,1345,+
chr15,99673976,1.8363740959894803,1089,675,1764,+
chr15,99673977,1.8363740959894803,1089,675,1764,+
chr16,135450,8.121203802306605,582,472,1054,+
chr16,135561,3.02141536622614,632,484,1116,+
chr16,313718,1.161209352450111,827,638,1465,+
chr16,449638,2.853139821632314,1007,771,1778,+
chr16,450400,3.0628569795794727,646,491,1137,+
chr16,450407,3.2723037604049914,883,643,1526,+
chr16,450481,2.1835848391676786,732,494,1226,+
chr16,731221,0.25841983852260425,589,420,1009,+
chr16,731496,3.651919778452662,712,389,1101,+
chr16,732026,1.6890680644105727,908,709,1617,+
chr16,732198,1.9644856676636895,1366,815,2181,+
chr16,732200,2.0193487494100992,777,488,1265,+
chr16,732442,2.3076267249823537,625,468,1093,+
chr16,732557,3.276191762607803,921,571,1492,+
chr16,732697,22.925002988024097,1922,954,2876,+
chr16,732698,24.0229293318565,3215,1583,4798,+
chr16,732700,12.828090553586701,1091,579,1670,+
chr16,765917,3.852266938359653,795,301,1096,+
chr16,816178,5.538473908028167,591,428,1019,+
chr16,1364069,1.0728198167628096,607,420,1027,+
chr16,1364071,1.0728198167628096,607,420,1027,+
chr16,1364316,1.6381493841279364,830,662,1492,+
chr16,1365714,1.6350226244343893,622,441,1063,+
chr16,1370474,1.6825469210050206,1791,1532,3323,+
chr16,1370475,1.6825469210050206,1791,1532,3323,+
chr16,1374777,2.957142857142857,620,391,1011,+
chr16,1374913,287.07909604519773,832,353,1185,+
chr16,1374914,162.37055300670212,2932,1558,4490,+
chr16,1374915,162.37055300670212,2932,1558,4490,+
chr16,1374958,0.3285963336679169,621,822,1443,+
chr16,1374959,0.45304153497181976,1162,1436,2598,+
chr16,1552050,2.226825092666942,745,444,1189,+
chr16,1705259,2.523186761155558,663,394,1057,+
chr16,1735572,2.2264220193640964,556,458,1014,+
chr16,1748994,2.6167158709151987,611,516,1127,+
chr16,1748996,2.42261690647482,1252,1111,2363,+
chr16,1748997,2.518788280086078,950,862,1812,+
chr16,1748998,2.518788280086078,950,862,1812,+
chr16,1749288,13.215720746378214,958,1143,2101,+
chr16,1749289,11.290955605705886,1059,1297,2356,+
chr16,1749396,0.378205873036956,582,480,1062,+
chr16,1749460,2.0454061758642723,634,555,1189,+
chr16,1749723,1.9512081730094335,566,493,1059,+
chr16,1749830,1.0258064516129033,688,519,1207,+
chr16,1749831,0.8384948783010544,1036,816,1852,+
chr16,1750160,0.4645001743211095,739,567,1306,+
chr16,1751188,0.9946044047677439,750,550,1300,+
chr16,1751189,0.9946044047677439,750,550,1300,+
chr16,1877753,1.3382539442136367,815,515,1330,+
chr16,1877795,1.2004668998071604,1065,646,1711,+
chr16,2009706,3.687529861442905,680,482,1162,+
chr16,2009716,2.5606295851674004,584,487,1071,+
chr16,2025884,4.082075500808539,637,477,1114,+
chr16,2222208,2.175891758917589,731,541,1272,+
chr16,2222210,0.1590337365174541,922,568,1490,+
chr16,2222213,1.5592217799060581,5008,3363,8371,+
chr16,2222214,0.9945576962680106,5002,3025,8027,+
chr16,2222215,1.5592217799060581,5008,3363,8371,+
chr16,2223307,3.0873264015123976,964,808,1772,+
chr16,2223309,3.0873264015123976,964,808,1772,+
chr16,2223322,1.667347250736205,1206,919,2125,+
chr16,2223999,2.520516835314923,586,461,1047,+
chr16,2224284,1.4411694698907487,557,444,1001,+
chr16,2227538,6.781600500872262,831,530,1361,+
chr16,2227797,2.0695842225177583,694,498,1192,+
chr16,2256613,2.022023962744372,636,401,1037,+
chr16,2258597,0.5309402587030619,1261,881,2142,+
chr16,2258598,0.5309402587030619,1261,881,2142,+
chr16,2258599,0.5309402587030619,1261,881,2142,+
chr16,2258610,2.3040194639775216,1129,673,1802,+
chr16,2258768,2.504708097928437,664,353,1017,+
chr16,2284989,0.3666367713004484,583,445,1028,+
chr16,2284991,0.3726847882009947,914,685,1599,+
chr16,2284992,0.5097163865546218,646,475,1121,+
chr16,2284996,2.2596598639455783,562,524,1086,+
chr16,2284997,2.1728124956535657,922,760,1682,+
chr16,2285459,1.359653047135839,848,649,1497,+
chr16,2569250,1.5857091184111012,1161,980,2141,+
chr16,2569251,1.5857091184111012,1161,980,2141,+
chr16,2569740,2.238799119545106,635,572,1207,+
chr16,2747968,2.7088377574002576,648,402,1050,+
chr16,2806538,3.100591227213151,872,469,1341,+
chr16,2806550,3.651811513669705,1216,817,2033,+
chr16,2806551,3.651811513669705,1216,817,2033,+
chr16,2807937,1.3418148757537405,777,627,1404,+
chr16,2807940,2.8077753779697625,649,462,1111,+
chr16,2807942,2.8077753779697625,649,462,1111,+
chr16,2808486,1.756199984153395,714,600,1314,+
chr16,2808489,2.1022467201375075,2043,1815,3858,+
chr16,2808491,1.819532830151448,1552,1397,2949,+
chr16,2808991,1.8904716849842091,1819,1440,3259,+
chr16,2808993,1.8904716849842091,1819,1440,3259,+
chr16,2809705,6.322444052972996,587,538,1125,+
chr16,2809706,5.720993903090983,724,634,1358,+
chr16,2814577,4.305555555555555,774,395,1169,+
chr16,2814579,4.305555555555555,774,395,1169,+
chr16,2814729,8.397900176471468,691,504,1195,+
chr16,2816774,3.297764877383526,605,412,1017,+
chr16,2817150,1.5516462422187736,567,499,1066,+
chr16,2817663,0.9699573695240391,600,423,1023,+
chr16,2821098,14.967685076380729,1018,73,1091,+
chr16,2821099,13.460526315789473,1022,94,1116,+
chr16,2821124,11.373734646856033,565,513,1078,+
chr16,2821127,4.361388849144654,574,985,1559,+
chr16,2821129,1.183921302578019,276,736,1012,+
chr16,2867258,2.1578556642067235,719,512,1231,+
chr16,2867452,0.5608888888888889,630,374,1004,+
chr16,2867846,0.5918045705279747,750,422,1172,+
chr16,2867895,1.781347899429673,1151,843,1994,+
chr16,2867896,1.781347899429673,1151,843,1994,+
chr16,2867907,0.6197292069632495,711,469,1180,+
chr16,2867937,2.567664670658682,602,500,1102,+
chr16,2867958,2.066666666666667,695,579,1274,+
chr16,2867961,1.8838546727589442,1761,1288,3049,+
chr16,2868763,1.7682795077498767,2313,2009,4322,+
chr16,2868793,1.2861139896373055,1378,1157,2535,+
chr16,2868874,2.794177897574124,1363,1112,2475,+
chr16,2870966,1.6454659010849628,1761,1394,3155,+
chr16,2871005,1.0821692231460702,3089,2316,5405,+
chr16,2871032,0.6048813123414312,1618,1250,2868,+
chr16,2871370,1.484607402282947,1627,1077,2704,+
chr16,2871397,1.4031395549422114,1742,1053,2795,+
chr16,2871490,1.693884297520661,731,483,1214,+
chr16,2871641,2.4186704384724185,569,504,1073,+
chr16,2946562,2.7266031601828398,651,540,1191,+
chr16,2946748,2.1292413069123755,696,480,1176,+
chr16,2949060,1.4009624483357168,651,435,1086,+
chr16,2949105,2.417134306023195,922,485,1407,+
chr16,2949106,2.4749115166441675,1226,703,1929,+
chr16,2949180,2.716038722840624,920,721,1641,+
chr16,3071260,2.220149253731343,764,401,1165,+
chr16,3071262,1.4261598023560915,1598,1104,2702,+
chr16,3071620,0.4305820105820106,625,524,1149,+
chr16,3071647,2.1369346733668344,728,596,1324,+
chr16,3071793,4.486880466472304,569,489,1058,+
chr16,3071816,2.305436749875895,1137,766,1903,+
chr16,3071871,1.9452667283379588,681,563,1244,+
chr16,3071951,2.3387658037686845,655,406,1061,+
chr16,3071987,2.97045233787298,2299,1518,3817,+
chr16,3071988,2.742588364167517,2500,1714,4214,+
chr16,3072027,1.3860407276647484,1738,1465,3203,+
chr16,3072029,1.990507484483388,939,829,1768,+
chr16,3072124,2.8227215980024964,645,533,1178,+
chr16,3072155,5.253922130825702,1395,1172,2567,+
chr16,3072156,4.229082847900573,1435,1149,2584,+
chr16,3072157,4.142401392111369,620,430,1050,+
chr16,3072193,0.6237396426075671,780,566,1346,+
chr16,3072275,0.7851899323389913,3019,2057,5076,+
chr16,3569931,1.779855157605931,1403,804,2207,+
chr16,3569932,1.6587125416204218,975,543,1518,+
chr16,3569933,1.8331236237810629,776,577,1353,+
chr16,3569934,3.1267468409217796,682,421,1103,+
chr16,3569945,1.5428522157858562,1577,1144,2721,+
chr16,4484384,0.9020501138952164,683,438,1121,+
chr16,4484385,0.9020501138952164,683,438,1121,+
chr16,4484434,0.48554060434372043,865,705,1570,+
chr16,4487437,2.6594456917516878,937,679,1616,+
chr16,4491507,1.7844157051018705,1030,764,1794,+
chr16,4491508,2.4256032212226732,1113,730,1843,+
chr16,4506087,0.9797818689677955,662,480,1142,+
chr16,4920903,0.5587044534412956,758,428,1186,+
chr16,4920928,2.1925971198288705,1024,556,1580,+
chr16,4920929,2.277320692186072,2400,1481,3881,+
chr16,4920930,2.3458545023342725,1963,1143,3106,+
chr16,9212601,0.344640198322371,603,461,1064,+
chr16,14738137,1.798481373763057,636,423,1059,+
chr16,14738379,2.090091614833584,562,453,1015,+
chr16,14742303,0.3031617647058823,588,424,1012,+
chr16,14762176,1.7941872574079334,823,502,1325,+
chr16,14951468,1.6427677483911058,674,559,1233,+
chr16,14972613,0.6388083239502121,1371,841,2212,+
chr16,14972615,1.3457770270270268,1541,887,2428,+
chr16,14972616,2.125071804865722,1953,1231,3184,+
chr16,14972617,2.07678916827853,1192,704,1896,+
chr16,14972618,2.196146245059289,761,527,1288,+
chr16,15092209,2.4040041067761804,668,486,1154,+
chr16,15092211,1.7859460187029557,975,713,1688,+
chr16,15100421,0.3644366197183099,965,567,1532,+
chr16,15100422,0.3644366197183099,965,567,1532,+
chr16,15100423,0.7420667362339242,1537,1002,2539,+
chr16,15102664,1.6681358680062988,1043,699,1742,+
chr16,15102671,0.6158986175115208,593,433,1026,+
chr16,15102673,0.4931972789115645,724,419,1143,+
chr16,15125684,2.408627132684568,722,546,1268,+
chr16,15126739,2.325660865412647,784,609,1393,+
chr16,15129321,2.0313827513199225,750,574,1324,+
chr16,15129882,2.6758677120010366,1123,840,1963,+
chr16,15130106,2.499357532926437,818,565,1383,+
chr16,15130107,2.4717666021530476,1055,780,1835,+
chr16,15130222,1.7523644251626898,747,460,1207,+
chr16,15130588,2.5343369960243476,791,587,1378,+
chr16,15130688,1.5033679402890345,698,455,1153,+
chr16,15130747,8.144672005778919,587,417,1004,+
chr16,15130966,2.384808053729297,781,506,1287,+
chr16,15131096,2.8828660425820827,1074,793,1867,+
chr16,15131354,2.033896520590559,1151,752,1903,+
chr16,19104618,1.6270578270463063,555,461,1016,+
chr16,19104619,1.6270578270463063,555,461,1016,+
chr16,19132468,7.60834348924861,830,544,1374,+
chr16,19132469,5.959313413858869,653,428,1081,+
chr16,19548898,2.1034830454928395,665,522,1187,+
chr16,20926896,2.21958318075195,782,500,1282,+
chr16,21624030,1.4632450730686488,702,568,1270,+
chr16,21629301,2.830460634499774,760,521,1281,+
chr16,21964668,1.4905219044479494,1815,1044,2859,+
chr16,21964669,1.2420795892169447,1436,614,2050,+
chr16,21964671,1.071113863576042,1025,444,1469,+
chr16,21964678,2.341090310279078,1213,640,1853,+
chr16,21964680,2.341090310279078,1213,640,1853,+
chr16,21964688,0.8472471881341205,1928,1294,3222,+
chr16,21964691,0.6379142300194932,1077,683,1760,+
chr16,21964695,1.2911972271417576,4693,3447,8140,+
chr16,21964702,0.653029136182775,1731,1271,3002,+
chr16,21964738,1.4551046965574357,2131,1390,3521,+
chr16,21968744,2.168431543540551,966,697,1663,+
chr16,21968751,2.031609195402299,1009,782,1791,+
chr16,21968875,1.6249595712239524,1233,940,2173,+
chr16,21974123,1.0229607300116823,4201,3044,7245,+
chr16,21974124,1.0229607300116823,4201,3044,7245,+
chr16,21974191,1.8520083325998298,1705,1081,2786,+
chr16,21983245,1.7382233436122554,2609,1988,4597,+
chr16,21983425,1.4596448947471965,1318,781,2099,+
chr16,21985227,1.7033401221995925,1577,981,2558,+
chr16,21991890,2.738108468548566,1094,817,1911,+
chr16,21992016,1.8045987917892279,1782,1170,2952,+
chr16,22314281,0.16830707987245008,1354,726,2080,+
chr16,22314282,0.16830707987245008,1354,726,2080,+
chr16,23573983,3.3302966400610354,659,508,1167,+
chr16,23583391,1.1335941178879265,728,478,1206,+
chr16,23583392,0.8962874464790879,803,554,1357,+
chr16,23584843,2.18511070501652,686,488,1174,+
chr16,23679571,4.062156539629188,808,607,1415,+
chr16,23690539,0.996470588235294,846,499,1345,+
chr16,23690541,1.4730723993896968,1051,657,1708,+
chr16,23690552,2.7574502474997478,852,520,1372,+
chr16,23690554,2.7574502474997478,852,520,1372,+
chr16,23691420,1.2816001510764192,830,610,1440,+
chr16,23691422,1.588412835133088,1242,866,2108,+
chr16,23691502,0.4313725490196078,753,492,1245,+
chr16,23691507,2.0361092604930047,1238,1184,2422,+
chr16,23691508,1.392507002939916,2404,1995,4399,+
chr16,23692302,2.282926829268293,611,409,1020,+
chr16,23692330,0.3636708304337043,1024,681,1705,+
chr16,23693402,2.608240223463687,1244,715,1959,+
chr16,23693404,2.608240223463687,1244,715,1959,+
chr16,23700662,2.12166084127394,1054,893,1947,+
chr16,23700672,2.7443946188340806,679,445,1124,+
chr16,28734545,2.2469412219439913,1452,583,2035,+
chr16,28734546,2.259453781512605,716,305,1021,+
chr16,28837656,2.0675706100219537,794,553,1347,+
chr16,28838267,7.400669676446237,1162,762,1924,+
chr16,28838287,1.1091787439613527,573,482,1055,+
chr16,28838288,1.1091787439613527,573,482,1055,+
chr16,28840743,1.2642241846862865,788,566,1354,+
chr16,28841946,1.203416149068323,674,482,1156,+
chr16,28843658,1.0519465611300003,598,476,1074,+
chr16,28843816,0.347203142648643,834,598,1432,+
chr16,28843818,0.3682756542267316,563,462,1025,+
chr16,28843885,2.606531134818107,614,462,1076,+
chr16,28844156,1.1647312989468,680,482,1162,+
chr16,28844157,1.1647312989468,680,482,1162,+
chr16,28845999,1.6896107881684066,628,373,1001,+
chr16,28848289,3.8857888056063716,1609,1241,2850,+
chr16,28848290,3.739821367404847,1559,1146,2705,+
chr16,28848291,4.034922749358519,782,627,1409,+
chr16,28848310,0.39849030222334975,633,493,1126,+
chr16,29690515,1.425829594115008,1088,797,1885,+
chr16,29706126,2.954252577319588,654,387,1041,+
chr16,29706155,3.364341085271318,619,515,1134,+
chr16,29706158,1.8173521934684833,819,528,1347,+
chr16,29706167,1.1988575931962484,1355,1151,2506,+
chr16,29706284,4.936765033791985,839,682,1521,+
chr16,29706415,1.0822062902648533,726,484,1210,+
chr16,29708399,2.6093927791116442,837,610,1447,+
chr16,29708430,0.9922239502332815,813,642,1455,+
chr16,29708431,0.9922239502332815,813,642,1455,+
chr16,29708546,2.125826100449206,994,725,1719,+
chr16,29708588,2.0125661375661377,715,575,1290,+
chr16,29708675,2.410434782608696,923,549,1472,+
chr16,29708691,1.8407859078590787,1000,737,1737,+
chr16,29708804,1.3683559950556243,1025,808,1833,+
chr16,29708914,0.6685689413357837,1023,712,1735,+
chr16,29709286,4.138248348472337,624,414,1038,+
chr16,29709361,6.002674676469317,785,524,1309,+
chr16,29709374,25.481601665080177,645,802,1447,+
chr16,29802124,0.9991474850809887,585,458,1043,+
chr16,29802125,0.8389171659901639,1249,912,2161,+
chr16,29802126,0.9338894158015276,1177,633,1810,+
chr16,29802127,0.8696585588671919,963,694,1657,+
chr16,29802128,1.0944395410414829,991,514,1505,+
chr16,29802129,1.7726608187134505,969,911,1880,+
chr16,29802131,1.698812611850055,3024,2293,5317,+
chr16,29802133,1.5935936751018354,2557,1862,4419,+
chr16,29809731,0.2795825098814229,502,505,1007,+
chr16,29809736,1.6737946122168843,896,751,1647,+
chr16,29809738,1.282095166774981,2330,1902,4232,+
chr16,29809768,2.700924974306269,656,555,1211,+
chr16,29811257,1.3814071143596585,682,503,1185,+
chr16,29814250,1.3768469531731113,756,546,1302,+
chr16,29814788,0.3268995507847333,816,577,1393,+
chr16,29814862,1.6569537238547107,1188,831,2019,+
chr16,29814864,0.3798449612403101,636,428,1064,+
chr16,29814896,0.7053808975834293,841,868,1709,+
chr16,29814897,0.650517730086192,1469,1464,2933,+
chr16,29814898,1.8896970653676806,996,678,1674,+
chr16,29814899,0.6213384975515845,1467,1333,2800,+
chr16,29814918,2.6782574257425744,662,504,1166,+
chr16,29814920,1.5681434134156196,927,697,1624,+
chr16,29814923,1.4884437596302003,827,648,1475,+
chr16,29814926,0.7251272491242597,3796,2933,6729,+
chr16,29818657,0.4330789504755519,1151,793,1944,+
chr16,29818658,0.48368433233047914,879,595,1474,+
chr16,29818698,1.2084505159631214,700,548,1248,+
chr16,29818921,2.3608476873844,1331,1031,2362,+
chr16,29818922,2.3608476873844,1331,1031,2362,+
chr16,29818949,0.3942530323875209,513,565,1078,+
chr16,29819091,3.0080831454746773,760,447,1207,+
chr16,29819106,2.0516106912406022,1076,709,1785,+
chr16,29819108,2.2386363636363638,590,439,1029,+
chr16,29819937,1.3135637070238495,1302,834,2136,+
chr16,29819978,1.835756634669678,838,505,1343,+
chr16,29820010,1.2776863446630888,1265,799,2064,+
chr16,29820055,2.7370628906409573,592,484,1076,+
chr16,29821522,3.251272015655577,638,364,1002,+
chr16,29821524,3.2543703842198743,966,562,1528,+
chr16,29821525,3.1199008951406655,979,717,1696,+
chr16,29821580,2.3680331352812978,718,553,1271,+
chr16,29822017,4.239742715773243,989,455,1444,+
chr16,29822024,4.265289917231181,2419,1281,3700,+
chr16,29822025,8.140253958317933,3315,2109,5424,+
chr16,29822026,7.480269356966871,2815,1699,4514,+
chr16,29822027,8.732852667811116,2467,1703,4170,+
chr16,29822042,0.29097206105335294,580,524,1104,+
chr16,29822049,3.7360295120268625,529,504,1033,+
chr16,29822073,2.6789076518406034,2148,1849,3997,+
chr16,29822074,2.5590941462391084,2418,2153,4571,+
chr16,29822099,2.270171149144254,618,408,1026,+
chr16,29822126,7.941881854133386,5950,5722,11672,+
chr16,29822127,7.941881854133386,5950,5722,11672,+
chr16,29822128,7.941881854133386,5950,5722,11672,+
chr16,29822134,1.6367149758454105,461,620,1081,+
chr16,29822135,0.5847768781773678,605,903,1508,+
chr16,29822138,1.8827433628318584,758,677,1435,+
chr16,29822139,0.4475350907223553,746,1015,1761,+
chr16,29822287,8.912242746234734,2005,1773,3778,+
chr16,29822288,12.664913847855239,1031,1044,2075,+
chr16,29822289,10.157696341194079,1356,1205,2561,+
chr16,29822315,0.3192219679633867,464,574,1038,+
chr16,29822316,0.3192219679633867,464,574,1038,+
chr16,29974744,0.7357147118410565,814,551,1365,+
chr16,29984273,0.5437613874080571,710,510,1220,+
chr16,29984274,0.9417683063531581,980,750,1730,+
chr16,30075504,0.6699143609926695,619,385,1004,+
chr16,30075559,0.6463036963036963,680,363,1043,+
chr16,30075750,2.1682339449541286,1532,1089,2621,+
chr16,30075752,2.362673420991674,2383,1576,3959,+
chr16,30075755,1.2291850786147365,1758,1314,3072,+
chr16,30075757,1.2835243938615912,2619,1939,4558,+
chr16,30075762,1.8449699699699698,982,719,1701,+
chr16,30077130,2.830641606546941,951,680,1631,+
chr16,30077162,2.281420765027322,667,365,1032,+
chr16,30077180,2.064777327935223,539,467,1006,+
chr16,30077240,2.3468634686346865,529,541,1070,+
chr16,30078562,1.7885097457410344,2184,1776,3960,+
chr16,30078806,1.6106623586429725,1993,1237,3230,+
chr16,30078899,1.6670695859435027,3362,2309,5671,+
chr16,30078914,1.7064810505655492,1756,1353,3109,+
chr16,30078944,1.2556057026490737,2976,2278,5254,+
chr16,30079998,1.3784840664627704,4705,3863,8568,+
chr16,30080168,0.7233836628171129,2950,2200,5150,+
chr16,30080171,1.6090075344544723,3705,2150,5855,+
chr16,30080173,1.3885869608564083,3672,2622,6294,+
chr16,30080216,1.3149253474631846,4695,3199,7894,+
chr16,30080284,1.6063185227928445,2226,1732,3958,+
chr16,30080654,1.8204184072783711,2099,1705,3804,+
chr16,30080693,1.358434926457367,2243,1793,4036,+
chr16,30080835,1.30172172086547,2559,2042,4601,+
chr16,30080862,1.3572510514067138,4828,4142,8970,+
chr16,30081150,1.6808191126279863,1781,1464,3245,+
chr16,30081299,1.6778581765557166,2107,1381,3488,+
chr16,30081300,1.5858178887993553,1727,1313,3040,+
chr16,30081306,1.2151857584426533,4796,3897,8693,+
chr16,30081330,1.5045333333333333,2076,1674,3750,+
chr16,30081457,1.5441207853179684,1966,1561,3527,+
chr16,30081462,1.5824056570748444,2658,1586,4244,+
chr16,30081587,1.915193341604632,2554,1983,4537,+
chr16,30081588,1.8487489688153136,3704,2958,6662,+
chr16,30081636,0.5018867924528302,1063,847,1910,+
chr16,30081639,1.4901454514157844,1573,1290,2863,+
chr16,30081682,1.4541096107224354,3599,2584,6183,+
chr16,30081695,0.7226181913293664,1541,1118,2659,+
chr16,30087677,0.8526005032095214,1151,569,1720,+
chr16,30087678,3.056842105263158,725,299,1024,+
chr16,30087679,1.060583131557708,840,412,1252,+
chr16,30087680,1.7883647798742137,1033,423,1456,+
chr16,30087681,1.5390946502057614,791,323,1114,+
chr16,30087682,1.5390946502057614,791,323,1114,+
chr16,30087696,5.447393661814026,776,403,1179,+
chr16,30087704,1.937150837988827,1063,715,1778,+
chr16,30087705,1.956492037301253,1858,1106,2964,+
chr16,30087707,1.9854875283446713,795,391,1186,+
chr16,30087718,0.4777327935222671,707,455,1162,+
chr16,30087726,0.643565354369105,1149,707,1856,+
chr16,30087735,0.5782400589101621,1046,581,1627,+
chr16,30087746,1.7153614457831323,1138,663,1801,+
chr16,30087762,1.5895510835913311,1866,949,2815,+
chr16,30093824,1.8855047607782838,838,456,1294,+
chr16,30093825,1.8855047607782838,838,456,1294,+
chr16,30093840,1.2014205512984248,828,612,1440,+
chr16,30094808,1.344513258090113,837,578,1415,+
chr16,30094885,3.102449891522024,738,492,1230,+
chr16,30096025,0.8960889953107852,780,513,1293,+
chr16,30096026,0.8960889953107852,780,513,1293,+
chr16,30096085,1.022911347532149,1085,843,1928,+
chr16,31121590,1.383400070592428,692,466,1158,+
chr16,31129128,1.9520673544634244,1643,837,2480,+
chr16,31129129,2.2891788014940726,880,376,1256,+
chr16,31129130,2.2891788014940726,880,376,1256,+
chr16,31138642,2.4116656862746746,648,499,1147,+
chr16,31138645,0.9764676616915424,1032,803,1835,+
chr16,31138646,0.8287781908134034,1532,1156,2688,+
chr16,31138654,3.218986702575324,682,456,1138,+
chr16,31138662,1.268028658690931,1847,1415,3262,+
chr16,31138665,2.9538916256157646,788,724,1512,+
chr16,31191516,3.0219000348310696,586,470,1056,+
chr16,31193719,2.1938283510125363,649,609,1258,+
chr16,31193721,2.1938283510125363,649,609,1258,+
chr16,31193867,1.935294117647059,657,407,1064,+
chr16,31193877,2.039575596816976,817,724,1541,+
chr16,31193958,1.8669767441860463,668,429,1097,+
chr16,31193966,2.114097123998114,589,504,1093,+
chr16,31193979,1.6696149379076208,583,532,1115,+
chr16,31193981,0.3885714285714285,934,769,1703,+
chr16,31195286,0.5156723963599595,764,644,1408,+
chr16,31195320,0.4148111658456486,742,608,1350,+
chr16,31195539,1.8579664570230603,708,423,1131,+
chr16,31195621,0.2408963585434173,773,611,1384,+
chr16,31195700,9.9375,953,239,1192,+
chr16,31195701,6.682439537329127,1270,316,1586,+
chr16,31195702,6.682439537329127,1270,316,1586,+
chr16,31195703,5.980632829771554,1224,294,1518,+
chr16,31195709,4.995869344034016,2169,461,2630,+
chr16,31195710,15.013883814395324,1416,390,1806,+
chr16,31195711,5.316666666666666,1043,269,1312,+
chr16,31195712,15.236533638313746,2849,873,3722,+
chr16,31195713,10.691291864532497,1709,575,2284,+
chr16,31196258,3.5637849760620592,1701,3709,5410,+
chr16,31196259,5.744036227602546,3026,5005,8031,+
chr16,31196260,5.744036227602545,3026,5005,8031,+
chr16,31196265,0.4143803712803712,888,1664,2552,+
chr16,31196271,0.4428167848623349,1180,2118,3298,+
chr16,31196272,0.48983168175558883,1981,3371,5352,+
chr16,31196422,3.9989859883898036,1381,949,2330,+
chr16,31196423,5.001292015882943,1611,1225,2836,+
chr16,31196424,4.421990991077018,1877,1489,3366,+
chr16,31196425,4.065742068469401,2503,2135,4638,+
chr16,31196426,4.820246693145833,2511,2501,5012,+
chr16,31196427,3.99645558160475,3396,3901,7297,+
chr16,31196428,3.11552277736752,3118,4008,7126,+
chr16,31196429,2.7615313356000932,2428,3326,5754,+
chr16,31196430,2.96931650018498,913,1695,2608,+
chr16,31196451,0.3455606407182702,1037,1353,2390,+
chr16,31196452,0.3139230769230769,582,649,1231,+
chr16,31196494,0.8949934469200526,775,544,1319,+
chr16,31196495,0.8949934469200526,775,544,1319,+
chr16,31198125,2.9507800712271255,2017,1919,3936,+
chr16,31198146,0.6980073976852403,974,985,1959,+
chr16,31198147,0.5740905057675244,646,505,1151,+
chr16,31198148,0.5861765734985721,1215,1044,2259,+
chr16,31200473,1.3915042364831491,1381,1131,2512,+
chr16,31200991,1.5330542473399618,1308,818,2126,+
chr16,31201644,12.09785303450426,1129,684,1813,+
chr16,31201650,1.8706009398282688,698,524,1222,+
chr16,31201653,3.1211198395503277,1477,1138,2615,+
chr16,31201680,3.322589141453551,1417,1512,2929,+
chr16,31201683,5.22205372244933,1503,1794,3297,+
chr16,31202072,0.1137198856676194,556,789,1345,+
chr16,31202298,3.6271787270710303,1538,1225,2763,+
chr16,31202384,10.623788508690541,1358,424,1782,+
chr16,31202385,12.225286060047582,1911,654,2565,+
chr16,31202386,11.864034831199861,2086,699,2785,+
chr16,31202387,5.157983193277311,836,209,1045,+
chr16,31202389,5.028398297151477,1057,412,1469,+
chr16,31202392,8.304088205583735,2805,4534,7339,+
chr16,31202393,8.304088205583733,2805,4534,7339,+
chr16,31202394,6.41725406802234,3163,5715,8878,+
chr16,31202396,2.256622844218264,1065,3536,4601,+
chr16,31202398,0.3365394884724484,1235,3587,4822,+
chr16,31202402,0.8380549527660962,1172,3127,4299,+
chr16,31202404,1.1840143915496848,1981,5589,7570,+
chr16,31202406,1.011494252873563,967,2870,3837,+
chr16,31202417,0.37505285813555106,3392,7388,10780,+
chr16,31202418,0.37505285813555106,3392,7388,10780,+
chr16,31202422,0.2540079659903091,825,1661,2486,+
chr16,31202733,0.3187899057464275,465,1011,1476,+
chr16,31202752,0.4152815829528158,717,656,1373,+
chr16,31202753,1.048436541998774,1139,931,2070,+
chr16,31202755,1.048436541998774,1139,931,2070,+
chr16,31202781,2.400194979283451,1230,1118,2348,+
chr16,31202783,2.400194979283451,1230,1118,2348,+
chr16,46731421,1.232822740356336,666,447,1113,+
chr16,46963184,0.7539723602010443,1032,533,1565,+
chr16,47723032,2.7905588235294116,871,523,1394,+
chr16,47723033,2.7378854906118963,1148,720,1868,+
chr16,47723035,2.048909512761021,668,430,1098,+
chr16,47723059,0.9909463774811221,1046,686,1732,+
chr16,47727307,1.5974002742829885,892,540,1432,+
chr16,47730304,2.9020239599900384,690,381,1071,+
chr16,47730340,2.543859649122807,608,440,1048,+
chr16,47730341,2.543859649122807,608,440,1048,+
chr16,53358594,0.9045751633986928,691,407,1098,+
chr16,53358596,0.9045751633986928,691,407,1098,+
chr16,53358601,0.6743206935711713,1622,1370,2992,+
chr16,53358602,0.6743206935711713,1622,1370,2992,+
chr16,53358603,0.6743206935711713,1622,1370,2992,+
chr16,53358620,2.138699063528221,649,438,1087,+
chr16,53524349,1.5540451283544294,771,523,1294,+
chr16,56642495,1.0152111873464884,5886,4361,10247,+
chr16,56642509,0.9742481848346712,7652,5514,13166,+
chr16,56642962,1.2514247030643413,32673,23449,56122,+
chr16,56642963,1.2514247030643413,32673,23449,56122,+
chr16,56642964,1.249778241411017,24812,18895,43707,+
chr16,56643228,1.4215976982810503,8241,6192,14433,+
chr16,56643290,1.3121281625811472,4978,3152,8130,+
chr16,56643330,1.5908303816454772,13059,11793,24852,+
chr16,56659692,1.955582857071581,733,669,1402,+
chr16,56659719,1.4944805977343938,720,460,1180,+
chr16,56659738,1.5808851687729086,780,676,1456,+
chr16,56659760,1.5450577221296882,853,756,1609,+
chr16,56660419,1.8887902987281868,823,587,1410,+
chr16,56660887,1.4873432979749277,1370,1036,2406,+
chr16,56660910,1.5920027420905136,3000,2242,5242,+
chr16,56717923,1.241863282017027,1154,790,1944,+
chr16,56717933,2.038188761593017,933,610,1543,+
chr16,56717936,1.6738303115208295,3334,2517,5851,+
chr16,56717937,1.5922853477883063,4613,3574,8187,+
chr16,56717938,1.6232083563918096,6098,4939,11037,+
chr16,56717939,1.4872996887514078,5732,4589,10321,+
chr16,56717940,1.546721580009287,4428,3734,8162,+
chr16,56974144,1.084598698481562,679,460,1139,+
chr16,56974145,1.084598698481562,679,460,1139,+
chr16,56976087,2.6007268948445663,618,411,1029,+
chr16,56976134,1.4045854619314333,624,431,1055,+
chr16,57286735,2.551874829323808,660,450,1110,+
chr16,57485005,0.8004851265693371,680,445,1125,+
chr16,57493524,0.9782608695652174,635,423,1058,+
chr16,57493526,0.8136483899042646,885,647,1532,+
chr16,57493557,2.409144169083185,541,476,1017,+
chr16,57494006,3.0761109916598026,1766,941,2707,+
chr16,57494009,1.6456424082349443,1861,1011,2872,+
chr16,57494503,1.5543578255788006,2672,1739,4411,+
chr16,57494504,1.980441363926068,2395,1568,3963,+
chr16,57494506,1.7849092657005623,3737,2300,6037,+
chr16,57494514,2.269326427527499,1638,906,2544,+
chr16,57494519,0.9856420488444196,3624,2594,6218,+
chr16,57494520,0.668939393939394,2648,1814,4462,+
chr16,57494521,0.9856420488444196,3624,2594,6218,+
chr16,57494537,1.878477522280762,2288,1765,4053,+
chr16,57494544,1.472560122576777,5262,4414,9676,+
chr16,57494545,1.1375804632883755,10714,8035,18749,+
chr16,57494546,2.4516738961183404,3148,1997,5145,+
chr16,57505246,0.4465421607042898,584,456,1040,+
chr16,57505248,0.4465421607042898,584,456,1040,+
chr16,66420885,4.050452714143549,611,394,1005,+
chr16,66423265,1.9532817502668087,1060,936,1996,+
chr16,66423266,2.08829453234067,1288,1100,2388,+
chr16,66423271,2.0808130481108105,576,580,1156,+
chr16,66438443,3.3634616868292064,613,446,1059,+
chr16,66586501,0.34308689697286665,581,428,1009,+
chr16,66586640,1.64031170650556,645,422,1067,+
chr16,66599808,2.068765133171913,711,412,1123,+
chr16,66599835,0.5470588235294117,805,584,1389,+
chr16,67226697,0.4271307099070595,719,388,1107,+
chr16,67226699,0.4271307099070595,719,388,1107,+
chr16,67226747,1.1257125713336897,1003,541,1544,+
chr16,67226931,2.546271338724169,653,476,1129,+
chr16,67229888,2.4069537526427336,570,463,1033,+
chr16,67229895,3.4138947333815506,663,472,1135,+
chr16,67572939,3.2734864300626305,671,478,1149,+
chr16,67572940,2.552608438172043,889,618,1507,+
chr16,67573641,2.0964661865325445,1008,732,1740,+
chr16,67573647,0.5954782139207255,1397,947,2344,+
chr16,67573750,2.203422234967976,921,633,1554,+
chr16,67573754,1.8033782991202347,1052,774,1826,+
chr16,67573762,2.348712967459932,1208,993,2201,+
chr16,67877729,4.356793726898814,814,612,1426,+
chr16,67902416,0.968492445054945,777,727,1504,+
chr16,67902417,0.968492445054945,777,727,1504,+
chr16,67905096,3.1810195852534564,596,495,1091,+
chr16,67905098,2.4571162669534967,643,551,1194,+
chr16,67915950,3.9912935191682797,842,524,1366,+
chr16,67918220,0.7926315789473684,752,379,1131,+
chr16,67918221,0.7926315789473684,752,379,1131,+
chr16,67918222,0.7154107284978346,950,515,1465,+
chr16,67918228,2.1907108173424192,1164,716,1880,+
chr16,67918230,1.8618977825418603,1122,609,1731,+
chr16,67918247,1.9467277932734526,1049,677,1726,+
chr16,68225577,2.215756265614354,896,584,1480,+
chr16,68331461,6.855185071798276,244,772,1016,+
chr16,68331894,5.140708205503187,733,471,1204,+
chr16,68331934,1.0374720357941836,794,595,1389,+
chr16,68331936,1.0374720357941836,794,595,1389,+
chr16,68363030,0.8003784169038191,609,428,1037,+
chr16,68373778,2.569843355100518,786,419,1205,+
chr16,68382285,1.818205707090379,606,480,1086,+
chr16,69171766,1.32456269473271,847,827,1674,+
chr16,69171767,0.9675425038639875,625,646,1271,+
chr16,69189888,3.57333039440428,604,466,1070,+
chr16,69194351,1.131987982990178,763,572,1335,+
chr16,69199339,1.413126213592233,826,514,1340,+
chr16,69199340,2.123448979658272,1000,647,1647,+
chr16,69199341,1.413126213592233,826,514,1340,+
chr16,69458545,3.2033172600969304,769,622,1391,+
chr16,69458546,0.4204301075268817,781,557,1338,+
chr16,69458548,0.5145063885165254,2303,1711,4014,+
chr16,69458564,1.272188080064182,2324,1908,4232,+
chr16,69458565,0.9254497082564924,1832,1454,3286,+
chr16,69458583,1.64279989313385,1418,787,2205,+
chr16,69458641,2.1008155339805827,643,514,1157,+
chr16,69458662,1.6888888888888889,645,509,1154,+
chr16,69458691,0.6361016193730501,891,634,1525,+
chr16,69458716,1.4427942631801274,2077,1700,3777,+
chr16,69458734,0.6169180492709905,1066,662,1728,+
chr16,69481063,1.9339960238568585,607,502,1109,+
chr16,69481064,1.729938271604938,766,623,1389,+
chr16,69481065,1.5587303925178586,1113,733,1846,+
chr16,69481068,1.9162876100655175,1147,772,1919,+
chr16,69481093,1.5783417935702198,741,590,1331,+
chr16,69496351,1.7996674057649664,1545,1229,2774,+
chr16,69496440,1.5004530353367562,1241,769,2010,+
chr16,69496464,2.2082822837539817,750,582,1332,+
chr16,69496467,1.6541353383458648,879,607,1486,+
chr16,69496509,1.5483652666751258,831,638,1469,+
chr16,69496591,0.6134393063583814,848,691,1539,+
chr16,69496595,1.5778419705743096,1938,1360,3298,+
chr16,69496613,1.483957219251337,1109,781,1890,+
chr16,69496637,1.6187997724687146,1210,878,2088,+
chr16,69496736,0.7054881963559616,1911,1396,3307,+
chr16,69496899,1.985351273988547,1884,1240,3124,+
chr16,69496921,1.9978181306306304,810,591,1401,+
chr16,69496941,1.0940021883265074,1690,1290,2980,+
chr16,69496960,1.8109017496635265,896,742,1638,+
chr16,69496967,0.5063599908048325,1278,832,2110,+
chr16,69497019,3.660704607046071,613,409,1022,+
chr16,69497205,0.9991518955135272,1121,906,2027,+
chr16,69497206,0.9991518955135272,1121,906,2027,+
chr16,69497214,0.5410312273057372,744,458,1202,+
chr16,69497251,7.50062892312574,4810,3016,7826,+
chr16,69497252,5.945546319936356,6336,4085,10421,+
chr16,69497254,1.814965986394558,1449,1124,2573,+
chr16,69497262,9.081110985182299,6623,5139,11762,+
chr16,69497263,9.081110985182299,6623,5139,11762,+
chr16,70380859,2.2128416818819296,956,591,1547,+
chr16,70380861,2.445785249838908,1227,793,2020,+
chr16,70380863,2.581260945709281,866,570,1436,+
chr16,70380873,2.8298205467903164,978,436,1414,+
chr16,70380875,2.8298205467903164,978,436,1414,+
chr16,70380923,2.109647887323944,2065,1703,3768,+
chr16,70380925,2.190437717681658,3263,2367,5630,+
chr16,70380928,2.116403296174893,4201,2893,7094,+
chr16,70380929,2.318722044728435,2591,1564,4155,+
chr16,70399002,1.017026491447643,1344,751,2095,+
chr16,70399004,1.017026491447643,1344,751,2095,+
chr16,70399005,1.5086264417119437,645,537,1182,+
chr16,70399012,1.7814986737400529,795,463,1258,+
chr16,70406452,0.48986978408287224,784,558,1342,+
chr16,70406466,1.7400968910211183,1636,1118,2754,+
chr16,70406467,1.7400968910211183,1636,1118,2754,+
chr16,70406479,1.568907933908435,2170,1471,3641,+
chr16,70560559,2.356528652385315,811,505,1316,+
chr16,70560561,2.339593750882843,788,454,1242,+
chr16,70560619,0.3833009708737864,845,617,1462,+
chr16,70560620,0.3833009708737864,845,617,1462,+
chr16,70562849,0.2410179056785778,1021,627,1648,+
chr16,70566461,2.110944527736132,615,405,1020,+
chr16,70588472,1.8269259253135963,1596,1114,2710,+
chr16,70588473,1.1836007130124775,663,560,1223,+
chr16,70588474,2.3560360360360364,933,554,1487,+
chr16,70589020,0.4792026014421037,806,642,1448,+
chr16,70589021,0.4792026014421037,806,642,1448,+
chr16,70595617,2.2902975495499356,869,607,1476,+
chr16,70599103,0.4030054026819595,635,388,1023,+
chr16,70599108,2.5746410248489355,637,457,1094,+
chr16,70601377,8.767610197106801,2430,2060,4490,+
chr16,70601378,8.767610197106801,2430,2060,4490,+
chr16,70605041,1.099847600110293,654,449,1103,+
chr16,70606120,3.8776890173995926,971,378,1349,+
chr16,70606131,25.034105951135633,1609,1527,3136,+
chr16,70606132,25.034105951135633,1609,1527,3136,+
chr16,71950496,2.8449530871355417,875,611,1486,+
chr16,71950498,2.3284103114930184,666,391,1057,+
chr16,71954662,2.633745747067678,713,487,1200,+
chr16,74330714,0.6004033817091072,688,507,1195,+
chr16,74330722,2.709060464557908,765,552,1317,+
chr16,74330875,0.6237580993520517,721,462,1183,+
chr16,74334071,1.5681407942238266,694,553,1247,+
chr16,74334074,0.9228578954435227,1899,1587,3486,+
chr16,74336156,1.5474448872521818,1226,921,2147,+
chr16,74338241,1.7928331466965284,1600,1127,2727,+
chr16,74338243,1.7928331466965284,1600,1127,2727,+
chr16,74339273,1.6837782340862422,639,486,1125,+
chr16,74339275,5.751047277079593,960,556,1516,+
chr16,74339293,1.8985560600482678,1008,842,1850,+
chr16,74339338,1.839090909090909,577,439,1016,+
chr16,74339369,1.5811889973380655,1133,685,1818,+
chr16,74339449,2.5881273511331315,655,518,1173,+
chr16,74339490,1.6066016793745777,1217,796,2013,+
chr16,74339808,0.5681818181818181,759,417,1176,+
chr16,74339814,3.193040293040293,757,419,1176,+
chr16,74339905,2.1390374331550803,699,560,1259,+
chr16,74339926,2.107712765957447,633,375,1008,+
chr16,74339933,0.5987951807228915,851,663,1514,+
chr16,74339962,0.6433540634552546,938,715,1653,+
chr16,74339998,1.9032665181885668,826,448,1274,+
chr16,75600784,1.3186650562557738,931,716,1647,+
chr16,75611310,1.96,857,714,1571,+
chr16,75611312,1.96,857,714,1571,+
chr16,75611641,2.3809395158074036,719,475,1194,+
chr16,75688223,2.018211041383642,572,438,1010,+
chr16,75690289,5.317552620748449,718,506,1224,+
chr16,75690402,0.584152481419324,1328,872,2200,+
chr16,75690403,1.7573269909467544,1017,685,1702,+
chr16,75690405,2.004819277108434,831,414,1245,+
chr16,75690412,1.8066131887169057,978,500,1478,+
chr16,75690420,0.7096564722279417,1210,612,1822,+
chr16,75690423,0.7543440140283754,2365,1393,3758,+
chr16,75690531,0.5234646411117,634,458,1092,+
chr16,81040827,0.39206009468114733,708,417,1125,+
chr16,81040853,2.3980451568240966,1502,815,2317,+
chr16,81040855,2.163950313845544,1694,931,2625,+
chr16,81045587,0.6248544141625902,739,476,1215,+
chr16,81045597,1.7300091972709195,1521,1017,2538,+
chr16,81735282,1.7970779220779218,614,419,1033,+
chr16,81737473,12.761745125246678,1252,545,1797,+
chr16,81737474,11.33149927137268,1410,699,2109,+
chr16,81737475,11.33149927137268,1410,699,2109,+
chr16,81737476,9.861457529625845,1052,575,1627,+
chr16,81737618,2.718351064091171,597,464,1061,+
chr16,81739133,0.6928050178871882,1419,1088,2507,+
chr16,81739135,0.6928050178871882,1419,1088,2507,+
chr16,81739146,1.7492236024844718,750,505,1255,+
chr16,81739181,1.253763440860215,1429,974,2403,+
chr16,81739203,1.7047560333655813,4135,2643,6778,+
chr16,81739205,1.6163610177724548,3086,1935,5021,+
chr16,81740620,1.2187115178273435,8172,5195,13367,+
chr16,81740621,1.0972421483529906,5340,3222,8562,+
chr16,81740622,1.1982960897826682,6837,4291,11128,+
chr16,81740630,1.8702651578373448,3982,3098,7080,+
chr16,81740635,1.6573781467375566,19993,16055,36048,+
chr16,81740636,1.6573781467375566,19993,16055,36048,+
chr16,81740637,1.7648625675372298,24276,20855,45131,+
chr16,81740639,1.8871924341040098,14971,12816,27787,+
chr16,81740641,1.6844272199972383,3453,2227,5680,+
chr16,81740685,0.4438515725842091,897,602,1499,+
chr16,81743387,2.447811447811448,726,527,1253,+
chr16,81743403,1.9536679536679538,735,591,1326,+
chr16,81743469,2.0112982301000413,747,724,1471,+
chr16,81743563,28.63693695239245,1009,1054,2063,+
chr16,81743564,28.63693695239245,1009,1054,2063,+
chr16,81743565,28.43587277297186,853,995,1848,+
chr16,81743570,0.3682366603093876,499,887,1386,+
chr16,81743591,0.3734466004583651,799,1076,1875,+
chr16,81743593,0.43303571428571425,581,703,1284,+
chr16,81743594,0.21219931271477663,493,775,1268,+
chr16,81743596,0.3510708857097767,853,1182,2035,+
chr16,81743607,0.4128390240467531,699,815,1514,+
chr16,81743631,0.2638858399283399,692,535,1227,+
chr16,81743686,23.059901960784313,1049,76,1125,+
chr16,81743687,22.693347790994654,1459,112,1571,+
chr16,81743689,14.328308653216403,1246,109,1355,+
chr16,81743691,12.411582282747926,1045,96,1141,+
chr16,81743697,18.14135085523216,1281,217,1498,+
chr16,81743698,17.750141407691213,1709,316,2025,+
chr16,81743699,17.750141407691213,1709,316,2025,+
chr16,81743700,33.03860834164844,1283,263,1546,+
chr16,81743703,19.98051928751201,1842,1579,3421,+
chr16,81743704,16.805217277081127,2722,3004,5726,+
chr16,81743705,16.80521727708113,2722,3004,5726,+
chr16,81743706,16.65868996090193,2122,2782,4904,+
chr16,81743714,0.23196392497525378,707,926,1633,+
chr16,81743715,0.2345679012345679,607,719,1326,+
chr16,81743716,0.4560753102452442,475,747,1222,+
chr16,81743754,0.495757841059596,833,836,1669,+
chr16,81745110,1.869565217391304,601,419,1020,+
chr16,81745237,1.1103396828383891,1008,675,1683,+
chr16,81745239,0.8001270508777453,1299,960,2259,+
chr16,81745240,0.7586901916463652,689,572,1261,+
chr16,83841613,2.3194733458525776,761,398,1159,+
chr16,83841621,1.141725328186212,1268,814,2082,+
chr16,83841622,1.7875547869226616,1558,1001,2559,+
chr16,83841624,1.740518962075848,871,500,1371,+
chr16,83841630,1.067807047553883,1155,739,1894,+
chr16,83841632,1.067807047553883,1155,739,1894,+
chr16,83841637,0.5353105627810867,733,432,1165,+
chr16,83841649,1.7602154823646186,1476,1012,2488,+
chr16,83841679,1.717055918043783,740,712,1452,+
chr16,83841709,1.5869350700611802,730,562,1292,+
chr16,83842944,0.8914476738787259,2759,2046,4805,+
chr16,83842945,1.5591664005110188,2546,1615,4161,+
chr16,83842946,0.8914476738787259,2759,2046,4805,+
chr16,83842958,0.5259770114942529,1663,1159,2822,+
chr16,83843002,1.3734178608377907,2901,1593,4494,+
chr16,83845156,1.8625833183210232,1076,792,1868,+
chr16,83845499,0.29565810813369825,1059,718,1777,+
chr16,84328471,2.3014006876986106,633,445,1078,+
chr16,84358053,0.9307382391278589,682,581,1263,+
chr16,84358055,0.9307382391278589,682,581,1263,+
chr16,84363172,1.2187840670859538,558,476,1034,+
chr16,84363174,1.2187840670859538,558,476,1034,+
chr16,84363368,2.4249201277955272,689,625,1314,+
chr16,84779209,2.7463176147109185,744,493,1237,+
chr16,84792378,5.104278993871235,629,471,1100,+
chr16,84797795,1.9041709997054523,734,393,1127,+
chr16,84812543,1.061654926726581,1048,536,1584,+
chr16,84812544,1.061654926726581,1048,536,1584,+
chr16,84813003,1.7172619047619049,576,431,1007,+
chr16,84813004,2.412678653757492,1216,722,1938,+
chr16,84813005,2.412678653757492,1216,722,1938,+
chr16,85706596,3.10075350160965,593,467,1060,+
chr16,85706654,1.4617754095616942,639,504,1143,+
chr16,85833305,0.923805741923685,1316,917,2233,+
chr16,85833306,0.40180403982761237,713,566,1279,+
chr16,85833327,1.8371031885694273,1628,1255,2883,+
chr16,85833329,1.8126869520371327,1043,830,1873,+
chr16,85833346,4.390917080460664,3735,3466,7201,+
chr16,85833347,2.681405208964264,1397,1523,2920,+
chr16,85834819,0.6695518207282913,1165,1189,2354,+
chr16,85834820,0.7488889942746145,2795,2488,5283,+
chr16,85834825,0.6559175167269935,2989,3038,6027,+
chr16,85834826,0.6478091010294664,7956,7526,15482,+
chr16,85834828,0.6470704576510918,3321,3303,6624,+
chr16,85834853,1.3912668405758817,2930,2143,5073,+
chr16,85838620,1.4539990977055943,2200,1292,3492,+
chr16,85838625,1.999854386603568,2288,1434,3722,+
chr16,85838644,1.4902855805243445,1818,1423,3241,+
chr16,85838665,1.4674119820242069,1917,1576,3493,+
chr16,85838697,1.6244772315824665,3961,3372,7333,+
chr16,85838698,1.3113058433359224,8773,7012,15785,+
chr16,85839425,1.5560526399643118,2653,1584,4237,+
chr16,85839458,1.6918527222875053,1837,1479,3316,+
chr16,85840454,1.3476431489724985,1767,1425,3192,+
chr16,87426045,1.4540021580620488,636,421,1057,+
chr16,87436707,1.935337016547148,1404,1076,2480,+
chr16,89623640,2.6025465239356746,716,457,1173,+
chr16,89627073,0.7252349975325655,1982,799,2781,+
chr16,89627074,0.771571865443425,1212,374,1586,+
chr16,89627075,0.771571865443425,1212,374,1586,+
chr16,89627083,1.6923888932129514,1302,583,1885,+
chr16,89627084,1.2392659509067157,3720,2356,6076,+
chr16,89627085,0.8488742090639438,2679,2113,4792,+
chr16,89627087,0.908044548797972,5961,2979,8940,+
chr16,89627088,0.8968531941948412,7464,4178,11642,+
chr16,89627089,0.908044548797972,5961,2979,8940,+
chr16,89627101,1.2977661175204938,11226,6527,17753,+
chr16,89627102,1.2862813000930629,20632,12345,32977,+
chr16,89627103,1.2377993914010863,6461,4955,11416,+
chr16,89627104,1.2864877944755018,10065,5320,15385,+
chr16,89627359,1.33862992317386,5103,4382,9485,+
chr16,89627460,1.3535898353450555,7787,3869,11656,+
chr16,89627461,1.3535898353450555,7787,3869,11656,+
chr16,89627466,1.4288198757763977,1561,1264,2825,+
chr16,89627467,1.1798432275544153,5594,4062,9656,+
chr16,89627634,1.4370050948376405,3228,1480,4708,+
chr16,89627635,1.803990421558641,1998,1621,3619,+
chr16,89627648,0.7725893358897227,2945,2326,5271,+
chr16,89627723,1.3843515646732014,15553,10087,25640,+
chr16,89627726,1.6717208274109852,11939,7054,18993,+
chr16,89627731,1.4603422892896578,5648,3989,9637,+
chr16,89627846,2.42023346303502,621,513,1134,+
chr16,89627847,2.42023346303502,621,513,1134,+
chr16,89627856,0.6804766309854191,834,657,1491,+
chr16,89628000,1.2640074148680105,12993,8287,21280,+
chr16,89628024,1.3655762711864403,7796,4129,11925,+
chr16,89628038,0.7861932164628763,11852,9735,21587,+
chr16,89628048,1.265168739355866,14335,11371,25706,+
chr16,89628746,1.3086976917007305,15590,10456,26046,+
chr16,89628747,1.2262703980698566,33006,21185,54191,+
chr16,89628749,1.1811787203670208,23624,17211,40835,+
chr16,89628752,1.3204417783237516,19088,14281,33369,+
chr16,89628767,1.3904947171929007,10939,8037,18976,+
chr16,89629297,1.2674646809063448,14367,11577,25944,+
chr16,89629401,1.8942719028062973,3200,1460,4660,+
chr16,89629422,1.3680889400038336,3273,1738,5011,+
chr16,89629434,1.2919316623020327,3884,2186,6070,+
chr16,89629435,1.0947270145808208,7260,5295,12555,+
chr16,89629438,1.1941001942343794,25450,17174,42624,+
chr16,89629439,1.1125433330056669,16349,11850,28199,+
chr16,89629440,1.2957603723049322,14148,8436,22584,+
chr16,89629442,1.2883795550919523,15150,9283,24433,+
chr16,89629444,1.277683943369962,16053,10070,26123,+
chr16,89629445,1.3095735853779509,11006,6958,17964,+
chr16,89629516,1.4026142746851955,2532,1976,4508,+
chr16,89629519,1.35540502995671,8854,6126,14980,+
chr16,89629537,4.743867228122599,11675,8971,20646,+
chr16,89629579,0.8063832542588385,3604,2928,6532,+
chr17,904506,1.7597432857739514,616,462,1078,+
chr17,904508,2.973765432098766,563,485,1048,+
chr17,1733367,7.9560097595784915,1136,833,1969,+
chr17,1733368,2.816112859011749,853,758,1611,+
chr17,1733370,1.1406008398401708,580,524,1104,+
chr17,1747892,2.4802183069907673,1743,1286,3029,+
chr17,1747907,2.7966326068884233,876,591,1467,+
chr17,1747917,2.3058752271350698,563,507,1070,+
chr17,1747933,0.5265496556320818,789,642,1431,+
chr17,1747935,3.487539487539488,551,517,1068,+
chr17,1778959,2.4907034393031298,1282,869,2151,+
chr17,1779036,2.0798098132828735,767,521,1288,+
chr17,1782565,0.580542264752791,727,569,1296,+
chr17,1782659,1.661776461183994,598,416,1014,+
chr17,1782662,0.865255161667316,2552,1509,4061,+
chr17,1782663,0.865255161667316,2552,1509,4061,+
chr17,1782664,0.8179348961213503,3793,2289,6082,+
chr17,1792074,2.200455580865604,758,438,1196,+
chr17,1798350,0.7244988101490435,1547,1277,2824,+
chr17,1800548,0.5030534417228629,919,791,1710,+
chr17,1800592,2.231746031746032,702,503,1205,+
chr17,1800593,2.231746031746032,702,503,1205,+
chr17,1943604,2.4154089337210154,939,670,1609,+
chr17,1943606,2.684759531062494,660,470,1130,+
chr17,1946528,1.203890983082557,651,520,1171,+
chr17,3572519,0.2527715673881686,581,428,1009,+
chr17,3572660,1.856488768064101,864,481,1345,+
chr17,3572673,1.076600400960447,4894,3088,7982,+
chr17,3572674,1.488569389750773,2610,1686,4296,+
chr17,3572675,0.5916583249916583,1611,998,2609,+
chr17,3572742,2.4310506566604126,2200,1270,3470,+
chr17,3572744,1.2956730769230769,3002,2079,5081,+
chr17,3572750,1.4400242523812317,2073,1310,3383,+
chr17,3572755,1.5923200122025627,2244,1489,3733,+
chr17,3572768,1.2498531208557322,10624,6599,17223,+
chr17,3572770,1.2498531208557322,10624,6599,17223,+
chr17,3572805,0.5247252747252747,763,493,1256,+
chr17,3572828,0.3557636887608069,822,693,1515,+
chr17,3572829,3.0252100840336134,839,538,1377,+
chr17,3572832,2.3784507181382106,1529,1115,2644,+
chr17,3572843,1.8155251141552509,993,656,1649,+
chr17,4475826,1.037688528404708,910,783,1693,+
chr17,4475828,0.7882399546582901,1517,1181,2698,+
chr17,4475829,0.6775821267219068,1689,1288,2977,+
chr17,4475831,0.6626190476190476,1209,899,2108,+
chr17,4699478,1.641154912184147,1697,839,2536,+
chr17,4699479,1.5920878132044105,3279,1858,5137,+
chr17,4699480,1.5460906601764526,967,691,1658,+
chr17,4699481,1.4896363112945017,1178,612,1790,+
chr17,4699482,1.939189189189189,804,459,1263,+
chr17,4699483,1.939189189189189,804,459,1263,+
chr17,4699486,1.0022346151604065,1257,970,2227,+
chr17,4699487,1.4158464180815722,1734,1264,2998,+
chr17,4699574,2.712505876821815,1048,708,1756,+
chr17,4699575,2.9839801444043323,1586,1107,2693,+
chr17,4699577,2.435823478655846,1713,1277,2990,+
chr17,4699578,0.5807770961145196,851,488,1339,+
chr17,4700026,1.7342105263157894,658,474,1132,+
chr17,4700040,2.2658520027155467,595,490,1085,+
chr17,4700041,1.9298989898989898,698,494,1192,+
chr17,4700076,1.181810242593124,2358,1531,3889,+
chr17,4700078,1.0419861928268277,1815,1065,2880,+
chr17,4700737,1.6438733095252036,652,550,1202,+
chr17,4700825,3.018051174202594,1012,633,1645,+
chr17,4700979,2.0108749382105784,677,577,1254,+
chr17,4701009,1.9158258098778544,961,806,1767,+
chr17,4701092,1.7476303317535546,589,421,1010,+
chr17,4701304,1.772027972027972,723,519,1242,+
chr17,4701307,2.155061250805932,763,563,1326,+
chr17,4701340,1.5946688279526318,931,672,1603,+
chr17,4701379,1.4840328688143167,1978,1562,3540,+
chr17,4701433,0.5210806385591487,1071,697,1768,+
chr17,4701616,2.1100423239707577,913,564,1477,+
chr17,4701658,1.763145338295639,595,498,1093,+
chr17,4701659,0.6209187279151943,763,565,1328,+
chr17,4701676,1.57763610056068,850,581,1431,+
chr17,4790958,2.9751451378809866,712,688,1400,+
chr17,4790960,2.9417090773812946,744,658,1402,+
chr17,4843963,3.0045921955132293,702,507,1209,+
chr17,4845874,1.1222858536984779,1645,1399,3044,+
chr17,4845875,0.7176763110307415,1269,1105,2374,+
chr17,4845876,0.7176763110307415,1269,1105,2374,+
chr17,4845887,0.396361273554256,609,512,1121,+
chr17,4846178,1.009970168001256,829,578,1407,+
chr17,4846179,1.009970168001256,829,578,1407,+
chr17,4846496,2.1382978723404253,803,610,1413,+
chr17,4846498,1.5471254604575315,1211,858,2069,+
chr17,4848455,55.94477309915127,1419,821,2240,+
chr17,4848456,45.18080067088803,1752,1483,3235,+
chr17,4848457,37.12431252312287,1917,1674,3591,+
chr17,4848468,7.749819368801357,832,1202,2034,+
chr17,4855158,1.83616616663066,836,576,1412,+
chr17,4856627,3.142580872011252,714,473,1187,+
chr17,4858737,1.141501976284585,1215,735,1950,+
chr17,4858738,1.4462540801475643,1643,1105,2748,+
chr17,4858755,2.1406896551724137,678,405,1083,+
chr17,4858767,2.4664429530201346,734,446,1180,+
chr17,4858782,1.4226170402710814,987,788,1775,+
chr17,4858788,2.0204789455060537,1151,867,2018,+
chr17,4858799,1.902335456475584,1119,784,1903,+
chr17,4858807,2.3065527065527065,735,584,1319,+
chr17,4858809,1.9442861665083888,1161,971,2132,+
chr17,4858810,1.9948006138482328,798,692,1490,+
chr17,4858812,1.4854266622035435,1761,1168,2929,+
chr17,4858815,1.715235909736442,6003,4053,10056,+
chr17,4858817,1.8052253210394704,3971,2730,6701,+
chr17,4858820,1.7919364290896915,2272,1557,3829,+
chr17,4859370,1.6476388168137002,634,422,1056,+
chr17,4859905,2.2718421308083894,675,455,1130,+
chr17,4860170,0.5850168175310446,769,602,1371,+
chr17,5212034,2.16661563790823,928,713,1641,+
chr17,5212036,2.16661563790823,928,713,1641,+
chr17,5212063,2.348539303873174,615,449,1064,+
chr17,5241408,2.3503649635036497,643,410,1053,+
chr17,5241409,2.3503649635036497,643,410,1053,+
chr17,5253850,1.7506493506493506,673,494,1167,+
chr17,5253875,1.5609886987065413,1986,1736,3722,+
chr17,5253876,1.682901554404145,1217,1157,2374,+
chr17,5264565,1.452216562912658,630,588,1218,+
chr17,5264567,2.017337699865151,951,715,1666,+
chr17,5264679,3.155130241522201,936,563,1499,+
chr17,5264683,2.7864413814299236,1220,817,2037,+
chr17,5264701,1.7307839388145316,729,522,1251,+
chr17,5264717,1.9311135330151457,1194,648,1842,+
chr17,5264718,1.9311135330151457,1194,648,1842,+
chr17,5264735,1.6406618928839372,2748,1881,4629,+
chr17,5264741,1.0520676726505538,2135,1595,3730,+
chr17,5264761,1.122785767329303,4371,3116,7487,+
chr17,5264762,1.4731812577065353,2510,1621,4131,+
chr17,5264766,3.84307263277982,1466,1028,2494,+
chr17,5280577,1.6533615337446823,1062,552,1614,+
chr17,5280581,5.593170731707318,818,409,1227,+
chr17,5281504,1.9882140274765003,886,460,1346,+
chr17,5281517,1.644736842105263,1249,683,1932,+
chr17,5283668,2.374822030723117,1111,784,1895,+
chr17,5286552,0.7562924879998051,695,453,1148,+
chr17,5286813,1.5177663211213996,1185,808,1993,+
chr17,5323569,1.077202586417373,686,470,1156,+
chr17,5324655,3.11727078891258,558,468,1026,+
chr17,5324656,3.11727078891258,558,468,1026,+
chr17,5391648,3.037155457552371,1351,906,2257,+
chr17,5391649,3.0830127548892463,3285,2154,5439,+
chr17,5391650,3.0883189385562333,3020,1979,4999,+
chr17,5391663,2.3469785575048734,644,512,1156,+
chr17,5391671,8.169368821567367,4592,4609,9201,+
chr17,5391672,8.169368821567367,4592,4609,9201,+
chr17,5391690,3.6664127951256655,829,1009,1838,+
chr17,5392638,0.2909722222222222,837,575,1412,+
chr17,5392640,0.2909722222222222,837,575,1412,+
chr17,5393153,0.8386153547781666,597,474,1071,+
chr17,6544490,2.5407608695652173,604,505,1109,+
chr17,6544491,2.5407608695652173,604,505,1109,+
chr17,6545073,1.5271585412559043,631,529,1160,+
chr17,6545107,0.4877790289461483,525,486,1011,+
chr17,6545112,2.808288770053476,777,439,1216,+
chr17,6545129,1.4899598393574296,688,497,1185,+
chr17,6915942,0.4467232078083783,870,662,1532,+
chr17,6915974,1.3311146912904288,1026,680,1706,+
chr17,6916029,2.156320683588841,857,518,1375,+
chr17,6916030,0.4670318919976521,681,537,1218,+
chr17,6916074,0.5285570469798658,828,595,1423,+
chr17,6917641,1.5634448785459487,766,608,1374,+
chr17,6917711,2.4836601307189543,759,458,1217,+
chr17,6917730,1.821161825726141,626,481,1107,+
chr17,6918381,0.8404008284541367,801,534,1335,+
chr17,7123233,0.9463137515298454,887,498,1385,+
chr17,7123235,0.9463137515298454,887,498,1385,+
chr17,7123243,3.6340399002493764,602,400,1002,+
chr17,7123244,3.6340399002493764,602,400,1002,+
chr17,7123301,1.0882295292216109,1562,931,2493,+
chr17,7123302,1.0882295292216109,1562,931,2493,+
chr17,7123790,1.2299884659746252,687,509,1196,+
chr17,7123791,1.2299884659746252,687,509,1196,+
chr17,7123823,0.6164281242672246,1186,804,1990,+
chr17,7123829,1.0725446428571428,1270,983,2253,+
chr17,7123830,1.4144086955981419,2088,1505,3593,+
chr17,7123922,1.6011700913242009,1144,875,2019,+
chr17,7123928,1.38726144411678,2191,1548,3739,+
chr17,7123969,0.6966637718917353,1480,1127,2607,+
chr17,7124110,0.509108906720583,1050,832,1882,+
chr17,7124113,0.9771322074618428,2485,1855,4340,+
chr17,7124115,0.9771322074618428,2485,1855,4340,+
chr17,7124256,1.9041887337506016,1129,803,1932,+
chr17,7124261,2.2695936139332367,1250,688,1938,+
chr17,7124304,2.7662517289073305,749,481,1230,+
chr17,7124338,2.1837028505614744,631,452,1083,+
chr17,7124341,1.5110691220682615,2575,2098,4673,+
chr17,7124343,1.5509335764620966,1643,1448,3091,+
chr17,7124904,1.7963636363636366,805,549,1354,+
chr17,7124971,0.8601313255153366,3199,2069,5268,+
chr17,7124973,1.1593315526333814,3163,1883,5046,+
chr17,7124974,1.1692627206645898,3377,2032,5409,+
chr17,7124976,1.5002327530025137,2301,1400,3701,+
chr17,7124977,0.4240679217423403,717,601,1318,+
chr17,7125316,1.5403387884008035,1072,647,1719,+
chr17,7125507,2.3597479704349937,949,785,1734,+
chr17,7125582,2.800578034682081,968,518,1486,+
chr17,7125613,3.767195767195767,622,440,1062,+
chr17,7125999,2.130256973692242,1744,1142,2886,+
chr17,7126001,2.130256973692242,1744,1142,2886,+
chr17,7126093,2.8686427971087705,1930,1391,3321,+
chr17,7126119,0.5031829032624758,680,462,1142,+
chr17,7126172,1.9967822862129143,892,572,1464,+
chr17,7126484,2.342913536484663,1571,1210,2781,+
chr17,7126485,2.342913536484663,1571,1210,2781,+
chr17,7126986,1.9652014652014653,782,566,1348,+
chr17,7127014,1.771573604060914,697,590,1287,+
chr17,7127041,1.577966064518648,1479,1150,2629,+
chr17,7127188,1.8420146362462333,777,605,1382,+
chr17,7127335,1.6724818341267855,796,613,1409,+
chr17,7127345,1.5792932539084505,2145,1642,3787,+
chr17,7127665,1.2472783825816485,801,642,1443,+
chr17,7127666,1.2472783825816485,801,642,1443,+
chr17,7127668,4.065846994535519,646,365,1011,+
chr17,7127689,1.29140595761453,971,717,1688,+
chr17,7127817,1.1528057559179845,1102,836,1938,+
chr17,7127848,0.5933141841889835,1575,1252,2827,+
chr17,7127856,1.8209225886886549,553,518,1071,+
chr17,7128131,1.639577741993201,1477,809,2286,+
chr17,7128133,1.7144080808080808,2256,1249,3505,+
chr17,7128134,1.700385961762858,1535,856,2391,+
chr17,7128170,1.5602830952174047,2450,1810,4260,+
chr17,7128172,1.5602830952174047,2450,1810,4260,+
chr17,7128291,1.9937402190923317,636,425,1061,+
chr17,7128414,0.4908992285438765,542,487,1029,+
chr17,7128417,1.985703536493604,636,442,1078,+
chr17,7128440,0.6111601019008426,997,755,1752,+
chr17,7128514,1.678157988078377,1627,1273,2900,+
chr17,7156107,10.480564251291275,917,830,1747,+
chr17,7210878,2.983065813550261,616,481,1097,+
chr17,7210979,0.5296124031007752,853,429,1282,+
chr17,7211011,4.115444015444015,626,517,1143,+
chr17,7211014,1.7346082882883198,924,790,1714,+
chr17,7211017,4.899736378010554,2344,1900,4244,+
chr17,7211018,1.091147540983607,575,548,1123,+
chr17,7211042,1.915839905535586,1154,1087,2241,+
chr17,7211048,1.6202278325123152,841,811,1652,+
chr17,7211050,1.6729707901467223,937,645,1582,+
chr17,7211054,1.1630613041780553,2247,1575,3822,+
chr17,7211055,1.1630613041780553,2247,1575,3822,+
chr17,7211364,3.497241433308075,1064,679,1743,+
chr17,7211365,3.7187168141487366,755,585,1340,+
chr17,7211366,3.4923053940701094,1308,915,2223,+
chr17,7211388,2.0189874789837474,813,653,1466,+
chr17,7211390,3.5640792905909238,1121,907,2028,+
chr17,7212935,0.6477742882976795,3665,3200,6865,+
chr17,7212936,0.6509726926650881,2748,2284,5032,+
chr17,7212941,0.6246111733233795,1003,986,1989,+
chr17,7212950,0.7385286975895098,7788,6830,14618,+
chr17,7212951,0.7111127516187788,5008,4281,9289,+
chr17,7212952,0.7863175364189563,2780,2549,5329,+
chr17,7213008,0.7838952430789164,3700,2547,6247,+
chr17,7213015,1.6273562533363988,6319,3746,10065,+
chr17,7213025,1.7561156412157153,2780,1916,4696,+
chr17,7213029,1.6757427109667422,7762,4822,12584,+
chr17,7213032,1.3494081748537146,27902,18421,46323,+
chr17,7213033,1.3494081748537146,27902,18421,46323,+
chr17,7213034,1.3226765924340929,35456,23314,58770,+
chr17,7213068,1.302619368067129,3775,2725,6500,+
chr17,7213069,1.4537591149107367,2335,1939,4274,+
chr17,7214937,0.7321088199618783,2274,1392,3666,+
chr17,7215168,1.6464288250025054,3235,2018,5253,+
chr17,7215285,1.632606433515812,1781,1425,3206,+
chr17,7215440,1.0133521072052825,772,541,1313,+
chr17,7215441,1.0133521072052825,772,541,1313,+
chr17,7215445,1.108788844621514,1350,1003,2353,+
chr17,7215446,1.108788844621514,1350,1003,2353,+
chr17,7215447,0.5126220802499493,882,664,1546,+
chr17,7215508,1.6549606601420073,783,578,1361,+
chr17,7215536,1.8613773122353467,869,640,1509,+
chr17,7215544,1.5770436460091637,980,753,1733,+
chr17,7215629,1.780713502983076,1124,381,1505,+
chr17,7215638,2.53395500460315,3555,1915,5470,+
chr17,7215648,16.921928535482188,6608,3955,10563,+
chr17,7215649,9.494413407821227,1544,1073,2617,+
chr17,7215650,9.979468987891417,4060,2064,6124,+
chr17,7215673,1.6299959355100937,1588,846,2434,+
chr17,7215679,3.2326530612244895,863,629,1492,+
chr17,7404387,2.1249440214957453,729,615,1344,+
chr17,7404388,2.1249440214957453,729,615,1344,+
chr17,7404631,1.6485996055226826,652,506,1158,+
chr17,7404641,2.1535428027205246,1405,1108,2513,+
chr17,7404658,2.009924322889007,1100,1075,2175,+
chr17,7412383,0.5651515151515152,745,483,1228,+
chr17,7468804,0.957603777296872,648,390,1038,+
chr17,7468806,0.957603777296872,648,390,1038,+
chr17,7468835,1.739633030166799,1091,745,1836,+
chr17,7468836,2.25,683,431,1114,+
chr17,7474062,0.28125,524,524,1048,+
chr17,7474063,0.28125,524,524,1048,+
chr17,7475119,6.121875043235149,746,658,1404,+
chr17,7476143,0.7098314099311769,7094,3843,10937,+
chr17,7476144,0.6693524600061975,9947,4883,14830,+
chr17,7476145,0.7218094206195349,12916,6250,19166,+
chr17,7476148,2.1424920453099143,6898,2424,9322,+
chr17,7476149,2.0689779758437767,12145,5058,17203,+
chr17,7476152,1.7266295650090633,22051,10497,32548,+
chr17,7476153,1.791554357927147,18661,8707,27368,+
chr17,7476159,1.9537527793863467,4375,1900,6275,+
chr17,7476173,1.8856095679012344,4249,2591,6840,+
chr17,7477876,1.4006077168066278,3829,1965,5794,+
chr17,7477933,1.3426057294653908,3581,2531,6112,+
chr17,7478439,1.232656111462951,5592,3157,8749,+
chr17,7478473,1.3873136924739864,9990,7611,17601,+
chr17,7478474,1.2808229091591234,18059,13468,31527,+
chr17,7478524,0.7524114799086724,3774,3126,6900,+
chr17,7479931,0.5126385809312639,4334,2459,6793,+
chr17,7479953,1.4758809730556386,4140,2488,6628,+
chr17,7479984,1.3177490802935607,5314,3306,8620,+
chr17,7480000,1.2343157894736845,5862,3799,9661,+
chr17,7480448,1.1937629937629937,2969,1949,4918,+
chr17,7480453,1.41725904883585,9260,5132,14392,+
chr17,7480454,1.3827854186124307,12552,7334,19886,+
chr17,7480745,1.7615756555080686,7230,5012,12242,+
chr17,7480746,1.7615756555080686,7230,5012,12242,+
chr17,7481002,1.5372501514233798,3347,2417,5764,+
chr17,7481808,2.7003585239459555,2155,1358,3513,+
chr17,7481881,47.8749648714626,11358,3521,14879,+
chr17,7481882,35.11051477647662,8240,2292,10532,+
chr17,7481890,33.184626575087826,6954,3132,10086,+
chr17,7481891,30.445816130410794,9700,4416,14116,+
chr17,7481910,1.8644840447575632,1226,761,1987,+
chr17,7481943,0.3751662971175166,798,934,1732,+
chr17,7482023,0.43502501127027887,829,800,1629,+
chr17,7482026,1.4726984621778887,1245,801,2046,+
chr17,7482027,1.1128682914898904,1791,1310,3101,+
chr17,7482028,1.4726984621778887,1245,801,2046,+
chr17,7482030,0.6132563011872261,946,828,1774,+
chr17,7482031,0.5708705357142857,1484,1279,2763,+
chr17,7482032,1.74964534060125,823,682,1505,+
chr17,7482033,0.5020446681346336,1025,866,1891,+
chr17,7482038,0.5763825163004105,662,504,1166,+
chr17,7482041,0.4833572224876573,606,482,1088,+
chr17,7482110,1.507391530267602,1506,1282,2788,+
chr17,7482228,4.649104717933625,4274,3087,7361,+
chr17,7484879,12.050151029697524,1161,2184,3345,+
chr17,7484880,13.386628011139369,1390,2846,4236,+
chr17,7484881,13.386628011139369,1390,2846,4236,+
chr17,7484886,0.27550838387653137,591,1473,2064,+
chr17,7484887,0.27550838387653137,591,1473,2064,+
chr17,7484888,0.3181216931216931,480,965,1445,+
chr17,7484903,0.27010603044472525,403,880,1283,+
chr17,7487203,3.9467320261437906,928,407,1335,+
chr17,7487205,4.263045061008861,1268,591,1859,+
chr17,7489383,2.146944098703794,1272,903,2175,+
chr17,7491014,3.5002917796689426,857,588,1445,+
chr17,7491389,2.7858823529411763,665,449,1114,+
chr17,7491441,1.769660560013065,581,448,1029,+
chr17,7491442,2.405392156862745,700,509,1209,+
chr17,7491444,8.19557731340794,723,618,1341,+
chr17,8124874,0.9497065394421192,1293,1101,2394,+
chr17,15907560,1.509630524550251,760,494,1254,+
chr17,15929923,1.9091104627239743,741,532,1273,+
chr17,15929954,0.5098491557099238,937,715,1652,+
chr17,15929971,2.417152783477676,1298,1004,2302,+
chr17,15929987,1.860085227272727,872,615,1487,+
chr17,15929993,2.2930481283422464,1004,824,1828,+
chr17,15930000,2.494156147732585,1066,929,1995,+
chr17,15932023,20.514611889547666,1252,1150,2402,+
chr17,15932024,20.514611889547666,1252,1150,2402,+
chr17,16284403,1.012073284984255,3949,2396,6345,+
chr17,16284404,0.9449461372579474,5565,3310,8875,+
chr17,16284408,1.754808709001931,5786,3689,9475,+
chr17,16284467,1.6619870403644168,7667,5958,13625,+
chr17,16284468,1.42991456004889,3173,2258,5431,+
chr17,16285231,0.8381559503246397,5962,3833,9795,+
chr17,16285305,1.4329581738101804,7033,5025,12058,+
chr17,16285306,1.4329581738101804,7033,5025,12058,+
chr17,16285459,1.1324463500033866,2008,1318,3326,+
chr17,16285464,1.7355947955390338,995,537,1532,+
chr17,16285495,1.4415634268184478,6384,4463,10847,+
chr17,16285533,1.4125848204491986,2725,1972,4697,+
chr17,16285540,1.5492063492063493,3051,2288,5339,+
chr17,16285546,1.3158895265423245,5240,3279,8519,+
chr17,16285692,1.1861886151776275,4057,3533,7590,+
chr17,16285708,1.310009267840593,4625,3236,7861,+
chr17,16285810,1.4468762435336249,1817,1076,2893,+
chr17,16285848,1.6385565474471944,4082,2643,6725,+
chr17,16285849,1.6385565474471944,4082,2643,6725,+
chr17,16285852,1.3439573654476715,2127,1426,3553,+
chr17,16285854,1.2295488379012167,5966,4138,10104,+
chr17,16285907,0.7892114987186079,3314,2616,5930,+
chr17,16285908,1.431058923093198,2794,2054,4848,+
chr17,16342349,1.175640576965305,1689,1407,3096,+
chr17,16342350,1.1520343763913694,4492,3852,8344,+
chr17,16342352,1.4083560230078584,3217,2941,6158,+
chr17,16342354,1.0286273805352906,4798,4088,8886,+
chr17,16342356,0.6580029342284375,3886,3612,7498,+
chr17,16342357,1.4515733936310533,1490,1043,2533,+
chr17,16342718,1.3298331847126723,7800,5932,13732,+
chr17,16342720,1.3608673353354999,15749,11460,27209,+
chr17,16342859,1.7060394678837227,1461,786,2247,+
chr17,16342925,1.2676523370034545,2958,2315,5273,+
chr17,16342944,0.6912089913364727,2951,2260,5211,+
chr17,16342945,0.7547373874403153,3324,2091,5415,+
chr17,16343525,1.3627291344758354,7758,4890,12648,+
chr17,16343539,1.222502218946371,8062,5192,13254,+
chr17,16344538,0.5884710377930006,1352,932,2284,+
chr17,16344684,1.0339489969695383,22113,16465,38578,+
chr17,16344685,1.1669905711929054,47759,35760,83519,+
chr17,16344901,1.7503565027408192,1807,1340,3147,+
chr17,16344902,1.2432539682539685,2650,1847,4497,+
chr17,16344903,0.770842312377026,2570,1641,4211,+
chr17,16344905,1.289801112586144,4524,3597,8121,+
chr17,16344907,1.3754168501093518,4386,3076,7462,+
chr17,16344908,0.7470285021224985,2081,1648,3729,+
chr17,16344913,1.3516738353111883,2065,1677,3742,+
chr17,16344972,1.336983435047951,3965,3440,7405,+
chr17,16345013,1.5540398497003758,8260,6910,15170,+
chr17,16345047,1.1455741751720865,5585,4212,9797,+
chr17,16345142,0.8551408924457973,7262,5400,12662,+
chr17,17991335,2.35803296261557,837,438,1275,+
chr17,17991337,2.35803296261557,837,438,1275,+
chr17,18009779,3.3937823834196887,785,385,1170,+
chr17,18009780,3.3937823834196887,785,385,1170,+
chr17,18009783,1.4633545628667626,768,508,1276,+
chr17,18010467,1.6021636185461654,845,581,1426,+
chr17,18010479,1.2377010163079816,803,604,1407,+
chr17,18010501,9.164634146341465,834,655,1489,+
chr17,18112846,1.4535629346683112,707,510,1217,+
chr17,18554876,1.6212602212602214,886,692,1578,+
chr17,18554879,0.6003888087221421,1032,755,1787,+
chr17,18554887,1.6502456331877728,833,457,1290,+
chr17,18554902,1.9383097383097383,1101,665,1766,+
chr17,18554909,2.078618535230823,1238,803,2041,+
chr17,18694211,0.24712448118587424,724,431,1155,+
chr17,18694221,2.0177970399741803,1041,528,1569,+
chr17,18694223,1.3950518891947772,1888,999,2887,+
chr17,18694224,1.0322270322270322,1109,566,1675,+
chr17,18694230,2.0126197183098595,686,354,1040,+
chr17,18694234,1.2678640005250057,884,529,1413,+
chr17,18694284,0.5378079864061173,632,427,1059,+
chr17,18694287,0.2535917312661498,700,449,1149,+
chr17,18694290,0.5965646333406738,773,477,1250,+
chr17,18694294,0.5232581453634084,948,531,1479,+
chr17,18702212,1.121941489361702,766,469,1235,+
chr17,18702213,1.121941489361702,766,469,1235,+
chr17,18709028,0.9642625081221572,741,569,1310,+
chr17,18709029,0.9642625081221572,741,569,1310,+
chr17,18709352,1.7385874246339363,733,515,1248,+
chr17,19091387,1.272151466006064,1396,1179,2575,+
chr17,19091388,1.0258154555521894,1252,1065,2317,+
chr17,19575049,5.63629904595997,870,875,1745,+
chr17,19575213,2.364708793450201,778,499,1277,+
chr17,20108457,0.5890791913127924,784,481,1265,+
chr17,20109104,0.7414856960992674,747,467,1214,+
chr17,20130734,1.4553236397748592,1181,655,1836,+
chr17,20130765,1.6273739025164609,3250,1939,5189,+
chr17,20130768,2.0039956212370007,1926,1159,3085,+
chr17,20130805,1.7857444221080585,4327,2441,6768,+
chr17,20130806,1.7857444221080585,4327,2441,6768,+
chr17,20130831,2.3106725990985786,1508,1017,2525,+
chr17,20135088,1.858352488163297,1477,1082,2559,+
chr17,20135094,2.129117259552042,1615,1286,2901,+
chr17,20135642,1.4529704365625962,627,450,1077,+
chr17,20135643,0.8679693961952026,729,495,1224,+
chr17,20217522,1.0972488701285987,711,574,1285,+
chr17,20217681,1.0581546134663342,623,400,1023,+
chr17,20217682,1.0581546134663342,623,400,1023,+
chr17,20217737,0.9728523616717033,962,705,1667,+
chr17,20217739,0.3776785248075983,1008,780,1788,+
chr17,25621390,1.006566774298879,866,640,1506,+
chr17,25621391,1.006566774298879,866,640,1506,+
chr17,25621401,0.5726090655000609,588,421,1009,+
chr17,25621409,3.229391371340524,620,471,1091,+
chr17,25621417,1.978089222266088,910,595,1505,+
chr17,25621418,2.3190239170114197,1864,1646,3510,+
chr17,25621419,2.2674142954478005,2400,1967,4367,+
chr17,25639428,0.9723407173460499,643,418,1061,+
chr17,26653812,1.4355419277429675,672,576,1248,+
chr17,26654067,0.45053437391873796,761,534,1295,+
chr17,26654068,0.5103665082594459,627,430,1057,+
chr17,26654352,9.066227396684209,1302,316,1618,+
chr17,26654353,7.890113119454109,1558,383,1941,+
chr17,26654355,5.779131167225387,936,260,1196,+
chr17,26654360,11.523917652545867,1701,557,2258,+
chr17,26654361,12.065517784479873,1635,532,2167,+
chr17,26654365,22.078300110938947,1209,848,2057,+
chr17,26654366,19.421445838898354,2207,1690,3897,+
chr17,26654367,14.552228730983739,2683,2144,4827,+
chr17,26654369,6.958537289946545,953,874,1827,+
chr17,26655032,3.376471312292748,839,643,1482,+
chr17,26668462,2.117836259864666,550,538,1088,+
chr17,26795354,1.7874631522917062,1068,599,1667,+
chr17,26795366,1.8937750333778367,1334,855,2189,+
chr17,26795368,1.5390998638235696,770,450,1220,+
chr17,26795390,1.593358968255912,1185,816,2001,+
chr17,26795398,1.5075185858659226,4789,3366,8155,+
chr17,26795401,2.0273684210526315,962,774,1736,+
chr17,26795402,2.0273684210526315,962,774,1736,+
chr17,27047003,1.1080398631385495,617,526,1143,+
chr17,27047005,1.230817031304649,976,928,1904,+
chr17,27047006,1.0753321085599132,4624,6045,10669,+
chr17,27047007,1.0762608045642066,2319,1850,4169,+
chr17,27047008,1.0637910358913543,6666,7642,14308,+
chr17,27047010,0.8266748932004583,6330,3582,9912,+
chr17,27047011,0.7768945389872534,48551,31355,79906,+
chr17,27047012,0.9304785650844446,13203,7467,20670,+
chr17,27047013,0.8163513405152756,35124,16469,51593,+
chr17,27047014,1.3149948105864102,84603,52958,137561,+
chr17,27047016,1.2896309473261263,102679,56490,159169,+
chr17,27047017,1.41032999024334,41231,20977,62208,+
chr17,27047018,1.2620124308420495,159711,113925,273636,+
chr17,27047020,1.1991059338729728,186624,145355,331979,+
chr17,27047021,1.1706591975810634,132509,103742,236251,+
chr17,27047038,1.4496270855722795,89282,57561,146843,+
chr17,27047039,1.4496270855722795,89282,57561,146843,+
chr17,27047905,0.6612961325605003,877,376,1253,+
chr17,27049740,1.4584347393184676,2297,1197,3494,+
chr17,27049741,1.4841458944281525,3159,1487,4646,+
chr17,27049743,1.1959942446924126,2200,1036,3236,+
chr17,27049748,1.7264367816091952,750,434,1184,+
chr17,27049752,2.075361774102612,817,312,1129,+
chr17,27049753,1.542651493045424,3659,1862,5521,+
chr17,27049754,1.635267314655643,5661,2918,8579,+
chr17,27049756,1.5931127051276572,8066,4037,12103,+
chr17,27049757,1.5915871254692864,9693,4887,14580,+
chr17,27049759,1.4995644262563548,10348,5357,15705,+
chr17,27049760,1.4433987156651602,7147,3734,10881,+
chr17,27049762,0.6878658709860755,930,764,1694,+
chr17,27049764,1.6732280517925304,2915,1723,4638,+
chr17,27049776,0.6098514464425332,2274,1278,3552,+
chr17,27049780,1.34297933086941,2611,1462,4073,+
chr17,27049792,1.403693628814537,7587,4372,11959,+
chr17,27049793,1.3639625516582445,24210,15719,39929,+
chr17,27049795,1.407049621385697,17207,12320,29527,+
chr17,27049796,1.3697560038125012,15491,10332,25823,+
chr17,27049800,1.2926028105670153,15933,9781,25714,+
chr17,27049802,1.311656807680101,9054,4612,13666,+
chr17,27049807,1.3613703223705063,25047,16897,41944,+
chr17,27049832,1.1935995878207686,33795,19871,53666,+
chr17,27049833,1.2230719908406926,46083,27778,73861,+
chr17,27049834,1.1842610051997684,42694,26903,69597,+
chr17,27049843,1.3760891344705026,30507,19861,50368,+
chr17,27049853,0.9815807887196476,127471,101379,228850,+
chr17,27049854,0.9925554600000115,112542,90189,202731,+
chr17,27049855,0.8753668864245168,99040,82624,181664,+
chr17,27049857,0.9960745709859374,100908,77190,178098,+
chr17,27051051,1.9944664031620554,695,439,1134,+
chr17,27051083,1.761967501097936,707,620,1327,+
chr17,27051132,1.6704980842911876,653,463,1116,+
chr17,27071218,1.7314427588686057,880,609,1489,+
chr17,27071220,1.716357889274556,1053,760,1813,+
chr17,27074864,0.9323316840151925,984,714,1698,+
chr17,27075087,2.811499703615886,557,481,1038,+
chr17,27075088,2.811499703615886,557,481,1038,+
chr17,27076089,1.5009771420529934,601,419,1020,+
chr17,27076434,1.1233317253241857,710,501,1211,+
chr17,27076629,3.5712900853070466,944,636,1580,+
chr17,27076933,6.348821302696525,1056,177,1233,+
chr17,27076934,4.734201222570305,2388,397,2785,+
chr17,27076935,4.483659662659305,3916,658,4574,+
chr17,27076936,4.695641720879731,4999,829,5828,+
chr17,27076937,5.311980683340504,3791,642,4433,+
chr17,27076938,5.974243721192926,2539,417,2956,+
chr17,27076939,7.168470383596999,1305,230,1535,+
chr17,27076945,11.907616295272264,1245,255,1500,+
chr17,27076948,19.214105729446484,2944,3515,6459,+
chr17,27076949,19.214105729446484,2944,3515,6459,+
chr17,27076957,1.4888901591516692,2400,5253,7653,+
chr17,27076958,1.170375374802045,1604,3484,5088,+
chr17,27076984,0.16475046567098106,848,1973,2821,+
chr17,27077021,0.5993340732519423,539,582,1121,+
chr17,27183577,1.7906466974306567,1444,938,2382,+
chr17,27183579,1.6486229819563152,991,545,1536,+
chr17,27183582,0.6518209232196706,561,478,1039,+
chr17,27184965,0.4594043887147335,976,695,1671,+
chr17,27184978,0.6837732992714542,1245,812,2057,+
chr17,27184982,2.302180903117573,940,621,1561,+
chr17,27184985,0.6384171653458408,1527,915,2442,+
chr17,27184991,1.0946156248922125,3032,1911,4943,+
chr17,27186091,2.724348936674278,862,642,1504,+
chr17,27186093,2.55484482350154,673,468,1141,+
chr17,27187748,0.9964836680948109,838,558,1396,+
chr17,27861271,3.1149653234289563,579,552,1131,+
chr17,27861273,2.8588533773820983,711,661,1372,+
chr17,27861276,1.1094477535231826,675,527,1202,+
chr17,27872025,2.6353790613718413,656,553,1209,+
chr17,27872026,2.6353790613718413,656,553,1209,+
chr17,27872030,2.274195934025057,664,569,1233,+
chr17,28512208,2.8874992650221474,998,722,1720,+
chr17,28754493,6.894853228935123,576,473,1049,+
chr17,28769391,3.0583997547516857,738,465,1203,+
chr17,28769393,3.0583997547516857,738,465,1203,+
chr17,28769406,3.9747399445547122,835,597,1432,+
chr17,28791987,3.059296958219908,717,496,1213,+
chr17,28792004,2.6737001353610954,818,660,1478,+
chr17,28792655,0.3913214990138067,743,389,1132,+
chr17,28808196,2.0822316234796405,899,487,1386,+
chr17,28808197,2.0822316234796405,899,487,1386,+
chr17,28808219,1.985042962514163,1428,1049,2477,+
chr17,28819735,1.432185398164513,773,535,1308,+
chr17,28958776,1.6817302936283105,747,705,1452,+
chr17,28958777,1.6817302936283105,747,705,1452,+
chr17,30520215,0.4698731177018742,839,702,1541,+
chr17,30677228,3.564102564102564,833,467,1300,+
chr17,30677229,4.513695863348733,1788,1022,2810,+
chr17,30677239,15.162695273045248,1529,1580,3109,+
chr17,30677240,12.652283846333619,2279,2359,4638,+
chr17,30677293,0.33571128787567256,1008,1176,2184,+
chr17,30677300,0.3862738819511154,516,693,1209,+
chr17,30677313,0.4539754915930464,530,637,1167,+
chr17,30687912,3.0144264602392683,658,405,1063,+
chr17,30687914,2.878863207686363,878,568,1446,+
chr17,30694836,2.1859337700266552,1035,735,1770,+
chr17,30694837,2.2465111324171727,658,446,1104,+
chr17,30694889,1.814104121123796,658,536,1194,+
chr17,30694960,1.5870941667789302,692,570,1262,+
chr17,30696857,2.7616060834587444,923,679,1602,+
chr17,30771563,4.150505133816004,614,527,1141,+
chr17,30773979,1.386848168631982,704,485,1189,+
chr17,30791076,2.2905882352941176,648,424,1072,+
chr17,30796083,0.9330638330061714,993,804,1797,+
chr17,30800872,1.832461873638344,646,458,1104,+
chr17,30804539,1.9274964166268516,977,727,1704,+
chr17,30804540,1.9274964166268516,977,727,1704,+
chr17,30806378,1.906558185404339,835,623,1458,+
chr17,30807634,2.7422628617363345,826,621,1447,+
chr17,30807635,2.7422628617363345,826,621,1447,+
chr17,30807828,2.736029067615148,3018,2059,5077,+
chr17,30807829,2.308206141559715,4076,2832,6908,+
chr17,30807830,2.8614603174603173,1185,874,2059,+
chr17,30807831,1.121937984496124,1058,773,1831,+
chr17,30807858,0.5388926862611073,656,417,1073,+
chr17,30808024,4.227025012390866,807,525,1332,+
chr17,30808026,3.703769401330377,695,409,1104,+
chr17,30809103,2.6793355855855854,613,443,1056,+
chr17,30809104,2.6793355855855854,613,443,1056,+
chr17,32582370,2.169117647058824,589,479,1068,+
chr17,32582419,1.3696187371342305,1190,959,2149,+
chr17,32583249,1.4254842083164108,1587,1059,2646,+
chr17,32583281,0.5539007092198581,780,704,1484,+
chr17,32583830,0.5889101338432122,769,522,1291,+
chr17,32583843,2.467432950191571,804,579,1383,+
chr17,32583857,1.490308100387676,912,753,1665,+
chr17,32583865,1.6618457300275482,1015,725,1740,+
chr17,32583999,1.3662889398183515,1629,1070,2699,+
chr17,32584066,1.935190886699508,966,671,1637,+
chr17,32584074,2.0080226521944318,924,814,1738,+
chr17,33310215,1.6856022877709491,828,478,1306,+
chr17,33310304,2.1468819992927037,627,498,1125,+
chr17,33331667,0.215819800942902,823,414,1237,+
chr17,33331673,1.7410624613809043,1524,808,2332,+
chr17,33331675,2.110203391252359,1693,941,2634,+
chr17,33331677,2.5521108877367475,1205,726,1931,+
chr17,33331678,2.5996424440004207,823,513,1336,+
chr17,33595110,6.026474589835934,652,398,1050,+
chr17,33951476,1.5039504830145227,663,439,1102,+
chr17,33951501,2.5904666666666665,792,624,1416,+
chr17,33951502,2.5904666666666665,792,624,1416,+
chr17,33951532,2.6199616122840688,545,520,1065,+
chr17,33951548,1.4722926733312474,797,792,1589,+
chr17,33984713,2.4948586118251925,646,388,1034,+
chr17,33984715,2.4948586118251925,646,388,1034,+
chr17,34050958,4.825780085004619,677,489,1166,+
chr17,34136487,0.8901459449931004,782,243,1025,+
chr17,34136492,2.1038215958077147,1303,430,1733,+
chr17,34147362,1.8806122448979592,872,587,1459,+
chr17,34147399,1.518122759856631,3608,2789,6397,+
chr17,34147400,1.518122759856631,3608,2789,6397,+
chr17,34149687,2.5230286804776956,779,536,1315,+
chr17,34151160,14.872264358623113,2388,2216,4604,+
chr17,34151161,10.662472683376595,3164,3447,6611,+
chr17,34151162,10.34003264210593,2987,3375,6362,+
chr17,34151163,8.557813180093724,2271,2993,5264,+
chr17,34151193,0.22512748471910266,448,743,1191,+
chr17,34163145,0.467168714493328,543,521,1064,+
chr17,34163159,2.162654320987654,636,404,1040,+
chr17,34163197,1.7982551799345694,775,523,1298,+
chr17,34163215,4.327976481640536,8569,9519,18088,+
chr17,34163216,4.327976481640536,8569,9519,18088,+
chr17,34171087,6.229876152115874,1222,791,2013,+
chr17,34171090,5.247109207584617,1276,991,2267,+
chr17,34171149,3.694041702889991,544,541,1085,+
chr17,34171531,23.577492044572587,835,550,1385,+
chr17,34171532,23.577492044572587,835,550,1385,+
chr17,34171675,5.3805517979460555,935,519,1454,+
chr17,34171697,7.748795864691856,1492,1365,2857,+
chr17,34171698,7.748795864691856,1492,1365,2857,+
chr17,34171699,7.748795864691856,1492,1365,2857,+
chr17,34171744,1.595223824738551,1854,1778,3632,+
chr17,34171745,1.5056374055428317,2402,2317,4719,+
chr17,34171747,1.7808219178082187,779,815,1594,+
chr17,34171758,0.2622622622622623,654,539,1193,+
chr17,34171765,1.3835237973464627,2617,1853,4470,+
chr17,34171766,1.8314756740190121,3293,2529,5822,+
chr17,34171769,0.460390902015048,1013,745,1758,+
chr17,34171811,3.2080829874159575,2364,1475,3839,+
chr17,34171853,8.332083158205482,592,532,1124,+
chr17,34171995,13.339013450766435,582,573,1155,+
chr17,34171996,13.339013450766435,582,573,1155,+
chr17,34174077,12.327107722103639,1344,139,1483,+
chr17,34174078,11.898412200462083,1907,182,2089,+
chr17,34174079,11.857869045290588,2974,269,3243,+
chr17,34174081,16.789940038731373,2967,273,3240,+
chr17,34174083,17.70067318843566,2113,185,2298,+
chr17,34174084,27.66254285878929,1378,131,1509,+
chr17,34174087,72.61493152355729,2115,417,2532,+
chr17,34174089,70.54621936471564,3920,1888,5808,+
chr17,34174090,74.34396987612129,2857,1797,4654,+
chr17,34842591,3.126670934667321,711,454,1165,+
chr17,34848696,1.3209022495390639,932,637,1569,+
chr17,34851089,2.782852564102564,603,415,1018,+
chr17,34851192,2.4449927901919555,1023,789,1812,+
chr17,34935715,1.8521182219521348,824,525,1349,+
chr17,35310358,1.3922269548680215,659,529,1188,+
chr17,35310461,4.430465107827525,668,410,1078,+
chr17,35310527,2.061350407881895,2739,1917,4656,+
chr17,35310528,2.0062350657108725,1953,1487,3440,+
chr17,35310529,2.0062350657108725,1953,1487,3440,+
chr17,35348084,2.1082427536231885,1329,643,1972,+
chr17,35348085,2.1082427536231885,1329,643,1972,+
chr17,35348092,3.019957983193277,749,407,1156,+
chr17,35348094,2.2743221690590114,712,417,1129,+
chr17,35348096,0.8698707164393477,2470,1548,4018,+
chr17,35348101,1.890288193953116,931,572,1503,+
chr17,35348103,1.352839439569681,979,588,1567,+
chr17,35348122,1.4810296255906945,1386,916,2302,+
chr17,35348130,1.8516308056225264,1681,1234,2915,+
chr17,35376349,1.628904878904879,976,776,1752,+
chr17,35873073,0.23992380136071825,1140,646,1786,+
chr17,35873074,0.2408290121225591,1400,805,2205,+
chr17,35873075,0.2999712671200076,695,393,1088,+
chr17,35873131,7.869433304936158,1566,460,2026,+
chr17,35873132,6.773058642834423,1427,399,1826,+
chr17,35873140,41.12185650887574,758,675,1433,+
chr17,35873141,38.34361062968544,1967,2529,4496,+
chr17,35873142,38.34361062968544,1967,2529,4496,+
chr17,36462592,1.956371191135734,564,455,1019,+
chr17,36476622,1.9175519128175282,629,478,1107,+
chr17,36478082,2.636947791164658,979,829,1808,+
chr17,36478084,2.371794871794872,1499,1299,2798,+
chr17,36478085,2.2365393465255408,1019,900,1919,+
chr17,36478092,2.3371771217712176,562,541,1103,+
chr17,36478932,1.3594582846716539,775,564,1339,+
chr17,36884612,24.198468200779498,555,575,1130,+
chr17,36887586,0.5409893999975273,724,462,1186,+
chr17,36909013,0.628583338866098,2135,1208,3343,+
chr17,36909014,0.6501056363172466,1796,952,2748,+
chr17,36909022,1.9845887130527105,887,585,1472,+
chr17,36909029,2.0782726045883937,714,506,1220,+
chr17,36909031,1.908155339805825,633,514,1147,+
chr17,36909067,2.7447878186856087,1703,1411,3114,+
chr17,36909414,0.5937516298962082,1422,995,2417,+
chr17,36909490,1.263474637126782,2848,2187,5035,+
chr17,36909520,1.5878275570583262,1173,844,2017,+
chr17,36909547,1.7278404512489929,952,729,1681,+
chr17,36909570,1.394094295502746,1767,1035,2802,+
chr17,36909584,1.629310774176737,2653,1747,4400,+
chr17,36912188,1.4381404105869149,1985,1166,3151,+
chr17,36912199,1.5104631342255104,2191,1312,3503,+
chr17,36916820,0.7128572610077356,2964,2292,5256,+
chr17,36920380,1.822969920342409,806,646,1452,+
chr17,36920382,1.4067425068827593,1713,1034,2747,+
chr17,37054691,1.0437242881539714,1427,1007,2434,+
chr17,37054703,1.739773232547799,845,691,1536,+
chr17,37075030,2.1034561988343174,901,569,1470,+
chr17,37075167,0.41264227287282035,537,504,1041,+
chr17,37076192,7.595539712874394,2004,1763,3767,+
chr17,37076193,7.595539712874394,2004,1763,3767,+
chr17,37076194,7.53750499546662,1699,1539,3238,+
chr17,37076204,2.250298850574713,436,724,1160,+
chr17,37076205,2.43866664175352,1279,1814,3093,+
chr17,37076206,2.1065387045401693,791,1322,2113,+
chr17,37077051,3.086256961406937,760,515,1275,+
chr17,37077302,0.4304182509505703,565,525,1090,+
chr17,37077303,0.4814394553412223,879,795,1674,+
chr17,37077305,1.0229753340035659,836,727,1563,+
chr17,37077454,19.79223976535341,1229,935,2164,+
chr17,37077455,15.944839431640343,1758,1457,3215,+
chr17,37077728,1.8740973893723387,722,490,1212,+
chr17,37356564,1.0657057556131324,4130,3591,7721,+
chr17,37356565,0.9269913000821688,7723,6170,13893,+
chr17,37356566,0.8693954093000142,14124,10068,24192,+
chr17,37356567,0.8772845889753558,43338,29124,72462,+
chr17,37356568,0.8839757152176168,42664,28633,71297,+
chr17,37356569,0.8014487324678907,54023,34603,88626,+
chr17,37356571,0.7695217830827967,52734,29675,82409,+
chr17,37356572,0.7954129250168348,32407,13881,46288,+
chr17,37356573,0.7441502907765233,65756,35827,101583,+
chr17,37356574,0.802720275963349,38045,18661,56706,+
chr17,37357463,1.2313026858187142,14861,7202,22063,+
chr17,37357464,1.197753302824441,15937,8016,23953,+
chr17,37357465,1.2421528413785021,23796,13520,37316,+
chr17,37357496,1.2301778134069958,10770,7813,18583,+
chr17,37357514,1.192517559577844,60789,43260,104049,+
chr17,37357515,1.1066553500177394,91944,73987,165931,+
chr17,37357516,0.9411449590338987,49192,40908,90100,+
chr17,37357517,1.0735217221099724,100213,77119,177332,+
chr17,37357530,1.7367036372282818,17416,14485,31901,+
chr17,37358647,1.0779271778730468,65068,42356,107424,+
chr17,37358648,1.3679269862067622,47184,26004,73188,+
chr17,37358649,1.2401027421120816,166110,102831,268941,+
chr17,37358650,1.3796432527664861,204669,130164,334833,+
chr17,37358651,1.6408109480499682,85795,50361,136156,+
chr17,37358652,1.564720010085368,162641,105392,268033,+
chr17,37358653,1.8579630579360054,86632,56161,142793,+
chr17,37359239,1.0427027638548065,3464,3820,7284,+
chr17,37359240,1.0687857659318503,5378,5092,10470,+
chr17,37359243,1.4333656541372743,23390,14017,37407,+
chr17,37359261,0.8579102318961231,64174,40140,104314,+
chr17,37359267,0.8595425471300341,88126,59161,147287,+
chr17,37359268,0.9602243813897625,176263,115253,291516,+
chr17,37359275,1.4701283665570704,138945,101375,240320,+
chr17,37359276,1.2971097823739361,272103,189634,461737,+
chr17,37359277,1.2459861330329502,504234,340490,844724,+
chr17,37359279,1.2540847096169236,542456,364981,907437,+
chr17,37359280,1.2432916164474612,398930,270718,669648,+
chr17,37359285,1.153489113435508,128397,89740,218137,+
chr17,37359297,1.1862930030175989,239170,175006,414176,+
chr17,37359303,1.704334882548326,94245,90128,184373,+
chr17,37360369,1.363585370430326,34630,23856,58486,+
chr17,37360802,1.3197544351186863,31330,19588,50918,+
chr17,37360809,1.420386402027027,15256,11263,26519,+
chr17,37360871,0.9213463394863489,22419,16356,38775,+
chr17,37618592,2.0998677248677247,634,629,1263,+
chr17,37618593,1.9048301544867101,1070,900,1970,+
chr17,37627523,4.193535631561234,1242,750,1992,+
chr17,37627524,2.632950191570881,858,494,1352,+
chr17,38137081,1.6865146291552324,841,465,1306,+
chr17,38137116,3.030765504891378,634,458,1092,+
chr17,38137371,3.8290790411272573,848,476,1324,+
chr17,38137422,1.5952329097443683,789,578,1367,+
chr17,38140635,3.3930952497679976,609,503,1112,+
chr17,38142938,0.5267558528428093,644,597,1241,+
chr17,38144958,0.6454959349593495,862,614,1476,+
chr17,38146173,1.4139894843470795,1360,1099,2459,+
chr17,38146411,0.4870344092702268,1094,766,1860,+
chr17,38151495,2.377430820083014,1383,1011,2394,+
chr17,38151699,2.101030409650666,835,518,1353,+
chr17,38151754,2.1940819764636825,1101,971,2072,+
chr17,38152512,0.7735170235170234,1074,1035,2109,+
chr17,38152514,0.7735170235170234,1074,1035,2109,+
chr17,38153600,1.9717241808487087,2130,1586,3716,+
chr17,38153851,14.974222147650233,1197,138,1335,+
chr17,38153852,15.473870024532216,995,106,1101,+
chr17,38153858,18.083610631793253,1381,245,1626,+
chr17,38153859,17.5465513913289,1562,323,1885,+
chr17,38153860,27.121913694559673,2117,648,2765,+
chr17,38153861,35.38701366012579,1103,507,1610,+
chr17,38153867,20.431573820478846,1356,923,2279,+
chr17,38153868,20.431573820478842,1356,923,2279,+
chr17,38153873,6.66244351681232,801,770,1571,+
chr17,38153890,6.590880116524488,465,644,1109,+
chr17,38153912,0.30232744352828744,2962,2755,5717,+
chr17,38153913,0.32040041353471854,3249,3029,6278,+
chr17,38153914,0.31739283731674883,3516,3262,6778,+
chr17,38153915,0.42148019201350423,798,800,1598,+
chr17,38153970,4.182539500285275,1067,739,1806,+
chr17,38154014,0.7539088530921663,1048,676,1724,+
chr17,38154015,0.8670771459616081,797,501,1298,+
chr17,38154093,3.982468897253599,1112,888,2000,+
chr17,38154094,3.9152968608392813,962,733,1695,+
chr17,38154130,2.1013766670335046,2147,1801,3948,+
chr17,38154131,2.331539742063225,2091,1747,3838,+
chr17,38154143,4.077087794432549,543,466,1009,+
chr17,38244694,1.825917209949305,637,394,1031,+
chr17,38244695,0.3727448676297781,718,628,1346,+
chr17,38244696,0.41897146565335724,1065,828,1893,+
chr17,38244733,4.4807244501940495,1236,772,2008,+
chr17,38244734,4.4807244501940495,1236,772,2008,+
chr17,38244738,1.8668611442633434,2534,1619,4153,+
chr17,38244739,2.7001535167315835,2173,1612,3785,+
chr17,38244743,3.066647207627943,732,570,1302,+
chr17,38279273,0.6107220755366777,759,280,1039,+
chr17,38279274,0.6107220755366777,759,280,1039,+
chr17,38279421,5.7598027238066205,637,440,1077,+
chr17,38279529,0.7960005063111165,1615,1101,2716,+
chr17,38279530,1.0754871235863197,876,536,1412,+
chr17,38279531,0.493366224414961,739,565,1304,+
chr17,38279535,2.2886280408005146,1167,734,1901,+
chr17,38282497,2.3857311926007942,653,528,1181,+
chr17,38286318,8.335027100271002,765,285,1050,+
chr17,38286319,9.399430395870716,1061,407,1468,+
chr17,38286336,8.450296694548546,2107,3864,5971,+
chr17,38286337,5.935423400681533,2741,5250,7991,+
chr17,38286338,5.935423400681533,2741,5250,7991,+
chr17,38286339,4.250377985150879,1794,3894,5688,+
chr17,38286384,0.3704536804470406,397,739,1136,+
chr17,38286392,0.46165684353309233,980,1454,2434,+
chr17,38290534,0.398362848770544,1136,667,1803,+
chr17,38290535,0.398362848770544,1136,667,1803,+
chr17,38291498,17.70873176998932,1512,1196,2708,+
chr17,38291499,16.338639458513914,1709,1424,3133,+
chr17,38291500,16.338639458513917,1709,1424,3133,+
chr17,38291509,2.8310444265299894,924,960,1884,+
chr17,38318083,2.143234422603397,987,553,1540,+
chr17,38318105,2.7221686335158686,2486,1588,4074,+
chr17,38318107,3.3047497640011945,2180,1398,3578,+
chr17,38318255,1.6019716275030607,4109,2876,6985,+
chr17,38318273,2.2214015542513343,4446,3307,7753,+
chr17,38318275,1.625612912226502,8719,6125,14844,+
chr17,38318276,1.0574030817146136,3558,2323,5881,+
chr17,38318278,1.4017224847754737,5612,4482,10094,+
chr17,38318279,2.028730075416448,2011,1365,3376,+
chr17,38444233,1.174948180084258,660,487,1147,+
chr17,38445716,2.2369672367414375,924,727,1651,+
chr17,38450208,2.3111737157671213,746,496,1242,+
chr17,38450254,2.9433754236887197,1126,735,1861,+
chr17,38450670,2.195983033932136,606,500,1106,+
chr17,38450671,0.8954385964912279,1847,1424,3271,+
chr17,38450673,1.1128738742023103,2722,1986,4708,+
chr17,38457122,1.698216735253772,618,458,1076,+
chr17,38457220,0.9909830574314944,843,657,1500,+
chr17,38457720,2.5009784735812133,638,364,1002,+
chr17,38457790,1.9635375583985182,1580,855,2435,+
chr17,38457823,2.0801724137931035,1269,724,1993,+
chr17,38457824,2.2694187376520745,2024,1466,3490,+
chr17,38457826,2.181579167934924,3129,2336,5465,+
chr17,38457828,2.117946872938778,3343,2615,5958,+
chr17,38457830,2.3838135368029456,3567,2926,6493,+
chr17,38457831,1.5250889901016615,7843,4982,12825,+
chr17,38457832,2.064333406706288,3801,3244,7045,+
chr17,38457833,1.640273097009142,12248,8430,20678,+
chr17,38457834,1.6821996844714897,3542,2294,5836,+
chr17,38600053,2.7133052166641654,683,531,1214,+
chr17,38600082,0.5491141034727144,595,414,1009,+
chr17,38600225,1.4080524777543117,1190,778,1968,+
chr17,38600229,0.607605633802817,718,567,1285,+
chr17,38600245,0.5606481481481481,864,404,1268,+
chr17,38600246,2.13015873015873,792,584,1376,+
chr17,38600258,1.7694135445367298,2205,1434,3639,+
chr17,38600262,1.731898029134533,702,388,1090,+
chr17,38609258,0.3880145278450363,640,471,1111,+
chr17,38609260,1.5425558251225429,3254,2125,5379,+
chr17,38609262,1.5425558251225429,3254,2125,5379,+
chr17,38609287,1.5200423390096685,8772,5697,14469,+
chr17,38609288,1.5265180761713555,9973,6475,16448,+
chr17,38610195,2.3251439539347407,672,520,1192,+
chr17,38610230,1.938073394495413,584,435,1019,+
chr17,38610261,1.5021435376309944,900,535,1435,+
chr17,38610264,2.344222625529341,774,695,1469,+
chr17,38610278,1.9329836258456714,1010,657,1667,+
chr17,38612800,2.264048076188376,981,769,1750,+
chr17,38612894,1.1156343593850775,2080,1557,3637,+
chr17,38612917,1.4726676494479376,978,772,1750,+
chr17,38612923,1.3488531490133993,1862,1362,3224,+
chr17,38613126,1.3748601167603716,1377,1106,2483,+
chr17,38613185,1.6682918484304163,1695,1298,2993,+
chr17,38613216,0.9717421974862699,6691,5147,11838,+
chr17,38613255,0.4672445820433436,1028,849,1877,+
chr17,38613287,1.5612412810688674,2704,2105,4809,+
chr17,38613438,1.57949473501755,1349,981,2330,+
chr17,38613459,1.601135135135135,1558,1109,2667,+
chr17,38613611,8.757958412098299,911,574,1485,+
chr17,38613612,7.755673508197388,10216,7200,17416,+
chr17,38613613,12.189459798451622,2853,2568,5421,+
chr17,38613614,7.88762613828972,9765,6966,16731,+
chr17,38613641,3.8072940522392775,8483,10258,18741,+
chr17,38613642,2.9867895983561388,7509,8434,15943,+
chr17,38613646,0.6582077769642927,1945,2257,4202,+
chr17,38613850,1.445103062075539,1564,1198,2762,+
chr17,38613869,1.3968520872030503,1133,964,2097,+
chr17,39845136,0.896502106823231,1070,846,1916,+
chr17,39845138,0.896502106823231,1070,846,1916,+
chr17,39845141,0.5497686898766715,725,738,1463,+
chr17,39845241,0.4665284360189572,699,421,1120,+
chr17,39845260,1.5704168292170573,1216,708,1924,+
chr17,39845263,2.279103868862648,2636,1608,4244,+
chr17,39845264,2.279103868862648,2636,1608,4244,+
chr17,39845266,1.7210462776659956,890,709,1599,+
chr17,39845270,1.5093321668124822,940,761,1701,+
chr17,39846086,1.6562756357670223,2018,1324,3342,+
chr17,39846094,0.8188349764804433,3909,2955,6864,+
chr17,39846096,1.4942771977464615,4647,3285,7932,+
chr17,39846097,1.4942771977464615,4647,3285,7932,+
chr17,39846121,2.374523575826333,2002,1600,3602,+
chr17,39847365,0.6870582530157,1770,1268,3038,+
chr17,39847372,2.306215722120658,695,546,1241,+
chr17,39847528,1.3131085407562326,3650,2886,6536,+
chr17,39847618,1.8258766211487,1457,1120,2577,+
chr17,39847724,1.6402810178853942,1825,1202,3027,+
chr17,39969221,5.648654322957217,2188,1138,3326,+
chr17,39969222,6.889268324566301,4256,2223,6479,+
chr17,39969223,5.811700680272109,1085,734,1819,+
chr17,39969224,6.948031961288453,2625,1295,3920,+
chr17,39969228,1.9331209932647697,1219,851,2070,+
chr17,39969238,3.0056053866942536,1698,1067,2765,+
chr17,39969239,2.18928035982009,1286,666,1952,+
chr17,39969258,0.4877758895886647,823,735,1558,+
chr17,39969471,1.6926452408160793,3547,2359,5906,+
chr17,39969472,1.6779938747008545,3499,2260,5759,+
chr17,39969473,1.608756228304248,2961,1801,4762,+
chr17,39969522,1.8948820526969237,807,658,1465,+
chr17,39973351,2.6376703841387856,733,537,1270,+
chr17,39973356,2.4414667182662537,720,543,1263,+
chr17,39973361,1.9189143755608218,1287,1000,2287,+
chr17,39974367,2.000277430989041,1029,800,1829,+
chr17,39974370,1.533155080213904,731,679,1410,+
chr17,39974471,1.8332135154565061,815,427,1242,+
chr17,39974490,1.4583333333333337,839,575,1414,+
chr17,39974637,1.4185294117647058,909,679,1588,+
chr17,39974680,1.6314967227211432,2782,2206,4988,+
chr17,39974734,1.6057476425684776,893,654,1547,+
chr17,39974736,0.6752439045226989,1234,928,2162,+
chr17,39975467,2.291171749598716,792,622,1414,+
chr17,39975622,2.1938692886061304,653,454,1107,+
chr17,39975644,1.627373417721519,967,631,1598,+
chr17,39975803,0.6362170486383678,2284,1758,4042,+
chr17,39975882,1.4636518356430828,859,456,1315,+
chr17,39976525,0.6486325802615932,1090,840,1930,+
chr17,39976553,1.3982724471830987,1563,1023,2586,+
chr17,39976624,1.4762847628476283,1046,812,1858,+
chr17,39977245,2.0198321891685733,661,569,1230,+
chr17,39977962,0.5629103815439219,792,574,1366,+
chr17,39977986,2.362439743658966,1467,978,2445,+
chr17,39977997,1.7593984962406013,701,531,1232,+
chr17,39978000,4.1419624217119,575,478,1053,+
chr17,39978019,1.639594197402105,1350,994,2344,+
chr17,39978043,1.5767112509834775,834,614,1448,+
chr17,39978052,2.4704326923076927,716,623,1339,+
chr17,39978532,1.551339809892485,4802,3713,8515,+
chr17,39978533,1.602622442444467,3329,2696,6025,+
chr17,39978541,1.4140272847795408,2040,1744,3784,+
chr17,39978592,1.4558265582655827,789,614,1403,+
chr17,39978711,2.579606440071556,720,558,1278,+
chr17,39978712,2.579606440071556,720,558,1278,+
chr17,39978725,2.8009038946953577,2983,2202,5185,+
chr17,39978726,3.3920319401970778,1093,871,1964,+
chr17,39978729,3.052631578947368,579,455,1034,+
chr17,39978737,1.9187101108498488,815,457,1272,+
chr17,39978777,1.7056688405583262,1155,720,1875,+
chr17,39978778,1.2525754528566473,3264,2679,5943,+
chr17,39978779,0.5448807557080527,676,548,1224,+
chr17,39978780,1.6810253217548117,1820,1578,3398,+
chr17,39978823,1.9226263580538496,865,729,1594,+
chr17,39978829,1.3546328033160162,5376,3931,9307,+
chr17,39978975,2.0331325301204823,863,663,1526,+
chr17,39978999,2.22003388394748,952,786,1738,+
chr17,39979084,2.346153846153846,1158,702,1860,+
chr17,39979207,2.218057702215353,1012,646,1658,+
chr17,39979241,0.7455522971652004,1577,1115,2692,+
chr17,39979251,1.5971124359409288,2462,2060,4522,+
chr17,39979340,2.48636712749616,1125,335,1460,+
chr17,39979359,0.13149067601497463,3623,668,4291,+
chr17,39979376,18.308352049972527,5723,391,6114,+
chr17,39979377,28.133858267716537,1190,126,1316,+
chr17,39979378,12.471308134742184,7249,376,7625,+
chr17,39979379,13.918188779784105,8095,399,8494,+
chr17,39979380,16.86492787910097,6918,324,7242,+
chr17,39979381,13.876491054791318,11019,585,11604,+
chr17,39979382,13.707957234373097,12374,718,13092,+
chr17,39979383,13.811412934098195,11988,716,12704,+
chr17,39979384,23.17369822015186,12647,1103,13750,+
chr17,39979385,26.799120955004057,11384,1161,12545,+
chr17,39979386,22.378898978049403,10729,1368,12097,+
chr17,39979388,36.358785506178464,7309,3078,10387,+
chr17,39979389,33.55944900408918,8214,4654,12868,+
chr17,39979390,33.559449004089174,8214,4654,12868,+
chr17,40127061,3.0577659556333088,635,453,1088,+
chr17,40714904,1.0403103298611112,766,575,1341,+
chr17,40714905,1.3456400468553789,1142,923,2065,+
chr17,40714943,1.7233130218912212,663,421,1084,+
chr17,40715056,1.189982540375382,726,631,1357,+
chr17,40715058,1.189982540375382,726,631,1357,+
chr17,40715258,1.839037037037037,1220,749,1969,+
chr17,40715259,1.839037037037037,1220,749,1969,+
chr17,40715262,2.644001307616868,673,436,1109,+
chr17,40715265,1.8593539325119444,1638,1012,2650,+
chr17,40715332,0.6721754330208168,845,608,1453,+
chr17,40715980,1.72347118374693,1585,1149,2734,+
chr17,40716474,2.0456532297231664,935,567,1502,+
chr17,40716481,2.6959658215436337,986,648,1634,+
chr17,40716488,1.7965886983667374,1044,712,1756,+
chr17,40716591,1.8688118811881187,754,403,1157,+
chr17,40716746,1.8953120506183487,658,365,1023,+
chr17,40717003,1.8872549019607845,664,407,1071,+
chr17,40717008,1.915046406456328,837,775,1612,+
chr17,40717013,2.308649789029536,705,473,1178,+
chr17,40717257,1.1589228553324016,1470,1132,2602,+
chr17,40717281,1.6196903533148073,1019,686,1705,+
chr17,40717941,2.561588921282799,638,391,1029,+
chr17,40717955,0.5811586638830898,523,478,1001,+
chr17,40717962,1.756716168863674,751,460,1211,+
chr17,40717964,0.4495389344262295,584,487,1071,+
chr17,40718097,1.6863727454909818,692,498,1190,+
chr17,40719648,3.4243213595231423,724,475,1199,+
chr17,40720493,2.2783657384459683,692,517,1209,+
chr17,40720543,5.38991861931435,701,589,1290,+
chr17,40720938,1.2489539748953975,596,477,1073,+
chr17,40720940,1.2489539748953975,596,477,1073,+
chr17,40721264,3.03525641025641,946,419,1365,+
chr17,40721286,1.4519415986237303,2914,1405,4319,+
chr17,40721287,0.5919500346981262,852,523,1375,+
chr17,40721288,0.8640296662546353,1630,808,2438,+
chr17,40721297,2.115472758187329,1021,500,1521,+
chr17,40721298,2.151801363193768,1616,789,2405,+
chr17,40721301,1.6489763717629091,3516,1835,5351,+
chr17,40721302,1.6489763717629091,3516,1835,5351,+
chr17,40721313,0.441314375023825,1361,708,2069,+
chr17,40721317,2.0637261146496813,1506,784,2290,+
chr17,40721533,1.6003125976867771,1968,913,2881,+
chr17,40721556,1.3768588458173083,16263,8651,24914,+
chr17,40721557,1.4174138946694848,19364,10436,29800,+
chr17,40721558,1.4466374203608485,25831,14111,39942,+
chr17,40721559,1.241378421552428,17859,10377,28236,+
chr17,40721560,1.4685025816908677,15293,8556,23849,+
chr17,40721593,1.582287047881091,5127,3470,8597,+
chr17,40721596,1.274670795009562,5930,3474,9404,+
chr17,40722072,1.825937096079276,651,421,1072,+
chr17,40722073,1.6496083897517588,856,485,1341,+
chr17,40722127,1.5367535744322962,1141,869,2010,+
chr17,40722133,1.527264148165402,2126,1594,3720,+
chr17,40723768,0.4922267400143506,685,451,1136,+
chr17,40724290,1.8595518044722177,621,517,1138,+
chr17,40724390,1.0103440507342236,861,645,1506,+
chr17,40724615,0.5066851083448594,627,481,1108,+
chr17,40761749,3.0823613086770982,698,369,1067,+
chr17,40761788,0.7989230769230768,576,499,1075,+
chr17,40761789,0.7989230769230768,576,499,1075,+
chr17,40762534,0.518515205724508,934,558,1492,+
chr17,40762536,0.518515205724508,934,558,1492,+
chr17,40762548,1.7981491888651604,740,345,1085,+
chr17,40762549,1.791060948081264,683,442,1125,+
chr17,40762554,1.7334726443768995,729,328,1057,+
chr17,40762559,1.6568497407723661,2786,1496,4282,+
chr17,40762561,1.8271383788625168,2583,1462,4045,+
chr17,40762562,1.6340165151785184,2768,1628,4396,+
chr17,40762564,1.6723404272909235,2904,1665,4569,+
chr17,40762568,0.7001588681394443,1373,913,2286,+
chr17,40762571,1.7420356526739504,1121,739,1860,+
chr17,40762582,1.4486506140917903,1558,883,2441,+
chr17,40765959,3.120552022730348,743,388,1131,+
chr17,40765961,3.120552022730348,743,388,1131,+
chr17,40766517,4.6534022448695795,684,441,1125,+
chr17,40766648,0.3664437613254033,676,396,1072,+
chr17,40767085,2.0916134554249943,2978,1950,4928,+
chr17,40767086,2.3915782938483803,2811,1755,4566,+
chr17,40767087,2.143680716107282,3834,2563,6397,+
chr17,40767088,2.07455619752483,2812,1941,4753,+
chr17,40767089,2.009186375344489,2291,1616,3907,+
chr17,40767090,2.057681894586949,2095,1492,3587,+
chr17,40767160,1.5224735083875136,758,617,1375,+
chr17,40767166,1.0953567047102122,1015,726,1741,+
chr17,40767168,1.6416472270121534,1388,1052,2440,+
chr17,40925474,1.7568981398783052,1080,591,1671,+
chr17,40925483,1.6271382992137653,673,434,1107,+
chr17,40925502,1.8311316185074602,1241,759,2000,+
chr17,40925815,2.2808363160380054,1061,809,1870,+
chr17,40927418,0.5889080569931633,708,422,1130,+
chr17,40927437,1.8178564500526762,1150,896,2046,+
chr17,40927479,1.9079229122055679,692,466,1158,+
chr17,40931388,1.8442367601246104,591,427,1018,+
chr17,40931541,0.8193954190035108,1264,786,2050,+
chr17,40989675,1.2250814276660775,736,561,1297,+
chr17,40991352,0.4742096505823627,1006,600,1606,+
chr17,40991353,2.1451829151503548,699,453,1152,+
chr17,40991368,1.634189864382584,722,466,1188,+
chr17,40991371,2.5131737428485406,1213,737,1950,+
chr17,40991373,1.670862412761715,653,471,1124,+
chr17,40991380,2.4033613445378155,883,577,1460,+
chr17,40993634,2.392441012889057,794,576,1370,+
chr17,40993658,2.0163420903950695,627,529,1156,+
chr17,40994019,6.048412014378746,757,559,1316,+
chr17,40994132,0.3460118761033541,587,602,1189,+
chr17,40994133,0.3460118761033541,587,602,1189,+
chr17,40994147,0.3530591149360329,536,486,1022,+
chr17,41150416,0.6135309278350515,620,387,1007,+
chr17,41150418,0.5506756756756757,977,591,1568,+
chr17,41150419,0.8219837245587512,881,570,1451,+
chr17,41150429,0.39764934313806494,836,636,1472,+
chr17,41150430,0.7334096912961867,2422,1581,4003,+
chr17,41150431,1.0245137380795015,1285,711,1996,+
chr17,41150439,1.4329017905032106,2039,1360,3399,+
chr17,41150441,1.069305787985458,1089,805,1894,+
chr17,41150450,0.5827207977207977,2152,1559,3711,+
chr17,41150451,0.5827207977207977,2152,1559,3711,+
chr17,41150454,0.6823125341353891,9397,5249,14646,+
chr17,41150455,0.656609252705577,10971,6060,17031,+
chr17,41150456,0.749758476471227,8175,4562,12737,+
chr17,41150464,1.3058320325598394,15200,8038,23238,+
chr17,41150465,1.24123134848124,21202,11689,32891,+
chr17,41150466,1.2805261666341818,20077,10806,30883,+
chr17,41150467,1.1907457964900636,16350,8916,25266,+
chr17,41150473,1.459815748305232,4998,2614,7612,+
chr17,41150474,1.4407242785413843,7782,4313,12095,+
chr17,41150764,0.8940493699418103,19355,10475,29830,+
chr17,41150765,1.1602775869994395,40390,24364,64754,+
chr17,41150766,0.8940493699418103,19355,10475,29830,+
chr17,41150767,1.551426694389333,12055,8243,20298,+
chr17,41150773,1.1572492653340944,4806,3760,8566,+
chr17,41150774,1.1757925569438477,20941,11100,32041,+
chr17,41150779,1.20300192934302,91870,51152,143022,+
chr17,41150780,1.2013864256236004,81904,43998,125902,+
chr17,41150781,1.2013864256236004,81904,43998,125902,+
chr17,41150801,1.4246308937264311,26367,14871,41238,+
chr17,41150818,1.447921044017778,130188,86672,216860,+
chr17,41150819,1.447921044017778,130188,86672,216860,+
chr17,41151948,0.4815602871936609,5206,3423,8629,+
chr17,41151964,0.8714573290437706,128563,84363,212926,+
chr17,41151969,0.969345367277691,132589,86588,219177,+
chr17,41151972,1.3171393481364342,149940,101516,251456,+
chr17,41151977,1.2724889256010214,143925,90375,234300,+
chr17,41151979,1.1448382064854157,91292,49392,140684,+
chr17,41151982,1.2659465249947823,52385,29093,81478,+
chr17,41151987,1.2391965761984738,134392,96503,230895,+
chr17,41152001,1.1270694256646951,116297,96120,212417,+
chr17,41154886,0.9484515509354541,1730,1288,3018,+
chr17,41323230,0.908949338396276,993,402,1395,+
chr17,41342678,1.4011342410933507,630,459,1089,+
chr17,41343393,1.8684304267161413,837,633,1470,+
chr17,41345601,2.318240619014277,996,707,1703,+
chr17,41346503,0.4626527815696254,862,594,1456,+
chr17,41348575,1.9677494025240303,808,604,1412,+
chr17,41349052,1.4011786547218945,869,635,1504,+
chr17,41352283,5.302564102564103,751,259,1010,+
chr17,41352284,5.302564102564103,751,259,1010,+
chr17,41352294,10.2117145104889,838,539,1377,+
chr17,41352297,7.518789898995499,851,764,1615,+
chr17,41352300,8.710669469013158,900,1177,2077,+
chr17,41353714,1.8192922016911997,627,411,1038,+
chr17,41353720,2.215568862275449,739,500,1239,+
chr17,41353741,1.7683893195521103,837,644,1481,+
chr17,41353742,0.48479281486017567,999,551,1550,+
chr17,41353750,1.690514279898836,2241,1557,3798,+
chr17,41353785,1.51536312849162,867,715,1582,+
chr17,41353790,2.7845627747923785,899,800,1699,+
chr17,41361967,0.5152917505030181,590,425,1015,+
chr17,41362019,1.6710173740167689,715,502,1217,+
chr17,41362578,1.9085106382978723,965,704,1669,+
chr17,41363023,3.548774746549105,705,667,1372,+
chr17,41363064,0.6186991869918699,760,569,1329,+
chr17,41363288,2.566998892580288,1036,730,1766,+
chr17,41363325,0.4486748545572074,630,441,1071,+
chr17,41570055,3.409934739457638,761,411,1172,+
chr17,42148517,2.396462823617464,598,440,1038,+
chr17,42152813,1.8794193785610667,890,662,1552,+
chr17,42153505,2.4096145124716557,717,440,1157,+
chr17,42153506,2.4096145124716557,717,440,1157,+
chr17,42422689,1.2106272989616378,711,543,1254,+
chr17,42426535,2.118583351728233,989,674,1663,+
chr17,42426564,2.0669220945083016,577,521,1098,+
chr17,42426649,1.5382254464285716,744,559,1303,+
chr17,42426796,0.60205967784526,599,540,1139,+
chr17,42426844,1.801169590643275,615,607,1222,+
chr17,42426878,1.3310920548301175,952,732,1684,+
chr17,42427087,1.676702364113963,921,706,1627,+
chr17,42427597,1.9026650253803716,2056,1588,3644,+
chr17,42427910,0.5426930806775768,726,386,1112,+
chr17,42427929,0.6388888888888888,780,638,1418,+
chr17,42428141,2.1497147337213027,1807,1240,3047,+
chr17,42428509,1.6055226824457596,1143,675,1818,+
chr17,42428739,0.5124401913875598,1070,835,1905,+
chr17,42428774,1.5934784779786277,966,588,1554,+
chr17,42428818,1.6358596465512236,1796,1191,2987,+
chr17,42428975,1.7223300970873785,886,514,1400,+
chr17,42429020,2.416666666666667,811,447,1258,+
chr17,42429030,4.378359511343804,783,572,1355,+
chr17,42429054,1.5256048387096774,1080,619,1699,+
chr17,42429122,1.964876315429821,1306,812,2118,+
chr17,42429153,0.6347256347256347,1084,813,1897,+
chr17,42429398,1.6508245998862623,1015,745,1760,+
chr17,42429482,1.9623181492964463,725,598,1323,+
chr17,42429484,1.726654411764706,605,543,1148,+
chr17,42429508,1.6001787678767878,628,605,1233,+
chr17,42429606,0.6130030959752322,703,543,1246,+
chr17,42429750,1.983022071307301,656,557,1213,+
chr17,42429751,2.1136363636363638,836,557,1393,+
chr17,42429763,2.415661815661816,600,480,1080,+
chr17,42429877,0.5874560491259347,948,761,1709,+
chr17,42429879,1.1202949138656613,1781,1463,3244,+
chr17,42429924,3.25492012039824,851,616,1467,+
chr17,42430042,1.9458413926499032,1005,516,1521,+
chr17,42430088,2.560096153846154,638,479,1117,+
chr17,42430094,1.9608963485403086,645,486,1131,+
chr17,42430131,1.813063063063063,769,406,1175,+
chr17,42430252,0.6210236716914083,984,716,1700,+
chr17,42430312,1.5734818121063134,1613,1115,2728,+
chr17,42430343,1.5856983655274886,1835,1345,3180,+
chr17,42430345,1.5856983655274886,1835,1345,3180,+
chr17,42430350,1.5605843371512753,3174,2442,5616,+
chr17,42430352,1.6120168987638865,3007,2323,5330,+
chr17,42430354,1.624401913875598,2057,1616,3673,+
chr17,42430415,0.6971916746623368,1144,796,1940,+
chr17,42430421,3.762637362637362,855,839,1694,+
chr17,42826677,1.292570029572517,579,482,1061,+
chr17,42826682,1.81565498484554,990,739,1729,+
chr17,42826683,0.9502483227324215,573,498,1071,+
chr17,42826687,2.1690910635602876,664,457,1121,+
chr17,43138692,2.070046725313101,725,399,1124,+
chr17,43138749,2.9229960619812805,614,389,1003,+
chr17,43138776,3.245231625829239,861,533,1394,+
chr17,43171096,1.8473897537851225,1314,793,2107,+
chr17,43173565,3.2714258116508184,1053,731,1784,+
chr17,43173566,3.64507494646681,618,466,1084,+
chr17,43174557,1.2017078236787444,761,618,1379,+
chr17,43174559,1.6631547798950492,1216,892,2108,+
chr17,43182290,1.78173719376392,599,448,1047,+
chr17,43185345,6.115522739043534,621,403,1024,+
chr17,43227669,6.299716177040453,1115,894,2009,+
chr17,45006907,3.5184835878512772,681,492,1173,+
chr17,45012421,1.3058385869331006,573,442,1015,+
chr17,45689939,1.665666192891243,742,510,1252,+
chr17,45699382,0.3995161131284908,605,443,1048,+
chr17,45727599,0.4071754341852412,853,541,1394,+
chr17,45727631,1.540829882638939,630,482,1112,+
chr17,45734418,1.6653225806451613,766,495,1261,+
chr17,45734423,2.177578051698971,1250,884,2134,+
chr17,45735948,1.9084856747924555,1238,944,2182,+
chr17,45738487,1.7726668157283385,1053,795,1848,+
chr17,45745631,1.9670624281884337,641,372,1013,+
chr17,45745758,0.4542225169326955,684,490,1174,+
chr17,45747119,1.5556246194583916,1226,998,2224,+
chr17,45748098,0.2657535789769714,1020,776,1796,+
chr17,45748126,2.003939075630252,586,447,1033,+
chr17,45753795,3.9040606068596193,811,598,1409,+
chr17,45753807,0.4486093664349634,1486,1134,2620,+
chr17,45753808,0.44082915158070707,1836,1334,3170,+
chr17,45753838,1.0716768794742877,1069,788,1857,+
chr17,45757400,1.969056313665193,1365,945,2310,+
chr17,45757401,1.969056313665193,1365,945,2310,+
chr17,45757423,1.9796236251509949,1324,641,1965,+
chr17,45757494,1.4865866957470009,2303,1309,3612,+
chr17,45757880,2.173402436276394,3415,2038,5453,+
chr17,45757896,1.2611795718732135,3452,2248,5700,+
chr17,45757905,1.5371694742293363,10175,6352,16527,+
chr17,45757908,1.6270198966692315,4673,3307,7980,+
chr17,45757911,1.7419806247490632,9978,7606,17584,+
chr17,45757912,1.7419806247490632,9978,7606,17584,+
chr17,45757915,1.686955818036862,13432,9352,22784,+
chr17,45759970,1.1979372110777642,1049,749,1798,+
chr17,45760156,24.500172845194466,2037,928,2965,+
chr17,45760157,21.386372270939372,1808,832,2640,+
chr17,45760556,0.39924056585973416,867,575,1442,+
chr17,45760568,0.41690324246074045,785,510,1295,+
chr17,45760669,15.648765181490488,4881,2338,7219,+
chr17,45760670,19.204882134086393,6630,6496,13126,+
chr17,45760671,15.512399527821724,7166,7693,14859,+
chr17,45760672,12.993962133385471,5580,7221,12801,+
chr17,45760673,4.604478822281829,2096,3909,6005,+
chr17,45760675,0.3843652033016708,1759,3702,5461,+
chr17,45760677,0.3233939830982677,2584,4902,7486,+
chr17,45760678,0.3612889898781243,1324,2574,3898,+
chr17,45760805,0.9866310160427808,1106,945,2051,+
chr17,45760806,0.9866310160427808,1106,945,2051,+
chr17,45761146,2.1714358470356374,639,444,1083,+
chr17,45761298,2.4457135393098555,608,409,1017,+
chr17,45761899,10.432189552244749,923,164,1087,+
chr17,45761901,5.04390243902439,1033,163,1196,+
chr17,45761903,6.005865102639296,1023,154,1177,+
chr17,45761905,6.0511982570806095,1009,152,1161,+
chr17,45761907,16.739335345877198,1738,332,2070,+
chr17,45761908,17.736896074784184,1403,284,1687,+
chr17,45761911,31.89664461262374,2054,918,2972,+
chr17,45761912,29.072446830526744,2536,1218,3754,+
chr17,45761913,29.072446830526744,2536,1218,3754,+
chr17,45761914,27.52444866844482,1459,832,2291,+
chr17,45761927,7.364037302036969,678,562,1240,+
chr17,46053371,3.8531705042379767,626,459,1085,+
chr17,46054118,3.749342564138367,658,556,1214,+
chr17,46056237,1.3138091057318448,837,468,1305,+
chr17,46056238,1.3138091057318448,837,468,1305,+
chr17,46056239,1.0805312011483905,1068,671,1739,+
chr17,46058862,3.4952923135651863,701,402,1103,+
chr17,46128368,5.697567782268099,1419,898,2317,+
chr17,46128369,5.4273399630850845,1112,698,1810,+
chr17,46128384,11.447698744769877,623,716,1339,+
chr17,46128385,8.383266713785465,1584,1876,3460,+
chr17,46128386,8.383266713785465,1584,1876,3460,+
chr17,46135666,4.254904950068055,592,486,1078,+
chr17,46135970,3.9467592592592586,619,383,1002,+
chr17,46135972,3.9467592592592586,619,383,1002,+
chr17,46136469,5.426789933445711,593,434,1027,+
chr17,46138252,2.744135908268934,1195,936,2131,+
chr17,46138672,24.17830421289447,960,1048,2008,+
chr17,46138673,25.23368817374369,823,984,1807,+
chr17,46138674,25.23368817374369,823,984,1807,+
chr17,46138693,3.4484058374870536,929,1369,2298,+
chr17,46138694,3.4484058374870536,929,1369,2298,+
chr17,46929920,2.5003019717379535,632,444,1076,+
chr17,46930351,2.8209150326797388,912,494,1406,+
chr17,46930354,1.0945459720671578,1334,872,2206,+
chr17,46933459,1.778391356542617,2468,1518,3986,+
chr17,46933461,1.778391356542617,2468,1518,3986,+
chr17,46933464,1.6468052347959972,1336,865,2201,+
chr17,46933545,2.237348100818248,765,556,1321,+
chr17,46940227,2.5770142180094786,695,421,1116,+
chr17,46940234,1.6394796613669216,793,500,1293,+
chr17,46940272,1.9662921348314608,1224,622,1846,+
chr17,46940280,1.4735043880217058,1659,1011,2670,+
chr17,46940285,2.122443181818181,1686,1119,2805,+
chr17,46940293,2.1967255493321844,1960,1054,3014,+
chr17,46970164,1.4222065891052507,1180,825,2005,+
chr17,46970178,0.7693480318675132,1898,1120,3018,+
chr17,46970180,0.8795255377533857,1151,571,1722,+
chr17,46970774,3.0616768526269067,1558,1058,2616,+
chr17,46970776,1.5367403885903264,861,655,1516,+
chr17,46970797,1.4298561151079134,1079,833,1912,+
chr17,46971757,2.765548980933596,1433,844,2277,+
chr17,46971795,1.5615009746588695,865,683,1548,+
chr17,46971805,1.5783077125213507,960,773,1733,+
chr17,46972601,1.7550335570469804,1045,595,1640,+
chr17,46972602,1.576887961392983,929,696,1625,+
chr17,46972627,1.8173599556295064,1056,600,1656,+
chr17,46972640,2.2419154881288463,2015,1360,3375,+
chr17,46972658,2.161492281303602,812,582,1394,+
chr17,46972677,1.507568359375,974,767,1741,+
chr17,47004907,41.99953259387283,924,509,1433,+
chr17,47004908,28.620433453987477,1498,882,2380,+
chr17,47004910,11.285845912891677,887,576,1463,+
chr17,47006039,12.020304470515239,3392,2818,6210,+
chr17,47006040,12.020304470515239,3392,2818,6210,+
chr17,47006041,10.14768131336591,3020,2494,5514,+
chr17,47006056,0.3535248298159626,898,763,1661,+
chr17,47869256,3.483910083396212,592,494,1086,+
chr17,48814326,0.5706646683771516,785,587,1372,+
chr17,48814329,0.9284565916398712,769,621,1390,+
chr17,48814331,0.9284565916398712,769,621,1390,+
chr17,48814337,2.1934912925348766,763,656,1419,+
chr17,48814360,1.805629035235452,1024,836,1860,+
chr17,48814365,1.78809173612246,745,632,1377,+
chr17,48814379,2.1232876712328768,557,583,1140,+
chr17,48822072,0.4372083648593214,1284,950,2234,+
chr17,48822076,2.1443181818181816,628,439,1067,+
chr17,48823103,1.6449647887323944,1506,1135,2641,+
chr17,48823275,2.107713797920224,678,378,1056,+
chr17,48823302,1.5520892151326933,2931,1770,4701,+
chr17,48823304,1.5629550582950593,5390,3247,8637,+
chr17,48823305,1.4836438084953203,3024,1851,4875,+
chr17,48823327,1.9128421120578365,3774,2581,6355,+
chr17,48823329,1.9128421120578365,3774,2581,6355,+
chr17,48823932,2.5011662425784564,760,523,1283,+
chr17,48827959,1.6489597942963998,972,551,1523,+
chr17,48828028,1.6394698085419734,2540,1469,4009,+
chr17,48828030,1.4577231118146552,3414,1976,5390,+
chr17,48828031,0.9301181102362206,874,507,1381,+
chr17,48828404,3.8516743832247884,691,355,1046,+
chr17,48828405,3.13015873015873,815,419,1234,+
chr17,48828416,1.6318465669839353,862,610,1472,+
chr17,48828417,1.3679735370315111,1898,1320,3218,+
chr17,48828419,1.8058811638971026,1932,1277,3209,+
chr17,48828426,2.1482617586912065,572,488,1060,+
chr17,48828713,1.8484254026480198,800,587,1387,+
chr17,48829546,1.817154315923799,622,476,1098,+
chr17,48829553,2.345006347862886,714,555,1269,+
chr17,48829554,1.668103448275862,902,559,1461,+
chr17,48829558,1.8067815608799211,2578,2195,4773,+
chr17,48829560,1.8986519118038905,4370,3752,8122,+
chr17,48829561,1.9244528619528616,3539,3023,6562,+
chr17,48829566,1.9996930803571429,1936,1791,3727,+
chr17,48829769,2.598350803379909,999,633,1632,+
chr17,49230951,1.2080042595921576,718,485,1203,+
chr17,49230954,1.775603993203567,775,556,1331,+
chr17,49230969,0.5228690102147929,2591,1677,4268,+
chr17,49230997,1.4631647624077635,4399,2695,7094,+
chr17,49230998,1.47147322261616,3409,1863,5272,+
chr17,49231003,0.6293725479437021,1239,888,2127,+
chr17,49233021,1.532262989160857,1228,913,2141,+
chr17,49233053,1.4025205761316872,1434,1079,2513,+
chr17,49233082,0.7090387279562266,2269,1902,4171,+
chr17,49233085,1.5186340994240108,3987,3041,7028,+
chr17,49237409,1.3852725107836088,2834,1711,4545,+
chr17,49237431,1.6899448620178856,2302,1656,3958,+
chr17,49238533,1.9881656804733727,1199,974,2173,+
chr17,49238576,1.4851379598662209,2152,1494,3646,+
chr17,49238599,0.7116211876128186,2856,1927,4783,+
chr17,49238603,1.5066867772750123,1872,1274,3146,+
chr17,49238611,0.7192031894764036,3814,2394,6208,+
chr17,49239091,0.5809987819732034,5723,3283,9006,+
chr17,49239094,1.526724734839944,9635,6244,15879,+
chr17,49239097,1.8082295271049593,3522,2889,6411,+
chr17,49239168,1.6014893325414592,1844,1483,3327,+
chr17,49239308,1.421468714874485,3448,2354,5802,+
chr17,49243767,1.4434077741207192,803,378,1181,+
chr17,49243768,1.4575408618127788,1275,672,1947,+
chr17,49243769,1.3044844302798313,1917,1231,3148,+
chr17,49243770,1.2916797776979794,1692,1137,2829,+
chr17,49243771,1.3555923874512588,864,748,1612,+
chr17,49243796,1.9440573167141038,618,442,1060,+
chr17,49243799,1.3335754876304478,2116,1664,3780,+
chr17,49243800,1.6744258439402324,1466,1111,2577,+
chr17,49243806,0.4659011945336025,703,642,1345,+
chr17,49243815,1.4987388947447675,1624,915,2539,+
chr17,49243822,0.6698675062311427,981,846,1827,+
chr17,49243849,1.3983430332078057,2195,1269,3464,+
chr17,49244185,1.2689981725090598,1101,732,1833,+
chr17,49244186,1.0730849621750917,2890,2073,4963,+
chr17,49244188,1.124256736094594,2067,1548,3615,+
chr17,49244221,1.3929368883830318,9504,7480,16984,+
chr17,49244222,1.3929368883830318,9504,7480,16984,+
chr17,49244224,1.3050276698457552,3663,2234,5897,+
chr17,49244258,1.2447748515186168,6185,4225,10410,+
chr17,49244279,1.3070255474452557,2864,2191,5055,+
chr17,49245610,1.1512557504533414,7307,6355,13662,+
chr17,49245671,1.244277493014563,6403,4156,10559,+
chr17,49248871,1.3840546941328926,4501,3196,7697,+
chr17,49354527,1.801496896466621,1057,824,1881,+
chr17,49357772,1.8181157462257416,602,504,1106,+
chr17,49365436,0.9738125530110264,834,523,1357,+
chr17,49365437,0.9738125530110264,834,523,1357,+
chr17,49374356,0.9136788022761172,1066,786,1852,+
chr17,49374357,0.9136788022761172,1066,786,1852,+
chr17,51183648,0.5934461669998784,1359,944,2303,+
chr17,52990106,1.3230669358573828,940,770,1710,+
chr17,52990107,0.9248368522072935,633,520,1153,+
chr17,52992050,2.7740324517479156,1432,942,2374,+
chr17,52992053,2.3838438847711125,1525,1061,2586,+
chr17,52992056,2.179990269868071,2590,2104,4694,+
chr17,52992057,2.179990269868071,2590,2104,4694,+
chr17,52992058,2.07798800184587,3554,2954,6508,+
chr17,52992060,1.9332753055868133,2385,1957,4342,+
chr17,52993142,1.5058936030123764,625,422,1047,+
chr17,52993189,2.171680117388114,1319,956,2275,+
chr17,52993190,2.499536607970343,1797,1377,3174,+
chr17,52993191,1.8914520890943842,2987,2114,5101,+
chr17,52993192,2.181974760690272,1914,1588,3502,+
chr17,52993193,0.8898639920978649,1190,737,1927,+
chr17,52993194,2.1331250203430656,1023,930,1953,+
chr17,52993197,2.067242325862032,2143,1594,3737,+
chr17,52993200,2.046929364684321,1440,1245,2685,+
chr17,57679889,1.989777270662332,634,502,1136,+
chr17,57685570,0.8801980198019802,634,504,1138,+
chr17,57685572,0.7782544102350394,771,607,1378,+
chr17,57721767,0.29804441939297144,685,560,1245,+
chr17,57721770,1.7888198757763976,647,377,1024,+
chr17,57724933,1.7301392301392302,675,406,1081,+
chr17,57742185,2.13878070105715,867,546,1413,+
chr17,57743910,0.4671597431888326,1043,699,1742,+
chr17,57746240,2.518375680580762,652,463,1115,+
chr17,57751014,1.9782214156079851,653,521,1174,+
chr17,57752084,2.1138080347223527,873,657,1530,+
chr17,57754400,1.8662913441238564,662,405,1067,+
chr17,57754438,2.096304591265397,647,422,1069,+
chr17,57756870,0.9245090073202236,860,592,1452,+
chr17,57758661,2.148460271195032,826,606,1432,+
chr17,57758663,2.1152780020557813,1322,1016,2338,+
chr17,57759728,2.252453166815344,706,412,1118,+
chr17,57760363,1.0489070705616337,2996,2011,5007,+
chr17,57760367,1.893917486022749,1354,987,2341,+
chr17,57761235,2.5898089171974523,855,627,1482,+
chr17,57761237,2.5898089171974523,855,627,1482,+
chr17,57762567,2.3365079365079366,643,440,1083,+
chr17,57762974,0.4679747406405052,1244,738,1982,+
chr17,57762976,0.4679747406405052,1244,738,1982,+
chr17,57762993,2.533895170832537,1544,991,2535,+
chr17,57762994,2.880273321449792,830,593,1423,+
chr17,57763069,1.6341200151696371,777,580,1357,+
chr17,57771306,0.5566860465116279,765,511,1276,+
chr17,57771318,1.8620996441281135,804,561,1365,+
chr17,57771703,2.356538822926454,835,508,1343,+
chr17,57771903,0.6123787402650636,746,562,1308,+
chr17,57772010,1.5819963614780421,1342,959,2301,+
chr17,57785073,2.7633843301366494,636,385,1021,+
chr17,57808802,2.25432385632966,1335,866,2201,+
chr17,57812738,3.348267620655326,583,516,1099,+
chr17,57814867,2.448837209302326,647,429,1076,+
chr17,57842378,0.9763734471785563,1410,959,2369,+
chr17,57842382,1.9184899184899187,687,443,1130,+
chr17,57842383,1.9076165225234532,1431,1145,2576,+
chr17,57851123,2.077397910731244,624,467,1091,+
chr17,57851146,2.1214086822352387,928,939,1867,+
chr17,57851147,1.953150242326333,623,618,1241,+
chr17,57915291,0.8779880081250789,2739,1712,4451,+
chr17,57915292,0.9715198649045764,2203,1345,3548,+
chr17,57915293,0.9715198649045764,2203,1345,3548,+
chr17,57915353,1.7386371746463072,745,571,1316,+
chr17,57915521,1.4835365739757522,824,570,1394,+
chr17,57915546,2.252,562,449,1011,+
chr17,57915547,2.252,562,449,1011,+
chr17,57915584,1.8300653594771243,874,611,1485,+
chr17,57915732,2.012718600953895,632,443,1075,+
chr17,57915741,1.842914541250507,1970,1454,3424,+
chr17,57917130,0.7134694061559615,1543,1068,2611,+
chr17,57917155,2.013655462184874,780,475,1255,+
chr17,57917214,3.8707256046705587,662,653,1315,+
chr17,57917321,1.2571889578137492,1438,1118,2556,+
chr17,57917387,1.4530712319339298,2034,1452,3486,+
chr17,57917525,0.5779067332715145,1655,992,2647,+
chr17,57917553,0.5526451901773239,1626,1166,2792,+
chr17,57917562,1.3917443408788284,2612,1501,4113,+
chr17,57917578,0.7766019790745158,2701,1750,4451,+
chr17,57917625,1.2894217827704813,4523,2944,7467,+
chr17,57917642,1.7526947167382108,11844,8297,20141,+
chr17,57917644,1.7526947167382108,11844,8297,20141,+
chr17,57917647,1.9580496049080487,6452,4878,11330,+
chr17,57918693,0.9515753856484758,1094,606,1700,+
chr17,57918747,2.4993297587131367,677,372,1049,+
chr17,57918830,2.288484848484848,825,549,1374,+
chr17,57918853,0.4217642425833552,1070,585,1655,+
chr17,57918890,1.553670350844328,1967,868,2835,+
chr17,57918925,1.4418721335894322,2113,1314,3427,+
chr17,57918949,0.7184873949579832,2089,1189,3278,+
chr17,57918977,1.7836011583669298,3420,1600,5020,+
chr17,57918978,1.7836011583669298,3420,1600,5020,+
chr17,57918979,1.876688750241204,4645,2220,6865,+
chr17,57918981,1.9609599540141793,3665,1841,5506,+
chr17,57918982,1.8917557294945841,5730,3251,8981,+
chr17,57918991,1.4568058968058968,1646,924,2570,+
chr17,57918994,1.4366931489603483,5897,3785,9682,+
chr17,57918995,1.388682129956067,10825,6761,17586,+
chr17,57919077,2.9268313782483824,860,492,1352,+
chr17,57919081,1.5805038672219596,1770,1233,3003,+
chr17,60525075,2.5011551155115512,658,403,1061,+
chr17,60525077,2.863241387258812,882,629,1511,+
chr17,61502307,2.2993197278911564,623,503,1126,+
chr17,61502308,2.291984121870068,832,646,1478,+
chr17,61502309,2.2993197278911564,623,503,1126,+
chr17,61502311,1.0691882412259168,806,465,1271,+
chr17,61502313,1.6223102412255983,820,536,1356,+
chr17,61864600,1.975453222178113,817,686,1503,+
chr17,61864601,1.8768267223382047,557,478,1035,+
chr17,61893027,1.7418357591794316,696,386,1082,+
chr17,61894234,0.34663373422437316,951,578,1529,+
chr17,61894236,0.307622811970638,680,384,1064,+
chr17,61894255,3.063110498666671,881,682,1563,+
chr17,61904847,2.695146649653452,622,456,1078,+
chr17,61904867,1.097360184328753,790,618,1408,+
chr17,61905513,2.2453195083313764,1030,874,1904,+
chr17,61907288,1.7477064220183485,761,435,1196,+
chr17,61907291,1.6985138004246283,799,470,1269,+
chr17,61907679,1.7551999999999999,1096,624,1720,+
chr17,61907693,1.5515807087070803,2613,1801,4414,+
chr17,61907729,1.8570860724659841,2335,2109,4444,+
chr17,61907730,1.8570860724659841,2335,2109,4444,+
chr17,61907734,3.406339071941626,1298,1252,2550,+
chr17,61907799,1.9213075060532687,620,412,1032,+
chr17,61908412,4.983839515518928,1997,1429,3426,+
chr17,61908455,1.9421106557377046,668,487,1155,+
chr17,61908463,2.5155960209070987,745,658,1403,+
chr17,61908464,2.5155960209070987,745,658,1403,+
chr17,61908512,2.159847036328872,705,522,1227,+
chr17,61908514,2.159847036328872,705,522,1227,+
chr17,61908574,2.2735457063711912,1406,911,2317,+
chr17,61908575,2.2735457063711912,1406,911,2317,+
chr17,61908710,2.102670057215512,881,571,1452,+
chr17,61908928,2.5700610432852384,740,423,1163,+
chr17,61908932,1.760356319160675,1238,833,2071,+
chr17,61909106,2.625801792617136,1993,1120,3113,+
chr17,61909107,2.625801792617136,1993,1120,3113,+
chr17,61909108,2.625801792617136,1993,1120,3113,+
chr17,61909118,1.9332726585119298,1192,792,1984,+
chr17,62223440,0.8494702462038636,1500,967,2467,+
chr17,65688842,3.1773618538324424,712,527,1239,+
chr17,65688843,3.1773618538324424,712,527,1239,+
chr17,65714051,0.27209048831103805,600,494,1094,+
chr17,65717605,0.5514784620596002,1027,704,1731,+
chr17,65718744,3.4390345401581355,1032,533,1565,+
chr17,65720187,1.6164095922131954,3361,1787,5148,+
chr17,65720189,1.6164095922131954,3361,1787,5148,+
chr17,65720192,1.716254218222722,1435,888,2323,+
chr17,65720197,1.4110058309037898,2150,1224,3374,+
chr17,65720210,1.507014997581035,1957,1377,3334,+
chr17,65720215,1.422585935782764,3235,1987,5222,+
chr17,65720228,1.697322687551081,2929,2161,5090,+
chr17,65722649,1.5261038308940946,677,435,1112,+
chr17,65733754,3.5712829176877143,612,489,1101,+
chr17,65734033,1.694688221709007,1222,865,2087,+
chr17,65734084,1.6717757539653186,2796,2274,5070,+
chr17,65734237,2.6680725053840635,1165,795,1960,+
chr17,65734256,0.43459572389725026,3233,2299,5532,+
chr17,65734257,0.7155230850342698,2849,2413,5262,+
chr17,65734263,0.9753313590687797,4858,3830,8688,+
chr17,65734271,1.3992664706049762,3239,2352,5591,+
chr17,66031858,3.9340466866448627,583,491,1074,+
chr17,66031889,3.127450980392157,637,611,1248,+
chr17,66031891,3.127450980392157,637,611,1248,+
chr17,66031935,2.298368298368298,637,428,1065,+
chr17,66031946,2.7374557260920898,686,483,1169,+
chr17,66033235,3.4522520664625644,1188,957,2145,+
chr17,66033248,1.90595703125,672,511,1183,+
chr17,66033269,1.500893388921977,1154,802,1956,+
chr17,66033310,2.011671645093484,886,785,1671,+
chr17,66033552,1.7823691460055098,646,362,1008,+
chr17,66033595,1.652127086698977,766,618,1384,+
chr17,66038312,2.8915113452188,864,616,1480,+
chr17,66038318,2.000259184863604,881,670,1551,+
chr17,66038437,1.7297478991596642,995,594,1589,+
chr17,66039052,1.5904150620453574,1211,778,1989,+
chr17,66039235,1.7800393462469737,940,825,1765,+
chr17,66039256,0.549388111888112,1256,1143,2399,+
chr17,66039315,1.50523178807947,1336,905,2241,+
chr17,66039316,0.6217296302685298,864,681,1545,+
chr17,66039454,1.9481395797185272,859,740,1599,+
chr17,66039464,1.652270210409745,745,587,1332,+
chr17,66040070,1.4422088473012566,979,822,1801,+
chr17,66040102,2.321651414309484,949,600,1549,+
chr17,66040151,1.8983870967741936,962,743,1705,+
chr17,66040155,1.6290944674440369,2516,1796,4312,+
chr17,66040537,2.867456896551724,886,695,1581,+
chr17,66042701,0.629115410137308,2464,1858,4322,+
chr17,66042703,0.629115410137308,2464,1858,4322,+
chr17,66246596,1.2993574702405197,836,609,1445,+
chr17,66250550,1.880427942101951,995,453,1448,+
chr17,66250598,0.624087591240876,1025,547,1572,+
chr17,66250613,1.4741379310344829,1367,695,2062,+
chr17,66250633,1.6322747109450328,3618,1997,5615,+
chr17,66250664,1.354178987540122,2911,1814,4725,+
chr17,66250671,1.688978601954979,5367,3413,8780,+
chr17,66250684,1.653233460331588,4758,2701,7459,+
chr17,66252007,1.2597163015965793,731,582,1313,+
chr17,66253083,3.1805417594133423,658,527,1185,+
chr17,66511642,1.685216658042034,718,467,1185,+
chr17,66521939,7.674437966752323,792,693,1485,+
chr17,66526115,1.6944303797468352,872,473,1345,+
chr17,66526116,1.6944303797468352,872,473,1345,+
chr17,66526117,1.6944303797468352,872,473,1345,+
chr17,66528404,0.5750267316145894,604,442,1046,+
chr17,67513713,1.511457131055715,923,692,1615,+
chr17,67515500,3.7058823529411766,629,424,1053,+
chr17,67516426,1.8365907572056466,961,708,1669,+
chr17,67522805,2.120565139399976,931,607,1538,+
chr17,67532273,1.7017699115044245,640,564,1204,+
chr17,67537907,1.8371559633027523,711,435,1146,+
chr17,72199816,1.020334276569404,23440,10997,34437,+
chr17,72199817,1.020334276569404,23440,10997,34437,+
chr17,72199818,1.0381816310403225,12918,6194,19112,+
chr17,72199820,1.3232836523159104,5341,3254,8595,+
chr17,72199821,1.8686967902926257,11017,5289,16306,+
chr17,72199825,1.304084505276762,28071,13156,41227,+
chr17,72199826,1.186112174327945,21803,8607,30410,+
chr17,72199827,1.3157025846019312,41051,19648,60699,+
chr17,72199828,1.2036765550999833,30829,14668,45497,+
chr17,72199878,1.513286948715071,5862,3751,9613,+
chr17,72200055,0.348527715007935,717,409,1126,+
chr17,72200071,1.205161071246222,21576,13260,34836,+
chr17,72200273,1.0310036717388142,44401,28484,72885,+
chr17,72200275,1.1077224773852772,53562,33563,87125,+
chr17,72200283,1.03268139797043,33019,22372,55391,+
chr17,72200284,1.2599416210897552,39444,26692,66136,+
chr17,72200286,1.437705191642454,27091,18525,45616,+
chr17,73227950,1.0846987759858344,697,473,1170,+
chr17,73227954,0.32980683621903156,700,434,1134,+
chr17,73230852,0.44294404239449203,614,482,1096,+
chr17,73259457,3.009545199326221,669,410,1079,+
chr17,73259527,1.926488060603661,1216,849,2065,+
chr17,73667916,2.26851400896912,603,540,1143,+
chr17,74266683,12.59754271857045,817,1001,1818,+
chr17,74266684,12.59754271857045,817,1001,1818,+
chr17,74266692,0.2700915581979269,394,643,1037,+
chr17,74553889,2.7328158817432535,831,588,1419,+
chr17,74554876,0.9228358478815516,967,1000,1967,+
chr17,74557462,1.8187711820888772,2259,1351,3610,+
chr17,74557463,1.8491515203721245,1601,892,2493,+
chr17,74559250,0.5026921194322076,631,453,1084,+
chr17,74559265,1.0112223016440316,2020,1398,3418,+
chr17,74559266,1.664938705862363,3345,2290,5635,+
chr17,74559268,2.672788353863381,1325,892,2217,+
chr17,74559562,2.039565826330532,698,407,1105,+
chr17,74560723,2.5138196048137913,601,474,1075,+
chr17,74729261,2.3411313642361913,754,558,1312,+
chr17,75483532,3.3110414860457467,1369,946,2315,+
chr17,75483556,2.133765200590976,750,418,1168,+
chr17,75496476,14.038891782796371,1103,281,1384,+
chr17,75496480,36.69083765370446,1340,1105,2445,+
chr17,75496481,34.75324218625942,1952,2049,4001,+
chr17,75496482,34.00277981622636,1796,2000,3796,+
chr17,75496487,0.29361139620151583,432,902,1334,+
chr17,75496489,0.31593026324244,987,1586,2573,+
chr17,75496491,0.4139817629179331,453,657,1110,+
chr17,75496499,0.35777206755756275,1142,1870,3012,+
chr17,75496500,0.37928165658464374,1262,1915,3177,+
chr17,75496501,0.39019363382366473,2084,3064,5148,+
chr17,75496536,0.5443297280608321,1208,1098,2306,+
chr17,76210354,3.7222008229908394,755,397,1152,+
chr17,76210439,2.1428246862680496,745,420,1165,+
chr17,76212754,0.5321558270056124,596,465,1061,+
chr17,76212755,1.9507389162561573,835,531,1366,+
chr17,76212790,1.5260131591350794,2782,2004,4786,+
chr17,76212791,0.9860751035680876,1418,1068,2486,+
chr17,76219688,1.6607669616519174,562,451,1013,+
chr17,76219886,0.3864142538975501,693,448,1141,+
chr17,76220154,0.5013535376697495,907,710,1617,+
chr17,76220187,2.5823252688172045,529,495,1024,+
chr17,76220473,1.4857482674665459,843,588,1431,+
chr17,76220612,3.0456228962048404,967,573,1540,+
chr17,76220653,1.6591444514703722,967,626,1593,+
chr17,76394369,1.169496234538766,1369,853,2222,+
chr17,76394383,1.994243110607777,1242,882,2124,+
chr17,76394385,1.8008885629988287,2021,1395,3416,+
chr17,76394391,1.8087569101083216,1661,1254,2915,+
chr17,76394392,2.100881245036701,1038,699,1737,+
chr17,77030585,2.6721737078121315,611,445,1056,+
chr17,77030586,2.773360231670357,827,573,1400,+
chr17,77040174,2.244440669204967,566,508,1074,+
chr17,77044519,2.2063903281519863,583,578,1161,+
chr17,77044521,3.3215496551666095,809,728,1537,+
chr17,77044541,1.6301482088329486,683,462,1145,+
chr17,77044608,2.6394833266606437,672,602,1274,+
chr17,77044687,33.2029273055111,1560,681,2241,+
chr17,77044688,28.572474820967212,2351,1087,3438,+
chr17,77044689,28.572474820967212,2351,1087,3438,+
chr17,77044690,24.15691233523819,1371,653,2024,+
chr17,77045129,2.0607816647947885,931,708,1639,+
chr17,77045676,0.9349395135890033,588,423,1011,+
chr17,77045738,0.7969002756535272,1003,665,1668,+
chr17,78081358,1.0874030187224617,764,409,1173,+
chr17,78092076,3.581960079014802,628,456,1084,+
chr17,78092598,2.3555600901476916,594,441,1035,+
chr17,78093428,4.3544717936709505,882,578,1460,+
chr17,78867640,1.5266302471936755,866,640,1506,+
chr17,78897447,3.127295871976723,592,422,1014,+
chr17,78897449,2.0645848237345126,984,698,1682,+
chr17,78899200,1.9991422291320438,1355,810,2165,+
chr17,78899201,1.9991422291320438,1355,810,2165,+
chr17,78899205,1.84864300096691,1277,836,2113,+
chr17,78899224,1.0456157147389689,2608,1678,4286,+
chr17,78899225,0.9256193863885849,3462,2252,5714,+
chr17,78899233,1.6175213675213675,1513,1052,2565,+
chr17,78914358,1.5654219675756693,610,459,1069,+
chr17,78936283,1.2785165796171372,2074,1308,3382,+
chr17,78936284,1.2785165796171372,2074,1308,3382,+
chr17,79214821,2.729357798165138,594,435,1029,+
chr17,79214823,2.040677712663747,822,613,1435,+
chr17,79214825,1.4259318903111746,761,580,1341,+
chr17,79214827,0.9261059795819153,634,483,1117,+
chr17,79214870,2.6110315252040603,603,437,1040,+
chr17,79214907,1.1346479159952245,717,485,1202,+
chr17,79214960,1.6613159434829865,640,442,1082,+
chr17,79653369,2.8474510564062805,564,468,1032,+
chr17,79653370,2.8474510564062805,564,468,1032,+
chr17,79655767,1.530374331550802,697,424,1121,+
chr17,79655773,1.5827392120075048,665,532,1197,+
chr17,79670408,2.992679264596128,709,425,1134,+
chr17,79670477,1.1655223757134583,1408,784,2192,+
chr17,79670478,1.0454584780074325,1726,977,2703,+
chr17,79670479,1.1655223757134583,1408,784,2192,+
chr17,79670566,2.2758620689655173,863,463,1326,+
chr17,79670568,2.2758620689655173,863,463,1326,+
chr17,79671429,2.557787174066244,1036,945,1981,+
chr17,79671431,2.557787174066244,1036,945,1981,+
chr17,79673945,1.2989858880729208,1286,1049,2335,+
chr17,79673946,1.5416666666666663,1257,655,1912,+
chr17,79673948,1.3539243603060735,1380,1105,2485,+
chr17,79673963,1.5316326530612243,947,734,1681,+
chr17,79673973,2.368055555555556,681,521,1202,+
chr17,79674037,2.0083538756505064,1675,1216,2891,+
chr17,79674038,2.0083538756505064,1675,1216,2891,+
chr17,79674156,1.4426029962546818,1490,1067,2557,+
chr17,79674225,2.365918218327857,528,497,1025,+
chr17,79674447,57.75760606134716,2387,795,3182,+
chr17,79674448,57.75760606134716,2387,795,3182,+
chr17,79851433,2.0991682748486804,786,576,1362,+
chr17,79857919,2.1749875184980167,1033,660,1693,+
chr17,79858023,2.0101010101010104,596,461,1057,+
chr17,79858031,1.3973632202396553,1745,1384,3129,+
chr17,79858039,0.5073593073593075,878,538,1416,+
chr17,79858043,0.5526138442283623,860,662,1522,+
chr17,80011188,3.3701183207770735,681,452,1133,+
chr17,80011798,2.668172284055021,705,407,1112,+
chr17,80011900,1.89855265584946,663,519,1182,+
chr17,80012471,2.1581659615561026,944,593,1537,+
chr17,80012783,1.1422774198395818,1267,811,2078,+
chr17,80012790,1.7461807884343095,807,496,1303,+
chr17,80013638,2.1039475689681453,811,485,1296,+
chr17,80013639,2.0697481229443935,1032,645,1677,+
chr17,80014555,1.3440689175349942,757,593,1350,+
chr17,80014595,1.0068998142830978,1380,1024,2404,+
chr17,80014596,0.5045234588680834,871,678,1549,+
chr17,80014719,0.8632263478078457,822,680,1502,+
chr17,80014720,1.219616462602783,1152,938,2090,+
chr17,80014760,2.120779220779221,638,384,1022,+
chr17,80014799,1.9665683382497543,624,564,1188,+
chr17,80014835,1.5951820573169042,822,698,1520,+
chr17,80014937,2.366919191919192,720,593,1313,+
chr17,80015215,4.848216917182435,657,376,1033,+
chr17,80015216,4.848216917182435,657,376,1033,+
chr17,80186927,0.4985328581883561,1723,1309,3032,+
chr17,80186959,5.569478155339806,632,411,1043,+
chr17,80193865,1.6313064229815812,1352,1023,2375,+
chr17,80193867,1.6624305555555556,646,599,1245,+
chr17,80193924,1.7221924177396282,1750,931,2681,+
chr17,80193957,1.5179941002949853,1991,1129,3120,+
chr17,80193960,1.5833734060813127,3042,1992,5034,+
chr17,80193966,1.6197394094168882,3270,2307,5577,+
chr17,80193967,1.5676342919153556,1132,969,2101,+
chr17,80193972,1.4841934381408066,1197,1063,2260,+
chr17,80193983,1.7026992679677668,7392,6022,13414,+
chr17,80194017,1.7740176770102796,1697,1486,3183,+
chr17,80194022,1.6589948776054575,1756,1568,3324,+
chr17,80194074,0.7173245015023219,2681,2091,4772,+
chr17,80194718,2.109563602599814,1407,1076,2483,+
chr17,80195030,1.419342903033208,2463,1628,4091,+
chr17,80195055,1.790235499254217,1396,1160,2556,+
chr17,80195064,1.447938727938728,1375,1154,2529,+
chr17,80195187,1.685810810810811,1496,813,2309,+
chr17,80195304,2.4977994447829914,1084,546,1630,+
chr17,80195325,2.3043731778425656,607,489,1096,+
chr17,80195333,2.139015728056824,1239,656,1895,+
chr17,80195334,0.5684594594594594,1106,924,2030,+
chr17,80195370,1.6048475945648182,1310,777,2087,+
chr17,80195373,1.5792993589921382,2109,1378,3487,+
chr17,80195400,0.6404736871230148,1285,1062,2347,+
chr17,80195426,1.7293148087371917,1008,830,1838,+
chr17,80195472,1.6289038579301898,1424,1064,2488,+
chr17,80195522,1.620279547525778,4459,2816,7275,+
chr17,80195523,1.620279547525778,4459,2816,7275,+
chr17,80195622,1.701870187018702,1104,908,2012,+
chr17,80195625,1.2508487654320988,1246,971,2217,+
chr17,80195628,1.5347355003186745,1289,1045,2334,+
chr17,80195637,1.3201948627103632,1354,1128,2482,+
chr17,80195661,1.403872053872054,1344,1079,2423,+
chr17,80195696,1.7615384615384615,1144,870,2014,+
chr17,80195705,1.4445545956663364,1223,920,2143,+
chr17,80196601,1.4448857153457106,2721,1625,4346,+
chr17,80196606,1.5738761347089256,2031,1112,3143,+
chr17,80196607,1.6752577319587627,1169,872,2041,+
chr17,80196613,1.656454918032787,1267,975,2242,+
chr17,80196616,1.3804078368652537,2054,1524,3578,+
chr17,80196742,1.4514103887168903,4821,2906,7727,+
chr17,80196744,1.4514103887168903,4821,2906,7727,+
chr17,80196769,2.3928193366266757,1084,871,1955,+
chr17,80196781,3.3207169411242496,4193,3240,7433,+
chr17,80196784,1.5954290737281616,2177,1436,3613,+
chr17,80196808,0.7322843822843823,2059,1429,3488,+
chr17,80196809,1.002138984130136,2247,2064,4311,+
chr17,80196839,0.5880962431405657,1160,1029,2189,+
chr17,80196881,2.7867416714695348,6600,4414,11014,+
chr17,80196884,1.8753977028600084,6761,4717,11478,+
chr17,80196890,1.5791728525980913,1261,1024,2285,+
chr17,80196914,0.7809945512911859,3172,2230,5402,+
chr17,80197005,2.6796071893983324,3545,1230,4775,+
chr17,80197018,13.196997095731271,3762,2078,5840,+
chr17,80197019,17.364845011048708,15070,9531,24601,+
chr17,80197020,18.12742815885597,18392,11619,30011,+
chr17,80197021,19.08945656552495,17156,11112,28268,+
chr17,80197029,0.5850762314308053,1841,1278,3119,+
chr17,80197035,0.48792674707755235,1234,1365,2599,+
chr17,80197046,0.7079494159161711,5387,5049,10436,+
chr17,80197101,1.473332210347689,2745,1586,4331,+
chr17,80197186,6.912366912366912,3375,329,3704,+
chr17,80197187,12.29917808219178,7481,437,7918,+
chr17,80197188,10.500488694483916,16548,1274,17822,+
chr17,80197189,63.889103826251336,19058,2865,21923,+
chr17,80197191,42.46315167700937,19164,6892,26056,+
chr17,80197192,40.232307270620765,13649,6504,20153,+
chr17,80197257,1.432930571132319,1025,1098,2123,+
chr17,80321250,5.519958745070451,1175,1132,2307,+
chr17,80321251,4.519063554204307,988,985,1973,+
chr17,80321380,2.2127777218303475,922,644,1566,+
chr17,80321405,5.156105684380896,580,481,1061,+
chr17,80416586,0.6690097908074737,1046,403,1449,+
chr17,80438969,6.779926923478443,616,414,1030,+
chr17,80561610,2.514705882352941,1052,611,1663,+
chr17,80561612,2.514705882352941,1052,611,1663,+
chr17,80678153,6.431160442716604,496,556,1052,+
chr17,81037833,0.42136710511487124,617,424,1041,+
chr17,81042828,1.578994801419332,1006,787,1793,+
chr17,81042855,0.6133952924537832,827,520,1347,+
chr17,81042907,0.4658430232558139,640,515,1155,+
chr17,81043082,2.936332987551868,646,481,1127,+
chr17,81043115,0.5968516244278218,890,688,1578,+
chr17,81043121,2.125075895567699,699,548,1247,+
chr17,81043148,1.5960937165374567,1095,630,1725,+
chr17,81050931,1.71914548952111,1131,580,1711,+
chr17,81050965,2.112104949314252,643,558,1201,+
chr17,81052018,1.9184652278177459,639,555,1194,+
chr17,81052022,1.8794297653662155,1897,1292,3189,+
chr17,81052045,2.794599018003273,682,610,1292,+
chr17,81052060,0.45187721658309904,738,628,1366,+
chr17,81052180,1.8316645310682613,827,786,1613,+
chr17,81052204,2.024149731558262,945,801,1746,+
chr17,81052206,0.45115922857341784,863,541,1404,+
chr17,81052318,1.5908109447453187,976,656,1632,+
chr17,81052351,1.5747958533619044,823,556,1379,+
chr17,81052439,1.630703066566941,645,381,1026,+
chr17,81052473,0.4685095468794528,547,483,1030,+
chr17,81052478,0.5811518324607329,628,572,1200,+
chr17,81052479,0.6183033082214214,1387,1074,2461,+
chr17,81052480,0.3335057494131221,761,612,1373,+
chr17,81052602,2.01913357400722,986,830,1816,+
chr17,81052603,2.01913357400722,986,830,1816,+
chr17,81052604,0.46367287331142754,634,497,1131,+
chr18,659640,2.3315035104749016,779,564,1343,+
chr18,659660,2.0836524300441828,523,484,1007,+
chr18,662151,0.4348964829134447,633,421,1054,+
chr18,662246,1.9031250000000002,608,479,1087,+
chr18,662264,0.5676216882316697,669,540,1209,+
chr18,669078,3.103006582458637,645,510,1155,+
chr18,669095,1.762168823166975,714,540,1254,+
chr18,669122,0.5492753623188406,1136,689,1825,+
chr18,669127,2.075641905992918,1879,1302,3181,+
chr18,669142,1.7441077441077442,2108,1538,3646,+
chr18,669168,1.5951848895982979,1965,1073,3038,+
chr18,670695,1.3427457699721568,2117,1014,3131,+
chr18,670699,1.8453674691627335,2416,1326,3742,+
chr18,670720,1.4823207730916172,6331,3813,10144,+
chr18,670721,1.4823207730916172,6331,3813,10144,+
chr18,670726,1.6498188154652464,12739,8507,21246,+
chr18,670727,1.6828024113213853,11367,7528,18895,+
chr18,670728,1.495192509716093,21054,14388,35442,+
chr18,670730,1.599840897616767,12520,8904,21424,+
chr18,670732,1.465919521210278,19371,14082,33453,+
chr18,670733,1.4655837334071433,12781,9291,22072,+
chr18,670735,1.1534735968285226,17217,10368,27585,+
chr18,670736,1.2226608800764616,15373,9151,24524,+
chr18,670739,1.469954955252737,20068,14304,34372,+
chr18,671390,1.88660048885282,1204,848,2052,+
chr18,672892,2.01960323981688,1394,1216,2610,+
chr18,672893,2.01960323981688,1394,1216,2610,+
chr18,673310,2.0276162790697674,774,515,1289,+
chr18,673397,6.190878791653078,1576,1130,2706,+
chr18,2587895,2.3576011049268386,884,678,1562,+
chr18,2587911,2.561162079510704,669,435,1104,+
chr18,2587912,2.561162079510704,669,435,1104,+
chr18,2587916,2.1012435384386,707,511,1218,+
chr18,2587919,2.2922625583735448,764,577,1341,+
chr18,2589203,0.3351694034504261,644,565,1209,+
chr18,3247821,1.9370557116878826,918,525,1443,+
chr18,3247823,1.9370557116878826,918,525,1443,+
chr18,3247854,1.857013574660633,607,519,1126,+
chr18,3253233,2.2388102388102387,823,665,1488,+
chr18,3253256,0.6689399257847758,919,766,1685,+
chr18,3253257,1.423280423280423,1075,825,1900,+
chr18,3253263,2.0470997679814387,1037,861,1898,+
chr18,3253275,1.920749279538905,1289,1040,2329,+
chr18,3253276,1.72938689217759,1226,989,2215,+
chr18,3253911,1.6477113906359189,1450,1079,2529,+
chr18,3253944,0.5160696587852187,1484,1008,2492,+
chr18,3253978,1.5951916829109811,1472,1052,2524,+
chr18,3254006,2.2613776909426586,1327,1186,2513,+
chr18,3254009,1.5517243508339873,4281,3932,8213,+
chr18,3254010,1.60686311077956,2871,2680,5551,+
chr18,3255821,2.13347329322944,1200,798,1998,+
chr18,3255826,1.3269339096627095,3429,2496,5925,+
chr18,3255828,1.717789677227428,2178,1659,3837,+
chr18,3256113,1.0609579106849296,3091,2376,5467,+
chr18,3256119,1.97340930674264,1038,896,1934,+
chr18,3262135,1.5801133741030156,1020,796,1816,+
chr18,3262136,1.115017274874174,1744,1083,2827,+
chr18,3262137,1.115017274874174,1744,1083,2827,+
chr18,3262188,1.801360544217687,992,503,1495,+
chr18,3272906,0.6984159202087229,2854,2020,4874,+
chr18,3272914,2.5289017341040463,874,691,1565,+
chr18,3272929,1.454222509284676,1895,1125,3020,+
chr18,3272998,1.682515376894768,1894,1273,3167,+
chr18,3272999,1.682515376894768,1894,1273,3167,+
chr18,3273010,0.7379802609879653,1710,1218,2928,+
chr18,3273014,1.8932497773144683,2981,2154,5135,+
chr18,3273018,1.6014381884944922,1162,859,2021,+
chr18,3273023,1.7581771407570743,1195,906,2101,+
chr18,3277254,1.4778245821147808,1079,792,1871,+
chr18,3277347,1.418621559780168,2456,1851,4307,+
chr18,3277370,1.7754622134617761,3083,2608,5691,+
chr18,3277373,1.623503247452827,3733,3331,7064,+
chr18,3277374,1.623503247452827,3733,3331,7064,+
chr18,3277375,1.5300422953906736,6231,4935,11166,+
chr18,3277775,1.3615735928153916,2188,1413,3601,+
chr18,3277845,1.7212449255751014,1006,738,1744,+
chr18,3277982,1.513553104733274,4866,3579,8445,+
chr18,3278077,1.2514912425036064,8542,6244,14786,+
chr18,3278099,1.84838685842328,6586,6240,12826,+
chr18,8638603,1.126271186440678,885,589,1474,+
chr18,8638604,1.126271186440678,885,589,1474,+
chr18,9102728,0.4541987366410991,895,715,1610,+
chr18,9119541,2.607638888888889,750,463,1213,+
chr18,9122520,2.018833849329205,625,455,1080,+
chr18,9122575,1.7355378534020909,1465,1158,2623,+
chr18,9124871,0.5578914983078658,815,596,1411,+
chr18,9124943,3.0523059617547807,803,507,1310,+
chr18,9533772,1.692581794622611,626,440,1066,+
chr18,9708420,0.3877192982456141,662,449,1111,+
chr18,9708422,0.3877192982456141,662,449,1111,+
chr18,9775287,2.327848872638635,763,546,1309,+
chr18,9775289,2.0039119775310215,1368,1044,2412,+
chr18,9815133,2.397544294253864,839,598,1437,+
chr18,9815165,1.4995375761322196,2793,1592,4385,+
chr18,9815166,1.2619951904138382,3918,2175,6093,+
chr18,9815213,2.109245097145627,3718,1838,5556,+
chr18,9845592,1.5217391304347825,1889,1007,2896,+
chr18,9845601,1.349641094011149,3174,1642,4816,+
chr18,9845611,1.5036966784079608,7434,3990,11424,+
chr18,9845612,1.5036966784079608,7434,3990,11424,+
chr18,9845620,1.958713503649635,4431,2739,7170,+
chr18,9859349,2.6272355646397547,790,411,1201,+
chr18,9859350,2.6272355646397547,790,411,1201,+
chr18,9859498,4.451134613245271,862,700,1562,+
chr18,9859708,0.492051282051282,807,599,1406,+
chr18,9859814,0.3971797884841362,675,459,1134,+
chr18,9860047,2.133426602990083,890,605,1495,+
chr18,9860205,0.5753153417424464,522,486,1008,+
chr18,9860737,1.9793702158522606,961,649,1610,+
chr18,9861187,1.6604593091669702,1582,1194,2776,+
chr18,9861215,2.315086782376502,1019,748,1767,+
chr18,9861217,2.315086782376502,1019,748,1767,+
chr18,9861318,1.768816067653277,576,472,1048,+
chr18,9861347,0.5574162679425837,698,527,1225,+
chr18,9861363,0.5661337209302326,930,687,1617,+
chr18,9861372,0.648,1052,649,1701,+
chr18,9861378,1.3077410242690763,2087,1353,3440,+
chr18,9861393,2.073411765682112,2735,1890,4625,+
chr18,9861404,1.4705381632460042,1689,1089,2778,+
chr18,9861414,0.9293100538988156,3669,2619,6288,+
chr18,9861426,1.5312166804880938,2349,1467,3816,+
chr18,9861453,1.4601971576456827,8776,6290,15066,+
chr18,9861896,2.2585290827740487,556,446,1002,+
chr18,9861963,1.6487404248598279,802,468,1270,+
chr18,9931838,2.2997734541577826,584,468,1052,+
chr18,9931875,2.334251968503937,846,634,1480,+
chr18,9936127,1.625483106844533,953,616,1569,+
chr18,9950433,1.470290567200082,1252,862,2114,+
chr18,9950549,1.4893150468383392,2475,1983,4458,+
chr18,9954203,1.7446033081020462,888,737,1625,+
chr18,9954242,1.8850646209136772,1090,741,1831,+
chr18,9954249,1.7431888178156838,565,468,1033,+
chr18,9954289,1.7256617807919492,985,652,1637,+
chr18,9954319,2.0365644171779143,1157,814,1971,+
chr18,9954363,1.4728192423690054,6164,5147,11311,+
chr18,9954364,1.4339345592481971,10342,8349,18691,+
chr18,9954365,1.4528259454184056,8466,7154,15620,+
chr18,9954366,1.4957762834769714,9021,7847,16868,+
chr18,9954368,1.716696257968515,7268,6570,13838,+
chr18,9954369,1.9193649908373838,4966,4563,9529,+
chr18,9954375,1.3801445712958702,7993,6959,14952,+
chr18,9954376,1.3544569055834257,8627,7374,16001,+
chr18,9954624,2.4337807606263984,945,744,1689,+
chr18,9954648,1.5010002500625157,979,743,1722,+
chr18,11851556,1.7992075774232215,1255,841,2096,+
chr18,11851557,2.25326264274062,974,612,1586,+
chr18,11851858,0.5771071034228928,587,417,1004,+
chr18,11852153,2.157267313760153,727,594,1321,+
chr18,11999076,1.8316299085529857,680,428,1108,+
chr18,12028067,0.3098377281947261,610,492,1102,+
chr18,12028069,0.3098377281947261,610,492,1102,+
chr18,12028904,0.41268158862771986,643,476,1119,+
chr18,12030581,1.9631718184349762,610,419,1029,+
chr18,12308297,2.226163663663664,817,332,1149,+
chr18,12308298,2.226163663663664,817,332,1149,+
chr18,12326251,1.1498541366757271,708,519,1227,+
chr18,12326260,1.8684355997788835,844,736,1580,+
chr18,12326262,1.8684355997788835,844,736,1580,+
chr18,12326288,0.5081947162426614,553,510,1063,+
chr18,12326306,1.8567080592831267,1470,1244,2714,+
chr18,12326482,0.4412045889101338,638,522,1160,+
chr18,12326483,0.4412045889101338,638,522,1160,+
chr18,12706564,0.9545052771599739,540,477,1017,+
chr18,12725478,0.9446194926568756,803,534,1337,+
chr18,12725479,0.9446194926568756,803,534,1337,+
chr18,12985597,3.9251527843900686,692,510,1202,+
chr18,19192314,0.5639734493018997,615,513,1128,+
chr18,19192329,1.364622733794183,2053,1803,3856,+
chr18,19192331,1.4227837421081726,3154,2813,5967,+
chr18,19192332,1.5373163132390284,3163,2611,5774,+
chr18,19192341,1.8383311603650585,986,766,1752,+
chr18,19192344,1.5594894944452813,2452,2170,4622,+
chr18,19192345,1.575643812158335,1017,722,1739,+
chr18,19192387,0.7717980052403798,6573,4963,11536,+
chr18,19192388,0.5941750259425804,1951,1224,3175,+
chr18,19192389,0.7841163011029476,10320,7715,18035,+
chr18,19192390,0.7763176055596679,11386,8334,19720,+
chr18,19192392,0.7587082322239853,14893,10372,25265,+
chr18,19192394,0.7746159901499706,8721,6179,14900,+
chr18,19203736,1.5898381661933576,2232,1532,3764,+
chr18,19203884,1.584169453734671,1246,896,2142,+
chr18,19209074,2.7219917012448134,655,481,1136,+
chr18,19209077,2.8057068741893647,675,513,1188,+
chr18,19209094,2.622997711670481,1833,1310,3143,+
chr18,19209096,2.622997711670481,1833,1310,3143,+
chr18,20526412,1.9481077784596028,1159,695,1854,+
chr18,20529586,1.79539641943734,701,390,1091,+
chr18,20529591,2.5760418062441377,1537,877,2414,+
chr18,20529592,2.4517123918827837,2100,1236,3336,+
chr18,20529603,2.2277765703108017,1024,641,1665,+
chr18,20529608,1.548355852712581,2553,1824,4377,+
chr18,20529609,1.9783943965517243,1508,1159,2667,+
chr18,20529611,1.6637498464803817,1920,1466,3386,+
chr18,20529616,1.4768596487918626,3302,2410,5712,+
chr18,20573761,2.445882755474453,840,547,1387,+
chr18,20573762,1.9964314927932365,1040,698,1738,+
chr18,20573763,2.445882755474453,840,547,1387,+
chr18,20573800,2.488829071332436,803,742,1545,+
chr18,20573801,2.488829071332436,803,742,1545,+
chr18,29100828,2.9799937501698324,626,502,1128,+
chr18,29100859,3.316552046413681,814,803,1617,+
chr18,29111099,3.0167825159347013,1146,736,1882,+
chr18,29111102,2.584394250513347,650,486,1136,+
chr18,29122590,2.004143126177025,625,530,1155,+
chr18,29122591,2.261664266680273,1829,1305,3134,+
chr18,29122593,2.534622823984526,818,516,1334,+
chr18,29127203,0.31443123862391176,1515,993,2508,+
chr18,29127204,0.4249075744063449,2765,1618,4383,+
chr18,29127205,0.29380670928228797,1329,793,2122,+
chr18,29127206,0.6078406208366856,1034,565,1599,+
chr18,32871166,0.8637161323460172,1186,765,1951,+
chr18,32871167,0.8637161323460172,1186,765,1951,+
chr18,32871174,2.7777306168647424,676,588,1264,+
chr18,32871175,2.7777306168647424,676,588,1264,+
chr18,32886035,0.4321133412042503,731,483,1214,+
chr18,32886037,0.4321133412042503,731,483,1214,+
chr18,33263411,3.1833651675638133,678,442,1120,+
chr18,33263412,3.1833651675638133,678,442,1120,+
chr18,33271030,0.9927113702623905,680,440,1120,+
chr18,33271031,0.9927113702623905,680,440,1120,+
chr18,33289763,0.9706521739130436,610,459,1069,+
chr18,33289764,0.9706521739130436,610,459,1069,+
chr18,33290487,3.0201759771098464,748,459,1207,+
chr18,33290547,2.6363636363636367,608,461,1069,+
chr18,33290549,2.897488874761602,926,725,1651,+
chr18,33290550,2.487128712871287,627,504,1131,+
chr18,33290575,2.561024056499669,966,984,1950,+
chr18,33290577,1.7328417910645197,1722,1639,3361,+
chr18,33290766,3.119395618134054,625,448,1073,+
chr18,33558983,2.2429378531073447,793,353,1146,+
chr18,33716303,2.544839582528025,626,397,1023,+
chr18,33718270,1.869094013814802,1273,863,2136,+
chr18,33721106,2.411330049261084,622,405,1027,+
chr18,33722811,3.008720930232558,574,429,1003,+
chr18,33744485,2.1801242236024843,701,405,1106,+
chr18,33744531,2.9881440413766285,1741,1252,2993,+
chr18,33751051,0.5363565891472868,813,599,1412,+
chr18,33779759,0.7160254409435982,717,495,1212,+
chr18,33779761,2.6778568662160445,613,450,1063,+
chr18,33793350,3.7272331154684095,657,458,1115,+
chr18,33793352,2.0626708936190092,1215,901,2116,+
chr18,33793353,1.0316417910447762,671,468,1139,+
chr18,33800051,0.4257223153826687,633,489,1122,+
chr18,33828913,1.32546080619258,1216,1000,2216,+
chr18,33828915,1.5279197948194407,1125,854,1979,+
chr18,33831230,2.1438916876574305,618,396,1014,+
chr18,33846754,2.1261516654854717,599,497,1096,+
chr18,33848507,2.2633053221288515,908,594,1502,+
chr18,33848508,2.2633053221288515,908,594,1502,+
chr18,39550357,2.3847314835575375,1207,890,2097,+
chr18,39550360,1.7156404812455768,781,470,1251,+
chr18,39609295,1.1673718248491123,705,638,1343,+
chr18,57570121,2.1989094357515406,874,702,1576,+
chr18,57570122,2.1989094357515406,874,702,1576,+
chr18,67993196,1.9647818270959307,686,421,1107,+
chr18,67993198,1.847405727194207,1424,964,2388,+
chr18,67993200,2.5509931245225363,721,475,1196,+
chr18,77475243,4.369719985458235,527,1219,1746,+
chr18,77475245,2.96402650671448,552,1023,1575,+
chr18,77475258,0.1366124942369755,430,963,1393,+
chr18,77730684,6.8233568093997405,763,566,1329,+
chr19,537058,2.310774300928326,802,539,1341,+
chr19,537060,2.291095890410958,668,437,1105,+
chr19,572571,0.9606418918918921,725,479,1204,+
chr19,572573,0.9606418918918921,725,479,1204,+
chr19,572595,1.7055653415764152,1107,664,1771,+
chr19,572598,1.244413250982594,598,519,1117,+
chr19,572604,0.667240100845321,702,612,1314,+
chr19,572611,1.5372187266385589,2476,1385,3861,+
chr19,572621,1.464415400227409,1575,918,2493,+
chr19,572622,1.6245682028814559,1554,1078,2632,+
chr19,572661,1.777474931018238,2091,1523,3614,+
chr19,579512,1.6446743978590543,2504,1474,3978,+
chr19,579513,1.3199044574175316,1872,1192,3064,+
chr19,579516,2.0887096774193545,1960,1271,3231,+
chr19,579520,1.433546887704322,4320,2952,7272,+
chr19,579521,1.433546887704322,4320,2952,7272,+
chr19,579534,2.513821832473917,2416,1790,4206,+
chr19,579537,1.3571429107507174,17252,12074,29326,+
chr19,579538,1.3703630007820582,13227,9052,22279,+
chr19,579639,0.6619624550659035,1694,1294,2988,+
chr19,579640,1.3631108775617444,1296,1037,2333,+
chr19,580445,1.3639166177334114,1466,1047,2513,+
chr19,580452,1.4881652011253,1507,1112,2619,+
chr19,580676,1.435493169234069,1911,1586,3497,+
chr19,580681,1.4011339353415593,2414,1955,4369,+
chr19,580758,1.389686684073107,2128,1531,3659,+
chr19,580759,1.3379137193258233,2338,2081,4419,+
chr19,581378,1.7831698973774233,2171,1753,3924,+
chr19,581549,1.314955510560437,2081,1312,3393,+
chr19,581555,1.1976573357157037,1389,1149,2538,+
chr19,581558,1.600978336827393,1658,1430,3088,+
chr19,582533,1.006320559972692,3723,2784,6507,+
chr19,582793,1.8012020342117432,1460,1235,2695,+
chr19,582797,1.5046502366162775,6148,4517,10665,+
chr19,582813,1.4049045285204298,3631,3147,6778,+
chr19,582814,1.364008701566751,7075,4487,11562,+
chr19,582815,1.3791227645488686,10706,7634,18340,+
chr19,582854,0.7661144509201046,3477,3112,6589,+
chr19,583042,2.0487673256078165,1360,977,2337,+
chr19,583055,1.6769170531895667,1661,1276,2937,+
chr19,583081,1.3423445478074498,3420,2751,6171,+
chr19,583121,0.9998699664912125,4277,3529,7806,+
chr19,583278,0.7770255652586866,1817,1306,3123,+
chr19,583331,1.793403311287107,13272,8942,22214,+
chr19,583332,1.793403311287107,13272,8942,22214,+
chr19,677922,2.6470207846729963,702,483,1185,+
chr19,681511,2.465232030449421,841,593,1434,+
chr19,681512,2.4292820947575247,1112,793,1905,+
chr19,681784,0.5199226305609285,863,494,1357,+
chr19,681904,9.17007434944238,1011,537,1548,+
chr19,681905,16.698589856547947,3215,1874,5089,+
chr19,681906,16.698589856547947,3215,1874,5089,+
chr19,682403,2.1521957251073185,819,658,1477,+
chr19,683190,1.8319672544094943,965,686,1651,+
chr19,797450,0.46793332265926585,906,456,1362,+
chr19,797451,0.8342313381536824,1142,682,1824,+
chr19,797482,1.9335083114610676,662,380,1042,+
chr19,797484,2.1171012537254597,873,669,1542,+
chr19,799422,0.5849802371541502,628,505,1133,+
chr19,799437,0.9872448979591836,1418,1154,2572,+
chr19,799439,0.8024367717476163,2396,1754,4150,+
chr19,803563,2.192926045016077,743,621,1364,+
chr19,803593,1.800104620749782,1228,774,2002,+
chr19,804094,2.2534664448141983,716,600,1316,+
chr19,804334,1.9767068273092365,748,414,1162,+
chr19,804352,1.7197590361445785,792,497,1289,+
chr19,804694,1.921916990146312,612,393,1005,+
chr19,804828,0.4710506134969325,566,488,1054,+
chr19,805500,0.25478968414140835,647,490,1137,+
chr19,805501,1.8390686173500927,1070,632,1702,+
chr19,805503,1.8390686173500927,1070,632,1702,+
chr19,806491,4.804477611940299,776,468,1244,+
chr19,806492,4.804477611940299,776,468,1244,+
chr19,806518,0.3902596877275301,602,525,1127,+
chr19,806519,0.3902596877275301,602,525,1127,+
chr19,806525,2.261282660332542,587,420,1007,+
chr19,806552,0.3398280572071348,768,507,1275,+
chr19,808670,2.3560976354866123,851,560,1411,+
chr19,808709,1.0800650607112232,851,713,1564,+
chr19,808721,1.701077939619148,2014,1510,3524,+
chr19,808722,1.86,1208,974,2182,+
chr19,808754,0.48561919427748235,610,490,1100,+
chr19,810713,2.4347941215411093,612,580,1192,+
chr19,810876,0.3543150684931507,738,583,1321,+
chr19,810892,1.1823519915069094,2219,1627,3846,+
chr19,810979,1.8923010752688167,646,464,1110,+
chr19,811225,26.622594344836664,2180,1044,3224,+
chr19,811227,17.703199668543483,2929,1662,4591,+
chr19,811228,14.940838667231965,1952,1310,3262,+
chr19,811250,24.839543546522272,1064,1201,2265,+
chr19,811268,0.3696551615276952,556,584,1140,+
chr19,811323,0.4565608919382504,506,582,1088,+
chr19,811324,0.4565608919382504,506,582,1088,+
chr19,811432,0.5996342737722048,997,659,1656,+
chr19,811435,0.6027649769585254,1089,874,1963,+
chr19,811450,1.9220366086981462,2274,1881,4155,+
chr19,811618,2.844662101481814,1468,1047,2515,+
chr19,811715,1.513213677293916,1009,531,1540,+
chr19,811779,1.8163399924613643,1284,757,2041,+
chr19,811781,1.762375565703063,1731,1127,2858,+
chr19,811836,0.4017825311942959,965,659,1624,+
chr19,811937,6.256804324534278,1202,589,1791,+
chr19,811939,1.1043112897332843,2014,951,2965,+
chr19,811940,1.890640323453097,2401,1200,3601,+
chr19,811941,1.5208697764820214,2121,1028,3149,+
chr19,811942,1.32176459474778,1626,789,2415,+
chr19,811959,2.5603977152528024,1273,651,1924,+
chr19,811960,2.5603977152528024,1273,651,1924,+
chr19,811985,1.9259358288770052,685,373,1058,+
chr19,811992,0.5956325710250421,644,448,1092,+
chr19,812032,2.126870049867996,852,486,1338,+
chr19,812070,1.603765323992995,813,570,1383,+
chr19,812154,1.6504858891542649,1345,1065,2410,+
chr19,812198,2.128838951310861,783,533,1316,+
chr19,863273,0.8384128809660726,728,628,1356,+
chr19,863337,1.4052880177685474,681,603,1284,+
chr19,1104068,0.8072864622952192,1018,489,1507,+
chr19,1104071,1.2996353820392061,787,434,1221,+
chr19,1105199,0.4250340854114439,603,428,1031,+
chr19,1105200,2.472589653145209,802,494,1296,+
chr19,1105227,1.9590299405012308,1106,716,1822,+
chr19,1105229,1.969465648854962,959,654,1613,+
chr19,1105238,0.3878942881500426,818,458,1276,+
chr19,1105260,2.2094378642601997,903,590,1493,+
chr19,1105271,1.5033036977167107,1836,1009,2845,+
chr19,1105272,1.7962292632360242,2238,1375,3613,+
chr19,1105378,1.6529928565563676,2261,1281,3542,+
chr19,1105399,1.6879168519341927,2864,1729,4593,+
chr19,1105407,1.5838043918964855,8539,5257,13796,+
chr19,1105408,1.8226079013473395,6650,4378,11028,+
chr19,1105463,1.1674262294723186,9840,5321,15161,+
chr19,1105464,1.3906681629834254,6665,3839,10504,+
chr19,1105780,2.6682808716707025,911,471,1382,+
chr19,1106402,2.6374133949191685,570,432,1002,+
chr19,1106543,0.5577990913679959,649,565,1214,+
chr19,1106631,1.1940493620480972,1063,688,1751,+
chr19,1258736,40.48908509338493,947,1275,2222,+
chr19,1258737,40.48908509338493,947,1275,2222,+
chr19,1258748,4.10056650144429,427,705,1132,+
chr19,1272440,0.5376344086021505,1034,712,1746,+
chr19,1272441,1.0390262570965128,1236,1004,2240,+
chr19,1272442,0.5376344086021505,1034,712,1746,+
chr19,1272636,4.039871479048473,712,470,1182,+
chr19,1421148,0.9194006376977389,819,630,1449,+
chr19,1421150,0.9569519172850464,616,501,1117,+
chr19,1421197,1.4112610686039926,639,552,1191,+
chr19,1438377,1.1410866139944318,691,433,1124,+
chr19,1438394,0.6147694557419002,1222,553,1775,+
chr19,1438395,0.6138761408739322,1975,1154,3129,+
chr19,1438400,1.959016393442623,2628,1176,3804,+
chr19,1438401,1.959016393442623,2628,1176,3804,+
chr19,1438402,1.9430356834411588,2947,1433,4380,+
chr19,1438405,1.45029990403071,2120,1041,3161,+
chr19,1438406,1.45029990403071,2120,1041,3161,+
chr19,1438421,1.6455460255284662,1602,870,2472,+
chr19,1438422,0.7772236958443854,1607,1449,3056,+
chr19,1438806,0.6559322033898305,1160,779,1939,+
chr19,1438807,1.5162651937241878,2640,1568,4208,+
chr19,1438810,1.6126748750293554,980,726,1706,+
chr19,1438818,1.0897452888435322,3492,2921,6413,+
chr19,1438820,1.2557019960728266,4423,3186,7609,+
chr19,1438821,1.2770165836391314,5876,4257,10133,+
chr19,1438823,1.3381527347781217,3062,1709,4771,+
chr19,1438841,1.615183878562388,10090,8560,18650,+
chr19,1438842,1.6669527833480091,6707,5441,12148,+
chr19,1440081,1.4860600299972646,2497,2098,4595,+
chr19,1440082,1.77216445368741,1496,664,2160,+
chr19,1440139,1.43213517208338,2773,2000,4773,+
chr19,1440363,1.4441912498709166,3745,2089,5834,+
chr19,1979202,1.0851941072917632,936,501,1437,+
chr19,1979203,2.074509803921569,1057,699,1756,+
chr19,1979204,1.0851941072917632,936,501,1437,+
chr19,1979205,2.074509803921569,1057,699,1756,+
chr19,1979209,1.7569905059175446,658,465,1123,+
chr19,1979216,1.8183425584255848,762,541,1303,+
chr19,1979227,2.297674418604651,857,644,1501,+
chr19,1979230,1.6830817378497793,953,775,1728,+
chr19,2245496,2.426169922762381,1334,709,2043,+
chr19,2245497,2.426169922762381,1334,709,2043,+
chr19,2245500,3.298748696558916,702,410,1112,+
chr19,2245548,1.2411591942349873,1150,911,2061,+
chr19,2246757,1.520089988751406,823,634,1457,+
chr19,2246762,1.8085255610972568,1008,801,1809,+
chr19,2246766,1.5879503554645138,1155,964,2119,+
chr19,2246771,1.451778523489933,2621,2383,5004,+
chr19,2246772,1.5557936109787487,5181,4562,9743,+
chr19,2246774,1.656449972905669,2761,2606,5367,+
chr19,2269518,0.918063675965028,3544,1331,4875,+
chr19,2269523,1.1951383737009542,3106,1143,4249,+
chr19,2269524,2.243650663878609,2216,1191,3407,+
chr19,2269533,2.301627413322551,2276,760,3036,+
chr19,2269551,2.0683679899180847,2989,1586,4575,+
chr19,2269552,1.6688068847436246,5925,2465,8390,+
chr19,2269553,1.85125168839032,11422,5728,17150,+
chr19,2269567,1.9618011474714194,7565,3947,11512,+
chr19,2269568,1.8531656669124532,6563,3248,9811,+
chr19,2269601,1.4924202856919018,3312,2055,5367,+
chr19,2269602,1.7548209366391183,1273,923,2196,+
chr19,2271405,1.4390378514550586,3673,2773,6446,+
chr19,2271407,1.5114331286866498,2902,2339,5241,+
chr19,2271408,1.407027328979908,7837,6040,13877,+
chr19,2271409,1.3761186798153109,4004,2978,6982,+
chr19,2271461,1.2678835585301633,11832,8007,19839,+
chr19,2271462,0.9864650673260291,6012,4697,10709,+
chr19,2271463,1.3101858972824634,11528,6912,18440,+
chr19,2271464,1.23704684088845,10479,6835,17314,+
chr19,2271470,0.5835253116863223,7268,4828,12096,+
chr19,2271483,1.487846137256178,8060,6370,14430,+
chr19,2271907,1.242918676888408,8313,5629,13942,+
chr19,2272800,1.2673561758049787,3413,2829,6242,+
chr19,2273146,2.01764705882353,1028,679,1707,+
chr19,2273163,4.009880768015725,20645,15994,36639,+
chr19,2273164,3.239113938223271,23982,18988,42970,+
chr19,2273165,3.089801000645054,14583,10827,25410,+
chr19,2273166,1.6551530516126771,8672,7693,16365,+
chr19,2273167,0.8726423688499426,4453,3966,8419,+
chr19,2273205,0.7994751472215744,3322,2728,6050,+
chr19,2273331,4.161889049288513,960,745,1705,+
chr19,2478108,2.0092212320805887,773,444,1217,+
chr19,2478110,1.9014257435666144,1243,752,1995,+
chr19,2478111,1.6703135492210583,1476,1006,2482,+
chr19,2478113,1.0538558265962938,1225,908,2133,+
chr19,2478117,0.5146136618141097,706,469,1175,+
chr19,2478120,1.5326836225338722,727,600,1327,+
chr19,2478143,0.6172807132555395,1711,1051,2762,+
chr19,2478145,1.8620590490797546,1294,1303,2597,+
chr19,3572974,1.0431475865649713,3027,1806,4833,+
chr19,3572975,1.0747163559180397,2110,1400,3510,+
chr19,3572976,1.0431475865649713,3027,1806,4833,+
chr19,3572978,0.5985836517693969,778,462,1240,+
chr19,3572979,0.5673368849172252,618,528,1146,+
chr19,3573702,2.997801848324885,842,425,1267,+
chr19,3573735,2.266009204470743,906,584,1490,+
chr19,3573736,2.266009204470743,906,584,1490,+
chr19,3573739,2.7231297160765675,776,586,1362,+
chr19,3574385,1.0365802675585285,1101,919,2020,+
chr19,3574386,1.2793345215839294,1901,1559,3460,+
chr19,3574410,1.6569278441788402,590,501,1091,+
chr19,3574420,0.7252346331791143,1142,849,1991,+
chr19,3574433,0.6207430340557275,1202,645,1847,+
chr19,3574485,2.2078828297307616,1387,1009,2396,+
chr19,3574492,1.8354114507248604,1539,935,2474,+
chr19,3574498,0.5166056903349554,807,598,1405,+
chr19,3574517,0.5876177232791859,1630,1216,2846,+
chr19,3574519,0.5876177232791859,1630,1216,2846,+
chr19,3574528,1.685019175455417,962,744,1706,+
chr19,3574557,2.011269572155181,1406,812,2218,+
chr19,3574574,0.6233173662417797,1668,1129,2797,+
chr19,3575560,1.6237047769582016,1998,1167,3165,+
chr19,3575571,1.5174494692453104,3091,2115,5206,+
chr19,3575595,1.9334881010384721,3891,2828,6719,+
chr19,3575651,1.5175778245038205,1820,1257,3077,+
chr19,3577986,0.9922355551073914,655,632,1287,+
chr19,3577988,0.9922355551073914,655,632,1287,+
chr19,3578040,0.4783476525210448,847,500,1347,+
chr19,3578064,1.9367504835589942,645,516,1161,+
chr19,3578071,1.6945068185552332,883,588,1471,+
chr19,3578543,2.3504835589941973,650,516,1166,+
chr19,3578546,1.2018026602169698,1177,971,2148,+
chr19,3578658,1.6274980374565435,1987,1204,3191,+
chr19,3578659,1.6274980374565435,1987,1204,3191,+
chr19,3578660,0.5832134292565947,607,416,1023,+
chr19,3578693,2.083583583583584,723,665,1388,+
chr19,3578713,0.7154751650875681,1245,809,2054,+
chr19,3578743,1.3907053134219411,1549,1077,2626,+
chr19,3578838,2.2360093652736106,785,491,1276,+
chr19,3578847,2.932772384523954,704,479,1183,+
chr19,3578868,1.11528644356211,1451,983,2434,+
chr19,3578870,1.11528644356211,1451,983,2434,+
chr19,3578974,3.2846565847511027,718,528,1246,+
chr19,3578988,1.753663003663004,765,545,1310,+
chr19,3578990,1.830788485607009,1218,1019,2237,+
chr19,3578991,1.9289892781938933,2029,1620,3649,+
chr19,3579025,0.583228577414624,1309,1031,2340,+
chr19,3762806,1.6122632955090248,790,603,1393,+
chr19,3762807,1.2133404443626576,1026,773,1799,+
chr19,3762808,0.9453298927342644,868,647,1515,+
chr19,3762809,0.7100377358490566,671,499,1170,+
chr19,4409024,2.455249569707401,633,497,1130,+
chr19,4409051,2.204070726723897,1287,868,2155,+
chr19,4409064,1.6414169964198229,842,548,1390,+
chr19,4422716,8.29768263516707,541,481,1022,+
chr19,4724090,1.6112701771857754,705,830,1535,+
chr19,4932961,3.0071054599850413,730,381,1111,+
chr19,4932963,3.0071054599850413,730,381,1111,+
chr19,4941541,2.714368353134873,1219,680,1899,+
chr19,4941542,2.714368353134873,1219,680,1899,+
chr19,4941543,2.753329297820823,1653,943,2596,+
chr19,4941545,1.9803417671493715,1095,685,1780,+
chr19,4941555,1.0425249169435216,1045,699,1744,+
chr19,4941556,1.0425249169435216,1045,699,1744,+
chr19,4941568,2.376862401402279,677,488,1165,+
chr19,4941571,1.5603864734299515,645,431,1076,+
chr19,4941579,0.6599576271186441,1868,1319,3187,+
chr19,4941580,0.615282065674993,2922,2035,4957,+
chr19,4941582,0.6255894858909934,2022,1392,3414,+
chr19,4941583,2.366609294320138,874,580,1454,+
chr19,4941588,2.1096944959802104,2110,1616,3726,+
chr19,4941589,1.8043630576976155,2661,2000,4661,+
chr19,4961764,2.269565217391304,818,454,1272,+
chr19,4961766,2.269565217391304,818,454,1272,+
chr19,4961809,1.593677670003323,537,467,1004,+
chr19,5649961,3.647637754133258,662,456,1118,+
chr19,5690275,0.7066096952996158,6295,2562,8857,+
chr19,5690276,0.715949058316315,2656,1242,3898,+
chr19,5690277,0.6989327725172496,5203,1952,7155,+
chr19,5690284,1.791518695741574,2168,1252,3420,+
chr19,5690285,1.6917905018759412,4442,2186,6628,+
chr19,5690303,1.628833201574709,9287,4399,13686,+
chr19,5690304,1.628833201574709,9287,4399,13686,+
chr19,5690305,1.5799123312409062,11003,5515,16518,+
chr19,5690326,1.4418091798122759,2040,1427,3467,+
chr19,5690328,1.3190341338982683,2961,1384,4345,+
chr19,5690333,1.2584299586857688,5749,3424,9173,+
chr19,5690523,1.6218416419962942,4498,3393,7891,+
chr19,5690526,1.4227727566171722,1958,1548,3506,+
chr19,5690531,0.6283521999865238,2445,1745,4190,+
chr19,5690551,1.3560849634752972,10156,7145,17301,+
chr19,5690564,1.2878888113496003,3690,3157,6847,+
chr19,5691347,1.5931629078795408,3050,2406,5456,+
chr19,5691415,1.3472608913370057,2586,1996,4582,+
chr19,5691455,1.23443390364141,6767,5735,12502,+
chr19,5691456,1.23443390364141,6767,5735,12502,+
chr19,5691605,1.6778479378418352,1880,1468,3348,+
chr19,6361895,0.7688148788927337,710,407,1117,+
chr19,6361897,0.7688148788927337,710,407,1117,+
chr19,6362483,3.119168428935264,640,610,1250,+
chr19,6364608,2.1376493818539726,663,423,1086,+
chr19,6364630,2.5309461479919606,788,633,1421,+
chr19,6368739,1.0852642782326531,561,453,1014,+
chr19,6746476,1.7692367511065492,774,663,1437,+
chr19,6750018,1.9821545304280466,648,491,1139,+
chr19,7695489,2.1081349206349205,594,440,1034,+
chr19,7747379,0.4589441410514549,658,427,1085,+
chr19,7976366,5.79362095339002,835,620,1455,+
chr19,7976368,5.600709030119074,859,724,1583,+
chr19,7976382,2.906952611553096,763,412,1175,+
chr19,7976384,2.2805459014383267,984,591,1575,+
chr19,7976411,1.8696297831192152,1258,761,2019,+
chr19,7976412,1.8696297831192152,1258,761,2019,+
chr19,7976418,1.6727047146401983,748,464,1212,+
chr19,7976419,2.755813953488372,1523,1015,2538,+
chr19,7976420,2.269486062578782,2350,1606,3956,+
chr19,7976422,1.732499180482993,2408,1718,4126,+
chr19,7976437,1.7147670617059303,2641,2037,4678,+
chr19,8386383,1.7146820033241268,1733,1995,3728,+
chr19,8386384,1.5967621463674682,1264,1222,2486,+
chr19,8386385,1.6899625179641187,1168,1279,2447,+
chr19,8386390,0.3747121565303384,697,1286,1983,+
chr19,8386391,0.3747121565303384,697,1286,1983,+
chr19,8386392,0.3787131596280138,930,1567,2497,+
chr19,8386414,0.5614938574938575,1057,1374,2431,+
chr19,8386415,0.5614938574938575,1057,1374,2431,+
chr19,8386417,0.9266734798160446,1673,926,2599,+
chr19,8386418,0.8364508485991247,2209,1491,3700,+
chr19,8386420,0.6981189320388349,707,823,1530,+
chr19,8386434,3.0650735294117646,1190,679,1869,+
chr19,8386437,1.57772534214252,795,814,1609,+
chr19,8386919,2.9333333333333336,1199,539,1738,+
chr19,8467380,2.95259560855024,654,528,1182,+
chr19,8467382,2.95259560855024,654,528,1182,+
chr19,8467434,1.5607142857142857,873,783,1656,+
chr19,8469128,0.9114219114219116,594,454,1048,+
chr19,8469129,1.8794052009502618,1055,855,1910,+
chr19,8509860,1.029020546815859,3129,1586,4715,+
chr19,8509862,0.9579620707999086,3521,1848,5369,+
chr19,8509868,0.4271978393891807,2804,1251,4055,+
chr19,8509869,0.45014420125845966,3345,1532,4877,+
chr19,8509880,1.526676163779238,677,462,1139,+
chr19,8509927,0.3958345028911469,640,378,1018,+
chr19,8509929,0.3958345028911469,640,378,1018,+
chr19,8509940,2.6964980544747084,692,513,1205,+
chr19,8509941,2.6964980544747084,692,513,1205,+
chr19,8520293,0.3988283981681672,981,735,1716,+
chr19,8520325,0.48722736625514396,1932,1295,3227,+
chr19,8520326,0.4804285526981213,3127,2029,5156,+
chr19,8520328,0.518595338269291,3033,1913,4946,+
chr19,8520335,0.5819359756097561,1526,831,2357,+
chr19,8520382,1.672734375,3171,1599,4770,+
chr19,8520421,1.6868946201423738,4654,3115,7769,+
chr19,8520452,1.0836157908389668,13839,8896,22735,+
chr19,8527439,1.821757687783566,3927,2704,6631,+
chr19,8528508,1.3904821038198352,1513,1058,2571,+
chr19,8530241,0.3361950723901448,1102,634,1736,+
chr19,8530294,2.340886699507389,647,608,1255,+
chr19,8530295,2.340886699507389,647,608,1255,+
chr19,8531160,1.496663254861822,1405,976,2381,+
chr19,8533706,2.713782427671613,819,492,1311,+
chr19,8538581,0.5073675826363998,545,485,1030,+
chr19,8539079,1.873644251626898,690,460,1150,+
chr19,8539123,1.8719999999999999,647,449,1096,+
chr19,8550496,3.317609422888473,1445,944,2389,+
chr19,8550498,3.578546307151231,1220,852,2072,+
chr19,8550499,6.829974391225234,1708,1194,2902,+
chr19,8550713,0.3058947927720931,850,603,1453,+
chr19,8551282,2.2681451612903225,624,464,1088,+
chr19,8553633,3.777358490566037,615,529,1144,+
chr19,8553634,4.38627847186856,2267,1709,3976,+
chr19,8553718,0.6122923588039867,775,601,1376,+
chr19,9938593,2.4605265819409214,1018,663,1681,+
chr19,9938594,2.404393731755269,1207,785,1992,+
chr19,9938622,1.967349010319743,801,513,1314,+
chr19,9938651,2.0820683111954463,664,526,1190,+
chr19,9938652,0.6187398614723073,800,546,1346,+
chr19,9939014,1.748298429319372,1082,763,1845,+
chr19,9939293,1.4159349566679538,2523,1753,4276,+
chr19,9939299,1.3610546343746948,2899,2202,5101,+
chr19,9939328,1.6256059809590562,1567,1316,2883,+
chr19,9939522,1.4684882767994565,2720,2041,4761,+
chr19,9959774,1.9514549031790411,625,448,1073,+
chr19,9960157,11.814303302990277,1951,1433,3384,+
chr19,9960158,11.491678951058947,2226,1747,3973,+
chr19,9960159,11.491678951058947,2226,1747,3973,+
chr19,9960165,0.28100187711884056,798,747,1545,+
chr19,9960167,0.3398847207786071,653,556,1209,+
chr19,10221054,10.169703991709845,759,491,1250,+
chr19,10221055,11.96061340940643,942,592,1534,+
chr19,10362928,3.446685878962536,735,346,1081,+
chr19,10365281,2.1179864681161784,691,484,1175,+
chr19,10395569,1.9216029510422488,818,489,1307,+
chr19,10395570,2.201608430393788,933,600,1533,+
chr19,10395572,2.216766723842196,632,423,1055,+
chr19,10765152,2.825127955459457,783,629,1412,+
chr19,10781206,1.6817193675889328,548,459,1007,+
chr19,10781209,1.3091534437502061,1037,881,1918,+
chr19,10781825,0.48398891966759,623,474,1097,+
chr19,10781835,1.0695470992539626,1715,1266,2981,+
chr19,10781843,1.2546779777092751,1431,1027,2458,+
chr19,10782118,2.841082577068969,911,709,1620,+
chr19,10787858,3.082170542635659,851,644,1495,+
chr19,10787860,3.082170542635659,851,644,1495,+
chr19,10787918,2.225813496396593,783,481,1264,+
chr19,10787972,2.679111442971813,551,486,1037,+
chr19,10791047,1.6137491141034723,758,497,1255,+
chr19,10791096,0.4508156203657933,607,475,1082,+
chr19,10791731,1.713527851458886,645,376,1021,+
chr19,10791760,2.242514534883721,1045,859,1904,+
chr19,10791761,2.242514534883721,1045,859,1904,+
chr19,10791769,1.1638972827927643,1412,967,2379,+
chr19,10792834,1.047751937984496,762,644,1406,+
chr19,10792836,1.047751937984496,762,644,1406,+
chr19,10793855,2.2120322074239125,1443,1518,2961,+
chr19,10793856,2.031303209699996,1948,2088,4036,+
chr19,10793857,2.031303209699996,1948,2088,4036,+
chr19,10793858,1.87203418230563,2006,2237,4243,+
chr19,10793860,1.5502160897664643,1037,1200,2237,+
chr19,10793864,1.490055289621136,1042,690,1732,+
chr19,10793865,0.4598323941626932,1004,768,1772,+
chr19,10793918,2.6706161137440763,587,421,1008,+
chr19,10793919,2.6706161137440763,587,421,1008,+
chr19,10794398,5.26135809898973,1115,795,1910,+
chr19,10794408,5.65972213505157,721,587,1308,+
chr19,10794421,8.618337138792931,852,811,1663,+
chr19,10794422,8.66278068002527,784,803,1587,+
chr19,10795255,1.6963118496623653,731,530,1261,+
chr19,10795740,4.333352005535544,616,453,1069,+
chr19,10795879,3.4469619812632666,678,470,1148,+
chr19,10799933,2.1598112693247624,950,594,1544,+
chr19,10799949,1.4071853199492343,1669,1200,2869,+
chr19,10799950,1.7826447308441422,1102,817,1919,+
chr19,10799964,2.323736066981748,1360,911,2271,+
chr19,10799967,0.6017405719021964,725,380,1105,+
chr19,10799976,0.6689299738219895,1257,763,2020,+
chr19,10799983,1.7449317455707227,1580,938,2518,+
chr19,10883156,0.403108340013405,811,591,1402,+
chr19,10893679,2.027875311033546,641,509,1150,+
chr19,10897281,2.4214963119072705,765,583,1348,+
chr19,10897283,2.4929390061895464,1126,831,1957,+
chr19,10897337,2.2791842646501403,692,443,1135,+
chr19,10904515,3.5689689176532347,661,463,1124,+
chr19,10930749,1.9666784828075152,729,402,1131,+
chr19,10942423,24.453532242538284,641,843,1484,+
chr19,10942424,23.10234639391479,741,1002,1743,+
chr19,11040826,1.392891469511663,636,497,1133,+
chr19,11101868,4.725849248947433,973,468,1441,+
chr19,11101880,1.0810927505512948,1309,789,2098,+
chr19,11101913,2.040705563093623,1151,736,1887,+
chr19,11101917,1.6726262019230769,1236,831,2067,+
chr19,11118601,2.9343365253077978,714,601,1315,+
chr19,11118602,2.696442307692308,966,831,1797,+
chr19,11118603,2.696442307692308,966,831,1797,+
chr19,11118604,2.5404894327030028,992,898,1890,+
chr19,11118606,2.7908338548903338,1253,1084,2337,+
chr19,11118608,3.0613531455816543,1001,854,1855,+
chr19,11145731,1.5569236727032292,568,457,1025,+
chr19,11145771,0.9886842105263158,662,379,1041,+
chr19,11145773,0.9886842105263158,662,379,1041,+
chr19,11145791,1.7092195756794564,1102,603,1705,+
chr19,11152030,1.4701493825028606,607,515,1122,+
chr19,11152031,0.9303423487995685,599,525,1124,+
chr19,11168991,1.8455540737032967,2947,2593,5540,+
chr19,11168992,2.0119408454708223,4514,4073,8587,+
chr19,11168994,2.387597930609655,3079,2852,5931,+
chr19,11169537,2.4718546759363087,667,342,1009,+
chr19,11169539,2.7725367218305115,895,495,1390,+
chr19,11170540,4.930135060012892,1150,731,1881,+
chr19,11170543,6.43937279197511,1001,687,1688,+
chr19,11200242,1.6603696338349236,1291,841,2132,+
chr19,11213435,1.7273880941393631,650,393,1043,+
chr19,11216139,0.8092005798454035,3768,2414,6182,+
chr19,11216252,2.3746044303797467,666,473,1139,+
chr19,11217263,0.4470153846153846,680,624,1304,+
chr19,11218090,1.2301865578881692,1254,949,2203,+
chr19,11218128,1.7232876712328766,887,583,1470,+
chr19,11218159,1.8153364632237872,2319,1490,3809,+
chr19,11218160,1.8153364632237872,2319,1490,3809,+
chr19,11218162,1.8171559306825764,1836,1188,3024,+
chr19,11218163,1.7439038686987105,1265,852,2117,+
chr19,11218167,1.4299815179641326,1353,928,2281,+
chr19,11218170,1.729046795568943,5633,3841,9474,+
chr19,11218171,0.4768239523453917,1143,810,1953,+
chr19,11218172,1.729046795568943,5633,3841,9474,+
chr19,11218177,1.6802954858919512,1731,1357,3088,+
chr19,11218178,2.458028319529789,1393,984,2377,+
chr19,11218182,1.9046634379931435,1590,1172,2762,+
chr19,11221333,1.5114032370479362,4982,4187,9169,+
chr19,11221335,1.5114032370479362,4982,4187,9169,+
chr19,11221384,1.98907489005498,1999,1502,3501,+
chr19,11221436,1.461147221805046,918,740,1658,+
chr19,11221444,2.525689223057644,555,455,1010,+
chr19,11224019,2.566183574879227,663,449,1112,+
chr19,11224021,2.566183574879227,663,449,1112,+
chr19,11224090,1.8446003042082133,1051,775,1826,+
chr19,11224091,1.8446003042082133,1051,775,1826,+
chr19,11224111,1.8221739130434784,634,499,1133,+
chr19,11224215,1.8607123870281763,624,494,1118,+
chr19,11224317,1.6009993963313633,995,647,1642,+
chr19,11224375,0.5648336296672594,592,507,1099,+
chr19,11224429,1.9248927038626613,620,465,1085,+
chr19,11226858,0.4592026825633383,869,670,1539,+
chr19,11230767,1.6736480889835519,831,625,1456,+
chr19,11230850,2.180067567567568,716,443,1159,+
chr19,11238710,1.97179203539823,574,451,1025,+
chr19,11238712,0.9718851132686083,960,823,1783,+
chr19,11238713,0.9718851132686083,960,823,1783,+
chr19,11238715,2.3276909722222223,691,511,1202,+
chr19,11238716,2.3276909722222223,691,511,1202,+
chr19,11238745,1.929186602870813,671,417,1088,+
chr19,11240310,0.47121048202909005,839,530,1369,+
chr19,11242052,1.902057323720767,745,516,1261,+
chr19,11242125,1.6155336521997492,1461,1074,2535,+
chr19,11242223,1.7379295983352485,1353,905,2258,+
chr19,11242226,1.8940554536627467,626,402,1028,+
chr19,11242295,1.7205184373859077,649,497,1146,+
chr19,11242325,2.671201814058957,607,503,1110,+
chr19,11242401,1.687149133512326,642,481,1123,+
chr19,11242408,1.746279491833031,848,550,1398,+
chr19,11242531,1.8812351543942996,626,420,1046,+
chr19,11242550,2.3998622860515444,786,597,1383,+
chr19,11242580,0.4917312661498707,691,429,1120,+
chr19,11242630,2.721953990343652,598,502,1100,+
chr19,11242779,2.4205330204492124,965,605,1570,+
chr19,11242783,1.2048094413739678,918,684,1602,+
chr19,11242787,2.079729729729729,1079,799,1878,+
chr19,11242788,2.079729729729729,1079,799,1878,+
chr19,11243554,2.1764851919918917,935,768,1703,+
chr19,11243612,1.773042126095561,864,523,1387,+
chr19,11243622,0.6118945432250155,997,698,1695,+
chr19,11243813,3.997494613526424,657,444,1101,+
chr19,11243832,0.9004560115671226,735,443,1178,+
chr19,11243834,1.5250278809577982,1077,674,1751,+
chr19,11243898,1.771578947368421,815,474,1289,+
chr19,11243912,2.104002337131172,830,488,1318,+
chr19,11243944,2.5113078798604658,1155,960,2115,+
chr19,11244012,1.6688888888888889,750,554,1304,+
chr19,11244047,2.0714548802946595,759,542,1301,+
chr19,11244049,2.0714548802946595,759,542,1301,+
chr19,11244223,1.1705639676152073,825,478,1303,+
chr19,11244265,2.2445812807881773,700,405,1105,+
chr19,11244288,2.634804562432381,1242,873,2115,+
chr19,11244292,2.489413188142771,822,550,1372,+
chr19,11244406,4.144849302744039,812,512,1324,+
chr19,11546486,0.4109684137452273,591,468,1059,+
chr19,11546865,1.4999219928233396,758,468,1226,+
chr19,11546887,2.917336394948335,692,401,1093,+
chr19,11546968,1.5756085712626173,1224,801,2025,+
chr19,11547215,2.33332435114105,1403,1010,2413,+
chr19,11547221,1.8097877732024072,585,450,1035,+
chr19,11548709,2.0128826530612245,1467,783,2250,+
chr19,11548711,2.0128826530612245,1467,783,2250,+
chr19,11548742,1.645155076093238,853,536,1389,+
chr19,11548746,0.6193462897526502,737,565,1302,+
chr19,11552089,1.6949248243624804,2794,1989,4783,+
chr19,11552125,1.6831210191082802,905,627,1532,+
chr19,11553302,0.47191011235955066,769,444,1213,+
chr19,11553312,2.997914494264859,749,410,1159,+
chr19,11556206,2.2457580733442803,745,405,1150,+
chr19,11557149,2.1359029718999163,1337,1056,2393,+
chr19,11557960,1.7038732095940332,717,512,1229,+
chr19,11558368,11.257928152380346,811,569,1380,+
chr19,11558371,5.037490496659903,901,1412,2313,+
chr19,11558372,4.707644628099174,398,835,1233,+
chr19,11558375,0.3664662523131575,776,1116,1892,+
chr19,11558401,2.597362637213217,1667,2995,4662,+
chr19,11558402,4.038658878957049,817,1630,2447,+
chr19,11558403,1.8158070253445973,593,1383,1976,+
chr19,11558404,2.9617176643342478,823,1452,2275,+
chr19,11558557,0.6402591218587201,1875,1842,3717,+
chr19,11558558,0.36906330504804724,1212,1469,2681,+
chr19,11558559,0.7536262760770756,2242,2121,4363,+
chr19,11558560,0.57468817380387,1127,1356,2483,+
chr19,11558562,0.5391489093962983,1892,1501,3393,+
chr19,11558563,0.6014821898159216,1405,892,2297,+
chr19,11559053,1.5298245614035089,871,512,1383,+
chr19,11559368,0.6514459665144596,855,656,1511,+
chr19,11559398,1.7567307692307694,782,649,1431,+
chr19,11559753,0.384711155378486,617,501,1118,+
chr19,11559925,2.176788589832068,756,413,1169,+
chr19,11560097,2.7324061168867915,1126,901,2027,+
chr19,11560099,2.908991228070175,757,607,1364,+
chr19,11560116,2.442934715887816,1071,705,1776,+
chr19,11560124,1.634080058758722,617,388,1005,+
chr19,11561466,2.1357340720221605,770,379,1149,+
chr19,11561632,2.223590677501624,584,553,1137,+
chr19,11561704,1.1607912210136737,823,679,1502,+
chr19,11561706,1.1607912210136737,823,679,1502,+
chr19,12848317,0.4531686465398269,1027,462,1489,+
chr19,12848343,7.579973573991431,2171,1129,3300,+
chr19,12848344,7.569691777386494,2729,1483,4212,+
chr19,12848353,13.098433184832203,1028,756,1784,+
chr19,12848464,13.832445163622575,1941,1459,3400,+
chr19,12848465,13.832445163622575,1941,1459,3400,+
chr19,12849392,3.338919925512104,651,357,1008,+
chr19,12849402,1.311567330898632,998,635,1633,+
chr19,12856265,2.70885697187313,822,556,1378,+
chr19,12856266,2.70885697187313,822,556,1378,+
chr19,12856543,2.156544547463935,708,570,1278,+
chr19,12858104,1.8342827253530916,675,483,1158,+
chr19,12859075,4.991005700122797,1049,817,1866,+
chr19,12859076,4.991005700122797,1049,817,1866,+
chr19,12902306,4.527481387835371,979,371,1350,+
chr19,12902356,2.5198256072483085,747,499,1246,+
chr19,12902558,2.641795437821928,618,452,1070,+
chr19,12902560,2.641795437821928,618,452,1070,+
chr19,12902590,2.331938633193863,835,716,1551,+
chr19,12902591,2.331938633193863,835,716,1551,+
chr19,12902593,1.542298618132794,1319,1034,2353,+
chr19,12902595,1.825093783053194,2563,2082,4645,+
chr19,12902597,2.5093378607809846,738,588,1326,+
chr19,12902625,1.9010890035208385,610,530,1140,+
chr19,12902786,2.5145249487354757,653,417,1070,+
chr19,12902787,2.2244105028154193,1106,709,1815,+
chr19,12902825,1.8375178997613368,801,418,1219,+
chr19,12902960,20.337109698811823,919,516,1435,+
chr19,12902961,20.992425987941242,2942,1675,4617,+
chr19,12902962,19.609460103908336,2765,1563,4328,+
chr19,12902965,4.881319256397613,1880,1407,3287,+
chr19,12902966,4.591831557584983,786,437,1223,+
chr19,12902967,4.286843591191418,583,505,1088,+
chr19,12902985,2.8931176381076016,890,758,1648,+
chr19,12903024,0.4017391304347826,692,574,1266,+
chr19,12903125,0.9362183999510311,664,526,1190,+
chr19,12903126,0.9362183999510311,664,526,1190,+
chr19,12903131,1.4647468027737687,610,502,1112,+
chr19,12903368,1.0241053677932406,950,1005,1955,+
chr19,12903369,1.0241053677932406,950,1005,1955,+
chr19,12903382,1.8124280782508635,674,473,1147,+
chr19,12903434,1.4881123833216108,1616,1207,2823,+
chr19,12903500,1.8900381056069682,743,500,1243,+
chr19,12903557,2.101295097132285,648,375,1023,+
chr19,12903643,1.7746937005312806,681,400,1081,+
chr19,12903788,1.938461538461539,615,428,1043,+
chr19,12903986,1.8142044479037172,825,436,1261,+
chr19,12903993,3.2218850692764844,623,486,1109,+
chr19,12904012,1.027199074074074,567,575,1142,+
chr19,12904013,1.027199074074074,567,575,1142,+
chr19,12917446,0.5859846547314579,715,390,1105,+
chr19,12917447,0.544361418586376,1248,759,2007,+
chr19,12917512,2.1059475783933985,784,546,1330,+
chr19,12917823,0.43626015581955835,1290,748,2038,+
chr19,12917833,3.11284046692607,749,513,1262,+
chr19,12917845,2.0951632617426226,922,497,1419,+
chr19,12917883,0.4933926599979927,1228,841,2069,+
chr19,12917884,0.4933926599979927,1228,841,2069,+
chr19,12918024,1.8798424399071996,905,805,1710,+
chr19,12918062,2.0359035506094334,1396,887,2283,+
chr19,12918064,2.0359035506094334,1396,887,2283,+
chr19,12918079,2.2355097365406644,696,484,1180,+
chr19,12920937,2.1466955125968314,768,622,1390,+
chr19,12920938,1.0657391304347827,765,574,1339,+
chr19,12920939,2.1466955125968314,768,622,1390,+
chr19,12920940,1.0657391304347827,765,574,1339,+
chr19,12921172,0.5012929147251902,1307,919,2226,+
chr19,12924158,1.3381923752138178,1157,746,1903,+
chr19,12924178,1.7920777166955344,1346,812,2158,+
chr19,12924179,1.7920777166955344,1346,812,2158,+
chr19,13049451,1.4619469510999192,670,530,1200,+
chr19,13049455,0.599798893916541,1192,883,2075,+
chr19,13049456,0.599798893916541,1192,883,2075,+
chr19,13049554,1.46481956011104,1192,891,2083,+
chr19,13049556,0.7120301068034648,1277,1011,2288,+
chr19,13049557,1.37015731154966,2084,1123,3207,+
chr19,13049562,1.4241603155628118,6136,3871,10007,+
chr19,13049563,1.3356474214131266,4670,2702,7372,+
chr19,13049569,1.3270197787462286,1826,1412,3238,+
chr19,13049965,1.674170902929073,2127,1700,3827,+
chr19,13049970,1.464534457478006,3043,1983,5026,+
chr19,13049980,1.4801232993197275,1670,1343,3013,+
chr19,13049982,0.774498751260876,2787,2082,4869,+
chr19,13050018,1.532889908256881,2132,1743,3875,+
chr19,13050267,1.5538013388882874,7930,5748,13678,+
chr19,13050911,1.6768527204502814,2814,2131,4945,+
chr19,13051117,0.7654251270593434,5074,3132,8206,+
chr19,13051183,1.1947555670893,6877,4818,11695,+
chr19,13051372,1.579977634737817,9142,6951,16093,+
chr19,13051428,0.7702427340649913,3590,2542,6132,+
chr19,13051445,1.3826136035144978,11937,8969,20906,+
chr19,13051446,1.3826136035144978,11937,8969,20906,+
chr19,13051589,1.364879715713564,2074,1618,3692,+
chr19,13051618,1.3373436499029985,2581,2056,4637,+
chr19,13051657,1.2529015431427952,2811,2139,4950,+
chr19,13054369,1.4610144797883624,4286,2777,7063,+
chr19,13054539,1.6288245088245092,1608,1364,2972,+
chr19,13054632,4.544641063360981,7471,4798,12269,+
chr19,13054641,3.400216839780442,3131,2241,5372,+
chr19,13054671,4.8459439451063995,6547,4308,10855,+
chr19,13054680,6.699711741494236,6456,5410,11866,+
chr19,13054689,1.9722136309604568,6262,5648,11910,+
chr19,13054692,4.1583059165491205,6450,6690,13140,+
chr19,13054725,0.6668500547617228,1768,1706,3474,+
chr19,13054774,1.4472645462016194,2085,1361,3446,+
chr19,13054921,0.420784207665075,1340,946,2286,+
chr19,13054925,1.7997794117647057,596,424,1020,+
chr19,13054928,1.2295010213014297,2384,1489,3873,+
chr19,13054930,1.0783347418281295,4957,3203,8160,+
chr19,13054931,1.0631863296840314,3070,2033,5103,+
chr19,13054938,1.3789283087195157,1441,1289,2730,+
chr19,13054939,1.3789283087195157,1441,1289,2730,+
chr19,13054979,1.5204798404432578,3969,3352,7321,+
chr19,13055058,1.3915108748778102,3324,1983,5307,+
chr19,13056769,3.233058210251955,1373,1150,2523,+
chr19,13056771,3.233058210251955,1373,1150,2523,+
chr19,13056783,1.8598415600243756,871,546,1417,+
chr19,13056807,0.4508290451686678,829,659,1488,+
chr19,13058677,0.6039916672266649,855,646,1501,+
chr19,13058679,1.562075983717775,1227,736,1963,+
chr19,13058683,1.6256357388316154,762,581,1343,+
chr19,13058725,1.457142857142857,893,744,1637,+
chr19,13058737,1.5882637811004803,2779,1969,4748,+
chr19,13059342,1.8163860830527496,866,494,1360,+
chr19,13059363,3.389652014652015,672,545,1217,+
chr19,13059511,1.7901153810689725,1416,1122,2538,+
chr19,13059591,1.8350512021417833,1341,942,2283,+
chr19,13059612,1.7764023210831723,655,516,1171,+
chr19,13059937,2.1636215671594323,1254,911,2165,+
chr19,13063503,1.7596380802517704,638,409,1047,+
chr19,13063524,2.726753048780488,794,491,1285,+
chr19,13063572,1.6300856531049248,629,466,1095,+
chr19,13063593,9.589598204542959,1646,1229,2875,+
chr19,13063620,1.6874546114742193,640,458,1098,+
chr19,13063622,0.6012572968118545,617,523,1140,+
chr19,13063625,1.1218435990832445,1152,957,2109,+
chr19,13063647,1.6460663854758848,815,573,1388,+
chr19,13063649,0.5524294336401877,862,697,1559,+
chr19,13063651,0.4716981132075471,749,635,1384,+
chr19,13063660,0.4980200945626477,886,719,1605,+
chr19,13063792,1.8739495798319328,1114,874,1988,+
chr19,13063808,1.7215240176841686,1215,981,2196,+
chr19,13063955,2.0432778689164905,1005,752,1757,+
chr19,13063956,2.0432778689164905,1005,752,1757,+
chr19,13063958,1.9191374663072778,711,423,1134,+
chr19,13063977,1.805555555555556,623,479,1102,+
chr19,13063981,2.2660171555649686,822,496,1318,+
chr19,13063985,2.102803738317757,899,534,1433,+
chr19,13063989,0.4910919729143383,995,573,1568,+
chr19,13064093,2.188762273034672,1930,1274,3204,+
chr19,13064094,2.151491309634504,1409,1022,2431,+
chr19,13064095,2.151491309634504,1409,1022,2431,+
chr19,13064120,2.7685943060498213,942,561,1503,+
chr19,13064122,2.7685943060498213,942,561,1503,+
chr19,13064226,2.0775831826219404,813,563,1376,+
chr19,13064232,1.0708214352195176,1014,700,1714,+
chr19,13064260,1.906820776255708,580,437,1017,+
chr19,13064261,1.6495896416373554,808,502,1310,+
chr19,13064357,1.635897435897436,615,454,1069,+
chr19,13263868,0.6880841893085662,1018,635,1653,+
chr19,13265285,6.003325412807962,995,784,1779,+
chr19,13265286,5.316428208551403,1588,1351,2939,+
chr19,13265287,5.316428208551403,1588,1351,2939,+
chr19,13265290,3.6871255596848704,469,597,1066,+
chr19,13265300,0.44467713787085517,636,763,1399,+
chr19,13265301,0.44467713787085517,636,763,1399,+
chr19,13265302,0.44467713787085517,636,763,1399,+
chr19,13265588,3.9544507245262004,1795,1428,3223,+
chr19,13265589,3.9544507245262004,1795,1428,3223,+
chr19,13265606,3.1988012551531213,598,534,1132,+
chr19,13884196,1.8993117716733883,700,435,1135,+
chr19,13885284,3.700608743774212,742,277,1019,+
chr19,13885285,3.476477953490105,956,399,1355,+
chr19,13885288,1.7842170925622127,1032,382,1414,+
chr19,13885295,3.075524475524475,732,274,1006,+
chr19,13885304,2.225739034323678,1079,566,1645,+
chr19,13885309,1.593952483801296,1079,462,1541,+
chr19,13885311,2.296725519172435,1736,896,2632,+
chr19,13885312,2.0981071287927175,2331,1287,3618,+
chr19,13885321,0.6446472019464721,756,547,1303,+
chr19,13885322,1.3483996539792389,3479,1631,5110,+
chr19,13885323,1.3483996539792389,3479,1631,5110,+
chr19,13885333,1.6381613183000867,2360,1152,3512,+
chr19,13885336,1.8184141943442675,2726,1416,4142,+
chr19,13885359,1.504410601463859,3605,2186,5791,+
chr19,13885360,0.6328675770085742,1532,1004,2536,+
chr19,13885364,1.2786297443106143,12435,7555,19990,+
chr19,13885365,1.3079158100086363,6420,3738,10158,+
chr19,13885377,1.2422434875879418,8027,4826,12853,+
chr19,13885378,1.2886768980728505,11651,6612,18263,+
chr19,13885379,1.346600807525978,2165,1508,3673,+
chr19,13885380,0.7127115221659123,6393,3841,10234,+
chr19,13885469,1.4907363880209057,4721,2493,7214,+
chr19,13885482,1.3647456283955497,46371,28951,75322,+
chr19,13885483,1.3647456283955497,46371,28951,75322,+
chr19,13885495,1.9820674887242935,7793,5576,13369,+
chr19,13889036,1.9680007604382026,1336,905,2241,+
chr19,13889070,2.0703703703703704,1117,719,1836,+
chr19,13889095,2.7475999513914204,664,632,1296,+
chr19,13889127,3.7047325102880655,553,485,1038,+
chr19,13889136,0.4633766233766234,668,659,1327,+
chr19,13889161,1.6270564737148359,2610,2100,4710,+
chr19,14515332,5.625498007968127,705,501,1206,+
chr19,14515333,5.625498007968127,705,501,1206,+
chr19,14515334,5.375608511597689,820,602,1422,+
chr19,14517521,2.39234093868649,690,488,1178,+
chr19,14574529,1.6717791411042944,544,488,1032,+
chr19,14580567,1.2840507623250872,946,685,1631,+
chr19,14580730,1.0668539325842696,843,533,1376,+
chr19,14580731,1.0668539325842696,843,533,1376,+
chr19,14640460,1.8971092622539096,1130,673,1803,+
chr19,14673340,2.6232333182552585,1732,1329,3061,+
chr19,14674063,2.4439288476411445,631,430,1061,+
chr19,14674616,1.8471337579617837,1391,784,2175,+
chr19,14674617,1.8471337579617837,1391,784,2175,+
chr19,14674830,1.5591443719909803,655,537,1192,+
chr19,14674863,2.0338983050847457,719,589,1308,+
chr19,14675022,1.535854035854036,784,665,1449,+
chr19,14675094,0.6151871235311543,1245,778,2023,+
chr19,14676046,1.9424978408296514,912,506,1418,+
chr19,14733091,1.3107442027512937,1847,1210,3057,+
chr19,14733092,1.174254994358532,2358,1585,3943,+
chr19,14733094,1.6301967475635357,2067,1396,3463,+
chr19,14734009,2.56651376146789,745,435,1180,+
chr19,14734010,2.56651376146789,745,435,1180,+
chr19,16187345,4.064724919093851,627,514,1141,+
chr19,16187346,4.064724919093851,627,514,1141,+
chr19,16187387,1.2429039732842637,1105,720,1825,+
chr19,16187406,0.43589743589743596,1104,844,1948,+
chr19,16187407,0.43589743589743596,1104,844,1948,+
chr19,16187411,0.6643939393939394,876,419,1295,+
chr19,16187502,0.9997497386914591,880,699,1579,+
chr19,16187503,1.6892561983471075,656,362,1018,+
chr19,16192727,2.2352941176470584,721,436,1157,+
chr19,16192771,1.7247854077253215,642,465,1107,+
chr19,16192773,2.1756796545293944,651,442,1093,+
chr19,16192789,1.8015482054890928,767,587,1354,+
chr19,16197276,2.188640627665018,801,532,1333,+
chr19,16197291,1.7301324503311253,1044,603,1647,+
chr19,16198873,2.7627673608246255,2015,1429,3444,+
chr19,16198894,2.324381926683717,930,781,1711,+
chr19,16198897,4.237737633395587,4368,3507,7875,+
chr19,16198904,0.6847609561752988,1099,1003,2102,+
chr19,16199854,0.6742361521781983,1005,889,1894,+
chr19,16199902,0.7402634766807995,1766,1523,3289,+
chr19,16212091,2.6853012887495646,906,521,1427,+
chr19,16212109,2.542426645519429,915,581,1496,+
chr19,16212110,1.7775229357798166,824,435,1259,+
chr19,16212112,3.4758503401360543,928,629,1557,+
chr19,16212131,1.1651030075184865,1899,1272,3171,+
chr19,16212148,0.5979187930407442,1498,1106,2604,+
chr19,16212151,2.82549154092364,1488,971,2459,+
chr19,16212173,1.7936406936292695,5021,3606,8627,+
chr19,16212473,1.395649699476687,1570,1180,2750,+
chr19,16212625,1.603126695604992,1152,775,1927,+
chr19,16212670,5.687594196821954,3774,2981,6755,+
chr19,16212671,4.8230473171481325,6114,4617,10731,+
chr19,16212823,1.5853352051812433,3014,2319,5333,+
chr19,16213036,0.5005720823798627,629,551,1180,+
chr19,16213057,1.5782312925170066,898,650,1548,+
chr19,16213066,2.119014084507042,1297,780,2077,+
chr19,16213229,1.9122807017543857,1961,1177,3138,+
chr19,16213338,1.5594267539209592,2244,1608,3852,+
chr19,16213646,2.1970554469111216,653,426,1079,+
chr19,16213657,1.8750243757115213,662,426,1088,+
chr19,16213670,1.1638364928189036,939,636,1575,+
chr19,16213691,1.5145662847790509,1321,909,2230,+
chr19,16213699,1.0134747298661053,2595,1832,4427,+
chr19,16213702,1.7395792754187769,1144,754,1898,+
chr19,16213723,1.5785785785785786,1244,998,2242,+
chr19,16240367,2.2694086671885008,1406,1080,2486,+
chr19,16240369,2.2694086671885008,1406,1080,2486,+
chr19,16244001,1.63615146992065,1817,1445,3262,+
chr19,16244002,2.28646045312712,910,755,1665,+
chr19,16244003,1.63615146992065,1817,1445,3262,+
chr19,16244010,2.30934631700635,800,643,1443,+
chr19,16296237,0.6890324926604102,572,437,1009,+
chr19,16296239,0.6890324926604102,572,437,1009,+
chr19,16302393,1.7957501037987778,836,556,1392,+
chr19,16302681,7.868279777430131,1039,849,1888,+
chr19,16302685,4.171373393753569,1033,1313,2346,+
chr19,16952715,0.8270928137418201,631,418,1049,+
chr19,17379882,2.3596454219004874,814,457,1271,+
chr19,17379896,1.4988520280837188,1154,732,1886,+
chr19,17382412,2.0611833077730246,1343,952,2295,+
chr19,17384716,0.7409432756950859,6175,3872,10047,+
chr19,17389854,4.252915125963406,714,499,1213,+
chr19,17389955,19.66117379956471,780,618,1398,+
chr19,17416680,0.9178990865593736,942,450,1392,+
chr19,17416687,2.250738713985425,3570,1822,5392,+
chr19,17416688,1.812781065088757,3329,1689,5018,+
chr19,17416689,1.8175875903660057,4019,2078,6097,+
chr19,17417220,0.956581352833638,643,546,1189,+
chr19,17417221,0.956581352833638,643,546,1189,+
chr19,17417253,2.1999043519846966,574,491,1065,+
chr19,17417255,2.1999043519846966,574,491,1065,+
chr19,17417318,1.8980582524271843,645,411,1056,+
chr19,17417341,1.425707472504382,1079,852,1931,+
chr19,17417427,1.5565463244889084,841,725,1566,+
chr19,17417481,3.5627970128988458,655,490,1145,+
chr19,17417488,2.1330778443113774,1011,834,1845,+
chr19,17666490,0.5760452749538065,840,741,1581,+
chr19,17670152,3.676190476190477,771,449,1220,+
chr19,17670153,3.676190476190477,771,449,1220,+
chr19,17671262,2.1470820189274447,1088,633,1721,+
chr19,17671263,1.496942231662158,1666,1071,2737,+
chr19,17678300,1.6296857587778208,682,512,1194,+
chr19,17679320,2.3574094556472702,682,472,1154,+
chr19,17688060,2.4985350785750122,739,547,1286,+
chr19,17688239,10.175192695906357,692,401,1093,+
chr19,17688847,3.4692266679694446,819,330,1149,+
chr19,17690303,3.8492866407263295,1348,770,2118,+
chr19,17690304,3.8492866407263295,1348,770,2118,+
chr19,17690305,1.9443826473859847,873,371,1244,+
chr19,17690307,0.49951620706337696,1769,779,2548,+
chr19,17690308,0.5469364231982529,3038,1267,4305,+
chr19,17690310,0.5643290351226471,2928,1267,4195,+
chr19,17690351,0.34168683443520326,1084,741,1825,+
chr19,17690400,12.922344263487748,1443,941,2384,+
chr19,17690411,7.4472446189927695,578,434,1012,+
chr19,17691702,1.3752759381898454,622,452,1074,+
chr19,17691704,1.6674197506129638,839,654,1493,+
chr19,17692053,0.6106188088276968,1079,710,1789,+
chr19,17692196,2.740341419586702,609,476,1085,+
chr19,17692197,2.740341419586702,609,476,1085,+
chr19,17692494,2.6562726613488032,665,393,1058,+
chr19,17692512,1.1326773789234583,1050,755,1805,+
chr19,17692542,0.6500775067308475,995,720,1715,+
chr19,17692565,1.8352841927660024,915,653,1568,+
chr19,17692621,0.6415253344569684,1259,862,2121,+
chr19,17693070,2.0186810339126304,2393,1628,4021,+
chr19,17693180,2.1255506607929515,771,453,1224,+
chr19,17693187,3.016626744446691,2249,1582,3831,+
chr19,17693244,2.5903502667594527,858,478,1336,+
chr19,17693256,0.5001146657493406,670,458,1128,+
chr19,17693259,0.5487778022462013,711,477,1188,+
chr19,17693280,0.6432270303527482,2280,1287,3567,+
chr19,17693281,1.126838988572461,3414,2111,5525,+
chr19,17693303,0.6567394094993583,1278,983,2261,+
chr19,17693328,1.8951862237561117,1786,1158,2944,+
chr19,17693341,1.7761325718685832,4177,2921,7098,+
chr19,17693343,1.7761325718685832,4177,2921,7098,+
chr19,17693689,0.3536094138945462,600,490,1090,+
chr19,17693690,0.636730082496842,1352,907,2259,+
chr19,17693692,1.0878347752399349,1149,658,1807,+
chr19,17693694,2.3487083762408143,948,607,1555,+
chr19,17693832,3.0847710908843906,840,432,1272,+
chr19,17693833,2.8261339640897596,1485,867,2352,+
chr19,17693835,2.0602430161253693,884,475,1359,+
chr19,17693877,1.443182073234164,789,696,1485,+
chr19,17972157,2.305454853005544,1187,733,1920,+
chr19,17972162,1.549730538077368,795,580,1375,+
chr19,17972165,1.6144744025871074,1345,816,2161,+
chr19,17972168,1.5618656631314858,855,473,1328,+
chr19,17972170,0.617085798816568,926,415,1341,+
chr19,17972171,1.6612929668287886,799,630,1429,+
chr19,17972175,0.2572320632088696,1100,825,1925,+
chr19,17972177,1.389246667665119,1545,1213,2758,+
chr19,17972180,1.1879142300194931,1891,1547,3438,+
chr19,17972185,1.4731826669242165,2079,1001,3080,+
chr19,17972187,1.0387865581112037,4656,3562,8218,+
chr19,17972188,1.009092815035023,10045,7960,18005,+
chr19,17972189,1.089569344487464,8070,5869,13939,+
chr19,17972190,1.5281189398836457,5909,2974,8883,+
chr19,17972192,1.4040911797639006,12076,7272,19348,+
chr19,17972216,1.283323838861226,4648,2787,7435,+
chr19,17972218,1.2528262702601418,5408,3123,8531,+
chr19,17972223,1.2742848452489144,12159,8558,20717,+
chr19,17972230,1.3204139952816716,13670,8976,22646,+
chr19,17972231,1.2755706954315393,22017,14000,36017,+
chr19,17972261,1.1892227306786556,12258,8303,20561,+
chr19,17972901,0.7202932293099243,1972,1384,3356,+
chr19,17972990,1.1403406391115525,20243,12632,32875,+
chr19,17973771,1.4835910028214363,20761,12193,32954,+
chr19,17973774,1.6388700710121311,27154,18881,46035,+
chr19,17973776,1.5814070449976052,60764,39201,99965,+
chr19,17973777,1.5593022070597526,47600,30249,77849,+
chr19,18047313,1.4585114063200615,702,436,1138,+
chr19,18053468,2.031243127472713,632,377,1009,+
chr19,18053503,2.2944942381562097,767,496,1263,+
chr19,18053504,2.2944942381562097,767,496,1263,+
chr19,18053536,2.665583546225442,799,572,1371,+
chr19,18053543,1.6144623299037502,904,523,1427,+
chr19,18053549,1.7757892120308227,892,595,1487,+
chr19,18053554,1.7519564140663695,955,672,1627,+
chr19,18053557,1.6641163576549594,3395,2411,5806,+
chr19,18053558,1.820235148514852,2119,1615,3734,+
chr19,18273225,2.672064777327935,758,493,1251,+
chr19,18273227,2.626137841352406,1153,768,1921,+
chr19,18273228,2.400224299065421,782,534,1316,+
chr19,18273231,0.4731420549267351,1036,654,1690,+
chr19,18273233,0.8392449856928228,2063,1395,3458,+
chr19,18273234,1.13291724456773,1130,720,1850,+
chr19,18277947,3.9359599053320338,743,652,1395,+
chr19,18284626,3.836761477854492,789,576,1365,+
chr19,18284628,2.619665361535923,847,598,1445,+
chr19,18284630,1.4165574640160434,724,408,1132,+
chr19,18284637,2.775333128606362,861,506,1367,+
chr19,18284671,3.209743107769423,1321,1063,2384,+
chr19,18284672,3.209743107769423,1321,1063,2384,+
chr19,18284673,3.209743107769423,1321,1063,2384,+
chr19,18284774,1.4516010305483988,985,626,1611,+
chr19,18285859,1.6529962366110202,1141,722,1863,+
chr19,18285860,1.6688199149204348,661,576,1237,+
chr19,18285879,1.5446173388377262,1215,870,2085,+
chr19,18285919,1.3918525703200777,1393,1030,2423,+
chr19,18285997,2.664562219637814,593,462,1055,+
chr19,18286123,1.9549214308275424,1850,1582,3432,+
chr19,18286125,1.8303250106700855,2524,2141,4665,+
chr19,18286490,1.8330876330876331,721,554,1275,+
chr19,18288530,1.0022450527067008,2139,1305,3444,+
chr19,18288531,1.0022450527067008,2139,1305,3444,+
chr19,18288705,2.9339207048458147,591,453,1044,+
chr19,18288784,2.136506582564091,1511,1326,2837,+
chr19,18288857,1.8767217630853996,544,461,1005,+
chr19,18306899,1.7416883603502176,952,638,1590,+
chr19,18306900,1.9169535867646905,1145,797,1942,+
chr19,18499532,1.7658195463073512,713,532,1245,+
chr19,18499533,1.7658195463073512,713,532,1245,+
chr19,18499739,2.410141685309471,605,446,1051,+
chr19,18499740,2.410141685309471,605,446,1051,+
chr19,18499943,0.3319789055070459,767,537,1304,+
chr19,18499944,0.3319789055070459,767,537,1304,+
chr19,18679754,1.1156220878034282,645,486,1131,+
chr19,18682666,0.9073431473877324,17583,7394,24977,+
chr19,18682667,0.8666985250659464,37305,15078,52383,+
chr19,18682668,0.9463580231859731,55744,24381,80125,+
chr19,18682669,0.9733326019321865,66203,30502,96705,+
chr19,18682670,0.9929500252993239,67336,30510,97846,+
chr19,18682672,1.3872115894511552,24008,8840,32848,+
chr19,18682674,1.6216268464898445,33804,15049,48853,+
chr19,18682679,1.2477651687998863,13343,5197,18540,+
chr19,18684195,1.1577269217642354,9794,5871,15665,+
chr19,18684498,1.5076398035333505,10566,6506,17072,+
chr19,18684545,1.2725779587304524,5000,3635,8635,+
chr19,18685765,1.5625547796092625,9210,7198,16408,+
chr19,18685766,1.5625547796092625,9210,7198,16408,+
chr19,18977339,2.825989403550379,770,583,1353,+
chr19,18977340,2.855769230769231,593,479,1072,+
chr19,18977398,0.5591959274246182,713,651,1364,+
chr19,18977401,0.2994806311819775,822,702,1524,+
chr19,18977405,2.5835229858898496,515,506,1021,+
chr19,19037140,3.7076606704103097,835,516,1351,+
chr19,19037144,2.247607602474313,810,616,1426,+
chr19,19627035,0.7314454360199564,490,534,1024,+
chr19,19627038,0.6296296296296297,543,575,1118,+
chr19,19627105,1.6747474747474749,828,714,1542,+
chr19,19627117,1.729342226127241,1633,1021,2654,+
chr19,19637016,1.6016034254999316,878,756,1634,+
chr19,19638097,1.410338973128037,989,898,1887,+
chr19,19638529,1.7092899565641346,856,777,1633,+
chr19,19638555,1.4727260283348165,811,768,1579,+
chr19,19638889,1.8201400107700592,1013,618,1631,+
chr19,19638901,1.655422937208095,1014,657,1671,+
chr19,24010451,0.9691245545837384,1901,1511,3412,+
chr19,24010452,0.7508187302499282,2051,1120,3171,+
chr19,24010453,1.2794756662804172,3158,2588,5746,+
chr19,24010454,1.0090745501247083,5345,2987,8332,+
chr19,24010455,1.3819864620539688,6431,4368,10799,+
chr19,24010456,1.1677510091099688,3294,1867,5161,+
chr19,30103033,0.6214484629466606,688,538,1226,+
chr19,30499932,2.032362754864847,1114,798,1912,+
chr19,30499981,1.7844907407407409,592,431,1023,+
chr19,30500158,1.7802929449084772,661,426,1087,+
chr19,30506465,1.5441176470588236,701,467,1168,+
chr19,32974635,2.3140968968618334,591,470,1061,+
chr19,33075863,1.796042617960426,589,437,1026,+
chr19,33075864,0.488828967642527,845,589,1434,+
chr19,33075867,1.4815038930625568,2799,2068,4867,+
chr19,33075868,1.8509263799756945,1907,1512,3419,+
chr19,33075869,1.8509263799756945,1907,1512,3419,+
chr19,33075870,0.5096462264150944,1028,799,1827,+
chr19,33075881,1.5682206398514105,2339,1780,4119,+
chr19,33078172,1.7533963926368992,1426,1026,2452,+
chr19,33870680,2.718781539590788,925,518,1443,+
chr19,33870682,2.2992414780712753,892,558,1450,+
chr19,33872663,2.237717908082409,705,630,1335,+
chr19,33872664,2.237717908082409,705,630,1335,+
chr19,34663642,1.2743723850565571,670,517,1187,+
chr19,34710343,8.882770300315482,926,218,1144,+
chr19,34710347,9.945726954685977,2032,562,2594,+
chr19,34710348,10.034610419058643,2409,687,3096,+
chr19,34710350,20.581508483625438,2475,1148,3623,+
chr19,34710351,15.982741935952212,3149,3561,6710,+
chr19,34710352,8.348453210417725,4088,5918,10006,+
chr19,34710353,6.86629428075417,3710,6433,10143,+
chr19,34710354,5.950478946441346,2894,6166,9060,+
chr19,34710355,3.4431770760884683,668,2053,2721,+
chr19,34710359,0.2002677511715326,731,2098,2829,+
chr19,34710361,0.242156790407836,784,2025,2809,+
chr19,34710385,0.0812655086848635,392,743,1135,+
chr19,34710390,0.177240866457773,1101,2039,3140,+
chr19,34712620,7.770935944791342,777,672,1449,+
chr19,34718290,1.4613580990827812,1065,842,1907,+
chr19,34856238,2.844267726971504,887,502,1389,+
chr19,34856241,1.88474025974026,773,615,1388,+
chr19,34856286,2.1903044293752707,968,716,1684,+
chr19,34857285,1.8565631469979291,1018,804,1822,+
chr19,34857690,1.6468428955012702,1646,1003,2649,+
chr19,34857723,1.8912599028878097,778,601,1379,+
chr19,34857724,1.8690285714285717,961,624,1585,+
chr19,34857736,1.515192631881913,856,736,1592,+
chr19,34857738,1.5147758152173914,990,639,1629,+
chr19,34857744,0.5816457793817531,1576,1208,2784,+
chr19,34859551,2.4816155458182507,1001,723,1724,+
chr19,34868444,1.5274037807697538,1020,773,1793,+
chr19,34868657,1.7972440944881891,995,761,1756,+
chr19,34868665,1.4642322097378278,1116,889,2005,+
chr19,34884163,18.691121120203796,3672,2319,5991,+
chr19,34884197,1.5676371086863294,939,676,1615,+
chr19,34884936,1.5492074705285002,815,780,1595,+
chr19,34887225,1.6156524371783227,820,733,1553,+
chr19,34887226,1.5640673981191224,886,637,1523,+
chr19,34887227,1.5748333333333335,858,599,1457,+
chr19,34887230,1.7665723047888655,880,627,1507,+
chr19,34887238,0.6209166913787986,1829,1398,3227,+
chr19,34887244,1.503716425474407,936,825,1761,+
chr19,34887305,1.7246928156019066,961,692,1653,+
chr19,34887313,1.5992955669889437,2243,1531,3774,+
chr19,34887490,0.5072804659498209,1293,991,2284,+
chr19,34887491,0.5072804659498209,1293,991,2284,+
chr19,34887494,1.7673767885532592,1157,924,2081,+
chr19,34890157,1.6428908833254603,1701,1333,3034,+
chr19,34890158,1.0440760828049804,2039,1234,3273,+
chr19,34890159,1.332137618365332,3740,2567,6307,+
chr19,34890181,1.9547422472815141,902,763,1665,+
chr19,34890233,1.7400858955407765,2192,1775,3967,+
chr19,34890470,2.091656244416652,1017,771,1788,+
chr19,34890471,1.756359454004692,4636,3546,8182,+
chr19,34890831,1.0993709483599066,2059,1722,3781,+
chr19,34890850,1.892982456140351,1244,854,2098,+
chr19,34891096,1.3697103494289327,839,535,1374,+
chr19,34891097,2.3099908060067427,669,501,1170,+
chr19,34891099,3.546226415037815,836,589,1425,+
chr19,34891111,0.4354409416218135,817,637,1454,+
chr19,34891112,0.4354409416218135,817,637,1454,+
chr19,34891140,1.6273894436519258,867,700,1567,+
chr19,34900404,1.0300632911392404,650,394,1044,+
chr19,34900405,1.0300632911392404,650,394,1044,+
chr19,34912530,2.6581563705891176,559,448,1007,+
chr19,34919393,7.2929072801649975,1146,247,1393,+
chr19,34919395,6.008323133414933,943,214,1157,+
chr19,34919397,5.3485876367443606,1043,268,1311,+
chr19,34919398,5.222552428502086,1210,246,1456,+
chr19,34919407,8.151733852576768,2511,892,3403,+
chr19,34919408,9.681929940419472,4227,1387,5614,+
chr19,34919409,9.746933749403963,3953,1340,5293,+
chr19,34919410,10.063921276510971,2689,925,3614,+
chr19,34919413,27.304161401143535,2285,1857,4142,+
chr19,34919414,22.324713741259732,2595,2207,4802,+
chr19,34919416,6.245979630125972,904,1065,1969,+
chr19,34919417,9.34013946503665,1565,1859,3424,+
chr19,34919421,0.2912525254009363,616,773,1389,+
chr19,34919423,0.4554679992312128,696,604,1300,+
chr19,34919425,0.4554679992312128,696,604,1300,+
chr19,34919432,0.5273554759368645,777,897,1674,+
chr19,34919433,0.2929856982162944,560,507,1067,+
chr19,34919434,0.509695642623761,1706,1891,3597,+
chr19,34919435,0.5808236244331709,1896,2025,3921,+
chr19,34919436,0.6074299694632147,5168,5252,10420,+
chr19,34919437,0.6114819270955284,4754,4782,9536,+
chr19,34919438,0.6385154901295118,1636,1657,3293,+
chr19,34919454,0.48245520244064294,2142,1963,4105,+
chr19,34919460,0.5548956370874178,1408,1286,2694,+
chr19,34919464,0.5231467772184385,1059,920,1979,+
chr19,34921076,2.532826169385627,764,498,1262,+
chr19,34921482,1.3436636188038948,2493,1932,4425,+
chr19,34921488,0.7744216744370819,9786,6867,16653,+
chr19,34921499,1.2138901094035204,16301,11423,27724,+
chr19,34921500,1.6452505344065194,8613,6414,15027,+
chr19,34921503,1.4217065790531782,16217,11934,28151,+
chr19,34921504,1.3522295225137229,17953,12759,30712,+
chr19,34921511,1.684597383491083,24994,18386,43380,+
chr19,34921513,1.4449530484222126,44275,29838,74113,+
chr19,34921514,1.325974477271833,13970,8302,22272,+
chr19,34925824,2.591735537190083,783,604,1387,+
chr19,34925853,2.287212810396844,1145,694,1839,+
chr19,34925868,1.92834595959596,1191,791,1982,+
chr19,34935942,0.6004329362779309,1268,928,2196,+
chr19,34941234,2.349933637255468,1850,1208,3058,+
chr19,34942904,1.6489554067261676,4627,3569,8196,+
chr19,34942905,1.061865189289012,3149,1994,5143,+
chr19,34942906,1.826744094964787,4706,3803,8509,+
chr19,34942907,1.3024964590115637,12142,9140,21282,+
chr19,34942909,1.2884093244532968,12631,10295,22926,+
chr19,34942910,1.4778738512286207,9560,8275,17835,+
chr19,34942911,1.4969388044561696,7715,7082,14797,+
chr19,34942912,1.4693905396693283,5927,5513,11440,+
chr19,34942915,1.387949565918642,12109,9380,21489,+
chr19,34942916,1.4494041530756887,16812,13949,30761,+
chr19,34945176,1.7721250662427133,835,628,1463,+
chr19,34945372,2.3271604938271606,662,458,1120,+
chr19,34945387,2.4885657820440428,1036,615,1651,+
chr19,34945391,1.6038575667655786,1080,673,1753,+
chr19,34949681,1.4578254509995123,1655,1171,2826,+
chr19,34949686,2.374120956399437,843,710,1553,+
chr19,34949704,1.640953716690042,818,712,1530,+
chr19,34949812,1.5324660633484164,1425,883,2308,+
chr19,34949821,1.582424376241996,1557,1293,2850,+
chr19,34954934,2.126333403053754,883,682,1565,+
chr19,34954965,1.6549307525446353,1391,921,2312,+
chr19,34957832,0.4275992438563327,753,459,1212,+
chr19,34957846,0.4844875209433264,1547,971,2518,+
chr19,34959947,1.593442967477539,4459,2718,7177,+
chr19,34959948,1.593442967477539,4459,2718,7177,+
chr19,34959953,0.5925955684110914,1618,1142,2760,+
chr19,34959997,0.7889484466646085,3798,2740,6538,+
chr19,34959998,1.3501291989664084,3343,2159,5502,+
chr19,34960024,1.5952555301921143,8227,5872,14099,+
chr19,34960208,1.9165994101512158,2291,1752,4043,+
chr19,34960278,1.8096774193548388,968,759,1727,+
chr19,34960452,1.6582534073700153,1313,848,2161,+
chr19,34960519,1.4197662061636558,1335,940,2275,+
chr19,34960653,1.510301968635302,1477,887,2364,+
chr19,35646479,2.2744320110322946,996,795,1791,+
chr19,35648324,0.4757832050429219,750,618,1368,+
chr19,35648331,2.345308924485126,830,689,1519,+
chr19,35648336,1.7824766782513262,936,780,1716,+
chr19,35649259,1.777777777777778,1679,1259,2938,+
chr19,35649272,1.4309591258599756,1860,1411,3271,+
chr19,35649278,2.335821535821536,1327,665,1992,+
chr19,35649280,1.02790893085002,4901,3112,8013,+
chr19,35649298,1.5232091262897929,18226,11534,29760,+
chr19,35649299,1.544635712101539,11005,6852,17857,+
chr19,35649300,1.5602925731018589,15061,9206,24267,+
chr19,35651612,1.2492195963618007,8398,5857,14255,+
chr19,35651619,0.6203239289446186,2297,1594,3891,+
chr19,35651620,1.2170521750084928,13420,9664,23084,+
chr19,35651625,1.6155263703806306,14455,10743,25198,+
chr19,35651626,1.724511054765096,13109,9866,22975,+
chr19,35657210,4.046863468634687,996,541,1537,+
chr19,35657212,4.046863468634687,996,541,1537,+
chr19,35660473,1.732079303643672,893,737,1630,+
chr19,35761700,3.757044673539519,840,581,1421,+
chr19,35769617,7.927774971660057,1892,1436,3328,+
chr19,35769618,5.512171645682405,2485,1919,4404,+
chr19,35769869,1.9345546721972575,1459,788,2247,+
chr19,35769870,1.9345546721972575,1459,788,2247,+
chr19,35769877,2.446703208983024,1641,988,2629,+
chr19,35769879,2.1689349751566214,2509,1542,4051,+
chr19,35769881,2.035169895204827,1708,1071,2779,+
chr19,35769902,1.11697835702392,2183,1545,3728,+
chr19,35769927,1.7298405588676606,3630,2842,6472,+
chr19,35769929,1.5870737968800863,7685,5950,13635,+
chr19,35769930,1.8189233720939095,5702,4342,10044,+
chr19,35770547,6.253942809461929,619,429,1048,+
chr19,35770548,6.415283221546338,715,535,1250,+
chr19,36036653,0.4293441514536849,634,492,1126,+
chr19,36036654,0.4293441514536849,634,492,1126,+
chr19,36036690,1.898307465411897,794,490,1284,+
chr19,36036704,0.8381271837875611,936,794,1730,+
chr19,36036705,0.8381271837875611,936,794,1730,+
chr19,36036809,1.0969469309462916,1799,1087,2886,+
chr19,36036810,1.0969469309462916,1799,1087,2886,+
chr19,36036842,1.87958435207824,614,408,1022,+
chr19,36037433,2.577449168207024,746,540,1286,+
chr19,36037579,2.068762278978389,662,508,1170,+
chr19,36037607,0.451417004048583,668,455,1123,+
chr19,36037613,1.874143302180685,657,534,1191,+
chr19,36037614,0.44599056637961304,1609,1103,2712,+
chr19,36037658,0.5668137687555164,844,514,1358,+
chr19,36037881,1.6276709401709402,830,467,1297,+
chr19,36038054,2.060412224591329,668,468,1136,+
chr19,36038073,0.6203115289778081,1066,600,1666,+
chr19,36038252,3.206386292834891,715,427,1142,+
chr19,36120537,2.206680868223578,830,528,1358,+
chr19,36120547,0.35761018749269996,673,573,1246,+
chr19,36120548,2.0740010289830217,1272,685,1957,+
chr19,36120549,2.0740010289830217,1272,685,1957,+
chr19,36124589,2.5354330708661417,1103,761,1864,+
chr19,36124590,2.3257057703740474,1506,1117,2623,+
chr19,36124594,2.301606845160864,1427,1253,2680,+
chr19,36124596,2.607298910152761,1404,1347,2751,+
chr19,36124599,2.078853046594982,579,557,1136,+
chr19,36125174,2.0150076980676612,848,559,1407,+
chr19,36125176,2.9979477671220693,657,532,1189,+
chr19,36128158,2.8463056263174558,1051,817,1868,+
chr19,36128378,0.9791603853015469,1402,998,2400,+
chr19,36139224,0.5168251112578388,1037,570,1607,+
chr19,36139233,1.5385445986509403,1396,764,2160,+
chr19,36139237,1.647114495082934,1618,947,2565,+
chr19,36139253,1.7058057797448587,727,500,1227,+
chr19,36139257,1.4482141174253134,1396,785,2181,+
chr19,36139275,1.5258215962441315,1984,1190,3174,+
chr19,36142172,1.6688158678370753,1695,1225,2920,+
chr19,36142226,1.423909664885867,2422,2058,4480,+
chr19,36145520,1.6910569105691058,2309,1844,4153,+
chr19,36149498,0.4007497899295456,1549,1145,2694,+
chr19,36149541,1.4084351730802025,1608,1204,2812,+
chr19,36149547,0.7049808429118775,1503,1268,2771,+
chr19,36149611,2.6970001675884028,846,701,1547,+
chr19,36236831,2.5634281718281717,861,539,1400,+
chr19,36236832,2.5634281718281717,861,539,1400,+
chr19,36616410,0.6905263157894737,655,569,1224,+
chr19,36616411,0.6905263157894737,655,569,1224,+
chr19,36616412,0.5974807139563627,1038,829,1867,+
chr19,36632077,3.9517439362550255,1129,830,1959,+
chr19,36632078,4.548041152304051,1626,1403,3029,+
chr19,36632079,3.3302325581395347,1073,644,1717,+
chr19,36632080,3.73562951331922,1553,1532,3085,+
chr19,36632081,4.9627016942580955,952,997,1949,+
chr19,36632103,1.0789697719775964,601,912,1513,+
chr19,36632104,0.3228100766301105,669,1146,1815,+
chr19,36632106,0.3283154121863799,457,774,1231,+
chr19,36633572,1.6698564593301437,697,417,1114,+
chr19,36633608,1.857928765880218,696,607,1303,+
chr19,36636737,0.6578359043147776,1069,851,1920,+
chr19,36637119,2.190420899854862,1077,794,1871,+
chr19,36640515,1.6767753786434687,819,670,1489,+
chr19,36640836,0.5324814557255448,798,718,1516,+
chr19,36640909,1.215822898494915,1748,1189,2937,+
chr19,36726657,1.2860599633232008,3612,3224,6836,+
chr19,36726658,1.2860599633232008,3612,3224,6836,+
chr19,36726659,1.3275684227343811,4242,3640,7882,+
chr19,36726902,2.0975989328590487,764,518,1282,+
chr19,36727522,0.3311802701115678,751,523,1274,+
chr19,36727630,1.7383820998278827,605,414,1019,+
chr19,36728069,3.5763475462590506,716,564,1280,+
chr19,36728070,3.5763475462590506,716,564,1280,+
chr19,36728285,2.1160907635815835,724,558,1282,+
chr19,36728464,1.5348131548299178,1190,823,2013,+
chr19,36728476,2.707714596160812,533,501,1034,+
chr19,36728526,2.1910768822201567,568,442,1010,+
chr19,36729110,2.2229515296340887,2158,1559,3717,+
chr19,36729117,2.177205882352941,944,849,1793,+
chr19,36729177,1.9872823805408075,869,622,1491,+
chr19,36729185,2.4128845267110206,813,798,1611,+
chr19,36729192,2.0734611824789204,1870,1768,3638,+
chr19,36729311,8.93547111619908,1385,320,1705,+
chr19,36729313,12.249197860962568,880,186,1066,+
chr19,36729316,9.839302946194149,3398,817,4215,+
chr19,36729317,9.05485505498316,4397,1101,5498,+
chr19,36729318,8.2310386953311,5182,1303,6485,+
chr19,36729320,18.956828534180193,3177,1144,4321,+
chr19,36729321,18.611714395917282,5889,4015,9904,+
chr19,36729322,18.61171439591728,5889,4015,9904,+
chr19,36729323,18.394947183131322,5104,3813,8917,+
chr19,36729336,7.656975043835851,5671,8837,14508,+
chr19,36729337,7.656975043835851,5671,8837,14508,+
chr19,36729338,7.656975043835851,5671,8837,14508,+
chr19,38795032,1.2519638563442836,879,572,1451,+
chr19,38795062,1.3874310915104742,1572,906,2478,+
chr19,38795063,1.3874310915104742,1572,906,2478,+
chr19,38795064,1.3874310915104742,1572,906,2478,+
chr19,38795318,1.8915343915343918,714,485,1199,+
chr19,38795323,1.51725,577,499,1076,+
chr19,38865427,0.8800007436192328,674,531,1205,+
chr19,38865560,0.46666666666666673,769,549,1318,+
chr19,38865561,0.46666666666666673,769,549,1318,+
chr19,38866814,0.5943061196460455,1164,808,1972,+
chr19,38866821,2.587114078639502,1192,648,1840,+
chr19,38867070,2.1897911832946635,725,430,1155,+
chr19,38867085,1.870253164556962,787,473,1260,+
chr19,38870002,2.02701561840439,685,411,1096,+
chr19,38872800,1.6182487725040915,677,610,1287,+
chr19,38874057,5.2514708336649605,971,638,1609,+
chr19,39109833,0.771056598597047,1414,831,2245,+
chr19,39109834,1.1056967981950592,1281,689,1970,+
chr19,39109836,2.498931297709924,743,392,1135,+
chr19,39109842,3.078468134895996,878,576,1454,+
chr19,39109866,1.9335575139146568,666,391,1057,+
chr19,39109901,3.286764705882353,893,559,1452,+
chr19,39111048,2.0511049723756902,674,542,1216,+
chr19,39114760,0.6498961388074292,924,527,1451,+
chr19,39114783,1.77343408028369,1513,1052,2565,+
chr19,39123085,1.76541671857481,765,697,1462,+
chr19,39123275,0.5396924178615881,1710,1317,3027,+
chr19,39123277,0.5396924178615881,1710,1317,3027,+
chr19,39125657,0.5505452821242295,682,569,1251,+
chr19,39125658,2.064705882352941,584,499,1083,+
chr19,39125707,2.4049559102578417,566,526,1092,+
chr19,39125711,1.7407442657276102,589,552,1141,+
chr19,39138367,4.008110498044653,606,722,1328,+
chr19,39138475,0.9590349667413373,1470,1056,2526,+
chr19,39138476,1.088961038961039,1031,879,1910,+
chr19,39138516,0.5412974122651542,1017,805,1822,+
chr19,39138524,1.744863327829756,1086,473,1559,+
chr19,39138529,1.434367029131427,1302,572,1874,+
chr19,39138530,1.3564489043899188,3217,2123,5340,+
chr19,39138531,0.6736221712331849,1740,1194,2934,+
chr19,39138532,1.3543736332818355,4864,2889,7753,+
chr19,39138537,1.773142112125163,1903,909,2812,+
chr19,39138539,1.2658702734722085,2136,1446,3582,+
chr19,39191238,1.0879817249717858,3088,2224,5312,+
chr19,39191239,1.168804780876494,2666,2007,4673,+
chr19,39191291,1.3166293930736848,846,608,1454,+
chr19,39196739,1.8414322250639386,749,424,1173,+
chr19,39198791,1.5683168316831684,743,504,1247,+
chr19,39207792,1.7662823763727846,902,619,1521,+
chr19,39208696,2.612921033108529,672,413,1085,+
chr19,39214658,1.176342377374824,651,522,1173,+
chr19,39214800,2.3116089899106687,950,653,1603,+
chr19,39214818,1.7787570610822148,993,656,1649,+
chr19,39214877,2.1852719969655454,646,501,1147,+
chr19,39214953,1.480673649885209,1189,825,2014,+
chr19,39215169,0.5218837535014006,812,407,1219,+
chr19,39215170,2.246823956442831,618,550,1168,+
chr19,39217702,1.3796440700303756,572,476,1048,+
chr19,39219759,3.620127688172043,742,495,1237,+
chr19,39219761,3.620127688172043,742,495,1237,+
chr19,39220158,0.3415263344775847,866,463,1329,+
chr19,39220196,25.58009690631869,1424,105,1529,+
chr19,39220198,32.95761541817065,2125,184,2309,+
chr19,39220199,27.337845274144485,1899,181,2080,+
chr19,39220200,27.337845274144485,1899,181,2080,+
chr19,39220201,16.59119496855346,1318,158,1476,+
chr19,39220203,10.382382875816203,1574,277,1851,+
chr19,39220204,19.561248706965504,898,238,1136,+
chr19,39220205,14.269216362628672,1896,417,2313,+
chr19,39220208,9.161249875076354,1927,704,2631,+
chr19,39220209,9.627731334638943,2255,803,3058,+
chr19,39220210,9.627731334638943,2255,803,3058,+
chr19,39220214,13.259955790934821,2333,1463,3796,+
chr19,39220215,13.259955790934821,2333,1463,3796,+
chr19,39220216,13.259955790934821,2333,1463,3796,+
chr19,39220220,17.50026871469155,1555,1607,3162,+
chr19,39220222,17.50026871469155,1555,1607,3162,+
chr19,39220278,1.010843692144935,440,596,1036,+
chr19,39220280,1.010843692144935,440,596,1036,+
chr19,39220755,0.8582375478927202,671,431,1102,+
chr19,39220757,0.8582375478927202,671,431,1102,+
chr19,39221024,4.334186540220794,2133,1493,3626,+
chr19,39221025,3.8814115177751543,1137,725,1862,+
chr19,39221026,3.8814115177751543,1137,725,1862,+
chr19,39423379,3.125653694893664,616,558,1174,+
chr19,39966766,1.3929236499068902,747,357,1104,+
chr19,39966767,1.3929236499068902,747,357,1104,+
chr19,39966768,1.3929236499068902,747,357,1104,+
chr19,39978778,2.1032412283639346,790,563,1353,+
chr19,40477080,1.3561328465509939,695,434,1129,+
chr19,40477088,1.4639863284763446,838,509,1347,+
chr19,40477089,1.4639863284763446,838,509,1347,+
chr19,40486256,1.1479156202913108,652,361,1013,+
chr19,40486258,1.1479156202913108,652,361,1013,+
chr19,40486264,2.3556043079377744,761,435,1196,+
chr19,40486266,2.3556043079377744,761,435,1196,+
chr19,40487129,1.9884057971014493,538,505,1043,+
chr19,40487153,0.556401384083045,602,509,1111,+
chr19,40487176,2.169802396438951,1302,863,2165,+
chr19,40487233,1.6771080760095012,1026,841,1867,+
chr19,40487254,3.401785714285714,634,447,1081,+
chr19,40487258,2.7769252628587666,697,390,1087,+
chr19,40487267,2.118344384167169,810,473,1283,+
chr19,40487274,1.0110733778484668,2772,2213,4985,+
chr19,40487280,0.7471190145042719,1156,718,1874,+
chr19,40487287,2.11737623226086,2521,2171,4692,+
chr19,40487288,2.11737623226086,2521,2171,4692,+
chr19,40854647,10.45032113662904,848,552,1400,+
chr19,40854659,12.441280139641279,1142,763,1905,+
chr19,40872777,0.5595287107183889,940,693,1633,+
chr19,40877718,1.326341707598749,746,571,1317,+
chr19,40880411,2.2223884114196615,794,606,1400,+
chr19,40882570,4.353185768876485,852,589,1441,+
chr19,40883729,1.188857324088676,829,665,1494,+
chr19,41257253,1.568306010928962,737,548,1285,+
chr19,41257267,2.0502657555049355,586,438,1024,+
chr19,41257284,0.4983778754397316,2718,1779,4497,+
chr19,41257285,0.540472506408628,1613,1006,2619,+
chr19,41257318,1.4990196949531656,2420,1657,4077,+
chr19,41263263,1.8372941176470587,678,424,1102,+
chr19,41263383,3.8369095059111467,1053,757,1810,+
chr19,41271207,5.669131957960295,661,366,1027,+
chr19,41271209,5.669131957960295,661,366,1027,+
chr19,41765487,2.553502096116417,1472,1141,2613,+
chr19,41765488,2.572627737226277,1112,821,1933,+
chr19,41778067,1.7522205197233462,720,493,1213,+
chr19,41779896,2.4865023084726157,829,519,1348,+
chr19,41779916,2.54185520361991,748,441,1189,+
chr19,41779919,2.5335628227194493,735,414,1149,+
chr19,41779922,0.5918483845187806,863,460,1323,+
chr19,41779927,1.8931297709923662,991,523,1514,+
chr19,41779933,1.7468239564428314,824,569,1393,+
chr19,41779935,1.7707668504013152,1381,765,2146,+
chr19,41779936,1.5539122396824534,1298,693,1991,+
chr19,41779942,2.044348793345262,1030,712,1742,+
chr19,41782129,2.392093741454063,609,494,1103,+
chr19,41800544,2.034885586649056,841,596,1437,+
chr19,41800584,2.0435603624671153,1075,738,1813,+
chr19,41810091,1.0760603386890397,674,463,1137,+
chr19,41812372,0.3890105263157894,856,644,1500,+
chr19,41812374,0.9990344989991757,625,567,1192,+
chr19,41813056,5.9436745189296865,1352,1101,2453,+
chr19,41813158,1.323247988375492,977,698,1675,+
chr19,41813346,13.386121443505333,941,628,1569,+
chr19,41813347,14.405404782353221,1647,1232,2879,+
chr19,41813348,14.405404782353221,1647,1232,2879,+
chr19,41813349,11.88417208906993,1467,1193,2660,+
chr19,42364323,0.8681462243668795,6809,2768,9577,+
chr19,42364324,0.9344021518428876,19263,8101,27364,+
chr19,42364325,1.030908107602839,6353,3652,10005,+
chr19,42364326,1.0000310294255703,27061,10625,37686,+
chr19,42364327,1.7820603753376434,30878,12932,43810,+
chr19,42364329,1.8780944080394146,21866,7658,29524,+
chr19,42364331,1.9132846102866057,20450,7713,28163,+
chr19,42364332,2.0014926456995146,15253,6171,21424,+
chr19,42364335,1.508118832558868,2384,1610,3994,+
chr19,42364348,1.8265907796244287,3020,2326,5346,+
chr19,42364349,2.170381410473545,7433,3053,10486,+
chr19,42364851,1.2731533232315706,4959,3975,8934,+
chr19,42364852,1.5024900618119315,15672,8318,23990,+
chr19,42364858,1.2729428326527799,38813,21926,60739,+
chr19,42364859,1.1730737666985804,45911,26496,72407,+
chr19,42364860,1.2669728273515928,32622,16764,49386,+
chr19,42364910,1.3111923391728983,18119,12751,30870,+
chr19,42365194,1.2398474106561574,27523,20232,47755,+
chr19,42373163,1.249714720126672,6154,4521,10675,+
chr19,42373177,1.175707128099173,8042,4839,12881,+
chr19,42373256,1.3038673110696917,22136,15631,37767,+
chr19,42373257,1.3996481823971691,21919,16941,38860,+
chr19,42373258,1.2160214852281899,38898,30248,69146,+
chr19,42373259,1.3044147140211315,35930,26695,62625,+
chr19,42373267,1.356540684360278,13387,11389,24776,+
chr19,42373268,1.356540684360278,13387,11389,24776,+
chr19,42373277,1.1983118560778465,24515,18892,43407,+
chr19,42373804,0.8589984511228166,7218,6098,13316,+
chr19,42373808,1.3863682193990725,6874,6497,13371,+
chr19,42406147,2.007627024211655,675,416,1091,+
chr19,42406443,2.7762791379563114,652,358,1010,+
chr19,42407008,3.549973835688122,1023,727,1750,+
chr19,42407009,3.549973835688122,1023,727,1750,+
chr19,42407010,3.1493439423953022,1162,824,1986,+
chr19,45165339,3.8447689508114085,726,541,1267,+
chr19,45166550,2.3529725932562977,1438,824,2262,+
chr19,45166554,3.049545587804163,742,378,1120,+
chr19,45166555,2.6057030481809247,847,451,1298,+
chr19,45166568,2.146643109540636,944,565,1509,+
chr19,45166574,0.6299490950226244,989,543,1532,+
chr19,45166575,2.386154461784714,1067,713,1780,+
chr19,45166581,2.020010744023637,1156,656,1812,+
chr19,46857213,1.525270911806166,710,414,1124,+
chr19,46878870,2.6396095239930197,2836,2022,4858,+
chr19,46878872,2.3087034824768398,2916,2141,5057,+
chr19,46878873,2.0980164782779678,1434,1122,2556,+
chr19,47111572,2.2426261365830866,699,482,1181,+
chr19,47113043,4.188771468335296,583,553,1136,+
chr19,47113380,3.488940957171396,660,459,1119,+
chr19,47634216,2.7173198636806233,663,364,1027,+
chr19,47653610,0.4488458250213736,524,483,1007,+
chr19,47653620,0.23966613672496018,602,543,1145,+
chr19,47656206,2.1206008583690985,731,465,1196,+
chr19,47656213,2.702713708732262,1144,802,1946,+
chr19,47673091,2.486595409146662,616,438,1054,+
chr19,47700519,1.894736842105263,611,417,1028,+
chr19,47712630,2.4893837537049652,1061,755,1816,+
chr19,47713006,2.4993380163206487,677,492,1169,+
chr19,47713275,1.5116640791764437,674,533,1207,+
chr19,47713283,0.44779502252852826,625,515,1140,+
chr19,47813116,1.1051192479017964,1428,1440,2868,+
chr19,47813117,0.9367883401909374,2261,2165,4426,+
chr19,47823124,2.876489707475623,589,425,1014,+
chr19,47823247,3.1827007943512795,600,411,1011,+
chr19,47823248,3.1827007943512795,600,411,1011,+
chr19,47823321,2.6208740371128205,630,415,1045,+
chr19,47823819,2.8488372093023258,636,429,1065,+
chr19,47823820,2.8488372093023258,636,429,1065,+
chr19,47823968,2.048141290414471,718,412,1130,+
chr19,47823969,2.048141290414471,718,412,1130,+
chr19,47824033,1.7857002325068843,806,619,1425,+
chr19,47824352,1.5759420082789914,660,509,1169,+
chr19,47824356,0.5021691430088302,614,422,1036,+
chr19,47824357,1.986183719193428,590,411,1001,+
chr19,47824359,1.986183719193428,590,411,1001,+
chr19,47824365,1.239912060110846,917,661,1578,+
chr19,47824420,1.5891301753967308,682,577,1259,+
chr19,47824774,3.9068915019821757,1157,972,2129,+
chr19,47824775,3.0424418094121735,2318,1738,4056,+
chr19,47824776,2.2665362442213906,1819,1341,3160,+
chr19,47824812,1.0766541822721598,587,444,1031,+
chr19,47824814,0.8816706231623509,857,700,1557,+
chr19,47824831,0.47449507363478455,839,614,1453,+
chr19,47824891,1.9627822867140836,915,721,1636,+
chr19,47825151,3.3402814222091632,616,450,1066,+
chr19,47825152,2.8426384158546987,757,535,1292,+
chr19,47846487,1.3843878381636459,677,567,1244,+
chr19,47846489,0.2164810690423163,566,448,1014,+
chr19,47856963,1.7972473721826208,960,684,1644,+
chr19,47856966,2.5890060491010147,1062,807,1869,+
chr19,48248856,2.3285931174089067,978,759,1737,+
chr19,48248858,2.6410831715742877,1344,1119,2463,+
chr19,48248940,0.464872934798893,770,545,1315,+
chr19,48248946,2.3250040220887676,1043,707,1750,+
chr19,48249000,1.6315384615384618,706,389,1095,+
chr19,48249006,2.7707591851026243,1117,845,1962,+
chr19,48249022,1.8859705131225173,1927,1203,3130,+
chr19,48249024,1.8504348309299545,1416,836,2252,+
chr19,48249027,2.4321218933433246,748,470,1218,+
chr19,48250248,1.5266512373152927,793,684,1477,+
chr19,48250279,0.5811188207180491,840,738,1578,+
chr19,48253481,2.1264908633329687,947,702,1649,+
chr19,48254223,2.060377358490566,545,476,1021,+
chr19,48254321,2.0701287793952967,642,375,1017,+
chr19,48254340,1.778950145080454,561,445,1006,+
chr19,48254833,2.309073769067544,1008,850,1858,+
chr19,48255837,0.9786386788084582,1293,1044,2337,+
chr19,48255839,0.9786386788084582,1293,1044,2337,+
chr19,48258047,2.791165203175698,559,447,1006,+
chr19,48258054,4.615276969022032,2249,2002,4251,+
chr19,48258055,4.3838833774491786,2515,2261,4776,+
chr19,48258056,4.346394030750791,3058,2513,5571,+
chr19,48258058,3.48046875,809,511,1320,+
chr19,48258738,3.4271425741213695,1332,1025,2357,+
chr19,48258739,3.096688732440097,1871,1416,3287,+
chr19,48258740,3.0966887324400965,1871,1416,3287,+
chr19,48258743,4.293473202247982,832,655,1487,+
chr19,48259014,1.2181672951624536,930,589,1519,+
chr19,48259025,0.5275636562392644,939,746,1685,+
chr19,48259026,1.64532744665195,558,452,1010,+
chr19,48259055,1.044857789856807,1944,1248,3192,+
chr19,48259067,1.5998520710059174,926,675,1601,+
chr19,48259075,2.7656872877602248,668,520,1188,+
chr19,48259954,0.9880033124353836,2247,1835,4082,+
chr19,48442799,0.9848506967679396,644,647,1291,+
chr19,48830843,0.4515292048178977,569,472,1041,+
chr19,48832739,2.334082397003745,655,355,1010,+
chr19,49407667,1.183874576219004,711,548,1259,+
chr19,49421987,3.7771392081736908,844,521,1365,+
chr19,49422289,1.7260538296864771,3409,2679,6088,+
chr19,49422290,1.8321213778020775,2310,1859,4169,+
chr19,49422293,1.5591329699581695,1311,1126,2437,+
chr19,49424458,0.2336647727272727,563,527,1090,+
chr19,49424459,0.2336647727272727,563,527,1090,+
chr19,49425180,1.3223947324986363,1072,739,1811,+
chr19,49425181,0.8038834951456311,666,514,1180,+
chr19,49425630,0.5688466433042442,904,633,1537,+
chr19,49426115,1.2570048623321355,721,565,1286,+
chr19,49426351,2.765134298517126,709,487,1196,+
chr19,49458200,2.817379816511956,580,506,1086,+
chr19,49458201,2.817379816511956,580,506,1086,+
chr19,49468565,1.078754145045172,1873,1146,3019,+
chr19,49468567,1.078754145045172,1873,1146,3019,+
chr19,49468589,1.3739049209781302,7592,5182,12774,+
chr19,49468591,1.4562972822159408,7822,5605,13427,+
chr19,49468592,1.4226476257554563,8302,5770,14072,+
chr19,49468596,1.325023169601483,3363,2489,5852,+
chr19,49468599,1.3964702557054443,9812,7731,17543,+
chr19,49468693,1.12696752590418,25537,18754,44291,+
chr19,49468724,1.1785906401291015,6572,5147,11719,+
chr19,49468783,0.8858804334183994,14704,11274,25978,+
chr19,49469032,1.0518796354248132,19836,14984,34820,+
chr19,49469033,1.1867874529049796,13501,8188,21689,+
chr19,49469125,1.0726804260359113,13575,9944,23519,+
chr19,49469126,1.30877889239065,8637,5644,14281,+
chr19,49469170,1.2595253283691052,17970,12244,30214,+
chr19,49469598,1.2688144011228728,58797,39744,98541,+
chr19,49469599,1.2494944643704757,70847,49003,119850,+
chr19,49469600,1.224621320401,32388,18802,51190,+
chr19,49469629,0.8833586857316701,12851,7694,20545,+
chr19,49469868,1.5050243440138324,5174,3994,9168,+
chr19,49469979,1.4809487961752317,5228,3806,9034,+
chr19,49502588,2.2730441272286734,567,451,1018,+
chr19,49510311,0.8144711465667382,713,417,1130,+
chr19,49510568,2.528947368421053,712,379,1091,+
chr19,49510569,2.528947368421053,712,379,1091,+
chr19,49510593,1.5372874804283,621,568,1189,+
chr19,49513764,1.2800091035524108,959,611,1570,+
chr19,49513777,0.9923365655301847,1409,833,2242,+
chr19,49513779,0.9923365655301847,1409,833,2242,+
chr19,49518850,1.7157453958862818,651,495,1146,+
chr19,49588772,2.356920286754999,815,541,1356,+
chr19,49588774,2.4499309392265194,644,361,1005,+
chr19,49589669,2.6658347623347924,827,586,1413,+
chr19,49589760,1.8612104030568224,603,426,1029,+
chr19,49593554,2.030136022514071,596,532,1128,+
chr19,49593731,0.5866735537190082,630,439,1069,+
chr19,49601692,1.5522935779816516,845,544,1389,+
chr19,49601702,0.4775551782682512,585,474,1059,+
chr19,49611416,0.5907363052978567,858,657,1515,+
chr19,49611418,0.6747005846904451,710,541,1251,+
chr19,49611552,5.170261107800618,1158,346,1504,+
chr19,49611572,35.87063421679814,1253,916,2169,+
chr19,49611573,39.25850305419327,1151,797,1948,+
chr19,49611610,0.3448275862068965,507,507,1014,+
chr19,49611611,0.3448275862068965,507,507,1014,+
chr19,49611665,0.5621748864082293,746,653,1399,+
chr19,49990864,0.8740477481855711,18735,11767,30502,+
chr19,49990865,1.0266994701064864,10290,7664,17954,+
chr19,49990866,0.7960502987900239,10521,6189,16710,+
chr19,49990883,0.47333243066924346,2651,2371,5022,+
chr19,49993135,1.2528245711878807,10966,6157,17123,+
chr19,49993159,1.2924709978996327,27259,16577,43836,+
chr19,49993160,1.35849062875213,30830,17153,47983,+
chr19,49993161,1.305187446782914,39625,22237,61862,+
chr19,49993162,1.3063950486557894,61265,37139,98404,+
chr19,49993163,1.1567352077744262,73630,49466,123096,+
chr19,49993164,1.1924064322000913,57292,38386,95678,+
chr19,49993167,1.2767068225515386,34216,23003,57219,+
chr19,49993168,1.2469132531397384,31373,19037,50410,+
chr19,49993170,1.3185996145453855,28802,18445,47247,+
chr19,49993734,1.3880025092235229,8476,5859,14335,+
chr19,49993761,1.7972792057143334,8420,5987,14407,+
chr19,49993815,1.2785825033268408,22424,13850,36274,+
chr19,49994033,1.0228517714594632,595,481,1076,+
chr19,49994047,1.199917710082897,22802,14693,37495,+
chr19,49994164,0.6535068496410316,847,1034,1881,+
chr19,49994180,0.39460716747070984,1237,1450,2687,+
chr19,49994181,0.39460716747070984,1237,1450,2687,+
chr19,49994184,0.6498721227621482,692,764,1456,+
chr19,49994188,0.6035834097111035,2464,2363,4827,+
chr19,49994190,0.612273373988389,1884,1813,3697,+
chr19,49994295,0.8308769953980523,8852,6923,15775,+
chr19,49994296,0.7740529852934132,39005,26572,65577,+
chr19,49995204,1.2316191141260977,5309,3579,8888,+
chr19,49995216,1.5921375733159084,10806,8248,19054,+
chr19,49995239,0.8763189988260368,8736,6748,15484,+
chr19,49995240,1.3445248477553615,14202,9770,23972,+
chr19,49995278,1.3244370743835798,29085,22904,51989,+
chr19,49995350,1.4318544823543542,8874,6720,15594,+
chr19,49995386,1.1751993989774638,22147,15112,37259,+
chr19,49995387,1.2352843958235922,31187,22230,53417,+
chr19,49995461,1.2489421428616947,7418,5505,12923,+
chr19,49999684,0.6574669090350496,641,561,1202,+
chr19,49999686,0.8505311965468016,4440,2959,7399,+
chr19,49999688,0.954952330981481,7334,4953,12287,+
chr19,49999689,0.9289949880525019,12106,6653,18759,+
chr19,49999690,1.00751293331604,15172,8154,23326,+
chr19,49999691,1.125199802812429,20715,11295,32010,+
chr19,49999692,1.2216362478094447,18884,10446,29330,+
chr19,49999693,1.346031127570154,24896,14648,39544,+
chr19,49999694,1.3133471184163343,7951,6357,14308,+
chr19,49999695,1.3487697748382472,10867,7055,17922,+
chr19,49999699,0.7210921035707571,2052,1906,3958,+
chr19,49999710,0.7731222842954686,2490,2213,4703,+
chr19,49999721,0.6713527387271774,3384,2764,6148,+
chr19,50000492,1.3553313234891071,10265,7223,17488,+
chr19,50000493,1.3553313234891071,10265,7223,17488,+
chr19,50000512,0.9896061628000716,15003,11457,26460,+
chr19,50000546,1.20946168760479,12361,7583,19944,+
chr19,50000800,0.75302588758523,26564,17822,44386,+
chr19,50000801,0.75302588758523,26564,17822,44386,+
chr19,50001172,1.054594851471946,611,405,1016,+
chr19,50001184,1.6527614640013248,69005,43673,112678,+
chr19,50001185,1.597926336369637,70037,46418,116455,+
chr19,50001190,1.4730014320312272,48649,30933,79582,+
chr19,50001221,1.3665068052832108,28522,14451,42973,+
chr19,50001228,1.0793671287051492,146058,92895,238953,+
chr19,50001230,1.1292077207910465,67508,35621,103129,+
chr19,50001241,1.151766081538283,179038,128613,307651,+
chr19,50001242,1.303565090664161,153963,106361,260324,+
chr19,50001244,1.260963317655925,160974,102109,263083,+
chr19,50001257,1.084106337089385,236499,160105,396604,+
chr19,50001266,1.3545021884360247,270207,168970,439177,+
chr19,50001268,1.2252589176637143,160695,87670,248365,+
chr19,50001274,1.5048966304522122,95525,55068,150593,+
chr19,50002776,1.2364918280121986,17896,11651,29547,+
chr19,50002785,1.6548231847666877,6977,5309,12286,+
chr19,50002868,1.201506059147071,16011,13234,29245,+
chr19,50002869,1.459152629912864,9316,8150,17466,+
chr19,50180518,1.5407098121085596,701,478,1179,+
chr19,50180531,7.6099179725281845,1825,1255,3080,+
chr19,50180532,7.978213752336189,1610,1093,2703,+
chr19,50185266,0.5359978023890273,1310,730,2040,+
chr19,50185283,3.2373434948285253,1251,667,1918,+
chr19,50185284,3.2373434948285253,1251,667,1918,+
chr19,50185307,1.9364745955151854,885,541,1426,+
chr19,50185310,2.286036036036036,927,591,1518,+
chr19,50185314,0.7898170082741098,2139,1063,3202,+
chr19,50185316,2.5691326530612244,1118,783,1901,+
chr19,50185504,1.1926169217514957,1002,797,1799,+
chr19,50187242,2.1247362869198314,1150,710,1860,+
chr19,50187243,2.1247362869198314,1150,710,1860,+
chr19,50187293,1.2112667543819682,969,547,1516,+
chr19,50188077,2.142360306051472,659,453,1112,+
chr19,50188083,2.2998410824857087,1129,878,2007,+
chr19,50188086,2.0941896024464834,748,544,1292,+
chr19,50188095,0.40187578499664833,1426,1025,2451,+
chr19,50189978,2.9028928068842537,851,552,1403,+
chr19,50191579,0.1157588544439077,1115,370,1485,+
chr19,50191580,0.0805508982035928,1120,333,1453,+
chr19,50191581,0.11185843353654913,1236,373,1609,+
chr19,50191582,0.12091168673278642,1334,366,1700,+
chr19,50191584,0.10429328217639408,889,216,1105,+
chr19,50191613,21.486351340434016,1215,122,1337,+
chr19,50191617,18.84433820231427,2157,288,2445,+
chr19,50191618,13.823025931497588,3228,499,3727,+
chr19,50191619,12.8767796170879,3403,538,3941,+
chr19,50191620,6.80974608374033,1469,271,1740,+
chr19,50191624,33.1816,1120,249,1369,+
chr19,50191625,24.779790815350342,2893,1082,3975,+
chr19,50191626,24.72423910354152,3179,1350,4529,+
chr19,50191627,22.87216879010677,3170,1449,4619,+
chr19,50191629,23.30932488235859,1479,1156,2635,+
chr19,50191630,23.805194463243474,2359,3470,5829,+
chr19,50191631,23.805194463243474,2359,3470,5829,+
chr19,50306252,0.8082722964239553,1339,843,2182,+
chr19,50306254,0.8082722964239553,1339,843,2182,+
chr19,50306258,2.650819672131148,587,487,1074,+
chr19,50306370,1.6660714285714286,932,629,1561,+
chr19,50306373,1.5213903743315509,1137,679,1816,+
chr19,50306374,1.2046593667811838,1332,986,2318,+
chr19,50979899,2.808225108225108,997,307,1304,+
chr19,50979900,3.191088730385955,1254,395,1649,+
chr19,50981192,2.7292853493461395,945,371,1316,+
chr19,50981193,2.5633966332200013,965,388,1353,+
chr19,50981201,2.166666666666667,727,335,1062,+
chr19,50981202,2.166666666666667,727,335,1062,+
chr19,50981207,3.942303038892279,3250,1517,4767,+
chr19,50981208,4.125314704262877,2526,1179,3705,+
chr19,50981213,3.5006580154867857,2117,1110,3227,+
chr19,50984213,1.117963224893918,831,504,1335,+
chr19,50984214,1.117963224893918,831,504,1335,+
chr19,52715958,0.3610488183543212,643,526,1169,+
chr19,52715959,0.3610488183543212,643,526,1169,+
chr19,52716318,1.97205680331685,604,430,1034,+
chr19,52723467,0.47175152788558417,660,507,1167,+
chr19,52725404,2.1549100512773487,633,401,1034,+
chr19,52729001,1.26913130706244,826,569,1395,+
chr19,52729036,0.461619256162444,1021,741,1762,+
chr19,52729037,0.4163923633969717,574,433,1007,+
chr19,54609308,3.297443745446399,658,508,1166,+
chr19,54622008,1.6216666513911768,858,514,1372,+
chr19,54625262,2.037372708757637,740,490,1230,+
chr19,54625265,1.7471071525082607,2862,1933,4795,+
chr19,54625266,1.805831638064086,2435,1616,4051,+
chr19,54631693,2.160984905466425,891,570,1461,+
chr19,54631713,2.1662276322700804,3177,2526,5703,+
chr19,54631714,2.2245804147615758,3674,2840,6514,+
chr19,54704724,1.00181854666767,1057,872,1929,+
chr19,54704725,0.9837438019138971,4797,3562,8359,+
chr19,54704726,0.8750090946250888,7938,5010,12948,+
chr19,54704727,1.0354149635854133,9249,6314,15563,+
chr19,54704728,1.024159641551799,5674,3768,9442,+
chr19,54704733,1.622430175067059,3462,2302,5764,+
chr19,54704735,1.4498783041829402,2819,1811,4630,+
chr19,54704736,1.4498783041829402,2819,1811,4630,+
chr19,54704745,1.67311072056239,2600,1706,4306,+
chr19,54704753,1.577861335289802,2324,1879,4203,+
chr19,54705050,1.5719978839710809,2583,2139,4722,+
chr19,54705121,1.3914288302359543,8318,5429,13747,+
chr19,54705128,1.541821058541316,5006,3109,8115,+
chr19,54705371,0.8118627422022684,5580,4231,9811,+
chr19,54710204,1.4085532302092814,3482,2825,6307,+
chr19,54710223,1.4337398221455104,6162,4594,10756,+
chr19,54710224,1.4337398221455104,6162,4594,10756,+
chr19,54710308,1.4985982825493436,11201,7750,18951,+
chr19,54710323,1.34908314860805,3193,2580,5773,+
chr19,54711310,1.30326234624564,5502,4189,9691,+
chr19,54711311,1.30326234624564,5502,4189,9691,+
chr19,54711383,0.508419655951023,6066,3324,9390,+
chr19,54711384,0.44578309482163536,14074,7081,21155,+
chr19,54711409,3.071879643387816,3128,672,3800,+
chr19,54711410,6.931138066681336,3773,1335,5108,+
chr19,54711415,40.95576540313973,12281,4445,16726,+
chr19,54711416,45.692129866031195,15247,5134,20381,+
chr19,54711438,7.237539517531445,5454,2557,8011,+
chr19,55897299,0.6305279792182508,737,408,1145,+
chr19,55897327,0.9670993912177818,1521,1145,2666,+
chr19,55897723,1.938810641627543,1905,1419,3324,+
chr19,55897725,1.938810641627543,1905,1419,3324,+
chr19,55897739,1.1695766575240147,4383,3293,7676,+
chr19,55897740,1.3786468123318367,4196,3412,7608,+
chr19,55897774,1.5688700919502616,4048,3024,7072,+
chr19,55897785,0.6874771814530851,1882,1493,3375,+
chr19,55897789,1.495878249841471,3032,2489,5521,+
chr19,55897943,0.7205363443895555,2041,1845,3886,+
chr19,55897946,1.3595484048376305,2201,1986,4187,+
chr19,55898045,1.3948040988547323,1960,1049,3009,+
chr19,55899333,1.97516835016835,1234,719,1953,+
chr19,55899338,1.433177933177933,2107,1455,3562,+
chr19,56154680,0.3281779277503817,700,367,1067,+
chr19,56156656,1.1564632648447655,1000,521,1521,+
chr19,56156658,1.1640645791836992,983,569,1552,+
chr19,56165907,3.449942164890341,742,372,1114,+
chr19,56165909,3.449942164890341,742,372,1114,+
chr19,56165917,2.2865370770338376,793,462,1255,+
chr19,56165937,2.2529608201013964,751,456,1207,+
chr19,56165941,1.7397241398799195,839,541,1380,+
chr19,56173965,1.775609756097561,623,409,1032,+
chr19,56174989,2.0727744165946413,570,444,1014,+
chr19,56174999,2.3833333333333333,703,639,1342,+
chr19,56175001,2.3833333333333333,703,639,1342,+
chr19,56179878,1.3007833849517214,713,498,1211,+
chr19,56179880,1.3007833849517214,713,498,1211,+
chr19,56179901,1.1194481641675271,679,461,1140,+
chr19,56180484,1.6079840399172132,854,565,1419,+
chr19,56180887,1.11651533589024,1325,732,2057,+
chr19,56180903,2.396435950413223,1030,725,1755,+
chr19,56180905,1.6455826788976538,2571,1608,4179,+
chr19,56180906,2.1777777777777776,1655,1241,2896,+
chr19,56180908,2.1853185595567868,1126,854,1980,+
chr19,56185703,25.797099621228742,1501,481,1982,+
chr19,56185704,29.518068832400957,1327,445,1772,+
chr19,56185705,24.72585587861943,1764,645,2409,+
chr19,56185710,8.8974103621694,620,460,1080,+
chr19,56185711,10.341689308788206,1014,693,1707,+
chr19,56185726,7.747546491546591,1306,1182,2488,+
chr19,56185727,8.471818793558505,2095,2102,4197,+
chr19,56185728,6.162484116899619,957,786,1743,+
chr19,56185729,7.8369943632894,1565,1635,3200,+
chr19,56185747,0.7503926067707073,1138,1120,2258,+
chr19,56185749,0.9545454545454547,749,624,1373,+
chr19,56185770,0.40876598738685715,515,576,1091,+
chr19,56185775,0.2850123186823033,1789,1684,3473,+
chr19,56185776,0.28999014868262063,2437,2107,4544,+
chr19,56185777,0.2819185164545989,1174,1163,2337,+
chr19,58898639,1.6999398862153128,939,674,1613,+
chr19,58898643,0.5472091798984966,871,682,1553,+
chr19,58898645,0.8870769370928803,2246,1513,3759,+
chr19,58898646,1.134694909438937,1365,1171,2536,+
chr19,58898647,0.8103908025878651,3634,2407,6041,+
chr19,58898648,0.7990340972859842,4030,2910,6940,+
chr19,58898649,1.3847141939627488,783,691,1474,+
chr19,58898665,1.656507068993364,4811,3654,8465,+
chr19,58898666,1.4826661604536937,1523,1138,2661,+
chr19,58898669,1.5519512125289892,1464,1317,2781,+
chr19,58898675,0.5682815227133355,1720,1461,3181,+
chr19,58898681,0.696127767203497,10891,7824,18715,+
chr19,58898683,0.7131030395984383,5009,3585,8594,+
chr19,58899524,1.3699241603466954,3854,3249,7103,+
chr19,58899539,0.6979856917550689,4083,3237,7320,+
chr19,58899541,1.1984522924033987,11134,7690,18824,+
chr19,58904453,1.3626650820884951,4616,3433,8049,+
chr19,58904477,1.2794533770420526,10456,7880,18336,+
chr19,58904486,1.3233876234331101,25326,17187,42513,+
chr19,58904487,1.3233876234331101,25326,17187,42513,+
chr19,58904846,1.5475975075425865,9945,6548,16493,+
chr19,58904848,1.5580062512810002,6020,4304,10324,+
chr19,58905870,1.3364807570091952,11002,7726,18728,+
chr19,58905908,0.8167278477760714,4106,3213,7319,+
chr19,58905909,1.59079882043609,3797,2992,6789,+
chr19,58905911,1.2453926433423168,3639,3218,6857,+
chr19,58906072,1.7738760283594643,4194,3517,7711,+
chr19,58906102,1.365755569127048,4971,3150,8121,+
chr19,59056809,3.3256888859191776,675,454,1129,+
chr19,59057150,0.5639256704128185,723,417,1140,+
chr19,59057166,2.900221729490022,762,450,1212,+
chr19,59057169,2.624626121635095,779,471,1250,+
chr19,59057238,0.5440366972477065,592,435,1027,+
chr19,59058750,1.670697195780808,572,506,1078,+
chr19,59058778,0.569348758611725,729,627,1356,+
chr19,59058797,1.9845735027223228,728,550,1278,+
chr19,59058988,1.6352590425831133,854,612,1466,+
chr19,59059033,1.6183203725225614,3191,2418,5609,+
chr19,59059034,1.6183203725225614,3191,2418,5609,+
chr19,59059035,1.6183203725225614,3191,2418,5609,+
chr19,59059036,0.5100531305344307,1087,661,1748,+
chr19,59059037,1.6301420973247598,2116,1481,3597,+
chr19,59059038,1.6301420973247598,2116,1481,3597,+
chr19,59059045,1.1109375,1421,1099,2520,+
chr19,59059047,1.5387671384896249,2670,2019,4689,+
chr19,59059052,1.0125897916694244,2821,2264,5085,+
chr19,59059075,0.6724404761904762,2053,1599,3652,+
chr19,59059166,1.4354249426315315,2049,1456,3505,+
chr19,59059174,1.6734472182452642,8565,6886,15451,+
chr19,59059175,1.523086508730799,10630,8426,19056,+
chr19,59059176,1.8050643389269319,7599,6207,13806,+
chr19,59059181,1.4697929765440612,9631,7085,16716,+
chr19,59059448,1.7123161764705883,620,543,1163,+
chr19,59059476,1.0533690674133784,1590,1070,2660,+
chr19,59059508,0.4028533607883512,746,522,1268,+
chr19,59059515,1.51849376114082,1159,703,1862,+
chr19,59059538,0.511178247734139,751,661,1412,+
chr19,59059664,1.4028682071577514,1243,745,1988,+
chr19,59059687,0.628698224852071,815,675,1490,+
chr19,59059855,2.509523809523809,832,489,1321,+
chr19,59060579,3.9352930186330655,901,514,1415,+
chr19,59060904,2.452913752913753,618,389,1007,+
chr19,59060910,1.097844760268624,826,673,1499,+
chr19,59060912,1.8898612301758264,1281,1044,2325,+
chr19,59060929,1.8494743214615033,941,822,1763,+
chr19,59060945,1.0570426757188123,1408,984,2392,+
chr19,59061007,1.950719424460432,934,555,1489,+
chr19,59061533,3.2073317307692317,592,415,1007,+
chr19,59061625,2.113858781437441,647,558,1205,+
chr19,59061967,2.6409850665725343,614,535,1149,+
chr20,371990,2.117463281781928,755,445,1200,+
chr20,372095,2.509031198686371,763,405,1168,+
chr20,372096,2.509031198686371,763,405,1168,+
chr20,372181,3.4164088783714437,663,473,1136,+
chr20,377306,3.3831682322218755,971,724,1695,+
chr20,377581,2.424832795312611,729,522,1251,+
chr20,377605,1.9200066940005016,1042,645,1687,+
chr20,377606,1.9200066940005016,1042,645,1687,+
chr20,377725,0.8747973338137272,606,426,1032,+
chr20,377726,0.8747973338137272,606,426,1032,+
chr20,390585,1.8808245225174476,717,465,1182,+
chr20,391165,2.539431819374827,637,398,1035,+
chr20,2633505,2.5750283787393164,787,557,1344,+
chr20,2634857,1.0330721494865276,1726,1192,2918,+
chr20,2635111,0.7667667667667667,765,665,1430,+
chr20,2635113,0.7667667667667667,765,665,1430,+
chr20,2635119,1.1028168138291259,800,619,1419,+
chr20,2635170,1.652522279453847,651,452,1103,+
chr20,2635522,3.176016260162602,600,409,1009,+
chr20,2636103,0.4788484332262563,785,540,1325,+
chr20,2637065,1.798342541436464,650,361,1011,+
chr20,2637122,1.064749053030303,770,527,1297,+
chr20,2637123,1.5540263894272834,3130,2140,5270,+
chr20,2637125,1.744203901678629,2437,1828,4265,+
chr20,2637126,1.792445671352565,2458,1722,4180,+
chr20,2637158,0.5913476501711795,949,755,1704,+
chr20,2637269,0.5728649498216659,1656,1228,2884,+
chr20,2637443,2.2570230607966457,768,529,1297,+
chr20,2638809,2.2016129032258065,636,433,1069,+
chr20,2845899,4.099349629961875,676,342,1018,+
chr20,2845944,0.8243844234732618,759,438,1197,+
chr20,2845946,0.8243844234732618,759,438,1197,+
chr20,2845957,0.5815765352887259,1268,1090,2358,+
chr20,2845958,1.08102395469462,1803,1522,3325,+
chr20,3026773,2.152778917959642,779,472,1251,+
chr20,3782998,2.252297794117647,753,679,1432,+
chr20,3783000,2.252297794117647,753,679,1432,+
chr20,3786536,3.9061438691714585,611,501,1112,+
chr20,4680236,4.1608263649041195,850,509,1359,+
chr20,4680237,5.127520815536207,819,543,1362,+
chr20,4680258,2.5871840484282074,596,474,1070,+
chr20,4680654,0.6148268398268398,597,439,1036,+
chr20,4680862,2.1976744186046515,797,515,1312,+
chr20,4680868,0.424623393885689,696,487,1183,+
chr20,4680939,1.9634977938227043,889,553,1442,+
chr20,4681584,0.577186512118019,625,583,1208,+
chr20,4681585,1.7124972054549519,765,496,1261,+
chr20,4681586,2.0865051903114185,602,492,1094,+
chr20,4682075,0.417603550295858,940,519,1459,+
chr20,5990423,0.919194499412614,597,465,1062,+
chr20,5990424,0.47880599571947013,694,480,1174,+
chr20,5990509,2.251310291560232,1176,882,2058,+
chr20,5990529,1.643336964415396,841,611,1452,+
chr20,5996027,2.4779779896907224,884,592,1476,+
chr20,6748735,0.9347442680776014,529,524,1053,+
chr20,6748736,0.7714328783559552,989,861,1850,+
chr20,6748739,1.6061072316250444,589,475,1064,+
chr20,6749174,2.258175107261091,740,539,1279,+
chr20,6749184,1.9723749672689186,654,401,1055,+
chr20,6749288,1.4745002859236762,708,395,1103,+
chr20,6749407,1.709968186638388,644,409,1053,+
chr20,6751057,3.431129308979283,738,523,1261,+
chr20,6751060,3.0814780864171767,695,402,1097,+
chr20,6758938,1.889880952380952,634,503,1137,+
chr20,6758952,0.6501928640308582,1304,914,2218,+
chr20,6759140,1.7738228194689625,1118,676,1794,+
chr20,6759230,2.169523809523809,803,524,1327,+
chr20,6759784,2.267006802721089,743,503,1246,+
chr20,6759785,2.267006802721089,743,503,1246,+
chr20,6759792,1.2830702078393377,1419,828,2247,+
chr20,6759794,1.1852561440742297,2273,1207,3480,+
chr20,6759795,1.2151350261991134,1555,826,2381,+
chr20,6759796,1.2151350261991134,1555,826,2381,+
chr20,6759802,1.7757412649065005,1616,936,2552,+
chr20,6759804,1.6596268321476841,2658,1604,4262,+
chr20,6759805,1.6975562605333596,1733,1047,2780,+
chr20,6759810,2.136766975308642,626,485,1111,+
chr20,6759911,1.6434659429088398,1792,1076,2868,+
chr20,11898599,0.2716379573338372,653,556,1209,+
chr20,11898608,2.672322375397667,629,450,1079,+
chr20,11898609,2.672322375397667,629,450,1079,+
chr20,11899190,2.9674744897959178,989,783,1772,+
chr20,11899191,2.9674744897959178,989,783,1772,+
chr20,11900367,0.9896616541353384,779,607,1386,+
chr20,11900368,1.6870273414776034,724,572,1296,+
chr20,11900369,0.9896616541353384,779,607,1386,+
chr20,11903289,0.6238324175824177,878,671,1549,+
chr20,11903760,1.997132385872892,881,785,1666,+
chr20,11904005,0.6153846153846154,863,571,1434,+
chr20,11904011,1.2065917011199037,1305,1149,2454,+
chr20,11904020,1.7274046133758885,1700,1242,2942,+
chr20,11904022,1.7274046133758885,1700,1242,2942,+
chr20,11904025,1.4610338971168741,1916,1716,3632,+
chr20,11904028,2.192101413944417,1404,878,2282,+
chr20,11904029,0.5873543594812352,1059,1076,2135,+
chr20,11904061,0.7031900138696257,1910,1714,3624,+
chr20,11904062,1.643492957746479,1682,1419,3101,+
chr20,11904065,1.2574349592402272,2781,1704,4485,+
chr20,11904068,1.3457516811915191,2250,1931,4181,+
chr20,11904069,1.3243944294106,3400,2084,5484,+
chr20,11904075,1.5318511352570026,13316,10131,23447,+
chr20,11904076,1.4494177420488135,14842,11330,26172,+
chr20,11904192,1.8165717900063247,717,526,1243,+
chr20,11904292,2.183874007268812,623,436,1059,+
chr20,11904311,1.5946784393270492,809,577,1386,+
chr20,11904320,2.820444915254237,638,471,1109,+
chr20,11904477,1.6878188124872475,1127,753,1880,+
chr20,11904924,1.9659839889070851,2547,1623,4170,+
chr20,11904925,2.2632639814150526,1351,886,2237,+
chr20,11905504,3.6636550308008218,810,486,1296,+
chr20,11905564,1.8804904051172704,568,468,1036,+
chr20,11905617,2.577605321507761,774,450,1224,+
chr20,11906066,1.9304086129907572,1432,1030,2462,+
chr20,11906595,0.5897435897435898,597,506,1103,+
chr20,11906702,2.206654991243433,899,570,1469,+
chr20,11906831,0.4129478315524827,656,515,1171,+
chr20,11906899,3.0294615963855422,784,663,1447,+
chr20,11907055,1.8260869565217392,713,526,1239,+
chr20,11907080,1.961315889164707,1677,1173,2850,+
chr20,16718029,3.540011625653943,629,396,1025,+
chr20,16718031,3.540011625653943,629,396,1025,+
chr20,16721591,3.18013223673601,679,476,1155,+
chr20,16721616,2.4413231658848917,1470,1230,2700,+
chr20,16721617,2.4413231658848917,1470,1230,2700,+
chr20,16721621,1.7518560254540634,838,793,1631,+
chr20,16721666,1.8958333333333333,1070,764,1834,+
chr20,16721674,0.6399626251751945,1601,1622,3223,+
chr20,17581456,0.5717467387846007,598,448,1046,+
chr20,17581460,0.6133869540115721,1374,945,2319,+
chr20,17581472,1.5187956686328024,907,613,1520,+
chr20,17581545,1.638029782359679,1039,775,1814,+
chr20,17581607,0.6075188901275858,1153,935,2088,+
chr20,17581654,2.1696428571428568,1097,975,2072,+
chr20,17587721,1.550191176470588,1368,999,2367,+
chr20,17588284,2.411842105263158,610,455,1065,+
chr20,17588310,5.4423480083857445,648,476,1124,+
chr20,17588311,4.083742690058479,601,474,1075,+
chr20,17588328,2.0176999438097023,694,561,1255,+
chr20,17588444,2.1508422249905217,650,498,1148,+
chr20,17588445,1.049800072700836,1291,916,2207,+
chr20,17588446,1.049800072700836,1291,916,2207,+
chr20,17588688,2.0727949720040586,656,501,1157,+
chr20,18513382,1.608626637955956,687,462,1149,+
chr20,18541399,3.2435374149659864,595,440,1035,+
chr20,18541400,3.0754562043795617,910,684,1594,+
chr20,18541402,3.394904458598726,614,470,1084,+
chr20,18548185,1.5817225903039933,810,510,1320,+
chr20,18548212,2.297312183636635,703,457,1160,+
chr20,20007501,1.2065304604871265,750,599,1349,+
chr20,21142729,2.42153672440542,724,459,1183,+
chr20,21142733,2.7676118357446464,785,518,1303,+
chr20,21142741,4.159550561797753,616,444,1060,+
chr20,21142772,1.6475787433852962,2002,1415,3417,+
chr20,21142797,1.170946758734166,1746,1217,2963,+
chr20,21142808,1.8280741156653568,891,684,1575,+
chr20,21142820,1.6016974276240556,2797,1984,4781,+
chr20,21306985,2.142088147306182,617,429,1046,+
chr20,21307174,1.910300342672848,701,450,1151,+
chr20,21307184,2.563130145222458,814,568,1382,+
chr20,21307191,2.7930389221556893,877,667,1544,+
chr20,21336782,3.2342530845051005,591,449,1040,+
chr20,21337255,0.20836961498819317,628,447,1075,+
chr20,21369931,3.6493253581861174,582,552,1134,+
chr20,21370304,1.6698179000387448,652,444,1096,+
chr20,30126021,1.6765375854214124,827,438,1265,+
chr20,30132758,0.8786197680846036,1913,1058,2971,+
chr20,30132762,2.207393153108414,1777,1110,2887,+
chr20,30132763,2.207393153108414,1777,1110,2887,+
chr20,30132766,1.669603524229075,757,453,1210,+
chr20,30132785,1.4317307692307693,1488,1039,2527,+
chr20,30132793,1.4730438966127348,4492,2695,7187,+
chr20,30136846,1.784249706151234,620,402,1022,+
chr20,30149510,1.762855283141679,624,418,1042,+
chr20,30157014,2.229694457182889,1173,938,2111,+
chr20,30330356,1.963731743929789,674,539,1213,+
chr20,30330439,2.748454588682834,1155,700,1855,+
chr20,30330440,2.748454588682834,1155,700,1855,+
chr20,30345290,0.3551312649164678,650,418,1068,+
chr20,30354460,2.2260186548846344,871,678,1549,+
chr20,30354461,1.895181609571726,2268,1446,3714,+
chr20,30354462,1.6584764903155158,1397,768,2165,+
chr20,30359388,1.8634361233480177,563,453,1016,+
chr20,30365415,2.833281004709576,751,454,1205,+
chr20,30366685,1.1795266125583277,1051,881,1932,+
chr20,30370146,2.102151482350298,1041,762,1803,+
chr20,30370148,3.044437816880406,703,478,1181,+
chr20,30371654,0.3052757427757427,1090,701,1791,+
chr20,30371682,1.7731876861966236,1487,1006,2493,+
chr20,30371713,1.6022651565622918,1442,868,2310,+
chr20,30371717,2.3388364779874213,1574,953,2527,+
chr20,30380576,1.732566906086143,6512,4587,11099,+
chr20,30380577,1.4615631087468273,7356,5386,12742,+
chr20,30380581,1.766102510628058,2423,1917,4340,+
chr20,30380586,2.339515225854621,2618,2205,4823,+
chr20,30385231,1.9902200488997552,628,408,1036,+
chr20,30385305,1.5960052760504992,846,548,1394,+
chr20,30386191,2.4216289370078745,728,507,1235,+
chr20,30386260,4.468734241048916,957,660,1617,+
chr20,30386263,2.144434771794553,1981,1461,3442,+
chr20,30386264,2.144434771794553,1981,1461,3442,+
chr20,30388928,2.2781272762311655,682,491,1173,+
chr20,30388935,1.8438727455122055,1446,1140,2586,+
chr20,30389211,2.397754933816204,1172,780,1952,+
chr20,30389337,0.5648567119155354,641,441,1082,+
chr20,30733172,2.2599333147345564,731,512,1243,+
chr20,30749130,2.5532353755663495,557,456,1013,+
chr20,30753405,16.733447937972507,661,1256,1917,+
chr20,30753411,0.5321709185835869,771,1203,1974,+
chr20,30753419,0.3038939580770786,388,725,1113,+
chr20,30753436,0.2661126982379855,603,1063,1666,+
chr20,30824321,1.0604885305172351,778,463,1241,+
chr20,30824424,1.90918648968327,1392,1086,2478,+
chr20,30824425,1.7803196385381121,3432,2439,5871,+
chr20,31407758,1.3981486725378105,1004,939,1943,+
chr20,31407759,2.20249482941561,1122,1048,2170,+
chr20,31407781,0.3557996648668777,545,523,1068,+
chr20,31407782,0.3283089103980257,801,832,1633,+
chr20,31427608,1.8887548483355128,1002,715,1717,+
chr20,31427636,2.291763075160863,819,545,1364,+
chr20,31436550,3.20490300091016,902,677,1579,+
chr20,31436594,2.4558938329430133,725,426,1151,+
chr20,31437132,2.9422160608719645,978,807,1785,+
chr20,31437316,3.588205551800631,1069,792,1861,+
chr20,31437317,3.5708154506437766,639,465,1104,+
chr20,31437957,2.129370629370629,629,389,1018,+
chr20,32217555,2.3153914962132505,1046,590,1636,+
chr20,32217556,2.347967479674797,683,409,1092,+
chr20,32441968,5.2017943359104715,642,565,1207,+
chr20,32659913,1.610273492286115,834,551,1385,+
chr20,32659917,2.325490196078431,592,577,1169,+
chr20,32660004,1.72635814889336,659,496,1155,+
chr20,32660061,2.0207100591715976,682,337,1019,+
chr20,32660101,0.9892163009404388,1126,637,1763,+
chr20,32660103,0.9892163009404388,1126,637,1763,+
chr20,32661637,2.7716262975778547,800,577,1377,+
chr20,32661638,2.7716262975778547,800,577,1377,+
chr20,32663749,2.192680064653136,939,520,1459,+
chr20,32663759,2.2020326455189405,649,381,1030,+
chr20,32663778,0.6723410342607824,939,450,1389,+
chr20,32663799,1.5880663501553252,1425,725,2150,+
chr20,32663801,1.5847584758475848,972,706,1678,+
chr20,32663836,1.3465871668955103,3044,1800,4844,+
chr20,32663837,1.5622210047885725,2368,1368,3736,+
chr20,32663839,2.426326129666012,1234,1017,2251,+
chr20,32663840,2.426326129666012,1234,1017,2251,+
chr20,32663843,1.6555023923444976,691,626,1317,+
chr20,32664507,1.5961832061068704,696,654,1350,+
chr20,32664509,1.9499575911789653,1044,785,1829,+
chr20,32664554,1.4699662688116244,1053,655,1708,+
chr20,32664952,0.24106831648658067,502,603,1105,+
chr20,32664953,0.24106831648658067,502,603,1105,+
chr20,32664954,0.24106831648658067,502,603,1105,+
chr20,32664986,2.2816326530612243,558,524,1082,+
chr20,32664988,2.2816326530612243,558,524,1082,+
chr20,32666350,2.3634678462881045,530,477,1007,+
chr20,32667812,2.9371980676328504,831,457,1288,+
chr20,32667814,3.239823286122054,1011,626,1637,+
chr20,32667893,2.3398396050287285,859,745,1604,+
chr20,32667942,1.0404511593454402,1297,1099,2396,+
chr20,32667943,0.6109805931058808,1203,939,2142,+
chr20,32667953,2.7276243230805117,976,894,1870,+
chr20,32667963,1.892101473357705,609,530,1139,+
chr20,32667964,2.4346897755140073,916,702,1618,+
chr20,32668006,2.6697794117647056,740,799,1539,+
chr20,32788452,0.4604045007833642,430,825,1255,+
chr20,32788464,1.5420087153339752,934,1749,2683,+
chr20,33000438,3.9529665155433875,675,461,1136,+
chr20,33104216,2.311310247063588,1285,822,2107,+
chr20,33104217,2.311310247063588,1285,822,2107,+
chr20,33104218,2.005912727748588,2375,1382,3757,+
chr20,33104223,0.5898692810457516,721,373,1094,+
chr20,33104226,1.1074356959679226,3328,2229,5557,+
chr20,33114124,3.5377969762419004,727,462,1189,+
chr20,33122526,2.320639534883721,886,644,1530,+
chr20,33122527,2.26322897865816,2087,1482,3569,+
chr20,33122549,1.254508081846211,925,555,1480,+
chr20,33122561,0.5291368621840725,875,698,1573,+
chr20,33470665,8.808046840453121,618,443,1061,+
chr20,33764796,4.114002590185142,592,425,1017,+
chr20,34129827,0.9360882405666652,1115,899,2014,+
chr20,34129828,1.235738532248656,808,754,1562,+
chr20,34129829,1.374793993774034,508,507,1015,+
chr20,34129870,1.7206749672346004,777,435,1212,+
chr20,34129881,1.1224289405684755,1173,899,2072,+
chr20,34129883,1.3367398514626865,1709,1322,3031,+
chr20,34130092,2.055375981245338,1629,1197,2826,+
chr20,34130093,2.055375981245338,1629,1197,2826,+
chr20,34130125,1.527964652223489,1050,876,1926,+
chr20,34130574,1.3876123549145338,5747,3631,9378,+
chr20,34130575,1.3696058927899344,4468,2656,7124,+
chr20,34130687,2.4657192720019943,988,763,1751,+
chr20,34135247,1.930349961495679,939,805,1744,+
chr20,34136268,2.160289389067524,1492,932,2424,+
chr20,34136320,1.4543516722425203,2141,1613,3754,+
chr20,34136334,1.7815670455934478,1649,908,2557,+
chr20,34136368,1.8322172619047614,984,755,1739,+
chr20,34136382,1.5520441434662655,1427,885,2312,+
chr20,34142819,1.7681690650737625,952,761,1713,+
chr20,34143982,1.4983049793176375,1024,868,1892,+
chr20,34144754,1.0558502473094749,1965,1636,3601,+
chr20,34144759,1.5541000084257945,2563,1777,4340,+
chr20,34145010,1.6026356341994792,1159,917,2076,+
chr20,34145222,1.5418298269950497,2921,2080,5001,+
chr20,34287610,1.3993729471484029,2677,1575,4252,+
chr20,34287612,1.3993729471484029,2677,1575,4252,+
chr20,34287663,2.350776655104811,865,697,1562,+
chr20,34288758,0.6683823529411765,908,679,1587,+
chr20,34288762,1.83894559189906,672,540,1212,+
chr20,34288765,1.6998882265275708,874,853,1727,+
chr20,34828233,3.219062694510872,676,479,1155,+
chr20,35173384,2.716389046246358,654,473,1127,+
chr20,35234211,0.5896866603325828,1668,957,2625,+
chr20,35234355,3.3918275013558032,616,444,1060,+
chr20,35234412,0.9408632266661483,1458,1010,2468,+
chr20,35234413,0.9582739283338086,1135,1168,2303,+
chr20,35234414,0.7851531919539428,2229,1919,4148,+
chr20,35234415,1.1781728692586126,1908,1602,3510,+
chr20,35234432,0.4545138888888889,560,539,1099,+
chr20,35234463,0.5918714348398421,980,687,1667,+
chr20,35238056,1.4641809479697392,1458,1269,2727,+
chr20,35240548,2.0500463392029653,947,746,1693,+
chr20,35240630,1.415950744558992,1797,1163,2960,+
chr20,35240634,1.328286633702221,2038,1369,3407,+
chr20,35807516,1.7856074425471162,680,343,1023,+
chr20,35807526,6.712871640509859,1078,620,1698,+
chr20,35807632,1.6665020794021796,923,724,1647,+
chr20,35807690,2.3877960885117053,701,459,1160,+
chr20,35807746,2.637546812203142,839,495,1334,+
chr20,35807754,1.7337130793284072,1115,850,1965,+
chr20,35807756,1.7337130793284072,1115,850,1965,+
chr20,35807757,1.4676594189658323,764,420,1184,+
chr20,35807759,1.9066629955947132,553,453,1006,+
chr20,35812583,2.0129882192082404,3342,2211,5553,+
chr20,35812584,1.7526612040585308,2986,1645,4631,+
chr20,35812586,1.9133597356527852,3823,2409,6232,+
chr20,35812587,1.7991772442568326,2140,1232,3372,+
chr20,35812612,1.7211112312182468,837,637,1474,+
chr20,35812616,1.5476370012377696,2521,1726,4247,+
chr20,35812676,0.7152549463308784,4037,3251,7288,+
chr20,35812677,1.5393594242550406,2524,1563,4087,+
chr20,35812766,1.65340122665109,1690,1290,2980,+
chr20,35826828,1.4508010284810129,3171,1895,5066,+
chr20,35827456,0.7722001325381047,2477,2011,4488,+
chr20,35827463,1.3993768870996388,3204,2031,5235,+
chr20,35827525,1.1805689304657527,3173,2422,5595,+
chr20,35827544,1.3200023084025851,1798,1443,3241,+
chr20,35827573,1.9041218637992836,1699,1295,2994,+
chr20,35832355,1.338129786284227,3364,2425,5789,+
chr20,35833218,1.1503330755171695,5244,4109,9353,+
chr20,35833219,1.6022970998725563,2843,2427,5270,+
chr20,35833229,1.7548663640948061,1512,1321,2833,+
chr20,35833241,1.390460012603085,2615,1920,4535,+
chr20,35835775,1.524575778024493,4039,2626,6665,+
chr20,35835787,1.933953488372093,1550,1174,2724,+
chr20,35842248,1.3653104019454088,2979,1875,4854,+
chr20,35854122,1.8495669553630916,1982,1579,3561,+
chr20,35854140,1.3843095353128385,4287,2944,7231,+
chr20,35857030,1.4220298830609246,4478,2964,7442,+
chr20,35857100,1.305332159924324,6711,4953,11664,+
chr20,35860742,1.033321617461777,5461,4354,9815,+
chr20,35860743,1.033321617461777,5461,4354,9815,+
chr20,35860759,1.6412283788755127,6096,4374,10470,+
chr20,35862449,0.690286396310278,2530,1990,4520,+
chr20,35862450,2.11577051710831,1541,1195,2736,+
chr20,35944855,23.543447894230507,902,475,1377,+
chr20,35944856,20.75839948769486,1168,629,1797,+
chr20,35944859,6.240473459615068,703,511,1214,+
chr20,35944862,16.273840937795658,1289,1408,2697,+
chr20,35944863,14.310440179464273,1566,1666,3232,+
chr20,35944864,14.310440179464273,1566,1666,3232,+
chr20,35944878,4.839934882186629,457,666,1123,+
chr20,36361381,2.186797752808989,691,533,1224,+
chr20,36361383,1.7190026021689755,950,710,1660,+
chr20,36365797,1.8009167606236147,627,448,1075,+
chr20,36431407,2.834179513985998,659,506,1165,+
chr20,36719412,4.0578209539705785,1433,1548,2981,+
chr20,36719413,4.280760354873797,1604,1926,3530,+
chr20,36719414,4.280760354873796,1604,1926,3530,+
chr20,37163822,2.511025886864813,581,446,1027,+
chr20,37163823,1.9625058274627218,1021,759,1780,+
chr20,37163824,2.356357927786499,797,636,1433,+
chr20,37163825,2.2770167427701677,615,510,1125,+
chr20,37581115,0.3372305599251732,660,546,1206,+
chr20,37581116,0.3372305599251732,660,546,1206,+
chr20,37581197,6.063684016133704,535,475,1010,+
chr20,37601227,1.8958447045369287,2087,1489,3576,+
chr20,37601228,1.7967327947642906,1232,888,2120,+
chr20,37601231,1.6610690830492976,688,522,1210,+
chr20,39657650,2.848695652173913,909,499,1408,+
chr20,39657651,2.848695652173913,909,499,1408,+
chr20,39657652,2.848695652173913,909,499,1408,+
chr20,39657705,2.1339917046185644,1591,927,2518,+
chr20,39657707,2.08588498879761,930,514,1444,+
chr20,39657710,2.2487898655275522,1582,1042,2624,+
chr20,39657716,0.6019377018439421,962,661,1623,+
chr20,39657717,1.5637544775666323,1446,904,2350,+
chr20,39657718,1.5637544775666323,1446,904,2350,+
chr20,39657723,2.008861482454403,2182,1485,3667,+
chr20,39657725,1.6946070126729451,4198,3000,7198,+
chr20,39657726,1.59979079035573,2412,1797,4209,+
chr20,39657728,1.6083852562787533,8295,6179,14474,+
chr20,39657729,1.6083852562787533,8295,6179,14474,+
chr20,39657730,1.395348629536224,11752,8841,20593,+
chr20,39657732,0.957631148399784,3655,2803,6458,+
chr20,39657737,0.5193914465533476,1587,1186,2773,+
chr20,39658073,1.6057334530857637,2171,1838,4009,+
chr20,39658088,1.3180061587405172,2328,1885,4213,+
chr20,39729892,3.23582680568065,599,463,1062,+
chr20,39742765,1.3792285591466775,739,489,1228,+
chr20,39751929,2.4190306699580235,562,443,1005,+
chr20,39752360,3.174198222794538,878,551,1429,+
chr20,39752664,4.5087925985638355,1222,521,1743,+
chr20,39752670,22.60115445406472,3094,1739,4833,+
chr20,39752671,22.870948030556875,3497,2257,5754,+
chr20,39752672,22.870948030556878,3497,2257,5754,+
chr20,42089164,1.330898134681825,2658,1410,4068,+
chr20,42089167,1.6566320014595877,2042,1133,3175,+
chr20,42089178,1.0476027608390084,1163,641,1804,+
chr20,42089179,1.7913881683958497,2354,1431,3785,+
chr20,42089182,2.0953890398334845,2464,1553,4017,+
chr20,42089194,1.553582089552239,2973,2009,4982,+
chr20,42089203,1.3095398619487595,4905,3183,8088,+
chr20,42089206,1.6581080641204275,3223,1679,4902,+
chr20,42089215,0.9930052978728136,8607,5243,13850,+
chr20,42089221,1.5364091345994495,2539,1355,3894,+
chr20,42089222,1.7443452380952378,5860,3887,9747,+
chr20,42089223,1.7443452380952378,5860,3887,9747,+
chr20,42089224,1.603189089731036,9143,5683,14826,+
chr20,42089397,1.5146282213772708,1246,525,1771,+
chr20,42089406,1.7548381608608736,2946,1382,4328,+
chr20,42089408,1.7548381608608736,2946,1382,4328,+
chr20,42089415,1.67323476796801,1718,883,2601,+
chr20,42089453,2.031168831168831,781,384,1165,+
chr20,42089463,1.4380032206119162,797,482,1279,+
chr20,42089475,1.7676950998185117,973,683,1656,+
chr20,42089478,1.586780414366621,650,480,1130,+
chr20,42089490,1.9342810300703777,1758,1041,2799,+
chr20,42089508,1.4356461225544035,9699,6280,15979,+
chr20,42089615,3.3657603177385145,799,438,1237,+
chr20,42089621,1.9924528301886795,823,514,1337,+
chr20,42089623,1.4268610818901233,1406,810,2216,+
chr20,42089624,0.6996065025718207,1578,935,2513,+
chr20,42089626,2.430502227000461,1054,765,1819,+
chr20,42089628,2.430502227000461,1054,765,1819,+
chr20,42089698,2.729631813969163,610,469,1079,+
chr20,42089868,1.678137003841229,698,567,1265,+
chr20,42090077,1.7963368651274276,845,565,1410,+
chr20,42311520,0.794776119402985,1206,669,1875,+
chr20,42311521,0.794776119402985,1206,669,1875,+
chr20,42311522,0.794776119402985,1206,669,1875,+
chr20,42333941,2.1851179673321237,601,550,1151,+
chr20,42333956,1.9224388439795004,790,700,1490,+
chr20,42333964,2.306233062330623,1405,1025,2430,+
chr20,42333966,2.396087134652137,2846,2033,4879,+
chr20,42333967,2.7391517930243983,2213,1772,3985,+
chr20,42333969,2.2599008366327484,3077,2410,5487,+
chr20,42333971,2.0157547370662128,1577,1341,2918,+
chr20,42344785,11.662938105891126,781,446,1227,+
chr20,42344786,11.662938105891126,781,446,1227,+
chr20,42344787,11.662938105891126,781,446,1227,+
chr20,42344792,1.2447527395192968,581,452,1033,+
chr20,43344010,0.6839219488974694,2046,1351,3397,+
chr20,43344022,1.1226469228783151,611,474,1085,+
chr20,43344046,1.0765303464443865,860,697,1557,+
chr20,43344047,1.0765303464443865,860,697,1557,+
chr20,43344064,2.075730825638233,1796,1206,3002,+
chr20,43348563,1.5959389335694865,1082,843,1925,+
chr20,43348564,1.7561900460883584,1154,793,1947,+
chr20,43353483,3.135967230443975,878,472,1350,+
chr20,43353485,3.135967230443975,878,472,1350,+
chr20,43355847,3.3519396438887714,622,502,1124,+
chr20,43356057,2.018609487232093,1381,989,2370,+
chr20,43356065,1.840097853886356,590,528,1118,+
chr20,43356091,0.5253231532649006,2772,2021,4793,+
chr20,43356093,0.5305065985525755,1683,1349,3032,+
chr20,43356094,0.6814610652535269,1653,1192,2845,+
chr20,43356118,1.915893108298172,972,789,1761,+
chr20,43356165,1.6710997442455244,725,574,1299,+
chr20,43356237,0.638477088948787,1136,741,1877,+
chr20,43356308,1.628682780320366,1110,735,1845,+
chr20,43356396,1.2241258507368178,1060,927,1987,+
chr20,43374804,2.3672441365194183,920,647,1567,+
chr20,43379507,2.309865434866246,622,423,1045,+
chr20,43379556,2.607730622641085,603,477,1080,+
chr20,43530300,2.2840827980014278,639,466,1105,+
chr20,43530313,2.0505902192242838,1055,592,1647,+
chr20,43530358,1.4519312823165422,4631,3642,8273,+
chr20,43530360,1.669788664745437,2453,2081,4534,+
chr20,43530367,1.6728974529351421,3171,2539,5710,+
chr20,43532653,1.6824034334763946,783,465,1248,+
chr20,43532747,1.6912174721189592,752,537,1289,+
chr20,43536010,0.3821801876540863,814,587,1401,+
chr20,43536011,0.3821801876540863,814,587,1401,+
chr20,43536364,1.7203501506024095,1118,663,1781,+
chr20,43536512,4.287775631915609,680,560,1240,+
chr20,43536513,3.922100320798545,749,554,1303,+
chr20,44044781,0.8803641158686547,827,672,1499,+
chr20,44044783,0.8160191789892045,1347,1032,2379,+
chr20,44045238,2.762124711316398,597,432,1029,+
chr20,44045292,3.4576236891227405,988,593,1581,+
chr20,44047497,1.86670230180737,915,808,1723,+
chr20,44047498,1.86670230180737,915,808,1723,+
chr20,44047538,2.463654223968566,560,508,1068,+
chr20,44047990,1.755238095238095,1163,839,2002,+
chr20,44047991,1.755238095238095,1163,839,2002,+
chr20,44048777,2.905828002842928,628,401,1029,+
chr20,44048786,1.6954418604651162,700,429,1129,+
chr20,44048856,0.5685675492192803,669,490,1159,+
chr20,44049203,2.135524798154556,643,407,1050,+
chr20,44049206,2.1906961398878257,663,432,1095,+
chr20,44049252,1.5471854304635762,622,452,1074,+
chr20,44050102,2.861643118785976,738,636,1374,+
chr20,44050103,2.861643118785976,738,636,1374,+
chr20,44050217,0.4887781798834842,751,682,1433,+
chr20,44053142,1.6152304609218435,623,498,1121,+
chr20,44054295,2.2694837698453676,767,648,1415,+
chr20,44054355,2.778182616921118,1092,845,1937,+
chr20,44054356,2.918671248568156,727,581,1308,+
chr20,44054431,2.3324985574386425,958,707,1665,+
chr20,44054432,2.356093900739629,627,490,1117,+
chr20,44054561,1.5815766359244618,669,505,1174,+
chr20,44054582,1.7416201117318435,644,536,1180,+
chr20,44054609,1.7407407407407407,657,377,1034,+
chr20,44054650,0.5131105028093935,837,630,1467,+
chr20,44054673,1.9332107843137252,630,543,1173,+
chr20,44054692,0.41855072463768117,721,574,1295,+
chr20,44054704,2.3387216372534483,829,612,1441,+
chr20,44054707,1.7228001905972046,1008,786,1794,+
chr20,44054710,0.6676767011395823,1085,798,1883,+
chr20,44054714,0.648484336739002,1199,910,2109,+
chr20,44441284,2.004519766232473,973,554,1527,+
chr20,44441286,2.126698779543775,807,497,1304,+
chr20,44442083,2.090863871832511,770,584,1354,+
chr20,44443039,0.4574934268185802,521,488,1009,+
chr20,44444297,1.761504601840736,1549,1224,2773,+
chr20,44444299,1.761504601840736,1549,1224,2773,+
chr20,44444340,1.613333333333333,846,674,1520,+
chr20,44444541,0.5688034188034188,846,727,1573,+
chr20,44445498,1.4803400637619557,1392,940,2332,+
chr20,44521466,1.2553012292298331,671,413,1084,+
chr20,44526397,3.615083025830258,824,541,1365,+
chr20,44526399,3.4093885601577907,1270,844,2114,+
chr20,44526401,3.01036531411958,865,585,1450,+
chr20,44527279,0.6593546151693668,923,775,1698,+
chr20,47630120,1.928942245295263,614,401,1015,+
chr20,47630149,3.3354234284633395,698,369,1067,+
chr20,47630198,0.5650591016548463,628,449,1077,+
chr20,47630200,0.2878643349231585,678,369,1047,+
chr20,47630201,0.326140272111427,1397,842,2239,+
chr20,47630211,1.7144686299615877,1235,659,1894,+
chr20,47630212,2.3513513513513518,719,554,1273,+
chr20,47630216,1.5346337579617837,770,627,1397,+
chr20,47662856,0.8338645250174648,1172,424,1596,+
chr20,47662869,2.842020061032616,2057,853,2910,+
chr20,47662870,2.8659586980594547,2894,1288,4182,+
chr20,47662893,4.681568431568431,814,363,1177,+
chr20,47662909,2.7629716981132075,780,423,1203,+
chr20,47662941,2.0013477088948783,824,529,1353,+
chr20,47662947,0.9216471719275757,1437,1026,2463,+
chr20,47662948,0.9216471719275757,1437,1026,2463,+
chr20,47682732,2.2934782608695654,843,735,1578,+
chr20,47683810,1.833197099538563,1336,924,2260,+
chr20,47685269,1.8010793554271811,676,571,1247,+
chr20,47686746,1.63087135062159,905,612,1517,+
chr20,47688946,1.882491048893585,843,630,1473,+
chr20,47689166,1.0810955163293672,2213,1612,3825,+
chr20,47693542,2.1270701225143136,1381,877,2258,+
chr20,47700570,2.5414551607445004,750,590,1340,+
chr20,47700579,2.075346112886049,1558,938,2496,+
chr20,47700686,2.157048249763481,569,452,1021,+
chr20,47704581,1.782181818181818,1013,824,1837,+
chr20,47706124,2.045772103107685,771,592,1363,+
chr20,47706126,2.0013409784518634,1602,982,2584,+
chr20,47706213,2.257815671944783,1078,820,1898,+
chr20,47706253,1.965366039654296,792,561,1353,+
chr20,47712910,1.5966467696629214,845,711,1556,+
chr20,47712935,1.566718995290424,997,844,1841,+
chr20,47838041,3.693991769100465,783,582,1365,+
chr20,47839889,2.328475871954133,1082,804,1886,+
chr20,47839908,1.61238025055269,1093,589,1682,+
chr20,47839910,1.6070410280436385,1818,1114,2932,+
chr20,47839911,1.6070410280436385,1818,1114,2932,+
chr20,47839939,2.0711136154211416,3067,1884,4951,+
chr20,47839949,2.9340242669363,1313,1031,2344,+
chr20,47849855,1.4429026544215748,737,514,1251,+
chr20,47850164,2.836724869451697,649,500,1149,+
chr20,47852899,0.2879402325762495,893,579,1472,+
chr20,47860404,0.34382662533213804,1293,837,2130,+
chr20,47860405,0.38680632631845324,2583,1536,4119,+
chr20,47860407,0.4918035779481562,928,497,1425,+
chr20,47895178,1.0137166768450268,909,918,1827,+
chr20,47895179,0.9687467248225219,832,1057,1889,+
chr20,47895181,0.9434792786698336,1011,961,1972,+
chr20,47895182,0.4452296819787986,467,565,1032,+
chr20,47895191,0.4672205510194336,514,536,1050,+
chr20,47895200,2.061818181818182,836,681,1517,+
chr20,47895205,1.5137265262091892,1108,720,1828,+
chr20,47895210,1.1663602267075082,2421,1861,4282,+
chr20,47895216,1.405828588552592,1250,1127,2377,+
chr20,47895481,0.9599238264006188,7831,6575,14406,+
chr20,47895482,0.9793794249230444,33258,24277,57535,+
chr20,47895723,1.3164916264547262,4637,3522,8159,+
chr20,47895737,0.7118675641439606,4245,3457,7702,+
chr20,47896861,0.9302176259529937,2551,1977,4528,+
chr20,47897101,1.2557417480753854,7984,5684,13668,+
chr20,47897224,0.985880232104566,1043,993,2036,+
chr20,47897225,0.9772463128037827,3895,3027,6922,+
chr20,47897473,0.7335270480470101,2288,1577,3865,+
chr20,47905616,1.5419776119402986,4697,3215,7912,+
chr20,47905617,1.251569975021521,4729,2967,7696,+
chr20,47905702,1.3662331719705996,7705,5527,13232,+
chr20,47905703,0.7851570251980106,11039,8439,19478,+
chr20,48553012,2.5646133721484023,732,445,1177,+
chr20,48558135,2.105290456431536,890,481,1371,+
chr20,48558136,0.4872455902306648,797,334,1131,+
chr20,48558154,1.7205042272831135,1220,690,1910,+
chr20,48558169,1.5181565930751597,1451,920,2371,+
chr20,48558243,1.9084510303063043,800,620,1420,+
chr20,48569411,6.3974427578141295,1408,674,2082,+
chr20,48569417,2.0658016682113067,742,331,1073,+
chr20,48569418,2.0658016682113067,742,331,1073,+
chr20,48569432,82.75373972780635,2451,2307,4758,+
chr20,48569433,82.75373972780635,2451,2307,4758,+
chr20,48569471,0.24577222523990577,616,788,1404,+
chr20,48569472,0.24577222523990577,616,788,1404,+
chr20,48807367,0.4612370470787369,2554,1554,4108,+
chr20,48807369,0.4778653445896962,1201,700,1901,+
chr20,48807435,1.6703804347826088,682,459,1141,+
chr20,48807651,1.8049552037082828,1372,906,2278,+
chr20,48808287,0.44489383215369044,703,551,1254,+
chr20,48808288,0.44489383215369044,703,551,1254,+
chr20,48808291,2.111217948717949,561,453,1014,+
chr20,48808345,1.7163249001331558,1215,750,1965,+
chr20,48808347,1.9058970018256636,1807,1198,3005,+
chr20,48808348,1.468789758523642,1176,850,2026,+
chr20,48808360,0.4994615140956604,656,769,1425,+
chr20,48808387,1.1972014032588454,1657,1331,2988,+
chr20,48808392,0.5648622456043195,1631,1397,3028,+
chr20,48808393,0.9828087795866906,2978,2308,5286,+
chr20,48808413,1.7855509717182767,886,681,1567,+
chr20,48808512,2.1911145186203105,2566,1548,4114,+
chr20,48808513,2.260856829149338,2935,1894,4829,+
chr20,48808676,1.8595598693097026,820,491,1311,+
chr20,48808701,0.9322830535024871,1012,801,1813,+
chr20,48808702,1.4852594856580696,1375,976,2351,+
chr20,48808721,1.803225806451613,558,509,1067,+
chr20,48808760,0.7094119125408394,1612,1037,2649,+
chr20,48808781,1.0626204234982464,1147,777,1924,+
chr20,48808782,1.3908119603371851,1961,1258,3219,+
chr20,48808785,1.51790243902439,840,499,1339,+
chr20,48808807,1.9529339144946127,1796,1467,3263,+
chr20,48808808,1.793384109916368,1021,743,1764,+
chr20,48808928,1.6965277777777772,1046,719,1765,+
chr20,48808944,1.6611643690808962,2945,1886,4831,+
chr20,48808948,1.823421599737389,1306,961,2267,+
chr20,48808995,1.5836196156241364,3303,2236,5539,+
chr20,48809016,1.4774002754179993,4135,2874,7009,+
chr20,48809025,0.7437843194874189,3001,2090,5091,+
chr20,48809026,1.865279628594764,1355,1081,2436,+
chr20,48809118,1.700950020652623,567,537,1104,+
chr20,49191153,4.487125956854558,743,478,1221,+
chr20,49191155,4.487125956854558,743,478,1221,+
chr20,49201176,11.618807091595167,300,782,1082,+
chr20,52824634,1.6123587603732006,1085,553,1638,+
chr20,52824636,1.251616315754494,1969,1306,3275,+
chr20,52824637,1.2351007603233122,1765,1010,2775,+
chr20,52824639,0.863984674329502,1231,695,1926,+
chr20,52830894,1.5815724599401302,970,630,1600,+
chr20,52830934,2.007179896290387,679,544,1223,+
chr20,52831848,2.218345864661654,921,797,1718,+
chr20,52831914,1.635779286436516,1561,988,2549,+
chr20,55043712,0.45736207062714157,788,462,1250,+
chr20,55049781,1.59347471451876,887,612,1499,+
chr20,55052143,2.4860678106393914,664,439,1103,+
chr20,55052164,2.589911480629687,697,422,1119,+
chr20,55093360,1.148762814060045,618,515,1133,+
chr20,55093567,1.7682351043526794,784,481,1265,+
chr20,55093595,3.1748797988016864,726,503,1229,+
chr20,55940441,1.7440835335290263,985,635,1620,+
chr20,55940443,2.3034083496412263,688,437,1125,+
chr20,55953083,1.016410389768874,802,567,1369,+
chr20,55953328,1.9344948962293111,1462,916,2378,+
chr20,55953330,1.8817512455359107,1066,612,1678,+
chr20,55953334,1.2306693711967545,1263,724,1987,+
chr20,55953336,1.2306693711967545,1263,724,1987,+
chr20,57019414,0.9353586497890296,651,394,1045,+
chr20,57019415,0.9353586497890296,651,394,1045,+
chr20,57020451,4.424829155575892,749,591,1340,+
chr20,57226740,0.5887008733624454,718,457,1175,+
chr20,57226741,0.5887008733624454,718,457,1175,+
chr20,57226742,0.5887008733624454,718,457,1175,+
chr20,57226768,5.365577548916987,1174,752,1926,+
chr20,57226776,8.353096464486729,1133,1203,2336,+
chr20,57226777,6.930243338339653,1600,1579,3179,+
chr20,57246316,1.322593453967894,1607,1036,2643,+
chr20,57246317,1.322593453967894,1607,1036,2643,+
chr20,57246318,1.322593453967894,1607,1036,2643,+
chr20,57246339,2.53695870814169,1349,918,2267,+
chr20,57246345,2.457487091222031,648,414,1062,+
chr20,57248686,2.3669230769230767,1085,649,1734,+
chr20,57248693,1.830366603093876,690,428,1118,+
chr20,57248701,2.21055701370662,757,507,1264,+
chr20,57248708,1.4037254621005877,1605,996,2601,+
chr20,57248709,0.7413554719613362,3400,2343,5743,+
chr20,57248710,0.7262382837718728,4411,3000,7411,+
chr20,57248711,1.2601792550911186,3055,1983,5038,+
chr20,57248714,1.9520098768054372,2070,1407,3477,+
chr20,57251985,2.4985096245394636,621,430,1051,+
chr20,57253873,3.084779735002592,657,471,1128,+
chr20,57290355,5.3213993697941175,980,1220,2200,+
chr20,57290356,4.734704297757089,1116,1398,2514,+
chr20,57466445,0.897509606616214,933,596,1529,+
chr20,57466448,1.280888322807361,2060,1356,3416,+
chr20,57466449,1.1207838700944064,2036,1371,3407,+
chr20,57466475,0.3897869628624523,1476,874,2350,+
chr20,57466522,4.938931371809952,722,391,1113,+
chr20,57466745,0.3941130714726215,834,563,1397,+
chr20,57466766,2.9513461405021757,717,302,1019,+
chr20,57466768,2.101422708618331,862,424,1286,+
chr20,57466769,1.7346686170937748,1643,854,2497,+
chr20,57466770,1.3575757870449183,2360,1354,3714,+
chr20,57466778,0.7755337801473309,2962,1917,4879,+
chr20,57466779,0.7139934902634212,4148,2529,6677,+
chr20,57466780,1.555269476372925,1833,1124,2957,+
chr20,57466781,0.5243271221532091,2025,1011,3036,+
chr20,57466782,1.555269476372925,1833,1124,2957,+
chr20,57466783,0.7324517210962859,2500,1230,3730,+
chr20,57466784,1.8860424028268554,853,565,1418,+
chr20,57466785,0.8880237045203969,1840,906,2746,+
chr20,57466794,1.2742765214045733,10064,6501,16565,+
chr20,57466795,1.135595035119635,5038,3312,8350,+
chr20,57466796,1.2742765214045733,10064,6501,16565,+
chr20,57466798,1.392288591215601,2622,1487,4109,+
chr20,57466799,1.3834965074685588,6024,4387,10411,+
chr20,57466801,1.3465054284988616,21200,15125,36325,+
chr20,57466802,1.3335843435012065,24766,17453,42219,+
chr20,57466803,1.5291838886065965,14825,11986,26811,+
chr20,57466805,1.5762374516381388,8004,6694,14698,+
chr20,57466809,1.533384067785543,7195,5729,12924,+
chr20,57470673,1.2522217001368772,2664,1578,4242,+
chr20,57470680,0.7193288400810671,1760,1298,3058,+
chr20,57478774,0.6871971726614605,1691,1323,3014,+
chr20,57478780,0.6503592753769861,1396,1204,2600,+
chr20,57478781,1.358214473585331,3052,1900,4952,+
chr20,57478787,1.6122843968805147,2097,1596,3693,+
chr20,57480471,2.036954314720812,2507,1969,4476,+
chr20,57480503,1.4017706693185272,2742,2193,4935,+
chr20,57484226,1.650713330805914,2685,2178,4863,+
chr20,57484227,1.356410870085507,3065,2336,5401,+
chr20,57484441,1.765711300194059,2307,1623,3930,+
chr20,57484465,1.62652482391786,2143,1588,3731,+
chr20,57484470,1.4593807160397911,4637,3521,8158,+
chr20,57484612,1.6268023748939782,1917,1571,3488,+
chr20,57484756,1.505857807735516,1705,1301,3006,+
chr20,57484828,1.1612612771958715,5960,4204,10164,+
chr20,57484837,1.3499175866033215,2214,1678,3892,+
chr20,57484849,1.4978917418860769,4303,3326,7629,+
chr20,57485025,1.5284676659579193,6105,4352,10457,+
chr20,57485053,0.7101969328036225,3499,2294,5793,+
chr20,57485430,1.7116447642886945,2763,1631,4394,+
chr20,57485757,1.373360554318238,1685,1346,3031,+
chr20,57485782,1.2781706204379564,3201,2054,5255,+
chr20,57485842,0.7976685250886973,2622,1972,4594,+
chr20,57485882,1.292788595400332,7352,5788,13140,+
chr20,57485883,1.6024729552235344,4300,3573,7873,+
chr20,57485976,1.536320235559812,2528,1626,4154,+
chr20,57485977,1.5205082408974115,1590,1181,2771,+
chr20,57485982,1.4241649435933366,9931,7176,17107,+
chr20,57485983,1.4290780829407694,8273,5917,14190,+
chr20,57486010,1.277532174083898,3250,2348,5598,+
chr20,57486102,2.364998807789913,4885,4491,9376,+
chr20,57561834,2.461799374780692,682,530,1212,+
chr20,57562804,2.73091738159124,682,483,1165,+
chr20,57564022,2.4121722353766555,808,542,1350,+
chr20,57564024,2.4121722353766555,808,542,1350,+
chr20,57564597,1.8379633226837062,914,586,1500,+
chr20,57564603,0.5709948853324534,823,550,1373,+
chr20,57564605,0.5435795584752884,1185,688,1873,+
chr20,57564606,0.5435795584752884,1185,688,1873,+
chr20,57564607,1.896963123644252,582,460,1042,+
chr20,57566074,1.6765989641919556,608,494,1102,+
chr20,57566394,2.5655738034858917,540,474,1014,+
chr20,57567068,0.548672111048561,930,667,1597,+
chr20,57568805,2.1356308592004485,752,540,1292,+
chr20,60709266,1.0706274097441288,1042,633,1675,+
chr20,60709268,1.4170482940670013,1404,900,2304,+
chr20,60710159,14.790977669235268,856,784,1640,+
chr20,60710160,11.830777551141344,1394,1484,2878,+
chr20,60710161,9.594077247204511,1009,1266,2275,+
chr20,60878743,1.1941154970760233,882,759,1641,+
chr20,60878744,1.8635115216552438,1709,1383,3092,+
chr20,60879591,1.464146907555681,680,502,1182,+
chr20,60883104,1.3021862412686172,1030,725,1755,+
chr20,60883105,0.847438330170778,637,464,1101,+
chr20,60962154,0.9169119609346164,3468,2387,5855,+
chr20,60962155,0.7077955473791753,12307,9247,21554,+
chr20,60962157,0.6648336731981989,28040,18616,46656,+
chr20,60962158,0.7748882717863936,11536,6369,17905,+
chr20,60962159,0.7073404794355755,26523,16943,43466,+
chr20,60962161,0.6987551054868842,8589,5524,14113,+
chr20,60962163,1.3863146309928474,11372,6728,18100,+
chr20,60962390,1.1339129727110862,17385,12491,29876,+
chr20,60962391,1.1339129727110862,17385,12491,29876,+
chr20,60962394,1.3718959090143363,7817,6256,14073,+
chr20,60962398,1.2972647041737315,22329,14700,37029,+
chr20,60962413,1.180695044361371,12333,8961,21294,+
chr20,60962673,1.2741180693693985,30214,20965,51179,+
chr20,60962713,1.1111078149816689,39490,27647,67137,+
chr20,60962896,0.9808627792282406,1048,897,1945,+
chr20,60963511,1.5023231761229505,725,625,1350,+
chr20,61299448,3.0046181021090046,597,438,1035,+
chr20,61300403,0.785143846819975,679,546,1225,+
chr20,61303175,2.0624533680548462,1585,1225,2810,+
chr20,61303176,2.1531575841038757,1112,896,2008,+
chr20,62373353,2.539491199744955,651,421,1072,+
chr20,62374312,1.040502846568013,982,662,1644,+
chr20,62374314,1.2705953881905043,847,577,1424,+
chr20,62500648,1.9666635306626767,767,437,1204,+
chr20,62505122,0.8514402428932667,931,610,1541,+
chr20,62521568,4.2020236570468805,1321,832,2153,+
chr20,62521569,3.8299465290869485,3162,2149,5311,+
chr20,62521571,3.649388161341366,2175,1483,3658,+
chr20,62521832,1.806993006993007,645,428,1073,+
chr20,62521850,1.1899334463269349,1024,754,1778,+
chr20,62522397,22.808278124861083,1804,1592,3396,+
chr20,62522398,22.808278124861083,1804,1592,3396,+
chr20,62522461,0.4690605841115451,644,603,1247,+
chr20,62616305,2.6960556844547563,663,430,1093,+
chr20,62616306,2.6960556844547563,663,430,1093,+
chr20,62626332,1.4466528640441683,891,643,1534,+
chr20,62626345,0.7792527472527473,2769,1624,4393,+
chr20,62626346,0.7792527472527473,2769,1624,4393,+
chr20,62626347,0.7792527472527473,2769,1624,4393,+
chr20,62626355,1.8023036183845043,3079,2076,5155,+
chr20,62626356,1.7610976640894773,5407,3642,9049,+
chr20,62626357,1.5456998812271907,8700,6073,14773,+
chr20,62626358,1.7817211489695242,5724,4231,9955,+
chr20,62626359,1.4383276266033742,9342,6626,15968,+
chr20,62626360,1.7459559650561174,3625,2786,6411,+
chr20,62626365,1.8613162523701126,3016,2243,5259,+
chr20,62630437,2.1266593614259017,609,406,1015,+
chr20,62642851,2.1976835335452845,914,473,1387,+
chr20,62648103,1.6497715504112094,1002,468,1470,+
chr20,62648106,2.1162210338680927,847,509,1356,+
chr20,62648111,1.4873133699472048,1465,926,2391,+
chr20,62648124,2.262260765550239,1779,911,2690,+
chr20,62658365,1.3195026141555128,804,619,1423,+
chr20,62658366,0.997107438016529,634,483,1117,+
chr20,62658382,0.8878333942272562,809,482,1291,+
chr20,62658384,0.8878333942272562,809,482,1291,+
chr20,62658413,2.4041662762734624,1570,820,2390,+
chr20,62658415,2.4041662762734624,1570,820,2390,+
chr20,62658419,2.0427931911541775,2595,1599,4194,+
chr20,62658420,2.199519230769231,1874,1039,2913,+
chr20,62701675,1.235674161274136,588,423,1011,+
chr20,62701684,0.4648063463225324,673,524,1197,+
chr20,62701693,1.7619368558512258,1185,938,2123,+
chr21,9827003,0.9951103726823816,193297,146130,339427,+
chr21,9827004,0.9951103726823814,193297,146130,339427,+
chr21,20230118,1.934879241369092,1598,793,2391,+
chr21,20230121,0.5495893872394189,1639,1582,3221,+
chr21,20230123,0.7301414041180848,1980,972,2952,+
chr21,20230157,1.5100918644407617,5383,2957,8340,+
chr21,20230159,1.2479567048771734,8054,5407,13461,+
chr21,33031975,0.4879699658062055,644,411,1055,+
chr21,33031980,2.033598835493924,749,349,1098,+
chr21,33032000,1.1148805319905315,729,484,1213,+
chr21,33032009,2.1385281385281387,1462,725,2187,+
chr21,33032011,2.1685912542550407,2268,1139,3407,+
chr21,33032013,1.7975500239766338,1555,790,2345,+
chr21,33032088,1.7277153558052434,658,533,1191,+
chr21,33032134,1.5939967072598273,2123,1392,3515,+
chr21,33032139,0.8535709505065652,3233,2342,5575,+
chr21,33036162,1.912206526064465,1038,717,1755,+
chr21,33039605,1.6264864864864863,2477,1849,4326,+
chr21,33039606,1.6264864864864863,2477,1849,4326,+
chr21,33040788,1.1381705017553003,2151,1590,3741,+
chr21,33040790,0.9102372612468311,3746,2742,6488,+
chr21,33040823,1.411280212616588,1500,1351,2851,+
chr21,34793795,1.8448637316561844,559,476,1035,+
chr21,34793796,1.8448637316561844,559,476,1035,+
chr21,34804581,2.459249657297295,705,497,1202,+
chr21,34805061,2.838475499092559,781,550,1331,+
chr21,34805062,2.669382023491876,1311,910,2221,+
chr21,34805112,3.4988057324840773,798,627,1425,+
chr21,34805116,2.026497837589661,3364,2905,6269,+
chr21,34805118,2.165052739996873,1810,1622,3432,+
chr21,34805130,1.1231882000955296,2101,1860,3961,+
chr21,34929583,1.575829383886256,645,421,1066,+
chr21,35761070,2.103465584473809,1069,712,1781,+
chr21,35761071,2.1276167471819645,603,431,1034,+
chr21,35761100,1.821723546828736,834,712,1546,+
chr21,35761101,1.981005410101489,1269,1100,2369,+
chr21,35761103,1.9999090164680198,861,757,1618,+
chr21,35761106,1.7177454230935565,992,990,1982,+
chr21,35761107,1.7177454230935565,992,990,1982,+
chr21,37443268,1.2552923076923077,1510,999,2509,+
chr21,37443269,1.3366196304003506,1785,1180,2965,+
chr21,37443270,1.2552923076923077,1510,999,2509,+
chr21,37444763,2.185195988337579,779,672,1451,+
chr21,37445003,2.2589118022688006,562,482,1044,+
chr21,37445056,5.477939123259169,675,482,1157,+
chr21,40177855,1.0529793510324486,775,338,1113,+
chr21,40177856,1.7559611788770302,1040,482,1522,+
chr21,40181979,2.1298245614035087,606,436,1042,+
chr21,40186722,2.2938306741324763,891,593,1484,+
chr21,40186790,2.5869693396226414,701,423,1124,+
chr21,40186799,1.7879065565307175,1668,1191,2859,+
chr21,40186800,1.7879065565307175,1668,1191,2859,+
chr21,40186817,0.4043255913062007,1011,721,1732,+
chr21,40186856,1.653298053298053,1150,714,1864,+
chr21,40186857,1.4497725065180715,1643,1261,2904,+
chr21,40191655,0.4221967963386727,614,436,1050,+
chr21,40194614,0.9592284592284592,754,480,1234,+
chr21,40194615,0.9592284592284592,754,480,1234,+
chr21,40194619,2.597360798197618,537,477,1014,+
chr21,40194621,1.6846181989858846,1434,988,2422,+
chr21,40194623,1.0272879464285714,897,511,1408,+
chr21,40194896,3.3851341235076315,612,487,1099,+
chr21,40194906,4.765716374269005,766,607,1373,+
chr21,40194907,4.765716374269005,766,607,1373,+
chr21,40195045,1.091965768988076,1448,1030,2478,+
chr21,40195113,1.88470066518847,679,450,1129,+
chr21,40195114,1.7885487077534792,832,502,1334,+
chr21,40195195,0.5932446591948273,1697,1008,2705,+
chr21,40195200,2.435308016794038,2217,1430,3647,+
chr21,40195201,2.687973484848485,1621,1055,2676,+
chr21,40195202,2.220179724511713,2852,1765,4617,+
chr21,40195230,5.383686651549428,7084,6258,13342,+
chr21,40195231,5.383686651549428,7084,6258,13342,+
chr21,40195232,3.3111481258343085,1773,1945,3718,+
chr21,40195523,2.0304196859903376,726,575,1301,+
chr21,40195524,2.0304196859903376,726,575,1301,+
chr21,40195933,3.048251119212478,603,475,1078,+
chr21,40196071,8.50866030823532,1455,1164,2619,+
chr21,40196072,8.50866030823532,1455,1164,2619,+
chr21,40762701,1.7944633421885874,546,457,1003,+
chr21,42540416,2.546996490542288,593,437,1030,+
chr21,42598250,3.4874251497005977,818,500,1318,+
chr21,42598253,2.0898318042813457,780,653,1433,+
chr21,42598275,2.2992656058751533,662,515,1177,+
chr21,42609611,0.6180868739615476,867,765,1632,+
chr21,42613744,0.36119182916869874,883,822,1705,+
chr21,42615312,0.5916678624384177,1236,908,2144,+
chr21,42615316,1.828080229226361,1072,697,1769,+
chr21,42615399,1.4074067622415385,1468,972,2440,+
chr21,42617889,1.5331734228831857,1430,1136,2566,+
chr21,42617987,1.5458720803709367,1633,1216,2849,+
chr21,42622685,0.5554270848388495,853,628,1481,+
chr21,42622729,1.6756167370860022,682,637,1319,+
chr21,42622732,1.6261769616026711,760,598,1358,+
chr21,42622739,1.6319972919386372,1900,1353,3253,+
chr21,42622775,0.6504224157614901,996,928,1924,+
chr21,42629133,1.812660550458716,800,653,1453,+
chr21,42629153,1.601226993865031,724,651,1375,+
chr21,42629219,2.0960049233294016,1339,1053,2392,+
chr21,42629220,2.0960049233294016,1339,1053,2392,+
chr21,42647319,2.083098591549296,985,567,1552,+
chr21,42647448,1.7873204700420715,1759,1242,3001,+
chr21,42647450,1.716624091883113,2598,1944,4542,+
chr21,42647513,1.8089668615984404,695,512,1207,+
chr21,42647514,1.691963572455664,705,568,1273,+
chr21,42647548,2.43313414382856,737,632,1369,+
chr21,42647549,1.7253097715271606,999,616,1615,+
chr21,42647596,1.7058961004273503,928,767,1695,+
chr21,42647603,1.6660810252170315,1315,943,2258,+
chr21,42647667,1.4570731707317073,926,737,1663,+
chr21,42647847,2.465979381443299,597,484,1081,+
chr21,42647860,0.5159350155547874,877,525,1402,+
chr21,42647909,0.5266829718134798,820,508,1328,+
chr21,42647918,1.8829787234042556,884,563,1447,+
chr21,42648025,1.8351357846671472,663,437,1100,+
chr21,42648108,0.3850018841854038,612,418,1030,+
chr21,42648131,2.5467608076303723,1027,597,1624,+
chr21,42648132,2.5467608076303723,1027,597,1624,+
chr21,42648142,1.1733552631578947,1188,683,1871,+
chr21,42648144,1.4006569656781485,1824,1067,2891,+
chr21,42648146,2.469858641130871,1230,730,1960,+
chr21,42648390,0.334136546184739,623,414,1037,+
chr21,44450253,0.9676320272572404,567,586,1153,+
chr21,44450255,0.9676320272572404,567,586,1153,+
chr21,45215083,2.805,679,499,1178,+
chr21,45215085,2.140811021132019,1697,1130,2827,+
chr21,45215087,2.3593350383631715,719,543,1262,+
chr21,45744389,3.0705550950674927,620,389,1009,+
chr21,47706824,0.44832470638857946,613,407,1020,+
chr21,47706825,2.6275975052056624,899,522,1421,+
chr21,47706841,2.1414323209598805,967,761,1728,+
chr21,47706842,2.1414323209598805,967,761,1728,+
chr21,47706847,2.132548701298701,610,559,1169,+
chr21,48055663,3.107889298121462,613,411,1024,+
chr22,18165988,3.3433054969257596,1011,640,1651,+
chr22,18165990,3.3433054969257596,1011,640,1651,+
chr22,18209621,3.468954244574568,689,437,1126,+
chr22,18209622,3.2990769680854073,658,484,1142,+
chr22,18210487,2.682608695652174,616,459,1075,+
chr22,18210488,2.682608695652174,616,459,1075,+
chr22,18211027,2.5402312460018717,796,463,1259,+
chr22,18211056,3.5589144841420803,657,463,1120,+
chr22,18211393,1.6069811189298404,658,462,1120,+
chr22,18211786,0.45359552246585855,1281,864,2145,+
chr22,18211787,0.4229100946372239,857,633,1490,+
chr22,19420098,1.163040156455952,699,516,1215,+
chr22,19420105,1.214738056968782,1182,952,2134,+
chr22,19422287,1.9045648712574912,2556,2215,4771,+
chr22,19422288,1.9359614203867874,3314,2751,6065,+
chr22,19423203,1.5980695549661068,942,695,1637,+
chr22,19423252,2.4617237687366167,1081,933,2014,+
chr22,19423282,1.9259259259259258,662,458,1120,+
chr22,19423294,1.4633058521421811,1202,754,1956,+
chr22,19423298,1.400529842605579,3287,3104,6391,+
chr22,19423300,1.400529842605579,3287,3104,6391,+
chr22,19423315,1.5908528721871287,3410,2455,5865,+
chr22,19423392,0.9168857811410707,1698,1099,2797,+
chr22,19423393,0.4429618842812876,1307,808,2115,+
chr22,19423411,1.442667748917749,750,479,1229,+
chr22,19506367,2.150037056759814,637,415,1052,+
chr22,19950242,1.8451178451178447,547,461,1008,+
chr22,19950264,2.2788904643743355,694,402,1096,+
chr22,19950283,1.5760247056222407,1972,1730,3702,+
chr22,19950284,1.5760247056222407,1972,1730,3702,+
chr22,19950302,1.7269839536395537,2794,2509,5303,+
chr22,19951219,2.435304541621934,934,655,1589,+
chr22,19951735,1.3263726230928983,848,625,1473,+
chr22,19956332,1.267304742593192,589,452,1041,+
chr22,19956412,0.5523891767415084,605,578,1183,+
chr22,20105068,19.367941712204004,685,365,1050,+
chr22,20106571,0.7199934265935375,700,600,1300,+
chr22,20106666,1.5445804195804198,991,831,1822,+
chr22,20109878,1.6281939288054157,805,481,1286,+
chr22,20109913,1.3133717689838889,1230,946,2176,+
chr22,20109934,0.6287086263076659,1221,685,1906,+
chr22,20112850,1.5930615199360827,1637,1043,2680,+
chr22,20112856,0.22524163048045936,803,483,1286,+
chr22,20112884,2.669573792720885,1154,876,2030,+
chr22,20112885,0.3942140052266549,1522,870,2392,+
chr22,20112887,2.0697468292479972,2799,1672,4471,+
chr22,20112898,1.5405109118203102,10990,6346,17336,+
chr22,20112899,1.5405109118203102,10990,6346,17336,+
chr22,20112910,1.5960418995911532,4660,2233,6893,+
chr22,20112911,1.5292774446220812,6844,3409,10253,+
chr22,20112916,1.7426199368218231,5469,2862,8331,+
chr22,20112917,1.670130063274025,8489,4509,12998,+
chr22,20112919,1.4886570393045884,8427,4636,13063,+
chr22,20112924,1.3275728233073758,10291,6109,16400,+
chr22,20112926,1.343917342901407,7337,4329,11666,+
chr22,20112935,1.6483188078476225,6179,4162,10341,+
chr22,20113880,1.767297548867515,711,585,1296,+
chr22,20114501,1.8174442190669369,1791,1121,2912,+
chr22,20937456,3.505031063630723,921,587,1508,+
chr22,20937515,1.0721437570452887,702,456,1158,+
chr22,20937516,1.0721437570452887,702,456,1158,+
chr22,21224770,4.002457466918714,682,528,1210,+
chr22,21242021,1.4292565947242206,595,416,1011,+
chr22,21242022,1.4292565947242206,595,416,1011,+
chr22,21242023,1.4292565947242206,595,416,1011,+
chr22,21242074,2.866985978021291,609,451,1060,+
chr22,21242089,2.0952666586757993,595,417,1012,+
chr22,21272399,2.0578682098189285,847,486,1333,+
chr22,21272400,2.0578682098189285,847,486,1333,+
chr22,21922021,0.6467155113775146,1474,737,2211,+
chr22,21922023,0.5985542616047468,1349,765,2114,+
chr22,21922030,1.5787310042447134,1060,609,1669,+
chr22,21947154,1.938406836038309,1299,741,2040,+
chr22,21947155,1.9141842550538786,2022,1181,3203,+
chr22,21947157,1.6771790973373952,3480,1996,5476,+
chr22,21947158,1.570717253839205,3243,1844,5087,+
chr22,21947160,1.5958856717053438,2220,1280,3500,+
chr22,21947178,1.7272683698413456,1000,672,1672,+
chr22,21965260,2.1126847671470097,1219,873,2092,+
chr22,21965262,2.1126847671470097,1219,873,2092,+
chr22,21975830,1.986670983756948,994,638,1632,+
chr22,21977075,3.2295582885336915,612,408,1020,+
chr22,21998330,1.6797434667397662,541,515,1056,+
chr22,21998502,17.3466344337944,2594,1455,4049,+
chr22,21998503,17.3466344337944,2594,1455,4049,+
chr22,21998504,17.3466344337944,2594,1455,4049,+
chr22,21998514,8.328482934666875,967,844,1811,+
chr22,21998515,9.444217415102985,1347,1258,2605,+
chr22,24129434,1.1951854838345954,720,549,1269,+
chr22,24133979,1.8668909649691128,1110,800,1910,+
chr22,24133981,2.866635759542574,1049,718,1767,+
chr22,24133983,2.9815841584158416,716,504,1220,+
chr22,24134031,0.5823970037453183,621,444,1065,+
chr22,24143192,2.0043638661585534,730,484,1214,+
chr22,24145491,0.7259802329358266,1271,936,2207,+
chr22,24145492,0.7259802329358266,1271,936,2207,+
chr22,24145495,0.5668811002661934,806,551,1357,+
chr22,24145504,1.5967741935483872,908,605,1513,+
chr22,24145513,1.9634790020653707,867,648,1515,+
chr22,24145561,1.9968433080396453,909,649,1558,+
chr22,24158984,1.1262458936718602,1457,955,2412,+
chr22,24167430,2.407013902165897,1376,892,2268,+
chr22,24167431,2.407013902165897,1376,892,2268,+
chr22,24167432,2.407013902165897,1376,892,2268,+
chr22,24167531,3.382392502064098,1374,932,2306,+
chr22,24167565,10.386392136405945,842,841,1683,+
chr22,24167566,12.467724867724868,547,629,1176,+
chr22,24175809,3.2754285258295126,811,524,1335,+
chr22,24176499,21.212838416304162,797,740,1537,+
chr22,24176500,19.41101425402512,899,846,1745,+
chr22,24236561,1.3885409477093598,900,545,1445,+
chr22,24236563,1.8275670741773737,1041,598,1639,+
chr22,24236569,0.5204795766148823,1677,958,2635,+
chr22,24236572,2.7793427230046945,1627,780,2407,+
chr22,24236574,2.7474094871249806,1989,995,2984,+
chr22,24236580,0.8925887901015305,10695,7604,18299,+
chr22,24236581,0.8960001400708582,17252,12577,29829,+
chr22,24236582,0.8960001400708582,17252,12577,29829,+
chr22,24236591,1.2868347742860664,10236,6769,17005,+
chr22,24236595,0.7544085322908812,7385,5412,12797,+
chr22,24236677,1.4398012592951763,18255,13177,31432,+
chr22,24236957,1.0958460782546338,10127,6561,16688,+
chr22,24236958,1.119404131723468,3732,2923,6655,+
chr22,24236959,1.1773155661609978,5778,3195,8973,+
chr22,24237007,1.5945408710783222,9465,7963,17428,+
chr22,24237009,1.4553466016609942,21916,15273,37189,+
chr22,24237049,1.3460291984320505,4360,2326,6686,+
chr22,24237064,1.2488292135223655,3902,2070,5972,+
chr22,24237231,1.3343811797099614,11753,8464,20217,+
chr22,24237236,1.3896771089490003,3560,2984,6544,+
chr22,24237239,1.2372986174814729,10014,7040,17054,+
chr22,24237357,1.6937351430105054,2007,1655,3662,+
chr22,24717419,2.258516650827144,1058,602,1660,+
chr22,24717425,2.861681329423265,1170,725,1895,+
chr22,24717427,2.861681329423265,1170,725,1895,+
chr22,24718112,1.9868131868131869,677,324,1001,+
chr22,24718114,2.2817534296835427,1948,1122,3070,+
chr22,24718116,2.3240318881117226,1662,1027,2689,+
chr22,24718117,2.635974551764025,632,454,1086,+
chr22,24951952,0.8736519068670764,1092,689,1781,+
chr22,24951992,1.9328440875103852,845,627,1472,+
chr22,24951999,1.4290766607314582,1452,1102,2554,+
chr22,24952019,1.539681790283745,1051,717,1768,+
chr22,24952020,1.527159209157128,1222,960,2182,+
chr22,24952023,2.367731575388776,1292,1043,2335,+
chr22,24964024,2.216365001251147,1021,630,1651,+
chr22,24964037,1.7804654362031411,1001,792,1793,+
chr22,24964056,2.3015873015873014,695,566,1261,+
chr22,24964117,1.4388061717141023,1521,1096,2617,+
chr22,24964127,1.9047844944429384,2081,1580,3661,+
chr22,24967992,1.3918677390527254,2224,1491,3715,+
chr22,29664321,0.4108623548922056,990,683,1673,+
chr22,29664322,0.4108623548922056,990,683,1673,+
chr22,29674101,3.761183968143999,757,445,1202,+
chr22,29678437,2.5528643502486923,763,490,1253,+
chr22,29678496,4.5415956196331395,744,585,1329,+
chr22,29678538,2.2058823529411766,647,458,1105,+
chr22,29682912,2.1368684077218254,907,757,1664,+
chr22,29683062,2.699453551912568,759,487,1246,+
chr22,29684752,14.451618585957911,2139,924,3063,+
chr22,29684753,13.81007761078043,2500,1240,3740,+
chr22,29684754,13.81007761078043,2500,1240,3740,+
chr22,29684755,23.549112426035503,1004,844,1848,+
chr22,29684757,30.468801420078343,1263,1145,2408,+
chr22,29684760,2.907864770643584,735,744,1479,+
chr22,29684769,3.723064281772743,595,846,1441,+
chr22,29687575,0.4329846419056574,960,708,1668,+
chr22,29687576,0.4329846419056574,960,708,1668,+
chr22,29688492,0.675155653745732,763,765,1528,+
chr22,29688521,2.8813528502591144,833,646,1479,+
chr22,29692313,1.901832833218511,1471,1259,2730,+
chr22,29695237,1.463834257064708,1213,886,2099,+
chr22,29695251,2.240125231714918,680,552,1232,+
chr22,29695628,2.7377651066239563,643,417,1060,+
chr22,29695702,2.415158924205379,897,408,1305,+
chr22,29695726,1.6502042830790438,1465,704,2169,+
chr22,29695730,1.7509833916083917,640,415,1055,+
chr22,29695734,2.479399255715045,1364,626,1990,+
chr22,29695745,1.9696976738449372,4291,2557,6848,+
chr22,29695746,2.2596796479949828,5210,3103,8313,+
chr22,29695747,0.0934164934164934,673,369,1042,+
chr22,29695748,2.0780533057398722,4701,2965,7666,+
chr22,29695774,2.558974358974359,997,524,1521,+
chr22,29695780,1.8255068153655516,2422,1344,3766,+
chr22,29695782,1.7864800337062874,3692,2083,5775,+
chr22,29695783,1.6025918906433176,4467,2809,7276,+
chr22,29695792,1.546672111065741,2123,1579,3702,+
chr22,29695814,1.9147577377196252,3357,2553,5910,+
chr22,29695820,1.5548472817255046,11957,8895,20852,+
chr22,29695823,3.130546295173089,13931,11027,24958,+
chr22,29695826,1.3884423980921132,6497,4337,10834,+
chr22,29695828,1.6735712464788035,18916,15946,34862,+
chr22,29695829,1.6843915457781127,15839,13919,29758,+
chr22,29696135,1.5535907614579574,737,488,1225,+
chr22,29696145,1.2809995289697738,1459,1195,2654,+
chr22,29696149,1.5354653439498762,918,814,1732,+
chr22,30163371,1.1858028681078145,782,698,1480,+
chr22,30163372,0.6891417555732225,850,793,1643,+
chr22,30163377,0.8777228887320631,582,544,1126,+
chr22,30163378,0.8777228887320631,582,544,1126,+
chr22,30163382,1.6484584060500294,658,572,1230,+
chr22,30163435,1.8662940461725397,892,822,1714,+
chr22,30163517,1.5894798807115273,2048,1349,3397,+
chr22,30163523,1.6968546637744035,1042,921,1963,+
chr22,30165834,1.7035714285714287,1241,965,2206,+
chr22,30824615,2.9570605187319883,661,346,1007,+
chr22,30824617,2.2127578747856256,879,537,1416,+
chr22,30824792,0.2801039025295318,646,436,1082,+
chr22,30824793,0.2801039025295318,646,436,1082,+
chr22,30824897,3.100522193211489,759,382,1141,+
chr22,30824899,2.383977432050173,961,580,1541,+
chr22,31303521,2.6479008535948036,664,460,1124,+
chr22,31373100,0.86959201008094,833,522,1355,+
chr22,31373831,1.9695526329781945,776,464,1240,+
chr22,31373835,2.702067414424967,821,527,1348,+
chr22,31373887,2.235053653551354,809,514,1323,+
chr22,31373892,0.3631032927379342,965,738,1703,+
chr22,31373914,1.6627694556083303,1109,781,1890,+
chr22,31373915,0.4085,816,479,1295,+
chr22,31373919,1.952610044512387,1315,966,2281,+
chr22,31373924,1.9704937575255719,3021,2426,5447,+
chr22,31373925,1.9704937575255719,3021,2426,5447,+
chr22,31374095,3.0453759674329177,714,503,1217,+
chr22,31795608,1.1463073440671732,747,584,1331,+
chr22,31795611,0.6180247805827453,1244,776,2020,+
chr22,31795626,1.983086240369422,1075,669,1744,+
chr22,31795640,2.6782429009465405,680,576,1256,+
chr22,31795647,1.5372395907264036,3047,2334,5381,+
chr22,31795651,1.784481523680685,5957,4649,10606,+
chr22,31795652,1.6175528579643739,5143,3803,8946,+
chr22,31795701,4.339244186046511,648,429,1077,+
chr22,31799014,2.3589601769911503,852,677,1529,+
chr22,31799015,2.1150306355729347,1733,1288,3021,+
chr22,31799017,1.865051903114187,881,611,1492,+
chr22,31799108,1.9426636568848763,661,442,1103,+
chr22,31799128,2.436501171958236,692,493,1185,+
chr22,31799129,0.9904827586206896,1168,874,2042,+
chr22,31799130,0.9904827586206896,1168,874,2042,+
chr22,31816311,1.7196029776674937,839,619,1458,+
chr22,31819362,6.785185185185186,686,404,1090,+
chr22,31819363,6.785185185185186,686,404,1090,+
chr22,31822620,1.8605421686746986,638,497,1135,+
chr22,31822698,1.8603228962818001,844,729,1573,+
chr22,31823072,1.9861351819757365,954,576,1530,+
chr22,31829895,2.1320443740095087,908,630,1538,+
chr22,31829906,0.4973840770431327,1439,1069,2508,+
chr22,31830057,2.019097736092632,1129,763,1892,+
chr22,31830072,2.1438097354967773,642,408,1050,+
chr22,31830106,0.4867407570422535,982,767,1749,+
chr22,32340794,2.2270740278208963,762,458,1220,+
chr22,32340797,2.0993856596641356,1840,1114,2954,+
chr22,32340798,2.389894736842105,902,474,1376,+
chr22,32352425,3.838637632607482,624,397,1021,+
chr22,32352461,0.980336744407425,844,763,1607,+
chr22,32352462,0.980336744407425,844,763,1607,+
chr22,32352463,0.4419404125286478,533,475,1008,+
chr22,32352756,2.180659986133529,596,455,1051,+
chr22,32352994,1.9101123595505616,611,444,1055,+
chr22,32353081,1.819906910132474,662,440,1102,+
chr22,32353082,1.7423076923076923,754,519,1273,+
chr22,32353285,1.825970548862115,681,497,1178,+
chr22,32879921,0.4647855526593369,1065,743,1808,+
chr22,32889186,1.361084823096817,821,598,1419,+
chr22,32889241,1.6634515506751744,1139,878,2017,+
chr22,32889242,1.710200333576957,1771,1385,3156,+
chr22,32889243,0.42375285924415534,2048,1460,3508,+
chr22,32889244,1.674988096047888,1215,963,2178,+
chr22,32889245,0.4676878294669955,2324,1640,3964,+
chr22,32889247,1.3131926555377262,3236,2599,5835,+
chr22,32889248,1.5112667976724707,2681,2171,4852,+
chr22,32889254,2.1034261241970023,892,933,1825,+
chr22,32889258,2.207850133809099,989,1120,2109,+
chr22,33255937,2.5870919912690833,786,482,1268,+
chr22,35661081,3.4470084357819935,649,514,1163,+
chr22,35691456,14.104544021292602,836,639,1475,+
chr22,35790133,7.813099443519001,930,1771,2701,+
chr22,35790134,7.813099443519001,930,1771,2701,+
chr22,35799202,0.47142660989002844,707,509,1216,+
chr22,35799299,3.5973124268686547,780,523,1303,+
chr22,35804418,1.0968525101881557,1011,606,1617,+
chr22,35804420,1.0968525101881557,1011,606,1617,+
chr22,35804470,2.0855683269476373,709,434,1143,+
chr22,35806789,0.6298292106817526,1078,705,1783,+
chr22,35806846,17.766831096874753,2099,1153,3252,+
chr22,35806847,18.249410645650478,2419,1380,3799,+
chr22,35806890,3.2797784875673996,773,525,1298,+
chr22,35806891,2.049036273253884,724,599,1323,+
chr22,35808621,1.6734877076724917,1002,652,1654,+
chr22,35808669,4.312854228066199,655,400,1055,+
chr22,35809949,1.82695374800638,631,417,1048,+
chr22,35811823,2.3079470198675494,696,452,1148,+
chr22,35812386,2.306292134831461,621,444,1065,+
chr22,35812388,2.306292134831461,621,444,1065,+
chr22,35812769,0.4148010671615821,595,465,1060,+
chr22,35813803,1.1002387504058426,822,699,1521,+
chr22,35813822,0.5277469478357381,633,423,1056,+
chr22,35815909,0.9596243087781698,1113,678,1791,+
chr22,35815911,0.9596243087781698,1113,678,1791,+
chr22,35820397,2.6143208424176105,627,380,1007,+
chr22,37425356,1.387649948794259,763,565,1328,+
chr22,37425366,0.4654151301821433,594,470,1064,+
chr22,37425367,0.4654151301821433,594,470,1064,+
chr22,37425762,3.570033327734819,602,416,1018,+
chr22,37425795,3.5413154655604333,726,482,1208,+
chr22,38062014,6.836250520617731,863,541,1404,+
chr22,38062015,7.686971637917916,979,642,1621,+
chr22,38062028,5.549888069450971,721,646,1367,+
chr22,38062499,1.5226880425510563,1034,718,1752,+
chr22,38062653,2.6,737,491,1228,+
chr22,38062655,2.6,737,491,1228,+
chr22,38071644,1.1174221441732373,3882,3127,7009,+
chr22,38071646,1.0871057087054103,9225,7618,16843,+
chr22,38073012,1.3702091452621343,1981,1512,3493,+
chr22,38073018,1.0003812017678242,5250,3805,9055,+
chr22,38074497,1.9140335895246232,1680,1170,2850,+
chr22,38074626,3.9709299194908088,4133,3179,7312,+
chr22,38074628,3.2752373813093456,1469,1333,2802,+
chr22,38074646,1.653846153846154,687,543,1230,+
chr22,38074648,0.6613100704009794,744,725,1469,+
chr22,38075653,0.49235257016713974,1248,1056,2304,+
chr22,38075669,0.6894626079175435,1862,1630,3492,+
chr22,38075670,1.6449400645458734,1678,1445,3123,+
chr22,38075706,1.728939043815763,1975,1536,3511,+
chr22,38153917,3.3235868596298044,845,387,1232,+
chr22,38153952,1.8229251148959176,612,410,1022,+
chr22,38153969,1.8423446540121915,2342,1286,3628,+
chr22,38153970,1.5509804521398636,1559,673,2232,+
chr22,38201466,2.0980473597219325,641,432,1073,+
chr22,38201607,2.2259191409344776,650,431,1081,+
chr22,38201665,1.0102586009422807,1989,1178,3167,+
chr22,38201666,1.854458753775294,1465,867,2332,+
chr22,38201667,1.231593940857287,3289,2000,5289,+
chr22,38201669,1.4461798413180216,3257,2040,5297,+
chr22,38201708,1.060093167888522,1776,1042,2818,+
chr22,38202408,38.06347733898754,822,685,1507,+
chr22,38202409,27.04294800830255,5260,4591,9851,+
chr22,38202410,27.04294800830255,5260,4591,9851,+
chr22,38202411,26.171670622968808,4989,4529,9518,+
chr22,38202421,0.3980291630601238,426,652,1078,+
chr22,38202458,4.314709245793523,4126,5550,9676,+
chr22,38202459,4.419144702872242,4884,6511,11395,+
chr22,38202460,4.419144702872242,4884,6511,11395,+
chr22,38202671,1.8928390693730146,700,459,1159,+
chr22,38202844,1.648763786764706,805,743,1548,+
chr22,38202903,7.907277286567636,1574,1212,2786,+
chr22,38203120,5.830354241143971,1195,180,1375,+
chr22,38203121,5.8267716535433065,924,126,1050,+
chr22,38203122,9.244286313396394,3383,519,3902,+
chr22,38203123,11.234603075793704,1594,261,1855,+
chr22,38203124,9.36230727922191,2193,337,2530,+
chr22,38203125,7.881226053639847,934,144,1078,+
chr22,38203129,28.262612853197695,3580,644,4224,+
chr22,38203130,31.487258444194083,3284,596,3880,+
chr22,38203131,20.578019443071344,1863,356,2219,+
chr22,38203133,21.589506010891906,3349,2605,5954,+
chr22,38203134,20.2266582370881,2885,2522,5407,+
chr22,38203137,0.43891936841115187,2002,3010,5012,+
chr22,38203138,1.3286524141181677,3764,6129,9893,+
chr22,38203139,0.8822984465580476,3661,6618,10279,+
chr22,38203140,0.9502205297128357,6455,10062,16517,+
chr22,38203141,0.9531665574966988,4617,7453,12070,+
chr22,38203142,0.9093969235735254,3514,5930,9444,+
chr22,38203177,0.6020932927712589,664,707,1371,+
chr22,38203236,0.3470067397911986,690,804,1494,+
chr22,38245422,1.1793409730647784,928,768,1696,+
chr22,38245424,1.1191221273380871,1430,1221,2651,+
chr22,38245425,1.8960849369608486,784,684,1468,+
chr22,38245427,0.5179228915951551,1300,1005,2305,+
chr22,38245429,0.4949029465158497,885,692,1577,+
chr22,38245444,0.5986842105263158,636,531,1167,+
chr22,38245445,1.2821646322282008,2132,1569,3701,+
chr22,38245454,0.6120986439963465,791,661,1452,+
chr22,38245461,0.6935901768615522,1047,806,1853,+
chr22,38245472,0.6647262647262647,1307,961,2268,+
chr22,38245473,1.5180825549103762,3206,2096,5302,+
chr22,38245475,1.5180825549103762,3206,2096,5302,+
chr22,38246041,1.7655780726053365,2181,1804,3985,+
chr22,38247425,1.3798619300314467,4222,2559,6781,+
chr22,38247487,1.333339574946166,2296,1941,4237,+
chr22,38259302,1.378025866543841,3277,2153,5430,+
chr22,38259303,1.4466962640146979,5747,4348,10095,+
chr22,38266267,1.2778687204808932,2180,1631,3811,+
chr22,38270400,1.7604715558931159,2839,2334,5173,+
chr22,38270424,0.8027073107724102,2177,1658,3835,+
chr22,38270508,1.650754030989714,3108,2778,5886,+
chr22,38271976,3.3989915966386555,1579,1189,2768,+
chr22,38271979,1.2058035143781587,3923,2792,6715,+
chr22,38273683,0.559770768210666,2675,1862,4537,+
chr22,38273690,1.3377367675694811,2674,1882,4556,+
chr22,38273755,1.7921881743634007,1660,1323,2983,+
chr22,38273791,1.4052808407994486,1874,1450,3324,+
chr22,38273807,1.4139772575947152,6349,4671,11020,+
chr22,38273932,2.064744668911336,1014,527,1541,+
chr22,38273939,1.9567587209302328,1076,601,1677,+
chr22,38273948,2.113412075530344,1264,756,2020,+
chr22,38273951,1.5726923076923078,1362,831,2193,+
chr22,38273963,2.256172839506173,1138,803,1941,+
chr22,38274041,1.7873552789169964,1330,933,2263,+
chr22,38274048,1.4680316091954022,1406,1007,2413,+
chr22,38274122,1.360136949727514,2061,1552,3613,+
chr22,38274167,1.3558246828143024,2350,1512,3862,+
chr22,38282781,1.3378219709278396,2968,2006,4974,+
chr22,38282811,1.6083452295979064,3956,2801,6757,+
chr22,38282832,1.372416769345093,9279,6380,15659,+
chr22,38349728,0.42913710608810424,764,550,1314,+
chr22,38349729,0.42913710608810424,764,550,1314,+
chr22,38349789,2.42923943124344,687,498,1185,+
chr22,38349791,2.42923943124344,687,498,1185,+
chr22,38355413,2.110543689320388,918,582,1500,+
chr22,38878612,2.2258081786732906,781,662,1443,+
chr22,38878637,2.0380380380380383,1017,998,2015,+
chr22,38878639,2.0380380380380383,1017,998,2015,+
chr22,38878909,2.5669604770721883,766,562,1328,+
chr22,39916566,0.8403151849767585,4918,2073,6991,+
chr22,39916567,0.9132123097073408,10682,4540,15222,+
chr22,39916568,0.9318377742732981,8513,3615,12128,+
chr22,39916569,0.8190844606961251,8137,3267,11404,+
chr22,39916570,2.1855591741309235,6959,2884,9843,+
chr22,39916572,2.068303329563861,7784,2989,10773,+
chr22,39916573,2.026051599462222,9827,4425,14252,+
chr22,39916588,1.804223433242507,1614,733,2347,+
chr22,39916594,1.8137478682933228,1893,1209,3102,+
chr22,39916615,1.8641611593279723,1950,1321,3271,+
chr22,39916640,3.1181945907973305,1339,875,2214,+
chr22,39916649,1.5132098937104217,3546,2104,5650,+
chr22,39916731,0.6393702451394759,2016,1091,3107,+
chr22,39917434,1.8536644165863068,1630,951,2581,+
chr22,39917447,1.5002685284640171,1811,930,2741,+
chr22,39917450,1.5845297481428156,4016,2345,6361,+
chr22,39917457,1.2681770284510012,2406,1611,4017,+
chr22,39917530,1.5098465643762506,4503,2997,7500,+
chr22,39917532,1.627210020285178,6922,4683,11605,+
chr22,39917533,1.4799460975854355,7047,4596,11643,+
chr22,39917604,1.5105952503690752,4764,3362,8126,+
chr22,39917612,1.5089289408816036,2658,1858,4516,+
chr22,39917663,1.0897781867793792,6242,4410,10652,+
chr22,39917796,1.0402796177565556,5401,4245,9646,+
chr22,39917813,1.3276798606749054,6012,4746,10758,+
chr22,39917927,1.491929339974965,3167,2926,6093,+
chr22,39917939,0.9839500975701876,3356,2443,5799,+
chr22,39917941,0.9839500975701876,3356,2443,5799,+
chr22,39917994,1.4824357686425387,9751,6866,16617,+
chr22,39917995,1.649376395962981,5015,3682,8697,+
chr22,39917997,0.7577919187349033,2844,1650,4494,+
chr22,39918029,1.466743014410065,4086,2975,7061,+
chr22,39918085,1.5188089628984198,4033,2816,6849,+
chr22,39918215,0.9302207278605984,7463,4941,12404,+
chr22,39918276,1.4180501968468007,5509,3409,8918,+
chr22,39918401,1.7860585197934598,1152,580,1732,+
chr22,39918413,1.8765469464622009,1360,707,2067,+
chr22,39918416,1.5398808053359685,1634,1011,2645,+
chr22,39918430,1.6035471873167988,6470,4262,10732,+
chr22,39918443,1.3269360269360269,2251,1319,3570,+
chr22,39918545,1.416196128896709,1518,1312,2830,+
chr22,39918564,1.5761903500172227,2258,1550,3808,+
chr22,39918590,1.1658597590227033,13216,9982,23198,+
chr22,39918592,1.4054447715853997,5678,4622,10300,+
chr22,40745860,0.6422050679644236,1561,1009,2570,+
chr22,40745862,0.6422050679644236,1561,1009,2570,+
chr22,40746001,2.211527854384997,593,517,1110,+
chr22,40750261,2.206281607665691,613,441,1054,+
chr22,40750299,1.0555750350631137,668,495,1163,+
chr22,40750300,1.0555750350631137,668,495,1163,+
chr22,40755291,0.3160851382560389,632,432,1064,+
chr22,40757623,3.469135802469136,561,485,1046,+
chr22,40760323,2.2503012566706833,1215,627,1842,+
chr22,40760325,2.2503012566706833,1215,627,1842,+
chr22,40760893,1.1694616371178077,1437,1079,2516,+
chr22,40760894,0.539467749210645,919,738,1657,+
chr22,40760950,1.961796231661366,682,526,1208,+
chr22,40761010,2.0307266709479816,955,652,1607,+
chr22,40761016,2.0606617647058822,1120,815,1935,+
chr22,40761020,1.4540023894862606,1216,929,2145,+
chr22,40800621,2.1677062032068113,732,569,1301,+
chr22,41347455,2.797420507246252,772,704,1476,+
chr22,41347463,1.9646142958244868,693,470,1163,+
chr22,41347473,1.4685838898732453,861,637,1498,+
chr22,41347476,0.6551606288448394,709,664,1373,+
chr22,41349559,1.9753231492361925,614,554,1168,+
chr22,41349624,1.564444444444445,879,749,1628,+
chr22,41360054,1.441678192715537,1120,722,1842,+
chr22,41755956,0.1929718765418563,439,628,1067,+
chr22,41755958,0.2843898428936792,478,643,1121,+
chr22,42017316,0.7252212389380531,1936,1299,3235,+
chr22,42017317,0.7252212389380531,1936,1299,3235,+
chr22,42017318,0.7252212389380531,1936,1299,3235,+
chr22,42017323,0.7980825180681614,922,802,1724,+
chr22,42017324,0.6460300679331857,1512,1064,2576,+
chr22,42032247,1.557227777205099,3295,2135,5430,+
chr22,42033716,1.537519290123457,1677,1295,2972,+
chr22,42033738,1.4635007849293562,2485,1567,4052,+
chr22,42042934,1.7010770975056688,810,503,1313,+
chr22,42042953,1.4623889555822331,1996,1189,3185,+
chr22,42043013,1.3654053805683828,1747,1318,3065,+
chr22,42046787,1.547534075271089,4044,2398,6442,+
chr22,42046788,1.547534075271089,4044,2398,6442,+
chr22,42046834,0.653631284916201,1169,894,2063,+
chr22,42049597,1.540023510971787,1738,1275,3013,+
chr22,42049598,1.5397405071904913,2661,1973,4634,+
chr22,42049600,1.523529411764706,1812,1359,3171,+
chr22,42049653,1.8875906785645504,1088,841,1929,+
chr22,42049670,1.318873946506641,1958,1398,3356,+
chr22,42054296,2.7640625,792,519,1311,+
chr22,42054347,1.7849529780564262,948,714,1662,+
chr22,42057352,1.872611464968153,1028,784,1812,+
chr22,42059712,1.788971183531553,4693,3134,7827,+
chr22,42059714,1.53194967074318,3520,2125,5645,+
chr22,42059772,1.5715265530080342,745,566,1311,+
chr22,42091666,1.6746064779231582,743,479,1222,+
chr22,42091680,3.264233276213967,747,501,1248,+
chr22,42262858,1.8690292604689567,975,621,1596,+
chr22,42263208,2.765545606797656,773,567,1340,+
chr22,42264788,2.74327924453498,603,470,1073,+
chr22,42266921,2.436807725078103,857,502,1359,+
chr22,42266923,2.436807725078103,857,502,1359,+
chr22,42271404,2.4633215962441315,729,425,1154,+
chr22,42271407,3.0980328926152856,738,442,1180,+
chr22,42271440,2.112574850299401,1763,1168,2931,+
chr22,42271441,2.112574850299401,1763,1168,2931,+
chr22,42271449,1.874230164081816,2110,1482,3592,+
chr22,42271451,1.874230164081816,2110,1482,3592,+
chr22,42271550,1.8422933375684905,2319,1798,4117,+
chr22,42271552,1.8422933375684905,2319,1798,4117,+
chr22,42271553,0.6295579609360826,1076,718,1794,+
chr22,42273985,1.683732057416268,620,569,1189,+
chr22,42273987,1.8128606862237273,1066,863,1929,+
chr22,42280851,0.6104536489151874,618,441,1059,+
chr22,42280853,1.9602044541803574,766,497,1263,+
chr22,42280876,1.6355351359493862,1009,780,1789,+
chr22,42280960,1.0815334496863713,911,549,1460,+
chr22,42280979,2.2720329010051437,796,566,1362,+
chr22,42289265,2.1749453644182344,935,649,1584,+
chr22,42290859,1.2950000748186328,621,477,1098,+
chr22,42299066,0.8323074081960744,595,482,1077,+
chr22,42301822,1.2318589801289197,692,515,1207,+
chr22,42301942,1.898469637997596,821,639,1460,+
chr22,42301980,3.4610643436500963,922,671,1593,+
chr22,42302280,5.184225339764796,997,290,1287,+
chr22,42302290,15.174492530328068,1185,483,1668,+
chr22,42302291,13.623869505458472,1505,613,2118,+
chr22,42302299,17.63714614234396,2702,2634,5336,+
chr22,42302300,17.63714614234396,2702,2634,5336,+
chr22,42302301,17.63714614234396,2702,2634,5336,+
chr22,42302357,0.49456807524676005,523,569,1092,+
chr22,42302483,5.565356301345629,965,789,1754,+
chr22,42302484,6.14241336482669,1342,1102,2444,+
chr22,42303206,2.2406876790830945,781,348,1129,+
chr22,42303207,2.71125787225855,2080,1102,3182,+
chr22,42303213,2.335180802870874,1250,737,1987,+
chr22,42303214,3.1109197876309365,1083,605,1688,+
chr22,42303216,3.491606714628297,727,416,1143,+
chr22,42303224,9.424951549055752,4462,3375,7837,+
chr22,42303225,7.173604968826789,6174,4873,11047,+
chr22,42303226,8.258068779042913,4439,3550,7989,+
chr22,42303227,5.378273595903357,4504,3678,8182,+
chr22,42478013,0.9517645437000275,1408,1169,2577,+
chr22,42478014,0.9517645437000275,1408,1169,2577,+
chr22,42478030,0.6296837267274286,1042,777,1819,+
chr22,43547564,0.634029362026404,1016,537,1553,+
chr22,43547568,2.0716906615366577,880,535,1415,+
chr22,43547583,2.02113327848622,781,491,1272,+
chr22,43555237,1.9622153725830678,864,643,1507,+
chr22,43555410,2.422322775263952,802,441,1243,+
chr22,43557081,2.5961538461538463,649,519,1168,+
chr22,43557099,0.5218003978779842,1258,753,2011,+
chr22,43557146,3.0568391866913123,629,540,1169,+
chr22,43557184,0.43809132044426163,638,560,1198,+
chr22,43557185,1.951830985915493,675,567,1242,+
chr22,43558822,1.4758227615370474,697,587,1284,+
chr22,43558869,2.0006349206349205,684,374,1058,+
chr22,43558896,1.8234101579172,742,425,1167,+
chr22,43558904,1.004516711833785,1667,901,2568,+
chr22,43558905,1.004516711833785,1667,901,2568,+
chr22,43558933,1.8786827551533436,1891,1169,3060,+
chr22,43558935,1.5306767025657262,2388,1677,4065,+
chr22,43559047,2.251344086021505,669,371,1040,+
chr22,43559048,2.828034682080925,926,691,1617,+
chr22,43559049,2.828034682080925,926,691,1617,+
chr22,43559090,1.3738909531401198,2485,1670,4155,+
chr22,43559091,1.2831392329945848,1673,1036,2709,+
chr22,43559164,0.6224690111615907,1073,848,1921,+
chr22,44041160,0.34733367561354206,788,578,1366,+
chr22,44368184,0.6801942567567568,766,639,1405,+
chr22,44489819,2.026769943504972,626,487,1113,+
chr22,44489842,2.396296296296296,646,377,1023,+
chr22,44489850,2.092106683943419,624,440,1064,+
chr22,44489857,1.9813279576107423,2539,1889,4428,+
chr22,44489858,1.6890221886508279,2403,1870,4273,+
chr22,44489861,1.697885471699961,5172,4016,9188,+
chr22,44489862,1.8533914706460004,3926,3068,6994,+
chr22,45577187,2.856363316317549,600,436,1036,+
chr22,45577200,1.9567635159279158,1243,902,2145,+
chr22,45577221,2.1316329522134274,660,378,1038,+
chr22,45898911,4.7436843854314885,663,394,1057,+
chr22,45914601,2.7840166943364832,2022,1442,3464,+
chr22,45914603,2.34280193236715,1298,1034,2332,+
chr22,45914606,2.12687265917603,648,533,1181,+
chr22,45914616,2.1478473581213304,812,510,1322,+
chr22,45921526,2.507395940832473,787,683,1470,+
chr22,45921528,1.8149707920119549,834,432,1266,+
chr22,45921546,0.6364091648929511,781,651,1432,+
chr22,45923736,0.6609195402298851,934,560,1494,+
chr22,45923783,1.8457378012933567,1001,728,1729,+
chr22,45923857,2.279464285714285,1701,1399,3100,+
chr22,45927187,1.355418187910644,2470,1869,4339,+
chr22,45928963,0.40882992605480645,722,604,1326,+
chr22,45929683,0.9324949032209123,4068,2767,6835,+
chr22,45929684,0.6742410687660285,2583,1655,4238,+
chr22,45929751,1.8076969501891045,1522,1155,2677,+
chr22,45938077,1.7402421307506053,1122,884,2006,+
chr22,45938102,1.451125,1221,749,1970,+
chr22,45944534,2.0341929875398432,519,492,1011,+
chr22,45944545,1.224506682230849,1873,1246,3119,+
chr22,45944548,1.8918283149971045,1024,627,1651,+
chr22,45944614,1.0930703143355915,3559,2599,6158,+
chr22,45944615,0.9227423748205228,2341,1898,4239,+
chr22,45946472,2.223539172691715,1339,766,2105,+
chr22,45946476,1.7540472175379425,1757,1185,2942,+
chr22,45946482,1.965872189204093,1425,858,2283,+
chr22,45958817,0.5621913645380492,1109,816,1925,+
chr22,45958879,1.500936843053429,1565,1217,2782,+
chr22,45958978,1.8635404175470913,1445,950,2395,+
chr22,45958982,2.459459459459459,727,517,1244,+
chr22,45959068,1.8646307237744904,3882,2690,6572,+
chr22,45959069,1.8646307237744904,3882,2690,6572,+
chr22,45959126,1.3625954198473282,1257,1047,2304,+
chr22,45996366,2.197465201288146,753,503,1256,+
chr22,45996403,2.4547629703023186,647,567,1214,+
chr22,46068040,0.8352933038184834,689,555,1244,+
chr22,46068041,1.3397557906165691,1137,867,2004,+
chr22,46068042,0.8352933038184834,689,555,1244,+
chr22,46068043,1.0036002304147464,605,433,1038,+
chr22,46085592,1.2659459112180071,889,748,1637,+
chr22,46085627,0.2897455278407659,574,440,1014,+
chr22,46085646,1.5435153583617747,803,585,1388,+
chr22,46096210,0.5947779862414009,826,614,1440,+
chr22,46096211,1.5553246753246752,997,824,1821,+
chr22,46098577,1.5739644970414202,987,675,1662,+
chr22,46098592,0.6611874513870885,1243,1014,2257,+
chr22,46114319,1.7530944625407163,1195,920,2115,+
chr22,46125333,1.923371010638298,1101,751,1852,+
chr22,46134623,1.7973034770953245,1582,1152,2734,+
chr22,46134624,1.7973034770953245,1582,1152,2734,+
chr22,46134649,0.6246147919876733,845,648,1493,+
chr22,46134650,1.5961773700305812,802,653,1455,+
chr22,46136296,1.6568314726209463,812,626,1438,+
chr22,46136335,3.0277432712215324,913,689,1602,+
chr22,46202892,1.9602911670010732,976,738,1714,+
chr22,46239037,1.4597861331493618,1373,1114,2487,+
chr22,46239620,1.4559747131175704,1557,1154,2711,+
chr22,47059945,0.37994504458825135,635,460,1095,+
chr22,47059954,1.7169892255767998,607,471,1078,+
chr22,47064732,4.202671428247234,693,394,1087,+
chr22,47073948,1.8639900515701144,610,498,1108,+
chr22,47074700,3.693461418945344,651,416,1067,+
chr22,47075162,4.540629598035173,736,587,1323,+
chr22,47075163,4.540629598035173,736,587,1323,+
chr22,47075474,1.8597518610421835,913,649,1562,+
chr22,50355362,0.761237897648686,628,481,1109,+
chr22,50355364,0.761237897648686,628,481,1109,+
chr22,50356836,2.352027412003039,871,565,1436,+
chr22,50357221,0.7071590451479113,727,542,1269,+
chr22,50357360,32.616898614829516,2911,1506,4417,+
chr22,50357361,32.616898614829516,2911,1506,4417,+
chr22,50357362,32.616898614829516,2911,1506,4417,+
chr22,50357440,0.4122621564482029,610,472,1082,+
chr22,50357453,1.0540958268933538,857,646,1503,+
chr22,50357454,1.0540958268933538,857,646,1503,+
chr22,50357480,0.6480872069107363,821,571,1392,+
chr22,50357509,1.6157565415244597,896,585,1481,+
chr22,50877052,2.6051688001647144,721,521,1242,+
chr22,50877053,3.4011129033509744,737,555,1292,+
chrX,1419385,0.4649624060150376,772,531,1303,+
chrX,1419387,0.4220540913397226,975,655,1630,+
chrX,1419389,2.296704336597666,699,440,1139,+
chrX,1419410,2.0187057633973717,1330,988,2318,+
chrX,1419411,2.0187057633973717,1330,988,2318,+
chrX,1419412,2.0187057633973717,1330,988,2318,+
chrX,1419414,2.0952759908924112,1480,886,2366,+
chrX,1419416,2.0952759908924112,1480,886,2366,+
chrX,1422906,1.4269519577956045,989,617,1606,+
chrX,1422907,0.8705491491023224,1034,606,1640,+
chrX,1718185,1.8313753465627647,1577,1289,2866,+
chrX,1718186,1.8597318055333227,1879,1594,3473,+
chrX,1718187,2.3716153127917834,1142,1070,2212,+
chrX,1718188,2.2442750861912537,870,834,1704,+
chrX,2609339,1.384149160241932,1332,874,2206,+
chrX,2632474,0.988793671720501,999,887,1886,+
chrX,2632476,1.404890382595984,1530,1233,2763,+
chrX,2635656,0.5411139455782313,1156,783,1939,+
chrX,2635657,0.5411139455782313,1156,783,1939,+
chrX,2635665,1.6638764729784643,705,534,1239,+
chrX,2635677,0.408268156424581,782,536,1318,+
chrX,2635678,2.731179971988796,760,475,1235,+
chrX,2638433,1.666519586213659,606,522,1128,+
chrX,2641355,1.9193438140806558,701,538,1239,+
chrX,2641390,1.2521098230521448,1518,1369,2887,+
chrX,2641391,1.041995231982395,946,930,1876,+
chrX,2641399,1.0360742705570292,944,724,1668,+
chrX,2641400,1.4863933023973483,1503,1175,2678,+
chrX,2644325,0.2288657485164035,583,457,1040,+
chrX,2644384,1.895064935064935,607,524,1131,+
chrX,2644405,1.845,737,559,1296,+
chrX,2644408,1.9207006369426751,814,627,1441,+
chrX,2644409,1.7497921186049958,1624,1216,2840,+
chrX,2656273,1.6786911899197234,825,756,1581,+
chrX,2658857,0.6480384022756904,809,648,1457,+
chrX,2658887,1.310499942866723,1562,1215,2777,+
chrX,2658915,1.568953301127214,640,574,1214,+
chrX,2658934,0.5159663865546219,613,594,1207,+
chrX,2658938,1.8008058176100628,732,423,1155,+
chrX,2658973,0.6433542976939203,958,674,1632,+
chrX,2659180,1.2062193821770166,525,508,1033,+
chrX,2659188,1.125971465225744,1437,1233,2670,+
chrX,2659189,1.8618607954545452,748,511,1259,+
chrX,2659190,0.9550213688878315,1157,1133,2290,+
chrX,2659216,2.092295345104334,631,622,1253,+
chrX,2659218,0.5226183672572208,742,528,1270,+
chrX,7108996,1.8064199113616681,709,544,1253,+
chrX,7252068,1.7862744185095247,750,635,1385,+
chrX,7268632,1.4133934145631792,620,389,1009,+
chrX,7269474,7.082886264501436,640,466,1106,+
chrX,7270921,3.042461885940147,928,769,1697,+
chrX,7270922,3.2302636049053834,1752,1541,3293,+
chrX,7270923,3.2302636049053834,1752,1541,3293,+
chrX,7270924,3.420681423611111,1260,1151,2411,+
chrX,7270926,4.614991683358762,945,901,1846,+
chrX,9687275,1.176678445229682,1109,565,1674,+
chrX,9687276,1.176678445229682,1109,565,1674,+
chrX,9687277,1.176678445229682,1109,565,1674,+
chrX,9687319,2.0951304085632443,1068,736,1804,+
chrX,11136686,2.4818976757361635,805,565,1370,+
chrX,12817493,0.6810572508327882,745,592,1337,+
chrX,12993226,1.0397909590400218,43326,31540,74866,+
chrX,12993227,1.0753213977114011,10477,7796,18273,+
chrX,12993228,1.0397909590400216,43326,31540,74866,+
chrX,12995028,0.564794436129941,1221,613,1834,+
chrX,12995034,1.355793509573247,4424,2578,7002,+
chrX,12995037,1.0231953542006818,6056,4002,10058,+
chrX,12995038,1.0231953542006818,6056,4002,10058,+
chrX,12995039,1.625542784163474,2235,1130,3365,+
chrX,12995061,1.3113499029338582,2639,1502,4141,+
chrX,12995063,1.4217421223614513,3640,1964,5604,+
chrX,12995064,1.3422439759036144,2874,1659,4533,+
chrX,12995066,0.9770625209399352,21726,13868,35594,+
chrX,12995067,1.0074428044027228,8572,4607,13179,+
chrX,12995068,1.0945121481213136,13244,8828,22072,+
chrX,12995070,1.3320998157530703,10084,5601,15685,+
chrX,12995071,1.3320998157530703,10084,5601,15685,+
chrX,12995074,0.7398579321231255,4686,3438,8124,+
chrX,12995078,1.8492086464522892,4368,2860,7228,+
chrX,12995174,3.2711913453833135,9796,2041,11837,+
chrX,12995175,3.2711913453833135,9796,2041,11837,+
chrX,12995188,84.34671480871631,38316,18857,57173,+
chrX,12995189,84.34671480871631,38316,18857,57173,+
chrX,12995204,0.6669507136149637,4626,3656,8282,+
chrX,13726844,2.0272952853598016,816,428,1244,+
chrX,13726846,2.0272952853598016,816,428,1244,+
chrX,13726848,1.264736210715146,798,518,1316,+
chrX,13726856,0.5527563571817944,1051,629,1680,+
chrX,13726861,1.7957635983263598,762,477,1239,+
chrX,13727140,1.5325171475528983,1595,1150,2745,+
chrX,13727235,4.87784679089027,759,482,1241,+
chrX,13727361,1.8220461245850508,1121,744,1865,+
chrX,16753423,2.309282559773994,810,552,1362,+
chrX,16753424,1.8214285714285716,611,447,1058,+
chrX,16778375,3.0335959320186023,864,610,1474,+
chrX,16778397,0.7057612188812171,855,669,1524,+
chrX,16861633,1.1242668691803104,1082,767,1849,+
chrX,16861634,1.0596776674336925,853,583,1436,+
chrX,17772393,1.7083333333333333,696,407,1103,+
chrX,17772700,1.9703216408733641,934,667,1601,+
chrX,19368122,1.1821423819028607,1032,834,1866,+
chrX,19368123,1.052083063896648,2778,2179,4957,+
chrX,19368124,0.5494140624999999,1066,879,1945,+
chrX,19368127,2.4957969865186365,561,484,1045,+
chrX,19369475,0.9534203145957808,1116,833,1949,+
chrX,19369476,0.9534203145957808,1116,833,1949,+
chrX,19372624,3.0434782608695654,1028,587,1615,+
chrX,19372625,3.0434782608695654,1028,587,1615,+
chrX,19372645,1.2354405089684697,1105,778,1883,+
chrX,19372654,1.7241886171213545,1563,1062,2625,+
chrX,19372655,1.6923145808794489,2342,1556,3898,+
chrX,19373473,1.6888061245603145,741,536,1277,+
chrX,19373488,2.532701736890219,801,572,1373,+
chrX,19373527,1.8997668997669,814,593,1407,+
chrX,19373565,1.110297809135575,2025,1392,3417,+
chrX,19373809,1.854971131945548,1029,650,1679,+
chrX,19377063,2.0140539672341795,808,565,1373,+
chrX,19377724,0.4835164835164836,725,461,1186,+
chrX,19377807,1.756989247311828,930,650,1580,+
chrX,19377841,0.9978735550164121,1370,1273,2643,+
chrX,19377842,0.9978735550164121,1370,1273,2643,+
chrX,21958938,3.0586981996377967,775,446,1221,+
chrX,21958939,2.2976594983034135,915,654,1569,+
chrX,21985331,0.9704105895434413,1379,917,2296,+
chrX,21985332,0.4954154191616766,1058,667,1725,+
chrX,21985377,2.0194696453874603,1828,1108,2936,+
chrX,21985379,2.0194696453874603,1828,1108,2936,+
chrX,21985384,1.7878787878787878,1061,692,1753,+
chrX,21985399,1.7339246119733926,781,409,1190,+
chrX,21985401,0.5510189826608596,2272,1414,3686,+
chrX,21985402,1.5331010452961673,615,450,1065,+
chrX,21985403,0.5905095052711101,3265,1943,5208,+
chrX,21985415,1.7560011709601875,3482,2195,5677,+
chrX,21985417,1.7560011709601875,3482,2195,5677,+
chrX,21985423,1.6543851717902354,1688,947,2635,+
chrX,21995181,2.8717105263157894,872,512,1384,+
chrX,21995212,1.6926488706365506,643,486,1129,+
chrX,21996153,0.487408834457135,758,558,1316,+
chrX,21997001,1.4373245140864237,2109,1673,3782,+
chrX,22012499,2.023635779142852,1239,845,2084,+
chrX,22012525,2.381374722838137,715,409,1124,+
chrX,22012702,1.8181818181818183,703,483,1186,+
chrX,22012703,2.0368589743589745,712,597,1309,+
chrX,22012725,0.5222948523403759,941,658,1599,+
chrX,22012793,1.3117726569070502,3165,2282,5447,+
chrX,22012847,1.1080612557496639,1277,957,2234,+
chrX,23093954,1.9280494658836909,805,623,1428,+
chrX,23685640,0.7488180567699483,1624,892,2516,+
chrX,23685666,2.0555320247881452,2075,1278,3353,+
chrX,23685667,1.9293487359785702,803,542,1345,+
chrX,23685714,2.0238119092558344,949,675,1624,+
chrX,23685716,2.0187620889748548,851,469,1320,+
chrX,23685748,3.3996945724312453,1547,1141,2688,+
chrX,23685751,2.0655679603048025,751,593,1344,+
chrX,23685829,2.0893553223388306,870,579,1449,+
chrX,23685847,1.6767676767676765,663,575,1238,+
chrX,23685901,0.6371308016877637,905,710,1615,+
chrX,23685910,1.7747815738256354,2792,2107,4899,+
chrX,23685914,1.041419836417057,2850,1798,4648,+
chrX,23685915,1.041419836417057,2850,1798,4648,+
chrX,23685924,1.4967527781786694,3456,2196,5652,+
chrX,23685925,1.5370369046355525,4284,2917,7201,+
chrX,23697281,1.557170107719928,1585,1113,2698,+
chrX,23697285,1.0237301880244656,5107,3670,8777,+
chrX,23701818,2.083109559613319,1069,930,1999,+
chrX,23801300,0.46308324914421106,871,781,1652,+
chrX,23801314,1.4509666476409266,859,602,1461,+
chrX,23801318,1.3558474108479328,1457,1248,2705,+
chrX,23801320,1.3558474108479328,1457,1248,2705,+
chrX,23801421,1.4336283185840708,3914,3276,7190,+
chrX,23801422,1.4336283185840708,3914,3276,7190,+
chrX,23801448,1.4890477155320943,4733,3227,7960,+
chrX,23801450,1.5253037775179217,3260,2313,5573,+
chrX,23801451,1.5269152848933647,3959,2717,6676,+
chrX,23801456,0.6969764339706536,3431,2703,6134,+
chrX,23801464,0.8081107702909706,3852,2870,6722,+
chrX,23801466,1.4518783197531018,4408,2936,7344,+
chrX,23801473,0.7878046279522849,4903,3441,8344,+
chrX,23801517,1.6274126017826411,3045,2048,5093,+
chrX,23801526,1.6488504048024326,12508,9349,21857,+
chrX,23801787,2.1997437399629187,23026,20011,43037,+
chrX,23801788,1.9807083813846116,34769,29533,64302,+
chrX,23801800,1.702823770472028,36586,34462,71048,+
chrX,23801801,1.6456120057228092,13514,12102,25616,+
chrX,23802202,2.3506921416170203,1087,517,1604,+
chrX,23802235,2.249297529040294,1687,932,2619,+
chrX,23802237,2.134449208723986,3848,2071,5919,+
chrX,23802239,2.104678458346981,2786,1703,4489,+
chrX,23802240,2.0148590441303837,3373,1950,5323,+
chrX,23802473,2.2355947394784095,1170,704,1874,+
chrX,23802560,1.5412306747151734,575,435,1010,+
chrX,23802792,1.5465721715630343,1236,742,1978,+
chrX,23802793,1.2648318042813456,1033,653,1686,+
chrX,23802794,1.2648318042813456,1033,653,1686,+
chrX,23802803,1.042273246600081,807,630,1437,+
chrX,23802805,1.042273246600081,807,630,1437,+
chrX,23802847,0.4120458653595332,1674,1043,2717,+
chrX,23802854,0.8098419606958506,2805,1611,4416,+
chrX,23802855,0.8098419606958506,2805,1611,4416,+
chrX,23802856,0.8098419606958506,2805,1611,4416,+
chrX,23803670,1.3551505311223209,6176,4658,10834,+
chrX,23803852,0.8863554791407458,22840,16453,39293,+
chrX,23803853,0.9373097006691641,24279,18066,42345,+
chrX,23803854,1.1996998572295043,29435,23072,52507,+
chrX,23803855,1.2346402879043725,26409,20767,47176,+
chrX,23803858,0.8196514134650942,5050,3751,8801,+
chrX,23803894,2.2314755742993846,19067,15028,34095,+
chrX,23803953,1.2665677764877588,4952,3811,8763,+
chrX,23804113,1.6515287769784173,3672,3279,6951,+
chrX,24073785,0.4637302708616225,2517,1800,4317,+
chrX,24073786,0.46154900794179954,3991,2732,6723,+
chrX,24078292,1.7602739726027397,1027,583,1610,+
chrX,24080538,2.3677605280282608,1414,1040,2454,+
chrX,24080546,1.4187342027886767,4990,3681,8671,+
chrX,24084175,2.690982776089159,663,422,1085,+
chrX,24084181,2.2570277240490006,1320,939,2259,+
chrX,24084182,2.2570277240490006,1320,939,2259,+
chrX,24089728,1.4730051557615458,2367,1744,4111,+
chrX,24091222,0.6997765939164805,1017,758,1775,+
chrX,24091223,1.5570511855882958,1571,1042,2613,+
chrX,24091241,1.9082986730045552,1174,764,1938,+
chrX,24091248,2.0888704318936875,1005,773,1778,+
chrX,24094855,1.8824040688998993,1161,644,1805,+
chrX,24094863,2.5942580421999306,599,412,1011,+
chrX,24094952,0.48249664829435424,1895,1175,3070,+
chrX,24095057,2.0839808046863513,1884,1184,3068,+
chrX,24095058,2.4835504336592042,2151,1408,3559,+
chrX,24095060,4.108974358974359,640,431,1071,+
chrX,24095061,1.9838554679992315,793,472,1265,+
chrX,24095063,1.8397877984084883,1155,714,1869,+
chrX,24095065,1.1292977758218765,1516,1063,2579,+
chrX,24095070,0.6774716962082985,2696,1952,4648,+
chrX,24095071,0.6873621489943049,2319,1641,3960,+
chrX,24095288,0.844506491535976,2381,1256,3637,+
chrX,24095289,0.8230500390608938,1651,828,2479,+
chrX,24095290,0.9500829467979583,2349,1230,3579,+
chrX,24095291,1.2858846918489064,1022,502,1524,+
chrX,24095294,1.643853778561634,995,531,1526,+
chrX,24095309,2.283983451536643,1309,939,2248,+
chrX,24095310,2.0409742384575127,2742,1904,4646,+
chrX,24095451,0.7795335037620071,2280,1486,3766,+
chrX,24095452,1.2491230889442013,2255,1539,3794,+
chrX,24095453,1.3933466291469734,1353,881,2234,+
chrX,24095672,1.6520763187429854,735,593,1328,+
chrX,24095773,2.36441893830703,720,573,1293,+
chrX,24095850,1.5643141554619426,752,558,1310,+
chrX,24095899,1.1546338922781918,2692,1942,4634,+
chrX,24095900,1.4563311373764771,1178,793,1971,+
chrX,24096456,1.7310696463441095,590,418,1008,+
chrX,24096535,1.9012286052217489,1119,722,1841,+
chrX,24096590,0.3923007450891849,694,411,1105,+
chrX,24722508,2.461166785969936,808,507,1315,+
chrX,24722536,0.5135928328699413,664,497,1161,+
chrX,24722541,2.160094637223975,912,633,1545,+
chrX,24722542,2.230824786942077,1403,988,2391,+
chrX,24722544,2.116788321167883,956,684,1640,+
chrX,24735062,2.164450683489171,591,452,1043,+
chrX,30649046,0.6324524312896407,1157,859,2016,+
chrX,38663536,0.34720953075133193,884,773,1657,+
chrX,38664435,2.129120879120879,699,391,1090,+
chrX,38664436,3.955019476280538,1255,878,2133,+
chrX,38664637,2.584375,826,479,1305,+
chrX,38664638,2.584375,826,479,1305,+
chrX,38664914,9.273624450903979,964,815,1779,+
chrX,38664915,8.734954294719747,1149,903,2052,+
chrX,38664916,14.057542088870715,798,724,1522,+
chrX,38664980,7.817642712352058,958,682,1640,+
chrX,38664981,7.0599841680382935,1536,1186,2722,+
chrX,38665229,1.1053652230122817,569,475,1044,+
chrX,38665231,1.1053652230122817,569,475,1044,+
chrX,38665580,2.077364994255075,677,372,1049,+
chrX,38665590,1.6206060606060604,763,439,1202,+
chrX,40448298,1.2737732457933322,785,566,1351,+
chrX,40448321,2.0770290271029856,776,521,1297,+
chrX,40450612,1.96602114767732,590,442,1032,+
chrX,40458916,1.7247474747474747,682,431,1113,+
chrX,40458947,1.7408239700374533,580,444,1024,+
chrX,40465638,1.0852385944820968,1453,1071,2524,+
chrX,40465734,2.095428001709158,612,412,1024,+
chrX,41196688,1.323884401464946,847,600,1447,+
chrX,41196704,1.1376879402367028,705,527,1232,+
chrX,41203284,2.240104166666667,758,575,1333,+
chrX,41203291,0.6080412231337717,943,601,1544,+
chrX,41203306,0.6529276912790142,1518,1101,2619,+
chrX,41203307,1.4678244237385198,3728,3072,6800,+
chrX,41203308,1.4678244237385198,3728,3072,6800,+
chrX,41203309,1.4678244237385198,3728,3072,6800,+
chrX,41203364,0.6392625056672208,845,508,1353,+
chrX,41203506,0.7903833722838247,892,594,1486,+
chrX,41203630,1.797979797979798,622,538,1160,+
chrX,41204722,1.6849036506245765,695,448,1143,+
chrX,41204753,5.011473962930275,834,514,1348,+
chrX,41205516,3.0026132404181185,765,491,1256,+
chrX,41205527,1.5592366816856615,794,538,1332,+
chrX,41205643,1.9585687382297552,639,471,1110,+
chrX,41206910,0.44983673702038957,722,482,1204,+
chrX,41206932,2.7332489144092427,779,534,1313,+
chrX,41206967,1.8974293059125964,670,388,1058,+
chrX,41207133,2.477637315369869,1391,1190,2581,+
chrX,41207135,2.711535546460512,831,732,1563,+
chrX,41207370,4.278145695364239,968,603,1571,+
chrX,41207452,1.5133887538552668,4193,4244,8437,+
chrX,41207454,1.1928577574662018,7723,6724,14447,+
chrX,41207875,0.6448042870456664,1024,739,1763,+
chrX,41208014,1.5384548611111113,957,639,1596,+
chrX,41208086,2.7572406529752502,747,632,1379,+
chrX,41208089,1.8832502304069614,1716,1387,3103,+
chrX,41208276,1.7231674018063432,585,528,1113,+
chrX,41208320,1.961930326217496,1174,817,1991,+
chrX,41208334,1.630540037243948,795,536,1331,+
chrX,41208607,0.6230376766091053,634,489,1123,+
chrX,41208690,2.9829457364341083,591,429,1020,+
chrX,41209227,1.951996026051235,1820,1361,3181,+
chrX,47044738,1.7822290374995406,698,453,1151,+
chrX,47044742,0.8241632860040567,590,463,1053,+
chrX,47044744,0.8241632860040567,590,463,1053,+
chrX,47053231,1.0387617780279033,923,880,1803,+
chrX,47058245,1.367895956145095,1147,951,2098,+
chrX,47058247,1.1744698942445662,649,606,1255,+
chrX,47058650,1.9697446859686105,1825,1267,3092,+
chrX,47058652,1.9734129227491803,1657,1252,2909,+
chrX,47058693,0.8905192431203993,720,518,1238,+
chrX,47058695,0.8905192431203993,720,518,1238,+
chrX,47058905,2.3174819942496705,938,635,1573,+
chrX,47058925,1.8088183421516757,640,404,1044,+
chrX,47060365,19.390605306348085,777,516,1293,+
chrX,47060904,1.2140938801688974,1031,851,1882,+
chrX,47060994,2.003576136068395,1430,943,2373,+
chrX,47061575,1.797400268937696,801,678,1479,+
chrX,47061779,1.681512325779033,1494,1052,2546,+
chrX,47062972,0.34870721801121063,2353,979,3332,+
chrX,47062973,0.3703733865385398,1515,598,2113,+
chrX,47063009,23.25582380126426,4498,2322,6820,+
chrX,47063010,23.25582380126426,4498,2322,6820,+
chrX,47063011,9.841509758035082,1818,990,2808,+
chrX,47063013,8.644842122446489,3070,2649,5719,+
chrX,47063014,4.467012294474893,991,784,1775,+
chrX,47063026,1.191035954315782,1573,1256,2829,+
chrX,47063047,0.4584921763869132,473,702,1175,+
chrX,47065352,0.4505928853754941,683,505,1188,+
chrX,47065383,2.0558983666061703,884,550,1434,+
chrX,47065395,2.126677852348993,584,446,1030,+
chrX,47065460,1.9479166666666663,604,439,1043,+
chrX,47065781,2.32686170212766,672,469,1141,+
chrX,47069478,1.0757160356997024,682,552,1234,+
chrX,47069480,1.0757160356997024,682,552,1234,+
chrX,47070552,1.590543259557344,836,496,1332,+
chrX,47070575,1.5372340425531914,866,563,1429,+
chrX,47071846,2.0852991944764097,762,631,1393,+
chrX,47072181,0.49148258605873724,1388,1083,2471,+
chrX,47072182,2.0862401402278703,1081,814,1895,+
chrX,47072395,1.6025179856115108,890,555,1445,+
chrX,47072508,2.07936170212766,673,469,1142,+
chrX,47072509,2.2293854100719535,1478,1014,2492,+
chrX,47073781,1.6140273163528978,1285,902,2187,+
chrX,47073789,2.5512768162829413,1424,1026,2450,+
chrX,47073794,1.90615699901987,3145,2493,5638,+
chrX,47073795,1.90615699901987,3145,2493,5638,+
chrX,47073951,1.6798705170798196,679,558,1237,+
chrX,47074200,1.8847645429362885,566,474,1040,+
chrX,47074305,1.9676013641530887,669,376,1045,+
chrX,47074457,2.8029658323569917,699,662,1361,+
chrX,47086853,1.513747068120176,653,404,1057,+
chrX,47087989,1.4220405328639967,916,663,1579,+
chrX,47099809,2.3779264214046822,710,350,1060,+
chrX,47099811,2.3779264214046822,710,350,1060,+
chrX,47099986,2.031655068724721,1672,1086,2758,+
chrX,47099989,2.837233169129721,600,405,1005,+
chrX,47100006,1.8337829260552203,796,547,1343,+
chrX,47100007,1.9746140651801027,1438,741,2179,+
chrX,47100008,1.9746140651801027,1438,741,2179,+
chrX,47100010,1.7207090495449946,922,687,1609,+
chrX,47100017,1.8029045643153527,868,481,1349,+
chrX,47104314,3.14296559107722,696,480,1176,+
chrX,47428411,3.1287793189957354,925,495,1420,+
chrX,47428415,2.4329798395298234,759,441,1200,+
chrX,47428420,2.470243671574504,702,438,1140,+
chrX,47441803,1.7004231827889953,598,449,1047,+
chrX,47442906,1.6815358026997993,999,541,1540,+
chrX,47442921,1.4969041300945771,1099,638,1737,+
chrX,47444334,1.6838095238095236,662,524,1186,+
chrX,47444362,1.49396621078037,1237,1016,2253,+
chrX,47444950,1.725152129817444,728,492,1220,+
chrX,47444965,2.4461739111457237,1388,1086,2474,+
chrX,47445033,1.6409296736967205,1833,1292,3125,+
chrX,47445034,1.5792631196218638,1240,891,2131,+
chrX,47445044,1.6844181459566074,670,506,1176,+
chrX,47445055,1.76963696369637,765,504,1269,+
chrX,47445057,0.4480590847144678,636,528,1164,+
chrX,47445946,0.2660091679399916,765,625,1390,+
chrX,47445999,1.5814868021998751,1534,1208,2742,+
chrX,47446001,1.6193142220231598,2357,1752,4109,+
chrX,47446079,1.6918510523475443,759,435,1194,+
chrX,47446080,0.3782520838595604,598,427,1025,+
chrX,47446082,2.0817685690500416,681,568,1249,+
chrX,47446088,0.4461343472750317,527,525,1052,+
chrX,48336469,1.1252428767101028,691,479,1170,+
chrX,48336513,1.17322022240055,1504,714,2218,+
chrX,48336514,1.17322022240055,1504,714,2218,+
chrX,48336515,1.17322022240055,1504,714,2218,+
chrX,48336517,1.9720496894409936,634,391,1025,+
chrX,48336526,1.6272321428571428,728,461,1189,+
chrX,48336849,1.0191198640578818,4873,2985,7858,+
chrX,48336852,1.5165535937521948,1686,1248,2934,+
chrX,48336855,1.390925305306183,2479,1813,4292,+
chrX,48336857,1.9261967753207212,1714,870,2584,+
chrX,48337057,1.5077869304303437,1181,738,1919,+
chrX,48337058,1.5077869304303437,1181,738,1919,+
chrX,48337072,2.668364827412446,679,446,1125,+
chrX,48340077,1.0162275461652936,714,711,1425,+
chrX,48340078,0.5757256307540938,511,526,1037,+
chrX,48340079,0.5757256307540938,511,526,1037,+
chrX,48344284,0.32533044323306787,650,434,1084,+
chrX,48382206,2.2534553110537523,713,654,1367,+
chrX,48382391,1.6609266482732374,601,456,1057,+
chrX,48385653,2.951502732240437,595,487,1082,+
chrX,48386897,1.20984840558559,1071,726,1797,+
chrX,48386921,1.841304347826087,604,459,1063,+
chrX,48387023,2.348684210526316,713,495,1208,+
chrX,48387037,2.5632396449704142,716,506,1222,+
chrX,48433582,2.529523809523809,663,524,1187,+
chrX,48434904,4.26009369138237,914,562,1476,+
chrX,48434917,2.5471720352447003,1050,864,1914,+
chrX,48434918,2.7739913034685006,761,681,1442,+
chrX,48434927,1.4059058252019454,1254,1178,2432,+
chrX,48434928,1.1193719695220503,908,914,1822,+
chrX,48435891,1.858669069378298,759,456,1215,+
chrX,48435985,3.181307853746502,687,507,1194,+
chrX,48436049,1.7278846153846157,598,415,1013,+
chrX,48436474,0.6065313697318008,880,695,1575,+
chrX,48755215,1.3588354884135707,1363,392,1755,+
chrX,48755216,4.316730446561664,1193,418,1611,+
chrX,48755217,3.763499853377789,2180,771,2951,+
chrX,48755218,4.083474337281444,1085,393,1478,+
chrX,48755219,3.1241008465902675,1651,627,2278,+
chrX,48759223,1.5931581703781081,764,565,1329,+
chrX,48759584,3.8096958214603522,666,408,1074,+
chrX,49028267,3.2003883495145624,1004,514,1518,+
chrX,49028268,3.825842696629213,680,355,1035,+
chrX,49028277,2.326241595032109,589,423,1012,+
chrX,49028291,1.4651345109499105,1379,1199,2578,+
chrX,49028292,1.5186749081341135,1644,1353,2997,+
chrX,49028293,1.3485775630703167,1141,1034,2175,+
chrX,49028390,2.7219512195121958,836,614,1450,+
chrX,49028392,2.5566733752167607,1415,950,2365,+
chrX,49028413,2.706724782067248,566,437,1003,+
chrX,49028439,2.549107142857143,570,447,1017,+
chrX,49029488,1.694093192447601,651,501,1152,+
chrX,49029599,1.9381107491856677,839,613,1452,+
chrX,49030715,1.9023854362837411,626,530,1156,+
chrX,49031027,1.5985247629083243,573,510,1083,+
chrX,49031199,0.4442427986717121,884,562,1446,+
chrX,49031225,1.598647062112149,816,576,1392,+
chrX,49031301,1.9836687785850446,1526,984,2510,+
chrX,49031325,2.032706093189964,697,431,1128,+
chrX,49031326,2.7474487679415907,894,708,1602,+
chrX,54471561,0.27189716075445586,699,406,1105,+
chrX,54835630,25.259104268026356,953,381,1334,+
chrX,54835631,17.570772872446696,2368,1047,3415,+
chrX,54835633,10.775670307231405,2018,918,2936,+
chrX,54835634,2.765834606894209,1017,452,1469,+
chrX,54835636,2.4854445318646734,1052,491,1543,+
chrX,54835637,2.4468690455670505,985,525,1510,+
chrX,54835643,11.90135156076362,1711,1355,3066,+
chrX,54835644,12.429087097648827,3253,2631,5884,+
chrX,54835645,12.429087097648827,3253,2631,5884,+
chrX,54835646,12.13677811550152,1088,845,1933,+
chrX,54835754,0.6143146913937989,529,475,1004,+
chrX,54836165,1.1435426595619749,1145,909,2054,+
chrX,54836400,1.221060525222092,686,568,1254,+
chrX,54836600,3.7988826815642454,599,536,1135,+
chrX,54836601,3.7988826815642454,599,536,1135,+
chrX,54837402,2.0246004615990767,620,409,1029,+
chrX,54837512,0.7368554127248966,741,596,1337,+
chrX,54837683,2.699637845178814,807,650,1457,+
chrX,54838027,2.223907766990292,732,411,1143,+
chrX,54838028,2.0311220311220306,1279,887,2166,+
chrX,54838030,2.0311220311220306,1279,887,2166,+
chrX,54839440,2.1586074648633415,1061,847,1908,+
chrX,54839967,2.319265463917526,625,387,1012,+
chrX,54841146,3.797183098591549,673,425,1098,+
chrX,54842109,2.0574519230769237,633,415,1048,+
chrX,55033524,0.7810671828231089,550,486,1036,+
chrX,56592907,2.6847407407407404,696,449,1145,+
chrX,56592908,2.6847407407407404,696,449,1145,+
chrX,56758625,0.5810692375109552,917,651,1568,+
chrX,64947679,2.084986143410759,1033,806,1839,+
chrX,64947680,1.9382620774810928,727,588,1315,+
chrX,64947684,1.662536034922988,759,590,1349,+
chrX,64949341,1.0628160281810626,879,697,1576,+
chrX,64949342,1.8768577494692145,781,470,1251,+
chrX,64949504,1.177351745826292,1131,770,1901,+
chrX,64951723,1.6124338624338623,741,503,1244,+
chrX,64951779,1.5978668969291525,1546,1147,2693,+
chrX,64951830,1.37114715856319,919,690,1609,+
chrX,64953048,1.695520121488231,615,438,1053,+
chrX,64953055,1.636880880919604,1234,1053,2287,+
chrX,64955238,1.509831469801414,1691,1087,2778,+
chrX,64955243,1.656410256410256,1087,639,1726,+
chrX,64955276,1.829178885630499,1496,929,2425,+
chrX,64955282,2.002507026913047,2805,1738,4543,+
chrX,64956657,1.5725977426757305,4428,2804,7232,+
chrX,64956666,0.4187463581120452,2095,1464,3559,+
chrX,64956688,1.4332354989819018,6263,4359,10622,+
chrX,64956712,1.4635087665983486,9075,6504,15579,+
chrX,64957108,3.131387997417141,598,482,1080,+
chrX,64959648,1.735308641975309,752,485,1237,+
chrX,64959683,0.3520581113801453,726,489,1215,+
chrX,64959702,2.320356960138451,989,683,1672,+
chrX,64959990,0.3884892086330935,593,416,1009,+
chrX,64960196,0.5989465763732129,596,442,1038,+
chrX,64960200,1.6313857086458745,960,744,1704,+
chrX,64960207,0.6304609218436873,725,498,1223,+
chrX,64960208,1.820354422910251,2145,1777,3922,+
chrX,64960209,1.820354422910251,2145,1777,3922,+
chrX,64960216,1.7338235294117648,1178,1019,2197,+
chrX,64960284,1.3039261985971318,7990,6147,14137,+
chrX,64960285,2.0838318596811747,3384,2836,6220,+
chrX,64960292,1.2702177569117008,6483,4411,10894,+
chrX,64960294,1.1943235092653068,15497,11318,26815,+
chrX,64960295,1.309637673274037,6999,4883,11882,+
chrX,64960412,2.021768992129852,1565,1249,2814,+
chrX,64960525,1.9408240390819431,657,570,1227,+
chrX,64960655,2.1201646090534982,735,485,1220,+
chrX,64960692,3.816964285714286,569,447,1016,+
chrX,64960813,1.119562556478425,570,450,1020,+
chrX,64960852,1.1298056036557895,1142,862,2004,+
chrX,64960921,1.851851851851852,727,467,1194,+
chrX,64961027,2.1953261567038163,925,579,1504,+
chrX,64961318,2.0227064085280784,1020,687,1707,+
chrX,64961515,2.6403007488583055,787,659,1446,+
chrX,64961527,0.3430386972130178,609,458,1067,+
chrX,64961593,1.8230739450251647,553,573,1126,+
chrX,64961618,1.6883231836850305,866,613,1479,+
chrX,67738629,2.253000536355815,690,476,1166,+
chrX,67742637,3.15796795143616,874,683,1557,+
chrX,67742639,0.8871428571428572,620,499,1119,+
chrX,67752759,4.664861593078875,655,436,1091,+
chrX,67752914,10.430173044009608,1235,957,2192,+
chrX,67752986,9.590801204656076,955,879,1834,+
chrX,67752987,7.356255648176585,1796,1527,3323,+
chrX,69353856,2.160919540229885,1033,560,1593,+
chrX,69353858,1.6301822848117926,1487,871,2358,+
chrX,69353914,2.316702203269368,561,468,1029,+
chrX,69353926,0.4984294924780955,669,525,1194,+
chrX,69353957,1.9092023284616102,2146,1498,3644,+
chrX,69353959,0.5530811771676871,973,663,1636,+
chrX,69354413,1.7472167648984938,666,508,1174,+
chrX,69354452,1.8674566600833877,739,433,1172,+
chrX,69354586,1.1753737535043722,1963,1377,3340,+
chrX,69366492,3.317898929549415,1427,926,2353,+
chrX,69366493,1.6436237373737377,1142,791,1933,+
chrX,69368622,1.9828148148148148,955,624,1579,+
chrX,69385964,3.058002326740901,574,546,1120,+
chrX,69385965,1.1882119172346683,1502,1150,2652,+
chrX,70183091,0.5488439935080133,812,557,1369,+
chrX,70183099,1.99969292184861,703,500,1203,+
chrX,70503503,0.4910356445466997,1008,808,1816,+
chrX,70504248,1.7359363993156889,574,522,1096,+
chrX,70510534,1.6863140676117774,792,523,1315,+
chrX,70510604,0.4671656686626746,1056,834,1890,+
chrX,70510605,0.4424658976908431,1772,1228,3000,+
chrX,70510614,1.824249104436484,1256,954,2210,+
chrX,70510615,1.8200945545496197,2147,1494,3641,+
chrX,70510637,0.5263122989687302,991,568,1559,+
chrX,70511744,2.0216530235014525,695,540,1235,+
chrX,70511756,1.86472692833842,1161,883,2044,+
chrX,70511757,1.86472692833842,1161,883,2044,+
chrX,70514076,2.399305555555556,1381,827,2208,+
chrX,70514095,1.524983344437042,1089,789,1878,+
chrX,70514197,1.511969111969112,1334,776,2110,+
chrX,70514291,2.0218694885361552,1432,944,2376,+
chrX,70514293,2.0218694885361552,1432,944,2376,+
chrX,70514294,0.6199445474740967,2022,1296,3318,+
chrX,70514301,1.6457142857142857,1106,614,1720,+
chrX,70516490,1.9426148082802979,6518,4143,10661,+
chrX,70516499,0.6949486819611939,2942,1902,4844,+
chrX,70516786,1.6598158642676368,4112,2425,6537,+
chrX,70516798,1.4514022792013161,10257,6059,16316,+
chrX,70516801,1.4852466946146403,10768,6775,17543,+
chrX,70516802,1.4852466946146403,10768,6775,17543,+
chrX,70516849,1.52109739826551,4291,2997,7288,+
chrX,70516855,1.2369133904385388,6819,5651,12470,+
chrX,70517711,2.420220564798878,925,746,1671,+
chrX,70517732,1.6252667520273154,951,780,1731,+
chrX,70517738,1.5476607315801236,1318,865,2183,+
chrX,70518663,2.6490473355467237,936,483,1419,+
chrX,70519823,2.356205064082526,602,456,1058,+
chrX,70519827,2.2069645650547507,876,506,1382,+
chrX,70519835,1.5568576388888888,1054,639,1693,+
chrX,70519846,1.83408879590888,852,716,1568,+
chrX,70519868,0.7082996972754794,1336,990,2326,+
chrX,70519927,1.3482932559425096,1560,1295,2855,+
chrX,70519949,1.4712092130518235,1700,1041,2741,+
chrX,70520087,11.644239281104817,13659,9089,22748,+
chrX,70520088,11.644239281104817,13659,9089,22748,+
chrX,70520089,11.644239281104817,13659,9089,22748,+
chrX,70520100,1.7847718624417654,1090,720,1810,+
chrX,70520246,0.8237606105747914,1153,892,2045,+
chrX,70520247,1.0053511303511302,726,593,1319,+
chrX,70520339,0.48205571186345936,572,453,1025,+
chrX,70520433,0.5682610503959143,2576,1639,4215,+
chrX,70520526,0.5314285714285715,774,624,1398,+
chrX,70520530,1.747710544334132,1432,1015,2447,+
chrX,70520531,1.747710544334132,1432,1015,2447,+
chrX,70520764,1.6488131357846585,4126,2974,7100,+
chrX,70520886,1.6469743589743588,867,649,1516,+
chrX,70756094,0.9973684210526317,757,474,1231,+
chrX,70756096,0.9973684210526317,757,474,1231,+
chrX,70757703,0.4885317127941987,1031,706,1737,+
chrX,70765604,1.6503747148908439,1012,464,1476,+
chrX,70765756,1.3156154806491884,2715,1601,4316,+
chrX,70765757,1.3156154806491884,2715,1601,4316,+
chrX,70765758,1.3156154806491884,2715,1601,4316,+
chrX,70766051,0.4921052631578947,747,531,1278,+
chrX,70766352,3.712015201290849,1090,825,1915,+
chrX,70766366,0.5542857142857143,678,489,1167,+
chrX,70766807,1.1855004236154236,894,559,1453,+
chrX,70767809,2.036577490293711,1488,1085,2573,+
chrX,70775827,0.5317971488516059,1158,780,1938,+
chrX,70776556,1.8539667896678966,692,541,1233,+
chrX,70776559,1.623598244758654,719,585,1304,+
chrX,70782791,2.96741214057508,773,625,1398,+
chrX,70782792,2.96741214057508,773,625,1398,+
chrX,70784582,1.294206892290582,918,661,1579,+
chrX,70787924,2.8528561099060017,606,460,1066,+
chrX,70793497,1.734127898050054,2125,1335,3460,+
chrX,70793498,1.734127898050054,2125,1335,3460,+
chrX,70793502,0.9977620933034947,1511,941,2452,+
chrX,70793504,0.8493201901596774,2779,1741,4520,+
chrX,70793512,1.6282281791435107,1373,873,2246,+
chrX,70793939,4.711534026571648,1181,1089,2270,+
chrX,70793940,3.8989198837666215,2678,2150,4828,+
chrX,70793942,1.9099108715375992,1233,913,2146,+
chrX,70793946,0.5763257575757575,715,527,1242,+
chrX,70794689,1.7160117878192531,646,508,1154,+
chrX,77154959,0.7762209918651186,852,442,1294,+
chrX,77154964,1.1683824646729095,2308,1483,3791,+
chrX,77154965,1.5206008123030557,4712,2785,7497,+
chrX,77154966,1.8808975624017832,2404,1302,3706,+
chrX,77154967,1.8808975624017832,2404,1302,3706,+
chrX,77154969,1.8339802399435428,692,435,1127,+
chrX,77154971,0.7210576393983205,1456,875,2331,+
chrX,77154976,0.7995431995847732,3477,1879,5356,+
chrX,77154978,0.8359216618106041,2994,1536,4530,+
chrX,77154979,1.4853237622301982,2384,1848,4232,+
chrX,77154981,1.4853237622301982,2384,1848,4232,+
chrX,77154984,1.4952457044142284,2539,1576,4115,+
chrX,77154997,1.3640833374442964,2182,1397,3579,+
chrX,77155009,1.5680178632772244,1252,993,2245,+
chrX,77155076,1.4226871844778295,5315,3608,8923,+
chrX,77359741,1.1566709340562793,2338,1354,3692,+
chrX,77359742,1.1566709340562793,2338,1354,3692,+
chrX,77359743,1.1566709340562793,2338,1354,3692,+
chrX,77359749,0.8223231667748215,2375,1379,3754,+
chrX,77359751,0.8172397184848954,3903,2434,6337,+
chrX,77359754,0.6022366829076877,1753,1153,2906,+
chrX,77359773,0.561024894924022,1261,1030,2291,+
chrX,77359800,1.0973870302838118,9352,5405,14757,+
chrX,77359801,1.149948959737495,12736,7532,20268,+
chrX,77359802,1.0216985172421318,11623,7150,18773,+
chrX,77359825,1.3122170293559223,3030,2295,5325,+
chrX,77359835,1.6512149672033392,5337,3119,8456,+
chrX,77359849,1.2721103951645094,6373,3704,10077,+
chrX,77365395,1.4798459420753327,3325,2437,5762,+
chrX,77369265,0.7067921026806968,5149,3015,8164,+
chrX,77369346,1.4105623990373721,7390,5022,12412,+
chrX,77369586,1.477482419961419,5258,3349,8607,+
chrX,77369597,2.202062012747912,2114,1485,3599,+
chrX,77369634,1.7027566539923953,5117,3944,9061,+
chrX,77369635,1.6386719544217347,19538,14738,34276,+
chrX,77369637,1.7351702104272106,5280,4163,9443,+
chrX,77378336,1.2633245628904628,5412,3377,8789,+
chrX,77378758,1.5434610303830911,3936,3027,6963,+
chrX,77380397,2.0150009591406097,2500,2004,4504,+
chrX,77380400,1.4383112679799128,5055,3297,8352,+
chrX,77380462,1.3077090083169112,3641,2547,6188,+
chrX,77381289,1.312776524103129,4282,2695,6977,+
chrX,77381421,1.5206121170558236,3249,1936,5185,+
chrX,77381454,1.5348065204874772,3434,2451,5885,+
chrX,77381455,1.5348065204874772,3434,2451,5885,+
chrX,77381459,2.2768595041322315,1937,1451,3388,+
chrX,77381461,1.0111649199246349,7230,4245,11475,+
chrX,77381462,1.0771732943096346,9457,5912,15369,+
chrX,77381463,0.7925875914462149,3918,2948,6866,+
chrX,77381492,1.301085048488455,3819,3218,7037,+
chrX,77381821,2.1985503080224884,850,620,1470,+
chrX,77381910,3.470434782608696,613,459,1072,+
chrX,77382014,2.856178386345267,1225,778,2003,+
chrX,77382015,2.4359483320027087,1458,935,2393,+
chrX,77382048,1.951436388508892,633,515,1148,+
chrX,80457717,3.441018405358642,641,402,1043,+
chrX,80457738,4.405760143379712,732,481,1213,+
chrX,80553014,3.449173813009831,766,682,1448,+
chrX,80553015,3.449173813009831,766,682,1448,+
chrX,100058987,2.5426653883029724,611,446,1057,+
chrX,100058989,2.5426653883029724,611,446,1057,+
chrX,100645972,0.6687857263274158,2780,1252,4032,+
chrX,100645973,0.6409574849492043,2071,840,2911,+
chrX,100645976,1.5895716103207318,961,556,1517,+
chrX,100645994,1.7432616469677138,1600,797,2397,+
chrX,100645997,1.4142127137698437,2470,1128,3598,+
chrX,100645998,1.582874219234016,5858,3509,9367,+
chrX,100645999,1.677697736497605,1239,942,2181,+
chrX,100646000,0.9338356192829445,9381,5987,15368,+
chrX,100646002,0.8323103369598328,15498,8037,23535,+
chrX,100646013,1.432121888935665,3572,2292,5864,+
chrX,100646014,1.745859872611465,2740,1569,4309,+
chrX,100646028,1.3927119947275919,3710,2275,5985,+
chrX,100650370,1.6190509740020234,17009,9349,26358,+
chrX,100650371,1.47566892579463,10440,5263,15703,+
chrX,100650376,1.4639777582396425,15547,9920,25467,+
chrX,100650382,1.1869184662153065,17938,13020,30958,+
chrX,100666966,1.3357466340269275,649,567,1216,+
chrX,100667026,3.997143832360088,660,536,1196,+
chrX,100667152,0.6026831785345718,656,458,1114,+
chrX,100667165,0.4306643091689821,619,427,1046,+
chrX,100667361,2.4131593914536587,814,560,1374,+
chrX,100667448,1.3474381302688798,1220,930,2150,+
chrX,100667471,3.234643727332391,1241,1018,2259,+
chrX,100667559,0.3654388774498589,598,422,1020,+
chrX,100667596,0.3531914893617021,746,422,1168,+
chrX,100667624,2.235934664246824,923,550,1473,+
chrX,100667630,0.531903856217602,946,588,1534,+
chrX,100667632,1.7703104190144454,1079,680,1759,+
chrX,100667663,1.7773273252047679,2427,1261,3688,+
chrX,100667666,2.3108320251177394,1183,636,1819,+
chrX,100667699,4.946794511468017,5341,3996,9337,+
chrX,100667700,3.037632057086391,19682,13911,33593,+
chrX,100667701,2.5845832106661972,22573,16483,39056,+
chrX,100667702,1.703011408312756,7974,5104,13078,+
chrX,100667703,3.1085278834581533,3871,3523,7394,+
chrX,100667706,0.719719499509776,4239,3146,7385,+
chrX,100667932,1.8434475971789408,1142,937,2079,+
chrX,100667934,1.8434475971789408,1142,937,2079,+
chrX,100667975,1.887150527680059,754,490,1244,+
chrX,100667977,1.7358474858474855,718,545,1263,+
chrX,100668172,9.417835671342685,722,498,1220,+
chrX,100668173,9.417835671342685,722,498,1220,+
chrX,100668177,7.087240875075745,2677,2437,5114,+
chrX,100668178,7.087240875075745,2677,2437,5114,+
chrX,100668194,0.5200146239796339,678,707,1385,+
chrX,100668428,2.081197392424251,2369,1543,3912,+
chrX,100668969,2.231034482758621,646,405,1051,+
chrX,100668970,2.231034482758621,646,405,1051,+
chrX,100879153,3.4753038367061433,702,466,1168,+
chrX,100881318,0.5383748879186877,735,502,1237,+
chrX,102611515,2.1387429134172042,1242,972,2214,+
chrX,102612050,1.9619803987833728,682,537,1219,+
chrX,102612066,1.7409761362273657,1036,806,1842,+
chrX,102612068,1.6361744697879153,1075,734,1809,+
chrX,102612688,3.384048356184579,997,797,1794,+
chrX,102612740,2.1903575150663825,1178,760,1938,+
chrX,102612788,1.9689587973273943,1844,1346,3190,+
chrX,102612795,1.8631445477599329,1394,1182,2576,+
chrX,102612893,1.5418734630002235,931,638,1569,+
chrX,102631528,2.177374560266617,671,490,1161,+
chrX,102631996,1.876066934095299,1903,1398,3301,+
chrX,102632438,1.6374719281360282,1407,1038,2445,+
chrX,102632447,1.523536013732092,981,890,1871,+
chrX,102632465,1.499601015596663,968,918,1886,+
chrX,102632478,1.889817792068596,1101,932,2033,+
chrX,102632554,0.7112722917221187,1526,1155,2681,+
chrX,102632582,1.7812636165577342,2189,1376,3565,+
chrX,102841606,1.2738434368941909,774,673,1447,+
chrX,102841694,2.20679012345679,649,404,1053,+
chrX,102841841,7.145483817313321,3558,1711,5269,+
chrX,102841842,7.145483817313321,3558,1711,5269,+
chrX,102841859,24.66674722817416,3482,3231,6713,+
chrX,102841860,24.66674722817416,3482,3231,6713,+
chrX,102841863,9.866019205257498,1771,2238,4009,+
chrX,102841878,2.9793809986465147,1068,1500,2568,+
chrX,102842074,5.18676352274543,789,578,1367,+
chrX,102842227,0.8977405182462118,800,586,1386,+
chrX,102842229,1.4149371405815792,1047,781,1828,+
chrX,103436331,1.4623655913978495,631,473,1104,+
chrX,103436346,1.1290405620633697,820,595,1415,+
chrX,103437878,2.4998342175066317,886,463,1349,+
chrX,103437880,2.1183768415611266,1365,729,2094,+
chrX,103437881,1.679212199859652,1672,1087,2759,+
chrX,103437883,1.458672588206267,738,578,1316,+
chrX,103437911,1.7774294670846396,860,450,1310,+
chrX,106871719,1.0843821595564602,578,437,1015,+
chrX,106871738,1.113958298327492,1548,1253,2801,+
chrX,106871740,0.9288111429566046,1657,1350,3007,+
chrX,106871744,0.6890947802329498,3945,2599,6544,+
chrX,106871745,0.5813172402719049,1608,951,2559,+
chrX,106871809,4.056341719077569,672,423,1095,+
chrX,106871813,1.954860524091293,745,454,1199,+
chrX,106882529,0.5726529022204908,629,452,1081,+
chrX,106882700,0.6197916666666666,685,391,1076,+
chrX,106885659,0.503645757883046,744,530,1274,+
chrX,106885660,1.9275590551181099,815,634,1449,+
chrX,106893329,3.461956521739131,636,459,1095,+
chrX,106893502,1.115069326900455,1180,964,2144,+
chrX,106893803,6.696939836331256,626,619,1245,+
chrX,106893805,4.703577620639289,550,707,1257,+
chrX,106893808,1.4848205174497433,736,1319,2055,+
chrX,106893809,0.537188003220612,304,735,1039,+
chrX,106893810,0.5589035174646856,704,1409,2113,+
chrX,106893836,2.1461104222515694,678,539,1217,+
chrX,106893932,2.6339449541284403,791,544,1335,+
chrX,106894091,4.032956547269524,1220,1047,2267,+
chrX,106894092,3.9845929614824014,1737,1424,3161,+
chrX,106894132,1.99297395517868,913,634,1547,+
chrX,114795519,2.3570472163150527,678,412,1090,+
chrX,114844577,0.4621212121212121,853,545,1398,+
chrX,114856717,1.847545219638243,844,558,1402,+
chrX,114868349,0.4233787465940054,1370,733,2103,+
chrX,114869195,2.2652644542390457,2025,1101,3126,+
chrX,114869273,1.9288206129421737,4495,2904,7399,+
chrX,114869274,1.9288206129421737,4495,2904,7399,+
chrX,114869275,1.3026172132270712,3466,1538,5004,+
chrX,114869339,0.2696827262044653,764,554,1318,+
chrX,114869351,0.5514421007318123,853,605,1458,+
chrX,114871262,0.5211296639868068,789,538,1327,+
chrX,114877761,2.329007552388044,754,552,1306,+
chrX,114880463,2.101083032490975,775,553,1328,+
chrX,114880500,1.6179506962048569,936,632,1568,+
chrX,114881907,0.5881319383435828,1051,658,1709,+
chrX,114882282,2.0105415636781263,1296,1074,2370,+
chrX,114882307,0.9998455969011342,2187,1731,3918,+
chrX,114883895,1.8329678362573096,1002,607,1609,+
chrX,114883922,1.7705971614746052,1043,658,1701,+
chrX,114884141,1.8052862994459244,1050,871,1921,+
chrX,114884641,1.7027027027027029,1070,739,1809,+
chrX,114884827,2.135593220338983,811,471,1282,+
chrX,117925885,2.219685708218305,1129,553,1682,+
chrX,117925886,2.219685708218305,1129,553,1682,+
chrX,117925895,1.863898500576701,1211,662,1873,+
chrX,117925896,1.863898500576701,1211,662,1873,+
chrX,117928166,7.0579117952891925,637,474,1111,+
chrX,118370395,0.49753289473684215,725,511,1236,+
chrX,118370397,0.49753289473684215,725,511,1236,+
chrX,118374395,2.2883225561049825,751,477,1228,+
chrX,118374401,1.5664744329104192,925,509,1434,+
chrX,118374418,0.6305402688445513,2284,1519,3803,+
chrX,118374423,1.3801560758082496,1237,689,1926,+
chrX,118377113,1.186147038891528,5932,3665,9597,+
chrX,118377114,1.099827299695736,4429,2513,6942,+
chrX,118377115,1.099827299695736,4429,2513,6942,+
chrX,118377116,1.3369730057628146,1557,1098,2655,+
chrX,118377119,1.553103448275862,1688,1217,2905,+
chrX,118377183,1.7447978013349037,807,565,1372,+
chrX,118377186,1.639225141882361,1368,1128,2496,+
chrX,118377188,1.639225141882361,1368,1128,2496,+
chrX,118377406,1.6141750653228817,934,563,1497,+
chrX,118377550,1.5897262842144733,985,761,1746,+
chrX,118377660,1.587814023247094,900,761,1661,+
chrX,118377677,1.9876926155693413,684,525,1209,+
chrX,118377891,1.5648148148148149,1013,647,1660,+
chrX,118378094,0.4583931133428981,638,573,1211,+
chrX,118602390,0.6160829480647444,1789,909,2698,+
chrX,118602405,1.2548027648438982,3096,1957,5053,+
chrX,118602412,1.6617675876935136,794,566,1360,+
chrX,118602419,1.6811301858707999,2943,1991,4934,+
chrX,118602420,1.53478404220244,930,673,1603,+
chrX,118602421,1.6299664268585132,1846,1389,3235,+
chrX,118602441,1.6928849009509968,1700,1020,2720,+
chrX,118602538,1.5887167008196725,1610,1219,2829,+
chrX,118602542,1.502976945319603,3457,2606,6063,+
chrX,118603635,1.5872152081612592,5981,4225,10206,+
chrX,118603652,1.3966714257719548,2122,1763,3885,+
chrX,118603749,1.4034781665360427,5958,5010,10968,+
chrX,118603752,1.4774990313831848,3112,2580,5692,+
chrX,118603791,1.2850239693192709,4130,2681,6811,+
chrX,118604005,0.7905670036450796,7352,5319,12671,+
chrX,118604872,1.6016132267702734,3033,1932,4965,+
chrX,118604902,1.3608970438328236,2687,2179,4866,+
chrX,118604992,1.3865439386180067,3906,2987,6893,+
chrX,118605022,0.781596176001418,5324,3967,9291,+
chrX,118605079,1.2611764705882351,4103,3059,7162,+
chrX,118716586,1.4025310809305254,1163,883,2046,+
chrX,118717380,1.1292202793357529,603,432,1035,+
chrX,118717381,1.1292202793357529,603,432,1035,+
chrX,118717985,2.306242918958612,686,536,1222,+
chrX,119005805,0.5457295722169583,1212,964,2176,+
chrX,119005819,0.7542743540806661,3542,2646,6188,+
chrX,119005820,0.7187463636011017,1852,1523,3375,+
chrX,119005824,1.358509550482867,3193,2409,5602,+
chrX,119005839,0.6813561338727321,6332,4888,11220,+
chrX,119005841,0.695317019250446,3479,2782,6261,+
chrX,119005847,1.5617625283852419,7847,5841,13688,+
chrX,119005923,1.6174233476638162,1901,1734,3635,+
chrX,119007266,0.6862597607278459,1954,1409,3363,+
chrX,119392001,2.4248877796381656,627,433,1060,+
chrX,119737963,1.4836798460271943,1393,907,2300,+
chrX,119737964,1.0940249905338888,606,474,1080,+
chrX,119739385,1.6424403183023877,687,519,1206,+
chrX,119742164,3.0656565656565657,606,449,1055,+
chrX,119742176,8.020833333333334,769,607,1376,+
chrX,123171418,3.521016925255502,612,443,1055,+
chrX,123176481,1.0208391608391607,810,649,1459,+
chrX,123176483,1.0208391608391607,810,649,1459,+
chrX,123195148,1.5879103310158915,1348,959,2307,+
chrX,123195149,2.0788311247026843,965,653,1618,+
chrX,123196802,1.991599327946236,802,430,1232,+
chrX,123196972,1.8278127540248943,3678,2231,5909,+
chrX,123196973,1.8278127540248943,3678,2231,5909,+
chrX,123196980,1.16368528728277,2224,1404,3628,+
chrX,123197010,1.7061411720651565,1457,871,2328,+
chrX,123197026,2.0130040146622448,1976,1347,3323,+
chrX,123197029,1.7988766339697615,6646,4936,11582,+
chrX,123197030,1.7988766339697615,6646,4936,11582,+
chrX,123197031,1.7988766339697615,6646,4936,11582,+
chrX,123200068,1.4499863925583871,903,712,1615,+
chrX,123211882,2.662644667329353,1059,756,1815,+
chrX,123215271,2.354474272930649,678,446,1124,+
chrX,123215300,2.0447870778267254,556,453,1009,+
chrX,123220559,2.569437994926816,608,446,1054,+
chrX,123234934,2.0731736963656253,655,432,1087,+
chrX,123235525,1.9267770662627102,970,678,1648,+
chrX,129058890,0.984251643931444,926,761,1687,+
chrX,129543316,2.0635151679395944,954,705,1659,+
chrX,129543318,3.148318042813456,567,435,1002,+
chrX,131202327,4.573437284403389,734,559,1293,+
chrX,131205101,0.5600298284862043,750,446,1196,+
chrX,131205104,1.780160857908847,663,372,1035,+
chrX,131207044,2.847220291755213,816,555,1371,+
chrX,131208232,0.3614906832298136,872,482,1354,+
chrX,131208234,0.3614906832298136,872,482,1354,+
chrX,131208753,3.192269713640852,729,416,1145,+
chrX,131208761,3.1404886510801293,870,556,1426,+
chrX,131208776,2.5171475875118263,945,603,1548,+
chrX,131208786,0.3660520270689762,736,412,1148,+
chrX,131208811,1.7033822208919491,812,513,1325,+
chrX,131208852,2.0517067238840845,3925,3372,7297,+
chrX,131208853,2.0517067238840845,3925,3372,7297,+
chrX,131208854,2.0517067238840845,3925,3372,7297,+
chrX,131208969,1.168037244982325,673,524,1197,+
chrX,131209349,1.6107550777727149,571,436,1007,+
chrX,133511669,2.6190741041422734,769,576,1345,+
chrX,133561333,1.7647350426111914,588,422,1010,+
chrX,133562341,24.061203291490582,1076,1382,2458,+
chrX,133562342,24.061203291490582,1076,1382,2458,+
chrX,133594337,1.2451570486219268,709,570,1279,+
chrX,133607422,2.318188292266059,625,412,1037,+
chrX,133609242,1.6457410142786806,954,676,1630,+
chrX,133609327,1.877773951637588,2929,2177,5106,+
chrX,133609329,1.2293994166183906,8770,6336,15106,+
chrX,133609330,1.1207949282369434,7347,5299,12646,+
chrX,133609333,1.6521165144989574,3510,2886,6396,+
chrX,133609334,1.6675564387917325,5505,4624,10129,+
chrX,133609335,0.5649963436292091,2949,1832,4781,+
chrX,133609336,1.6276947663625077,5874,4575,10449,+
chrX,133632642,1.9062961141170685,673,427,1100,+
chrX,133634179,0.6145906638517477,785,608,1393,+
chrX,133634471,1.9463877084014385,686,482,1168,+
chrX,133634554,2.30092316855271,908,583,1491,+
chrX,134166384,0.8403156695772175,720,355,1075,+
chrX,134166385,1.2399356118924456,737,384,1121,+
chrX,134166546,3.2540135745417866,570,466,1036,+
chrX,134167220,0.4544547529208169,731,477,1208,+
chrX,134167334,2.048964218455744,607,530,1137,+
chrX,134167336,2.048964218455744,607,530,1137,+
chrX,134167435,3.2791361043194787,618,408,1026,+
chrX,135289186,1.4354039954574889,988,638,1626,+
chrX,135289187,1.1737139205453189,759,457,1216,+
chrX,135289289,1.498611368265136,851,490,1341,+
chrX,135289307,2.219801682692308,590,415,1005,+
chrX,135289308,0.3960965031173759,1123,594,1717,+
chrX,135292327,3.3389888021717,614,420,1034,+
chrX,135292334,1.7723495341223874,611,417,1028,+
chrX,135292636,2.0662617580017995,595,444,1039,+
chrX,135292661,2.3882445608689955,675,508,1183,+
chrX,135293307,0.5580232888383981,613,502,1115,+
chrX,135586580,2.084597236265588,1236,551,1787,+
chrX,135586581,2.084597236265588,1236,551,1787,+
chrX,135593144,2.306477093206951,583,421,1004,+
chrX,135593319,1.7841813939287436,698,505,1203,+
chrX,147031423,4.791637630662021,763,573,1336,+
chrX,147031425,4.233992735399262,1053,722,1775,+
chrX,149896163,1.136316400757993,640,398,1038,+
chrX,149896165,1.136316400757993,640,398,1038,+
chrX,149896166,2.381425731326328,558,502,1060,+
chrX,149896168,2.381425731326328,558,502,1060,+
chrX,150154156,1.4809579664741426,777,656,1433,+
chrX,150154157,0.9751773049645388,604,516,1120,+
chrX,150156277,3.0521652120509506,619,484,1103,+
chrX,150156376,7.407056840561665,613,732,1345,+
chrX,150156379,4.366900029549508,800,1219,2019,+
chrX,150565780,0.7308929120812259,645,422,1067,+
chrX,150572102,2.2002565458867536,943,766,1709,+
chrX,150574642,0.7434539917389139,706,506,1212,+
chrX,150575298,1.2421616324973188,1436,954,2390,+
chrX,150575300,0.910425261821644,849,547,1396,+
chrX,150575307,0.6112776752767527,836,541,1377,+
chrX,150575313,2.016662258661729,609,397,1006,+
chrX,150575329,1.7566050970306288,682,610,1292,+
chrX,150575343,1.5362212970773408,4468,3278,7746,+
chrX,150576661,0.13963865518461868,997,587,1584,+
chrX,151869732,1.9669672281279424,790,554,1344,+
chrX,151870013,6.5169411422228665,865,658,1523,+
chrX,151870292,5.018093346128557,609,431,1040,+
chrX,153060063,0.9244215919790182,1203,541,1744,+
chrX,153060079,2.9634109359846352,745,276,1021,+
chrX,153060104,1.5606090409238063,923,610,1533,+
chrX,153060117,1.6012773722627736,899,684,1583,+
chrX,153060122,1.4168179297157248,2398,1563,3961,+
chrX,153060123,0.9836970889757072,2207,1730,3937,+
chrX,153060124,0.9836970889757072,2207,1730,3937,+
chrX,153060126,1.7265722097936864,1207,893,2100,+
chrX,153061923,1.3271732689847058,1907,1402,3309,+
chrX,153062943,1.288189612128037,2635,1665,4300,+
chrX,153063198,1.44915466400469,4396,3269,7665,+
chrX,153063200,1.520733961928283,6717,5041,11758,+
chrX,153063201,1.5828420595302444,6571,5176,11747,+
chrX,153063533,0.7090071178863984,4896,3983,8879,+
chrX,153063537,1.8829353359772734,2091,1692,3783,+
chrX,153063565,1.3048666932710031,2640,1948,4588,+
chrX,153063841,2.233437277750424,2299,1353,3652,+
chrX,153063874,1.6070400882967402,1381,1102,2483,+
chrX,153626715,1.2225391505465237,3006,2326,5332,+
chrX,153626717,1.0364860143598311,15962,12405,28367,+
chrX,153626718,0.8879017602521628,28548,20109,48657,+
chrX,153626719,0.9837305525319077,22611,17263,39874,+
chrX,153626720,0.7309777921383896,20134,13415,33549,+
chrX,153626721,0.9158881117641264,10174,7500,17674,+
chrX,153626724,1.466707692307692,3504,2499,6003,+
chrX,153626843,0.7649270081409562,4145,3309,7454,+
chrX,153626844,1.2309037721324096,5168,3896,9064,+
chrX,153627857,0.9745178928178347,24232,14683,38915,+
chrX,153627858,1.363103317550982,31517,21916,53433,+
chrX,153627859,1.1141540777317291,69213,44664,113877,+
chrX,153627860,1.0402263979437492,80812,55631,136443,+
chrX,153628802,0.8607470064982968,828,657,1485,+
chrX,153628809,0.7990752435853691,6994,5630,12624,+
chrX,153628872,1.1214469160899017,9479,7788,17267,+
chrX,153628873,1.331354573507972,5263,3112,8375,+
chrX,153628895,0.7244253811960553,10929,8932,19861,+
chrX,153628902,1.2933798924434148,18766,13228,31994,+
chrX,153628904,1.306176712648608,20957,12469,33426,+
chrX,153660185,0.3786564342119897,618,485,1103,+
chrX,153660186,1.257051715793715,901,750,1651,+
chrX,153661283,2.5365035817710715,627,485,1112,+
chrX,153661284,1.7539939638331454,1015,749,1764,+
chrX,153662749,2.328776045996785,632,444,1076,+
chrX,153663747,1.4554516327196698,583,435,1018,+
chrX,153663783,2.111637832460402,604,523,1127,+
chrX,153664117,2.898915498675114,733,554,1287,+
chrX,153664266,36.47850942989994,2010,1379,3389,+
chrX,153664267,36.987796477741576,1842,1329,3171,+
chrX,153664428,3.904874710543209,945,702,1647,+
chrX,153664434,1.7891479567592667,1038,835,1873,+
chrX,153664560,1.9873621323529411,557,543,1100,+
chrX,153667444,0.9310959310959311,626,480,1106,+
chrX,153667446,0.9310959310959311,626,480,1106,+
chrX,153668299,1.983436159210215,592,459,1051,+
chrX,153670511,0.755532603080029,661,540,1201,+
chrX,153671628,3.7476306858270094,635,446,1081,+
chrX,153674866,5.933353961331906,672,416,1088,+
chrX,153677252,1.373481231836722,726,482,1208,+
chrX,153991234,1.3016599190159803,672,505,1177,+
chrX,153993178,2.4694509552899317,889,594,1483,+
chrX,153993754,1.6365824308062575,815,553,1368,+
chrX,153996609,1.9699763593380615,640,469,1109,+
chrX,153996701,1.1296525889726912,1013,655,1668,+
chrX,153997506,3.890131578947369,656,379,1035,+
chrX,153999057,2.4887845592070943,1100,851,1951,+
chrX,153999059,2.4887845592070943,1100,851,1951,+
chrX,154005726,1.6458565072302558,622,463,1085,+
chrX,154005736,1.2197479257458648,1104,1028,2132,+
chrX,154255325,1.8782696716672906,623,424,1047,+
chrX,154261781,0.5510774575259186,1309,800,2109,+
chrX,154261782,0.5510774575259186,1309,800,2109,+
chrX,154274794,2.1193009410409065,1253,634,1887,+
chrX,154274814,1.8100873485488864,1459,844,2303,+
chrX,154274826,1.4477464788732397,1622,1064,2686,+
chrX,154274841,1.888971807628524,1198,669,1867,+
chrX,154274842,1.7007981230800222,2256,1346,3602,+
chrX,154274849,2.487151067323481,1408,811,2219,+
chrX,154279946,1.8866985645933012,1642,1044,2686,+
chrX,154279963,1.4214748100197017,2219,1495,3714,+
chrX,154283238,2.259566620562472,753,481,1234,+
chrX,154467168,0.5548293391430646,763,566,1329,+
chrX,154467657,1.9019573878399447,609,501,1110,+
chrX,154467679,0.5361216730038023,704,525,1229,+
chrX,154467719,2.2542517006802725,722,587,1309,+
chrX,155172099,1.0682313329372153,937,560,1497,+
chrX,155172100,1.0682313329372153,937,560,1497,+
chrX,155172524,7.353283616803859,1367,971,2338,+
chrX,155172525,8.253098972184015,1639,1162,2801,+
chrX,155173231,0.16848211805922295,1223,633,1856,+
chr3,8983295,2.2010712208509986,3713,2545,6258,-
chr3,8983296,2.517466311496942,4506,3138,7644,-
chr3,8983298,2.43161221082757,2398,1796,4194,-
chr3,8983300,2.6345759755831697,2323,1667,3990,-
chr3,8983301,2.1521033591731262,1530,1074,2604,-
chr3,8983308,1.8795104895104893,866,571,1437,-
chr3,8983315,1.8250276854928016,1132,692,1824,-
chr3,8983316,1.8250276854928016,1132,692,1824,-
chr3,8983327,2.3354718961774474,1004,576,1580,-
chr3,9831484,2.575704609606038,824,601,1425,-
chr3,9833989,5.177697816993206,745,500,1245,-
chr3,10015383,3.3257335674499315,679,499,1178,-
chr3,10019084,2.561659374493599,831,560,1391,-
chr3,10019085,2.561659374493599,831,560,1391,-
chr3,10342832,2.962097611630322,1140,962,2102,-
chr3,10342839,1.8771478961955157,1111,881,1992,-
chr3,10342840,1.423886236028756,1004,645,1649,-
chr3,10342846,2.46337543053961,893,669,1562,-
chr3,10342864,1.913104089219331,715,537,1252,-
chr3,10343003,1.0924568339615475,1488,1101,2589,-
chr3,10345716,1.4900562474889514,689,523,1212,-
chr3,10345785,0.6514589479218389,1311,937,2248,-
chr3,10346739,1.8824109453962776,663,426,1089,-
chr3,10346810,4.813324980266097,2144,1470,3614,-
chr3,10347340,2.0953703703703703,875,539,1414,-
chr3,10353664,2.7763347763347763,779,692,1471,-
chr3,10353706,2.082391304347826,926,574,1500,-
chr3,10353712,2.661711265279154,1150,1008,2158,-
chr3,10353728,2.8864142538975504,719,448,1167,-
chr3,10353745,2.951293919629707,904,678,1582,-
chr3,10353779,1.6650602409638555,690,414,1104,-
chr3,10354296,0.653903903903904,870,665,1535,-
chr3,10354297,0.6823468596536573,559,510,1069,-
chr3,10354363,1.3463829787234045,1581,986,2567,-
chr3,10354364,1.3463829787234045,1581,986,2567,-
chr3,10354393,1.6669398402279907,1360,1143,2503,-
chr3,10357049,1.7064341761115955,940,774,1714,-
chr3,10359767,1.8640106951871656,1290,747,2037,-
chr3,10359768,1.4583527884907443,1771,1173,2944,-
chr3,10359773,1.9087502303028567,1085,867,1952,-
chr3,11851148,0.7877999028928099,592,503,1095,-
chr3,12629119,2.0083737803152695,809,523,1332,-
chr3,12641206,2.2355982263350684,564,461,1025,-
chr3,12641265,1.2721157280436486,813,612,1425,-
chr3,12653477,2.6958448753462605,810,569,1379,-
chr3,12653482,2.185077519379845,769,515,1284,-
chr3,12653487,1.9495798319327726,695,440,1135,-
chr3,12653490,0.4301170562386913,727,458,1185,-
chr3,12653493,0.2181818181818181,639,439,1078,-
chr3,12660022,3.131282356260055,840,540,1380,-
chr3,12877683,1.330938447492407,18567,12724,31291,-
chr3,12877684,1.330938447492407,18567,12724,31291,-
chr3,12877717,1.2330043859649122,12282,6815,19097,-
chr3,12880964,1.2025347114921354,37397,25634,63031,-
chr3,12880983,1.1346116890023024,53367,41201,94568,-
chr3,12881683,1.2483460864194151,25183,20262,45445,-
chr3,12881684,1.207272674411949,41399,30857,72256,-
chr3,12881696,1.2070001674213573,21938,15481,37419,-
chr3,12881704,1.2492127473317696,8060,5988,14048,-
chr3,12881705,1.1454006862114507,12930,8505,21435,-
chr3,12882997,1.1666284709716563,132306,83010,215316,-
chr3,12882999,1.2036657254353587,133620,88535,222155,-
chr3,12883000,1.4476740625132596,56522,44069,100591,-
chr3,12883002,1.486899553677503,51591,38703,90294,-
chr3,12883003,1.1267972669463822,97288,62944,160232,-
chr3,12883005,1.1311368395361816,150883,92651,243534,-
chr3,12883006,1.220971324808949,42456,30564,73020,-
chr3,12883007,1.1414449629475285,112351,68781,181132,-
chr3,12883013,1.2795280390734887,50773,27062,77835,-
chr3,12883014,1.2301238334529794,4198,2855,7053,-
chr3,12883015,1.2795280390734887,50773,27062,77835,-
chr3,12883018,1.2266415936592299,27453,15561,43014,-
chr3,12883021,1.3315880322682088,26922,13764,40686,-
chr3,12883022,1.3977424770897242,21955,10643,32598,-
chr3,12883024,1.384114782969025,20141,9455,29596,-
chr3,12883025,1.1799361878756964,18432,8463,26895,-
chr3,12883026,0.7346962447440916,6333,3134,9467,-
chr3,12883027,0.8850126652842047,20712,10311,31023,-
chr3,12883029,0.8534579616184792,18564,8677,27241,-
chr3,12883030,0.9198843664226085,15874,8086,23960,-
chr3,12883031,0.8601679691225014,12941,6142,19083,-
chr3,12883036,1.2383791839897413,12808,6558,19366,-
chr3,12883037,1.195131858572467,10118,4883,15001,-
chr3,12883040,1.7698926540009485,2484,1496,3980,-
chr3,12883041,1.6854217356042174,1329,821,2150,-
chr3,12883043,1.196575435685723,1615,675,2290,-
chr3,12883044,0.7686538400384713,981,595,1576,-
chr3,12883045,0.7299037518937707,723,457,1180,-
chr3,13357852,2.445155608573008,754,572,1326,-
chr3,13358308,1.5029932651534048,617,421,1038,-
chr3,13358357,2.806915306915307,577,428,1005,-
chr3,13358390,1.9146799116997792,912,603,1515,-
chr3,13358391,2.045784212518241,1256,843,2099,-
chr3,13358653,3.0923600017303787,811,501,1312,-
chr3,13363269,1.9913296151270476,604,529,1133,-
chr3,13363747,0.367765942879305,771,560,1331,-
chr3,13363766,1.2462442091391284,669,510,1179,-
chr3,13364844,0.6277408228627741,636,450,1086,-
chr3,13368796,1.7286720875621402,630,414,1044,-
chr3,13370298,0.6801614162978391,949,667,1616,-
chr3,13370299,0.3500440754116075,2461,1517,3978,-
chr3,13370300,1.8132817643186303,1694,1301,2995,-
chr3,13370305,1.508328698546256,3781,2394,6175,-
chr3,13370306,0.6648694180331453,3414,2308,5722,-
chr3,13370308,0.6648694180331453,3414,2308,5722,-
chr3,13370327,0.5323028619731915,1101,636,1737,-
chr3,13370328,0.6517285531370037,1017,709,1726,-
chr3,13370330,0.4643114635904829,965,583,1548,-
chr3,13370342,2.243524015110632,722,435,1157,-
chr3,13372049,7.698913907232983,762,587,1349,-
chr3,13377055,0.540868942848486,731,607,1338,-
chr3,13377056,0.5933201385452747,570,469,1039,-
chr3,13377057,0.5933201385452747,570,469,1039,-
chr3,13384793,1.695965175486452,749,473,1222,-
chr3,13417082,2.42475780257216,661,476,1137,-
chr3,13427870,1.379751552795031,765,699,1464,-
chr3,14985067,0.36825755458286946,1284,643,1927,-
chr3,14985068,0.39556388588999386,1810,1012,2822,-
chr3,14985199,2.476483748481233,648,448,1096,-
chr3,14985788,0.5696079568812411,648,458,1106,-
chr3,14985845,2.44316484797254,574,427,1001,-
chr3,14987324,2.1435271342234,870,613,1483,-
chr3,14987605,0.40400262858489994,810,581,1391,-
chr3,15093775,8.481595872094294,1109,917,2026,-
chr3,15093778,35.31316083598105,1136,774,1910,-
chr3,15094112,0.9790277777777778,741,479,1220,-
chr3,15094113,1.325117783214963,955,657,1612,-
chr3,15100891,1.5022464310109598,5945,3773,9718,-
chr3,15100895,1.3116891527253105,2761,1699,4460,-
chr3,15100911,1.598288062587904,2170,1263,3433,-
chr3,15100913,1.434727338033228,4501,2653,7154,-
chr3,15100914,1.1235114257651313,7746,5380,13126,-
chr3,15100918,1.57525942302892,1766,966,2732,-
chr3,15100928,1.7977666922112556,4147,3095,7242,-
chr3,15100945,1.5202838752269352,4186,3284,7470,-
chr3,15100946,1.5202838752269352,4186,3284,7470,-
chr3,15100955,1.6884534456908376,4175,2752,6927,-
chr3,15100956,1.7197256385998108,3304,2264,5568,-
chr3,15100967,2.187245475113122,2606,1559,4165,-
chr3,15100969,2.1380971113059153,3013,1895,4908,-
chr3,15100971,2.132387706855792,655,375,1030,-
chr3,15106598,2.852542372881356,747,471,1218,-
chr3,15106600,2.852542372881356,747,471,1218,-
chr3,15106603,0.4905808793868496,1870,1109,2979,-
chr3,15106604,0.4905808793868496,1870,1109,2979,-
chr3,15106605,0.4905808793868496,1870,1109,2979,-
chr3,15296678,1.977761304670126,695,425,1120,-
chr3,15296832,0.53035413153457,591,592,1183,-
chr3,15296835,8.86111111111111,538,881,1419,-
chr3,15296877,4.786765926023276,2183,3359,5542,-
chr3,15296878,4.786765926023276,2183,3359,5542,-
chr3,15296894,5.498992020209103,1949,2011,3960,-
chr3,15296895,5.868425763463385,1792,1787,3579,-
chr3,15296906,4.838689306763963,542,508,1050,-
chr3,15296908,7.355042920618698,2012,1433,3445,-
chr3,15296909,9.136543139353687,1732,1172,2904,-
chr3,15296916,7.29193075641039,990,255,1245,-
chr3,15296923,9.543295019157089,957,173,1130,-
chr3,15296924,10.576346245875188,1605,280,1885,-
chr3,15296925,13.014782706223553,1812,283,2095,-
chr3,15296926,17.849999999999998,951,127,1078,-
chr3,15296927,16.746613851265018,1129,149,1278,-
chr3,15297190,2.2742735580140807,1310,1116,2426,-
chr3,15297254,2.7655041804104696,914,630,1544,-
chr3,15298522,2.2944031431737186,640,389,1029,-
chr3,15298601,1.3136717908332498,653,475,1128,-
chr3,15303698,1.3194050248184435,831,599,1430,-
chr3,15303752,1.301731041804326,651,452,1103,-
chr3,15372033,0.17084730157754605,520,489,1009,-
chr3,15373802,2.589633137982616,800,1146,1946,-
chr3,15838077,2.4297520661157024,1028,846,1874,-
chr3,15838079,2.4297520661157024,1028,846,1874,-
chr3,25665825,2.2602263617971525,787,524,1311,-
chr3,25665826,2.825510204081633,638,391,1029,-
chr3,25668338,1.958969024503005,996,926,1922,-
chr3,25668698,1.6754176610978522,727,418,1145,-
chr3,25668704,1.2110841025883476,1374,915,2289,-
chr3,27446421,0.9093083320259646,1580,1001,2581,-
chr3,27446425,0.5802038626609443,720,465,1185,-
chr3,27446447,1.5439990892489182,598,404,1002,-
chr3,28365401,2.258346273291925,894,671,1565,-
chr3,28365404,1.7637700192755723,2081,1420,3501,-
chr3,28365409,1.570451570237537,1266,812,2078,-
chr3,28365412,1.995747696669029,639,414,1053,-
chr3,28365416,0.5900170648464164,921,585,1506,-
chr3,28373894,1.779059040590406,797,541,1338,-
chr3,28378331,2.681610678475085,836,644,1480,-
chr3,28378334,2.0084105599309545,2639,1838,4477,-
chr3,28378335,2.0084105599309545,2639,1838,4477,-
chr3,31743987,2.1421949760765555,946,718,1664,-
chr3,31774765,1.63251252441827,631,451,1082,-
chr3,32524137,1.151274654424129,688,480,1168,-
chr3,32570084,3.5622449961091287,588,420,1008,-
chr3,32587437,2.2061376328384834,853,712,1565,-
chr3,33055654,1.8291135265315386,613,552,1165,-
chr3,33058246,1.7472477171142347,1269,929,2198,-
chr3,33059986,4.127709196943256,821,641,1462,-
chr3,33065812,1.8569190856135884,842,658,1500,-
chr3,33065813,1.8569190856135884,842,658,1500,-
chr3,33107004,0.5012089134364578,852,651,1503,-
chr3,33110336,2.8186010607712153,677,537,1214,-
chr3,33114182,0.8895043563556632,751,653,1404,-
chr3,33114184,1.6292306675959767,804,653,1457,-
chr3,33431287,1.2918824763792374,768,536,1304,-
chr3,33450976,1.7908314788248303,1285,965,2250,-
chr3,33450979,1.7948706135541226,911,600,1511,-
chr3,38164456,2.718458726411664,620,396,1016,-
chr3,42826457,1.0811913504691963,1059,644,1703,-
chr3,42826458,1.0811913504691963,1059,644,1703,-
chr3,42826472,3.4741573033707867,772,444,1216,-
chr3,42826473,0.3852425601304525,629,445,1074,-
chr3,42826482,2.377525557433792,1135,605,1740,-
chr3,42826483,2.377525557433792,1135,605,1740,-
chr3,42826503,1.1014994232987312,954,458,1412,-
chr3,42826505,1.1014994232987312,954,458,1412,-
chr3,42835764,2.0851063829787235,559,469,1028,-
chr3,42845946,0.822878914599015,1011,843,1854,-
chr3,42845947,0.822878914599015,1011,843,1854,-
chr3,42845957,0.5724881660722987,939,719,1658,-
chr3,44967541,5.440332716735262,770,641,1411,-
chr3,45868907,2.295518025040512,863,661,1524,-
chr3,45868908,2.34,584,499,1083,-
chr3,47552676,8.418837379443513,611,432,1043,-
chr3,47629203,10.242731478818396,1166,1027,2193,-
chr3,47629204,9.635633549093159,1323,1157,2480,-
chr3,47721945,0.6812891032089027,702,445,1147,-
chr3,47742816,3.4151023509430587,662,468,1130,-
chr3,47892555,5.9788877788877794,548,453,1001,-
chr3,47893127,0.3387096774193548,671,495,1166,-
chr3,47893142,1.190069817142244,1538,1250,2788,-
chr3,47893144,1.0220231978139216,1344,997,2341,-
chr3,47893199,2.7887657148056597,687,463,1150,-
chr3,47893794,2.326817149260503,984,683,1667,-
chr3,47893795,1.8818335877712897,1011,763,1774,-
chr3,47893796,1.2075829383886254,881,632,1513,-
chr3,47894051,0.3516787815853236,507,641,1148,-
chr3,47894052,0.3516787815853236,507,641,1148,-
chr3,47894058,3.370247264373375,713,677,1390,-
chr3,47894066,1.6771146809764401,858,883,1741,-
chr3,47894072,1.4986922151057664,538,476,1014,-
chr3,47894080,6.805842759408708,899,645,1544,-
chr3,47894081,6.507936507936507,655,440,1095,-
chr3,47894086,5.359202573635918,1411,1033,2444,-
chr3,47894089,4.427683658130482,1494,960,2454,-
chr3,47894090,5.080564487271286,1038,676,1714,-
chr3,47894091,5.358092014780334,1108,772,1880,-
chr3,47896772,3.127992339610597,699,481,1180,-
chr3,47896773,3.127992339610597,699,481,1180,-
chr3,47898986,0.6162640110748895,599,456,1055,-
chr3,47908761,1.317217447272849,799,569,1368,-
chr3,47910803,2.3446707323989373,670,551,1221,-
chr3,47912365,0.35124498683139527,734,491,1225,-
chr3,47912740,3.3647532063874346,743,561,1304,-
chr3,47917235,2.4713702511830817,991,651,1642,-
chr3,47917284,3.1972972972972977,675,369,1044,-
chr3,47917285,3.1972972972972977,675,369,1044,-
chr3,47918916,1.6160613071580814,601,501,1102,-
chr3,47957778,1.7734952742728551,1580,1132,2712,-
chr3,48215882,1.0974965845423885,1346,1153,2499,-
chr3,48215883,1.9952686718485968,575,537,1112,-
chr3,48215884,0.3777254518210452,771,616,1387,-
chr3,48476328,2.821794838807632,1130,650,1780,-
chr3,48509367,1.174834919055942,1146,827,1973,-
chr3,48509395,1.582498967571135,1236,1035,2271,-
chr3,48509417,3.0921732530460746,737,559,1296,-
chr3,48509886,2.2215639311698028,691,466,1157,-
chr3,48510183,9.19285714285714,1022,619,1641,-
chr3,48510184,9.19285714285714,1022,619,1641,-
chr3,48510185,8.638973286875723,1252,798,2050,-
chr3,48510437,2.1533632728367604,624,467,1091,-
chr3,48510543,2.302184235517569,712,389,1101,-
chr3,48510545,2.302184235517569,712,389,1101,-
chr3,48511182,2.071073205401564,657,468,1125,-
chr3,48511183,2.071073205401564,657,468,1125,-
chr3,48514504,0.616783687203818,978,895,1873,-
chr3,48514505,0.7516685001833516,553,504,1057,-
chr3,48514506,0.4312787609632714,702,592,1294,-
chr3,48601605,19.913757354876807,718,570,1288,-
chr3,48603714,2.8221329260363763,567,444,1011,-
chr3,48605563,0.6008740896966689,710,515,1225,-
chr3,48613318,2.3899415204678363,600,569,1169,-
chr3,48613321,2.804761904761905,588,524,1112,-
chr3,48613329,2.143927532990382,1008,788,1796,-
chr3,48613330,2.143927532990382,1008,788,1796,-
chr3,48626192,4.686685932264098,647,464,1111,-
chr3,48636499,0.5464099702380952,1174,895,2069,-
chr3,48636500,0.5464099702380952,1174,895,2069,-
chr3,48637090,1.7020254357041922,1245,964,2209,-
chr3,48637096,1.4183249038254993,1962,1248,3210,-
chr3,48637130,1.554093567251462,1062,835,1897,-
chr3,48637507,0.6564422015454976,924,745,1669,-
chr3,48637516,1.7686882933709451,835,708,1543,-
chr3,48637918,1.3291904340124003,1320,1128,2448,-
chr3,48637923,0.7079774832219087,1801,1373,3174,-
chr3,48637949,1.6769999999999998,902,749,1651,-
chr3,48637950,0.6487788215200684,1460,1170,2630,-
chr3,48637953,1.634010736196319,946,651,1597,-
chr3,48638148,1.324459188269935,3582,2480,6062,-
chr3,48638221,1.5395189003436422,1663,1260,2923,-
chr3,48638236,2.146666666666667,895,719,1614,-
chr3,48638249,2.032324735449736,792,575,1367,-
chr3,48638432,1.8850485436893203,808,514,1322,-
chr3,48638435,0.992074592074592,2051,1052,3103,-
chr3,48638436,0.992074592074592,2051,1052,3103,-
chr3,48641036,1.51044776119403,1655,1004,2659,-
chr3,48641674,0.6773451327433628,1512,1129,2641,-
chr3,48641756,1.519395723979004,1241,962,2203,-
chr3,48641770,1.458212966917029,1074,846,1920,-
chr3,48641812,1.4670199159510324,1146,841,1987,-
chr3,48642090,0.6222279822590865,3873,2571,6444,-
chr3,48642110,1.638650657518582,2865,1748,4613,-
chr3,48642118,1.7242204799808485,2579,1301,3880,-
chr3,48642150,1.537262571294019,3492,2635,6127,-
chr3,48642151,0.7104246375169585,3238,2012,5250,-
chr3,48642152,1.257696897656019,8185,5646,13831,-
chr3,48642153,1.604849127425173,3009,2103,5112,-
chr3,48642205,0.6324342324342325,1186,909,2095,-
chr3,48643244,0.9144366566843409,3732,2906,6638,-
chr3,48643245,0.5985138182994431,2143,1776,3919,-
chr3,48643278,1.5055285272003538,850,713,1563,-
chr3,48646602,1.9330268845060647,2017,1438,3455,-
chr3,48646612,2.3724279835390947,1152,728,1880,-
chr3,48646643,1.87905604719764,587,451,1038,-
chr3,48646657,2.174390276303824,926,766,1692,-
chr3,48646705,2.213675213675214,776,467,1243,-
chr3,48647004,2.53125,764,407,1171,-
chr3,48647009,1.881137679842957,1595,1096,2691,-
chr3,48647011,1.83493810178817,873,726,1599,-
chr3,48647066,2.238307769675635,912,387,1299,-
chr3,48647067,2.238307769675635,912,387,1299,-
chr3,48647071,1.510441283944625,906,496,1402,-
chr3,48647076,1.2058974486596254,956,314,1270,-
chr3,48665404,2.652834312072129,1055,636,1691,-
chr3,48665440,2.2993608776911953,894,541,1435,-
chr3,48754619,1.231277207976088,1680,1241,2921,-
chr3,48754620,0.7665513101535689,1915,1454,3369,-
chr3,48754628,2.1089171987484607,672,432,1104,-
chr3,48754632,2.060129387169664,1338,991,2329,-
chr3,48754633,1.998854476647097,1595,1165,2760,-
chr3,48754635,1.9536707876582877,735,515,1250,-
chr3,49062103,1.3691073580856632,6490,5335,11825,-
chr3,49062109,1.4664566419190206,26025,17559,43584,-
chr3,49062110,1.7637421552806167,19477,13859,33336,-
chr3,49062111,1.76029503467676,23592,16326,39918,-
chr3,49062112,1.8719867947118063,17915,11821,29736,-
chr3,49062113,1.8933896818879088,12941,8158,21099,-
chr3,49062143,1.5647478351540034,4956,2957,7913,-
chr3,49062167,0.7511833960432092,2062,1497,3559,-
chr3,49062217,0.935879371995548,7025,3838,10863,-
chr3,49062218,0.8723533019856439,9147,5300,14447,-
chr3,49062335,0.681282208053105,2079,1283,3362,-
chr3,49062343,0.4908594863239843,1802,1241,3043,-
chr3,49062360,0.3811218278865062,1539,1266,2805,-
chr3,49062394,1.7190169652766767,2296,1854,4150,-
chr3,49062395,1.7190169652766767,2296,1854,4150,-
chr3,49062403,0.5814018319394664,1122,929,2051,-
chr3,49062593,1.8002574264737654,2420,1705,4125,-
chr3,49062611,1.727627164747484,1360,1075,2435,-
chr3,49062653,0.5260645161290322,905,774,1679,-
chr3,49062668,1.858334538791649,819,668,1487,-
chr3,49062676,1.1381604843884394,1624,1367,2991,-
chr3,49062680,0.5604395604395604,737,573,1310,-
chr3,49063761,2.211899101954569,816,630,1446,-
chr3,49063768,1.5489384988039743,2200,1513,3713,-
chr3,49063770,1.916474309652048,772,556,1328,-
chr3,49064156,2.111111111111111,1341,1097,2438,-
chr3,49064168,1.073317737422491,2947,2329,5276,-
chr3,49064169,1.6072980017376197,1799,1150,2949,-
chr3,49064217,0.7010195705707003,1410,1171,2581,-
chr3,49064398,1.7473793461338871,1402,1174,2576,-
chr3,49065183,0.5469132635212351,937,808,1745,-
chr3,49065245,1.5123945147679323,1146,947,2093,-
chr3,49065285,1.4997830138105328,1198,910,2108,-
chr3,49065332,1.569134819532909,1289,941,2230,-
chr3,49065743,1.87765179044581,9341,7690,17031,-
chr3,49065744,1.87765179044581,9341,7690,17031,-
chr3,49065892,1.4198907256368745,5722,4147,9869,-
chr3,49065898,1.4205069839627522,2691,1932,4623,-
chr3,49065906,1.6712449955794624,4620,3676,8296,-
chr3,49065928,1.711487556114879,3967,2598,6565,-
chr3,49065939,1.371214953271028,1702,1390,3092,-
chr3,49065941,0.7002676181980375,1569,1120,2689,-
chr3,49066688,1.9659550425446095,2698,1907,4605,-
chr3,49066733,1.496501272264631,940,785,1725,-
chr3,49066767,1.7560567212600071,838,658,1496,-
chr3,49066768,1.7994816974408812,1514,1322,2836,-
chr3,49066769,1.7994816974408812,1514,1322,2836,-
chr3,49083956,0.3730501945699994,650,465,1115,-
chr3,49095140,2.3919033551778437,880,482,1362,-
chr3,49095180,3.0235368956743,678,392,1070,-
chr3,49095181,3.0235368956743,678,392,1070,-
chr3,49095182,3.0235368956743,678,392,1070,-
chr3,49135476,0.6531766249807011,966,761,1727,-
chr3,49135483,1.738970588235294,879,543,1422,-
chr3,49135530,1.7405472416541217,755,490,1245,-
chr3,49135680,2.499339846844468,630,540,1170,-
chr3,49135794,1.6338028169014085,608,496,1104,-
chr3,49135838,1.9462530418032251,2198,1578,3776,-
chr3,49135876,2.403296703296704,728,454,1182,-
chr3,49136565,2.179083094555874,1013,697,1710,-
chr3,49136567,2.179083094555874,1013,697,1710,-
chr3,49136667,2.4776656871039617,1174,761,1935,-
chr3,49136668,2.628425283156741,653,482,1135,-
chr3,49136790,1.9396895200156496,875,525,1400,-
chr3,49136793,6.45686274509804,711,509,1220,-
chr3,49136795,6.45686274509804,711,509,1220,-
chr3,49137205,1.9279112754158965,1638,1081,2719,-
chr3,49137206,1.8600500911821867,2163,1546,3709,-
chr3,49137224,2.147787501540737,696,426,1122,-
chr3,49137454,1.6650335441167559,769,658,1427,-
chr3,49137722,2.3114973262032086,664,439,1103,-
chr3,49137875,3.149532710280374,673,427,1100,-
chr3,49138852,1.444081748509793,924,812,1736,-
chr3,49138853,1.738897768455273,2101,1647,3748,-
chr3,49139085,0.6267257788593597,702,538,1240,-
chr3,49139859,2.1199076039594393,2996,2726,5722,-
chr3,49139862,1.607142857142857,1409,1455,2864,-
chr3,49139866,1.193791606555459,2624,2151,4775,-
chr3,49139872,1.655452761424166,1180,1043,2223,-
chr3,49139882,0.6783203496104884,1070,830,1900,-
chr3,49139883,1.5208102771171361,1642,1418,3060,-
chr3,49140796,1.61,643,479,1122,-
chr3,49140797,1.7322422258592471,587,469,1056,-
chr3,49141853,1.0856572655706722,1119,879,1998,-
chr3,49141899,2.555440910288754,842,504,1346,-
chr3,49142090,1.6407077486430859,949,745,1694,-
chr3,49142092,1.3706124425078674,595,485,1080,-
chr3,49142183,0.8326446280991736,688,317,1005,-
chr3,49142184,0.7458107502585873,1507,804,2311,-
chr3,49394672,1.9140306733764678,742,641,1383,-
chr3,49394703,1.611236641221374,775,654,1429,-
chr3,49394704,1.3494013616088896,1436,982,2418,-
chr3,49394706,2.497505345687812,729,609,1338,-
chr3,49394707,0.6410429918347093,1014,820,1834,-
chr3,49394739,2.3236859614105128,634,500,1134,-
chr3,49394761,1.6292613636363638,1084,703,1787,-
chr3,49394766,1.7883780332056192,736,539,1275,-
chr3,49394785,2.186887254901961,912,543,1455,-
chr3,49394798,2.440613026819923,636,376,1012,-
chr3,49394811,2.3178173277399585,717,493,1210,-
chr3,49394956,2.44507338233438,1641,1063,2704,-
chr3,49395154,1.736758850160912,795,678,1473,-
chr3,49395589,2.481177275838467,749,486,1235,-
chr3,49395594,1.082423067653114,974,780,1754,-
chr3,49395597,2.2491145218417947,1269,769,2038,-
chr3,49395598,2.1652991505460624,1984,1372,3356,-
chr3,49395719,0.42615196530322963,752,438,1190,-
chr3,49396827,2.1824607908106914,1139,1005,2144,-
chr3,49396831,0.4933799533799534,1113,714,1827,-
chr3,49397170,1.638434868746904,1653,1345,2998,-
chr3,49397172,1.3818699818699818,1441,1169,2610,-
chr3,49397514,1.509956948656501,1757,1545,3302,-
chr3,49397642,1.714647280560043,1872,1237,3109,-
chr3,49397669,0.6419726393584402,1718,1105,2823,-
chr3,49397797,1.9754053561668792,1548,997,2545,-
chr3,49405912,1.670631005635668,1844,1212,3056,-
chr3,49405940,1.5029078989108595,1397,1157,2554,-
chr3,49405944,1.4195588584077794,1607,972,2579,-
chr3,49412897,1.6582073230513972,1395,1152,2547,-
chr3,49412936,1.4674750047860121,2850,2088,4938,-
chr3,49413005,1.7703465905713096,1841,1601,3442,-
chr3,49413006,1.7703465905713096,1841,1601,3442,-
chr3,49449280,2.047989335703177,837,642,1479,-
chr3,49449281,1.5456570427882848,1474,1104,2578,-
chr3,49449355,1.3816125184492543,2071,1399,3470,-
chr3,49449356,1.824607683982684,1299,923,2222,-
chr3,49449376,2.809139851855183,673,560,1233,-
chr3,50325591,1.9614522635589424,546,484,1030,-
chr3,50325597,2.0289624867055887,1387,1053,2440,-
chr3,50325598,2.0607987505577867,753,663,1416,-
chr3,50325665,1.98565050928267,702,497,1199,-
chr3,50325694,1.6366432094924919,642,535,1177,-
chr3,50325916,1.2176457569165948,691,534,1225,-
chr3,50326126,2.778238341968912,765,578,1343,-
chr3,50326127,2.778238341968912,765,578,1343,-
chr3,50326128,2.7883632891466306,1146,810,1956,-
chr3,50326297,3.3185185185185184,671,431,1102,-
chr3,50326298,3.099350649350649,998,629,1627,-
chr3,50326300,3.785947712418301,661,407,1068,-
chr3,50326304,2.1943161314928363,704,464,1168,-
chr3,50326727,2.1177682669936493,818,547,1365,-
chr3,50327619,1.3238060889463736,598,437,1035,-
chr3,50355326,12.67379443874843,756,662,1418,-
chr3,52002599,2.833552151714077,606,456,1062,-
chr3,52002600,2.833552151714077,606,456,1062,-
chr3,52002629,4.131683273262284,740,480,1220,-
chr3,52027818,1.2855369204083023,24841,18981,43822,-
chr3,52027824,1.41750541240229,6712,5285,11997,-
chr3,52027844,1.436389865195734,14055,9202,23257,-
chr3,52027847,1.395167241247368,19177,13539,32716,-
chr3,52027850,1.4003061435709996,19830,12121,31951,-
chr3,52027852,1.3192990995376004,20849,11739,32588,-
chr3,52027854,1.33765748413554,24428,14989,39417,-
chr3,52027855,1.2845815531447455,23088,13915,37003,-
chr3,52027856,1.2863430549897723,9994,6716,16710,-
chr3,52027949,1.2717055977804423,53894,35593,89487,-
chr3,52027951,1.2717055977804423,53894,35593,89487,-
chr3,52027987,0.6919093310743502,17194,10284,27478,-
chr3,52027993,1.26230335939343,5288,3110,8398,-
chr3,52027994,1.366763483661198,5566,2668,8234,-
chr3,52028000,1.3526085529249747,17726,10131,27857,-
chr3,52028001,1.285147573508333,9265,4243,13508,-
chr3,52028005,1.3456002633426376,4005,1740,5745,-
chr3,52028015,1.3254543143982718,2979,2317,5296,-
chr3,52028018,1.391746125243898,2907,1180,4087,-
chr3,52028019,1.4373661868489362,4279,2948,7227,-
chr3,52028027,1.4520672421626533,2396,922,3318,-
chr3,52029116,1.5473267210403907,20382,14456,34838,-
chr3,52029463,1.2465152361447278,4098,3143,7241,-
chr3,52029470,1.4900234259631433,6940,5914,12854,-
chr3,52029482,0.782780367425281,3049,2604,5653,-
chr3,52029483,1.4479518381574656,6421,5133,11554,-
chr3,52029875,0.8087967220556884,3085,2360,5445,-
chr3,52029893,1.4508168107401291,2077,1898,3975,-
chr3,52029898,1.3567878223050638,1746,1257,3003,-
chr3,52029900,1.1279973018016856,6555,3837,10392,-
chr3,52029901,1.1252857102794043,15516,10892,26408,-
chr3,52029902,1.1252857102794043,15516,10892,26408,-
chr3,52029903,1.109537581496527,13107,9442,22549,-
chr3,52029910,1.4975726449794415,1710,1040,2750,-
chr3,52029915,1.1873410854251163,3455,2197,5652,-
chr3,52029916,1.352016394378258,4234,2652,6886,-
chr3,52029917,0.5852980319760048,991,724,1715,-
chr3,52029918,1.11884372598229,1715,976,2691,-
chr3,52029938,0.7237053775260828,1106,813,1919,-
chr3,52029939,1.3569988002817088,697,455,1152,-
chr3,52262688,8.556502394009588,1684,1236,2920,-
chr3,52262689,8.556502394009588,1684,1236,2920,-
chr3,52262690,8.682110238424848,1454,975,2429,-
chr3,52443580,1.7811349944914558,1168,1152,2320,-
chr3,52443582,1.7773393686585042,2297,2119,4416,-
chr3,52443584,1.859873104302074,1117,1076,2193,-
chr3,52485436,2.6493847415914686,733,529,1262,-
chr3,52485438,3.054758488761358,729,491,1220,-
chr3,52561944,0.34200901500309605,638,463,1101,-
chr3,52562213,1.2224985817473863,787,703,1490,-
chr3,52731750,1.2793674019976093,696,455,1151,-
chr3,52731756,2.692697432035915,888,601,1489,-
chr3,53259742,1.238919312347873,10816,11209,22025,-
chr3,53259744,6.986623976650456,49507,52334,101841,-
chr3,53259745,11.535420730135057,57972,55221,113193,-
chr3,53259746,11.535420730135057,57972,55221,113193,-
chr3,53259747,17.55957776519329,42923,37076,79999,-
chr3,53259751,11.00686714037507,5524,1944,7468,-
chr3,53259760,2.1444357713060818,11377,3632,15009,-
chr3,53259762,2.251653613374189,32638,10138,42776,-
chr3,53259763,2.5433943626668594,37652,12437,50089,-
chr3,53259764,2.4381658126584695,48137,15943,64080,-
chr3,53259766,2.1684356652825705,25790,8642,34432,-
chr3,53259864,1.3538252268922373,4843,3782,8625,-
chr3,53259879,1.296813849490879,4527,3473,8000,-
chr3,53260779,1.3940496146587806,5748,3512,9260,-
chr3,53260890,1.1934687444022753,10502,9086,19588,-
chr3,53262343,1.4371381582402216,46834,34529,81363,-
chr3,53262344,1.3421206826149124,28153,18632,46785,-
chr3,53262345,1.4371381582402216,46834,34529,81363,-
chr3,53262375,1.0605442265863771,494,519,1013,-
chr3,53263111,1.2433545790048206,13359,9551,22910,-
chr3,53263115,1.157104188403032,6212,5026,11238,-
chr3,53263396,1.4651814887979702,5304,3110,8414,-
chr3,53263397,1.940630937591348,4402,3420,7822,-
chr3,53264525,1.048994333748998,20603,16255,36858,-
chr3,53264527,0.9836220680980124,12246,10101,22347,-
chr3,53264583,1.6161998200534544,19465,13143,32608,-
chr3,53264585,1.4463335880134827,36529,23088,59617,-
chr3,53264586,1.2199258031254123,25436,16803,42239,-
chr3,53265374,1.254517792710567,10298,7358,17656,-
chr3,53265484,1.369342324704517,5592,4596,10188,-
chr3,53265490,0.7308850863172512,6218,4106,10324,-
chr3,53265558,1.3669241423641136,9686,7686,17372,-
chr3,53265559,1.3669241423641136,9686,7686,17372,-
chr3,53267214,0.7703389830508475,2726,2359,5085,-
chr3,53267225,1.211382281571031,9924,7183,17107,-
chr3,53269109,1.3155237873328094,26644,17188,43832,-
chr3,53269110,1.3155237873328094,26644,17188,43832,-
chr3,53269111,1.2938147409522522,16154,9384,25538,-
chr3,53274282,1.2799678532189,15401,10636,26037,-
chr3,53274284,1.3193557145536807,19701,14197,33898,-
chr3,53274285,1.1938033254237708,23079,15366,38445,-
chr3,53274286,1.1345068117028136,27606,18488,46094,-
chr3,53274291,1.5444968857854298,4106,2756,6862,-
chr3,53274294,1.4223649083589809,7473,4635,12108,-
chr3,53275181,1.1828666741670684,4794,2926,7720,-
chr3,53275182,0.7044802253923352,7231,5624,12855,-
chr3,53275193,1.5797010225603874,8199,5709,13908,-
chr3,53275238,1.353164081581942,4965,3650,8615,-
chr3,53276165,1.0063411316187194,10164,8062,18226,-
chr3,53276173,1.2995530789288938,4658,3067,7725,-
chr3,53276190,1.2599118942731278,3816,3469,7285,-
chr3,53276211,1.2733008068131937,7921,6379,14300,-
chr3,53276228,1.4571302647786732,3069,2480,5549,-
chr3,53276245,1.4824540998354854,3724,2188,5912,-
chr3,53289932,1.4274696762985828,5127,4237,9364,-
chr3,53289996,1.175895132904479,4622,3541,8163,-
chr3,53289998,1.1546024693215524,6770,5588,12358,-
chr3,53290002,0.6674470356697239,3311,2420,5731,-
chr3,53290003,0.6473606911636578,5808,4720,10528,-
chr3,53290012,1.4880002203749296,2174,1501,3675,-
chr3,53290023,1.5681330472103003,789,465,1254,-
chr3,53290029,1.814476645523603,1152,752,1904,-
chr3,53290030,0.7671060891399875,939,884,1823,-
chr3,53290031,0.6485413710098801,1284,1247,2531,-
chr3,53919563,2.4843893480257115,772,604,1376,-
chr3,53919565,2.4843893480257115,772,604,1376,-
chr3,53919571,2.1216278006401463,695,485,1180,-
chr3,53919573,2.1216278006401463,695,485,1180,-
chr3,53919886,0.22630508953968478,2463,1578,4041,-
chr3,53919887,0.24464359986144713,1828,1233,3061,-
chr3,53925810,0.49562691131498476,852,653,1505,-
chr3,53925812,0.49562691131498476,852,653,1505,-
chr3,53925873,0.8682807532404011,633,434,1067,-
chr3,53925874,1.0717745539522383,1312,1110,2422,-
chr3,53925876,1.0438807609564915,661,578,1239,-
chr3,55500320,1.9426712675007636,2764,2441,5205,-
chr3,55500321,2.0167094784427535,2182,1971,4153,-
chr3,55500364,2.813769937852414,1009,757,1766,-
chr3,55500381,1.3392592029235293,843,622,1465,-
chr3,55502000,1.0974094767457871,2132,1574,3706,-
chr3,55502008,1.9756468797564688,825,656,1481,-
chr3,55502010,0.6899766899766899,1109,659,1768,-
chr3,55502014,1.1252235998771947,1438,968,2406,-
chr3,55502616,2.1498316047303763,616,444,1060,-
chr3,55503423,2.4315532664678776,689,526,1215,-
chr3,55503424,2.4315532664678776,689,526,1215,-
chr3,55503521,1.8837599677284456,1791,1108,2899,-
chr3,55503523,1.9539560233038904,1123,625,1748,-
chr3,56661119,1.4168098153148907,637,439,1076,-
chr3,56716769,1.6143203763174627,748,403,1151,-
chr3,56716775,2.2356687898089174,935,470,1405,-
chr3,56716777,1.726669908372313,1250,686,1936,-
chr3,56779313,1.9727697376923996,616,398,1014,-
chr3,57557693,1.407964425565806,1452,1234,2686,-
chr3,57557708,1.7588327091136082,1198,889,2087,-
chr3,57557772,2.0581095041322315,1225,725,1950,-
chr3,57557959,1.938931410941023,2010,1271,3281,-
chr3,57558001,1.6751016230397513,4038,2792,6830,-
chr3,57569707,1.7639125842879193,1839,1118,2957,-
chr3,57570136,1.6431779804120232,1332,986,2318,-
chr3,57582875,2.0837087087087083,792,591,1383,-
chr3,57582882,1.648279733419867,1382,1117,2499,-
chr3,57582887,0.3448853172610079,617,542,1159,-
chr3,57583025,1.4705690217952914,778,659,1437,-
chr3,57583063,2.8652392786942897,687,415,1102,-
chr3,61728131,0.9501466616887302,2582,1774,4356,-
chr3,61728198,1.4016864518560392,1081,695,1776,-
chr3,61728199,1.4016864518560392,1081,695,1776,-
chr3,63819865,2.2295,636,399,1035,-
chr3,64004524,1.926595269968764,2354,1295,3649,-
chr3,64004525,2.0281959378733574,1060,557,1617,-
chr3,64004526,1.6982333738718556,3386,1837,5223,-
chr3,64004528,1.495297095153553,2174,1150,3324,-
chr3,64004542,0.6611897180000657,1388,733,2121,-
chr3,64004559,0.5098122653316646,1970,1174,3144,-
chr3,64004560,0.5098122653316646,1970,1174,3144,-
chr3,64004563,0.4636264581463914,850,537,1387,-
chr3,67425562,1.6047780742178028,801,588,1389,-
chr3,67425671,2.02673658872077,1149,726,1875,-
chr3,67425697,0.9316861725184219,976,768,1744,-
chr3,67425698,0.9316861725184219,976,768,1744,-
chr3,67425734,0.5183016885891139,1160,722,1882,-
chr3,67425738,2.41977708051218,1479,922,2401,-
chr3,67426053,10.282462928946467,1449,1184,2633,-
chr3,67426059,11.783921505778151,1937,1335,3272,-
chr3,67426082,4.440139402687111,1198,696,1894,-
chr3,67546244,1.10205159813331,893,553,1446,-
chr3,67546245,1.10205159813331,893,553,1446,-
chr3,67659967,2.7076964210597483,735,550,1285,-
chr3,67659999,0.2173936661415612,666,448,1114,-
chr3,67660000,0.2173936661415612,666,448,1114,-
chr3,67660001,0.4678147972821965,1158,789,1947,-
chr3,69084231,1.9232503607503606,852,615,1467,-
chr3,69084233,1.9652006425778745,1217,799,2016,-
chr3,69104479,3.012701412490516,833,539,1372,-
chr3,69111043,3.155317164179104,824,535,1359,-
chr3,69111044,3.155317164179104,824,535,1359,-
chr3,81586134,1.8491276746988525,5369,4176,9545,-
chr3,81586135,1.8793284595090252,6913,5324,12237,-
chr3,81586139,2.7067597208374874,1211,1002,2213,-
chr3,81586142,1.81296340588376,1136,677,1813,-
chr3,81586161,1.5174160079051382,944,551,1495,-
chr3,81586163,2.5170076335877862,895,654,1549,-
chr3,81586167,3.5689303904923597,857,588,1445,-
chr3,81586225,2.462815600746635,1165,753,1918,-
chr3,81586226,2.462815600746635,1165,753,1918,-
chr3,81586240,1.6650674948443998,946,590,1536,-
chr3,81627193,0.7484106215607274,711,521,1232,-
chr3,100082931,4.332604268121503,625,401,1026,-
chr3,100091517,3.09555796339575,627,460,1087,-
chr3,100092396,1.3163326826524928,629,405,1034,-
chr3,100093922,0.3231382978723404,728,516,1244,-
chr3,100093924,1.1204780511716965,918,676,1594,-
chr3,100096584,2.3726620266052443,901,684,1585,-
chr3,101371476,2.9283831144067363,1628,1166,2794,-
chr3,101371505,2.7889986528536888,1038,703,1741,-
chr3,101371508,2.60055382485289,1365,962,2327,-
chr3,101371509,2.60055382485289,1365,962,2327,-
chr3,101371510,2.020314767346737,1874,1350,3224,-
chr3,101373562,1.6712952547704243,621,390,1011,-
chr3,101400030,1.3633993477940034,75108,58298,133406,-
chr3,101400031,1.1662492158286601,147737,119644,267381,-
chr3,101400033,1.0382108738425018,89789,73711,163500,-
chr3,101400036,1.4808671718312851,31984,23469,55453,-
chr3,101401298,1.257193100314735,30268,21727,51995,-
chr3,101404677,1.7259493670886077,6766,5292,12058,-
chr3,101405544,1.1567688545324875,37942,26342,64284,-
chr3,101405545,1.107616547255403,6851,6339,13190,-
chr3,101405546,1.2233770004001505,34316,19853,54169,-
chr3,101405547,1.0183107764287438,13205,5929,19134,-
chr3,101405548,0.9743759428890576,34207,20421,54628,-
chr3,101405549,0.8775929051008461,10741,8216,18957,-
chr3,101405550,0.8978463348509387,18497,11699,30196,-
chr3,101405555,1.3899328745619781,6935,3397,10332,-
chr3,101405556,1.3550859416468517,6977,2923,9900,-
chr3,101405557,1.1088865153784286,3925,2761,6686,-
chr3,101405558,1.3897564022485946,3899,1600,5499,-
chr3,101405560,1.3446978193146415,657,374,1031,-
chr3,101405561,0.8096002422774076,937,380,1317,-
chr3,101405563,0.7434029198471575,1253,587,1840,-
chr3,108269917,8.543291222968412,979,1564,2543,-
chr3,108269918,8.54329122296841,979,1564,2543,-
chr3,112260713,1.6674399264601434,1665,1230,2895,-
chr3,112724347,3.228999984387032,1388,929,2317,-
chr3,112724348,3.677972089736796,885,628,1513,-
chr3,112724352,1.9040488217646605,1325,660,1985,-
chr3,112724353,1.9040488217646605,1325,660,1985,-
chr3,113438364,0.6465112075198843,621,460,1081,-
chr3,113438843,1.6656639449935542,683,536,1219,-
chr3,113438926,3.135492859630791,642,521,1163,-
chr3,113439022,2.064443005181347,1124,578,1702,-
chr3,113439023,2.064443005181347,1124,578,1702,-
chr3,113439128,1.968713704994193,732,491,1223,-
chr3,113439329,1.725217391304348,743,482,1225,-
chr3,113439501,3.1635674622863443,836,697,1533,-
chr3,113440209,0.5769102570722077,1312,1041,2353,-
chr3,113440362,0.4882926829268292,636,409,1045,-
chr3,113440662,2.135808,926,624,1550,-
chr3,113440681,2.126126126126126,707,665,1372,-
chr3,113442883,1.9011705437842643,610,396,1006,-
chr3,113442888,1.9989304812834223,622,384,1006,-
chr3,113442904,1.1865122179717484,965,633,1598,-
chr3,116363143,2.4591734112350943,1579,1098,2677,-
chr3,116363144,2.4591734112350943,1579,1098,2677,-
chr3,116363150,0.5885742865981021,1035,692,1727,-
chr3,116363153,2.0963177774241664,746,576,1322,-
chr3,116363154,2.518417680973735,628,445,1073,-
chr3,118949067,7.414240930236025,837,614,1451,-
chr3,119165908,2.1782700421940926,825,473,1298,-
chr3,119165954,2.8984126984126988,663,419,1082,-
chr3,119165974,0.6044165576460963,1025,657,1682,-
chr3,119165976,0.7083333333333333,645,455,1100,-
chr3,119393995,1.5838264299802762,802,506,1308,-
chr3,119393998,1.5975213458066218,2363,1729,4092,-
chr3,119396108,1.8842662227481999,3548,2757,6305,-
chr3,119396110,1.860741875030577,4233,3313,7546,-
chr3,119396227,1.0802700675168793,599,429,1028,-
chr3,119396228,1.0802700675168793,599,429,1028,-
chr3,119396234,2.0351290915688596,754,486,1240,-
chr3,120044960,1.7902840108522844,945,457,1402,-
chr3,120044962,2.282450638991051,782,389,1171,-
chr3,120048525,1.5956378261541981,627,411,1038,-
chr3,120113788,0.44008339376359673,970,590,1560,-
chr3,120113789,0.44008339376359673,970,590,1560,-
chr3,120113867,2.0111641727733076,767,656,1423,-
chr3,120113887,2.456077372681678,833,593,1426,-
chr3,120114110,0.2970835705700005,586,478,1064,-
chr3,120114724,2.4513680784242045,808,625,1433,-
chr3,120115225,2.182255359738842,804,633,1437,-
chr3,120115312,1.6385604875416606,1052,746,1798,-
chr3,120115503,2.0177789709472553,758,620,1378,-
chr3,120115805,1.222961767886459,1006,631,1637,-
chr3,121414995,2.282210673539732,986,703,1689,-
chr3,121414997,2.1570241265230377,651,458,1109,-
chr3,121416365,1.7000565930956424,750,588,1338,-
chr3,121416373,2.2201634877384198,678,366,1044,-
chr3,121416377,1.8233628318584072,605,451,1056,-
chr3,121416391,2.4775413711583925,785,563,1348,-
chr3,121416393,2.4775413711583925,785,563,1348,-
chr3,121491473,2.980764587525151,787,496,1283,-
chr3,121491474,3.277912281015566,1319,804,2123,-
chr3,121491476,3.2834370750285298,1303,723,2026,-
chr3,122459649,2.8962868117797687,869,709,1578,-
chr3,122459662,1.9135413328802915,1846,1207,3053,-
chr3,122459663,2.3459302325581395,2151,1375,3526,-
chr3,122459665,2.0088268792710706,1410,877,2287,-
chr3,122459684,1.9846330932949363,1265,664,1929,-
chr3,122459694,1.840583386176284,630,414,1044,-
chr3,123212588,2.8410846213626972,694,481,1175,-
chr3,123213739,4.370433789954338,588,437,1025,-
chr3,123213740,4.370433789954338,588,437,1025,-
chr3,123634563,2.6430019261506468,803,514,1317,-
chr3,123667926,2.1580590395437897,1160,1023,2183,-
chr3,123667927,2.553929823592745,1622,978,2600,-
chr3,123667928,2.553929823592745,1622,978,2600,-
chr3,123667931,2.262532392100795,632,588,1220,-
chr3,123667934,2.6604123711340204,560,484,1044,-
chr3,124527919,3.627336448598131,620,427,1047,-
chr3,124527943,1.8561595062900544,679,382,1061,-
chr3,124538634,0.9863547758284599,527,512,1039,-
chr3,124538635,1.517101963910007,737,700,1437,-
chr3,125188305,1.0505979412655162,1206,733,1939,-
chr3,125188306,1.0505979412655162,1206,733,1939,-
chr3,125188314,2.407227973843897,738,511,1249,-
chr3,125188341,2.3163160195235664,628,432,1060,-
chr3,127799907,1.7360992301112064,737,500,1237,-
chr3,127799911,1.770497672753312,644,440,1084,-
chr3,127799958,2.205674491313997,581,575,1156,-
chr3,127800210,0.4716879187378431,872,660,1532,-
chr3,127800212,0.4716879187378431,872,660,1532,-
chr3,127806588,1.7151540386187567,1822,1436,3258,-
chr3,127806590,1.7425314912217251,1532,1362,2894,-
chr3,127806591,1.8892731552263402,1676,1267,2943,-
chr3,127819557,2.068682259803123,940,685,1625,-
chr3,127831822,1.6389781909236554,4982,3663,8645,-
chr3,127831823,1.6489593925835535,3286,2681,5967,-
chr3,127831826,1.5284930591067825,5431,3620,9051,-
chr3,127831827,1.9175669734431717,4313,2939,7252,-
chr3,127831837,2.1127819548872178,1123,721,1844,-
chr3,127831848,2.302591922845087,954,552,1506,-
chr3,127831858,0.4370708955223881,1232,799,2031,-
chr3,127838179,1.9372202861236512,2527,1547,4074,-
chr3,127838181,1.9267822736030829,1499,864,2363,-
chr3,127838219,1.704908432708688,914,586,1500,-
chr3,127838238,0.4822355289421157,754,500,1254,-
chr3,127838239,0.4822355289421157,754,500,1254,-
chr3,127838242,2.4074776719701894,752,520,1272,-
chr3,127842470,2.58640021406106,712,560,1272,-
chr3,127842603,2.034710723912206,9090,4703,13793,-
chr3,127842604,2.034710723912206,9090,4703,13793,-
chr3,127842605,1.5867550919488587,13587,7021,20608,-
chr3,127842611,2.0241913961276548,2733,1248,3981,-
chr3,127842654,0.9752923160282447,4116,2073,6189,-
chr3,127842661,2.336158300810549,1259,732,1991,-
chr3,127842662,0.924761278765728,1236,811,2047,-
chr3,127842664,0.9602931149016364,1664,854,2518,-
chr3,128339048,0.6116803278688525,994,609,1603,-
chr3,128339142,0.5240627336073936,3090,2907,5997,-
chr3,128339144,0.4302821246284143,1602,1697,3299,-
chr3,128339176,18.347122887679564,2863,2531,5394,-
chr3,128339179,7.092367554403544,2822,1672,4494,-
chr3,128339344,1.7465034965034971,665,571,1236,-
chr3,128339387,1.5258565723682005,1108,692,1800,-
chr3,128341061,1.655345471521942,1090,755,1845,-
chr3,128341082,2.0264646464646465,1432,1099,2531,-
chr3,128341101,1.7539797395079595,1009,690,1699,-
chr3,128341199,1.6823104693140796,1397,830,2227,-
chr3,128341240,1.6764018691588782,860,641,1501,-
chr3,128344404,0.692436974789916,823,611,1434,-
chr3,128344419,1.5709507341686033,814,568,1382,-
chr3,128344743,1.8293333333333333,1028,824,1852,-
chr3,128344788,1.6335917680252268,1059,826,1885,-
chr3,128345668,1.5424895951570186,1091,880,1971,-
chr3,128348799,1.4516477969279586,1097,848,1945,-
chr3,128348843,1.5920266947664206,1109,875,1984,-
chr3,128348850,1.739344262295082,1060,914,1974,-
chr3,128348956,2.4055680963130173,1111,885,1996,-
chr3,128350840,0.6386159415605405,1128,997,2125,-
chr3,128350933,2.134922394678492,916,819,1735,-
chr3,128356678,1.7661028192371475,831,602,1433,-
chr3,128363806,1.827067669172932,728,550,1278,-
chr3,128369437,1.1833249305875746,3550,2408,5958,-
chr3,128369442,0.8199609733700642,3821,2078,5899,-
chr3,128369444,0.6943935462449428,6273,4193,10466,-
chr3,128369445,0.9345919102543103,20981,13697,34678,-
chr3,128369447,0.9950908617226178,20409,12965,33374,-
chr3,128369448,1.2243472250822773,8884,5580,14464,-
chr3,128369453,1.4909218581808397,3252,1857,5109,-
chr3,128369455,1.577563649816702,4761,2702,7463,-
chr3,128369456,1.3782503265679695,3881,2378,6259,-
chr3,128369459,2.2154821801937046,2763,1635,4398,-
chr3,128369462,1.6798236116306082,1218,642,1860,-
chr3,128369473,2.212444444444444,1178,674,1852,-
chr3,128369482,1.8235725874990345,1048,601,1649,-
chr3,128369517,1.7556593604024435,697,505,1202,-
chr3,128369528,2.218950285813269,853,501,1354,-
chr3,128369546,1.5753086419753086,637,494,1131,-
chr3,128369551,2.194078947368421,782,431,1213,-
chr3,128849429,2.1598200114013055,918,553,1471,-
chr3,128888592,1.3243588987152843,20683,10779,31462,-
chr3,128888602,1.2360562018858408,16345,9104,25449,-
chr3,128888656,1.1882494988491992,21766,12464,34230,-
chr3,128888666,0.621851862743176,6736,3527,10263,-
chr3,128888685,0.7824462581127496,9548,5428,14976,-
chr3,128889180,1.5745790532669703,3049,1987,5036,-
chr3,128889189,1.4256014543204143,2563,2223,4786,-
chr3,128889201,0.759877797430238,3647,2695,6342,-
chr3,128889211,1.680750641680108,4083,3392,7475,-
chr3,128889265,1.7871900826446283,1729,1451,3180,-
chr3,128889292,2.083989501312336,1587,1269,2856,-
chr3,128889951,1.9512338049778384,2104,1675,3779,-
chr3,128890316,1.4530507855316044,1939,1563,3502,-
chr3,128890492,1.5149443929564412,1452,995,2447,-
chr3,128890515,1.3847749465986887,3438,2680,6118,-
chr3,128890518,1.4690713431646072,1270,964,2234,-
chr3,128890563,1.3657617712476546,1375,992,2367,-
chr3,128890609,0.6960694659293889,1252,966,2218,-
chr3,128902622,2.396638655462185,991,679,1670,-
chr3,128902698,0.6051267684549657,959,725,1684,-
chr3,128902700,1.5810165534804754,1891,1215,3106,-
chr3,128902702,1.5810165534804754,1891,1215,3106,-
chr3,128902703,0.4862973760932945,555,489,1044,-
chr3,129033701,1.18605059963193,902,627,1529,-
chr3,129033730,2.91375,776,449,1225,-
chr3,129033732,2.91375,776,449,1225,-
chr3,129033740,1.8218255213787666,689,427,1116,-
chr3,129033930,0.3113618876635035,606,556,1162,-
chr3,129033931,0.3113618876635035,606,556,1162,-
chr3,129033955,2.648325358851675,614,417,1031,-
chr3,129034228,1.3547223687295809,684,448,1132,-
chr3,129034452,2.7813905223106192,730,412,1142,-
chr3,129034522,1.7171621601931701,895,640,1535,-
chr3,129034539,1.8917862805379941,1300,854,2154,-
chr3,129034540,2.020587265284461,775,538,1313,-
chr3,129034689,1.216246189082942,1323,977,2300,-
chr3,129034690,1.4277973229236323,1264,1041,2305,-
chr3,129034715,0.9758112094395279,826,564,1390,-
chr3,129034716,0.9758112094395279,826,564,1390,-
chr3,129035052,3.3927710843373493,959,497,1456,-
chr3,129035053,3.3927710843373493,959,497,1456,-
chr3,129152741,1.7057029141622064,801,649,1450,-
chr3,129155864,3.580315678042552,999,636,1635,-
chr3,129155865,3.888489888489888,761,480,1241,-
chr3,129276040,2.1596243529090917,605,533,1138,-
chr3,130409373,2.495432955791012,682,475,1157,-
chr3,130409377,1.8034026465028357,635,413,1048,-
chr3,130409411,2.428369762799678,1053,511,1564,-
chr3,130409419,3.355196977502356,655,435,1090,-
chr3,131181349,1.5544239722541493,2036,1402,3438,-
chr3,131181428,1.082646483053005,5817,4273,10090,-
chr3,131181445,1.3875855008606488,5980,4134,10114,-
chr3,131181463,1.4776574248898606,1438,1040,2478,-
chr3,131181474,1.209806881579424,3104,2400,5504,-
chr3,131181567,2.435838355193194,1017,727,1744,-
chr3,131186976,1.928388746803069,779,509,1288,-
chr3,131186983,2.160768300060496,1098,683,1781,-
chr3,131188554,1.419456029658147,1447,1038,2485,-
chr3,131188589,0.3724137931034483,827,666,1493,-
chr3,131188590,1.4640448339904206,916,652,1568,-
chr3,131188593,0.5743740795287187,974,678,1652,-
chr3,131190050,3.0831571529245947,624,515,1139,-
chr3,131190097,0.562114887696283,807,467,1274,-
chr3,131217081,2.411111111111111,805,584,1389,-
chr3,131220446,0.6032739528165623,1252,898,2150,-
chr3,131220447,1.6083418107833165,1332,982,2314,-
chr3,131220481,1.872378900516441,1404,1293,2697,-
chr3,131220541,2.323529411764706,552,531,1083,-
chr3,131220547,1.5187558612066272,710,456,1166,-
chr3,131220554,2.003833333333333,1092,749,1841,-
chr3,131220556,2.003833333333333,1092,749,1841,-
chr3,131221606,2.2967115624655894,753,516,1269,-
chr3,131221668,1.7375208855803796,796,554,1350,-
chr3,131221670,1.499464214929193,917,591,1508,-
chr3,133358900,1.0364244553648163,1465,1089,2554,-
chr3,133358902,0.892448200768894,1342,998,2340,-
chr3,133941346,1.3934426229508197,594,426,1020,-
chr3,134196775,1.7669683257918551,638,441,1079,-
chr3,134196969,3.046445956269676,796,520,1316,-
chr3,134197395,1.7,611,419,1030,-
chr3,137821123,2.1009186891539837,977,662,1639,-
chr3,137821125,2.1009186891539837,977,662,1639,-
chr3,138218987,5.00485908649174,617,440,1057,-
chr3,138219008,2.4510299949496717,1613,978,2591,-
chr3,138219040,3.066314917473899,879,428,1307,-
chr3,139076549,1.4569604612850084,848,606,1454,-
chr3,139076650,1.8278301886792445,749,529,1278,-
chr3,139077639,1.7957279978369611,717,568,1285,-
chr3,139077918,1.5737182677949226,1247,734,1981,-
chr3,139079935,1.7783291976840363,1074,805,1879,-
chr3,139079969,0.5281553398058252,863,617,1480,-
chr3,139080094,1.805699144675486,1735,1317,3052,-
chr3,139081296,3.4184308841843083,609,437,1046,-
chr3,139085448,1.7158641607539402,1919,1496,3415,-
chr3,139085449,1.7158641607539402,1919,1496,3415,-
chr3,139085554,1.6686241610738255,662,595,1257,-
chr3,139085582,1.743754540881909,760,616,1376,-
chr3,139086998,1.8444846292947563,689,552,1241,-
chr3,139087055,1.895652173913044,980,689,1669,-
chr3,139088202,1.4522921891171583,2715,1821,4536,-
chr3,139088301,1.6603989535644212,676,555,1231,-
chr3,139088313,1.8102992643382616,1101,717,1818,-
chr3,139090598,0.5276580493972592,1928,1588,3516,-
chr3,139090636,0.6545129133628853,924,842,1766,-
chr3,139090648,4.875479388479371,5442,4658,10100,-
chr3,139090649,4.875479388479371,5442,4658,10100,-
chr3,139092131,1.83801652892562,694,549,1243,-
chr3,139092207,0.5598928434749331,835,602,1437,-
chr3,139094342,0.2990543735224586,781,611,1392,-
chr3,139094353,1.7795566502463056,764,608,1372,-
chr3,139094396,1.7560676824132913,975,705,1680,-
chr3,139108447,1.5971641746785301,763,663,1426,-
chr3,141811965,5.969227457728358,885,390,1275,-
chr3,142537159,1.54852611932617,762,609,1371,-
chr3,145787383,1.7099932223812033,1565,1083,2648,-
chr3,145787505,2.9569771791994013,607,485,1092,-
chr3,145787822,2.0039783615942555,1501,1056,2557,-
chr3,145787943,0.988437235576691,3299,2693,5992,-
chr3,145788050,1.5607199817726132,1095,835,1930,-
chr3,145788085,6.06330242510699,918,700,1618,-
chr3,145788406,1.460655737704918,1538,949,2487,-
chr3,145788452,1.5557336854017352,1221,963,2184,-
chr3,145788545,1.502364066193853,1270,845,2115,-
chr3,145788578,0.3446958270487683,856,662,1518,-
chr3,145788609,1.4877813704763092,1226,730,1956,-
chr3,145790370,2.223958333333333,792,623,1415,-
chr3,145790387,1.711182108626198,823,625,1448,-
chr3,145790414,2.2838905775075986,1325,845,2170,-
chr3,145799558,0.6954510745063817,1225,889,2114,-
chr3,145804602,1.2574995431868983,2309,1570,3879,-
chr3,145804627,1.8609733594741087,1640,1130,2770,-
chr3,145841935,3.1339031339031336,699,566,1265,-
chr3,146234827,4.363436653549604,818,645,1463,-
chr3,148748474,1.714236090990022,5917,3767,9684,-
chr3,148748475,1.6283697730667734,4265,2913,7178,-
chr3,148748476,1.6283697730667734,4265,2913,7178,-
chr3,148748483,2.2185286891169245,1227,747,1974,-
chr3,148748512,1.8151516433315007,893,502,1395,-
chr3,148748522,1.701932290003194,734,403,1137,-
chr3,148748564,0.18876663965791615,1028,568,1596,-
chr3,148748749,1.8668985098587665,12338,9072,21410,-
chr3,148748750,1.7702231611411545,16220,11753,27973,-
chr3,148748751,1.7702231611411545,16220,11753,27973,-
chr3,148748752,1.7663904063957363,11978,8549,20527,-
chr3,148748784,1.6562006183442115,2126,1229,3355,-
chr3,148748825,0.6132365319865319,1266,719,1985,-
chr3,148748853,1.4137029015881435,2235,1161,3396,-
chr3,148748876,1.6891521197007482,873,400,1273,-
chr3,148749099,1.8820908136835728,722,544,1266,-
chr3,148749992,1.5550116603315725,9645,6407,16052,-
chr3,148749993,1.5550116603315725,9645,6407,16052,-
chr3,148750007,1.4090531561461792,2261,1343,3604,-
chr3,148750022,1.5782749909779865,1772,977,2749,-
chr3,148750068,2.2982180293501044,876,476,1352,-
chr3,148750110,1.13219326748684,1506,803,2309,-
chr3,148750116,0.47088607594936704,743,394,1137,-
chr3,148764008,3.119562166713444,584,508,1092,-
chr3,148764009,3.119562166713444,584,508,1092,-
chr3,148777518,2.2872787718783614,730,486,1216,-
chr3,148777520,3.017653529242299,1025,703,1728,-
chr3,148789159,2.6805493223115247,860,585,1445,-
chr3,148792107,2.126721931000853,942,630,1572,-
chr3,148793676,1.1375476659614636,1178,770,1948,-
chr3,148793727,2.5785501927613095,863,536,1399,-
chr3,149087403,0.5881555024993798,5822,4773,10595,-
chr3,149087404,0.5881555024993798,5822,4773,10595,-
chr3,149087428,1.5834921845215402,2555,2195,4750,-
chr3,149087436,1.766181157477735,2175,1766,3941,-
chr3,149087650,1.2921778206560377,5592,3439,9031,-
chr3,149087651,1.2346155512670527,4161,3296,7457,-
chr3,149089521,1.2551562648767018,4348,3500,7848,-
chr3,149089583,1.3870333988212182,3176,2544,5720,-
chr3,149093490,1.2953589483026977,6944,4303,11247,-
chr3,149093491,1.3582302450069244,9341,6314,15655,-
chr3,149093518,1.6454323407820788,2145,1732,3877,-
chr3,149095232,1.2802770249924722,3036,2213,5249,-
chr3,149095353,0.6991615392605536,8209,5365,13574,-
chr3,149095354,0.6991615392605536,8209,5365,13574,-
chr3,149095393,0.7830358498340888,2406,1881,4287,-
chr3,149095413,1.3425309015860196,2601,1904,4505,-
chr3,149095423,1.4414692858628786,2020,1462,3482,-
chr3,149095431,1.0019582874892234,7521,6452,13973,-
chr3,149095432,1.059561303629172,9097,7655,16752,-
chr3,149095435,0.9948469981278163,4537,3316,7853,-
chr3,149095436,0.9948469981278163,4537,3316,7853,-
chr3,149683161,1.9405779405779409,1191,818,2009,-
chr3,149683290,0.4995791954216462,741,456,1197,-
chr3,149683423,0.9551718123146696,1368,909,2277,-
chr3,149683425,0.9551718123146696,1368,909,2277,-
chr3,149683434,1.249909569875373,752,531,1283,-
chr3,149683701,18.95156890944805,1809,1516,3325,-
chr3,149683702,5.646128500823723,713,606,1319,-
chr3,149683732,2.3701553668763333,1149,784,1933,-
chr3,149683935,1.6001932600555624,735,486,1221,-
chr3,149684029,1.0365174334639982,784,654,1438,-
chr3,149684030,1.0365174334639982,784,654,1438,-
chr3,149684166,11.476964346573158,1066,805,1871,-
chr3,149686313,2.532724505327245,639,437,1076,-
chr3,149688517,2.919754111978734,605,462,1067,-
chr3,149688519,2.919754111978734,605,462,1067,-
chr3,150260055,1.8092949244790002,1144,673,1817,-
chr3,150260064,2.3016661149729667,595,476,1071,-
chr3,150260065,1.6001588941938172,1030,741,1771,-
chr3,150260507,0.3981048486340142,646,477,1123,-
chr3,150260593,2.0888931188731323,707,552,1259,-
chr3,150260612,0.6027588964414234,669,487,1156,-
chr3,150260972,1.0297619047619049,691,623,1314,-
chr3,150260974,1.0297619047619049,691,623,1314,-
chr3,150261062,13.295621340025855,887,574,1461,-
chr3,150261069,7.374993804974326,1506,1036,2542,-
chr3,150261737,2.06498812163778,894,644,1538,-
chr3,150261939,1.4570777771942458,656,485,1141,-
chr3,150263550,1.483857264231096,997,748,1745,-
chr3,150263562,2.1539961013645224,779,647,1426,-
chr3,150263875,0.5597507524951153,847,652,1499,-
chr3,150263887,2.200949367088608,641,473,1114,-
chr3,150263905,3.5011709601873533,597,426,1023,-
chr3,150264046,3.6542768537602304,629,462,1091,-
chr3,150264282,1.0806796510025676,690,372,1062,-
chr3,150459345,0.9587669013634709,1425,1031,2456,-
chr3,150459346,1.1720364741641338,963,704,1667,-
chr3,150459365,2.5433721875847115,694,433,1127,-
chr3,150459366,2.4146117543089294,1006,659,1665,-
chr3,150459821,2.769469797954826,593,476,1069,-
chr3,156258589,2.7146085199879204,622,454,1076,-
chr3,156259218,1.3991867091581935,653,494,1147,-
chr3,156259647,0.5117075043183418,940,637,1577,-
chr3,156259659,2.381147116678745,806,742,1548,-
chr3,156259661,2.381147116678745,806,742,1548,-
chr3,156259971,3.054298642533937,647,407,1054,-
chr3,156260011,1.666460914421763,878,612,1490,-
chr3,156260192,0.9285714285714284,987,607,1594,-
chr3,156260193,0.9285714285714284,987,607,1594,-
chr3,156260208,1.5092936802973975,811,537,1348,-
chr3,156260414,1.0252779154570557,723,486,1209,-
chr3,156260415,1.0252779154570557,723,486,1209,-
chr3,156260600,2.341884816753927,638,381,1019,-
chr3,156260650,1.651076097221532,976,648,1624,-
chr3,156260688,2.759651307596513,830,437,1267,-
chr3,156260738,1.8763213530655392,851,472,1323,-
chr3,156260891,1.9849306811332128,800,710,1510,-
chr3,156260909,5.987962291667895,7738,6143,13881,-
chr3,156260910,5.987962291667895,7738,6143,13881,-
chr3,156260933,1.7608931849687162,1174,650,1824,-
chr3,156260936,0.4276646858009862,1056,718,1774,-
chr3,156266724,1.7011150307770337,2589,1965,4554,-
chr3,156271538,1.4121859819569742,833,654,1487,-
chr3,156271555,0.4487829614604463,648,637,1285,-
chr3,156272806,1.7528847109376784,870,792,1662,-
chr3,156272821,1.7027620267056889,641,496,1137,-
chr3,156272822,1.9356443389349949,1939,1403,3342,-
chr3,156272824,1.2363340320414118,1743,1141,2884,-
chr3,156877195,0.9424683581759281,963,549,1512,-
chr3,156877233,3.175262820385606,662,450,1112,-
chr3,158384516,0.6535382387255099,1082,741,1823,-
chr3,158384531,3.150213675213675,640,389,1029,-
chr3,158386897,2.31984375,706,399,1105,-
chr3,158387344,1.47387149027177,7382,5432,12814,-
chr3,158387345,1.405732309180069,13658,9667,23325,-
chr3,158387347,1.3318676416913098,22208,15542,37750,-
chr3,158387348,1.3128594023286029,21100,14483,35583,-
chr3,158387349,1.3329340805530303,21108,14518,35626,-
chr3,158387351,1.4626624314669223,5328,3491,8819,-
chr3,158387374,0.6020883624319318,1649,1136,2785,-
chr3,158387385,2.53968253968254,1009,605,1614,-
chr3,158387396,2.3299737790888235,1209,677,1886,-
chr3,158387397,1.6482909765246343,1056,718,1774,-
chr3,158388749,0.6741165810933253,836,472,1308,-
chr3,158388759,0.475388431910171,661,413,1074,-
chr3,158388805,1.90232577251808,984,675,1659,-
chr3,158388806,1.90232577251808,984,675,1659,-
chr3,158390154,2.3233914611277497,1187,821,2008,-
chr3,158390155,1.9683383991894627,817,563,1380,-
chr3,158390211,2.4267724794878096,747,537,1284,-
chr3,161146915,1.0462560983497,2677,2074,4751,-
chr3,161146916,1.1531921074061067,3250,2446,5696,-
chr3,161146918,2.1790341578327443,554,565,1119,-
chr3,161146924,2.197102721685689,714,535,1249,-
chr3,161146974,1.9681533313017991,661,538,1199,-
chr3,167401919,3.0544267053701017,731,423,1154,-
chr3,167401985,0.8889010593658772,1378,1039,2417,-
chr3,167402170,0.5906146206715117,897,646,1543,-
chr3,167413435,4.002603149811272,960,590,1550,-
chr3,167437907,1.8321616871704745,694,568,1262,-
chr3,167452618,2.781089213397577,2080,1779,3859,-
chr3,167452619,3.1495170040496228,1286,1234,2520,-
chr3,169482813,0.8152943463653531,27361,1845,29206,-
chr3,169482816,0.6284963069633482,14547,1132,15679,-
chr3,169482819,0.5642736399965879,22183,1876,24059,-
chr3,169482820,0.5642736399965879,22183,1876,24059,-
chr3,169482824,0.3147893772893773,2874,804,3678,-
chr3,169482825,0.3147893772893773,2874,804,3678,-
chr3,169482830,0.3101135668896011,1761,700,2461,-
chr3,169482831,0.2958269763236707,2434,1019,3453,-
chr3,169482833,0.4872507552870091,1439,661,2100,-
chr3,170584267,1.5285982807012524,2360,1501,3861,-
chr3,170585880,1.7943749999999996,782,575,1357,-
chr3,170585966,1.6611092052601488,1296,824,2120,-
chr3,170586139,1.0150679027025562,1189,893,2082,-
chr3,170586177,1.4369952078476222,577,551,1128,-
chr3,171320053,2.608021366748855,834,560,1394,-
chr3,171320168,4.4198219438384125,683,410,1093,-
chr3,171362736,4.226218774019045,605,476,1081,-
chr3,171362737,2.2757633987966037,577,461,1038,-
chr3,171443835,1.225906197034707,5907,4347,10254,-
chr3,171443854,1.5662945752096171,2296,1562,3858,-
chr3,171451280,2.246545097862485,2137,1409,3546,-
chr3,171451287,1.5762452107279692,967,579,1546,-
chr3,171451294,2.642857142857143,887,527,1414,-
chr3,171452707,0.3754680166640299,711,440,1151,-
chr3,171452708,0.3754680166640299,711,440,1151,-
chr3,171452749,2.4027772782342414,585,418,1003,-
chr3,172349989,1.9906348684271467,901,701,1602,-
chr3,172349994,0.3654320987654321,628,458,1086,-
chr3,176738626,2.1894609440461785,602,466,1068,-
chr3,176738651,3.2091324200913243,752,437,1189,-
chr3,176738652,2.914401945917543,1224,717,1941,-
chr3,176742470,1.700373134328358,650,535,1185,-
chr3,176742473,1.3729977116704806,599,482,1081,-
chr3,176742482,1.054608079186731,670,533,1203,-
chr3,176742484,1.054608079186731,670,533,1203,-
chr3,179118263,0.9114014040700258,640,362,1002,-
chr3,179118264,0.9114014040700258,640,362,1002,-
chr3,179123157,1.9893536471291378,860,579,1439,-
chr3,179123158,1.1333333333333333,679,449,1128,-
chr3,179137283,1.9824479358785574,756,513,1269,-
chr3,179311606,1.787152297525742,801,481,1282,-
chr3,179316468,1.7960616104503804,657,445,1102,-
chr3,179320449,0.3980267794221282,705,472,1177,-
chr3,179322344,2.482313726035008,1508,778,2286,-
chr3,179322376,5.502430487383237,1255,538,1793,-
chr3,179322413,5.67155524451379,2068,567,2635,-
chr3,179322414,6.674623115577889,1448,397,1845,-
chr3,179322417,3.7339425937477433,1994,499,2493,-
chr3,179322418,5.285001037824119,1713,427,2140,-
chr3,179322425,0.8696965754629365,2046,552,2598,-
chr3,180705973,2.2776536764889737,784,592,1376,-
chr3,183960664,2.3179923374462295,998,654,1652,-
chr3,183963277,1.8723378526194576,807,679,1486,-
chr3,183963325,1.9655599616679542,1016,712,1728,-
chr3,183963534,1.218748100442934,848,678,1526,-
chr3,183963573,1.0481962481962483,907,494,1401,-
chr3,183963575,1.799233049080455,1200,766,1966,-
chr3,184429123,17.098068372710795,604,695,1299,-
chr3,184429126,5.683245200353008,1002,849,1851,-
chr3,184429127,6.039456452081393,1307,1088,2395,-
chr3,184429129,6.275651660782003,864,685,1549,-
chr3,185135245,0.6285714285714287,683,419,1102,-
chr3,185135277,1.5250685468076772,598,413,1011,-
chr3,185363271,2.232684720229555,1032,668,1700,-
chr3,185363287,2.338049006010171,1075,617,1692,-
chr3,185363288,2.338049006010171,1075,617,1692,-
chr3,185363296,0.2936430099857346,940,700,1640,-
chr3,185363297,0.2936430099857346,940,700,1640,-
chr3,185363298,0.2936430099857346,940,700,1640,-
chr3,185634714,1.7075675675675677,701,443,1144,-
chr3,185634937,0.6418164488017429,856,575,1431,-
chr3,185635251,2.6056419113413933,875,578,1453,-
chr3,185636167,0.6771115846571097,901,711,1612,-
chr3,185636213,0.2833825518977029,973,1296,2269,-
chr3,185637233,0.4504845707513591,1206,1376,2582,-
chr3,185637255,7.36401017664965,1943,2772,4715,-
chr3,185637259,21.848443802695755,4747,3071,7818,-
chr3,185637260,15.940139294571022,6508,3710,10218,-
chr3,185637261,16.518324886628488,5169,2520,7689,-
chr3,185637262,8.543934900869932,5054,1842,6896,-
chr3,185637263,9.33330735660848,1408,400,1808,-
chr3,185637265,7.031875601507957,994,209,1203,-
chr3,185637268,5.761420661479122,1194,265,1459,-
chr3,185637271,3.9306168579731486,1358,327,1685,-
chr3,185638951,2.352988175135826,949,595,1544,-
chr3,185639848,2.684975369458128,990,811,1801,-
chr3,185641703,1.566974441322093,1170,845,2015,-
chr3,185641754,0.3283884873843032,1109,716,1825,-
chr3,185641769,0.6355932203389831,1159,927,2086,-
chr3,185643320,1.1515447341807266,1388,1082,2470,-
chr3,185643382,1.6235527882158045,1371,1208,2579,-
chr3,185643383,0.924144456710298,1171,745,1916,-
chr3,185643384,0.924144456710298,1171,745,1916,-
chr3,185644395,1.45177964850096,982,776,1758,-
chr3,185644413,1.74573055028463,999,774,1773,-
chr3,185644419,1.7749895796490396,2238,1712,3950,-
chr3,185644436,1.7979399517861057,585,506,1091,-
chr3,185644476,1.860633484162896,770,509,1279,-
chr3,185655684,1.4514827711699276,667,502,1169,-
chr3,185655712,2.3664750439743454,714,467,1181,-
chr3,185655716,1.9612302152906191,1374,817,2191,-
chr3,185655717,2.754,917,499,1416,-
chr3,185775267,2.8001800180018,509,504,1013,-
chr3,185775268,2.8001800180018,509,504,1013,-
chr3,185775269,2.8001800180018,509,504,1013,-
chr3,185823110,3.0074634194245315,624,598,1222,-
chr3,185823111,3.0074634194245315,624,598,1222,-
chr3,185823112,3.0074634194245315,624,598,1222,-
chr3,186507815,1.130863387258854,1097,801,1898,-
chr3,186507941,2.0536546398615365,1233,811,2044,-
chr3,186507942,2.0536546398615365,1233,811,2044,-
chr3,186507950,0.5619114877589454,681,471,1152,-
chr3,186510376,1.995850622406639,665,481,1146,-
chr3,186510377,1.8452380952380956,743,575,1318,-
chr3,186510660,0.4228873358317296,1832,1096,2928,-
chr3,186510661,0.2986045239528452,4241,2500,6741,-
chr3,186512494,1.8408736462093864,4046,3323,7369,-
chr3,186512495,1.8408736462093864,4046,3323,7369,-
chr3,186512505,2.4252826027019574,1686,1301,2987,-
chr3,186512520,2.0490096948789627,1299,988,2287,-
chr3,186512522,0.5918458566799163,1482,1098,2580,-
chr3,186512560,1.980392156862745,605,413,1018,-
chr3,186522374,2.477023250255799,905,686,1591,-
chr3,186524119,4.183662280701754,586,455,1041,-
chr3,186524120,3.9260304343873775,1183,917,2100,-
chr3,186857103,0.7110503253067995,1283,896,2179,-
chr3,186857105,0.7560962373371924,852,690,1542,-
chr3,187440041,0.1619402985074627,433,669,1102,-
chr3,189691731,1.2038907393579743,2981,1730,4711,-
chr3,189691732,1.226376759130417,3685,2086,5771,-
chr3,189691734,0.8411116512720791,1482,725,2207,-
chr3,189691735,0.6236333758132672,1616,876,2492,-
chr3,189691736,0.6236333758132672,1616,876,2492,-
chr3,189691745,0.5685285905898724,1302,843,2145,-
chr3,189691747,0.5256730877548721,1227,806,2033,-
chr3,189691749,0.4361766485178463,720,492,1212,-
chr3,194123720,5.901916998292607,2026,1515,3541,-
chr3,194123721,5.901916998292607,2026,1515,3541,-
chr3,194123722,4.764280549530008,598,460,1058,-
chr3,194124489,1.0405003403041269,939,605,1544,-
chr3,194151747,1.7127522832337354,1615,904,2519,-
chr3,194151834,1.491169977924945,771,603,1374,-
chr3,194151841,3.1141052631578945,687,499,1186,-
chr3,194151857,2.202704230655993,1862,1075,2937,-
chr3,194151859,1.0427510016726962,1030,626,1656,-
chr3,194159614,3.289131391131391,699,421,1120,-
chr3,194362044,7.477237596973389,592,428,1020,-
chr3,195243341,2.071207430340557,668,475,1143,-
chr3,195245827,3.3385213840408188,636,366,1002,-
chr3,195245979,1.9736050986050984,1312,692,2004,-
chr3,195245980,1.9736050986050984,1312,692,2004,-
chr3,195251625,1.2914509031933277,889,631,1520,-
chr3,195776364,5.224353741496598,2020,1749,3769,-
chr3,195776527,1.687958275549603,5311,3671,8982,-
chr3,195776542,0.681788695238507,2101,1216,3317,-
chr3,195776868,1.529446946242612,1010,835,1845,-
chr3,195776885,0.6923076923076924,1205,909,2114,-
chr3,195776936,3.9985761887808766,4922,3786,8708,-
chr3,195777788,0.6352135054617676,1522,1059,2581,-
chr3,195777804,1.4691810010847668,1378,955,2333,-
chr3,195777818,1.2546511359463144,1920,1420,3340,-
chr3,195777875,1.7408448673587085,778,577,1355,-
chr3,195778216,1.3954076715497303,1754,1296,3050,-
chr3,195778218,2.1333333333333333,1031,773,1804,-
chr3,195778566,1.5300230946882218,1059,865,1924,-
chr3,195778948,0.640959040959041,1202,909,2111,-
chr3,195780427,1.503452230560554,5509,3722,9231,-
chr3,195781974,0.5733106891050384,2227,1396,3623,-
chr3,195785233,1.3849723538704581,1858,1265,3123,-
chr3,195789468,0.5943715426341324,1580,1345,2925,-
chr3,195789792,1.6329760081674323,1370,1305,2675,-
chr3,195789804,1.922971404452886,1339,1214,2553,-
chr3,195791219,1.5774436090225563,1048,797,1845,-
chr3,195794400,3.011001737116387,1199,941,2140,-
chr3,195794402,1.427277179236043,1406,1020,2426,-
chr3,195794438,0.6093273466621484,1232,907,2139,-
chr3,195794493,2.597219991437288,2330,1811,4141,-
chr3,195796346,2.6830419977298523,1205,880,2085,-
chr3,195798979,0.6555444555444555,1157,909,2066,-
chr3,195799004,1.5123888182973315,1057,786,1843,-
chr3,195799009,1.8306788247213779,981,704,1685,-
chr3,195800868,0.5831944444444445,883,599,1482,-
chr3,195802074,1.863633600778021,1156,913,2069,-
chr3,195802209,1.9238730575707146,3018,2366,5384,-
chr3,195802211,2.1530355249204667,1459,1311,2770,-
chr3,195803954,1.47301394784718,1040,678,1718,-
chr3,195803968,2.253191489361702,1058,798,1856,-
chr3,195803969,2.048512158666301,1715,1333,3048,-
chr3,195808918,2.57818240770068,1156,749,1905,-
chr3,195808929,2.850913328617268,1928,1293,3221,-
chr3,195808930,2.7998728984445878,1303,984,2287,-
chr3,195808949,2.385168151767749,921,354,1275,-
chr3,195808951,2.405397416501506,1306,585,1891,-
chr3,196662998,3.565251989389921,659,451,1110,-
chr3,196663388,1.405682248313838,820,581,1401,-
chr3,196663389,0.9432779097387176,583,420,1003,-
chr3,196771313,2.900503271085095,608,540,1148,-
chr3,197009709,2.5169165530819324,1221,1064,2285,-
chr3,197023249,2.194247246022032,1378,816,2194,-
chr3,197023251,2.194247246022032,1378,816,2194,-
chr3,197023252,1.7026718428865035,698,452,1150,-
chr3,197023265,2.4254443516245376,1385,871,2256,-
chr4,336595,1.7024301989868307,761,851,1612,-
chr4,336597,1.8413155802861685,425,591,1016,-
chr4,336599,0.835649000636111,2495,1756,4251,-
chr4,336604,0.7103163428142307,1315,953,2268,-
chr4,667136,0.611727998531706,908,640,1548,-
chr4,667186,2.1915789473684213,693,474,1167,-
chr4,667188,0.4199386343543606,1291,937,2228,-
chr4,667189,0.4199386343543606,1291,937,2228,-
chr4,668007,3.2309545927032546,691,511,1202,-
chr4,668035,0.9144776038563616,803,498,1301,-
chr4,668037,0.9144776038563616,803,498,1301,-
chr4,1205429,1.0413486956955458,802,488,1290,-
chr4,1205430,1.0413486956955458,802,488,1290,-
chr4,1222059,2.4674243177788924,913,749,1662,-
chr4,1222103,3.025317306148272,777,570,1347,-
chr4,1694755,4.539306104523496,607,505,1112,-
chr4,1694757,4.539306104523496,607,505,1112,-
chr4,1701755,1.5327295655164503,1145,670,1815,-
chr4,1701789,2.038249754178958,1090,677,1767,-
chr4,1701792,2.3565279084815915,1376,791,2167,-
chr4,1717771,10.565142021075756,716,529,1245,-
chr4,1717772,10.565142021075756,716,529,1245,-
chr4,1985352,3.468999576303462,892,472,1364,-
chr4,2950129,1.1243242510146743,1616,1280,2896,-
chr4,2950130,1.637205387205387,777,461,1238,-
chr4,2951675,1.2343806825587191,1123,776,1899,-
chr4,2952867,2.743373493975904,965,580,1545,-
chr4,2952868,2.447975411184471,1573,907,2480,-
chr4,3514422,0.576209086468002,673,533,1206,-
chr4,3514577,1.5892329670329672,778,522,1300,-
chr4,3514633,2.0979109592077383,594,454,1048,-
chr4,3514707,4.059718524153671,820,477,1297,-
chr4,3514709,4.059718524153671,820,477,1297,-
chr4,3516629,1.8763730253407789,1079,685,1764,-
chr4,3517858,1.5751787821216765,2476,1905,4381,-
chr4,3517861,1.889722466952997,3550,2702,6252,-
chr4,3517862,1.806032890209005,3706,2905,6611,-
chr4,3517864,1.7606065715410275,3347,2437,5784,-
chr4,3517868,2.0485714285714285,955,649,1604,-
chr4,3517883,1.8833333333333333,790,524,1314,-
chr4,3519772,2.1423033639163287,733,494,1227,-
chr4,3526716,3.0423693086003376,848,592,1440,-
chr4,3526732,0.9119413638816832,1068,808,1876,-
chr4,3526733,0.5129259694477086,678,482,1160,-
chr4,3526734,0.9119413638816832,1068,808,1876,-
chr4,3526739,1.933581105383048,575,438,1013,-
chr4,3533963,2.2641610340066287,922,743,1665,-
chr4,3533966,1.7980955671289038,996,728,1724,-
chr4,4269749,1.3614819086060257,1430,990,2420,-
chr4,4270264,2.8030325211413287,1832,1235,3067,-
chr4,4276218,1.901497070948145,625,418,1043,-
chr4,4276263,1.9039596229666143,1436,1014,2450,-
chr4,4276264,2.4635197817189636,1025,732,1757,-
chr4,4285360,1.7019493532519585,691,498,1189,-
chr4,6709633,1.5916022974846504,573,458,1031,-
chr4,6709934,1.4974244560055259,890,469,1359,-
chr4,6711009,3.190751445086705,959,691,1650,-
chr4,6711021,1.8892193308550187,846,537,1383,-
chr4,6711023,1.996524383621158,706,340,1046,-
chr4,6711031,1.077891282577832,1763,1005,2768,-
chr4,6711039,1.9526572829659385,923,542,1465,-
chr4,6711048,1.940550133096717,809,489,1298,-
chr4,6711051,1.5031880286271957,721,434,1155,-
chr4,7062568,4.65186218255886,1209,854,2063,-
chr4,7062569,6.204605735333532,1385,1025,2410,-
chr4,7761063,1.4524444444444444,816,599,1415,-
chr4,7761064,1.4524444444444444,816,599,1415,-
chr4,7761065,1.11233615116146,1140,802,1942,-
chr4,7762403,3.412732474964235,733,465,1198,-
chr4,7762405,3.412732474964235,733,465,1198,-
chr4,7762476,2.5494515489227294,585,418,1003,-
chr4,7764853,1.955781391147245,1006,539,1545,-
chr4,7764854,1.5653448649955632,1743,1040,2783,-
chr4,7764855,1.0780876494023903,737,501,1238,-
chr4,7840426,3.9033419390571638,697,429,1126,-
chr4,10076504,2.1296992481203003,617,398,1015,-
chr4,10078970,1.729628968324739,10023,5767,15790,-
chr4,10078971,1.7440610709130169,11520,6427,17947,-
chr4,10078973,1.6422194086156459,3679,1760,5439,-
chr4,10078974,2.25356071964018,924,666,1590,-
chr4,10078980,0.5178931657318765,3351,1795,5146,-
chr4,10078981,0.5072326208069035,3776,2062,5838,-
chr4,10078983,1.9933892702771416,783,512,1295,-
chr4,10079007,0.5792109256449165,1040,658,1698,-
chr4,10079013,0.5745199491930664,1366,955,2321,-
chr4,10079014,0.5745199491930664,1366,955,2321,-
chr4,10079023,3.1553934340802505,1043,504,1547,-
chr4,10079025,3.1553934340802505,1043,504,1547,-
chr4,15607007,1.9212753053975224,1511,1116,2627,-
chr4,15607008,1.9212753053975224,1511,1116,2627,-
chr4,15607020,2.3073022312373226,636,405,1041,-
chr4,15607026,2.9592175861966985,1571,885,2456,-
chr4,15607028,2.5666666666666664,1077,629,1706,-
chr4,15646121,2.2282352941176478,946,781,1727,-
chr4,15646125,1.6560236998025015,902,685,1587,-
chr4,15646137,1.623529411764706,1471,1019,2490,-
chr4,15646139,1.623529411764706,1471,1019,2490,-
chr4,15646155,2.4525612168337765,876,542,1418,-
chr4,15646156,2.6580175830472643,1432,978,2410,-
chr4,24529488,0.2405042016806723,953,713,1666,-
chr4,24529500,2.1422950819672133,989,609,1598,-
chr4,24529502,1.6612787356321843,874,671,1545,-
chr4,24529640,0.5803334891693938,783,557,1340,-
chr4,24531312,0.4506675350048844,691,580,1271,-
chr4,24531386,2.0466384009691097,871,507,1378,-
chr4,24534572,1.6446399503914426,1034,678,1712,-
chr4,24534577,2.0337415486669217,910,602,1512,-
chr4,24534590,1.6525735294117647,695,543,1238,-
chr4,24538716,1.7422141852521602,666,473,1139,-
chr4,24538763,1.781618224666143,587,468,1055,-
chr4,24541798,1.7234042553191489,689,469,1158,-
chr4,24541799,0.4601907728246058,590,466,1056,-
chr4,24543639,0.9447944508081965,1290,1163,2453,-
chr4,24543640,0.9447944508081965,1290,1163,2453,-
chr4,24544633,2.329148848116981,937,658,1595,-
chr4,24550643,0.6018018018018018,667,569,1236,-
chr4,24556542,1.7902396765445527,1863,1336,3199,-
chr4,24557963,1.8476505531158451,1349,1184,2533,-
chr4,24578151,2.502858076106484,612,470,1082,-
chr4,24585982,1.0619947519979676,1172,807,1979,-
chr4,24586091,0.243343653250774,523,679,1202,-
chr4,24586092,0.3194336512192071,916,1026,1942,-
chr4,24586103,12.549378375010475,2266,2047,4313,-
chr4,24586104,14.732760142185569,2908,2660,5568,-
chr4,24586105,14.732760142185569,2908,2660,5568,-
chr4,24586106,19.128327071526694,1070,1056,2126,-
chr4,24586126,4.054391125518725,739,313,1052,-
chr4,25769430,2.5917154217706186,589,440,1029,-
chr4,25789939,1.557083885404528,643,647,1290,-
chr4,25806350,1.882195215593287,814,535,1349,-
chr4,25819772,3.8434484016741473,867,564,1431,-
chr4,25834631,1.0652898067954697,860,552,1412,-
chr4,25834632,1.0652898067954697,860,552,1412,-
chr4,25848964,1.5175736357543923,714,539,1253,-
chr4,25849245,2.465275215489814,878,597,1475,-
chr4,25849335,2.1002168646367187,952,615,1567,-
chr4,39322930,0.6023497451408727,1228,1081,2309,-
chr4,39322935,4.917586460632818,814,754,1568,-
chr4,39322939,1.7196675900277008,775,664,1439,-
chr4,39322940,1.638017381057593,966,875,1841,-
chr4,39322954,1.5793736501079914,584,462,1046,-
chr4,39322962,0.3277173913043478,602,574,1176,-
chr4,39344058,1.770094562647754,598,422,1020,-
chr4,39456202,1.3823440076369,12742,8015,20757,-
chr4,39456524,1.2214077951061262,33030,22622,55652,-
chr4,39456529,1.2064832186783403,11574,8495,20069,-
chr4,39456533,0.706600857654672,6760,5435,12195,-
chr4,39456537,1.4738589211618258,5585,4654,10239,-
chr4,39456541,0.8365101593599669,9924,8117,18041,-
chr4,39456542,0.9398355453436568,14022,10846,24868,-
chr4,39456549,1.292408537302246,6989,4433,11422,-
chr4,39456550,0.8547936275108993,3277,2726,6003,-
chr4,39456554,1.223413520156374,8069,4754,12823,-
chr4,39456555,1.223413520156374,8069,4754,12823,-
chr4,39456556,1.223413520156374,8069,4754,12823,-
chr4,39456562,1.2622478386167149,1605,1387,2992,-
chr4,39458028,2.4764735017335315,1099,672,1771,-
chr4,39458031,0.7073128033432564,2160,1598,3758,-
chr4,39458033,1.250020000320005,1249,752,2001,-
chr4,39458034,1.1143941944371023,2510,1799,4309,-
chr4,39458035,0.8462802443337601,1795,1363,3158,-
chr4,39460017,1.3216428077495803,11776,7891,19667,-
chr4,39460019,1.2496079248020957,19829,14049,33878,-
chr4,39460020,1.2202809181226448,5479,3474,8953,-
chr4,39460050,1.4493497832997115,18384,9697,28081,-
chr4,39460051,1.1975267136502423,4997,3777,8774,-
chr4,39460052,1.5656687624044079,15295,6861,22156,-
chr4,39460053,1.461903290989356,9876,4364,14240,-
chr4,39460057,1.4217818406045526,19247,10829,30076,-
chr4,39460058,1.2510286021112436,20693,11322,32015,-
chr4,39460060,1.0864048707020075,13076,7394,20470,-
chr4,39460520,1.4191948252941526,2750,997,3747,-
chr4,39460528,1.7000839077615961,13153,5811,18964,-
chr4,39460529,1.5079240175996695,11318,6185,17503,-
chr4,39460530,1.372422335360682,25424,11670,37094,-
chr4,39460531,1.351405870480093,20423,9526,29949,-
chr4,39460532,0.8302482516034494,7644,2387,10031,-
chr4,39460533,1.0058442517458912,3545,1997,5542,-
chr4,39460534,0.7471715935933361,7657,3269,10926,-
chr4,39460535,0.6885948197337947,2408,1203,3611,-
chr4,39864634,0.4299484793086255,596,546,1142,-
chr4,39911927,2.302961275626424,673,438,1111,-
chr4,39911928,2.302961275626424,673,438,1111,-
chr4,39911950,3.08294930875576,668,402,1070,-
chr4,39911951,3.08294930875576,668,402,1070,-
chr4,39929620,0.40103685165044634,559,446,1005,-
chr4,48906577,2.186932679901417,659,466,1125,-
chr4,57897388,1.9337461825585343,969,841,1810,-
chr4,57897399,1.8963320463320463,892,739,1631,-
chr4,57898596,1.7995993322203676,690,598,1288,-
chr4,57898597,1.719672139045652,1481,1087,2568,-
chr4,57899378,2.1819227145437576,829,574,1403,-
chr4,57906994,2.1343957258658808,798,471,1269,-
chr4,57906996,2.1343957258658808,798,471,1269,-
chr4,57976253,0.30088551296169025,638,640,1278,-
chr4,57976254,0.2793561812545122,505,500,1005,-
chr4,62971378,1.0905685999995653,963,713,1676,-
chr4,69179822,0.5875876882157489,767,551,1318,-
chr4,69189921,3.0025755494505497,602,447,1049,-
chr4,69195739,2.0046562751750705,1158,804,1962,-
chr4,69203496,1.984895191122072,1095,810,1905,-
chr4,69203534,3.461246370337279,595,406,1001,-
chr4,71685832,2.593670381380913,598,449,1047,-
chr4,71690059,2.025478165850361,1459,942,2401,-
chr4,71691068,1.7857637286571295,672,393,1065,-
chr4,71691082,3.1067350971388055,724,542,1266,-
chr4,71691942,2.098950524737631,944,620,1564,-
chr4,71697270,2.7991896388635515,852,681,1533,-
chr4,71697303,1.8002281254478014,1212,930,2142,-
chr4,71698097,2.9416195856873824,780,530,1310,-
chr4,71698107,3.5586170586170582,750,517,1267,-
chr4,71698910,1.9270281288218507,651,445,1096,-
chr4,71701935,2.7086710506193605,655,502,1157,-
chr4,71701985,1.1864831038798496,631,469,1100,-
chr4,71701987,1.1864831038798496,631,469,1100,-
chr4,74005834,1.5679709794407455,1731,1219,2950,-
chr4,74005852,1.4276228419654713,687,501,1188,-
chr4,76569459,0.3294944647750437,540,813,1353,-
chr4,76569460,0.32841335754847895,516,763,1279,-
chr4,76569473,9.618416627224384,735,1027,1762,-
chr4,76569476,3.6367887241491395,611,589,1200,-
chr4,76569480,17.2956217989613,978,909,1887,-
chr4,76569486,19.35064495573069,1684,700,2384,-
chr4,76569487,19.35064495573069,1684,700,2384,-
chr4,76569488,15.323601045064212,1425,519,1944,-
chr4,76569666,3.9103482062104313,831,533,1364,-
chr4,76570614,2.5315807449281595,776,569,1345,-
chr4,76587212,2.714792102759673,690,422,1112,-
chr4,77082229,9.14210643561411,568,692,1260,-
chr4,77082672,1.1221776197047364,584,465,1049,-
chr4,77089618,2.785616193135638,641,428,1069,-
chr4,77095301,2.3650075414781297,615,428,1043,-
chr4,77095302,2.3650075414781297,615,428,1043,-
chr4,77968416,1.960556844547564,584,430,1014,-
chr4,77968646,1.6843537414965988,618,489,1107,-
chr4,77969615,2.1150588633159244,793,546,1339,-
chr4,77969668,2.769121891044729,600,409,1009,-
chr4,83275097,2.7140668096843394,655,501,1156,-
chr4,83275202,1.6855272387187277,800,657,1457,-
chr4,83275216,1.7001632607104658,754,572,1326,-
chr4,83275222,0.4260100182575721,699,520,1219,-
chr4,83277827,4.07528261544265,619,462,1081,-
chr4,83278566,1.6890470532881274,1488,1056,2544,-
chr4,83279924,1.7364912280701754,706,569,1275,-
chr4,83279925,0.5625322198164759,991,731,1722,-
chr4,83280692,1.4307665279294266,6701,5155,11856,-
chr4,83280693,1.4463019265020098,2867,2398,5265,-
chr4,83280696,1.584888095334399,3535,2560,6095,-
chr4,83280697,1.7834011969502364,1254,850,2104,-
chr4,83280699,1.8491410567377662,2025,1378,3403,-
chr4,83280743,1.5292517006802722,1123,734,1857,-
chr4,83280786,1.4249571559416636,14328,11257,25585,-
chr4,83280787,1.430638015408746,14244,12070,26314,-
chr4,83280789,1.5385124101017373,19682,15375,35057,-
chr4,83280790,1.443430573953325,10016,8508,18524,-
chr4,83280791,1.2144460733549278,22509,16763,39272,-
chr4,83292685,2.0164739595064693,3882,2803,6685,-
chr4,83292686,1.4011025189449327,6740,4820,11560,-
chr4,83292706,2.106038291605302,1169,678,1847,-
chr4,83292712,0.9178081979452918,4451,3689,8140,-
chr4,83292714,0.652294434470377,3243,2784,6027,-
chr4,83292716,2.0989173228346454,852,507,1359,-
chr4,83294614,0.6366293301683852,1191,1104,2295,-
chr4,83294617,0.6617464675634578,3362,3298,6660,-
chr4,83294620,0.5056787091093158,2794,2537,5331,-
chr4,83294621,0.4758638211382113,1872,1919,3791,-
chr4,83294628,0.5307015338194618,1210,1434,2644,-
chr4,83294630,0.4977504836460161,762,716,1478,-
chr4,83294632,1.4321111644114348,4819,5421,10240,-
chr4,83294634,2.018134013167437,8200,8601,16801,-
chr4,83294635,3.668245533599356,5822,5935,11757,-
chr4,83294636,3.668245533599357,5822,5935,11757,-
chr4,83294654,6.045432004175497,3104,2583,5687,-
chr4,83294655,5.9694067842403475,3383,2750,6133,-
chr4,83294656,6.42404604182161,2705,2293,4998,-
chr4,83294681,2.2014569698490174,1020,686,1706,-
chr4,83294683,2.206608658387881,1749,1258,3007,-
chr4,83294684,2.171767570022834,1518,1101,2619,-
chr4,83294685,2.171767570022834,1518,1101,2619,-
chr4,83294866,1.990116814246577,8287,9503,17790,-
chr4,83294875,0.5602862573535605,3561,4340,7901,-
chr4,83294891,0.5686890141784788,8519,11652,20171,-
chr4,83294892,0.577930119404962,12235,17082,29317,-
chr4,83294894,0.5778546878261204,7759,11091,18850,-
chr4,83294897,0.6821901823905554,5546,6818,12364,-
chr4,83294899,0.72622813653348,2946,2357,5303,-
chr4,83294900,0.5677622627998568,1801,1469,3270,-
chr4,83294901,0.48688145538625965,4478,8309,12787,-
chr4,83294902,0.5159806512605583,6345,11218,17563,-
chr4,83294903,0.7683859644228798,8416,15097,23513,-
chr4,83294905,2.4705535197897865,9317,14281,23598,-
chr4,83294906,3.2806845923245906,7409,10569,17978,-
chr4,83294907,3.4939424660840004,5780,9097,14877,-
chr4,83294931,1.6121888564088935,699,638,1337,-
chr4,83294993,4.580516453165919,927,580,1507,-
chr4,83294994,4.820454545454545,706,439,1145,-
chr4,83295004,6.523059522989108,1459,841,2300,-
chr4,83295005,3.1384430176565004,710,355,1065,-
chr4,83295084,1.7638520914015448,1336,1013,2349,-
chr4,83347214,4.658221166534705,705,420,1125,-
chr4,83347216,4.658221166534705,705,420,1125,-
chr4,83347757,1.9515306122448977,679,447,1126,-
chr4,83349190,2.1892869646399813,669,450,1119,-
chr4,83349451,1.6742075297268424,3919,3028,6947,-
chr4,83349452,1.4483794614434882,4972,3825,8797,-
chr4,83349524,1.9512688302497219,1543,941,2484,-
chr4,83349556,1.5079052067116414,1177,704,1881,-
chr4,83349593,1.350071865826266,16528,11855,28383,-
chr4,83349596,1.1741144793675182,11204,8238,19442,-
chr4,83349597,0.6319902090001882,4115,2711,6826,-
chr4,83349599,0.5561286713286713,2070,1374,3444,-
chr4,83350409,1.528674716756112,3060,2235,5295,-
chr4,83350417,1.335479295569494,3930,2601,6531,-
chr4,83350418,1.2866916225635732,2491,1777,4268,-
chr4,83350419,1.3875050116366083,3304,2191,5495,-
chr4,83350422,1.4080904458287953,5165,3482,8647,-
chr4,83350433,1.5317214577838711,5378,3639,9017,-
chr4,83350434,1.4877702463641274,3781,2587,6368,-
chr4,83350451,1.4852521408182684,1560,1050,2610,-
chr4,83350470,1.6224014336917565,822,539,1361,-
chr4,83350475,1.6937142857142855,740,499,1239,-
chr4,83350476,1.9943871917556129,1274,835,2109,-
chr4,83350479,0.9504707327056895,1547,1046,2593,-
chr4,83350480,0.9504707327056895,1547,1046,2593,-
chr4,83350481,1.7173717371737174,1112,706,1818,-
chr4,83350487,2.4930054352668627,1141,773,1914,-
chr4,83350489,2.4930054352668627,1141,773,1914,-
chr4,83350497,1.771226549580886,1502,922,2424,-
chr4,83350499,1.771226549580886,1502,922,2424,-
chr4,83350516,2.2343518688662933,819,476,1295,-
chr4,83350524,1.4782009408356762,648,432,1080,-
chr4,83772588,0.6430694558173858,805,587,1392,-
chr4,83774785,3.700538804156007,1180,690,1870,-
chr4,83776122,2.418688915275354,597,489,1086,-
chr4,83785518,1.8594074844074842,1430,961,2391,-
chr4,83785519,1.8594074844074842,1430,961,2391,-
chr4,83785522,2.659954736712014,955,662,1617,-
chr4,83812276,0.7269834486278443,904,599,1503,-
chr4,89443019,2.456140350877193,574,436,1010,-
chr4,89443126,1.6226588430535798,1164,702,1866,-
chr4,89443144,1.083575152728332,1488,923,2411,-
chr4,90647531,0.5305771590717114,749,510,1259,-
chr4,90647713,2.5126366391848007,597,526,1123,-
chr4,90647767,2.5653901734104045,788,691,1479,-
chr4,90647768,2.5653901734104045,788,691,1479,-
chr4,90749330,0.5617283950617283,636,404,1040,-
chr4,91759713,0.6353731343283582,1160,1004,2164,-
chr4,91759733,0.5231939753891541,585,830,1415,-
chr4,91759743,0.49642620456413267,1071,1315,2386,-
chr4,91759788,0.3551165645140086,746,1265,2011,-
chr4,91759789,0.35736225779649433,664,1081,1745,-
chr4,91759790,0.30709570829210625,872,1465,2337,-
chr4,91759792,0.2472826954925649,987,1943,2930,-
chr4,91759794,0.22848434207657284,440,1087,1527,-
chr4,91759797,17.41630141476607,443,905,1348,-
chr4,99801971,2.011054658822307,657,414,1071,-
chr4,99802101,0.46582769716733163,573,479,1052,-
chr4,99993201,20.63472285029243,799,611,1410,-
chr4,99993557,4.139325842696629,613,444,1057,-
chr4,99996080,1.8136682242990652,674,427,1101,-
chr4,99997498,2.12790978654853,1035,954,1989,-
chr4,99997504,1.620936684748851,931,778,1709,-
chr4,99997547,1.5218365061590144,905,610,1515,-
chr4,99997570,0.5068237760529797,1201,814,2015,-
chr4,99997647,2.9839080459770115,648,463,1111,-
chr4,99997678,5.699650015908368,688,448,1136,-
chr4,99997919,1.5929038281979455,852,503,1355,-
chr4,99998010,0.5385882352941176,871,679,1550,-
chr4,99998032,1.864586994727592,642,568,1210,-
chr4,100003169,1.8298013245033111,613,452,1065,-
chr4,100006277,2.292227098424359,1404,766,2170,-
chr4,100006278,2.224558050645008,872,482,1354,-
chr4,100480484,0.2600056319367906,795,567,1362,-
chr4,100480494,2.313418591334224,605,402,1007,-
chr4,100480496,2.0417989871895634,1066,779,1845,-
chr4,100869643,1.0929729810851314,5325,4069,9394,-
chr4,100869653,1.758286616660087,2042,1489,3531,-
chr4,100869659,1.2869633381572598,3048,2072,5120,-
chr4,100870079,1.2898360504743485,5930,3806,9736,-
chr4,100870080,1.2898360504743485,5930,3806,9736,-
chr4,100870081,1.7484991548639037,3205,2450,5655,-
chr4,100870082,1.5496262370937914,5376,4374,9750,-
chr4,100870432,2.1132075471698117,1291,900,2191,-
chr4,100870466,1.4262238637786404,1401,1140,2541,-
chr4,100870506,0.7449505143898946,2570,2193,4763,-
chr4,100871328,1.3386944462591983,2799,2457,5256,-
chr4,100871335,0.774718818197079,2129,1553,3682,-
chr4,100871387,1.3635313105104552,4902,3652,8554,-
chr4,100871424,1.574837487243593,4850,3042,7892,-
chr4,100871425,1.604092261429051,4751,2939,7690,-
chr4,100871428,0.9458933869269788,2157,1289,3446,-
chr4,100871429,0.9439992846536571,3319,2063,5382,-
chr4,100871436,2.9805742176720726,607,498,1105,-
chr4,100871438,4.5731750065302315,1544,1248,2792,-
chr4,100871439,6.539043857897875,1232,997,2229,-
chr4,103183114,1.7431429605279143,879,580,1459,-
chr4,103560993,0.9499718431857237,851,481,1332,-
chr4,103717289,5.950596300578123,1926,1768,3694,-
chr4,103717290,6.261629209218741,2309,2023,4332,-
chr4,103717758,2.432520325203252,1121,614,1735,-
chr4,103717904,1.6520881470644353,1379,1083,2462,-
chr4,103717905,2.0182998819362457,788,461,1249,-
chr4,103717936,2.653508771929824,604,474,1078,-
chr4,103718187,2.4899598393574296,867,580,1447,-
chr4,103718269,1.827409521338695,804,592,1396,-
chr4,103718608,1.6605664488017429,823,611,1434,-
chr4,103720622,1.122942308937449,1295,1068,2363,-
chr4,103722653,1.6589030803906835,1034,604,1638,-
chr4,103723783,0.9906007876519651,1097,805,1902,-
chr4,106290869,1.6330445544554455,811,605,1416,-
chr4,106307773,2.1596509240246404,600,486,1086,-
chr4,106307781,2.3607970568166485,1610,1041,2651,-
chr4,106317410,1.5198172693347058,1026,817,1843,-
chr4,106317432,1.768993702264505,573,438,1011,-
chr4,106345447,1.7034219269102988,1898,1504,3402,-
chr4,106367561,1.7789119591694698,1277,698,1975,-
chr4,106370513,0.5634469696969697,804,527,1331,-
chr4,106395067,2.564179104477612,858,535,1393,-
chr4,106395068,2.564179104477612,858,535,1393,-
chr4,106614632,3.900509173075981,592,504,1096,-
chr4,110635541,1.9956828885400313,1129,636,1765,-
chr4,110635547,2.746737712048717,870,483,1353,-
chr4,110635550,1.9580699861260984,875,498,1373,-
chr4,110635551,2.959925442684064,1587,813,2400,-
chr4,110635553,2.959925442684064,1587,813,2400,-
chr4,110635592,0.8797554347826088,776,367,1143,-
chr4,110635593,0.8797554347826088,776,367,1143,-
chr4,110635598,2.503441494591937,1071,677,1748,-
chr4,110635599,2.482405586602164,1454,878,2332,-
chr4,110661987,2.196733155819638,747,513,1260,-
chr4,110667565,1.5872787881803825,746,440,1186,-
chr4,110670704,2.3922751084722917,681,455,1136,-
chr4,114421663,2.282002290128012,646,473,1119,-
chr4,114430799,3.280324111112479,849,589,1438,-
chr4,120221538,1.7405405405405407,615,406,1021,-
chr4,120221582,1.2834662310137641,779,520,1299,-
chr4,120980862,1.85625,879,511,1390,-
chr4,120981311,1.7761777695988221,756,493,1249,-
chr4,120986869,0.5673576489110469,568,514,1082,-
chr4,120986925,1.6715530061610366,561,522,1083,-
chr4,120986952,1.24889391253625,803,666,1469,-
chr4,120987960,1.6911469760833728,909,593,1502,-
chr4,122593719,1.543732077067097,4223,3070,7293,-
chr4,122593756,1.451561088891756,2102,1684,3786,-
chr4,122599589,1.764012463385921,2576,1740,4316,-
chr4,122607473,1.802777469360848,3960,2954,6914,-
chr4,122617751,2.355087014725569,680,497,1177,-
chr4,122617754,1.7978395061728394,1164,773,1937,-
chr4,122618036,1.844155844155844,567,461,1028,-
chr4,122618037,2.470626003210273,591,444,1035,-
chr4,122618047,1.8271604938271604,739,404,1143,-
chr4,122618116,1.507479926596851,638,474,1112,-
chr4,122738187,0.4590268711923412,784,1531,2315,-
chr4,122738188,0.4543383023857978,1881,3157,5038,-
chr4,122738192,0.1925253903897876,435,858,1293,-
chr4,122738199,0.2970758725906435,1224,2240,3464,-
chr4,122738200,0.23616535297531072,1066,2302,3368,-
chr4,122738206,52.16295041039722,2169,2626,4795,-
chr4,122738207,53.729792147806,704,865,1569,-
chr4,122738208,70.93849938499386,855,812,1667,-
chr4,122738215,3.6860845205147603,1616,432,2048,-
chr4,122738216,3.6860845205147603,1616,432,2048,-
chr4,122738218,6.479215387415834,1004,297,1301,-
chr4,122738221,4.853994490358127,880,230,1110,-
chr4,122738222,6.446700707719992,1166,319,1485,-
chr4,122738366,2.6639584743850144,907,632,1539,-
chr4,122738367,2.6639584743850144,907,632,1539,-
chr4,122738641,1.8452344152498712,967,646,1613,-
chr4,122740053,1.9997222222222224,625,399,1024,-
chr4,122740709,3.73191094619666,744,489,1233,-
chr4,122741888,1.752296587926509,762,507,1269,-
chr4,122742140,1.995959051724138,716,463,1179,-
chr4,122743662,2.79989114658926,670,423,1093,-
chr4,122743732,1.9736275060895636,1388,1185,2573,-
chr4,122743734,1.9736275060895636,1388,1185,2573,-
chr4,122743772,0.47862249122603623,789,653,1442,-
chr4,122743777,2.1471556041675113,758,504,1262,-
chr4,122743798,3.038843790522331,610,399,1009,-
chr4,129191710,2.9896919416527754,913,657,1570,-
chr4,129191891,0.24745475113122173,499,543,1042,-
chr4,129191956,0.4449866903283051,589,643,1232,-
chr4,129191964,0.4370834064037512,879,1256,2135,-
chr4,129191991,11.542864868564587,3975,4739,8714,-
chr4,129191992,11.786410704650335,5257,5423,10680,-
chr4,129191993,11.786410704650333,5257,5423,10680,-
chr4,129191994,15.319456154487044,3909,3458,7367,-
chr4,129192010,3.2653896368542172,1034,494,1528,-
chr4,139088218,1.1629032258064516,617,464,1081,-
chr4,139088220,1.1629032258064516,617,464,1081,-
chr4,139163435,1.7660639341173658,2073,1235,3308,-
chr4,139163439,1.6168446515207742,1383,920,2303,-
chr4,139163441,2.0395142760156078,3708,2064,5772,-
chr4,139163442,2.1438881933176583,2991,1578,4569,-
chr4,139163443,2.45510469264667,2965,1599,4564,-
chr4,139163445,2.9293821555467825,1262,595,1857,-
chr4,140216231,2.083431551977635,950,763,1713,-
chr4,140216241,2.479323960653624,1906,1273,3179,-
chr4,140216242,2.3216621684977317,2054,1454,3508,-
chr4,140216243,2.4305822136916184,1571,1041,2612,-
chr4,140216298,3.0914608396323504,718,494,1212,-
chr4,140454325,3.048834014559156,790,674,1464,-
chr4,140454327,2.998078155028828,701,668,1369,-
chr4,140454329,3.4478653530377668,680,608,1288,-
chr4,140454330,2.0328525347956146,738,570,1308,-
chr4,145916681,1.178070308014117,4620,2905,7525,-
chr4,145916682,1.524747218081865,6074,4250,10324,-
chr4,145916689,0.5819549597338091,1723,1164,2887,-
chr4,145916696,1.7636104721218098,1149,894,2043,-
chr4,155468204,4.194842108412143,747,468,1215,-
chr4,155471476,0.5052359357414311,958,537,1495,-
chr4,155471551,0.6641244755330414,801,489,1290,-
chr4,155526112,1.8277140539914265,630,410,1040,-
chr4,155526194,0.3768817204301075,700,495,1195,-
chr4,155526206,2.385942076147088,610,438,1048,-
chr4,155527864,0.4113146071785923,696,486,1182,-
chr4,155529733,2.210820478426112,637,496,1133,-
chr4,155529774,2.4631816789336556,827,585,1412,-
chr4,159630417,2.0871504847137596,937,509,1446,-
chr4,159636777,3.483499595132943,642,491,1133,-
chr4,159636783,0.8854796570318906,726,519,1245,-
chr4,159640367,2.017925857880679,1175,1298,2473,-
chr4,159640370,2.115760869565217,1373,1379,2752,-
chr4,159640371,2.0602657682949657,1805,1780,3585,-
chr4,159640372,2.097331887734814,2146,2232,4378,-
chr4,159640373,2.073151750972763,1331,1284,2615,-
chr4,159640378,0.4638230017939007,536,518,1054,-
chr4,174253068,1.6743831006979064,1761,1002,2763,-
chr4,174253246,4.884564580512202,3377,2723,6100,-
chr4,174253252,3.8486653642346838,3318,2450,5768,-
chr4,174253269,1.6295888245377856,2032,1401,3433,-
chr4,174253270,1.8609255134867608,1279,897,2176,-
chr4,174253275,2.1314355677992043,940,604,1544,-
chr4,174253276,2.218874324357736,2219,1472,3691,-
chr4,174253346,1.7852935352935355,1360,961,2321,-
chr4,174254062,1.5003791389333558,1112,912,2024,-
chr4,174254229,1.546492129234735,5707,4090,9797,-
chr4,174254230,1.546492129234735,5707,4090,9797,-
chr4,174254250,1.555639459014126,6352,4174,10526,-
chr4,174254252,1.5992011392952905,4032,2738,6770,-
chr4,174254324,1.449272320179121,1613,1190,2803,-
chr4,174254711,1.4501252167212484,4130,2684,6814,-
chr4,174254712,0.7655915889784419,8824,4579,13403,-
chr4,174254714,0.7540328673241695,15977,9082,25059,-
chr4,174254715,0.7585224854535008,12471,7720,20191,-
chr4,174254716,0.7060700423885286,18533,10613,29146,-
chr4,174254719,0.8216298161838005,11450,6983,18433,-
chr4,174254720,0.813708417539977,9266,6010,15276,-
chr4,174254721,0.895914945314696,13219,7957,21176,-
chr4,174254723,1.446553936740394,3674,2037,5711,-
chr4,174254725,1.6114228456913826,1495,997,2492,-
chr4,174254727,0.6549706863438796,1400,760,2160,-
chr4,174254765,0.5206780923994039,1819,1231,3050,-
chr4,174254766,1.4991039426523296,955,743,1698,-
chr4,174254767,0.5206780923994039,1819,1231,3050,-
chr4,174254788,1.749222797927461,843,578,1421,-
chr4,174255437,2.7398205659075225,1587,965,2552,-
chr4,174255438,2.7398205659075225,1587,965,2552,-
chr4,174255503,0.7623919026213232,2255,1201,3456,-
chr4,174255509,1.6353418094711625,709,602,1311,-
chr4,174255510,1.1492275401292074,1674,1257,2931,-
chr4,174255511,1.4783628554402235,1156,893,2049,-
chr4,178355557,3.1690019638339426,700,465,1165,-
chr4,184570698,4.560752441869814,628,414,1042,-
chr4,185549724,2.189974511469839,715,534,1249,-
chr4,185549735,1.6600790513833992,599,459,1058,-
chr4,185549751,1.9259185211669643,732,491,1223,-
chr4,186111413,3.2427331153353123,854,554,1408,-
chr5,205767,1.335063434846824,694,555,1249,-
chr5,205771,2.599791883454735,1040,774,1814,-
chr5,205772,2.599791883454735,1040,774,1814,-
chr5,205773,2.599791883454735,1040,774,1814,-
chr5,205954,2.370355027452316,613,476,1089,-
chr5,1051228,0.9491627824375782,671,529,1200,-
chr5,1057618,2.8506144393241164,570,433,1003,-
chr5,1057619,2.8506144393241164,570,433,1003,-
chr5,1318097,0.5074642244958496,1448,1169,2617,-
chr5,1318153,1.7926693128256013,704,555,1259,-
chr5,1318154,0.5674267048148685,1098,1112,2210,-
chr5,1318160,6.77298499706427,5202,4441,9643,-
chr5,1318161,6.77298499706427,5202,4441,9643,-
chr5,1318162,6.77298499706427,5202,4441,9643,-
chr5,1318181,5.611748735729866,1574,998,2572,-
chr5,1318412,1.568523753077414,1127,996,2123,-
chr5,1318439,0.4398572884811417,862,653,1515,-
chr5,1318452,2.0218163368848296,796,510,1306,-
chr5,1318483,2.0200838666960936,677,393,1070,-
chr5,1320757,1.7404580152671756,575,523,1098,-
chr5,1323911,1.5792531399019412,1146,708,1854,-
chr5,1325905,2.141546762589928,1133,694,1827,-
chr5,1334419,1.7833910450151118,1619,1062,2681,-
chr5,1334484,1.552657427044278,1898,1558,3456,-
chr5,1334487,1.786354201395984,3056,2512,5568,-
chr5,1334488,1.786354201395984,3056,2512,5568,-
chr5,1334489,1.786354201395984,3056,2512,5568,-
chr5,1335177,1.6330202197102373,788,570,1358,-
chr5,1335191,1.596529284164859,735,460,1195,-
chr5,1335206,0.6870926015167271,629,442,1071,-
chr5,1335232,1.9287433155080216,686,373,1059,-
chr5,1335237,2.3016304347826084,692,367,1059,-
chr5,1335243,2.6857816030231194,966,584,1550,-
chr5,1335285,1.208305317551436,1448,1326,2774,-
chr5,1335286,0.4826635145784081,734,647,1381,-
chr5,1335287,1.9276960784313726,714,679,1393,-
chr5,1339029,1.8099242188311016,1267,740,2007,-
chr5,1339031,1.8099242188311016,1267,740,2007,-
chr5,1339084,4.0298042307577875,1019,721,1740,-
chr5,1341819,1.7016364375161614,1244,1176,2420,-
chr5,1341820,1.6583047268209674,3082,2677,5759,-
chr5,1341821,1.6268992940918956,1838,1501,3339,-
chr5,1341836,1.7123050259965338,740,576,1316,-
chr5,1341840,1.5658888126286892,675,495,1170,-
chr5,1344504,1.7141329258976323,862,594,1456,-
chr5,1344522,1.8333333333333333,637,434,1071,-
chr5,1344527,2.213903743315508,647,395,1042,-
chr5,1461603,7.72174449297968,488,567,1055,-
chr5,1462106,1.7384057977034375,691,497,1188,-
chr5,1463642,1.4431372549019608,735,458,1193,-
chr5,1463643,1.5603762075290024,899,585,1484,-
chr5,1463644,1.4431372549019608,735,458,1193,-
chr5,1798723,0.550250593510947,595,445,1040,-
chr5,1798832,1.863676692396416,976,577,1553,-
chr5,1798869,1.9824136065088567,955,786,1741,-
chr5,1798893,2.2504252504252507,881,480,1361,-
chr5,1799001,1.4932739872260004,2952,2195,5147,-
chr5,1799036,1.774114173228346,1574,1015,2589,-
chr5,1799038,1.8785898729863288,2256,1425,3681,-
chr5,1799039,1.644722891566265,1421,874,2295,-
chr5,6372231,2.850853889943074,625,526,1151,-
chr5,6372232,2.850853889943074,625,526,1151,-
chr5,6374507,2.059369202226345,554,538,1092,-
chr5,6374519,1.4936951346525815,1408,1033,2441,-
chr5,6374520,1.4936951346525815,1408,1033,2441,-
chr5,6374521,1.7617124394184167,726,618,1344,-
chr5,6374522,1.7617124394184167,726,618,1344,-
chr5,6599922,0.6366128540968625,835,669,1504,-
chr5,6599940,1.9712918660287082,617,527,1144,-
chr5,6599966,2.0810439397765466,1214,907,2121,-
chr5,6599968,1.8470505896135387,1133,888,2021,-
chr5,6600013,1.0308315020061234,632,413,1045,-
chr5,6600198,1.7656842108349466,3408,2430,5838,-
chr5,6600199,1.7838629279022131,4094,2972,7066,-
chr5,6600218,1.7100465047612021,701,588,1289,-
chr5,6604333,2.3512088349417968,843,528,1371,-
chr5,6604765,2.032137015298759,659,546,1205,-
chr5,6607330,1.923596087071447,1731,1237,2968,-
chr5,6607372,1.3832808836941686,1712,1238,2950,-
chr5,6607422,0.6718033526272269,661,501,1162,-
chr5,6609967,1.8143826547500823,876,635,1511,-
chr5,6610033,1.933075933075933,750,591,1341,-
chr5,6611083,1.1935698066135334,1220,872,2092,-
chr5,6616849,0.49055527021628703,613,530,1143,-
chr5,6616857,0.5949445398045367,1282,990,2272,-
chr5,6616908,0.9717315692559505,1356,945,2301,-
chr5,6616909,0.9717315692559505,1356,945,2301,-
chr5,6620239,0.5300925925925926,915,647,1562,-
chr5,6620247,1.6016295025728988,746,582,1328,-
chr5,6620266,1.7634782608695654,623,459,1082,-
chr5,6620314,3.312297320511105,761,545,1306,-
chr5,6620318,2.251573175178715,830,437,1267,-
chr5,6625729,1.6015972116548867,2183,1601,3784,-
chr5,6632720,2.257283950617284,652,539,1191,-
chr5,6632769,1.1448349307774228,1074,625,1699,-
chr5,6632771,1.1448349307774228,1074,625,1699,-
chr5,6632861,7.808027689318986,2925,1898,4823,-
chr5,6632862,5.246111111111111,664,374,1038,-
chr5,6633012,2.0081236831299183,2361,1240,3601,-
chr5,6633013,1.8605239735912833,1480,638,2118,-
chr5,6633014,2.002790417163256,1864,1050,2914,-
chr5,10279535,1.8470121861694322,1257,972,2229,-
chr5,10279599,2.0969419596421885,629,436,1065,-
chr5,10279760,3.708609271523179,615,452,1067,-
chr5,10279793,0.6059328563090697,1407,951,2358,-
chr5,10280030,1.9212268106407269,1814,1235,3049,-
chr5,10280158,1.8520851063829784,805,469,1274,-
chr5,10280161,4.015255530129672,657,436,1093,-
chr5,10280179,1.3063291139240507,644,394,1038,-
chr5,10280192,0.4744189467908255,772,599,1371,-
chr5,10280221,0.45393995881801535,722,515,1237,-
chr5,10280562,1.637137330754352,1287,769,2056,-
chr5,10280575,1.7161919867595337,1058,852,1910,-
chr5,10280580,2.858424166926191,1042,844,1886,-
chr5,10286467,2.599315969481715,987,723,1710,-
chr5,10286493,1.6097927865347166,2586,1821,4407,-
chr5,10286590,1.420847750865052,1094,866,1960,-
chr5,10288578,2.187081182043318,4563,3509,8072,-
chr5,10290693,1.609442915819277,1008,642,1650,-
chr5,10290702,1.6578515625,986,799,1785,-
chr5,10290878,1.5940321947389082,724,565,1289,-
chr5,10290884,1.5629240324892495,695,454,1149,-
chr5,10290885,0.649390243902439,1277,983,2260,-
chr5,10290887,1.0068092787611602,2382,1771,4153,-
chr5,10290888,0.9594453703114806,1647,1284,2931,-
chr5,10307763,3.945881098373767,778,340,1118,-
chr5,10307765,3.945881098373767,778,340,1118,-
chr5,10307949,1.600298058631392,687,483,1170,-
chr5,10679738,2.0216901984857785,759,542,1301,-
chr5,10679739,2.0216901984857785,759,542,1301,-
chr5,10680621,1.0860576923076923,752,415,1167,-
chr5,10680622,1.0860576923076923,752,415,1167,-
chr5,10680908,2.1239922385779493,1165,804,1969,-
chr5,10680918,2.224883983444124,656,468,1124,-
chr5,10748323,5.498752228163993,481,560,1041,-
chr5,14710806,3.508410699743157,594,426,1020,-
chr5,14713756,4.053484874628187,633,469,1102,-
chr5,16451730,2.834224598930481,1695,1495,3190,-
chr5,16451737,1.1943787269257637,4445,2995,7440,-
chr5,16451772,1.6106573227887797,7186,4245,11431,-
chr5,16451773,1.6454897146676946,9454,5474,14928,-
chr5,16451775,1.5935326621771324,4825,2655,7480,-
chr5,16451796,1.7115839243498818,723,422,1145,-
chr5,16451845,0.3591945657447841,672,457,1129,-
chr5,16451846,0.3591945657447841,672,457,1129,-
chr5,16451862,1.1158918807174285,715,485,1200,-
chr5,16453226,0.6371225748903179,5478,2985,8463,-
chr5,16453228,1.4718243200605792,1665,1195,2860,-
chr5,16453229,0.5668174522107107,1078,622,1700,-
chr5,16453231,1.8094413725388871,1505,1045,2550,-
chr5,16453232,0.6489779393583692,3363,1830,5193,-
chr5,16453234,0.8743652342980147,7631,4382,12013,-
chr5,16453235,1.4118867886137505,1284,832,2116,-
chr5,16453236,1.0459834487586568,4268,2552,6820,-
chr5,16453238,1.4882840236686392,1047,649,1696,-
chr5,16453253,1.5025519673348182,1377,897,2274,-
chr5,16453254,1.788949275362319,789,479,1268,-
chr5,16458673,1.8319946452476568,594,414,1008,-
chr5,16463358,0.3537871524448706,614,446,1060,-
chr5,16463804,3.0510253866825505,613,491,1104,-
chr5,16666184,6.670066613903178,630,453,1083,-
chr5,16701118,2.7079718056072046,727,335,1062,-
chr5,31421439,1.4367431370577333,1785,1038,2823,-
chr5,31421445,2.5373153068091643,4904,3432,8336,-
chr5,31421446,2.5373153068091643,4904,3432,8336,-
chr5,31421447,2.5373153068091643,4904,3432,8336,-
chr5,31421452,1.8617226890756304,1501,951,2452,-
chr5,31421465,1.7439588688946015,1271,777,2048,-
chr5,31422898,0.6043543543543544,804,443,1247,-
chr5,31422940,1.7690721649484538,857,484,1341,-
chr5,31423039,0.42120915369906026,940,751,1691,-
chr5,31423040,0.373719165085389,605,526,1131,-
chr5,31515189,1.447576604743974,630,449,1079,-
chr5,31526216,2.2560463301926426,1366,876,2242,-
chr5,31526220,1.8948943294034475,3816,2774,6590,-
chr5,31526222,2.024563901744393,3712,2808,6520,-
chr5,31526223,2.0569719413189005,2406,1769,4175,-
chr5,31526237,0.6670258893932095,922,697,1619,-
chr5,31526240,2.265768958185684,694,414,1108,-
chr5,31526245,1.7906905993306967,653,518,1171,-
chr5,31526257,2.126969124133585,941,528,1469,-
chr5,31526259,2.209289716821087,1884,1101,2985,-
chr5,31526260,1.9646522086307288,1367,860,2227,-
chr5,31526264,1.4987068965517245,1158,579,1737,-
chr5,31526265,1.4987068965517245,1158,579,1737,-
chr5,31526266,1.4987068965517245,1158,579,1737,-
chr5,31526362,3.9277502356008505,745,488,1233,-
chr5,31526451,0.3265913549152383,587,456,1043,-
chr5,32125293,1.769417475728155,809,514,1323,-
chr5,32125589,0.611762610869867,1053,867,1920,-
chr5,32125789,2.400669642857143,716,559,1275,-
chr5,32125962,2.4474448348131204,1309,930,2239,-
chr5,32126304,2.074188908753512,767,539,1306,-
chr5,32126464,3.8639387220318486,660,450,1110,-
chr5,32126465,3.8639387220318486,660,450,1110,-
chr5,32230136,2.0556926710141443,1492,1079,2571,-
chr5,32230137,2.1592920353982303,839,677,1516,-
chr5,32355847,2.714158019168593,678,519,1197,-
chr5,32390401,5.791423803354676,641,421,1062,-
chr5,32395395,1.7620192467882987,1212,905,2117,-
chr5,32395401,2.534335839598997,1263,854,2117,-
chr5,32395402,2.534335839598997,1263,854,2117,-
chr5,32397364,1.6853820762888483,1627,1221,2848,-
chr5,32400248,3.7920582389402484,721,513,1234,-
chr5,34914835,1.1760480040447792,3385,2434,5819,-
chr5,34914837,0.4213249561119838,1139,821,1960,-
chr5,36201238,2.4520504637971112,653,483,1136,-
chr5,38481263,1.0196627591924248,856,545,1401,-
chr5,38481265,1.42994362512068,730,486,1216,-
chr5,38938722,1.789419098401742,1109,910,2019,-
chr5,38939673,3.2609168930077437,750,436,1186,-
chr5,39372766,2.2428238515982493,1606,1246,2852,-
chr5,39372768,2.0930966898954706,1226,860,2086,-
chr5,39372973,1.6727921329131112,694,582,1276,-
chr5,39373462,1.7175417175417176,632,566,1198,-
chr5,39373495,0.7282855418917367,1912,1581,3493,-
chr5,39373496,1.2385592960294003,2480,2036,4516,-
chr5,39373497,0.7282855418917367,1912,1581,3493,-
chr5,39376119,2.9902636916835696,545,492,1037,-
chr5,39376163,1.3665310333284355,2044,1408,3452,-
chr5,39376804,1.5601639739570772,646,637,1283,-
chr5,39376807,2.039128595600677,621,590,1211,-
chr5,39376829,2.3141242937853104,575,530,1105,-
chr5,39377007,1.5699026738569017,773,554,1327,-
chr5,39377333,1.820829995349483,757,521,1278,-
chr5,39382911,2.499265785609398,850,680,1530,-
chr5,39382913,2.499265785609398,850,680,1530,-
chr5,39383151,1.5581790629095675,1950,1525,3475,-
chr5,39383190,0.5796490413749532,4086,2780,6866,-
chr5,39383191,0.5796490413749532,4086,2780,6866,-
chr5,39383192,0.5796490413749532,4086,2780,6866,-
chr5,39383343,0.6486013986013986,741,649,1390,-
chr5,39389204,1.9218328840970351,758,582,1340,-
chr5,39390016,1.9312639853118363,747,600,1347,-
chr5,39390022,1.677869480132732,679,510,1189,-
chr5,39390560,1.6705529650808395,2546,1860,4406,-
chr5,39390561,1.0554531398667937,1382,1050,2432,-
chr5,39390562,2.428365920967648,1164,810,1974,-
chr5,39390587,1.2768101940266867,1187,801,1988,-
chr5,39390618,2.7967828418230565,651,372,1023,-
chr5,39392488,2.1149289099526065,594,421,1015,-
chr5,39394359,4.042261099260376,768,688,1456,-
chr5,39394362,3.354387452310301,771,673,1444,-
chr5,39394363,3.0070823742050856,1143,911,2054,-
chr5,39394500,3.381216344630979,576,450,1026,-
chr5,39394501,2.928634850582142,937,670,1607,-
chr5,40746943,2.1470948012232416,1427,980,2407,-
chr5,40746945,2.1470948012232416,1427,980,2407,-
chr5,40746964,2.0816326530612246,935,636,1571,-
chr5,40746981,3.301867844948785,684,382,1066,-
chr5,40760513,3.6639948144548335,585,484,1069,-
chr5,40764668,2.44619892958311,1624,1257,2881,-
chr5,40764669,1.9825648600051373,1164,915,2079,-
chr5,40798265,3.8775070966541025,818,284,1102,-
chr5,40825624,1.7624471200780996,676,438,1114,-
chr5,40826782,0.5836584532938585,1733,1375,3108,-
chr5,40826789,1.4985576923076924,1038,831,1869,-
chr5,40826899,1.6356368804405756,593,432,1025,-
chr5,40826955,1.8645276310237846,806,650,1456,-
chr5,40827194,1.5741364096865906,982,826,1808,-
chr5,40827207,1.862351429489239,772,565,1337,-
chr5,40827274,1.5398121464403889,1418,1040,2458,-
chr5,40827639,3.066427289048474,731,556,1287,-
chr5,40827762,2.5021647661442774,1108,712,1820,-
chr5,40827797,1.6345015930814748,797,675,1472,-
chr5,40827802,1.9292219204345742,689,568,1257,-
chr5,40827839,1.7539202888317593,1695,1240,2935,-
chr5,40827841,1.3419441090219075,840,681,1521,-
chr5,40827842,1.348369119496364,702,553,1255,-
chr5,40834574,0.8901848695693121,39717,29700,69417,-
chr5,40834622,1.1789111786462982,73076,52600,125676,-
chr5,40834638,1.537276589689596,20543,17634,38177,-
chr5,40834671,1.1345798362898551,44185,31355,75540,-
chr5,40834674,0.964559969608097,71581,56623,128204,-
chr5,40834675,1.0176898594877617,39521,29939,69460,-
chr5,40835292,0.8009585264806558,21303,15447,36750,-
chr5,40835293,0.8405481472873872,52919,42222,95141,-
chr5,40835294,0.9522017642759948,34454,32298,66752,-
chr5,40835295,0.8891972788854137,26359,25072,51431,-
chr5,40835296,0.9191158659776276,26372,23656,50028,-
chr5,40835305,0.740820888132825,4084,4066,8150,-
chr5,40835308,0.8206838116654043,5871,6093,11964,-
chr5,40835310,0.8206838116654043,5871,6093,11964,-
chr5,40835311,1.0339389670711532,7366,5059,12425,-
chr5,40835312,1.4687489678888586,6110,5596,11706,-
chr5,40835313,0.9006217739447459,26919,21887,48806,-
chr5,40835315,1.0508443457441408,25320,21606,46926,-
chr5,40835316,0.9869366638616722,14514,12491,27005,-
chr5,40835327,1.618580337490829,665,463,1128,-
chr5,40835339,0.5770173835330494,2716,1932,4648,-
chr5,40835341,0.749636670967341,2876,2143,5019,-
chr5,40835342,1.0172613854820367,923,783,1706,-
chr5,41739517,2.038191447659951,1165,867,2032,-
chr5,41739518,1.503564251299595,1141,990,2131,-
chr5,41762268,3.0297779284239184,736,515,1251,-
chr5,41861474,1.1658295173805,617,482,1099,-
chr5,41862842,2.2590672986156757,611,459,1070,-
chr5,43289705,1.492935712882678,6864,3393,10257,-
chr5,43289706,1.492935712882678,6864,3393,10257,-
chr5,43289707,1.492935712882678,6864,3393,10257,-
chr5,43289717,1.7774050508956325,5898,4630,10528,-
chr5,43289718,1.7774050508956325,5898,4630,10528,-
chr5,43290110,0.5857619914996964,680,548,1228,-
chr5,43290172,5.169480257127694,577,514,1091,-
chr5,43290406,2.30830164765526,704,525,1229,-
chr5,43290408,2.30830164765526,704,525,1229,-
chr5,43290707,2.7025307302964574,583,460,1043,-
chr5,43291054,1.7835760046592897,527,504,1031,-
chr5,43291163,0.3382142634954597,2126,3925,6051,-
chr5,43291164,0.34960238767373775,1816,3163,4979,-
chr5,43291165,0.34960238767373775,1816,3163,4979,-
chr5,43291174,10.07286995469821,1631,2702,4333,-
chr5,43291175,9.416604528065724,1444,2456,3900,-
chr5,43291180,7.861039569357478,1250,1135,2385,-
chr5,43291181,9.81395641100047,2564,2009,4573,-
chr5,43291182,9.81395641100047,2564,2009,4573,-
chr5,43291183,11.999512987012988,1564,1076,2640,-
chr5,43291187,97.71292759528053,1536,147,1683,-
chr5,43291188,123.16486899182152,1796,163,1959,-
chr5,43291189,143.51132686084142,1266,102,1368,-
chr5,43291190,60.736559139784944,1026,61,1087,-
chr5,43292622,2.061096256684492,570,439,1009,-
chr5,43292683,3.02444652228992,823,717,1540,-
chr5,43292713,1.9390343091428677,876,761,1637,-
chr5,43293061,1.6479374999999996,798,639,1437,-
chr5,43297126,1.6516739801722735,766,585,1351,-
chr5,43297186,1.731974921630094,662,521,1183,-
chr5,43298144,1.2650155121556992,789,575,1364,-
chr5,43298199,0.4938695127374373,597,476,1073,-
chr5,43298650,3.1869515886212527,1005,676,1681,-
chr5,43298748,0.8456349594290742,1037,578,1615,-
chr5,43298749,0.7138702887718206,1952,1144,3096,-
chr5,43298930,0.9857038790748496,865,577,1442,-
chr5,43298931,0.9857038790748496,865,577,1442,-
chr5,43298955,1.7202561509942704,703,515,1218,-
chr5,43445654,3.306291735179477,715,481,1196,-
chr5,43445655,3.221411192214112,661,410,1071,-
chr5,43527341,1.7787644058190064,1344,947,2291,-
chr5,43527343,1.7787644058190064,1344,947,2291,-
chr5,43527364,1.3556306056858005,727,428,1155,-
chr5,43536972,2.907251602564102,630,415,1045,-
chr5,43536978,2.3830477072718854,734,380,1114,-
chr5,43536981,2.196883852691218,704,352,1056,-
chr5,43539088,1.6307995331797138,2541,1867,4408,-
chr5,43539107,0.5814410380591218,706,508,1214,-
chr5,43539112,1.6674380165289258,775,604,1379,-
chr5,43555966,0.5676167502486299,1072,800,1872,-
chr5,43555997,0.6727046790613201,1125,685,1810,-
chr5,43555998,1.9244239631336408,695,464,1159,-
chr5,43556006,1.8657458563535911,920,542,1462,-
chr5,43556950,6.696344986797927,1039,771,1810,-
chr5,43556952,6.436489375296535,712,494,1206,-
chr5,43575450,3.47081898711868,1049,797,1846,-
chr5,43575452,3.47081898711868,1049,797,1846,-
chr5,52403006,1.4919065588782887,1011,727,1738,-
chr5,52403007,0.7562577447335811,717,537,1254,-
chr5,52404399,1.5802149830218981,1050,743,1793,-
chr5,52404401,1.5551263164208176,989,758,1747,-
chr5,60454900,2.214814814814815,597,413,1010,-
chr5,60455066,2.625,623,511,1134,-
chr5,60455068,2.625,623,511,1134,-
chr5,60456954,1.3623171153500755,572,445,1017,-
chr5,60457042,1.5433648346883642,963,665,1628,-
chr5,61684864,2.2636436392397887,629,399,1028,-
chr5,61694487,3.3102200489144686,744,542,1286,-
chr5,64825000,2.4821501814766873,614,528,1142,-
chr5,64838673,0.39561722347725015,866,605,1471,-
chr5,64857301,1.1032704402515725,536,529,1065,-
chr5,64857302,1.1032704402515725,536,529,1065,-
chr5,68647990,2.055215558275534,1888,1418,3306,-
chr5,68647992,1.9062435528838346,3519,2597,6116,-
chr5,68647993,1.6694191343963554,1803,1316,3119,-
chr5,68660862,2.814663951120163,690,490,1180,-
chr5,68660988,2.307443365695793,712,617,1329,-
chr5,68661000,1.6931137724550895,782,500,1282,-
chr5,68661380,1.6937669376693767,1124,737,1861,-
chr5,68661476,1.7956647398843932,980,691,1671,-
chr5,68661477,2.095081967213115,567,487,1054,-
chr5,68661511,3.477901894123361,1847,1135,2982,-
chr5,68661512,3.477901894123361,1847,1135,2982,-
chr5,68662388,1.1011787267586253,4264,2767,7031,-
chr5,68662389,0.9014234389922234,3196,1998,5194,-
chr5,68662397,1.930005737234653,840,580,1420,-
chr5,68662401,2.819889502762431,791,542,1333,-
chr5,68662403,1.796490415242949,939,556,1495,-
chr5,68662406,0.6850702751196173,893,607,1500,-
chr5,68662417,1.9270468661773008,631,384,1015,-
chr5,70351209,1.4614855939425344,803,571,1374,-
chr5,70351210,1.418212838558328,797,520,1317,-
chr5,71515523,2.4166666666666665,715,536,1251,-
chr5,71515531,2.0741428259445294,654,481,1135,-
chr5,71515546,2.86281179138322,605,440,1045,-
chr5,71515850,2.090752808552909,781,575,1356,-
chr5,71515922,2.4361948955916475,629,430,1059,-
chr5,71515924,2.4169898137297454,1024,731,1755,-
chr5,71516624,2.456793184048982,681,453,1134,-
chr5,71516850,1.943584993052339,831,566,1397,-
chr5,71516896,0.5039086821169146,606,412,1018,-
chr5,71533883,0.5191072219760744,720,487,1207,-
chr5,71593503,0.7884516511765869,2463,1944,4407,-
chr5,71593505,0.660022411699758,4445,3428,7873,-
chr5,71593506,0.6304202655540173,2102,1723,3825,-
chr5,71593507,1.6478133947117275,994,757,1751,-
chr5,71593508,0.515218908076051,694,587,1281,-
chr5,71593511,0.4647367605470112,1370,1243,2613,-
chr5,71593513,0.4647367605470112,1370,1243,2613,-
chr5,71593514,1.6816239316239316,786,571,1357,-
chr5,71593516,0.552972972972973,557,554,1111,-
chr5,72851321,2.6389322383358205,1044,885,1929,-
chr5,72851328,1.8970757914046557,1240,995,2235,-
chr5,72851329,1.9283302305709062,1721,1373,3094,-
chr5,72851331,2.553907450076805,1281,991,2272,-
chr5,72851333,2.505216095380029,819,609,1428,-
chr5,72861308,3.278753993610224,820,625,1445,-
chr5,72861310,3.278753993610224,820,625,1445,-
chr5,72861316,1.898567398172926,689,460,1149,-
chr5,74018336,1.0997899159663866,697,407,1104,-
chr5,74018338,1.0997899159663866,697,407,1104,-
chr5,74056745,1.2818747955133785,995,680,1675,-
chr5,74056747,0.9373728123728126,736,467,1203,-
chr5,74096838,4.106942980915583,585,437,1022,-
chr5,76987211,1.7871855765036593,1249,877,2126,-
chr5,77004162,0.7142927405075743,1544,1195,2739,-
chr5,77072046,1.5706337389591054,2805,1822,4627,-
chr5,77072047,1.5791263442248544,5054,3695,8749,-
chr5,77072052,1.5753219526804434,1051,847,1898,-
chr5,77072053,1.085088687827331,2185,1583,3768,-
chr5,77072060,1.5786458333333335,865,639,1504,-
chr5,77072072,4.764806435394671,1101,764,1865,-
chr5,77072082,1.835605765485002,588,452,1040,-
chr5,77072095,1.7139567219953074,1126,621,1747,-
chr5,77072126,2.466377708978328,765,474,1239,-
chr5,77072134,1.9481470032303552,2278,1289,3567,-
chr5,77072135,1.8444538886527837,1239,723,1962,-
chr5,77072157,2.8724696356275303,730,441,1171,-
chr5,77072159,0.9337712012922691,1074,632,1706,-
chr5,77072160,0.8997720169626937,1118,596,1714,-
chr5,77409612,0.6463160719355816,595,536,1131,-
chr5,77409614,0.6463160719355816,595,536,1131,-
chr5,81571949,2.006485714285714,11015,8749,19764,-
chr5,81571950,2.006485714285714,11015,8749,19764,-
chr5,81571958,1.3379116007071945,5827,4084,9911,-
chr5,81571961,1.4362151303826054,9732,6749,16481,-
chr5,81571970,1.419632793126769,4722,3070,7792,-
chr5,81572262,1.3115002815765795,32453,21852,54305,-
chr5,81572274,1.1999252238317275,67420,44846,112266,-
chr5,81572275,1.2563181880307277,65768,44294,110062,-
chr5,81572280,1.3498755495867996,35096,23514,58610,-
chr5,81573633,1.3640557846752743,47004,34296,81300,-
chr5,81573644,1.201107967663838,27917,20722,48639,-
chr5,81574141,1.3447855803039843,11515,8540,20055,-
chr5,81574144,1.3350324767602506,18419,12008,30427,-
chr5,81574161,1.255935987140591,5742,2972,8714,-
chr5,81574163,1.4918154049968233,6347,4335,10682,-
chr5,81574166,1.640802910563074,4839,2352,7191,-
chr5,81574168,1.3085387348067898,3721,2518,6239,-
chr5,81574169,0.9546620495307528,25016,14388,39404,-
chr5,81574170,0.9305603998645747,24990,13988,38978,-
chr5,81574171,0.9250106514713207,20425,10912,31337,-
chr5,81574172,0.8715292346138664,19736,10561,30297,-
chr5,81574173,0.9149428777049798,11073,5850,16923,-
chr5,81574174,0.9305191554945327,11111,6296,17407,-
chr5,81574175,0.8733024089810557,1605,1015,2620,-
chr5,81574179,2.443018038360264,780,491,1271,-
chr5,81574201,0.6882282006915258,617,420,1037,-
chr5,82350006,1.081773325156589,589,413,1002,-
chr5,82350924,0.529485834207765,956,952,1908,-
chr5,82350925,1.6248275862068966,805,724,1529,-
chr5,82350961,1.982517865687426,897,712,1609,-
chr5,82350979,1.9872680252645711,732,619,1351,-
chr5,82352613,1.5543713399253922,1682,1209,2891,-
chr5,82352779,1.841201716738197,626,465,1091,-
chr5,82352865,2.1601435849930524,1434,1015,2449,-
chr5,82357717,1.175213590585439,1148,762,1910,-
chr5,83236752,1.298705081662282,2252,1679,3931,-
chr5,83236872,1.950075918615244,1395,889,2284,-
chr5,83236917,1.9701960784313726,627,449,1076,-
chr5,83237015,1.852060707323865,718,531,1249,-
chr5,83237375,1.1283198539050636,2404,1607,4011,-
chr5,83237819,1.6295264623955432,974,717,1691,-
chr5,83237965,0.6488407188914803,1390,984,2374,-
chr5,83238103,2.314647377938517,759,552,1311,-
chr5,83238175,1.791005291005291,676,503,1179,-
chr5,83238239,2.270443251941303,1833,1246,3079,-
chr5,83238302,1.8140522875816996,853,679,1532,-
chr5,83239127,2.4166354115912814,1133,820,1953,-
chr5,83239130,1.8458001768346597,613,389,1002,-
chr5,83239225,2.485630734290942,2082,1583,3665,-
chr5,83239226,2.8869034406215315,702,529,1231,-
chr5,83239227,2.100508905852417,761,654,1415,-
chr5,83239348,1.7877289909857514,635,542,1177,-
chr5,83239354,4.017080745341615,596,482,1078,-
chr5,83259094,1.9619137977771757,578,433,1011,-
chr5,83259167,1.5269528501055598,1141,869,2010,-
chr5,83259170,1.5015316541865216,864,564,1428,-
chr5,83356130,1.909911894273128,597,453,1050,-
chr5,83356222,1.7664423253393875,1442,1132,2574,-
chr5,83360603,1.0309573361082205,2641,1921,4562,-
chr5,83360605,1.0309573361082205,2641,1921,4562,-
chr5,83360645,2.0685126914201803,1048,680,1728,-
chr5,83402490,0.684560327198364,1338,977,2315,-
chr5,83402606,2.811601997694967,850,684,1534,-
chr5,83433071,2.253952827720256,1339,862,2201,-
chr5,83433167,1.5911067556807743,837,562,1399,-
chr5,83476249,0.4968261108611986,993,701,1694,-
chr5,83476250,2.002096875655273,681,501,1182,-
chr5,83549993,2.029624143677097,755,490,1245,-
chr5,83680193,0.9004815409309791,764,533,1297,-
chr5,83680194,0.9004815409309791,764,533,1297,-
chr5,83680202,2.1410027505670026,751,390,1141,-
chr5,83680203,2.1410027505670026,751,390,1141,-
chr5,86690298,1.627912087912088,822,519,1341,-
chr5,86697523,1.836103079471128,1614,1453,3067,-
chr5,86697551,1.8619164619164617,1262,769,2031,-
chr5,86708683,0.2824534152972992,669,545,1214,-
chr5,89695343,2.3420020385398153,939,682,1621,-
chr5,90604113,2.3153854134246292,825,550,1375,-
chr5,90604573,3.2826025966807872,587,417,1004,-
chr5,90605672,2.159610705596107,633,410,1043,-
chr5,90605674,2.159610705596107,633,410,1043,-
chr5,93018888,4.905716093651129,801,430,1231,-
chr5,93018901,0.32158048305994225,713,550,1263,-
chr5,94803575,2.367837923393479,934,485,1419,-
chr5,94803576,2.6517542235126,1747,979,2726,-
chr5,94803577,2.96,813,494,1307,-
chr5,94848274,2.5976553850102464,695,472,1167,-
chr5,95149822,2.320585664335664,776,623,1399,-
chr5,95150055,0.5608667941363926,769,522,1291,-
chr5,95150061,0.5286113536353899,1315,900,2215,-
chr5,95152279,0.6508708464100045,848,622,1470,-
chr5,95158397,0.9683693700077618,1807,1524,3331,-
chr5,95221801,1.6951095746790912,879,640,1519,-
chr5,95222066,2.1065634218289087,590,451,1041,-
chr5,95222146,1.4165492739458143,1035,692,1727,-
chr5,95223349,2.1594202898550727,744,551,1295,-
chr5,95223350,2.1594202898550727,744,551,1295,-
chr5,95223570,5.555035128805621,592,426,1018,-
chr5,95223579,2.3993171416761148,846,678,1524,-
chr5,95223582,1.6972236773179676,1199,829,2028,-
chr5,95223979,1.826086956521739,698,465,1163,-
chr5,95223986,0.6690248503773094,1326,1007,2333,-
chr5,95224015,3.6864668452967,781,535,1316,-
chr5,95224316,1.457932113625421,1274,803,2077,-
chr5,95224338,4.906380511246449,560,447,1007,-
chr5,95226818,4.570081967213115,825,487,1312,-
chr5,95226820,4.570081967213115,825,487,1312,-
chr5,95226972,1.6930817610062894,672,529,1201,-
chr5,95226973,1.2035738832378695,1999,1481,3480,-
chr5,95234210,1.7486691236691236,588,443,1031,-
chr5,95234285,0.5972826086956522,784,574,1358,-
chr5,95236772,0.7165314401622718,1412,985,2397,-
chr5,95242337,1.758454106280193,818,620,1438,-
chr5,95249506,1.6162633190055142,2463,1536,3999,-
chr5,95249507,1.1876299105823007,4107,2469,6576,-
chr5,95249510,1.0710830318139521,3665,2361,6026,-
chr5,95249512,1.4456306677658701,2062,1212,3274,-
chr5,95249599,0.5574200634610691,608,481,1089,-
chr5,95255197,1.7685630868776139,722,550,1272,-
chr5,95297295,0.41909808390323977,861,725,1586,-
chr5,95297353,1.6043189368770765,438,601,1039,-
chr5,95297355,2.3899223032941683,717,913,1630,-
chr5,95297393,4.753483897193845,598,548,1146,-
chr5,95297401,32.34944099545914,803,547,1350,-
chr5,95297402,40.006107464631974,1076,676,1752,-
chr5,95297403,40.006107464631974,1076,676,1752,-
chr5,95297404,40.3195434950537,808,466,1274,-
chr5,98215386,1.6736008241840312,1247,815,2062,-
chr5,98215394,4.433889602053915,941,778,1719,-
chr5,98215395,4.433889602053915,941,778,1719,-
chr5,98215415,2.657021276595745,668,469,1137,-
chr5,98215417,2.657021276595745,668,469,1137,-
chr5,112214359,0.463203803509161,827,594,1421,-
chr5,112214399,1.1465310315209565,9379,6550,15929,-
chr5,112214402,0.6051282051282051,1179,659,1838,-
chr5,112214405,0.562909209951986,1085,631,1716,-
chr5,112214421,1.5909809183064996,2602,1559,4161,-
chr5,112214423,0.4835737875890839,855,522,1377,-
chr5,112214440,2.373489657997133,1716,1027,2743,-
chr5,112214451,1.5484369211752922,4225,2681,6906,-
chr5,112214492,1.9864118464301448,3781,2185,5966,-
chr5,112214493,1.9120180610656905,5567,3182,8749,-
chr5,112214495,1.8465225081303132,3653,2061,5714,-
chr5,112222715,1.8161465388817095,39309,27161,66470,-
chr5,112222716,1.8161465388817095,39309,27161,66470,-
chr5,112222717,1.8930198821147155,29045,20301,49346,-
chr5,112222719,1.9871073259203187,9650,7093,16743,-
chr5,112222720,1.8886660909421689,10802,7209,18011,-
chr5,112222725,1.9731643092456597,7059,4386,11445,-
chr5,112222728,1.5526631623288005,6501,3930,10431,-
chr5,112222730,1.581039909877245,8989,5257,14246,-
chr5,112222779,1.7048663393344243,1516,1174,2690,-
chr5,112222780,1.6556756756756756,1020,499,1519,-
chr5,112222783,1.4301075268817205,1385,1022,2407,-
chr5,112222788,2.007792207792208,772,384,1156,-
chr5,112222797,2.3451519154557463,1137,756,1893,-
chr5,112222821,1.824960338445267,985,609,1594,-
chr5,112238080,4.0242600654308,1631,1114,2745,-
chr5,112238086,0.4398798962740548,585,430,1015,-
chr5,114949458,2.494195688225539,892,602,1494,-
chr5,114950024,2.9482013746219975,1508,967,2475,-
chr5,114950026,2.186021505376344,855,495,1350,-
chr5,114950609,2.3943711763881756,745,480,1225,-
chr5,114950900,0.6080260847755204,712,442,1154,-
chr5,114951738,1.2502276010026372,919,634,1553,-
chr5,114952091,2.9476677737252674,983,721,1704,-
chr5,114961317,1.8431313357321093,816,595,1411,-
chr5,115177088,1.4251802453915325,609,439,1048,-
chr5,115387597,0.5941163627388626,1646,1042,2688,-
chr5,115387605,1.552826466315851,1551,1097,2648,-
chr5,115387607,1.6011276035323252,2881,1978,4859,-
chr5,115387616,1.6900016471750947,683,466,1149,-
chr5,122361547,2.1475107381111336,741,543,1284,-
chr5,122365074,1.3300612158739096,704,512,1216,-
chr5,122365083,0.32703933747412,717,482,1199,-
chr5,122365085,0.32703933747412,717,482,1199,-
chr5,125885684,2.059748427672956,654,476,1130,-
chr5,125885899,0.5880968493753872,1588,968,2556,-
chr5,125894951,2.7621326660335646,1199,953,2152,-
chr5,125894952,2.633030852994555,557,550,1107,-
chr5,125912838,0.2971909366421361,579,441,1020,-
chr5,125929093,1.2737364884604148,762,488,1250,-
chr5,125929094,1.6668910756563782,1353,1066,2419,-
chr5,125930702,3.737559719292718,657,488,1145,-
chr5,127594517,1.5525114155251138,934,656,1590,-
chr5,127594521,2.007792207792208,772,538,1310,-
chr5,127594524,1.030438583818668,939,763,1702,-
chr5,127594538,0.288578589330469,805,531,1336,-
chr5,127594539,0.288578589330469,805,531,1336,-
chr5,127597477,0.32213985105916954,593,467,1060,-
chr5,127664183,1.857967626080015,796,627,1423,-
chr5,127664488,2.167300380228137,683,525,1208,-
chr5,127668711,0.49215805471124613,758,524,1282,-
chr5,127670939,0.584509591024249,849,613,1462,-
chr5,127670972,0.5823754789272031,759,521,1280,-
chr5,127670973,1.8249617820484825,618,481,1099,-
chr5,127671201,1.802477824562255,1687,1350,3037,-
chr5,127671202,1.802477824562255,1687,1350,3037,-
chr5,127671753,1.7173584271551001,729,540,1269,-
chr5,127671767,1.6535172413793104,665,499,1164,-
chr5,127671773,2.098883572567783,610,428,1038,-
chr5,127671798,1.884521857697483,872,588,1460,-
chr5,127671799,0.610944976076555,680,531,1211,-
chr5,127671803,1.5148830479919821,618,469,1087,-
chr5,127681057,1.6209301405435033,797,616,1413,-
chr5,127681141,1.0698050080354764,1035,859,1894,-
chr5,127681142,0.8335648148148148,830,575,1405,-
chr5,127704996,0.4666227492314449,624,505,1129,-
chr5,127704998,0.949375692590801,952,742,1694,-
chr5,127714564,3.184357541899441,683,536,1219,-
chr5,127727820,0.20500063711445723,595,734,1329,-
chr5,127727828,0.42431638429655383,1600,1923,3523,-
chr5,127727846,0.43263064296209996,866,1361,2227,-
chr5,127728831,0.40432078901448154,782,1294,2076,-
chr5,127728846,16.48365456658232,1804,2826,4630,-
chr5,127728847,16.483654566582317,1804,2826,4630,-
chr5,127728852,9.256581802702572,1963,1907,3870,-
chr5,127728853,10.000050001995929,3077,2457,5534,-
chr5,127728854,10.000050001995929,3077,2457,5534,-
chr5,127728855,11.003914736848476,2163,1503,3666,-
chr5,127729057,2.0118133235408524,868,722,1590,-
chr5,127729058,1.9979965224753404,1139,908,2047,-
chr5,127855050,2.290411715943631,613,516,1129,-
chr5,127863579,2.615411806291976,1056,860,1916,-
chr5,127863580,2.55639250477517,1464,1130,2594,-
chr5,127873671,1.1030751334209343,759,528,1287,-
chr5,130498302,0.8627634638873619,7561,5502,13063,-
chr5,130500821,1.2317725939656852,6371,4922,11293,-
chr5,130500822,1.290380009477823,3904,2394,6298,-
chr5,130500879,1.6127937550784075,3673,2885,6558,-
chr5,130500892,1.2825089240183585,1508,1112,2620,-
chr5,130500893,1.378469096909691,2013,1110,3123,-
chr5,130500899,1.3536285936285937,1795,974,2769,-
chr5,130500945,0.6593139898608565,977,507,1484,-
chr5,130500948,0.594647201946472,751,410,1161,-
chr5,130500952,0.4326974600793055,849,601,1450,-
chr5,130500953,0.8576751592356687,1145,627,1772,-
chr5,130500954,0.6664220047425815,1994,1228,3222,-
chr5,131530698,5.036969113115729,647,390,1037,-
chr5,133291304,0.559508124725516,636,494,1130,-
chr5,133291306,3.6272692429936244,679,518,1197,-
chr5,133291486,2.2473416023040214,839,546,1385,-
chr5,133292248,2.383263295895635,926,704,1630,-
chr5,133292299,2.2781783681214423,666,464,1130,-
chr5,133292411,2.6249407894308643,1450,941,2391,-
chr5,133292413,2.760401096163428,1080,668,1748,-
chr5,133295297,2.1871195734469286,723,479,1202,-
chr5,133307840,2.082902016776727,1372,861,2233,-
chr5,133307841,1.416500994035785,1249,1005,2254,-
chr5,133307888,3.359375,816,607,1423,-
chr5,133307985,2.022312373225152,996,679,1675,-
chr5,133308020,0.5342539648289999,1237,712,1949,-
chr5,133308209,0.6479511426319937,1429,1079,2508,-
chr5,133308243,2.990165631469979,1089,919,2008,-
chr5,133308390,1.5021791767554478,1055,825,1880,-
chr5,133308428,1.857728103616776,1588,1123,2711,-
chr5,133308436,1.9425863991081385,764,597,1361,-
chr5,133308550,1.6055330490405118,2062,1339,3401,-
chr5,133309502,1.532868921702632,2548,1783,4331,-
chr5,133309529,2.105608258928572,773,511,1284,-
chr5,133309530,1.700172562553926,562,487,1049,-
chr5,133309531,1.7931658291457289,810,397,1207,-
chr5,133309537,3.0775752437473507,725,336,1061,-
chr5,133311568,4.629870129870129,712,307,1019,-
chr5,133316602,1.635244099105703,1143,717,1860,-
chr5,133326742,1.784255265630433,2318,1710,4028,-
chr5,133326744,1.421387871244318,3372,2496,5868,-
chr5,133328663,2.045099431818182,885,703,1588,-
chr5,133328673,1.252677022848956,962,595,1557,-
chr5,133340339,2.273271834191925,574,490,1064,-
chr5,133340340,2.273271834191925,574,490,1064,-
chr5,133340371,3.4469392298131205,759,507,1266,-
chr5,133340399,2.61151570323168,674,337,1011,-
chr5,133492913,2.847241867043847,670,403,1073,-
chr5,133492914,2.847241867043847,670,403,1073,-
chr5,133492981,2.644096458851086,812,643,1455,-
chr5,133492997,3.310279714616449,666,426,1092,-
chr5,133492998,3.310279714616449,666,426,1092,-
chr5,133493343,1.8769681033078114,6478,4274,10752,-
chr5,133493345,1.807379167743603,4717,2967,7684,-
chr5,133496765,1.750522544042998,1574,1181,2755,-
chr5,133496795,1.640433489215526,2988,2192,5180,-
chr5,133496798,2.209295352323838,1227,804,2031,-
chr5,133512557,1.4307728144990592,2457,1909,4366,-
chr5,133512562,0.57496318685577,1186,758,1944,-
chr5,133512619,1.7716400509859918,1277,883,2160,-
chr5,133512626,1.5283295714074603,1252,869,2121,-
chr5,133512628,2.3971426738938217,1428,928,2356,-
chr5,133512634,2.007787274453941,681,350,1031,-
chr5,133512636,1.9604211087420045,938,468,1406,-
chr5,133512638,1.886535933595389,859,439,1298,-
chr5,133532939,1.6055850372996565,2747,2091,4838,-
chr5,133533039,1.738695652173913,1332,919,2251,-
chr5,133533154,2.360230547550432,909,693,1602,-
chr5,133533447,1.7930024013837347,5751,5263,11014,-
chr5,133533450,1.7630211178573105,5509,4865,10374,-
chr5,133533453,1.7737808115282516,5177,4394,9571,-
chr5,133533456,1.6857155438838092,4766,3803,8569,-
chr5,133533461,1.776931216931217,4197,3149,7346,-
chr5,133533472,1.2937837015058435,12720,8219,20939,-
chr5,133533473,1.242552089892672,9346,5809,15155,-
chr5,133533485,1.9703593049768064,2637,1816,4453,-
chr5,133533491,1.5950587437534087,6095,3523,9618,-
chr5,133533492,1.4956031949381632,8454,5032,13486,-
chr5,133534859,0.6607238366910323,1198,868,2066,-
chr5,133536081,2.730593607305936,571,437,1008,-
chr5,133536098,0.5893546867640131,781,578,1359,-
chr5,133536135,1.6234304289629675,848,540,1388,-
chr5,133536160,0.5683364047579159,770,634,1404,-
chr5,133536760,1.2035762589393082,2411,1868,4279,-
chr5,133537700,1.847152273111374,2023,1939,3962,-
chr5,133537707,1.6461448751951544,1861,1610,3471,-
chr5,133541615,1.584526643120393,3114,2441,5555,-
chr5,133541617,1.584526643120393,3114,2441,5555,-
chr5,133541636,1.609891569465575,1281,962,2243,-
chr5,133561478,1.2757745718046858,860,705,1565,-
chr5,133561533,0.366373495460365,518,561,1079,-
chr5,133561555,5.097263759399228,589,551,1140,-
chr5,133561558,6.62419752099173,777,679,1456,-
chr5,133561702,2.8710220318237454,694,343,1037,-
chr5,133561703,2.8710220318237454,694,343,1037,-
chr5,133738426,0.37178907094845054,732,542,1274,-
chr5,133942404,1.7231584669747213,817,565,1382,-
chr5,133942569,2.1204819277108435,703,497,1200,-
chr5,133944177,2.3274389510405387,690,488,1178,-
chr5,133956629,2.123844731977819,765,540,1305,-
chr5,133956630,2.123844731977819,765,540,1305,-
chr5,133956663,2.0226467974260522,1061,833,1894,-
chr5,134670291,2.083265987004131,831,584,1415,-
chr5,134670473,2.1551116333725027,785,554,1339,-
chr5,134679039,3.7328224474549385,870,587,1457,-
chr5,134679085,1.557772556555228,976,712,1688,-
chr5,137088392,0.6104194119485368,2797,3677,6474,-
chr5,137088426,0.4915227291855648,1167,1752,2919,-
chr5,137088430,0.2401209123385545,513,1212,1725,-
chr5,137088443,0.2995279666061679,2574,5757,8331,-
chr5,137088444,0.2909584779367842,3635,8084,11719,-
chr5,137088446,0.3166829942296693,2045,3866,5911,-
chr5,137088447,2.071821309905287,1863,3676,5539,-
chr5,137088448,9.104303593056116,1013,2476,3489,-
chr5,137088449,9.914134231555881,6739,11186,17925,-
chr5,137088450,10.098853504721538,7950,11153,19103,-
chr5,137088451,12.441068270808126,9297,10452,19749,-
chr5,137088452,13.740284627806442,7328,6202,13530,-
chr5,137088453,15.228137754561695,5431,3560,8991,-
chr5,137088456,42.4472584649178,4713,565,5278,-
chr5,137088457,42.4472584649178,4713,565,5278,-
chr5,137088458,47.67437678676417,3835,450,4285,-
chr5,137088464,11.079129850397948,2027,301,2328,-
chr5,137088465,9.032392904896627,1450,239,1689,-
chr5,137088479,0.1948616600790513,985,183,1168,-
chr5,137088481,0.17656344722228953,1328,302,1630,-
chr5,137088501,8.967804783660277,3392,1015,4407,-
chr5,137088502,8.767888187693496,2879,887,3766,-
chr5,137088677,0.6487941429801894,654,515,1169,-
chr5,137088684,3.9177148846960166,597,476,1073,-
chr5,137088697,1.9882653828794945,825,577,1402,-
chr5,137088709,1.272387333734588,941,739,1680,-
chr5,137088826,1.5366300366300365,838,559,1397,-
chr5,137088829,0.5439716312056737,766,479,1245,-
chr5,137088849,3.926741730938951,919,713,1632,-
chr5,137088858,6.8707369401011364,882,613,1495,-
chr5,137088920,3.0528213159384796,1228,840,2068,-
chr5,137088921,3.987041999669484,1633,1178,2811,-
chr5,137089037,5.25963149078727,627,596,1223,-
chr5,137089146,4.603328479544844,791,492,1283,-
chr5,137089148,3.47930029154519,662,342,1004,-
chr5,137089149,4.684954667107466,853,583,1436,-
chr5,137089157,8.4070698861629,577,480,1057,-
chr5,137089345,2.2565055762081783,606,537,1143,-
chr5,137089381,0.5962692967409948,926,703,1629,-
chr5,137089396,1.680333778535403,1524,1099,2623,-
chr5,137089403,1.6132132132132129,947,554,1501,-
chr5,137089440,1.9138663967611336,572,493,1065,-
chr5,137089442,1.670226359985396,630,497,1127,-
chr5,137089466,1.4291271814948656,1527,1035,2562,-
chr5,137089467,1.1713964734039957,1141,693,1834,-
chr5,137089471,3.2401960784313726,660,560,1220,-
chr5,137089472,3.2401960784313726,660,560,1220,-
chr5,137089529,2.197041227593626,630,478,1108,-
chr5,137089634,1.6792514558659948,801,492,1293,-
chr5,137089678,1.7172897196261685,783,427,1210,-
chr5,137089708,1.890554365929098,547,466,1013,-
chr5,137089712,0.23932292182976253,1205,883,2088,-
chr5,137089733,0.5716473140232231,639,460,1099,-
chr5,137089748,0.8507126781695424,755,601,1356,-
chr5,137089749,0.693123290004672,1264,993,2257,-
chr5,137089993,9.900235285356183,1183,770,1953,-
chr5,137089996,10.688808332899992,1164,629,1793,-
chr5,137090002,9.551122169540879,1979,840,2819,-
chr5,137090003,10.405419730284555,2729,1194,3923,-
chr5,137090004,15.917737789203082,773,388,1161,-
chr5,137090005,11.588219951110824,1161,484,1645,-
chr5,137492808,3.354399611084103,689,362,1051,-
chr5,137501710,0.8226957076684683,654,529,1183,-
chr5,137528263,1.845036319612591,1777,979,2756,-
chr5,137528278,1.899740652690728,2881,1321,4202,-
chr5,137528279,1.948872065476361,5798,2391,8189,-
chr5,137528281,2.426599608829282,2713,1192,3905,-
chr5,137528285,1.7092732150228416,1619,705,2324,-
chr5,137528292,1.9160256410256407,2195,701,2896,-
chr5,137528294,1.8915503661720372,3178,1108,4286,-
chr5,137528315,0.5222960151802657,1100,475,1575,-
chr5,137533939,0.3730387653975396,762,395,1157,-
chr5,137843229,3.336454949042647,554,486,1040,-
chr5,137843654,3.149265905383361,857,612,1469,-
chr5,137843656,3.149265905383361,857,612,1469,-
chr5,137843776,0.3816290885995554,873,535,1408,-
chr5,137843777,0.3816290885995554,873,535,1408,-
chr5,137846781,1.082148715144888,608,471,1079,-
chr5,137846782,1.082148715144888,608,471,1079,-
chr5,137846813,1.9673314286217514,783,519,1302,-
chr5,137848604,1.036144578313253,730,580,1310,-
chr5,137848605,1.36084079712889,1006,797,1803,-
chr5,137853381,1.241007471928721,767,497,1264,-
chr5,137890936,1.0867997183613245,1049,868,1917,-
chr5,137890937,0.47345030900379964,1608,1049,2657,-
chr5,137890944,1.9407032442698344,1529,962,2491,-
chr5,137890945,2.1372545169124026,1720,1254,2974,-
chr5,137890947,3.7832072058577526,1296,1040,2336,-
chr5,137890948,2.563380281690141,587,496,1083,-
chr5,137890992,0.9151087431500378,813,510,1323,-
chr5,137890993,1.0958498658333995,877,565,1442,-
chr5,137890994,0.2857421875,626,383,1009,-
chr5,137891221,1.37171470444553,1958,1379,3337,-
chr5,137891266,1.992087254063302,2159,1335,3494,-
chr5,137891330,1.4627551020408165,1097,839,1936,-
chr5,137891655,1.5654292708147073,9634,7301,16935,-
chr5,137891749,0.7070546609863528,1631,1258,2889,-
chr5,137892185,2.25287119746429,2026,1428,3454,-
chr5,137895623,1.5689542847154911,1430,1338,2768,-
chr5,137895649,1.8517869423073734,3788,2714,6502,-
chr5,137896798,0.8855825647263876,569,453,1022,-
chr5,137897350,1.6074442508541222,1965,1446,3411,-
chr5,137897376,0.7680153116689055,9385,6733,16118,-
chr5,137897454,0.7538172535041663,1877,1596,3473,-
chr5,137897469,1.7082779570913234,1474,1144,2618,-
chr5,137902392,1.5250643646827202,1854,1490,3344,-
chr5,137902767,1.5734226689000557,1408,1193,2601,-
chr5,137903198,0.6259376326838704,2781,1926,4707,-
chr5,137903201,1.3891872424376672,6679,4771,11450,-
chr5,137903202,1.3891872424376672,6679,4771,11450,-
chr5,137903203,1.3891872424376672,6679,4771,11450,-
chr5,137903222,0.7945536022061358,2765,1933,4698,-
chr5,137903230,1.5280160284550097,1911,1325,3236,-
chr5,137903377,1.433892392977936,3760,2669,6429,-
chr5,137904667,1.8174299717349254,7972,4250,12222,-
chr5,137904720,1.0205635929696844,6554,4076,10630,-
chr5,137906709,0.7004503115168712,1513,1130,2643,-
chr5,137906720,1.9677655677655683,1263,909,2172,-
chr5,137906822,1.6311422120108598,3274,2090,5364,-
chr5,137909475,0.6102775079934961,1363,1006,2369,-
chr5,137909796,1.1084194454466492,2177,1521,3698,-
chr5,137909807,1.5298290873911642,592,442,1034,-
chr5,137909814,0.5933603238866396,686,474,1160,-
chr5,137911015,1.7576401179940997,930,564,1494,-
chr5,137911039,1.9996470588235293,738,424,1162,-
chr5,138362579,2.5821048022186543,609,526,1135,-
chr5,139682637,0.8290399301907968,792,809,1601,-
chr5,139682638,0.5557887759611136,558,619,1177,-
chr5,140025157,0.5040650406504066,867,573,1440,-
chr5,140025214,1.6370370370370368,948,656,1604,-
chr5,140025245,0.48074807480748083,873,605,1478,-
chr5,140026887,1.5502763977328389,632,460,1092,-
chr5,140026914,0.5455576559546313,887,459,1346,-
chr5,140026935,2.01980198019802,866,504,1370,-
chr5,140027193,0.1157258064516129,573,479,1052,-
chr5,140027212,0.6112914680832796,736,486,1222,-
chr5,140027215,0.681922700277636,736,602,1338,-
chr5,140057279,1.9972487398676808,892,577,1469,-
chr5,140698203,2.893953634085213,738,455,1193,-
chr5,140698209,2.1621621621621623,767,443,1210,-
chr5,140698256,1.5728239011778224,1459,943,2402,-
chr5,140698260,0.6960955456634954,2633,1808,4441,-
chr5,140698261,1.7971541042849768,2870,2383,5253,-
chr5,140698262,1.1692540673043075,6639,5008,11647,-
chr5,140698263,1.277834394166512,5227,4055,9282,-
chr5,140698343,1.7617200674536255,673,592,1265,-
chr5,140698489,0.6396586059743955,802,702,1504,-
chr5,140698583,2.037754719339917,651,420,1071,-
chr5,140698662,0.6526046229530292,1075,780,1855,-
chr5,140698668,1.710415412402167,946,754,1700,-
chr5,140698675,1.5697722567287782,891,551,1442,-
chr5,140698708,2.087114337568058,689,521,1210,-
chr5,140698731,2.779510022271715,571,448,1019,-
chr5,140698732,1.822710622710623,621,454,1075,-
chr5,140698897,1.8005628506202964,7036,5486,12522,-
chr5,140698905,1.5281812370273735,8859,6310,15169,-
chr5,140698907,1.010489856848643,5190,3417,8607,-
chr5,140698908,1.6816951889560643,3361,2464,5825,-
chr5,140698912,1.547121411644871,5983,4128,10111,-
chr5,140698913,1.3279962099920501,12728,8960,21688,-
chr5,140698916,1.4387755102040816,2609,1739,4348,-
chr5,140698937,1.7043671377422862,6000,4082,10082,-
chr5,140698946,1.5211966232543426,3254,1916,5170,-
chr5,140698993,2.064182634004366,1334,867,2201,-
chr5,140699034,0.632015065913371,838,530,1368,-
chr5,140699035,2.2535695115405256,655,404,1059,-
chr5,140699190,4.359528487229863,633,508,1141,-
chr5,140699410,2.027057926829269,590,491,1081,-
chr5,140699414,0.5465139642354833,951,710,1661,-
chr5,140699415,1.6393823695142817,1633,1175,2808,-
chr5,140699770,0.4736,813,624,1437,-
chr5,140700110,1.317966979398663,708,506,1214,-
chr5,140905957,2.8526330849381463,609,470,1079,-
chr5,140908033,1.7624894869638352,675,409,1084,-
chr5,140908034,0.5745995423340962,836,569,1405,-
chr5,140908310,0.9990338164251209,2067,1609,3676,-
chr5,140908311,0.8308917090304808,4581,3687,8268,-
chr5,140908312,0.8717587845513994,3480,2748,6228,-
chr5,140908327,1.6432700247729148,795,518,1313,-
chr5,141380979,13.512490847837688,495,546,1041,-
chr5,143539180,1.547771926405972,895,643,1538,-
chr5,143549506,1.742979653684046,740,534,1274,-
chr5,143549526,2.523282768261701,667,490,1157,-
chr5,143550151,4.200652744527967,843,605,1448,-
chr5,145502057,1.706982313927782,638,471,1109,-
chr5,145503604,0.6254960538636466,667,546,1213,-
chr5,145506068,2.709722623102533,744,507,1251,-
chr5,145523844,1.865937699044677,1136,660,1796,-
chr5,145523845,1.0519074421513448,840,450,1290,-
chr5,145531435,2.641686182669789,610,426,1036,-
chr5,145537327,2.5105964433692156,728,562,1290,-
chr5,145540002,2.2140191897654584,638,468,1106,-
chr5,145543988,2.14739336492891,590,421,1011,-
chr5,145544033,2.0511626710863893,891,598,1489,-
chr5,148875209,2.589166666666667,716,479,1195,-
chr5,148875211,2.1280340099069712,911,602,1513,-
chr5,148875851,0.5543226105784101,1061,847,1908,-
chr5,148876046,1.8681355665555035,1317,1014,2331,-
chr5,148876396,2.175438596491228,675,506,1181,-
chr5,148891385,1.652746212121212,562,439,1001,-
chr5,148892642,2.3076510027642327,948,763,1711,-
chr5,148929718,1.1688762626262623,528,527,1055,-
chr5,148929719,1.6371389186505736,945,839,1784,-
chr5,148930420,3.4282352941176466,563,509,1072,-
chr5,148930421,2.9574707188998044,927,788,1715,-
chr5,148930499,0.6178400133015316,1868,1194,3062,-
chr5,148930500,1.9099302082760892,992,586,1578,-
chr5,148930505,2.190815836997009,1657,1205,2862,-
chr5,148930508,1.7792004584002172,1547,1099,2646,-
chr5,148930521,2.056073153899241,700,482,1182,-
chr5,148930539,2.364607170099161,774,455,1229,-
chr5,148930541,2.364607170099161,774,455,1229,-
chr5,148930559,3.0859263516028625,1338,1065,2403,-
chr5,148930560,3.350548109914054,989,871,1860,-
chr5,149823880,1.574762661263709,10862,6681,17543,-
chr5,149825176,1.1385169185304973,25860,18436,44296,-
chr5,149825185,1.25866125285494,6175,4656,10831,-
chr5,149825248,0.5387433043640152,1331,876,2207,-
chr5,149826370,0.9943063917552952,22691,15020,37711,-
chr5,149826372,1.4717725292364137,8022,6229,14251,-
chr5,149826394,1.53029823374776,15879,11754,27633,-
chr5,149826396,1.53029823374776,15879,11754,27633,-
chr5,149827195,1.3116976673000436,26858,16941,43799,-
chr5,149827263,1.1292918708730415,9748,8284,18032,-
chr5,149827271,1.116346383514646,13844,9449,23293,-
chr5,149827297,1.5235756749617861,62881,38964,101845,-
chr5,149827299,1.4846669490209763,32176,20313,52489,-
chr5,149829284,1.2181654587218875,26387,16531,42918,-
chr5,149829285,1.3618798449995355,19413,12342,31755,-
chr5,149829298,0.8763797503765045,19373,9239,28612,-
chr5,149829299,0.8996806999935203,39944,20461,60405,-
chr5,149829300,0.8905476107830779,27164,13985,41149,-
chr5,149829301,0.9191976031883944,12780,6476,19256,-
chr5,150078074,4.3483888481442134,592,410,1002,-
chr5,150113021,2.7264148031581033,1302,744,2046,-
chr5,150113025,0.1966617780571269,703,386,1089,-
chr5,150113035,1.03003003003003,1028,591,1619,-
chr5,150113036,1.03003003003003,1028,591,1619,-
chr5,150121684,1.0879842690214256,1298,773,2071,-
chr5,150409548,4.335159885159885,905,775,1680,-
chr5,150409556,1.7665429969355677,1475,1611,3086,-
chr5,150409557,2.28554324028462,940,1217,2157,-
chr5,150409565,1.5557845165715418,874,810,1684,-
chr5,150409580,2.16395850919894,1074,959,2033,-
chr5,150410209,0.9647092038396388,602,461,1063,-
chr5,150410210,0.9647092038396388,602,461,1063,-
chr5,150416357,1.0853796838813385,932,633,1565,-
chr5,150422503,3.2703234265734262,729,703,1432,-
chr5,150422505,2.5208796553640918,1082,1027,2109,-
chr5,150422506,2.051690319603092,1045,962,2007,-
chr5,150422508,1.9662921348314608,685,622,1307,-
chr5,150429464,1.5980606479297241,2066,1307,3373,-
chr5,150429478,2.25850846196764,758,565,1323,-
chr5,150429487,1.5854397204426325,697,504,1201,-
chr5,150508998,1.096069268829027,637,427,1064,-
chr5,150508999,1.096069268829027,637,427,1064,-
chr5,150512695,0.3761819575773064,735,454,1189,-
chr5,150512696,0.3761819575773064,735,454,1189,-
chr5,157213620,1.8146103896103891,728,439,1167,-
chr5,157213664,2.0784313725490198,635,431,1066,-
chr5,157214493,3.288778054862843,627,400,1027,-
chr5,157214689,2.821019504653551,764,537,1301,-
chr5,157214690,1.4755183471640838,888,625,1513,-
chr5,157218733,0.3459960213246925,934,577,1511,-
chr5,157218978,2.9591005812283995,687,469,1156,-
chr5,157221968,1.487395508842672,568,449,1017,-
chr5,157233103,2.791009944872134,988,711,1699,-
chr5,157285950,0.47920543122957,732,484,1216,-
chr5,157285972,0.4617669852751226,649,631,1280,-
chr5,157285973,0.4617669852751226,649,631,1280,-
chr5,157285997,7.5292637964950035,706,609,1315,-
chr5,157286006,3.398395945546547,713,549,1262,-
chr5,157286007,3.398395945546547,713,549,1262,-
chr5,158584594,6.975620074762579,653,497,1150,-
chr5,158584595,6.975620074762579,653,497,1150,-
chr5,158585046,8.428189244235574,829,1253,2082,-
chr5,158585047,8.164336602417155,903,1403,2306,-
chr5,159831838,2.468597285067873,592,424,1016,-
chr5,159831841,2.149980246212163,1427,980,2407,-
chr5,159831848,1.7132307692307691,767,519,1286,-
chr5,159835465,3.048005884405633,888,576,1464,-
chr5,159842276,1.6567679059706224,797,673,1470,-
chr5,162880837,0.7338267613105312,1742,1276,3018,-
chr5,162880987,1.901865272662469,666,442,1108,-
chr5,162880988,0.587171052631579,713,479,1192,-
chr5,162884076,1.629742033383915,894,658,1552,-
chr5,162884603,1.326815376899154,767,565,1332,-
chr5,162886878,1.5210172546816612,730,486,1216,-
chr5,162886912,2.553050397877984,769,376,1145,-
chr5,162886913,2.363738837785411,1165,588,1753,-
chr5,162886915,3.876034278959811,708,422,1130,-
chr5,162886916,3.876034278959811,708,422,1130,-
chr5,167980136,0.6691535150645623,900,696,1596,-
chr5,167980166,2.203964847741672,673,465,1138,-
chr5,167980168,2.203964847741672,673,465,1138,-
chr5,167983932,2.711201378796507,989,610,1599,-
chr5,167990999,1.6980443142686246,1022,652,1674,-
chr5,167995965,1.5984398804098885,1225,868,2093,-
chr5,167995979,3.577758644164003,673,475,1148,-
chr5,168006268,1.1232590915748195,1581,1143,2724,-
chr5,168006269,0.5244122965641952,1014,783,1797,-
chr5,168006270,0.5244122965641952,1014,783,1797,-
chr5,168006321,3.1317585978228037,599,413,1012,-
chr5,171638977,0.4356995884773662,604,485,1089,-
chr5,171638978,0.4356995884773662,604,485,1089,-
chr5,172195283,1.2264174685577023,9712,6884,16596,-
chr5,172195363,1.3398727146772296,5771,3863,9634,-
chr5,172195625,1.3767619814740235,2278,1909,4187,-
chr5,172195795,1.7226494323385575,1465,1180,2645,-
chr5,172195801,1.873753142486416,1466,1120,2586,-
chr5,172195825,1.4351043332103472,1320,1037,2357,-
chr5,172195849,1.6582482716114668,3151,2520,5671,-
chr5,172195850,1.5642987457240594,2248,1753,4001,-
chr5,172195855,1.7772704714640195,1278,774,2052,-
chr5,172195871,2.0176357335386985,1277,741,2018,-
chr5,172196084,1.343025411713382,2676,1729,4405,-
chr5,172196126,1.3894832231587766,8305,5946,14251,-
chr5,172196624,1.3335801928870783,2475,2013,4488,-
chr5,172196660,1.629791699225291,2335,1905,4240,-
chr5,172196702,1.3570833173326098,4330,3234,7564,-
chr5,172196752,2.0492334145293025,1211,996,2207,-
chr5,172197170,0.6036383682469681,1167,906,2073,-
chr5,172197192,1.5007185677917383,1090,901,1991,-
chr5,172197225,1.5992460154940134,3833,2876,6709,-
chr5,172197264,0.7021476968722132,1684,1236,2920,-
chr5,172197267,1.1731418315916897,3447,2768,6215,-
chr5,172197295,1.6872489212914747,1133,610,1743,-
chr5,172197302,2.5127314814814814,2170,1071,3241,-
chr5,172197303,1.760553368709188,3371,2025,5396,-
chr5,172197305,1.6902489705112695,2415,1866,4281,-
chr5,172197306,1.682685009487666,1795,1359,3154,-
chr5,172197592,1.78064073674929,1453,1037,2490,-
chr5,172197593,1.78064073674929,1453,1037,2490,-
chr5,172197626,2.5229116928278406,1047,758,1805,-
chr5,172197807,0.6160991769406783,819,622,1441,-
chr5,172197886,1.8864152261218785,696,497,1193,-
chr5,172198037,2.075030077655037,1580,1337,2917,-
chr5,172198081,1.7226702985678106,1618,958,2576,-
chr5,172198136,1.4159978598180845,1184,889,2073,-
chr5,172198137,1.5897247706422022,1215,544,1759,-
chr5,172198146,2.929617000495496,2862,1939,4801,-
chr5,172198189,1.9494647355163728,853,396,1249,-
chr5,172198191,1.1034507778035756,1490,943,2433,-
chr5,172198193,1.0822610997497881,2791,1761,4552,-
chr5,172198194,0.904821897262842,1402,888,2290,-
chr5,172744157,0.4767025089605735,455,557,1012,-
chr5,172744180,5.897716209697658,2365,2314,4679,-
chr5,172744194,5.648985959438377,638,640,1278,-
chr5,172744248,9.235264195062456,1760,1834,3594,-
chr5,172744251,6.717063656327361,2190,1895,4085,-
chr5,172744252,7.641693811074918,965,920,1885,-
chr5,172744302,0.4259787038535178,929,933,1862,-
chr5,172744307,0.1759794282256844,830,600,1430,-
chr5,172744308,0.1759794282256844,830,600,1430,-
chr5,172744309,0.1759794282256844,830,600,1430,-
chr5,172744325,20.642263167728682,4057,2702,6759,-
chr5,172744326,20.213071916039787,4446,2898,7344,-
chr5,172744327,19.775886806433395,4727,2975,7702,-
chr5,172744328,18.368552232336366,1168,768,1936,-
chr5,172744515,11.700633259288551,1667,1209,2876,-
chr5,172744516,11.700633259288551,1667,1209,2876,-
chr5,172744521,3.7626686875936017,1259,707,1966,-
chr5,172744522,4.041175382123507,848,506,1354,-
chr5,172744646,1.4863313997218506,1338,1089,2427,-
chr5,172744823,1.2271572037113194,1523,1257,2780,-
chr5,172744847,2.387972646432695,966,754,1720,-
chr5,172744863,0.7931034482758621,942,579,1521,-
chr5,172744864,0.7931034482758621,942,579,1521,-
chr5,172744868,0.3737522610035506,796,648,1444,-
chr5,172744870,0.3737522610035506,796,648,1444,-
chr5,172744878,1.005338078291815,1129,842,1971,-
chr5,172744880,1.538417681213711,1449,1116,2565,-
chr5,172744912,3.2790834986739603,575,480,1055,-
chr5,172744933,0.933991917377638,639,523,1162,-
chr5,172744935,0.933991917377638,639,523,1162,-
chr5,172744968,2.295026849195168,779,548,1327,-
chr5,172745198,2.524950459376689,583,426,1009,-
chr5,172750278,2.026554856743536,579,476,1055,-
chr5,172750338,3.634387351778656,612,505,1117,-
chr5,172752934,1.606186478126381,931,729,1660,-
chr5,172752949,1.635056967572305,847,651,1498,-
chr5,172752957,2.287426431246656,667,444,1111,-
chr5,172752961,2.587800369685767,719,540,1259,-
chr5,172755089,2.986871888879894,871,557,1428,-
chr5,172755199,0.42478303827517244,720,699,1419,-
chr5,172755228,0.3467076106723213,682,1029,1711,-
chr5,172755234,0.5767236910316226,444,642,1086,-
chr5,172755242,5.355596038157242,2818,3190,6008,-
chr5,172755243,5.355596038157242,2818,3190,6008,-
chr5,172755244,5.050328515445505,2438,2897,5335,-
chr5,172755250,5.00345692907502,1313,1162,2475,-
chr5,172755252,5.060749071191887,719,432,1151,-
chr5,172755253,5.429759719122853,1180,766,1946,-
chr5,172755256,6.207318414689654,1098,588,1686,-
chr5,172755265,3.8580655391120504,737,303,1040,-
chr5,172755280,8.490973327866945,1549,526,2075,-
chr5,172755281,9.756250370234353,2741,910,3651,-
chr5,172755282,9.756250370234353,2741,910,3651,-
chr5,172755283,15.75238095238095,826,284,1110,-
chr5,172755417,1.1665392075543208,1666,1273,2939,-
chr5,172755419,1.1817711832144056,990,618,1608,-
chr5,172755447,0.4884004720270343,846,723,1569,-
chr5,172755449,0.8466973400685154,1833,1523,3356,-
chr5,172755450,1.0309055893552763,742,681,1423,-
chr5,173035189,0.572198617292936,1230,911,2141,-
chr5,173035216,1.0861191128628986,1266,925,2191,-
chr5,175773163,1.3401683925397652,587,456,1043,-
chr5,175773324,5.536310944425503,705,418,1123,-
chr5,175773325,5.536310944425503,705,418,1123,-
chr5,175782703,5.126243419433118,651,355,1006,-
chr5,175782705,4.074756746617764,791,491,1282,-
chr5,175786914,2.8002295493331326,1080,688,1768,-
chr5,175811022,2.3318571237311403,689,486,1175,-
chr5,175811304,2.0945475638051043,627,430,1057,-
chr5,175811316,0.5499714448886351,641,411,1052,-
chr5,175812223,2.337889248978441,2073,1509,3582,-
chr5,175812226,1.7014126999091943,3726,2550,6276,-
chr5,175812228,1.7014126999091943,3726,2550,6276,-
chr5,175812243,1.5538033395176252,1674,930,2604,-
chr5,175812245,1.6946353065539113,1424,945,2369,-
chr5,175812297,1.8174127478850568,1128,678,1806,-
chr5,175815242,3.2855731225296445,664,413,1077,-
chr5,175824673,2.103896103896104,764,594,1358,-
chr5,175824674,2.103896103896104,764,594,1358,-
chr5,175824692,0.8925802879291254,805,601,1406,-
chr5,175824693,0.8925802879291254,805,601,1406,-
chr5,175824949,2.1994856153262554,590,417,1007,-
chr5,176758744,2.7992516935085443,886,839,1725,-
chr5,176758745,5.423456475953747,1241,1045,2286,-
chr5,176759030,1.728358793576185,705,443,1148,-
chr5,176759223,1.35674589310456,727,477,1204,-
chr5,176761323,2.1567760942760943,830,593,1423,-
chr5,176761385,0.4372968349016253,851,667,1518,-
chr5,176764138,2.3174242424242424,797,395,1192,-
chr5,176764144,3.2264957264957266,754,341,1095,-
chr5,176764172,1.7921981424148603,535,474,1009,-
chr5,176764246,0.8662958843159065,707,619,1326,-
chr5,176764247,0.8662958843159065,707,619,1326,-
chr5,176764767,0.487753840300566,640,488,1128,-
chr5,176765544,1.6478337236533953,865,487,1352,-
chr5,176765545,0.5426532933512562,655,508,1163,-
chr5,176765548,0.6201851851851853,787,431,1218,-
chr5,176765583,0.5714285714285714,701,440,1141,-
chr5,176778189,2.24346116027532,735,564,1299,-
chr5,176778198,2.008639308855292,557,462,1019,-
chr5,176778228,3.161111111111111,568,434,1002,-
chr5,176778231,0.5237037037037038,706,539,1245,-
chr5,176778468,1.6139362110926094,1049,632,1681,-
chr5,176778486,0.7058823529411766,1031,594,1625,-
chr5,176778514,2.6678774816881403,1342,1136,2478,-
chr5,176778563,0.514757885985398,2059,1590,3649,-
chr5,176778568,2.404572703192528,1175,796,1971,-
chr5,176778569,2.5620117130536424,1719,1256,2975,-
chr5,176778570,2.6254182973623177,1981,1576,3557,-
chr5,176778629,7.982227163074617,1249,1022,2271,-
chr5,176778630,1.3634146341463416,558,450,1008,-
chr5,176884696,2.291428571428572,801,531,1332,-
chr5,176884697,2.2399974864865797,1031,751,1782,-
chr5,176893962,1.9969771944922543,2542,1327,3869,-
chr5,176893964,1.908575282578842,3757,1937,5694,-
chr5,176893965,1.8461134569746003,4787,3124,7911,-
chr5,176893968,1.9911140990350904,1973,1261,3234,-
chr5,176893971,1.737344857270697,2081,1558,3639,-
chr5,176894028,2.3236137961270535,1297,750,2047,-
chr5,176894029,2.6270915684566907,1465,948,2413,-
chr5,176943187,2.6052631578947367,629,559,1188,-
chr5,176943188,2.6052631578947367,629,559,1188,-
chr5,177576592,0.4486682808716706,653,589,1242,-
chr5,177576606,3.8490284005979074,823,445,1268,-
chr5,177576798,1.7354368932038833,779,617,1396,-
chr5,177577946,1.5784313725490196,965,849,1814,-
chr5,177577953,2.3668823220842805,1276,816,2092,-
chr5,177577955,2.3504127899357883,1887,1173,3060,-
chr5,177577957,2.1546566593295564,1243,748,1991,-
chr5,177580497,2.973232323232323,840,439,1279,-
chr5,177580499,2.973232323232323,840,439,1279,-
chr5,177580673,0.5813695691042374,738,594,1332,-
chr5,177580807,1.818519715578539,725,441,1166,-
chr5,177580810,2.1950953678474114,635,366,1001,-
chr5,177580817,3.193311036789298,615,459,1074,-
chr5,177580819,3.193311036789298,615,459,1074,-
chr5,179041616,3.906200317965024,881,517,1398,-
chr5,179041729,1.7609265734265733,710,623,1333,-
chr5,179041761,1.6354401805869074,620,442,1062,-
chr5,179041766,1.4724236802158879,969,725,1694,-
chr5,179041770,1.0382026141158065,801,592,1393,-
chr5,179041847,6.334326425807182,6491,5225,11716,-
chr5,179041848,6.281374085457674,7464,5852,13316,-
chr5,179041849,4.579796111911258,4847,3686,8533,-
chr5,179043131,2.388235294117647,608,560,1168,-
chr5,179043141,0.5794903160040775,645,544,1189,-
chr5,179043146,1.744186046511628,549,472,1021,-
chr5,179043933,1.500261643118786,731,587,1318,-
chr5,179044085,1.995165061482817,1834,1267,3101,-
chr5,179044086,1.9369747899159662,921,685,1606,-
chr5,179044520,1.5366282823012436,2016,1282,3298,-
chr5,179044521,2.0904298459042985,1030,547,1577,-
chr5,179044522,1.0291645601617796,986,735,1721,-
chr5,179045045,1.1771750581865223,30306,22484,52790,-
chr5,179045047,1.5793805497706774,32772,25280,58052,-
chr5,179045048,1.574436216219077,56296,41546,97842,-
chr5,179045049,1.773575321838412,71527,51669,123196,-
chr5,179045050,1.889035130512676,88187,59926,148113,-
chr5,179045051,2.2544981897264287,70217,46756,116973,-
chr5,179045052,4.012002295386825,16021,10742,26763,-
chr5,179045057,1.2057374509563024,15723,9479,25202,-
chr5,179045185,1.954549985049337,2649,1269,3918,-
chr5,179045231,1.7062913737363372,3283,1498,4781,-
chr5,179046341,3.8281584430504982,2972,2327,5299,-
chr5,179046344,9.90511994271393,1005,797,1802,-
chr5,179046345,9.43010101525927,2649,1966,4615,-
chr5,179047983,3.9440734557595993,809,598,1407,-
chr5,179048303,2.260869565217391,909,804,1713,-
chr5,179048355,1.7190311418685122,863,679,1542,-
chr5,179050093,0.45579450418160106,762,557,1319,-
chr5,179228897,2.3069355980184003,880,470,1350,-
chr5,179228899,2.3069355980184003,880,470,1350,-
chr5,179228954,1.5927703947302245,677,479,1156,-
chr5,179228955,1.735417488439036,908,647,1555,-
chr5,179440190,2.08991073364189,1336,844,2180,-
chr5,179666973,2.579582230067667,1369,1132,2501,-
chr5,179666974,2.579582230067667,1369,1132,2501,-
chr5,179666981,2.825018896447468,574,440,1014,-
chr5,180664042,1.1151700879713744,1025,740,1765,-
chr5,180664043,0.9338340569302687,961,669,1630,-
chr5,180665119,1.9039070087014245,22683,18937,41620,-
chr5,180665121,1.6144149091242366,44938,33956,78894,-
chr5,180665212,0.9740291540949138,18722,14324,33046,-
chr5,180665239,1.2908095446106906,1197,1004,2201,-
chr5,180666117,0.8339538880779113,11632,7451,19083,-
chr5,180666118,1.2788028089975436,9474,7145,16619,-
chr5,180666139,1.185563036407733,25691,19625,45316,-
chr5,180666161,1.2300370239454264,7552,6021,13573,-
chr5,180666580,2.2533426308769107,8464,7125,15589,-
chr5,180666583,0.944875047167005,609,515,1124,-
chr5,180668505,1.5153875502008032,8292,5999,14291,-
chr5,180668547,0.7591625441204498,32121,23659,55780,-
chr5,180668621,1.3098182927545379,19165,13524,32689,-
chr5,180669178,0.8468747206329341,5810,4793,10603,-
chr5,180669342,1.2675881134612794,8070,6853,14923,-
chr5,180669346,0.9751106649426184,1110,859,1969,-
chr5,180670712,1.1960842689700624,9398,6090,15488,-
chr5,180670723,1.246942016480032,22340,17226,39566,-
chr5,180670733,1.3828422824741131,32474,23330,55804,-
chr5,180670734,1.4002306574049372,26965,18385,45350,-
chr5,180670741,1.2769741750641537,12416,8173,20589,-
chr5,180670747,1.5457401291956159,14580,7637,22217,-
chr5,180670748,1.5457401291956159,14580,7637,22217,-
chr5,180670789,1.284525419856929,6878,5211,12089,-
chr5,180670796,1.0548648851763813,12563,9152,21715,-
chr5,180670853,1.2010529387530895,8116,6619,14735,-
chr5,180670855,1.2518740212209452,13553,9619,23172,-
chr5,180670861,1.3323003395540107,10169,7725,17894,-
chr5,180670862,1.365267050864832,6832,5016,11848,-
chr5,180670875,1.457753767575722,8700,5700,14400,-
chr5,180670880,1.885923111011285,3304,1630,4934,-
chr5,180670891,1.6720804331013148,1586,1292,2878,-
chr5,180670894,1.496502978387008,8690,4747,13437,-
chr5,180670896,1.5045500204366857,12634,6899,19533,-
chr5,180670897,1.3731419248682264,7109,3117,10226,-
chr5,180670899,1.4236235253595109,4566,1974,6540,-
chr5,180670902,0.8755233974644516,3033,1197,4230,-
chr5,180670903,0.7504347085540205,5910,3055,8965,-
chr5,180670905,0.6747149613083193,3696,1939,5635,-
chr5,180670913,0.5358658314811072,701,440,1141,-
chr5,180670915,1.0307149459352396,968,636,1604,-
chr5,180670916,1.111551460442487,785,592,1377,-
chr6,497468,2.244221105527638,615,397,1012,-
chr6,497469,2.244221105527638,615,397,1012,-
chr6,599219,2.1280943025540275,1353,1017,2370,-
chr6,599220,1.5278681552365765,1282,824,2106,-
chr6,610100,2.204951593770329,1225,842,2067,-
chr6,610107,2.4614173228346456,1041,634,1675,-
chr6,610108,2.5411061285500747,1104,668,1772,-
chr6,610117,1.7973900094912514,2580,1571,4151,-
chr6,610119,1.9963799266935156,1547,901,2448,-
chr6,610127,1.6428763595833813,736,440,1176,-
chr6,610134,1.9897029980386665,1234,663,1897,-
chr6,610135,1.9897029980386665,1234,663,1897,-
chr6,610140,2.5453577676119865,1152,638,1790,-
chr6,610141,2.4116738197424894,877,465,1342,-
chr6,2117727,0.9910904940726014,672,502,1174,-
chr6,2117728,1.6781398802516176,1126,816,1942,-
chr6,2832695,12.857766971128735,723,437,1160,-
chr6,2833464,2.630286493860846,963,732,1695,-
chr6,2833466,2.630286493860846,963,732,1695,-
chr6,2833591,1.896655701754386,628,383,1011,-
chr6,2833929,1.5397343877594876,1432,877,2309,-
chr6,2833957,1.7183257918552035,1126,597,1723,-
chr6,2834031,1.5850033192353692,2602,1821,4423,-
chr6,2834093,1.4283915724563203,1565,972,2537,-
chr6,2836118,2.005084745762712,1351,943,2294,-
chr6,2836120,1.4018710420264824,1570,1157,2727,-
chr6,2836425,1.4851865997381053,1577,1263,2840,-
chr6,2836483,1.610202784678491,1185,910,2095,-
chr6,2838856,1.288625215297993,1998,2181,4179,-
chr6,2838861,2.0403923311968577,3776,3780,7556,-
chr6,2838863,2.0403923311968577,3776,3780,7556,-
chr6,2838907,1.4147963304869604,1508,1237,2745,-
chr6,2840734,1.3310678950712531,1484,957,2441,-
chr6,2840782,1.7662721893491125,596,506,1102,-
chr6,2840799,0.5172627918529558,594,548,1142,-
chr6,2948589,1.892924035950195,1450,972,2422,-
chr6,2948647,1.8112814895947424,718,414,1132,-
chr6,2948740,0.6499965699389448,1136,773,1909,-
chr6,2948742,0.4359355884006215,823,592,1415,-
chr6,2948767,2.311743555983188,829,636,1465,-
chr6,2948834,1.727562246670527,662,470,1132,-
chr6,2948838,1.189693524089645,1575,1042,2617,-
chr6,2948900,1.5416666666666667,1019,679,1698,-
chr6,2953311,2.4105177077435997,957,756,1713,-
chr6,2953347,1.449748402012784,1229,816,2045,-
chr6,2953359,2.0093919920909538,812,577,1389,-
chr6,2953416,1.3732313348751706,1411,802,2213,-
chr6,2954864,1.837978560490046,705,652,1357,-
chr6,2955760,1.813512145748988,2388,1871,4259,-
chr6,2955762,1.813512145748988,2388,1871,4259,-
chr6,2955795,0.6465117408513635,1023,776,1799,-
chr6,2955809,1.8117182356813692,895,685,1580,-
chr6,2955813,1.6617069568036889,886,676,1562,-
chr6,2955837,2.6874251497005988,747,500,1247,-
chr6,2955863,1.7038697498820194,746,488,1234,-
chr6,2955890,2.375412397985761,569,442,1011,-
chr6,2959499,1.8593902269246831,741,652,1393,-
chr6,2959549,1.791097675388304,1209,904,2113,-
chr6,2959551,1.791097675388304,1209,904,2113,-
chr6,2959560,1.9625850340136055,576,440,1016,-
chr6,3738324,1.48359375,1687,1535,3222,-
chr6,3738327,1.8996834876316475,3591,2621,6212,-
chr6,3738337,1.5972435987127465,1342,1020,2362,-
chr6,3738339,0.48423484642565906,1526,1131,2657,-
chr6,3738348,0.6372340425531914,1197,939,2136,-
chr6,3738351,1.6647945610404966,1055,596,1651,-
chr6,3738362,1.6129976580796253,724,426,1150,-
chr6,4117590,0.42045265216974465,707,590,1297,-
chr6,4119451,2.841357867610493,709,604,1313,-
chr6,5109580,4.403361396071728,796,634,1430,-
chr6,5109605,2.564638931878478,680,410,1090,-
chr6,5260889,2.0494434441857328,690,521,1211,-
chr6,7287908,2.761802575107296,692,465,1157,-
chr6,7288073,1.7034453781512604,698,475,1173,-
chr6,7288145,2.5271894262813466,880,574,1454,-
chr6,7288281,2.2352352352352347,637,443,1080,-
chr6,7288414,1.8794213916165134,711,450,1161,-
chr6,7288773,2.2678164023791356,1300,937,2237,-
chr6,7289001,2.661290322580645,791,464,1255,-
chr6,7289247,1.6729351032448376,697,451,1148,-
chr6,7289434,2.279377958079784,601,492,1093,-
chr6,7289521,1.8678247911120385,1433,990,2423,-
chr6,7289877,0.5202839756592292,1025,782,1807,-
chr6,7295692,1.6260598905227004,1211,846,2057,-
chr6,7310224,1.9224929761751417,1577,1071,2648,-
chr6,7310225,0.5875933853773189,699,626,1325,-
chr6,7310243,0.46823234524847435,660,495,1155,-
chr6,7313294,1.8004971636178213,855,540,1395,-
chr6,7881846,2.760056390977444,752,559,1311,-
chr6,7881847,2.306133931704176,1319,893,2212,-
chr6,7881971,1.8898179383144573,2497,2091,4588,-
chr6,7882066,1.7399258343634116,1172,808,1980,-
chr6,7882118,1.5254671842556649,1431,1006,2437,-
chr6,7882141,2.027568922305764,808,664,1472,-
chr6,7882573,1.5535732051069475,975,814,1789,-
chr6,7882574,0.5319238473628923,2317,1732,4049,-
chr6,7882929,1.076463842153554,2508,1827,4335,-
chr6,7883013,1.6067835192351467,1216,954,2170,-
chr6,7883059,1.4034847029770887,1704,1181,2885,-
chr6,7883263,1.1289402773381698,2344,1640,3984,-
chr6,7883282,2.7209872286910715,1727,1146,2873,-
chr6,7883377,2.451524259338772,792,684,1476,-
chr6,7883450,2.022614201718679,935,736,1671,-
chr6,7884598,1.4496711984025097,3607,2582,6189,-
chr6,7884599,1.4872165980817074,2088,1617,3705,-
chr6,7884604,0.6330234617087207,1000,752,1752,-
chr6,7884643,1.37108177818237,1411,1013,2424,-
chr6,7886206,1.4650964922458136,1761,1325,3086,-
chr6,7886248,1.650645503828313,894,616,1510,-
chr6,7886261,0.6419274714356682,922,731,1653,-
chr6,7888955,2.60514096185738,682,401,1083,-
chr6,7888958,2.52172373081464,688,384,1072,-
chr6,7888974,4.16358024691358,709,359,1068,-
chr6,7889055,2.8973988439306355,801,691,1492,-
chr6,7889732,1.558621718377088,1214,837,2051,-
chr6,7889811,1.77576342967531,1194,938,2132,-
chr6,7891863,1.7451638598088304,828,675,1503,-
chr6,7891883,1.6233766233766234,1124,692,1816,-
chr6,7891929,1.991936168406757,756,560,1316,-
chr6,7891954,0.6630063445583211,1044,682,1726,-
chr6,7895361,2.011015911872705,635,515,1150,-
chr6,7895369,1.9095322376738304,920,564,1484,-
chr6,7904814,0.9135046429715017,786,693,1479,-
chr6,7904816,1.9998883785407977,1297,1032,2329,-
chr6,7904875,0.5016501650165016,607,504,1111,-
chr6,7904920,1.719520872865275,536,495,1031,-
chr6,8015964,3.186417186417186,626,480,1106,-
chr6,8079910,1.829779411764706,552,479,1031,-
chr6,8080080,1.6792715177622073,1338,852,2190,-
chr6,8080227,1.5408233276157803,1381,879,2260,-
chr6,8097523,0.7187890462307371,1562,1175,2737,-
chr6,8097586,2.220027927388789,717,556,1273,-
chr6,8097588,1.7903418124006358,1154,739,1893,-
chr6,8097616,1.711666666666667,947,719,1666,-
chr6,8102755,2.5349119611414697,667,487,1154,-
chr6,8102756,2.2792479678869535,985,670,1655,-
chr6,10397876,0.5073131760078663,634,451,1085,-
chr6,10398378,0.4405945992920047,1345,989,2334,-
chr6,10398379,0.4892764604698761,976,728,1704,-
chr6,10400721,1.5667680036612075,834,926,1760,-
chr6,10400748,2.5087792642140467,705,597,1302,-
chr6,10400779,3.133136094674556,705,506,1211,-
chr6,10402779,0.32015065913371,679,412,1091,-
chr6,10404774,1.178831527856667,762,466,1228,-
chr6,10404787,2.016487361147556,940,617,1557,-
chr6,10404789,2.393251274894154,1464,924,2388,-
chr6,10404827,1.1192824269747346,700,545,1245,-
chr6,10404828,1.1192824269747346,700,545,1245,-
chr6,10406572,3.538593358311668,622,443,1065,-
chr6,10412317,1.1693501242309716,582,448,1030,-
chr6,13799069,1.5512214498510426,1501,1006,2507,-
chr6,13800609,1.9938071246768643,1168,810,1978,-
chr6,17629684,2.9555555555555557,573,614,1187,-
chr6,17629686,2.9555555555555557,573,614,1187,-
chr6,17629689,1.5382587938377412,614,526,1140,-
chr6,18224579,4.031285944329423,673,482,1155,-
chr6,18224615,1.9747550240823784,1159,668,1827,-
chr6,18224685,1.956521739130435,1079,643,1722,-
chr6,18224767,1.9114877589453865,734,530,1264,-
chr6,18224786,0.49585899341686124,933,553,1486,-
chr6,18225001,1.5839464882943142,1479,896,2375,-
chr6,18225004,1.3528606102635228,2108,1441,3549,-
chr6,18225308,1.573885350318471,1058,784,1842,-
chr6,18225443,0.6713634880545251,1461,996,2457,-
chr6,18225517,1.727816856563801,2197,1581,3778,-
chr6,18225902,1.7056602817472384,1140,857,1997,-
chr6,18236738,1.8423870632099197,2072,1213,3285,-
chr6,18249933,2.0164088988397006,6608,7346,13954,-
chr6,18249952,1.3373105883774448,5390,4920,10310,-
chr6,18249971,1.216332673948568,3994,3321,7315,-
chr6,18249974,1.6806315312964901,7455,6172,13627,-
chr6,18249982,1.4205343561623256,3040,2265,5305,-
chr6,18249983,1.449615339093384,3128,2484,5612,-
chr6,18249992,1.4453918070783094,2617,2020,4637,-
chr6,18255995,1.3698911480796878,1739,1081,2820,-
chr6,18256077,1.7534356260761603,2501,1872,4373,-
chr6,18258238,1.590576612520186,1793,1088,2881,-
chr6,18258599,0.5191158248568019,2970,2291,5261,-
chr6,18258602,0.4222703441987691,740,641,1381,-
chr6,18264078,3.6475799725197717,2793,2250,5043,-
chr6,18264079,3.705251629811264,3339,2519,5858,-
chr6,18264081,3.7396036368726158,2651,1809,4460,-
chr6,18264084,3.0358589988374485,1128,604,1732,-
chr6,18264625,0.32558636600229957,1043,585,1628,-
chr6,18264626,0.3519825638330794,1050,583,1633,-
chr6,18264663,3.441988130563798,702,336,1038,-
chr6,18264715,2.5636902649919766,803,465,1268,-
chr6,24718870,1.1886438399009454,572,455,1027,-
chr6,26056331,2.487069496774046,779,608,1387,-
chr6,26056488,2.757034260348089,556,463,1019,-
chr6,27106406,2.1344319829098954,1075,770,1845,-
chr6,27106407,2.1344319829098954,1075,770,1845,-
chr6,27114219,3.127363844689357,931,628,1559,-
chr6,27114220,3.986618344020072,649,421,1070,-
chr6,27114221,2.873151596858714,762,506,1268,-
chr6,27114531,2.125890642359448,966,518,1484,-
chr6,27114610,1.5823412698412698,824,419,1243,-
chr6,27114630,1.3055396916047972,761,308,1069,-
chr6,27114633,0.8740861658251258,1067,413,1480,-
chr6,28872043,0.4881687955573941,752,514,1266,-
chr6,28872175,3.2406394780736636,662,454,1116,-
chr6,28872253,2.4937085021340666,1685,1339,3024,-
chr6,28872254,3.6715349194968687,2377,2001,4378,-
chr6,28872255,3.698418714975206,2088,1734,3822,-
chr6,28872276,0.4431907407920201,631,441,1072,-
chr6,28876614,0.5555243445692883,697,533,1230,-
chr6,28887900,2.13055092758357,641,444,1085,-
chr6,28889759,1.5678364037534744,1290,1039,2329,-
chr6,28890993,1.0457808811959086,1250,983,2233,-
chr6,28890994,0.8429164040740726,1803,1402,3205,-
chr6,28890995,1.1935642992742168,1032,795,1827,-
chr6,28891011,2.3824648533062804,961,640,1601,-
chr6,28891012,2.3793103448275863,643,463,1106,-
chr6,30638574,1.70186538120267,797,660,1457,-
chr6,30680492,1.5671743530433162,633,443,1076,-
chr6,30695664,1.6813252067188138,3762,3071,6833,-
chr6,30695666,1.706180990324417,2341,1756,4097,-
chr6,30695702,1.6102003642987253,747,670,1417,-
chr6,30695740,1.695936139332366,778,688,1466,-
chr6,30695769,0.5813127090301003,617,597,1214,-
chr6,30695855,2.0373606043476027,880,670,1550,-
chr6,30695903,1.932734916486763,944,676,1620,-
chr6,30695919,1.5112364833098262,1147,708,1855,-
chr6,30697818,0.6744057490326149,1219,728,1947,-
chr6,30697823,1.8524912587412585,1210,727,1937,-
chr6,30697856,1.1831400614973848,2097,1428,3525,-
chr6,30697865,1.659391648049493,567,505,1072,-
chr6,30697952,1.616736293552694,872,748,1620,-
chr6,30698219,0.7442158890676472,1273,915,2188,-
chr6,30698246,0.517207081758504,599,456,1055,-
chr6,30698247,1.1137102906314014,1962,1266,3228,-
chr6,30698494,1.8325101032779525,582,523,1105,-
chr6,30698498,0.6102047900034709,878,644,1522,-
chr6,30698698,0.657307249712313,815,631,1446,-
chr6,30698723,1.92926217765043,1196,697,1893,-
chr6,30698725,2.135962589435995,2090,1291,3381,-
chr6,30698726,1.933665864006421,1162,645,1807,-
chr6,30698737,2.2550000000000003,860,699,1559,-
chr6,30698738,2.2550000000000003,860,699,1559,-
chr6,30698857,1.9390243902439024,794,491,1285,-
chr6,30707961,1.8687508269589577,6052,5062,11114,-
chr6,30707962,1.9362663429804523,8874,7271,16145,-
chr6,30707964,1.891414981055907,8300,6169,14469,-
chr6,30707975,1.7163633341643814,2173,1336,3509,-
chr6,30707986,1.9778118360096133,2102,1510,3612,-
chr6,30708015,1.3382842997238884,1756,1166,2922,-
chr6,30708487,1.7029481374768474,1248,903,2151,-
chr6,30708552,0.5487025766796862,1767,1211,2978,-
chr6,30708567,0.7032097728306906,1434,1067,2501,-
chr6,30709036,1.6909015371832157,879,663,1542,-
chr6,30709409,1.613267813267813,1273,813,2086,-
chr6,30709584,0.6364104829210837,909,565,1474,-
chr6,30709598,2.3020170408880345,1114,845,1959,-
chr6,30709601,1.8716577540106958,755,458,1213,-
chr6,30709962,1.4776360225140712,742,532,1274,-
chr6,30710400,0.4778859872216364,641,657,1298,-
chr6,30710413,13.04554260665497,658,505,1163,-
chr6,30710428,5.665547747879289,772,449,1221,-
chr6,30711026,0.6626296743063933,885,828,1713,-
chr6,30711044,35.627321593479614,6511,4444,10955,-
chr6,30711046,37.89294868204112,11790,7169,18959,-
chr6,30711047,48.15998490135514,8555,4890,13445,-
chr6,30711056,8.079069616366775,4564,1912,6476,-
chr6,30711096,0.3267403921115698,942,586,1528,-
chr6,30711099,0.5363237445148709,879,585,1464,-
chr6,30711202,0.4700724173604611,733,765,1498,-
chr6,30711203,1.4889480147359804,969,697,1666,-
chr6,30711207,10.892797538316719,5894,4987,10881,-
chr6,30711208,11.076038612685034,4978,4363,9341,-
chr6,30711224,2.1932202375609613,1077,856,1933,-
chr6,30711225,2.0601066293744874,3521,2527,6048,-
chr6,30711226,1.662706394565822,2316,1553,3869,-
chr6,30711239,3.932810740518403,2251,1300,3551,-
chr6,30711242,2.177085302039174,1238,828,2066,-
chr6,30711245,13.987328639163554,1854,1048,2902,-
chr6,30711268,0.5402433660753555,736,358,1094,-
chr6,30711269,1.7594563106796113,838,514,1352,-
chr6,30711348,1.0307076702267048,1975,1367,3342,-
chr6,30711500,2.5176151761517613,928,614,1542,-
chr6,30711531,0.3748651564185544,694,411,1105,-
chr6,30711603,2.737710524066,1032,556,1588,-
chr6,30711676,0.44853017019082,668,553,1221,-
chr6,30711678,1.4297273526824978,1015,757,1772,-
chr6,30711679,0.3286233511659247,618,520,1138,-
chr6,30711687,0.6302438285627745,860,638,1498,-
chr6,30711781,1.543997513598579,1463,1119,2582,-
chr6,30711787,1.8920158617424243,1345,1023,2368,-
chr6,30711788,1.6002731174404994,630,465,1095,-
chr6,30711789,1.8920158617424243,1345,1023,2368,-
chr6,30711809,1.750904392764858,615,386,1001,-
chr6,30711879,0.3729881974248927,617,465,1082,-
chr6,30711893,1.5538993191664947,640,523,1163,-
chr6,30712095,2.3359173126614987,790,601,1391,-
chr6,30712097,2.08254591429332,1180,883,2063,-
chr6,30712098,1.92606100795756,784,579,1363,-
chr6,30712323,0.9914893003314265,2477,1381,3858,-
chr6,31236849,1.3673563305642402,2216,1608,3824,-
chr6,31236922,1.2310058827197703,2519,1976,4495,-
chr6,31237119,1.5662856765872526,3705,2921,6626,-
chr6,31237120,1.5662856765872526,3705,2921,6626,-
chr6,31237138,1.4315485670711108,3448,2557,6005,-
chr6,31237139,1.4315485670711108,3448,2557,6005,-
chr6,31237153,1.5068379610443432,1514,888,2402,-
chr6,31237160,1.7489698184653075,1207,656,1863,-
chr6,31237754,1.6597914309008384,1363,1190,2553,-
chr6,31237822,0.7204486626402071,1669,1158,2827,-
chr6,31237824,2.028344487414029,2304,1392,3696,-
chr6,31237825,1.5163336504915954,4780,3152,7932,-
chr6,31237826,1.5161687168086149,6997,4749,11746,-
chr6,31237837,1.244801660618198,5695,3645,9340,-
chr6,31237840,1.6442148760330575,3286,1814,5100,-
chr6,31237841,1.6499629131044302,5041,2908,7949,-
chr6,31237844,1.3477358456645137,4458,2798,7256,-
chr6,31237853,1.3653482226409837,3386,2259,5645,-
chr6,31237856,1.6482025851418252,2358,1348,3706,-
chr6,31237857,1.6482025851418252,2358,1348,3706,-
chr6,31237988,2.400293793609989,816,388,1204,-
chr6,31237998,0.4641580828253101,965,496,1461,-
chr6,31238008,0.6139550821686167,1364,822,2186,-
chr6,31238113,0.610909090909091,923,604,1527,-
chr6,31238115,1.8432741732130733,730,490,1220,-
chr6,31238119,1.8249427917620136,659,436,1095,-
chr6,31238122,1.87578125,1175,767,1942,-
chr6,31238123,1.5971609750486522,1244,873,2117,-
chr6,31238124,1.87578125,1175,767,1942,-
chr6,31238127,1.9776016199930853,1096,793,1889,-
chr6,31238129,1.9297976041600255,2512,1679,4191,-
chr6,31238131,1.7979315831344471,1355,837,2192,-
chr6,31238132,1.6940021983889546,2490,1492,3982,-
chr6,31238133,1.440025978456477,1951,1177,3128,-
chr6,31238144,1.7090541225931424,805,413,1218,-
chr6,31238254,0.5427504736848727,5477,3759,9236,-
chr6,31238255,0.4677850327445151,2637,2017,4654,-
chr6,31238256,0.7819500916846049,2451,1807,4258,-
chr6,31238257,0.6341925701288855,1672,1318,2990,-
chr6,31238261,1.7236616702355458,946,466,1412,-
chr6,31238916,1.4430531675282827,3018,2433,5451,-
chr6,31238919,1.8859649122807018,859,683,1542,-
chr6,31238920,1.2148497130066829,3628,2543,6171,-
chr6,31238921,1.38954674816309,3865,2412,6277,-
chr6,31238923,1.2142693266344906,7094,4844,11938,-
chr6,31238924,1.2025909407868747,3360,2378,5738,-
chr6,31238925,1.3039063373257125,4909,3223,8132,-
chr6,31238926,0.6320859929288375,700,628,1328,-
chr6,31238927,1.0431372549019609,979,764,1743,-
chr6,31238928,0.858270651064218,1672,1172,2844,-
chr6,31238931,1.1611161126643676,843,642,1485,-
chr6,31239057,1.864446822122782,5327,3935,9262,-
chr6,31239058,1.7596183574203346,4155,3185,7340,-
chr6,31239102,1.9940029985007497,1861,1333,3194,-
chr6,31239104,1.902208037445046,3580,2354,5934,-
chr6,31239106,2.134172732638206,1694,1172,2866,-
chr6,31239112,2.681442080378251,697,375,1072,-
chr6,31239449,1.066043461835909,2420,2029,4449,-
chr6,31239452,1.0004902807329474,2123,2092,4215,-
chr6,31239458,2.225882290148243,4700,4198,8898,-
chr6,31239459,2.388764612043353,4604,4260,8864,-
chr6,31239473,1.5309730363423213,1271,852,2123,-
chr6,31239516,1.134974743439838,4576,3422,7998,-
chr6,31239523,0.7118656639421019,3530,2396,5926,-
chr6,31239539,1.998492840994725,1733,1326,3059,-
chr6,31239551,0.7058209135098221,2509,2045,4554,-
chr6,31239552,0.7058209135098221,2509,2045,4554,-
chr6,31239555,1.7241318988891807,1231,617,1848,-
chr6,31239556,1.679997251425823,1062,881,1943,-
chr6,31239566,1.7694210786739235,1191,845,2036,-
chr6,31239581,1.723807866341803,848,662,1510,-
chr6,31239620,1.6065466448445171,1226,584,1810,-
chr6,31239623,1.7920327800998839,1808,1482,3290,-
chr6,31239626,1.4528021636960184,922,715,1637,-
chr6,31239818,2.8136363636363635,618,483,1101,-
chr6,31239822,1.7226640159045723,1732,1005,2737,-
chr6,31239823,1.7226640159045723,1732,1005,2737,-
chr6,31239856,1.939571150097466,994,512,1506,-
chr6,31239858,1.939571150097466,994,512,1506,-
chr6,31321812,1.5012768271927583,4629,3362,7991,-
chr6,31321813,1.190171799586302,4539,3647,8186,-
chr6,31321818,1.2588996014943252,7563,5366,12929,-
chr6,31321820,1.258455995638842,14829,11416,26245,-
chr6,31321879,0.7939680085574188,2968,1968,4936,-
chr6,31321885,1.534957314133765,3013,2403,5416,-
chr6,31321989,1.4222720285785435,2649,2042,4691,-
chr6,31322259,1.5409239575479472,7840,6480,14320,-
chr6,31322260,0.8114982260401337,2517,1915,4432,-
chr6,31322261,1.495844992629144,4208,3558,7766,-
chr6,31322294,1.4330610224727078,4994,3716,8710,-
chr6,31322424,1.4466748021579636,5471,4362,9833,-
chr6,31322434,1.733731944994064,3357,2431,5788,-
chr6,31322435,1.2748966691561765,5489,4391,9880,-
chr6,31322437,0.682664464795061,3560,3018,6578,-
chr6,31322938,1.603505387625726,7410,7058,14468,-
chr6,31322939,1.5600224192628334,10895,10257,21152,-
chr6,31322941,1.3577796751817466,19733,17139,36872,-
chr6,31322942,1.4234321960737946,25318,20489,45807,-
chr6,31322943,1.684316115676714,16126,14150,30276,-
chr6,31322944,1.6615413752146773,18769,15058,33827,-
chr6,31322945,1.89222237472717,14677,12167,26844,-
chr6,31322947,2.07932266717762,8646,6799,15445,-
chr6,31322948,1.9562796930602242,8287,6032,14319,-
chr6,31322964,0.7360145506259206,4521,3369,7890,-
chr6,31322991,0.7889554499759002,2021,1544,3565,-
chr6,31323114,1.4705041418082454,3620,2407,6027,-
chr6,31323136,1.6204867847514424,2426,1845,4271,-
chr6,31323198,1.4409161163411548,2343,1940,4283,-
chr6,31323201,0.6727487575157266,1488,1250,2738,-
chr6,31323202,1.482271746944644,2177,1390,3567,-
chr6,31323205,1.6142136528908688,2136,1697,3833,-
chr6,31323269,0.4422282533254834,2496,1502,3998,-
chr6,31323275,0.657485771498458,4746,2586,7332,-
chr6,31323277,0.6839744920517254,8614,5148,13762,-
chr6,31323281,1.103428279829282,5651,3803,9454,-
chr6,31323282,1.103428279829282,5651,3803,9454,-
chr6,31323283,1.0115119963469792,6780,4582,11362,-
chr6,31323290,1.489077285679108,1410,916,2326,-
chr6,31323293,1.378876509028845,2998,1899,4897,-
chr6,31323301,4.226713532513181,961,568,1529,-
chr6,31323317,0.5041956018518519,696,383,1079,-
chr6,31323326,2.211309523809524,742,335,1077,-
chr6,31323327,2.211309523809524,742,335,1077,-
chr6,31323361,0.6070214802932992,981,658,1639,-
chr6,31324068,1.2897194111578698,4952,3580,8532,-
chr6,31324122,1.0445409835081498,5868,3599,9467,-
chr6,31324123,1.6821700162954916,990,788,1778,-
chr6,31324124,1.0209492397251019,8407,5426,13833,-
chr6,31324126,0.9851150102115352,2669,1812,4481,-
chr6,31324146,1.8178801236256776,982,730,1712,-
chr6,31324149,0.6941015089163237,714,584,1298,-
chr6,31324481,1.4669174681973318,2081,1757,3838,-
chr6,31324482,1.284467994005566,2096,1556,3652,-
chr6,31324485,0.6745208845998546,2876,2457,5333,-
chr6,31324499,1.5757838174910312,3176,2507,5683,-
chr6,31324518,1.6126824817518248,1413,821,2234,-
chr6,31324519,0.5153119005246493,928,882,1810,-
chr6,31324522,0.5019762845849802,1142,758,1900,-
chr6,31324532,1.6429387508738218,2749,2208,4957,-
chr6,31324533,1.6293740376337587,3984,2920,6904,-
chr6,31324541,1.461166335321405,1296,1005,2301,-
chr6,31324581,0.7162985387001533,1368,990,2358,-
chr6,31324623,2.15167138587384,3325,2607,5932,-
chr6,31324625,2.04691464805635,4866,3684,8550,-
chr6,31324626,1.9791633580027317,4649,3313,7962,-
chr6,31324628,1.6633639504056985,3029,2093,5122,-
chr6,31324632,1.5269558769002596,1395,929,2324,-
chr6,31324640,1.4798605056669571,1229,774,2003,-
chr6,31324641,0.6325788032094619,1469,1146,2615,-
chr6,31324712,1.7266242038216562,752,627,1379,-
chr6,31324871,1.8997028900693256,1054,765,1819,-
chr6,31324885,2.55072463768116,890,485,1375,-
chr6,31324948,1.71190400339811,657,437,1094,-
chr6,31324951,1.8940382576323034,1747,1021,2768,-
chr6,31324956,2.0603305785123966,830,494,1324,-
chr6,31324960,2.289937690574042,750,396,1146,-
chr6,31324981,2.6479411087769513,1022,480,1502,-
chr6,31324988,0.9055459597652284,1461,610,2071,-
chr6,31498644,2.1021091396049547,896,514,1410,-
chr6,31498663,1.9549086757990868,821,437,1258,-
chr6,31499117,1.7242365172189735,855,569,1424,-
chr6,31499171,1.5649605852018447,871,656,1527,-
chr6,31499177,0.6100496464570483,810,577,1387,-
chr6,31500587,2.0963265306122447,855,699,1554,-
chr6,31503177,2.56964656964657,617,480,1097,-
chr6,31503237,0.62759410801964,912,649,1561,-
chr6,31504345,1.9475806451612905,758,495,1253,-
chr6,31504348,0.6086142322097378,649,533,1182,-
chr6,31504349,1.5869074492099324,702,442,1144,-
chr6,31508311,1.4703354142505818,801,700,1501,-
chr6,31508312,0.5377314814814814,605,539,1144,-
chr6,31509777,0.9412885662431942,2276,869,3145,-
chr6,31509778,0.8950784715976159,4605,1716,6321,-
chr6,31509779,0.9020064756330967,5705,2184,7889,-
chr6,31606917,2.575052854122622,545,472,1017,-
chr6,31606919,2.575052854122622,545,472,1017,-
chr6,31606987,3.051612903225806,791,743,1534,-
chr6,31606988,3.051612903225806,791,743,1534,-
chr6,31606989,3.051612903225806,791,743,1534,-
chr6,31608663,1.3103576506264518,1251,944,2195,-
chr6,31608708,2.440668567291958,815,624,1439,-
chr6,31615501,2.582142857142857,722,489,1211,-
chr6,31615502,2.582142857142857,722,489,1211,-
chr6,31617049,1.0367758186397984,685,396,1081,-
chr6,31617050,1.5076845679814432,1225,781,2006,-
chr6,31617052,0.9630606860158312,656,378,1034,-
chr6,31617385,1.8628865979381442,694,484,1178,-
chr6,31617390,2.112769485903814,685,468,1153,-
chr6,31617395,0.5410375893134514,621,434,1055,-
chr6,31617402,2.100051519529758,1077,785,1862,-
chr6,31620238,1.2295922959229593,827,541,1368,-
chr6,31620240,1.2295922959229593,827,541,1368,-
chr6,31698418,22.51908088934034,5679,4904,10583,-
chr6,31698419,22.51908088934034,5679,4904,10583,-
chr6,31698433,1.565693430656934,1022,547,1569,-
chr6,31698436,1.5507901774860202,937,456,1393,-
chr6,31698441,6.703577983681941,4875,2522,7397,-
chr6,31698442,6.7392114279021245,4039,2155,6194,-
chr6,31698447,7.918784822199187,4801,2116,6917,-
chr6,31698448,8.384883003865465,5818,2440,8258,-
chr6,31698449,7.895312778104284,3628,1462,5090,-
chr6,31698457,1.6319278547539418,1092,321,1413,-
chr6,31698461,4.622325627344213,5548,1841,7389,-
chr6,31698462,4.622325627344213,5548,1841,7389,-
chr6,31698530,1.2575328237860666,1791,1196,2987,-
chr6,31700010,1.6282828282828286,805,626,1431,-
chr6,31701367,1.4537530266343826,1500,944,2444,-
chr6,31701374,1.8045377516922112,2152,1490,3642,-
chr6,31702020,1.7642455858747992,976,711,1687,-
chr6,31704079,0.5934782608695652,636,459,1095,-
chr6,31704092,1.6123969140728915,835,536,1371,-
chr6,31704221,0.4217768871075484,573,498,1071,-
chr6,31704222,0.4212191997588727,429,576,1005,-
chr6,31704225,3.3807953386958314,2348,2285,4633,-
chr6,31704236,8.272680767537524,2168,1891,4059,-
chr6,31704239,13.749066989272299,6282,4371,10653,-
chr6,31704240,13.79242606467557,6695,4554,11249,-
chr6,31704241,13.792426064675569,6695,4554,11249,-
chr6,31704242,15.36037037037037,1237,719,1956,-
chr6,31746788,4.523012779842291,610,393,1003,-
chr6,31750937,1.325298603969309,614,466,1080,-
chr6,31760640,0.874110220576825,583,456,1039,-
chr6,31765308,1.9394990116950654,864,664,1528,-
chr6,31765337,3.905908096280088,594,456,1050,-
chr6,31765338,3.905908096280088,594,456,1050,-
chr6,31765451,1.823939176298522,762,575,1337,-
chr6,31765648,2.512342322749021,1126,967,2093,-
chr6,31765649,2.512342322749021,1126,967,2093,-
chr6,31773906,1.9829130875987677,909,614,1523,-
chr6,31852492,3.0892830439356715,666,431,1097,-
chr6,31920160,2.3584738830654524,714,562,1276,-
chr6,31922102,2.4701670644391407,584,418,1002,-
chr6,31922363,5.183645078667353,1462,1231,2693,-
chr6,31922369,4.610452442710667,1430,1047,2477,-
chr6,31922405,9.500848625961883,2431,1287,3718,-
chr6,31922406,17.712177121771216,959,541,1500,-
chr6,31922514,2.784690799396682,843,623,1466,-
chr6,31922517,2.27673762503206,806,556,1362,-
chr6,31922521,1.9875871346459584,2166,1325,3491,-
chr6,31922522,1.9875871346459584,2166,1325,3491,-
chr6,31922523,1.9875871346459584,2166,1325,3491,-
chr6,31922852,0.4841434342747258,2293,1706,3999,-
chr6,31922853,0.5060789403366798,1606,1138,2744,-
chr6,31922854,0.5060789403366798,1606,1138,2744,-
chr6,31922999,0.4866142382397259,942,768,1710,-
chr6,31923019,2.3702923686818638,1443,1008,2451,-
chr6,31923021,2.3702923686818638,1443,1008,2451,-
chr6,31923046,2.7310522442972776,570,452,1022,-
chr6,31924786,1.1111892570153796,1624,1110,2734,-
chr6,31926155,2.4890081799591,748,488,1236,-
chr6,31926156,0.5575221238938053,701,451,1152,-
chr6,31926212,2.13265306122449,670,426,1096,-
chr6,31926213,2.13265306122449,670,426,1096,-
chr6,32083110,10.570920644726465,577,870,1447,-
chr6,32083192,4.899413264254025,985,649,1634,-
chr6,32083248,15.551428347258174,762,569,1331,-
chr6,32084570,2.7319474245024824,721,557,1278,-
chr6,32094913,1.4714147356908336,696,511,1207,-
chr6,32136063,21.37429468712834,1806,1407,3213,-
chr6,32136064,16.68104471013167,1969,1506,3475,-
chr6,32137054,4.892607129631905,635,546,1181,-
chr6,32138751,4.4983310426075,789,462,1251,-
chr6,32152889,7.7195005861575785,822,573,1395,-
chr6,32152890,9.052925261843237,717,474,1191,-
chr6,32152891,10.010384194720796,709,485,1194,-
chr6,32153954,4.596331222060311,694,587,1281,-
chr6,32153955,6.468535414646746,697,584,1281,-
chr6,32795566,2.0563355096515097,1601,1176,2777,-
chr6,32795598,0.8353033884948778,1589,845,2434,-
chr6,32795599,1.1700637822248363,2303,1267,3570,-
chr6,32795600,1.021117542685942,2064,1108,3172,-
chr6,32795601,0.8086036123519129,1513,812,2325,-
chr6,32795646,2.6727675406226936,961,518,1479,-
chr6,32795673,4.424118322195782,833,395,1228,-
chr6,32809915,1.8321591477098038,1013,725,1738,-
chr6,32810536,0.4163549688302163,810,605,1415,-
chr6,32810538,0.4163549688302163,810,605,1415,-
chr6,32810778,2.377041931131406,1214,870,2084,-
chr6,32810860,2.003950561544105,806,610,1416,-
chr6,32810862,2.003950561544105,806,610,1416,-
chr6,32813207,1.5447588917521682,661,636,1297,-
chr6,32815411,1.4705882352941178,624,399,1023,-
chr6,32815412,1.4705882352941178,624,399,1023,-
chr6,32815413,1.4705882352941178,624,399,1023,-
chr6,33161861,9.658154923377865,626,795,1421,-
chr6,33237292,2.942358419087584,663,488,1151,-
chr6,33255988,28.481497532712325,2248,1680,3928,-
chr6,33255989,28.48149753271233,2248,1680,3928,-
chr6,33255990,38.880801015274415,1345,890,2235,-
chr6,33384387,2.5522388059701493,611,535,1146,-
chr6,33384740,0.655793991416309,1527,1164,2691,-
chr6,33384901,1.8009876971062209,1013,795,1808,-
chr6,33385039,1.3967868190139512,1340,867,2207,-
chr6,33385044,1.5317978404565424,3730,2470,6200,-
chr6,33385046,1.5317978404565424,3730,2470,6200,-
chr6,33385048,1.4423292562434225,4184,3810,7994,-
chr6,33385049,1.3101131659154006,8014,6800,14814,-
chr6,33385051,1.1666965461243262,9996,7818,17814,-
chr6,33385052,1.3751395197612255,8023,6181,14204,-
chr6,33385054,1.9978916155897624,2284,1942,4226,-
chr6,33385281,1.9943232473936066,1419,1125,2544,-
chr6,33385299,0.9073827094632644,1423,977,2400,-
chr6,33385301,0.9073827094632644,1423,977,2400,-
chr6,33385306,2.106585628963086,1194,926,2120,-
chr6,33385308,1.9601776931619863,1764,1336,3100,-
chr6,33385309,1.9529923273657293,1156,849,2005,-
chr6,33385310,1.413291316002881,1099,746,1845,-
chr6,33665418,1.8798701298701297,771,447,1218,-
chr6,33665420,0.7968113975576663,890,736,1626,-
chr6,33665421,0.556356381967816,2359,1766,4125,-
chr6,33668277,0.5250889803894201,835,622,1457,-
chr6,33679333,0.5247642333216905,625,408,1033,-
chr6,33679337,3.147863757566584,2851,2161,5012,-
chr6,33679338,2.239933638238723,1454,1133,2587,-
chr6,33679353,3.582953682611997,754,438,1192,-
chr6,34249812,2.451138819617623,1797,1202,2999,-
chr6,34249813,2.578267502146666,2499,1788,4287,-
chr6,34249816,2.0805647840531565,834,515,1349,-
chr6,34249819,2.5685851322891384,1892,1401,3293,-
chr6,34249824,2.197263901147396,1148,823,1971,-
chr6,34249825,2.197263901147396,1148,823,1971,-
chr6,34249851,1.6361031122918268,775,467,1242,-
chr6,34386188,1.2873785978795524,32482,19897,52379,-
chr6,34386189,1.2739819911973356,31683,19779,51462,-
chr6,34389526,1.1672129085461818,14207,8475,22682,-
chr6,34389533,1.4419331134859195,11228,8672,19900,-
chr6,34389534,1.4918444091976146,12269,8090,20359,-
chr6,34392907,1.2772139019206863,7682,3671,11353,-
chr6,34392915,1.4411790576530263,6569,2960,9529,-
chr6,34393824,0.8021838978279551,5131,4820,9951,-
chr6,34393826,1.0400978164512165,11822,8049,19871,-
chr6,34393831,0.6284090263172853,4481,3284,7765,-
chr6,34393838,0.8074949621471108,14086,10168,24254,-
chr6,34393839,0.827617393004742,8304,5291,13595,-
chr6,34393840,0.760115718418515,3005,3049,6054,-
chr6,34393841,0.7127538914364046,2133,2097,4230,-
chr6,34393843,1.0882061467567787,5621,3571,9192,-
chr6,34393844,1.1893691290148845,9230,8664,17894,-
chr6,34393845,1.1354513296162687,11413,8919,20332,-
chr6,34393846,1.1790596281039567,6438,4662,11100,-
chr6,34393848,1.2062919030428054,2338,1301,3639,-
chr6,34393850,1.05368906455863,1370,758,2128,-
chr6,34846471,2.511387984271174,615,466,1081,-
chr6,35801574,2.82547931475021,688,470,1158,-
chr6,35810373,2.086551993211865,6055,4505,10560,-
chr6,35810375,1.962471320153408,7368,5501,12869,-
chr6,35810377,1.74207607839706,2676,2077,4753,-
chr6,35825042,1.857797664520353,2347,1665,4012,-
chr6,35825043,1.857797664520353,2347,1665,4012,-
chr6,35825057,1.661070636680393,873,573,1446,-
chr6,35825072,3.0845469255663427,609,411,1020,-
chr6,35825092,1.011923076923077,876,599,1475,-
chr6,35825094,1.011923076923077,876,599,1475,-
chr6,36823167,2.7460629921259843,619,507,1126,-
chr6,36823168,2.7460629921259843,619,507,1126,-
chr6,36823651,1.6206424083550748,7940,5958,13898,-
chr6,36823652,1.5722088218693755,5202,3323,8525,-
chr6,36823653,1.712485030369792,10214,7433,17647,-
chr6,36823654,1.5961800628968674,10267,7115,17382,-
chr6,36823655,1.6870132377441778,10623,7291,17914,-
chr6,36823657,1.9425097685192896,3589,2262,5851,-
chr6,36823672,1.6230791962174942,1351,845,2196,-
chr6,36823673,1.6230791962174942,1351,845,2196,-
chr6,36824408,1.9757296115654273,653,534,1187,-
chr6,36936003,1.5374160300397817,2065,1586,3651,-
chr6,36936082,1.5883283024292079,1189,772,1961,-
chr6,36936119,1.5076018612558788,1895,1621,3516,-
chr6,36936201,1.3961925070955894,1995,1417,3412,-
chr6,36936224,1.6747159090909092,654,351,1005,-
chr6,36936258,2.291400142146411,619,468,1087,-
chr6,36936433,0.4749586092715231,1019,905,1924,-
chr6,36936435,0.4749586092715231,1019,905,1924,-
chr6,36936442,3.406533775547706,2986,2858,5844,-
chr6,36936443,3.406533775547706,2986,2858,5844,-
chr6,36936461,1.898180780554188,889,677,1566,-
chr6,36936472,6.136261337563473,1313,969,2282,-
chr6,36936480,4.354358610914245,1023,497,1520,-
chr6,36936481,3.553981687168467,1816,1076,2892,-
chr6,36936486,7.243686858943283,2059,1305,3364,-
chr6,36936488,2.521105664488018,804,543,1347,-
chr6,36936500,20.51535753059638,2998,1419,4417,-
chr6,36936501,19.542176437972508,2583,1187,3770,-
chr6,36936586,1.4597980025954973,538,478,1016,-
chr6,36937830,2.9195071624676907,1350,918,2268,-
chr6,36937852,0.6859528780196839,574,478,1052,-
chr6,36937883,2.030316742081448,640,389,1029,-
chr6,36940568,2.469096671949287,983,630,1613,-
chr6,36945010,0.5479127134724858,615,495,1110,-
chr6,36945869,1.683661145617667,672,503,1175,-
chr6,36945885,1.7936685288640597,687,536,1223,-
chr6,36946306,1.7179863147605083,854,593,1447,-
chr6,36946383,1.8089212339889025,1278,958,2236,-
chr6,36949378,2.115839243498818,715,469,1184,-
chr6,36953653,3.091258664027166,749,573,1322,-
chr6,36953722,8.725109729128235,1211,917,2128,-
chr6,36953723,4.906231805514293,1092,732,1824,-
chr6,38643931,0.7140060438838522,1752,1289,3041,-
chr6,38644007,1.7750865051903113,1367,1155,2522,-
chr6,38644009,1.9056424398407323,2353,1734,4087,-
chr6,38644016,1.6701428390848185,754,585,1339,-
chr6,38644278,1.7270187393526404,791,586,1377,-
chr6,38644467,1.911570611526617,3159,2272,5431,-
chr6,38644469,4.432064060345752,6858,4972,11830,-
chr6,38644616,1.7442510732103491,1902,1325,3227,-
chr6,38644629,1.5609756097560974,1151,737,1888,-
chr6,38644991,1.871542428504454,997,710,1707,-
chr6,38645093,1.5378080544980963,983,712,1695,-
chr6,38652194,2.189168573607933,1784,1172,2956,-
chr6,38654741,2.596479791395045,568,471,1039,-
chr6,38654749,0.442350332594235,626,450,1076,-
chr6,38670751,1.9128101945003355,743,425,1168,-
chr6,38670754,0.6264586160108548,728,401,1129,-
chr6,38670913,1.8516114005019866,724,688,1412,-
chr6,41903338,2.5644505418380286,690,566,1256,-
chr6,42175539,2.6447101999493796,852,877,1729,-
chr6,42175565,0.5464262411324109,1399,997,2396,-
chr6,42175718,1.735629841011007,654,445,1099,-
chr6,42175872,0.4319880418535127,577,445,1022,-
chr6,42176650,2.286338201173741,697,430,1127,-
chr6,42176658,2.5499153976311337,684,393,1077,-
chr6,42176673,1.6717609178930806,1239,819,2058,-
chr6,42181900,2.0454373615944323,1009,626,1635,-
chr6,42182063,1.051381025904958,720,401,1121,-
chr6,42182065,1.051381025904958,720,401,1121,-
chr6,42182072,3.1842554644808745,642,365,1007,-
chr6,42182073,3.052993789986468,942,562,1504,-
chr6,42981658,0.8745619524405506,2540,1597,4137,-
chr6,42981659,1.0218795924821262,3009,1942,4951,-
chr6,42981660,1.0416427534127153,4408,2965,7373,-
chr6,42981661,1.023960243190204,3520,2390,5910,-
chr6,42981662,1.0044498312350283,2182,1633,3815,-
chr6,43014653,1.6070901173278611,796,501,1297,-
chr6,43014676,2.305605247101518,696,397,1093,-
chr6,43193467,1.8453417788334652,1215,841,2056,-
chr6,43193485,1.920881166614955,905,585,1490,-
chr6,43193525,0.5467625899280576,735,555,1290,-
chr6,43193528,1.9852073888972346,1753,1443,3196,-
chr6,43193529,1.7879149274498112,1284,1031,2315,-
chr6,43193590,1.7844626168224298,704,427,1131,-
chr6,43193813,0.3722627737226278,679,410,1089,-
chr6,43193863,6.56271186440678,615,412,1027,-
chr6,43194093,2.0832161609414674,733,642,1375,-
chr6,43194099,0.5638991818215453,809,671,1480,-
chr6,43194105,1.986353764208259,725,618,1343,-
chr6,43194113,2.2808583767830672,900,682,1582,-
chr6,43194114,2.1817397391498887,988,695,1683,-
chr6,43197144,2.608999842866895,1546,1121,2667,-
chr6,43197145,2.1995282718174285,907,580,1487,-
chr6,43197146,2.327267362362126,1355,903,2258,-
chr6,43480229,1.5523387837756486,652,439,1091,-
chr6,43483682,0.1925754060324826,580,430,1010,-
chr6,43483683,0.1925754060324826,580,430,1010,-
chr6,43643338,0.6709482038429406,1284,664,1948,-
chr6,43643343,1.0271224165548987,2734,1765,4499,-
chr6,43643351,2.356632319632622,1984,1113,3097,-
chr6,43646262,1.7513471901462663,874,432,1306,-
chr6,43646268,1.8591549295774645,749,354,1103,-
chr6,44081617,1.894022852295006,1167,849,2016,-
chr6,44081722,1.7788235294117647,755,611,1366,-
chr6,44081731,1.6567489114658929,760,582,1342,-
chr6,44081776,0.6046025104602512,577,477,1054,-
chr6,44081874,3.117957746478873,692,425,1117,-
chr6,44081917,0.5093167701863355,860,551,1411,-
chr6,44084338,2.037393655537611,1087,903,1990,-
chr6,44095097,3.696446078431373,972,543,1515,-
chr6,44095098,3.696446078431373,972,543,1515,-
chr6,44095154,1.755496902661619,832,439,1271,-
chr6,44222184,5.829830412337222,1898,1551,3449,-
chr6,44222218,5.942857142857144,647,404,1051,-
chr6,44222413,1.7275805299288665,868,656,1524,-
chr6,44222414,1.7275805299288665,868,656,1524,-
chr6,44222549,11.564528146018368,1593,1023,2616,-
chr6,44222550,13.805297672417026,2334,1353,3687,-
chr6,44222551,16.347097405136775,1792,1069,2861,-
chr6,44222937,1.7912479261659864,906,617,1523,-
chr6,44223283,2.1379077346502107,720,528,1248,-
chr6,44223290,2.6477493333920217,1086,744,1830,-
chr6,52128959,3.122047244094488,792,634,1426,-
chr6,52129104,2.149828302909813,792,502,1294,-
chr6,52129138,2.235054347826087,657,551,1208,-
chr6,52129145,1.9661299831241807,1275,877,2152,-
chr6,52129316,1.5923621022427836,1508,1112,2620,-
chr6,52129319,2.3425112741625314,1390,959,2349,-
chr6,52129337,1.9828140282241158,616,420,1036,-
chr6,52129344,2.3877950348538586,780,480,1260,-
chr6,52129461,1.5073529411764706,573,447,1020,-
chr6,52129504,2.0523821401845845,747,632,1379,-
chr6,52131441,1.9425154320987652,1006,671,1677,-
chr6,52131466,1.673545673076923,1718,1279,2997,-
chr6,52131467,1.6304880658942198,2560,1842,4402,-
chr6,52132749,0.5154375299952008,1073,892,1965,-
chr6,52133902,1.9047120227259864,2460,1883,4343,-
chr6,52133911,1.6970282810428634,930,583,1513,-
chr6,52137147,1.8465455015561592,1629,1084,2713,-
chr6,52137159,2.4355971896955504,623,426,1049,-
chr6,52138093,1.7327674023769102,566,464,1030,-
chr6,52138113,2.055925925925926,792,539,1331,-
chr6,52138116,2.3882818901939364,602,522,1124,-
chr6,52138550,1.929,642,499,1141,-
chr6,52138601,0.6014347681014348,720,665,1385,-
chr6,52138671,2.3382361228515074,901,844,1745,-
chr6,52138688,1.7895451459606244,658,490,1148,-
chr6,52141215,2.355368026254102,627,473,1100,-
chr6,52141904,2.181147972617167,762,632,1394,-
chr6,52141906,2.181147972617167,762,632,1394,-
chr6,52142375,1.9175,571,439,1010,-
chr6,52142376,1.7725714285714285,751,559,1310,-
chr6,52142377,1.774817793415431,641,518,1159,-
chr6,52142378,0.5656565656565656,839,539,1378,-
chr6,52142379,2.0566476432043967,694,497,1191,-
chr6,52142430,1.9034562211981565,750,619,1369,-
chr6,52142478,1.720372723422279,882,786,1668,-
chr6,52143609,1.8722891987687718,2378,2415,4793,-
chr6,52143610,1.8722891987687718,2378,2415,4793,-
chr6,52143613,2.2074344911639243,1131,1093,2224,-
chr6,52143630,0.6890143992055611,1180,1006,2186,-
chr6,52143636,2.418831168831169,744,615,1359,-
chr6,52143639,1.663752297899828,1609,1325,2934,-
chr6,52143645,2.5080082135523614,787,486,1273,-
chr6,52144176,2.027001569858713,1075,734,1809,-
chr6,52144177,2.027001569858713,1075,734,1809,-
chr6,52144370,0.5705521472392638,743,488,1231,-
chr6,52146887,0.4623150166341632,805,757,1562,-
chr6,52146951,2.181428913317726,6103,5227,11330,-
chr6,52146953,2.86403336363413,3545,3130,6675,-
chr6,52146954,2.0921758375911703,5307,4503,9810,-
chr6,52146956,2.5005649717514125,4425,3421,7846,-
chr6,52146957,2.424015711212943,4319,3178,7497,-
chr6,52146958,2.424015711212943,4319,3178,7497,-
chr6,52146959,2.467457737321196,3206,2306,5512,-
chr6,52146962,2.5684564680032955,1010,661,1671,-
chr6,52146965,1.5685847589424575,983,642,1625,-
chr6,52146966,0.7196786975622361,1452,1221,2673,-
chr6,52147557,1.8558790460974024,964,785,1749,-
chr6,52147569,0.5647435897435897,880,689,1569,-
chr6,52147608,3.025241124563924,566,442,1008,-
chr6,52147653,2.8778266331658293,832,596,1428,-
chr6,52148113,2.5249796084828717,634,612,1246,-
chr6,52149418,1.838867200074771,1764,1340,3104,-
chr6,52149421,1.813871196036801,931,627,1558,-
chr6,52149424,2.1414326414326417,618,467,1085,-
chr6,52149518,0.4819614411741796,1316,839,2155,-
chr6,52149546,0.7319537448630716,1319,857,2176,-
chr6,53132447,3.0754240974336677,981,604,1585,-
chr6,53132449,2.7894375609579884,1484,892,2376,-
chr6,53132450,2.331903454786577,1450,956,2406,-
chr6,53132590,1.9864061172472385,1001,748,1749,-
chr6,53132592,1.9864061172472385,1001,748,1749,-
chr6,53132642,2.1233493397358947,565,475,1040,-
chr6,53132846,3.395784543325527,579,426,1005,-
chr6,53133134,0.6312144647139663,936,628,1564,-
chr6,53133311,2.061544732015488,842,700,1542,-
chr6,53133356,1.8563753112305075,786,586,1372,-
chr6,53133498,0.9298387096774194,1152,929,2081,-
chr6,53133499,0.9712193861287662,2291,1727,4018,-
chr6,53133500,1.0156763751299294,1139,798,1937,-
chr6,53133677,1.891573155828382,1545,1149,2694,-
chr6,53133994,1.3644565210700261,929,639,1568,-
chr6,53135508,3.3079295219243057,806,610,1416,-
chr6,53141029,1.843843265620487,1007,798,1805,-
chr6,74082704,1.7438737831487081,1038,661,1699,-
chr6,74227355,1.2172011551099904,21841,14955,36796,-
chr6,74227356,1.2172011551099904,21841,14955,36796,-
chr6,74227358,1.3997896938624712,5780,3634,9414,-
chr6,74227373,0.6656358249983748,4574,2760,7334,-
chr6,74227381,1.137920262074526,9936,7476,17412,-
chr6,74227385,1.23487887344426,3200,1918,5118,-
chr6,74227386,1.4096700730420586,5910,4842,10752,-
chr6,74227388,1.3945767012932695,8553,6923,15476,-
chr6,74227389,1.3667705471224343,10112,7036,17148,-
chr6,74227391,1.1807352499442074,8659,5065,13724,-
chr6,74227393,1.2860412644682828,11453,7510,18963,-
chr6,74227394,1.2338214947582187,8186,4752,12938,-
chr6,74227396,1.2597070893776818,13384,8120,21504,-
chr6,74227397,1.4121818128952401,9268,5676,14944,-
chr6,74227398,1.2369983260462392,7755,4410,12165,-
chr6,74227399,1.7549279150155972,2939,2044,4983,-
chr6,74227400,0.6637031415599307,6343,4497,10840,-
chr6,74227401,1.3251850409037786,1236,603,1839,-
chr6,74227402,0.9068076378780673,6570,4652,11222,-
chr6,74227404,1.6722362043251304,1965,893,2858,-
chr6,74227406,1.3556700951065266,4957,2486,7443,-
chr6,74227407,1.6222774324783547,4446,2064,6510,-
chr6,74227408,1.376762593124133,4706,2306,7012,-
chr6,74227409,1.7448749999999995,2474,999,3473,-
chr6,74227415,0.6574807785705316,1096,721,1817,-
chr6,74227810,1.0943476007726725,30655,23750,54405,-
chr6,74227842,0.8583979471460693,18017,13447,31464,-
chr6,74227960,0.93233826677787,64438,51277,115715,-
chr6,74227961,1.261370362689549,101989,63508,165497,-
chr6,74227988,1.0003252339853483,1294,862,2156,-
chr6,74228075,4.500601962897155,858,583,1441,-
chr6,74228117,1.2264270226451848,64163,36564,100727,-
chr6,74228428,1.1953941083223876,113289,77624,190913,-
chr6,74228469,1.1647456992196399,58480,42181,100661,-
chr6,74228716,1.2511681300187207,15718,7858,23576,-
chr6,74228725,1.2294744283662875,23987,11521,35508,-
chr6,74228727,1.3049541331263794,96345,59540,155885,-
chr6,74228728,1.3202841235085165,72325,47094,119419,-
chr6,74228745,1.385749044347277,8479,5538,14017,-
chr6,74228748,1.3049616282874097,13800,6222,20022,-
chr6,74228749,1.4239577385821982,28343,14818,43161,-
chr6,74228757,1.4816853225563442,5392,2387,7779,-
chr6,74228760,1.4688373714232614,21431,11188,32619,-
chr6,74228761,1.3500754489073634,26245,13757,40002,-
chr6,74228764,1.5249586287258627,8142,3375,11517,-
chr6,74228765,1.4466622583144093,17929,8841,26770,-
chr6,74228766,1.38754344247302,9787,5466,15253,-
chr6,74228768,0.7566036174262921,8195,5904,14099,-
chr6,74228769,1.097324958054345,6100,3255,9355,-
chr6,74228770,0.9896963917116057,20334,13067,33401,-
chr6,74228771,1.1510998644795616,17176,10538,27714,-
chr6,74228772,1.2201495702500476,17882,9415,27297,-
chr6,74228773,1.3062967704627326,14977,7893,22870,-
chr6,74228776,0.6593838570548367,4397,3245,7642,-
chr6,74228778,0.7836504400502298,7857,5372,13229,-
chr6,74228779,1.1018766450554334,3021,1117,4138,-
chr6,74228780,0.968703216018872,6699,3866,10565,-
chr6,74228781,1.2738095238095235,1925,953,2878,-
chr6,74228784,0.926654863242277,3333,1409,4742,-
chr6,74228786,0.8156852539686295,2572,982,3554,-
chr6,74228787,1.0968721270875277,3578,1568,5146,-
chr6,74228788,0.9869060555171392,1340,1059,2399,-
chr6,74228790,0.9869060555171392,1340,1059,2399,-
chr6,74228793,1.4975604088789802,866,522,1388,-
chr6,74228794,1.1139846823384438,1383,660,2043,-
chr6,74228795,1.2178938111716402,1332,620,1952,-
chr6,74228797,1.19532267891873,1440,621,2061,-
chr6,74229147,1.1767644897983691,83657,48035,131692,-
chr6,74229640,1.2123931075951455,127369,78476,205845,-
chr6,74229641,1.2223366440331842,70930,39492,110422,-
chr6,74229662,1.0965458896384874,41493,22462,63955,-
chr6,74229663,1.0060167863776646,56871,40625,97496,-
chr6,74229664,1.160106932706922,58394,31544,89938,-
chr6,74229666,1.1987103495945328,80291,44884,125175,-
chr6,74229668,1.2921067351096305,89235,50135,139370,-
chr6,74229669,1.2613717601930208,70044,41275,111319,-
chr6,74229685,1.408924508506593,9501,4433,13934,-
chr6,74229688,1.3540009214591142,41938,23637,65575,-
chr6,74229690,1.3252910228579373,63909,34340,98249,-
chr6,74229691,1.2717657145031975,54442,31753,86195,-
chr6,74229700,1.265568018929015,22964,11855,34819,-
chr6,74229701,0.9773466341090834,10083,7819,17902,-
chr6,74229702,1.1861449988886847,37588,21998,59586,-
chr6,74229705,1.3679418598368185,4602,1989,6591,-
chr6,74229708,1.338341350927837,8583,5161,13744,-
chr6,74229741,0.619280835010141,8994,7815,16809,-
chr6,74230728,1.1594462452878962,3453,3560,7013,-
chr6,74230731,0.6021065615008846,2649,2678,5327,-
chr6,74230738,1.2271474522129553,4192,3232,7424,-
chr6,74230741,0.7532309059649736,3417,3812,7229,-
chr6,74230742,0.7532309059649736,3417,3812,7229,-
chr6,74230745,0.8022735455182824,2806,2362,5168,-
chr6,74230749,0.782574949063743,2219,1873,4092,-
chr6,74230750,0.6657346881873664,1998,1527,3525,-
chr6,74230753,1.2992115981306251,1460,1260,2720,-
chr6,74230754,1.273022945407649,3992,3262,7254,-
chr6,74230755,1.273022945407649,3992,3262,7254,-
chr6,75794897,1.602065104428576,918,488,1406,-
chr6,75794899,1.7639392592520708,1388,772,2160,-
chr6,75827190,1.1858101449736154,1615,1026,2641,-
chr6,75827205,0.5523619022771086,1360,792,2152,-
chr6,75827206,0.5523619022771086,1360,792,2152,-
chr6,75834955,2.9094703570721347,720,404,1124,-
chr6,75947659,1.305751357560568,2985,2015,5000,-
chr6,75953452,1.3884839747144284,3098,1774,4872,-
chr6,75953462,1.4272049328811938,9595,6110,15705,-
chr6,75953463,1.635929633547934,3919,2745,6664,-
chr6,75953482,1.3261348238482384,2236,1311,3547,-
chr6,75953501,0.8504030298823385,6829,3657,10486,-
chr6,75953505,1.4565636327299052,1020,610,1630,-
chr6,75962806,11.152858462009442,412,623,1035,-
chr6,75962812,8.217892240578527,887,1065,1952,-
chr6,75962813,8.762915662171258,805,899,1704,-
chr6,75963112,1.562210370067024,1326,938,2264,-
chr6,75963490,1.4239602853713937,771,525,1296,-
chr6,75965799,1.4263894812939455,635,375,1010,-
chr6,75965961,2.274858189571676,713,506,1219,-
chr6,79911299,3.0327297962074224,1112,660,1772,-
chr6,79913312,1.7820085673488817,623,381,1004,-
chr6,79924704,0.5422775657762603,674,382,1056,-
chr6,82882132,2.3353094417349447,1231,1035,2266,-
chr6,82882134,2.10597439544808,939,702,1641,-
chr6,82882135,3.012629801190422,836,648,1484,-
chr6,83926255,2.4315257910706545,3358,3075,6433,-
chr6,83926256,2.334856796116505,4432,3999,8431,-
chr6,83926257,2.334856796116505,4432,3999,8431,-
chr6,83926258,2.301661764971221,3291,2916,6207,-
chr6,83926289,0.4977851124815426,1041,793,1834,-
chr6,83926290,0.4840549358151628,1719,1325,3044,-
chr6,83926292,0.8182241720697285,842,598,1440,-
chr6,83926293,0.9846981027349969,2024,1543,3567,-
chr6,83926294,1.0974025974025974,1182,945,2127,-
chr6,83926312,0.8518933557454359,889,648,1537,-
chr6,83926313,1.0179864005264312,662,484,1146,-
chr6,83926314,0.922837310020136,1551,1132,2683,-
chr6,83937109,0.5908562419368911,673,408,1081,-
chr6,86257046,2.296596759450568,683,471,1154,-
chr6,86321805,0.5148385273333718,964,723,1687,-
chr6,86321806,0.486751244474091,1049,809,1858,-
chr6,86322601,1.4261704681872749,1079,594,1673,-
chr6,86322602,1.4261704681872749,1079,594,1673,-
chr6,86322603,1.2725198186222804,1240,738,1978,-
chr6,86328645,1.8482285443898976,1735,1165,2900,-
chr6,86328646,1.8482285443898976,1735,1165,2900,-
chr6,86328649,0.6035237025172718,970,708,1678,-
chr6,86332238,2.2860227593600086,794,515,1309,-
chr6,86333780,1.799399055658893,785,481,1266,-
chr6,86351024,1.7629291373239435,970,567,1537,-
chr6,86351036,0.4794395549406882,1017,640,1657,-
chr6,86351047,0.6183733010745037,868,610,1478,-
chr6,86387085,0.5600052621911882,850,537,1387,-
chr6,86387177,1.1359960852278432,957,726,1683,-
chr6,86387550,1.621818438914027,790,543,1333,-
chr6,86387862,0.34950505269175886,634,515,1149,-
chr6,86388447,2.9619269619269617,952,233,1185,-
chr6,86388448,2.8577063389433888,1098,315,1413,-
chr6,86388449,2.9619269619269617,952,233,1185,-
chr6,88228400,2.319306967318625,642,431,1073,-
chr6,88239268,3.222843423266494,1359,925,2284,-
chr6,88239270,3.2373472949389184,1059,763,1822,-
chr6,88239280,4.469628517640273,806,435,1241,-
chr6,88387635,3.840801953926518,732,515,1247,-
chr6,88411931,8.341171982997462,548,642,1190,-
chr6,89773322,1.3175179261127312,1795,1203,2998,-
chr6,89773330,0.9477409932746064,709,318,1027,-
chr6,90038136,1.720886551465064,1017,483,1500,-
chr6,90038201,4.105598543468366,819,506,1325,-
chr6,90038203,4.105598543468366,819,506,1325,-
chr6,90047985,1.7815882241103762,4136,3922,8058,-
chr6,90047988,2.0888667317238743,3351,3366,6717,-
chr6,90047990,1.6781785177859077,8849,8090,16939,-
chr6,90047991,1.466410176550775,9197,8007,17204,-
chr6,90047997,1.66893006111165,2789,2378,5167,-
chr6,90047999,1.66893006111165,2789,2378,5167,-
chr6,90048005,1.5236985236985237,1183,935,2118,-
chr6,90048014,1.5231732842942902,2996,2293,5289,-
chr6,90048015,1.5159783375778588,1846,1416,3262,-
chr6,90048017,1.5918848642438168,974,718,1692,-
chr6,90048020,0.6111111111111112,824,749,1573,-
chr6,90048021,1.9650754089979559,1381,977,2358,-
chr6,90048023,1.9650754089979559,1381,977,2358,-
chr6,90048026,1.869864603481625,1271,939,2210,-
chr6,90048027,1.869864603481625,1271,939,2210,-
chr6,90048179,0.5810147299509002,1064,1033,2097,-
chr6,90048181,0.8032021489788087,1506,1496,3002,-
chr6,90048183,0.9697835446302802,939,950,1889,-
chr6,99824002,0.868367147833172,1223,690,1913,-
chr6,99824004,0.868367147833172,1223,690,1913,-
chr6,99849224,2.378583126695543,636,400,1036,-
chr6,99849460,2.721424226432897,817,528,1345,-
chr6,99997437,1.3830612840984682,1096,796,1892,-
chr6,107040119,3.018356175770716,579,460,1039,-
chr6,107531690,3.029066437650916,663,403,1066,-
chr6,108192622,1.4864718614718613,1138,747,1885,-
chr6,108192623,2.363199282891252,1159,908,2067,-
chr6,108192645,1.582094723786151,1911,1289,3200,-
chr6,108192649,1.8819782854059552,1520,953,2473,-
chr6,108192682,2.2875201721355567,1133,571,1704,-
chr6,108192683,2.2875201721355567,1133,571,1704,-
chr6,108202436,2.3385713124085217,1716,1143,2859,-
chr6,108202437,2.3385713124085217,1716,1143,2859,-
chr6,108202446,3.2331753554502365,757,421,1178,-
chr6,108224077,1.8987654320987646,768,539,1307,-
chr6,108224114,2.0886558155642407,1110,696,1806,-
chr6,108224115,2.1508460221826935,1669,1050,2719,-
chr6,108224123,2.0361705245915775,656,389,1045,-
chr6,108230191,1.6175443319209573,644,582,1226,-
chr6,108532879,2.644986998496299,1419,1256,2675,-
chr6,108532880,2.971051295073641,974,894,1868,-
chr6,108533074,1.6276745495495497,745,591,1336,-
chr6,108533173,0.6483762597984322,771,607,1378,-
chr6,108533364,1.8928179593214618,1067,696,1763,-
chr6,108535758,0.591910292350821,738,453,1191,-
chr6,108544168,1.7937547265438676,1448,1017,2465,-
chr6,108544207,3.3157201303654387,1111,758,1869,-
chr6,108544236,0.7451348583134175,969,695,1664,-
chr6,108582072,1.4773917680894426,2184,1220,3404,-
chr6,108582078,1.1248496397094025,2860,2329,5189,-
chr6,108582079,0.6518977750223875,2405,1612,4017,-
chr6,108582085,1.7538120533496389,3128,2465,5593,-
chr6,108582087,1.7866329884247971,4561,3515,8076,-
chr6,108582088,1.8824643239592374,4714,3408,8122,-
chr6,108582090,1.990002733344138,4092,2890,6982,-
chr6,108582091,2.0791987387554483,2659,1840,4499,-
chr6,108582093,1.5850106586296009,1425,873,2298,-
chr6,108582105,1.5707819546369794,1780,1213,2993,-
chr6,108582106,1.1129777918002843,3600,2481,6081,-
chr6,108582126,1.4783523008411674,628,563,1191,-
chr6,108582130,1.867803520146545,1104,819,1923,-
chr6,108582135,1.584396145343301,1388,783,2171,-
chr6,108582136,1.5988484699087937,1396,777,2173,-
chr6,108582137,1.6435641342161376,1702,937,2639,-
chr6,108582138,1.5819590701370951,1326,718,2044,-
chr6,108582139,1.3433044450656977,960,510,1470,-
chr6,108582155,3.1021557897171084,1099,751,1850,-
chr6,108582156,2.571650348963893,1534,953,2487,-
chr6,109687855,2.267066267066267,591,428,1019,-
chr6,109688233,2.7181467181467185,639,369,1008,-
chr6,109688749,2.566487775790101,806,558,1364,-
chr6,109689098,2.4694096601073343,713,558,1271,-
chr6,109689522,2.086035123269166,796,563,1359,-
chr6,109689690,1.9693096058459714,1191,832,2023,-
chr6,109689728,2.641042030962188,819,516,1335,-
chr6,109689984,2.0823700825643514,793,709,1502,-
chr6,109690036,2.546300604932527,683,613,1296,-
chr6,109690087,2.200475059382423,771,420,1191,-
chr6,109690089,2.200475059382423,771,420,1191,-
chr6,109690154,2.1483216237314595,687,426,1113,-
chr6,109700814,2.5601525821596245,697,425,1122,-
chr6,109703457,2.574591621513271,706,527,1233,-
chr6,109703507,0.8857466589703432,674,429,1103,-
chr6,110421782,1.6954629164573916,778,542,1320,-
chr6,112015698,1.2307044238238154,720,490,1210,-
chr6,112017485,1.3976833560419222,3547,2728,6275,-
chr6,112017486,1.6602551834130785,2851,2279,5130,-
chr6,112017488,1.662921952991511,2471,2562,5033,-
chr6,112017490,1.9026687598116168,3635,3723,7358,-
chr6,112017491,1.796902388255916,3437,3422,6859,-
chr6,112017493,1.873454627874392,2244,2205,4449,-
chr6,112017496,1.2477762028755524,3720,3159,6879,-
chr6,112017497,1.793383563247681,2784,2460,5244,-
chr6,112017499,1.6935619618397566,1812,1566,3378,-
chr6,112017505,1.1938502673796794,704,604,1308,-
chr6,112017618,1.9448952768274361,3390,2538,5928,-
chr6,112017626,1.8115226337448558,1561,1214,2775,-
chr6,112017630,0.425489545303684,1281,916,2197,-
chr6,112017636,1.7964932451853983,1249,922,2171,-
chr6,112017637,2.6791987918289486,910,546,1456,-
chr6,112017640,1.4946797302991992,1134,790,1924,-
chr6,112017641,2.31,818,467,1285,-
chr6,112017644,1.7991143705737334,1893,1333,3226,-
chr6,112017646,0.5667227280635619,697,400,1097,-
chr6,112017651,1.7174379770992367,846,523,1369,-
chr6,112024141,3.350580103938935,620,469,1089,-
chr6,112035599,2.031963770018377,1491,1171,2662,-
chr6,112035600,1.9774977049366989,2187,1692,3879,-
chr6,112035602,2.1340263085272744,2089,1552,3641,-
chr6,112035604,2.1361280144241603,1353,985,2338,-
chr6,114262129,2.555319450347074,621,542,1163,-
chr6,114264564,2.370220588235294,920,679,1599,-
chr6,114264584,1.9054497573984543,1213,945,2158,-
chr6,114264595,1.7820289855072462,847,551,1398,-
chr6,114265505,1.7300675675675674,1137,639,1776,-
chr6,114267213,1.9868995633187772,594,457,1051,-
chr6,114270152,2.20995145631068,606,514,1120,-
chr6,114274551,1.834410455263536,963,843,1806,-
chr6,114292171,3.8690282942428986,752,462,1214,-
chr6,117882310,1.3637754633403933,1518,1032,2550,-
chr6,117882312,3.8850226498759444,720,481,1201,-
chr6,119515046,3.3206224068738845,603,491,1094,-
chr6,122765604,1.785872730979214,590,422,1012,-
chr6,122765610,2.6252742199424977,591,418,1009,-
chr6,122766301,1.2861884658883709,682,509,1191,-
chr6,122779677,2.7090725076938322,630,492,1122,-
chr6,122792944,0.3922842639593909,643,393,1036,-
chr6,122792945,0.4098270592511027,970,713,1683,-
chr6,125597280,1.7193155205450286,1094,853,1947,-
chr6,125597282,1.7193155205450286,1094,853,1947,-
chr6,125621726,2.1729041567751244,1048,1022,2070,-
chr6,125621727,2.023327838782489,1556,1371,2927,-
chr6,125621728,2.1729041567751244,1048,1022,2070,-
chr6,125622997,1.0050547996976569,850,503,1353,-
chr6,125622998,1.0050547996976569,850,503,1353,-
chr6,127651967,0.3924468985530611,748,576,1324,-
chr6,127651968,1.802469628565942,1202,886,2088,-
chr6,128318127,1.702060534358671,663,440,1103,-
chr6,128319869,4.971016541778595,878,642,1520,-
chr6,128319870,3.388156811069017,1305,933,2238,-
chr6,128319872,2.831817227598825,1392,908,2300,-
chr6,128319906,4.6928941934931405,679,330,1009,-
chr6,131190832,3.168542825361513,1206,898,2104,-
chr6,131190833,3.168542825361513,1206,898,2104,-
chr6,131190843,1.8130328415746164,1018,657,1675,-
chr6,131190844,1.8130328415746164,1018,657,1675,-
chr6,131216199,0.20353729284231273,779,463,1242,-
chr6,134491303,1.23241288625904,814,506,1320,-
chr6,134491305,1.23241288625904,814,506,1320,-
chr6,135308905,2.6292766373411536,741,371,1112,-
chr6,135308909,3.3870967741935485,692,340,1032,-
chr6,135308915,0.3487461545632516,1246,630,1876,-
chr6,135308916,0.9123275485220658,1776,918,2694,-
chr6,135318648,2.574184326915802,812,658,1470,-
chr6,135323979,1.611817475453839,555,453,1008,-
chr6,136582430,5.163702056698165,562,513,1075,-
chr6,136582432,5.163702056698165,562,513,1075,-
chr6,136582532,0.6242374578894656,856,522,1378,-
chr6,136582613,0.4254805206320409,625,401,1026,-
chr6,136589442,1.2883430954980761,862,529,1391,-
chr6,136597535,16.8384260285223,1307,1242,2549,-
chr6,136597536,17.66397727782212,1211,1126,2337,-
chr6,136597543,7.1122024014813165,778,344,1122,-
chr6,136597544,7.1122024014813165,778,344,1122,-
chr6,136599031,2.760706906182289,758,527,1285,-
chr6,136599032,3.426274438150923,585,420,1005,-
chr6,136599760,4.467794407176013,777,702,1479,-
chr6,136599763,5.356114242938751,600,482,1082,-
chr6,136599780,4.019717207937418,945,575,1520,-
chr6,136601005,5.713948748443882,553,454,1007,-
chr6,136665083,3.230129201094994,874,602,1476,-
chr6,136665232,2.6954545454545453,592,439,1031,-
chr6,136667116,2.52912821240094,816,643,1459,-
chr6,136677894,1.6405729206500477,609,424,1033,-
chr6,136683599,4.345395794956761,1167,949,2116,-
chr6,136710624,2.363254113345521,833,546,1379,-
chr6,136710626,1.712236915626746,633,412,1045,-
chr6,136710630,2.263157894736842,730,455,1185,-
chr6,136710648,2.7797180901345526,828,498,1326,-
chr6,136732768,2.3987095521014115,691,380,1071,-
chr6,136742869,0.680358075410262,611,426,1037,-
chr6,137519231,2.356368263284341,782,560,1342,-
chr6,137527341,4.638759958707317,618,505,1123,-
chr6,138412458,2.238704177323103,1312,781,2093,-
chr6,138413156,1.7292805822948119,4767,3558,8325,-
chr6,138413183,1.6747071858182971,777,584,1361,-
chr6,138413201,2.976447580988012,760,618,1378,-
chr6,138413230,0.5301960784313725,1143,849,1992,-
chr6,138413312,0.5870829507193144,958,725,1683,-
chr6,138413363,1.7482014388489209,944,694,1638,-
chr6,138413377,1.7782480314960631,622,507,1129,-
chr6,138417555,2.6337064676616917,604,535,1139,-
chr6,138417573,0.7131079178003528,1002,670,1672,-
chr6,138417574,0.5164342629482072,609,501,1110,-
chr6,138417579,2.5751178801707693,1969,1492,3461,-
chr6,138417588,1.630512377662637,832,578,1410,-
chr6,138428280,1.6381146257438146,633,411,1044,-
chr6,138428331,1.5498082407602765,827,544,1371,-
chr6,139238757,3.4388185654008434,814,473,1287,-
chr6,139238758,3.4388185654008434,814,473,1287,-
chr6,139694247,2.987151082435609,717,525,1242,-
chr6,139694285,2.632522468853804,596,430,1026,-
chr6,143081671,3.763885089454649,661,598,1259,-
chr6,143825186,3.0059947260365774,693,480,1173,-
chr6,143832582,1.9014178801101758,931,748,1679,-
chr6,143832584,1.058768068986929,797,626,1423,-
chr6,144416135,2.778119366025195,780,594,1374,-
chr6,144416305,1.1711289153997135,869,685,1554,-
chr6,144416515,3.2841283882813315,999,714,1713,-
chr6,144416516,3.5296645607866837,949,601,1550,-
chr6,144416530,1.457555158007165,1077,748,1825,-
chr6,144416699,0.8738963070693244,1233,615,1848,-
chr6,144416700,0.7552698928521625,891,482,1373,-
chr6,144416701,0.8248037277147422,1383,692,2075,-
chr6,149981622,3.130518029996809,653,552,1205,-
chr6,149981623,2.1682046526864287,1046,851,1897,-
chr6,150140187,5.001524996099396,877,749,1626,-
chr6,150140495,2.166132472076763,1497,1049,2546,-
chr6,150140764,0.9287379323828536,1311,973,2284,-
chr6,150141039,0.45156179266636487,797,563,1360,-
chr6,150141044,1.6730769230769231,779,519,1298,-
chr6,150141079,1.712984377241251,1742,1230,2972,-
chr6,150141080,1.2988483492522875,1747,1282,3029,-
chr6,150141203,2.5225,1008,799,1807,-
chr6,150141204,2.5225,1008,799,1807,-
chr6,150174143,0.472795497185741,593,428,1021,-
chr6,150174145,0.472795497185741,593,428,1021,-
chr6,153296214,4.728812024628757,588,416,1004,-
chr6,153296264,0.6661950671664648,2899,1852,4751,-
chr6,153296266,1.3301578822412157,2358,1439,3797,-
chr6,153296272,1.6543329414205683,1195,760,1955,-
chr6,153296280,1.4379764713435088,1722,988,2710,-
chr6,153296295,1.8786862224996101,1744,985,2729,-
chr6,153296296,1.878808027079304,2390,1315,3705,-
chr6,153296297,1.5513791404183628,5631,3290,8921,-
chr6,153296305,1.8909574468085104,710,375,1085,-
chr6,153296339,2.483552631578948,754,415,1169,-
chr6,153310967,10.622972585011349,768,464,1232,-
chr6,153312377,1.8129251700680271,1234,797,2031,-
chr6,153312382,1.510841170323929,1075,695,1770,-
chr6,153312392,1.7969830463222534,1843,1134,2977,-
chr6,153312393,1.7969830463222534,1843,1134,2977,-
chr6,153312397,2.080833333333333,680,449,1129,-
chr6,153312400,1.7916666666666663,644,395,1039,-
chr6,153312417,2.6636383537653243,784,570,1354,-
chr6,153603406,2.737777608255508,3048,2282,5330,-
chr6,153603407,2.867242617601668,3297,2570,5867,-
chr6,153603410,0.8822846448551065,1918,1202,3120,-
chr6,153603411,0.5898934037158562,1641,1013,2654,-
chr6,154727266,2.423944756861127,871,840,1711,-
chr6,157713911,3.085898022915755,654,403,1057,-
chr6,159057734,2.0568663036902604,679,550,1229,-
chr6,159057807,0.5731481481481482,618,539,1157,-
chr6,159187413,3.5307732475081615,2566,1678,4244,-
chr6,159187414,3.5307732475081615,2566,1678,4244,-
chr6,159187535,1.6017002740111013,893,661,1554,-
chr6,159190379,2.66295208535876,563,475,1038,-
chr6,159191869,2.002176697819514,943,766,1709,-
chr6,159192299,3.379619175912126,902,771,1673,-
chr6,159204687,1.9498988804764061,896,613,1509,-
chr6,159204694,0.45638377519744244,847,583,1430,-
chr6,159206511,1.1811056870413221,1037,799,1836,-
chr6,159208226,0.3632393807066296,609,457,1066,-
chr6,159239133,1.1985758096167782,570,486,1056,-
chr6,159239146,0.7872233116499089,674,431,1105,-
chr6,159239191,7.689121318716302,662,547,1209,-
chr6,160100691,0.6165266106442577,1135,839,1974,-
chr6,160100850,0.5637821729775753,1399,998,2397,-
chr6,160100852,0.5637821729775753,1399,998,2397,-
chr6,160100922,1.7062073779122757,635,425,1060,-
chr6,160101118,1.675673712500908,1002,705,1707,-
chr6,160101433,1.7877781133595083,682,472,1154,-
chr6,160101578,1.9977484472049687,952,643,1595,-
chr6,160101580,2.1421462294245246,1398,921,2319,-
chr6,160101581,1.764391035602058,928,590,1518,-
chr6,160101673,2.25143815915628,908,595,1503,-
chr6,160101703,2.4091778202676863,867,522,1389,-
chr6,160101705,2.4091778202676863,867,522,1389,-
chr6,160101884,1.869338925026803,756,498,1254,-
chr6,160101885,1.48262607672671,1020,678,1698,-
chr6,160102445,1.858552631578948,677,479,1156,-
chr6,160102616,15.49158259247064,2326,4108,6434,-
chr6,160102618,17.00161341560813,3942,4796,8738,-
chr6,160102619,29.283498855446343,2875,2456,5331,-
chr6,160102620,27.79473130384363,2003,1623,3626,-
chr6,160102621,26.857563025210084,857,339,1196,-
chr6,160102623,8.139559585923163,844,186,1030,-
chr6,160102803,1.6391793690180787,1253,867,2120,-
chr6,160102809,1.8689909384119183,1131,765,1896,-
chr6,160102810,1.9353988134475943,1100,614,1714,-
chr6,160102815,1.5270162785471835,1413,905,2318,-
chr6,160102846,2.0238999683444128,672,350,1022,-
chr6,160102847,0.4353224834237492,1255,789,2044,-
chr6,160102848,0.4353224834237492,1255,789,2044,-
chr6,160103180,2.5400613706102964,595,418,1013,-
chr6,160103590,1.3623088235294116,1268,999,2267,-
chr6,160103611,1.0750354463123122,3194,2353,5547,-
chr6,160105929,0.5195675675675675,533,499,1032,-
chr6,160105951,0.4629913221031138,906,652,1558,-
chr6,160106047,1.8980808539632068,1012,628,1640,-
chr6,160109234,1.9070791275796388,1428,988,2416,-
chr6,160109258,2.301939655172414,970,579,1549,-
chr6,160109272,1.5553122404289057,957,696,1653,-
chr6,160113718,1.5528200988800325,809,582,1391,-
chr6,160113760,0.4768702814001372,578,469,1047,-
chr6,160113872,1.8667943880097957,1037,760,1797,-
chr6,160114273,0.914818811570996,2554,1248,3802,-
chr6,160114275,1.008537392101238,4033,2450,6483,-
chr6,160114281,1.937375377404842,2825,1707,4532,-
chr6,160114283,2.06010863367644,1400,708,2108,-
chr6,160114298,0.5355114535047024,2086,1224,3310,-
chr6,160200193,2.127102046329439,1523,1138,2661,-
chr6,160200946,1.5600939815651544,1659,1005,2664,-
chr6,160201560,1.5287259615384614,1105,831,1936,-
chr6,160205071,1.4988690476190476,1936,1259,3195,-
chr6,160205753,1.6443957648776926,1125,912,2037,-
chr6,160210526,1.58560794044665,3194,1797,4991,-
chr6,160210528,1.5762074783043136,3709,2144,5853,-
chr6,160210550,1.7305769824128354,683,462,1145,-
chr6,160210560,0.42002056999084614,2598,1581,4179,-
chr6,160210561,0.4172165534704563,2221,1321,3542,-
chr6,160210562,0.5061094948426342,1494,994,2488,-
chr6,160210563,0.43148194623895736,2368,1510,3878,-
chr6,160210620,1.7706499888318068,733,604,1337,-
chr6,160210622,1.7706499888318068,733,604,1337,-
chr6,160210643,3.886067281073903,880,692,1572,-
chr6,160210647,4.6646500556817,790,478,1268,-
chr6,166353255,2.663265306122449,782,440,1222,-
chr6,166353257,2.663265306122449,782,440,1222,-
chr6,166353359,0.8527755430410296,1619,1242,2861,-
chr6,166353360,0.8527755430410296,1619,1242,2861,-
chr6,166353361,1.0751191172705816,1885,1466,3351,-
chr6,166353436,2.9119966791199663,609,437,1046,-
chr6,166353786,0.2230521719145024,646,457,1103,-
chr6,166353991,0.9642921748433639,1303,882,2185,-
chr6,166353992,1.325752328498929,955,634,1589,-
chr6,166362781,0.5581473589772346,710,481,1191,-
chr6,166401321,1.6006777577283813,2040,1438,3478,-
chr6,166401325,1.543103448275862,1073,695,1768,-
chr6,166401328,1.219084232196727,1728,1199,2927,-
chr6,166401334,1.5988420906789784,1383,994,2377,-
chr6,166401336,1.5032165227695953,825,536,1361,-
chr6,166401342,1.5532416592170457,1481,913,2394,-
chr6,166401388,1.4170141577348776,1071,677,1748,-
chr6,166401422,0.42398526823794597,763,546,1309,-
chr6,166401450,1.1879995786983466,607,471,1078,-
chr6,166733603,1.6368393511250656,1011,636,1647,-
chr6,166733698,0.5892339958054529,884,588,1472,-
chr6,166733705,1.6043575142361972,809,576,1385,-
chr6,166741773,1.7202763104429095,755,534,1289,-
chr6,166743008,1.7695670103092782,595,484,1079,-
chr6,166743654,1.9543394911118854,622,452,1074,-
chr6,166743659,0.528236914600551,589,439,1028,-
chr6,166756009,5.797357855879696,799,721,1520,-
chr6,166756011,6.450354181328376,1064,1024,2088,-
chr6,170104120,0.5297358573336493,1848,1271,3119,-
chr6,170104121,0.5897218293257898,847,605,1452,-
chr6,170105375,2.157738095238096,608,440,1048,-
chr6,170105739,0.5392992424242424,669,479,1148,-
chr6,170105740,0.37870432589492886,809,603,1412,-
chr6,170105742,1.731929540392792,610,448,1058,-
chr6,170108553,2.26321752265861,921,661,1582,-
chr6,170108705,1.718209655007672,1375,835,2210,-
chr6,170108707,2.285981187991238,958,596,1554,-
chr6,170109340,0.6049154334038055,762,527,1289,-
chr6,170109884,1.0447395794372425,892,615,1507,-
chr6,170110384,1.6612031174993398,1314,913,2227,-
chr6,170110409,2.1948600598486183,673,493,1166,-
chr6,170110411,1.006840904161845,1080,747,1827,-
chr6,170110412,0.4744034553565106,669,486,1155,-
chr6,170115895,1.598540500426217,2413,1796,4209,-
chr6,170115930,2.467617051314094,1671,1036,2707,-
chr6,170116078,2.1258653241032097,562,453,1015,-
chr6,170116093,2.0925343663660936,2373,1550,3923,-
chr6,170116094,1.893989719256623,2520,1685,4205,-
chr6,170116096,1.3679612081262933,2730,1868,4598,-
chr6,170117949,0.43830570902394106,645,542,1187,-
chr6,170118890,1.4663677971188478,1474,951,2425,-
chr6,170118891,2.729219295079995,708,488,1196,-
chr6,170121164,1.7494699346959546,1145,906,2051,-
chr6,170121165,1.7494699346959546,1145,906,2051,-
chr6,170121187,1.2097050647166505,1103,813,1916,-
chr6,170844283,0.6568342119708755,1713,1060,2773,-
chr6,170844394,1.6260697827518105,1975,1273,3248,-
chr6,170844422,1.7498478393183203,874,741,1615,-
chr6,170844425,1.6570398841589538,2062,1750,3812,-
chr6,170844461,1.4751144164759724,1718,1057,2775,-
chr6,170852757,1.5858099489795918,1506,1119,2625,-
chr6,170862244,1.3904438486744115,1912,1118,3030,-
chr6,170862310,0.6631174089068825,1488,1299,2787,-
chr6,170862311,1.8304087338570094,1296,1014,2310,-
chr6,170862359,0.5957625971760673,1131,910,2041,-
chr6,170862373,1.2692980214001925,2862,2395,5257,-
chr6,170862384,0.954963256873195,1157,763,1920,-
chr6,170862385,3.6457885672907695,932,649,1581,-
chr6,170862386,0.954963256873195,1157,763,1920,-
chr6,170886373,3.133030502739565,885,548,1433,-
chr6,170886497,1.6592036464441366,7930,4175,12105,-
chr6,170886498,1.7362742671107512,4950,2897,7847,-
chr6,170886538,1.4705267605007448,1537,788,2325,-
chr6,170886611,2.135584677419355,1114,639,1753,-
chr6,170886636,0.4140005468963632,756,476,1232,-
chr6,170886639,1.740139211136891,629,430,1059,-
chr6,170886685,1.9826839826839824,686,461,1147,-
chr6,170887957,4.345775462962963,652,431,1083,-
chr6,170889153,1.283725222908033,988,666,1654,-
chr6,170892266,2.5116279069767447,671,515,1186,-
chr6,170892613,0.566113922687628,700,501,1201,-
chr6,170892690,2.277892561983471,566,483,1049,-
chr6,170892699,3.3391592920353985,558,451,1009,-
chr6,170892810,0.4105737750739488,702,622,1324,-
chr6,170892832,1.6606757295911079,562,478,1040,-
chr7,1607233,2.016753091344236,631,435,1066,-
chr7,1607234,2.4551676284959667,1162,790,1952,-
chr7,1607236,2.4554455445544554,607,403,1010,-
chr7,1607481,2.43957345971564,638,421,1059,-
chr7,1607482,2.4766067009336794,881,594,1475,-
chr7,2770374,2.7720316322466863,936,836,1772,-
chr7,2770375,2.7720316322466863,936,836,1772,-
chr7,2770395,1.7914977580815863,801,601,1402,-
chr7,2770396,1.1753123853290672,730,561,1291,-
chr7,5566900,0.499489900020404,1019,753,1772,-
chr7,5566904,0.5814034495590691,2608,2081,4689,-
chr7,5566905,0.5814034495590691,2608,2081,4689,-
chr7,5566906,0.54575916837627,3839,3202,7041,-
chr7,5566909,1.590081421169504,933,771,1704,-
chr7,5566911,0.3376450056462375,597,572,1169,-
chr7,5566913,0.538726842727631,780,707,1487,-
chr7,5567184,1.387024811856363,4465,2838,7303,-
chr7,5567373,1.0396808067054102,8473,6218,14691,-
chr7,5567389,0.7265289686096018,18586,13134,31720,-
chr7,5567390,0.7563757489338322,9330,7230,16560,-
chr7,5567424,1.3486650548595893,11461,7996,19457,-
chr7,5567439,1.626364063969897,3114,2125,5239,-
chr7,5567445,1.8167699888729933,3088,2096,5184,-
chr7,5567500,1.3258335342562058,13559,9529,23088,-
chr7,5567636,1.205472408665805,5834,3734,9568,-
chr7,5567671,1.5354802244680996,6519,3910,10429,-
chr7,5567683,2.05003181519783,17932,14090,32022,-
chr7,5567684,1.8272479234558967,28285,20635,48920,-
chr7,5567704,1.5760563762827613,9990,6919,16909,-
chr7,5567707,0.6938918666290531,7700,4846,12546,-
chr7,5567729,1.4382078718478193,5914,3804,9718,-
chr7,5567790,1.3701587468599743,6742,4922,11664,-
chr7,5567794,1.370999663693479,2971,2382,5353,-
chr7,5568003,1.2739590212516971,7151,4634,11785,-
chr7,5568093,1.37019040047247,17982,13191,31173,-
chr7,5568094,1.3909775160003883,14685,10453,25138,-
chr7,5568141,1.2882733560705064,3108,2518,5626,-
chr7,5568216,1.269502053818241,7670,5163,12833,-
chr7,5568219,1.6525402916051406,4901,3086,7987,-
chr7,5568350,0.602934155815667,1327,961,2288,-
chr7,5568351,0.8340377939489012,630,432,1062,-
chr7,5568799,1.2431787175989086,3644,2931,6575,-
chr7,5568882,1.1350176071614522,5750,4575,10325,-
chr7,5568905,0.7654105566927284,2280,1752,4032,-
chr7,5568973,1.3501622924974497,2140,1314,3454,-
chr7,5568978,0.6172561084891571,1116,880,1996,-
chr7,5569004,1.453705407339262,1225,1086,2311,-
chr7,5569290,1.472078489980399,6374,4416,10790,-
chr7,5570178,1.2051497216517753,4673,3494,8167,-
chr7,5570191,1.7849536110522541,2886,1999,4885,-
chr7,5570200,1.6665134896147977,5654,3223,8877,-
chr7,5570202,1.6639495145122511,3158,1982,5140,-
chr7,5570205,2.127427178272016,2784,1337,4121,-
chr7,5570215,2.579765891224247,1973,817,2790,-
chr7,5570219,3.0007668711656454,902,488,1390,-
chr7,5570224,2.1511366994492924,6718,2858,9576,-
chr7,5570225,2.18991025300198,7026,2888,9914,-
chr7,5570226,2.1130168513569694,5341,2433,7774,-
chr7,5570227,2.3129301446016433,5395,2427,7822,-
chr7,5570228,2.4430925287895477,3417,1493,4910,-
chr7,5570231,0.7818455924729116,2559,891,3450,-
chr7,6063545,2.899945770065076,712,460,1172,-
chr7,6063592,0.554232913397032,1319,1052,2371,-
chr7,6063623,1.114900572189254,1176,925,2101,-
chr7,6063877,1.708674304418985,695,422,1117,-
chr7,6064111,1.8471337579617837,599,470,1069,-
chr7,6064142,2.45124716553288,704,440,1144,-
chr7,6064302,0.5966754155730534,1022,888,1910,-
chr7,6064306,11.083452491366943,5666,4534,10200,-
chr7,6064307,11.083452491366943,5666,4534,10200,-
chr7,6066533,0.47723965911452926,655,565,1220,-
chr7,6068259,1.4568227506860851,1499,999,2498,-
chr7,6068622,1.7017821465383327,4391,3267,7658,-
chr7,6068627,1.977552007740687,3715,2384,6099,-
chr7,6068628,1.977552007740687,3715,2384,6099,-
chr7,6077057,0.7203153988868275,1552,989,2541,-
chr7,6077129,0.3962264150943396,972,694,1666,-
chr7,6078208,0.5217877690176859,652,493,1145,-
chr7,6078297,1.7744107744107749,743,593,1336,-
chr7,6080599,1.4357353177390164,2466,1875,4341,-
chr7,6080600,0.9569661200681384,1737,1305,3042,-
chr7,6080660,1.534926470588235,834,607,1441,-
chr7,6080774,0.660627802690583,761,668,1429,-
chr7,6080783,0.6062059082892416,646,503,1149,-
chr7,6080812,2.8812820512820507,660,599,1259,-
chr7,6080833,1.7291749823472096,1235,910,2145,-
chr7,6082605,1.836149068322981,1136,804,1940,-
chr7,6082606,1.836149068322981,1136,804,1940,-
chr7,6084205,3.1662054971407487,612,416,1028,-
chr7,6085719,0.44695498676081197,632,514,1146,-
chr7,6085767,1.6200668896321069,691,597,1288,-
chr7,6086713,1.915257819103973,1006,675,1681,-
chr7,6089654,1.443139469226426,982,804,1786,-
chr7,6094210,0.5906195715112913,815,627,1442,-
chr7,6094213,1.7011860506284295,619,537,1156,-
chr7,6094214,3.170886075949367,667,473,1140,-
chr7,6094299,2.175187969924812,525,531,1056,-
chr7,6094304,2.3482457284465896,642,450,1092,-
chr7,6098601,0.39270546372819104,804,791,1595,-
chr7,6098603,0.4252518813298514,1810,1899,3709,-
chr7,6098604,0.513873603267507,1511,1481,2992,-
chr7,6098605,0.48237781719427986,1093,1146,2239,-
chr7,6098653,2.2818963359813567,618,834,1452,-
chr7,6098655,4.587584181523797,1908,2182,4090,-
chr7,6098656,5.286644304687768,1590,1752,3342,-
chr7,6098657,4.725735894735893,825,1029,1854,-
chr7,6098661,4.091446872260256,978,722,1700,-
chr7,6098662,4.359836033885744,1084,818,1902,-
chr7,6201525,2.227626459143969,915,513,1428,-
chr7,6201526,2.227626459143969,915,513,1428,-
chr7,6201541,2.477478579013208,732,374,1106,-
chr7,6202742,2.198127446851951,989,694,1683,-
chr7,6202743,2.280391841978481,709,478,1187,-
chr7,6449639,2.5605309158283416,616,490,1106,-
chr7,6452632,0.748341575071581,759,426,1185,-
chr7,6501297,1.5839585858880036,708,523,1231,-
chr7,6501637,1.8209727112676055,870,567,1437,-
chr7,6501716,1.1150447833454369,736,611,1347,-
chr7,6501717,1.1150447833454369,736,611,1347,-
chr7,6501756,2.2268271041184238,1582,942,2524,-
chr7,6501757,1.3851607130566452,2299,1335,3634,-
chr7,6501759,1.318479019869231,2169,1238,3407,-
chr7,6501761,0.8308943089430895,1386,778,2164,-
chr7,6501955,2.385866166353971,544,491,1035,-
chr7,6501990,4.8605874585927165,3870,2867,6737,-
chr7,6501991,4.8605874585927165,3870,2867,6737,-
chr7,6502046,2.213942307692308,920,575,1495,-
chr7,6502047,3.45892829725165,703,500,1203,-
chr7,6502048,2.7690639331333347,1623,1075,2698,-
chr7,6502233,1.8555366269165248,777,586,1363,-
chr7,6502417,0.5991723744292237,662,583,1245,-
chr7,6502601,1.9709734513274333,695,564,1259,-
chr7,6502619,1.953623188405797,673,494,1167,-
chr7,6502656,1.8069973087274127,563,458,1021,-
chr7,6502700,1.810545129579982,1012,745,1757,-
chr7,6502724,2.002353556485356,1208,716,1924,-
chr7,6505706,1.8622189224462569,1215,1032,2247,-
chr7,6505802,1.7488262910798122,744,638,1382,-
chr7,6505871,2.2931636726546905,706,500,1206,-
chr7,6513819,1.3826784101174343,789,655,1444,-
chr7,6513912,1.9826395370543213,558,486,1044,-
chr7,6513913,1.0107802874743328,1431,973,2404,-
chr7,6513914,1.0107802874743328,1431,973,2404,-
chr7,6523669,1.7776498239205238,4047,3029,7076,-
chr7,6523670,2.1805042016806726,2993,2274,5267,-
chr7,6523682,0.565252265982193,1214,684,1898,-
chr7,6523683,0.9546607959116911,3084,1916,5000,-
chr7,6523684,0.9389414217332065,5144,3288,8432,-
chr7,6523685,0.9389414217332065,5144,3288,8432,-
chr7,6523686,1.0390256642640407,4315,2638,6953,-
chr7,6523688,0.9858139484053537,1883,1232,3115,-
chr7,6523716,3.5017465636824134,682,356,1038,-
chr7,6854444,3.3198993575720928,809,549,1358,-
chr7,7676626,1.5169965830093084,1050,827,1877,-
chr7,7677527,0.5585113574905355,1611,1375,2986,-
chr7,7677538,1.5977701543739278,1172,900,2072,-
chr7,7679957,1.7881029748426587,1791,1323,3114,-
chr7,7679993,2.688927943760984,611,568,1179,-
chr7,7679995,3.0804253904951815,896,530,1426,-
chr7,7680032,2.2892955780955244,1099,721,1820,-
chr7,7680055,1.0493984421630431,973,656,1629,-
chr7,10977765,1.5271639807276955,2297,1851,4148,-
chr7,10978515,1.2750762666048812,2296,1991,4287,-
chr7,10978521,1.4487054988159385,6229,4572,10801,-
chr7,10979656,1.2602695323700646,2756,1636,4392,-
chr7,10979713,1.7141509433962263,1184,899,2083,-
chr7,10979751,0.6718981224221051,5712,3566,9278,-
chr7,10979752,0.6488630363352081,6731,4249,10980,-
chr7,10979756,0.5858523934163491,3627,2311,5938,-
chr7,10979788,1.3464246830778104,2446,1757,4203,-
chr7,10979789,0.7512101463466551,3889,2827,6716,-
chr7,10979796,0.6559160305343511,981,654,1635,-
chr7,10979797,0.8674483892454616,2674,1737,4411,-
chr7,10979799,0.8038852036623533,4630,3092,7722,-
chr7,19737964,2.979040401904649,664,479,1143,-
chr7,21940987,1.764842417971403,613,492,1105,-
chr7,21940988,3.389324394732723,700,418,1118,-
chr7,21942642,2.434996183957852,1048,718,1766,-
chr7,21942645,1.8257593989160272,750,515,1265,-
chr7,21945134,2.6964679911699783,697,452,1149,-
chr7,21945136,2.6964679911699783,697,452,1149,-
chr7,22549968,1.2631725619628846,2866,2293,5159,-
chr7,22549971,0.8708609511147649,15554,9863,25417,-
chr7,22549973,0.8237384236140931,14890,8941,23831,-
chr7,22549975,1.2949088599041996,1030,1105,2135,-
chr7,22549978,1.4243241569818617,6787,5687,12474,-
chr7,22549979,1.3724220645826646,7356,6146,13502,-
chr7,22549980,1.4053738304926253,6258,5267,11525,-
chr7,22549981,1.1340574394455822,5449,3943,9392,-
chr7,22549983,1.5700027130063656,2660,1928,4588,-
chr7,22549985,1.5016513528898834,4066,2786,6852,-
chr7,22549986,1.249987096707596,3094,1971,5065,-
chr7,22549987,1.3178445030470818,3636,2300,5936,-
chr7,22549988,1.0587314491056936,4523,2790,7313,-
chr7,22549989,1.2345410263594627,1877,1117,2994,-
chr7,22550025,1.4643787344875134,1592,962,2554,-
chr7,22550039,0.6071476019662548,913,578,1491,-
chr7,22852704,1.7294059811552642,3323,2440,5763,-
chr7,22857661,1.9498556998557,2913,2231,5144,-
chr7,22862382,0.7130202433853213,1963,1496,3459,-
chr7,22862432,1.7604267701260912,1209,1030,2239,-
chr7,22862433,1.5838498522852342,1518,848,2366,-
chr7,22862453,1.257181089604728,1513,1265,2778,-
chr7,22862454,1.5408720842161008,1798,1078,2876,-
chr7,22862460,1.075516005786295,1594,1164,2758,-
chr7,22862462,1.0507894736842105,1330,1063,2393,-
chr7,22862464,1.830479372592696,804,652,1456,-
chr7,23350201,2.253462026855311,643,428,1071,-
chr7,23350762,4.950272152465392,649,434,1083,-
chr7,23350763,1.7785779253786498,714,492,1206,-
chr7,23351057,0.4027504911591356,696,508,1204,-
chr7,23351058,0.4027504911591356,696,508,1204,-
chr7,23351725,7.730948532144185,936,260,1196,-
chr7,23351728,94.07276719629739,1667,297,1964,-
chr7,23351729,62.61040592179421,1947,281,2228,-
chr7,23351730,57.85372652976363,2185,267,2452,-
chr7,23351731,33.96591153349292,1994,170,2164,-
chr7,23351732,13.382018487321906,1799,125,1924,-
chr7,23351733,12.962962962962964,1199,71,1270,-
chr7,23351734,14.261904761904757,1197,71,1268,-
chr7,23351735,16.5,956,57,1013,-
chr7,23351841,2.3218697164882323,643,469,1112,-
chr7,23383436,1.1406171382645833,815,614,1429,-
chr7,23383450,1.0233228511530397,709,476,1185,-
chr7,23383452,1.3752750652095318,949,684,1633,-
chr7,23571507,1.5010443109066054,2466,1749,4215,-
chr7,23571509,1.0512485165911472,3064,1948,5012,-
chr7,23571510,0.9586580114519061,2152,1348,3500,-
chr7,24738423,1.901879153072404,640,435,1075,-
chr7,24742442,1.5402690018782412,703,586,1289,-
chr7,24758760,2.0772113943028487,977,695,1672,-
chr7,24758762,2.523513753327418,1421,988,2409,-
chr7,24758763,2.4915111111111115,918,624,1542,-
chr7,24789235,2.4438897616504045,1393,1017,2410,-
chr7,24789236,2.140455235204856,927,658,1585,-
chr7,25162947,1.3952442333785615,2538,1473,4011,-
chr7,25163202,1.6324453756360369,908,513,1421,-
chr7,25163211,2.6436170212765955,709,375,1084,-
chr7,25163219,1.7488815985684465,732,478,1210,-
chr7,25163389,0.8194311014577501,3461,2420,5881,-
chr7,25163420,1.4120056266327086,4389,3578,7967,-
chr7,25163578,1.511760027269628,1773,1353,3126,-
chr7,25163639,1.6508945244262394,1660,1276,2936,-
chr7,25164845,1.7605674323905636,1500,885,2385,-
chr7,25164875,2.7613235995548173,1546,819,2365,-
chr7,25164878,0.8602025683289078,2036,1254,3290,-
chr7,25164881,1.037600055681757,1785,1523,3308,-
chr7,25164882,1.037600055681757,1785,1523,3308,-
chr7,25164883,1.037600055681757,1785,1523,3308,-
chr7,26230009,1.7917363882095507,579,456,1035,-
chr7,26230616,3.090988948271782,832,591,1423,-
chr7,26230727,0.3602161533467852,684,627,1311,-
chr7,26231865,1.5045062745595132,3542,2939,6481,-
chr7,26232124,0.6321626984126983,4219,4479,8698,-
chr7,26232125,0.6816897176583694,9013,9748,18761,-
chr7,26232146,5.973583447181483,9415,10396,19811,-
chr7,26232149,4.959879278975654,18054,16634,34688,-
chr7,26232150,4.959879278975654,18054,16634,34688,-
chr7,26232159,4.132086427020163,26313,18576,44889,-
chr7,26232160,4.286729772534581,31941,21524,53465,-
chr7,26232161,4.286729772534581,31941,21524,53465,-
chr7,26232162,5.076226407854211,17653,11688,29341,-
chr7,26232168,1.7242351845431365,5668,2920,8588,-
chr7,26232171,2.097501121529306,4084,1836,5920,-
chr7,26232991,1.538822699589227,10319,11230,21549,-
chr7,26232993,1.2609394509488432,6395,6935,13330,-
chr7,26233206,0.7464053266110025,2927,2560,5487,-
chr7,26233211,1.846668318057964,3620,3302,6922,-
chr7,26233213,2.7686643086463074,12178,12924,25102,-
chr7,26233215,2.579183869325755,8222,8621,16843,-
chr7,26233216,2.0853552177587895,9565,9610,19175,-
chr7,26233223,1.677046263345196,1507,1123,2630,-
chr7,26233252,16.93937414468035,6262,5197,11459,-
chr7,26233255,10.735806130191616,6280,4169,10449,-
chr7,26233309,2.6068422868630643,5970,3715,9685,-
chr7,26236063,1.8586031498262625,9827,7421,17248,-
chr7,26236614,3.314100985221675,2514,2029,4543,-
chr7,26237056,1.3173133151102223,3255,2315,5570,-
chr7,26237252,1.265951446005718,9379,5422,14801,-
chr7,26237278,0.6462526197602103,15613,10150,25763,-
chr7,26237349,0.6174205122332913,2608,1916,4524,-
chr7,26240208,1.3629369191938507,3726,2647,6373,-
chr7,26240224,1.5659581565675007,7738,5217,12955,-
chr7,26240295,1.5755642787046122,1182,1018,2200,-
chr7,26240318,1.4127998919881948,2743,2255,4998,-
chr7,26240319,1.5011222504863084,1823,1140,2963,-
chr7,26240322,1.5720797720797721,1690,1025,2715,-
chr7,26240365,1.422634212739013,1932,1488,3420,-
chr7,26240366,1.066064688340667,762,606,1368,-
chr7,26240391,1.042857142857143,802,384,1186,-
chr7,26240393,0.9521405117070753,1442,768,2210,-
chr7,26240394,0.8470722260195944,640,384,1024,-
chr7,27671986,2.7971322792253526,2232,3212,5444,-
chr7,27671987,2.983213983213983,900,1442,2342,-
chr7,27671990,1.8917830563767966,1250,1730,2980,-
chr7,27671992,1.8917830563767966,1250,1730,2980,-
chr7,27671996,2.2697795071335927,749,1027,1776,-
chr7,27671997,2.2697795071335927,749,1027,1776,-
chr7,27672000,2.7728538283062645,702,861,1563,-
chr7,27672001,2.7728538283062645,702,861,1563,-
chr7,29035470,1.0253623188405796,565,505,1070,-
chr7,29035471,1.7523494140112206,1487,1147,2634,-
chr7,29035473,3.482395976223137,543,485,1028,-
chr7,29111506,1.7161687170474518,755,568,1323,-
chr7,29132269,0.4511665425663936,660,473,1133,-
chr7,29135824,1.4436437721969992,1279,981,2260,-
chr7,29152398,3.5608983527327807,1486,1168,2654,-
chr7,29152399,2.921193092621664,1162,909,2071,-
chr7,29160550,1.8308899176954727,618,431,1049,-
chr7,29962225,1.8002611684066103,951,690,1641,-
chr7,29962226,2.0801355133477033,772,587,1359,-
chr7,30536429,0.591699326700834,1023,641,1664,-
chr7,30536439,1.7072576940744144,952,621,1573,-
chr7,30536486,2.118055555555556,853,671,1524,-
chr7,30536581,1.574107142857143,860,734,1594,-
chr7,30536616,1.9462745325073816,861,750,1611,-
chr7,30536623,1.5449118683901293,912,574,1486,-
chr7,30536743,1.7719680464778504,609,458,1067,-
chr7,30536750,2.171589568670063,1289,889,2178,-
chr7,30536830,1.87812865497076,776,512,1288,-
chr7,30538514,2.1268411442483264,1091,794,1885,-
chr7,30540226,1.1367183436241215,1025,766,1791,-
chr7,32528243,2.886056971514243,879,666,1545,-
chr7,32528250,1.9551219512195126,834,614,1448,-
chr7,32528941,2.0561378989051944,678,476,1154,-
chr7,32528946,1.7544345898004436,632,450,1082,-
chr7,32529937,3.536784741144414,648,366,1014,-
chr7,32529961,2.1592677224724355,1052,564,1616,-
chr7,32529962,2.4644657258064515,888,495,1383,-
chr7,32910304,1.4815305710828095,546,468,1014,-
chr7,32910309,0.6222932602656315,583,460,1043,-
chr7,32910311,2.677678667925833,774,623,1397,-
chr7,32910315,2.8704663212435237,830,578,1408,-
chr7,32910316,2.8704663212435237,830,578,1408,-
chr7,32910328,2.7441834752174556,628,423,1051,-
chr7,32910445,1.748792870252886,1066,768,1834,-
chr7,34978902,3.434013752239402,547,490,1037,-
chr7,40172459,1.8654282933160284,792,535,1327,-
chr7,40172741,3.65123716546036,747,456,1203,-
chr7,40172810,0.4095038434661076,878,728,1606,-
chr7,40172812,0.4095038434661076,878,728,1606,-
chr7,40172839,0.5591179282279831,949,663,1612,-
chr7,40172842,1.9591799510245516,597,494,1091,-
chr7,40172848,1.320364436752525,909,700,1609,-
chr7,40174216,1.349595703798035,631,487,1118,-
chr7,42961529,1.5020919233567789,1100,867,1967,-
chr7,42964290,0.7003329153876086,1868,1373,3241,-
chr7,42964342,1.6566093148255894,1615,1361,2976,-
chr7,42964375,1.3963435667471544,1839,1114,2953,-
chr7,42967037,2.015810276679842,764,560,1324,-
chr7,42967048,2.544768464243845,1361,852,2213,-
chr7,42971758,1.8057031249999997,796,511,1307,-
chr7,42971766,1.612967333250528,1056,580,1636,-
chr7,42971768,1.612967333250528,1056,580,1636,-
chr7,43679017,0.5661308001461455,1032,781,1813,-
chr7,43679051,1.619927536231884,525,479,1004,-
chr7,43679192,1.3403837735799067,1132,946,2078,-
chr7,43680242,2.685786013878727,1074,769,1843,-
chr7,43684997,0.5608247422680412,696,484,1180,-
chr7,43687171,0.5279965935703641,619,426,1045,-
chr7,43687177,3.739810426540284,606,421,1027,-
chr7,43906298,1.4159599983739175,1892,1446,3338,-
chr7,43906359,1.4102617648407523,2957,2185,5142,-
chr7,43906449,2.50814332247557,659,613,1272,-
chr7,43906474,1.647857142857143,768,599,1367,-
chr7,43906476,2.6841046277666,551,496,1047,-
chr7,43906481,2.186698478974053,563,478,1041,-
chr7,43906520,1.7645833333333336,846,524,1370,-
chr7,43906521,0.6740681998413958,874,678,1552,-
chr7,43908587,1.5306841793395038,1732,1288,3020,-
chr7,43908590,2.6691685912240186,602,432,1034,-
chr7,43909094,0.471226878382712,714,593,1307,-
chr7,44154926,2.0801651601654165,975,701,1676,-
chr7,44154990,3.8684459940501608,865,673,1538,-
chr7,44155737,1.9371069182389933,758,476,1234,-
chr7,44156444,3.4216899873492497,610,531,1141,-
chr7,44156503,3.2046354488382356,830,589,1419,-
chr7,44157251,0.6743697478991597,1283,815,2098,-
chr7,44157252,1.7369727047146402,839,650,1489,-
chr7,44157276,1.086233873496961,1168,924,2092,-
chr7,44157310,1.5074304889741132,661,446,1107,-
chr7,44157617,2.905432595573441,721,496,1217,-
chr7,44161649,0.380078125,555,511,1066,-
chr7,44161651,1.3361025501858534,788,696,1484,-
chr7,44605504,1.2223725279543634,611,446,1057,-
chr7,44608581,0.7128313006981002,1903,1214,3117,-
chr7,44608740,2.339641434262948,890,501,1391,-
chr7,44608771,1.676702786377709,746,379,1125,-
chr7,44608774,1.8949399275404808,1171,626,1797,-
chr7,44608788,2.547945205479452,650,437,1087,-
chr7,44609428,3.2162416107382548,1140,595,1735,-
chr7,44609430,3.2162416107382548,1140,595,1735,-
chr7,44617711,1.5698527239770124,788,503,1291,-
chr7,44617993,0.6472161741835148,866,642,1508,-
chr7,44618083,0.7920812184443612,1287,923,2210,-
chr7,44618084,1.0000463475587411,1670,1206,2876,-
chr7,44618238,0.5312858768096446,832,655,1487,-
chr7,44618663,3.5925155925155927,639,480,1119,-
chr7,44618664,3.260696040868455,949,695,1644,-
chr7,44618666,3.806060606060606,627,449,1076,-
chr7,44618987,2.795205662393163,1020,623,1643,-
chr7,44618989,2.795205662393163,1020,623,1643,-
chr7,44620702,0.5728125,610,399,1009,-
chr7,44620775,0.6481493612839829,872,644,1516,-
chr7,44620788,0.5460599334073253,655,529,1184,-
chr7,44620797,1.1770722736888946,969,785,1754,-
chr7,44620801,1.747919169772566,1001,822,1823,-
chr7,44621076,0.5990652306441779,669,664,1333,-
chr7,44621086,0.3488636363636363,613,479,1092,-
chr7,44621093,3.3545571623174704,1578,1369,2947,-
chr7,44621105,2.0195571192052983,672,603,1275,-
chr7,44621107,2.0195571192052983,672,603,1275,-
chr7,44621671,1.930459497050859,653,474,1127,-
chr7,44873986,1.6818793753365646,960,618,1578,-
chr7,44874004,1.6742919389978217,741,458,1199,-
chr7,44874062,1.627858627858628,728,480,1208,-
chr7,44874140,2.082426626842754,1536,1058,2594,-
chr7,44874142,2.1201353317283265,1616,1213,2829,-
chr7,44875221,0.5274697580645161,597,495,1092,-
chr7,45139928,1.6008194335338883,734,503,1237,-
chr7,45139991,1.7099241291863343,761,563,1324,-
chr7,45139997,3.3099485733480942,717,528,1245,-
chr7,45140951,3.357024733579791,623,479,1102,-
chr7,45141635,3.141933745365169,944,581,1525,-
chr7,45142069,3.3922543427534353,643,459,1102,-
chr7,45144204,1.679111126070657,650,449,1099,-
chr7,45148632,0.9417601276092611,1059,860,1919,-
chr7,45151250,31.0530574530136,853,635,1488,-
chr7,45952368,2.279589371980677,754,551,1305,-
chr7,45952407,2.4992236024844723,665,482,1147,-
chr7,45952420,1.5490196078431373,1026,577,1603,-
chr7,45952562,0.5502092050209205,1051,955,2006,-
chr7,45952639,1.7568251922103035,847,748,1595,-
chr7,45952672,4.1517626903387574,954,737,1691,-
chr7,45952752,0.6809612225951581,977,835,1812,-
chr7,45952820,1.2016352942932893,1778,1313,3091,-
chr7,45952991,2.1202340187909527,2261,1694,3955,-
chr7,45953407,1.881,989,624,1613,-
chr7,45953408,0.6356704297880769,916,747,1663,-
chr7,45953419,0.4939127812747352,818,616,1434,-
chr7,45954422,2.0231607629427795,659,366,1025,-
chr7,45956156,0.5472197705207414,619,514,1133,-
chr7,45956834,1.50523317884759,5134,3306,8440,-
chr7,45956848,1.7148760578416733,4586,3356,7942,-
chr7,45956856,1.2550772101627556,3825,2665,6490,-
chr7,45956863,1.330441951264842,6116,3960,10076,-
chr7,45956884,1.530268673125816,2226,1322,3548,-
chr7,45956901,2.1819618485114534,1980,1138,3118,-
chr7,45956914,1.5427187346510238,6926,4968,11894,-
chr7,45956915,1.4397086364274159,6224,4622,10846,-
chr7,45956920,2.178788160737731,2367,1696,4063,-
chr7,45956926,1.6202920284743692,3239,2109,5348,-
chr7,45956929,1.3937721718565235,1903,1238,3141,-
chr7,45956930,1.1010138621101553,1557,1023,2580,-
chr7,45956950,1.2610358209633747,3129,1892,5021,-
chr7,45956952,0.9649735712597665,2753,1784,4537,-
chr7,45956955,2.1549019607843136,941,611,1552,-
chr7,45957029,1.3172181604560542,771,637,1408,-
chr7,45960343,1.80061702667478,794,545,1339,-
chr7,45960820,2.666511248397249,816,372,1188,-
chr7,45960822,2.5758914943199662,1073,502,1575,-
chr7,47409088,0.4449945394976338,763,409,1172,-
chr7,47409089,0.4449945394976338,763,409,1172,-
chr7,47436441,2.8590724751439036,838,485,1323,-
chr7,47436442,2.978629999153088,690,408,1098,-
chr7,51095514,0.8415749158766462,768,571,1339,-
chr7,51095516,1.257294429708223,710,428,1138,-
chr7,51152928,0.2663786897048236,554,462,1016,-
chr7,51152929,1.0527088641307345,876,713,1589,-
chr7,54825260,2.13093023255814,1308,859,2167,-
chr7,54826871,0.6021426323912505,4840,3349,8189,-
chr7,54826872,0.6232148659589319,3122,1972,5094,-
chr7,54826890,1.0142941686268365,1894,1399,3293,-
chr7,54826900,0.493105761477873,1083,813,1896,-
chr7,54826927,1.307450384865739,957,742,1699,-
chr7,55538453,1.0238373221267054,675,475,1150,-
chr7,55538456,0.865140391333376,813,624,1437,-
chr7,55538457,0.865140391333376,813,624,1437,-
chr7,56088863,0.3954200505924644,659,405,1064,-
chr7,56088897,1.7442363088914812,636,495,1131,-
chr7,56101841,1.8856567554731427,714,489,1203,-
chr7,56169397,1.300610549132948,2352,1729,4081,-
chr7,56169403,1.3503117457763474,1964,1355,3319,-
chr7,56169442,1.6196506146593956,1781,1046,2827,-
chr7,56170569,1.773238762455942,2341,1714,4055,-
chr7,56170578,1.3505982123938738,5875,3773,9648,-
chr7,56170581,1.4448603216314393,12089,8835,20924,-
chr7,56170650,1.6803315196981738,4251,3417,7668,-
chr7,56170652,1.6803315196981738,4251,3417,7668,-
chr7,56171926,1.6289137219369778,1617,1203,2820,-
chr7,56171931,1.5620168653910644,5751,3961,9712,-
chr7,56171956,1.4621528446185152,3449,2569,6018,-
chr7,56172029,1.5207523510971788,1515,824,2339,-
chr7,56172043,1.7326829268292685,1183,614,1797,-
chr7,56172046,0.3978529392743969,768,657,1425,-
chr7,56172052,2.3170648074065605,1266,672,1938,-
chr7,56172053,0.4433333333333333,587,559,1146,-
chr7,56172054,2.3170648074065605,1266,672,1938,-
chr7,56172055,1.9033063006862132,903,457,1360,-
chr7,56172127,1.7867783477027177,1522,832,2354,-
chr7,56172128,0.5143700372426393,914,748,1662,-
chr7,56172131,2.6665104654795377,793,581,1374,-
chr7,56172156,2.405128205128205,937,506,1443,-
chr7,56174088,3.7282471094607144,1003,696,1699,-
chr7,56174089,2.5814207650273224,1180,548,1728,-
chr7,56174108,1.992229992229992,1281,560,1841,-
chr7,56174168,0.7595788129395848,8135,4141,12276,-
chr7,56174169,0.6217222233463204,1915,1076,2991,-
chr7,56174172,0.5607353309216664,821,635,1456,-
chr7,65426027,2.4748132940697256,610,437,1047,-
chr7,66453454,2.307301587301587,631,419,1050,-
chr7,66456250,1.187010400386095,1448,999,2447,-
chr7,66459225,1.485995850622407,2864,1927,4791,-
chr7,66459243,0.9283005003489556,7663,5301,12964,-
chr7,66459256,0.6365986817284006,2941,2197,5138,-
chr7,66459257,1.4150464919695689,1709,1182,2891,-
chr7,66459282,1.0287954102005037,2248,1442,3690,-
chr7,66459309,2.256445993031359,1618,819,2437,-
chr7,66459310,1.9355310526295664,2842,1678,4520,-
chr7,66459314,1.6109243697478994,1064,713,1777,-
chr7,66459327,1.6890941388274516,1201,818,2019,-
chr7,72721471,2.5552863487611033,659,468,1127,-
chr7,72884743,2.351284178054454,649,544,1193,-
chr7,72951322,1.7556390977443606,933,607,1540,-
chr7,72951326,0.5964357937310414,857,551,1408,-
chr7,72951328,2.2221562221562223,773,480,1253,-
chr7,72951368,1.1204892542374754,655,472,1127,-
chr7,72984085,2.143595863166269,633,418,1051,-
chr7,72984087,2.143595863166269,633,418,1051,-
chr7,73653310,0.5548668826595295,605,457,1062,-
chr7,73653311,0.5548668826595295,605,457,1062,-
chr7,73653312,0.5548668826595295,605,457,1062,-
chr7,73657524,1.9657922107939445,566,508,1074,-
chr7,75103994,2.899285347866187,693,467,1160,-
chr7,75621821,2.157903968674168,653,441,1094,-
chr7,75659746,1.005897051474263,628,434,1062,-
chr7,75659748,2.184154690101278,660,452,1112,-
chr7,75956351,1.9860335195530725,710,536,1246,-
chr7,75956429,1.2645968640498841,572,535,1107,-
chr7,75956736,0.5441176470588235,665,373,1038,-
chr7,75956945,0.31312536677112895,351,761,1112,-
chr7,75956951,0.3093903755346423,654,995,1649,-
chr7,75956953,0.39213898955483295,731,879,1610,-
chr7,75956955,0.14892615244283527,355,916,1271,-
chr7,75956956,0.20975870150075568,421,811,1232,-
chr7,75956959,0.3145340253272266,576,1275,1851,-
chr7,75956960,0.26274851215363776,945,2479,3424,-
chr7,75956961,0.24918727168268667,1625,3989,5614,-
chr7,75956962,0.2392795121106384,1207,2906,4113,-
chr7,75956963,0.23647529819347526,994,2868,3862,-
chr7,75956964,0.3640892354342646,491,1025,1516,-
chr7,75956965,0.25412342987455316,539,1748,2287,-
chr7,75956966,0.24942200298224004,574,1887,2461,-
chr7,75956969,2.0228910203851074,232,1102,1334,-
chr7,75956970,2.573479266876416,504,1896,2400,-
chr7,75956971,3.350624396958293,292,1100,1392,-
chr7,75957259,1.5212525497546727,1970,1066,3036,-
chr7,75957261,2.5120065789473687,1696,959,2655,-
chr7,75957303,0.48623252449758425,3034,1797,4831,-
chr7,75957304,0.4116852098400358,1984,1140,3124,-
chr7,75957372,1.8715692254073364,715,498,1213,-
chr7,75958778,0.825083176064535,1292,2320,3612,-
chr7,75958780,1.0022311863803945,1108,1744,2852,-
chr7,75958795,8.048247067560547,1376,2167,3543,-
chr7,75958796,8.272571143758931,1533,2280,3813,-
chr7,75958799,16.49547733320057,673,385,1058,-
chr7,75959203,1.5133616805586845,2589,1543,4132,-
chr7,75959213,1.601735327849977,6587,4395,10982,-
chr7,75959214,1.5797096535553872,8733,5638,14371,-
chr7,75959215,1.601735327849977,6587,4395,10982,-
chr7,75959216,0.6326374115668134,1704,1188,2892,-
chr7,75959239,0.5730301427815971,1203,914,2117,-
chr7,75959248,2.574614065180103,1105,582,1687,-
chr7,75959252,1.969952691471679,993,473,1466,-
chr7,75959260,1.8367346938775508,971,566,1537,-
chr7,75959262,0.95935960591133,778,559,1337,-
chr7,75959263,1.4558697306725126,2427,1649,4076,-
chr7,80440003,4.589319965767595,936,700,1636,-
chr7,86826069,2.1877229058924277,633,436,1069,-
chr7,87848205,0.9665915915915916,617,591,1208,-
chr7,87848206,0.9665915915915916,617,591,1208,-
chr7,87848219,0.647941093250765,986,669,1655,-
chr7,87902689,1.9898989898989896,787,743,1530,-
chr7,87902690,1.9898989898989896,787,743,1530,-
chr7,87904378,2.072798188836211,1271,775,2046,-
chr7,87904379,1.7538955497029152,1143,622,1765,-
chr7,87906026,0.9300551200591431,14280,10359,24639,-
chr7,87906027,0.7998252956284794,12147,8879,21026,-
chr7,87906078,1.7429982254455674,1188,996,2184,-
chr7,87906079,1.3813488759367194,1658,1200,2858,-
chr7,87906300,1.4311256218905477,1840,1535,3375,-
chr7,87906412,1.2335357412952046,4225,2613,6838,-
chr7,87906769,1.3886625597729911,7245,4793,12038,-
chr7,87906948,1.225790490916119,4379,3249,7628,-
chr7,87907020,1.564637725156851,2688,1646,4334,-
chr7,87907024,1.6052370008800085,2391,1422,3813,-
chr7,87907030,1.4956506907726417,947,532,1479,-
chr7,87907055,1.7413806414758817,6912,3154,10066,-
chr7,87907056,1.3986359880125148,7540,3398,10938,-
chr7,87907058,0.8182949060749668,5340,2446,7786,-
chr7,87907062,0.40643969438196437,3396,1536,4932,-
chr7,87907065,0.6272691718821816,3969,2002,5971,-
chr7,87907066,0.5707500052308362,6095,3117,9212,-
chr7,87907082,2.3967592592592597,667,479,1146,-
chr7,87907315,1.4699748340115657,1638,1287,2925,-
chr7,87907477,1.865479723046489,1747,1347,3094,-
chr7,87907478,1.9722382880277616,1429,1182,2611,-
chr7,87907945,1.86707005569281,2899,2170,5069,-
chr7,87907994,1.339191710518956,5009,3555,8564,-
chr7,87908379,1.359105718298923,3683,2994,6677,-
chr7,87908600,1.3223897723992761,8035,5260,13295,-
chr7,87908712,0.7432516034725359,3149,2080,5229,-
chr7,87908844,1.3719240496166354,2303,1717,4020,-
chr7,87908862,1.3582725060827252,2232,1643,3875,-
chr7,87911068,3.0102336411524573,649,484,1133,-
chr7,87911199,0.28003456435164276,1131,742,1873,-
chr7,87912042,2.6734794537439504,3468,2948,6416,-
chr7,87912043,2.6734794537439504,3468,2948,6416,-
chr7,87912116,0.7803347751644589,4249,3287,7536,-
chr7,87912367,1.406295643414757,2427,1804,4231,-
chr7,87912420,1.4367883028570916,2029,1528,3557,-
chr7,87912461,1.2667180560035272,4782,3501,8283,-
chr7,87913235,0.8336752245953498,6005,4076,10081,-
chr7,87913536,1.343934472532128,1928,1454,3382,-
chr7,87913579,1.342318947694336,2465,1696,4161,-
chr7,87920298,1.8761609907120744,605,417,1022,-
chr7,87936118,3.65688622754491,590,500,1090,-
chr7,87936121,1.7295612373737377,706,527,1233,-
chr7,87936125,2.091377379619261,666,469,1135,-
chr7,87936132,1.5656720068484773,1137,628,1765,-
chr7,87936147,1.7541881962960486,1392,1043,2435,-
chr7,87936186,1.9272926803089734,1195,584,1779,-
chr7,87936187,1.8212807881773398,1026,434,1460,-
chr7,91741736,1.6081471348229217,1057,730,1787,-
chr7,91742324,3.426344896933132,704,350,1054,-
chr7,91742325,3.22957025161434,1035,498,1533,-
chr7,91742505,3.536701135835376,902,826,1728,-
chr7,91742507,3.154700849887371,2784,2204,4988,-
chr7,91742508,3.1543321201668966,1625,1260,2885,-
chr7,91743068,1.8613278194500693,972,653,1625,-
chr7,91746387,2.267869982069909,1194,740,1934,-
chr7,91746388,2.6163555902860915,1229,805,2034,-
chr7,91752608,4.463268792710706,626,438,1064,-
chr7,91755710,1.819960861056752,719,437,1156,-
chr7,91756902,2.9926641825803446,658,451,1109,-
chr7,91756904,1.65935085007728,975,646,1621,-
chr7,91756905,1.355448393871043,941,597,1538,-
chr7,91756907,1.5342969500480308,1264,818,2082,-
chr7,91761183,1.1124338624338623,782,566,1348,-
chr7,91761184,1.1124338624338623,782,566,1348,-
chr7,91851253,1.9483824063976738,669,523,1192,-
chr7,91851254,1.712908777969019,932,580,1512,-
chr7,91851273,0.4464217006540977,713,451,1164,-
chr7,91851274,1.659676674364896,690,432,1122,-
chr7,91851275,0.4464217006540977,713,451,1164,-
chr7,91851286,1.3262159572150953,1342,803,2145,-
chr7,91851287,0.8871526939248394,1240,772,2012,-
chr7,92238985,5.728092783505155,634,387,1021,-
chr7,92238987,5.728092783505155,634,387,1021,-
chr7,93515645,2.322198077518929,1060,702,1762,-
chr7,93515935,1.5661764705882353,851,594,1445,-
chr7,93516110,1.648392857142857,1085,839,1924,-
chr7,93516595,3.716878402903811,959,550,1509,-
chr7,93516597,0.5878611817469769,3270,1982,5252,-
chr7,93516598,0.5878611817469769,3270,1982,5252,-
chr7,93516662,0.658732010890704,1167,856,2023,-
chr7,93516669,1.6778181818181817,768,494,1262,-
chr7,93518405,2.0029239766081868,684,493,1177,-
chr7,93519498,2.810606060606061,794,494,1288,-
chr7,93519499,2.090800438170765,1132,725,1857,-
chr7,93519992,2.5091478290070937,975,652,1627,-
chr7,93623126,1.7620826607219207,779,616,1395,-
chr7,93628534,1.04058407815423,800,565,1365,-
chr7,93628535,1.04058407815423,800,565,1365,-
chr7,93628561,0.929494445703922,614,400,1014,-
chr7,93628562,0.929494445703922,614,400,1014,-
chr7,94259114,2.3524666632165467,665,565,1230,-
chr7,94259115,3.5526745490861353,539,473,1012,-
chr7,95034385,2.3087628609771857,928,648,1576,-
chr7,95034386,2.3087628609771857,928,648,1576,-
chr7,95034547,0.4174387655402446,1238,885,2123,-
chr7,95034674,1.9130915900578827,774,533,1307,-
chr7,95034752,0.5966254218222722,662,507,1169,-
chr7,95034772,1.7012241054613937,622,530,1152,-
chr7,95035522,1.1050478378735136,1636,1111,2747,-
chr7,95039374,1.7228029423151374,889,573,1462,-
chr7,95041720,0.6007390983000739,761,494,1255,-
chr7,95053869,2.1366822551138704,930,622,1552,-
chr7,95214146,1.9401430572690246,1329,960,2289,-
chr7,95214155,0.45201423702029414,1177,588,1765,-
chr7,95214156,0.6864343556846392,1483,869,2352,-
chr7,96339065,0.746009136830386,16001,11118,27119,-
chr7,96339066,0.909293407020786,34367,22702,57069,-
chr7,96339067,1.2663009109709615,9559,5318,14877,-
chr7,96339068,0.7657356707439076,13708,9831,23539,-
chr7,96339071,1.5716306749740456,5650,3229,8879,-
chr7,96339074,1.4566266268117458,6183,3708,9891,-
chr7,96339076,1.3664384882125102,17818,11059,28877,-
chr7,96339077,1.5067419253684542,3471,2125,5596,-
chr7,96339083,2.3539152298850574,5040,2783,7823,-
chr7,96339084,2.3539152298850574,5040,2783,7823,-
chr7,96339101,1.944686162208821,3788,2316,6104,-
chr7,96339107,1.38503220674572,5673,3174,8847,-
chr7,96339109,1.4225476036323188,1557,872,2429,-
chr7,96339112,1.6726223337515684,1448,796,2244,-
chr7,96339120,1.7187351778656126,1552,758,2310,-
chr7,96339124,1.7481257366681409,4177,2062,6239,-
chr7,96339132,0.6635260568105569,878,525,1403,-
chr7,96339136,2.187604690117253,652,397,1049,-
chr7,96339139,2.722986696455773,2102,915,3017,-
chr7,96339141,2.4720665623219378,3935,1697,5632,-
chr7,96339145,2.0344861530234684,4400,1862,6262,-
chr7,96339146,1.9921123372948504,3312,1301,4613,-
chr7,96339147,2.1530249110320283,1088,561,1649,-
chr7,96339156,0.6419569123414718,3324,1312,4636,-
chr7,96339157,0.6200936402039722,4411,1818,6229,-
chr7,96339171,0.6174284841698058,1212,516,1728,-
chr7,96339172,0.7855013550135501,1682,737,2419,-
chr7,96339174,1.1942856667553898,1243,610,1853,-
chr7,97481499,5.78107498940291,6911,5046,11957,-
chr7,97481500,5.1602573866515815,5714,4086,9800,-
chr7,97481501,7.573830268122748,3306,2553,5859,-
chr7,97481595,1.5814963900070285,727,422,1149,-
chr7,97482476,1.590725041123624,1478,1128,2606,-
chr7,97482673,1.4905967903711137,1320,996,2316,-
chr7,97483979,0.6897329936547776,3549,2486,6035,-
chr7,97484740,1.5820782193814529,1812,1316,3128,-
chr7,97486025,2.067431720785451,7249,4215,11464,-
chr7,97486115,1.3387392502473041,10460,6524,16984,-
chr7,97486116,1.5156888632916976,8183,5106,13289,-
chr7,97486117,1.5156888632916976,8183,5106,13289,-
chr7,97487653,0.7350485559339135,1266,880,2146,-
chr7,97487659,1.8235062117925456,1320,921,2241,-
chr7,97487665,1.7992455854531768,2797,2032,4829,-
chr7,97487668,1.8455778717406623,1021,687,1708,-
chr7,97488173,1.3985441310282074,1589,1098,2687,-
chr7,97488246,1.5336374002280502,1344,876,2220,-
chr7,97488570,1.747711670480549,1299,919,2218,-
chr7,97488621,1.5019328687809008,3048,2234,5282,-
chr7,97498313,1.823715095103197,1047,705,1752,-
chr7,97498400,1.9561112082531915,1016,816,1832,-
chr7,97498435,1.5113756814052088,1308,1015,2323,-
chr7,97499101,1.7746694995278562,1454,1058,2512,-
chr7,97499102,1.7746694995278562,1454,1058,2512,-
chr7,97499105,0.6721153846153847,698,591,1289,-
chr7,97501710,2.507188607353204,871,584,1455,-
chr7,97922725,0.637492993941216,978,759,1737,-
chr7,97922727,0.6565079323041169,1170,819,1989,-
chr7,97922782,2.930124177892922,923,560,1483,-
chr7,97922783,2.847252079925803,863,490,1353,-
chr7,97933656,2.8666610942822617,615,429,1044,-
chr7,97939809,0.9524952015355085,793,520,1313,-
chr7,97939811,0.9524952015355085,793,520,1313,-
chr7,97939838,0.866974240676663,614,577,1191,-
chr7,97939840,0.866974240676663,614,577,1191,-
chr7,97941514,2.0242645791311626,724,605,1329,-
chr7,97946552,0.2791706846673095,578,487,1065,-
chr7,97946656,1.5274754000410775,2947,2185,5132,-
chr7,97946659,0.7349426191703519,1900,1270,3170,-
chr7,97946662,1.8147456125781989,2545,1783,4328,-
chr7,97949371,1.3978886057517292,3299,2254,5553,-
chr7,97949373,3.4124999999999996,1520,1039,2559,-
chr7,97949378,1.6556358822930457,1354,853,2207,-
chr7,97949421,1.963084925645489,1641,972,2613,-
chr7,97949438,0.5297186427074508,791,546,1337,-
chr7,97949570,2.598992294013041,710,481,1191,-
chr7,97949575,2.4155969812294398,1313,837,2150,-
chr7,97949577,2.2886240867320478,1816,1155,2971,-
chr7,97991675,1.4285301582715995,1922,1126,3048,-
chr7,97991690,0.7007712082262211,1785,777,2562,-
chr7,97991692,0.6062107242787028,825,506,1331,-
chr7,97991693,0.5723572639909553,899,487,1386,-
chr7,97991706,0.37797619047619035,1015,503,1518,-
chr7,98994089,0.3263864077876905,989,1649,2638,-
chr7,98994090,0.3263864077876905,989,1649,2638,-
chr7,98994091,0.2681328613391579,711,1206,1917,-
chr7,98994092,0.4819813015832538,858,1039,1897,-
chr7,98994093,0.38652941997455875,1070,1653,2723,-
chr7,98994100,0.4079816980172852,534,842,1376,-
chr7,98994101,0.306563969683858,1008,1850,2858,-
chr7,98994102,0.35725403143498674,682,1103,1785,-
chr7,98994103,0.2732678339055408,687,1297,1984,-
chr7,98994106,0.24450759052742602,425,694,1119,-
chr7,98994112,11.702383339521498,1135,1803,2938,-
chr7,98994113,11.16400607210199,1350,2152,3502,-
chr7,98994114,12.724103192575857,1267,1923,3190,-
chr7,98997957,1.7459056043120722,814,498,1312,-
chr7,98997967,2.2044113078595835,886,695,1581,-
chr7,98997979,1.5471560525036463,669,483,1152,-
chr7,98997980,1.6153183520599252,730,533,1263,-
chr7,99002560,2.1373401534526857,821,781,1602,-
chr7,99002570,1.7734241908006811,693,586,1279,-
chr7,99002573,1.8036057033177957,633,520,1153,-
chr7,99006197,1.785066212528632,682,404,1086,-
chr7,99006199,1.785066212528632,682,404,1086,-
chr7,99055887,1.8899033297529535,764,664,1428,-
chr7,99055890,0.5520376077955231,1143,773,1916,-
chr7,99056849,1.8598269994327852,1542,1311,2853,-
chr7,99056865,1.3980163603010092,4329,3099,7428,-
chr7,99063765,1.1067656552091234,3973,2764,6737,-
chr7,99063766,0.8720377974952211,4788,3083,7871,-
chr7,99063777,0.693059293315494,2017,1403,3420,-
chr7,99063786,1.0690145703095504,931,620,1551,-
chr7,99690636,1.727535979793427,1893,1250,3143,-
chr7,99690732,0.5798610350042742,1429,1060,2489,-
chr7,99690995,1.5204154463340798,1187,990,2177,-
chr7,99691014,1.6606631797815394,2517,1841,4358,-
chr7,99691904,1.781559045956952,699,572,1271,-
chr7,99691940,1.750367107195301,1191,907,2098,-
chr7,99691941,1.750367107195301,1191,907,2098,-
chr7,99693479,0.5667254556143444,963,629,1592,-
chr7,99693480,0.6229707792207791,613,559,1172,-
chr7,99693483,0.685666851134477,825,555,1380,-
chr7,99693508,2.3642578125,806,511,1317,-
chr7,99693580,2.774929915899079,1013,680,1693,-
chr7,99693586,1.6251358991085019,1009,656,1665,-
chr7,99693655,2.1888990406578346,776,596,1372,-
chr7,99693786,1.9294990723562149,649,538,1187,-
chr7,99695247,2.2130143540669858,745,549,1294,-
chr7,99695352,1.4887856579701837,5998,3487,9485,-
chr7,99695353,1.1505278984768266,12022,6480,18502,-
chr7,99695354,0.659899689515166,8288,4186,12474,-
chr7,99695355,0.659899689515166,8288,4186,12474,-
chr7,99695358,1.02998766408094,5737,3125,8862,-
chr7,99695363,0.6198816967911538,10183,5488,15671,-
chr7,99695364,0.5946264037972326,4088,2271,6359,-
chr7,99695464,1.2848830729610783,4306,2377,6683,-
chr7,99695476,1.7077340004169277,2047,1065,3112,-
chr7,99695559,0.6505019305019305,1403,1049,2452,-
chr7,99695910,1.5434663167461118,13313,8326,21639,-
chr7,99695912,1.5434663167461118,13313,8326,21639,-
chr7,99696203,1.360786807073316,3642,2156,5798,-
chr7,99696207,0.8215828100574941,2818,1640,4458,-
chr7,99696213,0.7568018778517677,1913,1162,3075,-
chr7,99696229,0.6703415029210731,3892,2720,6612,-
chr7,99696239,0.4525340235451282,1083,811,1894,-
chr7,99696241,2.589470812875068,862,610,1472,-
chr7,99696262,2.643901703603196,922,736,1658,-
chr7,99696656,1.5862708719851577,809,692,1501,-
chr7,99696934,1.2184598416865453,1861,1336,3197,-
chr7,99696935,1.8417682926829262,862,655,1517,-
chr7,99696942,1.895541102592297,1733,1270,3003,-
chr7,99697015,2.005108695652174,945,735,1680,-
chr7,99697227,2.307386962724059,978,700,1678,-
chr7,99697291,1.5073821279891566,1270,938,2208,-
chr7,99697292,0.5183293269230769,1349,831,2180,-
chr7,99697313,1.6157459181391187,1203,788,1991,-
chr7,99697715,0.5721725425703225,1335,845,2180,-
chr7,99698888,1.8802453987730063,1276,814,2090,-
chr7,99698911,2.312604690117253,704,596,1300,-
chr7,99698977,1.6665406427221172,759,528,1287,-
chr7,99698984,1.8131868131868132,604,454,1058,-
chr7,100032962,0.2915096650199206,642,453,1095,-
chr7,100033026,2.3936781609195408,1567,1565,3132,-
chr7,100033028,1.8184178321678324,2252,2199,4451,-
chr7,100033030,1.6551342888446063,1831,1697,3528,-
chr7,100033031,1.316126191462909,1036,1015,2051,-
chr7,100033032,1.4653702815675778,1813,1552,3365,-
chr7,100033033,1.6983228149044696,777,537,1314,-
chr7,100410804,3.7357628004179726,772,637,1409,-
chr7,100850950,0.9636265771716376,534,476,1010,-
chr7,100853693,0.9488213399503725,804,519,1323,-
chr7,100853694,0.9488213399503725,804,519,1323,-
chr7,100859716,3.292403222412607,709,534,1243,-
chr7,100859794,4.620202623302279,1116,777,1893,-
chr7,100859795,4.656519575809191,831,580,1411,-
chr7,100859796,4.620202623302279,1116,777,1893,-
chr7,100883131,5.3321011069419875,2986,2223,5209,-
chr7,100883132,5.3321011069419875,2986,2223,5209,-
chr7,100883473,0.4403225806451613,545,479,1024,-
chr7,100883508,1.0960599153370238,917,746,1663,-
chr7,100883509,1.730204033360258,2267,1824,4091,-
chr7,100884123,2.388888888888889,601,413,1014,-
chr7,100884158,1.959841628959276,629,415,1044,-
chr7,100887325,1.3269565876603904,1067,690,1757,-
chr7,100888316,2.393022858234886,853,673,1526,-
chr7,102113950,4.265940173651301,947,752,1699,-
chr7,102114835,1.789735297640436,572,451,1023,-
chr7,102957314,2.434256055363322,736,747,1483,-
chr7,102957316,2.434256055363322,736,747,1483,-
chr7,102957336,1.3097255083327701,1155,768,1923,-
chr7,102964049,2.271365338781069,952,978,1930,-
chr7,102964056,1.2106016011265426,3793,3247,7040,-
chr7,102964058,1.8874172185430464,1649,1509,3158,-
chr7,102964073,1.6569125635184858,590,438,1028,-
chr7,102978232,2.123397910957233,1515,1043,2558,-
chr7,105121560,2.183716253797116,1759,1112,2871,-
chr7,105121585,1.7062862545427904,3453,2060,5513,-
chr7,105121586,1.618757004763239,2464,1375,3839,-
chr7,105121599,2.1419072948328264,2049,986,3035,-
chr7,105121600,2.1419072948328264,2049,986,3035,-
chr7,105146692,4.864036363514558,748,538,1286,-
chr7,105733420,2.890964554114679,868,659,1527,-
chr7,105733421,3.163422960253026,863,682,1545,-
chr7,105739665,0.9076620825147348,725,508,1233,-
chr7,105739666,0.9076620825147348,725,508,1233,-
chr7,105890582,2.5292755991285403,742,431,1173,-
chr7,105890583,2.5292755991285403,742,431,1173,-
chr7,105891351,1.9714800214143184,987,760,1747,-
chr7,105891552,2.717508896797153,978,561,1539,-
chr7,105891554,2.775699250288351,1452,815,2267,-
chr7,105891555,2.533972557447512,957,525,1482,-
chr7,105891558,3.9442351859018987,902,534,1436,-
chr7,105893533,1.7779891304347828,726,459,1185,-
chr7,105893541,2.0727718995559847,1181,935,2116,-
chr7,105894910,0.47700616661964435,788,576,1364,-
chr7,105894913,2.248312710911136,1024,634,1658,-
chr7,105894914,2.248312710911136,1024,634,1658,-
chr7,105904018,2.7630390143737165,840,486,1326,-
chr7,105904029,2.094528367783503,1287,775,2062,-
chr7,105908998,1.4245476807158992,3738,2633,6371,-
chr7,105915473,2.1599952133070066,721,618,1339,-
chr7,105915475,2.10025958380876,1137,876,2013,-
chr7,105915490,2.3283577444309462,920,579,1499,-
chr7,105915492,2.3283577444309462,920,579,1499,-
chr7,105925306,2.130091829526725,977,547,1524,-
chr7,105925307,2.130091829526725,977,547,1524,-
chr7,106300183,1.4444845840628326,603,481,1084,-
chr7,106876947,2.078061847299197,607,422,1029,-
chr7,107167756,2.6322976182385114,572,475,1047,-
chr7,107564380,2.116216216216216,782,665,1447,-
chr7,107564423,2.380069103473359,817,610,1427,-
chr7,107566720,1.836027713625866,635,432,1067,-
chr7,107569966,1.7782258064516125,881,479,1360,-
chr7,107570015,1.7864736070381229,721,495,1216,-
chr7,107571828,1.5187695516162671,970,684,1654,-
chr7,107571862,1.8145779466592662,1662,1192,2854,-
chr7,107571866,1.906602254428341,850,528,1378,-
chr7,107571867,1.826899383983573,1270,973,2243,-
chr7,107571868,1.826899383983573,1270,973,2243,-
chr7,107572663,2.0855489279454784,741,510,1251,-
chr7,107572666,3.023566762058058,548,453,1001,-
chr7,107575941,2.6771432719464157,689,603,1292,-
chr7,107577699,1.8436730123180287,587,469,1056,-
chr7,107580670,1.2197102989680713,735,482,1217,-
chr7,107592461,1.2157323842184309,836,591,1427,-
chr7,107592659,2.2837445315125864,743,546,1289,-
chr7,107600193,2.4392607642710296,1583,1166,2749,-
chr7,107600194,2.872246289980643,798,570,1368,-
chr7,107600997,2.1164021164021163,639,431,1070,-
chr7,107602105,0.6076868235141616,585,416,1001,-
chr7,107603371,0.3204365983959816,841,728,1569,-
chr7,107603399,2.604891820920037,795,646,1441,-
chr7,107603476,1.5503289889544973,630,442,1072,-
chr7,107613492,2.5839885226147445,764,576,1340,-
chr7,107615725,2.523809523809524,794,509,1303,-
chr7,107615784,0.1977559607293127,563,459,1022,-
chr7,107621059,2.178479741042527,672,526,1198,-
chr7,107621125,1.9818230419673883,673,386,1059,-
chr7,107626668,0.5073529411764706,965,671,1636,-
chr7,107626781,1.7060257749912924,631,521,1152,-
chr7,107638807,0.5238832375055285,617,531,1148,-
chr7,107642141,1.1722936915547568,700,509,1209,-
chr7,108155014,2.4860138369853257,1037,771,1808,-
chr7,108155025,1.0036310820624543,690,458,1148,-
chr7,108155026,1.0036310820624543,690,458,1148,-
chr7,111509703,2.981862851362093,877,658,1535,-
chr7,111509705,2.981862851362093,877,658,1535,-
chr7,112757254,2.031490788355337,875,620,1495,-
chr7,112757354,1.705843293492696,733,501,1234,-
chr7,112758136,2.789633914088779,565,465,1030,-
chr7,123181314,1.6980648833238474,662,501,1163,-
chr7,123181720,2.1163537549407114,658,351,1009,-
chr7,123182002,2.291150915004126,1179,762,1941,-
chr7,123182187,1.0723642594660652,912,787,1699,-
chr7,123182249,0.5382488479262673,656,557,1213,-
chr7,123190529,1.276703774991935,777,625,1402,-
chr7,123190616,0.5978112175102599,666,492,1158,-
chr7,123190617,0.5444091650218827,792,541,1333,-
chr7,123388677,1.77037064685902,1673,1100,2773,-
chr7,123388679,1.5325267106018892,3594,2207,5801,-
chr7,123388680,1.3004740850858876,4240,2485,6725,-
chr7,123388681,1.3878403085157502,3930,2254,6184,-
chr7,123388682,1.2050457754144717,3418,1957,5375,-
chr7,123388708,0.8768624946785867,748,347,1095,-
chr7,123388709,0.8768624946785867,748,347,1095,-
chr7,124487022,2.159459114682996,528,602,1130,-
chr7,124487035,2.402169241271206,1172,1068,2240,-
chr7,124487036,2.034910789216215,1424,1267,2691,-
chr7,124487037,2.402169241271206,1172,1068,2240,-
chr7,127978842,0.5185758513931888,669,475,1144,-
chr7,127978847,0.573180799622597,1079,833,1912,-
chr7,127979339,1.934366289349435,1135,695,1830,-
chr7,127979340,1.806046329014527,919,565,1484,-
chr7,128034975,3.3720978379499407,677,480,1157,-
chr7,128210282,0.5351071692535107,723,373,1096,-
chr7,128210284,0.5060823002153542,939,497,1436,-
chr7,128594382,5.616270902635198,3428,2452,5880,-
chr7,128594383,5.616270902635198,3428,2452,5880,-
chr7,128594458,4.09706156132674,1304,917,2221,-
chr7,128594459,4.3183908045977,662,434,1096,-
chr7,128594576,0.21745042601176556,457,558,1015,-
chr7,128594578,0.21433310671402053,432,626,1058,-
chr7,128594588,3.7252819815707494,516,944,1460,-
chr7,128594589,3.7252819815707494,516,944,1460,-
chr7,128594964,2.6780236033397844,724,435,1159,-
chr7,129470738,2.438921442902828,714,571,1285,-
chr7,129470883,1.5729228182661827,874,714,1588,-
chr7,129470884,1.4722323049001815,831,759,1590,-
chr7,129470885,1.4722323049001815,831,759,1590,-
chr7,129470886,1.522825681725932,826,667,1493,-
chr7,129471748,2.3929355066888918,594,444,1038,-
chr7,129471750,2.100587421447011,706,521,1227,-
chr7,129472478,1.7035246533641748,4764,3638,8402,-
chr7,129472480,1.7035246533641748,4764,3638,8402,-
chr7,129472485,1.3855302524540711,1600,1325,2925,-
chr7,129472491,1.5636660243633382,4019,2606,6625,-
chr7,129472492,1.6208695858888416,2253,1367,3620,-
chr7,129472497,2.09375,937,543,1480,-
chr7,129472544,1.4132290951255813,2319,1474,3793,-
chr7,129472566,3.163055453543885,637,388,1025,-
chr7,129473151,3.0571532249774074,1408,1075,2483,-
chr7,129473154,1.9161510272738203,1614,1147,2761,-
chr7,129473155,2.0814895163700196,2846,2069,4915,-
chr7,129473159,2.9575093384527147,2807,1789,4596,-
chr7,129473160,3.219904891304348,2988,1839,4827,-
chr7,129473161,3.219904891304348,2988,1839,4827,-
chr7,129473162,3.347479614529281,2229,1348,3577,-
chr7,129473245,2.3785365853658536,635,409,1044,-
chr7,129473297,0.320951449983708,787,557,1344,-
chr7,129473299,0.320951449983708,787,557,1344,-
chr7,129474106,1.7163158522494846,632,465,1097,-
chr7,129474777,2.4759558390681953,539,468,1007,-
chr7,132469970,2.154139496109309,895,673,1568,-
chr7,132470014,0.960602087720151,2588,1462,4050,-
chr7,132470056,2.146591970121382,725,356,1081,-
chr7,132470059,1.936646884272997,686,336,1022,-
chr7,132719321,2.1025139424274317,3102,2335,5437,-
chr7,132719330,2.653439153439153,648,593,1241,-
chr7,132719358,1.7823113745156145,1116,641,1757,-
chr7,132719368,1.4744814633349663,2344,1883,4227,-
chr7,132719370,1.5453604829328689,3087,2260,5347,-
chr7,132719371,1.365206562781786,600,496,1096,-
chr7,132719373,1.5506646777674213,1368,1061,2429,-
chr7,132719388,0.8678657413964028,765,306,1071,-
chr7,132719389,0.7113406371312375,1351,711,2062,-
chr7,132720096,3.758394991462721,561,501,1062,-
chr7,132720097,3.758394991462721,561,501,1062,-
chr7,132720098,3.758394991462721,561,501,1062,-
chr7,132720102,1.2440347071583515,774,460,1234,-
chr7,132720103,1.2440347071583515,774,460,1234,-
chr7,132720104,1.0834229095705574,909,541,1450,-
chr7,134127323,1.7063321385902035,964,674,1638,-
chr7,134127335,1.8775212858959274,1435,1053,2488,-
chr7,134127337,3.011272275176129,772,634,1406,-
chr7,134127374,3.2481854620301163,936,542,1478,-
chr7,134127453,0.3375344352617079,753,659,1412,-
chr7,134133788,0.9315567922374428,2212,1751,3963,-
chr7,134133790,0.9315567922374428,2212,1751,3963,-
chr7,134133798,2.003664495114007,797,613,1410,-
chr7,134133815,1.483908626155634,1527,1056,2583,-
chr7,134133818,2.1591201863969642,1144,918,2062,-
chr7,134133821,0.5288769275530987,660,490,1150,-
chr7,134134539,1.892074198988196,679,592,1271,-
chr7,134135605,2.4886340364530004,783,513,1296,-
chr7,134136342,2.3649979035639412,1021,629,1650,-
chr7,134136353,2.168235294117647,678,349,1027,-
chr7,134143808,2.8980248047772164,700,310,1010,-
chr7,134143809,2.8980248047772164,700,310,1010,-
chr7,135611749,3.887323943661972,620,425,1045,-
chr7,135611965,2.35921875,718,399,1117,-
chr7,135612810,1.6327266483516485,770,545,1315,-
chr7,135612812,2.1374485596707817,741,485,1226,-
chr7,135613052,4.6123658455317615,498,522,1020,-
chr7,135613059,4.3803933641265145,534,489,1023,-
chr7,135613069,3.0181982003356853,1523,975,2498,-
chr7,135613070,3.06312502690317,1311,801,2112,-
chr7,135613155,0.46448215979513935,1404,1631,3035,-
chr7,135613230,42.641553427859975,4241,4135,8376,-
chr7,135613231,47.39417172393179,5762,4287,10049,-
chr7,135613232,39.856013551665725,1485,965,2450,-
chr7,135613233,48.306551418744284,6402,1303,7705,-
chr7,135613234,7.728592308259399,5768,608,6376,-
chr7,135613235,7.633411309726317,7485,810,8295,-
chr7,135613237,8.695387187081117,7123,806,7929,-
chr7,135613238,8.022391530399563,4554,523,5077,-
chr7,135613239,7.8877729559099015,3980,476,4456,-
chr7,135613334,0.3235432817137035,1232,807,2039,-
chr7,135613565,2.860103626943005,643,385,1028,-
chr7,135613722,2.044785877737823,694,482,1176,-
chr7,135614103,2.336309523809524,627,419,1046,-
chr7,135614137,0.6553275109170306,1046,915,1961,-
chr7,135614146,1.0690569021048093,1405,1388,2793,-
chr7,135614150,3.261784511784512,499,527,1026,-
chr7,135614194,1.3009257659154507,1140,824,1964,-
chr7,135614285,2.397541687801891,999,639,1638,-
chr7,135614389,1.8979526208596846,680,490,1170,-
chr7,135614486,1.0455032119914347,650,466,1116,-
chr7,135614488,1.0455032119914347,650,466,1116,-
chr7,135614590,2.823836865356939,757,557,1314,-
chr7,137560466,1.5599878638854783,744,549,1293,-
chr7,137562040,1.6689202240679928,809,500,1309,-
chr7,137562053,2.147899159663865,638,454,1092,-
chr7,137562901,0.9303247464626212,1819,1404,3223,-
chr7,137562903,0.9967812043930048,1565,1190,2755,-
chr7,137563187,3.693777911804028,636,480,1116,-
chr7,137563951,2.84589688931442,728,499,1227,-
chr7,137564481,2.178490313961256,525,498,1023,-
chr7,137564484,2.5200991189427318,1016,907,1923,-
chr7,137564485,2.5200991189427318,1016,907,1923,-
chr7,137613088,2.015577688750628,644,452,1096,-
chr7,137613089,1.768552539534059,726,538,1264,-
chr7,138745644,2.4765623296516175,706,583,1289,-
chr7,140153502,0.28905315937727905,1402,1076,2478,-
chr7,140153542,1.194354345522481,632,451,1083,-
chr7,140158809,1.2496610877148144,711,464,1175,-
chr7,148523639,3.2632937234069064,883,619,1502,-
chr7,148526924,1.4665742840346014,1396,971,2367,-
chr7,148526928,0.9668496556784052,5891,4266,10157,-
chr7,148526929,0.7911230829541738,4928,3320,8248,-
chr7,148526930,1.1441562343039826,5428,4148,9576,-
chr7,148526931,1.7496014030612244,1290,1175,2465,-
chr7,148526932,1.7496014030612244,1290,1175,2465,-
chr7,148684339,0.9801813066583309,602,456,1058,-
chr7,148700726,2.1703657670454546,842,511,1353,-
chr7,148700731,1.9373846988605528,540,484,1024,-
chr7,148700756,1.936291739894552,1016,568,1584,-
chr7,148700758,1.979440692420744,1282,755,2037,-
chr7,148700951,2.2273926210557167,936,748,1684,-
chr7,148700992,2.099271571324714,3751,2418,6169,-
chr7,148701013,1.238862642942293,2984,1594,4578,-
chr7,148701026,0.6590874848208048,5663,3110,8773,-
chr7,148701039,1.4596368315699173,5372,2689,8061,-
chr7,148701040,1.4596368315699173,5372,2689,8061,-
chr7,148701041,1.240588920027303,7691,4090,11781,-
chr7,148701057,1.8070192804513712,3069,1591,4660,-
chr7,148701078,1.838653348605849,3232,1905,5137,-
chr7,148701079,1.5900663666731707,3998,2503,6501,-
chr7,148701099,0.6667997781475319,883,600,1483,-
chr7,148701111,1.543597961867193,682,506,1188,-
chr7,148701112,1.6877770265194199,955,521,1476,-
chr7,148701115,0.5434858539993014,777,408,1185,-
chr7,148701195,2.3481638418079096,664,471,1135,-
chr7,148701196,1.555787037037037,857,539,1396,-
chr7,148701261,2.4692982456140347,562,474,1036,-
chr7,148702279,2.174163368118028,1006,793,1799,-
chr7,148702280,2.174163368118028,1006,793,1799,-
chr7,148702336,2.628093099328132,1473,1128,2601,-
chr7,148702458,1.9585759806614655,712,478,1190,-
chr7,148702999,1.7286171063149482,691,416,1107,-
chr7,148703068,5.610738255033557,1143,595,1738,-
chr7,148703069,5.610738255033557,1143,595,1738,-
chr7,148703123,1.9408975612138262,841,501,1342,-
chr7,148705353,1.6417461415806731,1069,772,1841,-
chr7,148705354,0.4786135693215339,648,564,1212,-
chr7,148705374,3.5339805825242716,649,514,1163,-
chr7,148705399,1.6712837837837835,872,591,1463,-
chr7,148709023,3.0524109014675056,559,476,1035,-
chr7,148709050,2.13028413028413,635,480,1115,-
chr7,148709088,1.8018067316256345,1447,1001,2448,-
chr7,148709346,1.7925726191935287,1107,994,2101,-
chr7,148709347,1.9262309849463453,1636,1399,3035,-
chr7,148709416,1.9443207126948776,581,448,1029,-
chr7,148712008,2.5418613707165107,745,641,1386,-
chr7,148712133,2.034192987539844,584,492,1076,-
chr7,148716128,1.0588305783725926,1332,958,2290,-
chr7,148716136,3.5747074707470747,610,403,1013,-
chr7,148716254,1.6380807858954136,2343,1726,4069,-
chr7,148716255,1.6380807858954136,2343,1726,4069,-
chr7,148718124,2.455072463768116,846,689,1535,-
chr7,148718148,0.6003187988482107,933,747,1680,-
chr7,148718157,0.6111851775886235,940,596,1536,-
chr7,148718172,2.94784746029004,1248,1035,2283,-
chr7,148718227,1.4698518611640026,911,658,1569,-
chr7,148718232,1.184265010351967,649,524,1173,-
chr7,148718233,1.184265010351967,649,524,1173,-
chr7,150773795,12.361592908340299,578,492,1070,-
chr7,150916212,1.6915743154938074,4573,3502,8075,-
chr7,150916236,1.8173610737142694,4806,3010,7816,-
chr7,150916237,1.674205306433839,5808,3524,9332,-
chr7,150916239,1.5154292399941502,3767,2247,6014,-
chr7,150918669,2.2205882352941178,905,611,1516,-
chr7,150918686,1.660955685679173,717,476,1193,-
chr7,150918710,2.088786051720285,2184,1522,3706,-
chr7,150918721,1.686746987951807,839,580,1419,-
chr7,150919641,2.626346281715912,1016,748,1764,-
chr7,150919642,2.8309675819748343,918,629,1547,-
chr7,150919696,0.8375868048702827,691,489,1180,-
chr7,150923461,0.30326397844315145,753,701,1454,-
chr7,151164031,3.8101710203806496,747,416,1163,-
chr7,151164171,1.8838525669153137,1300,859,2159,-
chr7,151167662,0.7096529968454259,1367,950,2317,-
chr7,151167665,2.3487940630797777,632,538,1170,-
chr7,151167697,2.127693535514765,773,536,1309,-
chr7,151168662,0.553765365795441,869,512,1381,-
chr7,151181846,2.0609742092704284,2128,1540,3668,-
chr7,151181867,1.827339130434783,795,574,1369,-
chr7,151181877,1.8684615384615388,693,499,1192,-
chr7,151181885,0.2450829383886256,590,421,1011,-
chr7,151188041,0.5198802772526779,568,459,1027,-
chr7,158424201,2.9963861065453066,992,1324,2316,-
chr7,158424210,11.839238694809586,2804,2839,5643,-
chr7,158424211,11.767117511030408,3714,3326,7040,-
chr7,158424212,11.767117511030408,3714,3326,7040,-
chr7,158424213,12.871096807316636,2771,2241,5012,-
chr7,158424220,10.004280185875933,1474,563,2037,-
chr7,158424221,7.1037151702786385,1058,305,1363,-
chr7,158424222,7.1037151702786385,1058,305,1363,-
chr7,158424228,11.435607891660426,2437,717,3154,-
chr7,158424229,9.203431344928125,1733,535,2268,-
chr7,158424230,9.06227599668273,2271,654,2925,-
chr7,158444996,1.0462576930712726,619,437,1056,-
chr7,158444997,1.0462576930712726,619,437,1056,-
chr7,158447938,0.5787037037037037,874,566,1440,-
chr7,158448032,1.4374497424415824,2864,1921,4785,-
chr7,158448034,1.880883116883117,1340,874,2214,-
chr7,158448051,3.9004267425320056,913,591,1504,-
chr7,158448052,3.173918674623518,1547,1004,2551,-
chr7,158448090,1.5010146573394887,899,501,1400,-
chr7,158449025,0.3378167412039239,943,674,1617,-
chr7,158449026,0.33314580403188,645,473,1118,-
chr7,158449280,2.688895618663061,677,423,1100,-
chr7,158525999,0.4319407008086253,640,423,1063,-
chr7,158526528,2.082615049628371,772,558,1330,-
chr7,158526850,2.393964606364434,753,648,1401,-
chr7,158529831,1.0489864864864866,827,591,1418,-
chr7,158529832,0.8990322701181827,1064,810,1874,-
chr7,158534494,0.8831159723467416,711,459,1170,-
chr7,158536237,2.7175066404736876,581,482,1063,-
chr7,158542403,2.6132598916167753,638,462,1100,-
chr7,158557371,1.2118110486674063,762,482,1244,-
chr7,158586383,3.0210863355456192,618,423,1041,-
chr7,158590704,0.9651135005973714,576,464,1040,-
chr7,158590706,0.9651135005973714,576,464,1040,-
chr8,11701992,0.6685389982287577,5051,3573,8624,-
chr8,11701993,0.5917696761070255,2851,1908,4759,-
chr8,11702017,1.5167341040462428,1070,864,1934,-
chr8,11702119,0.6989641905889316,1686,1084,2770,-
chr8,11702140,1.6274131274131274,1123,839,1962,-
chr8,11702148,0.7016131390418636,1673,1206,2879,-
chr8,11702175,0.6196883852691217,874,705,1579,-
chr8,11702302,0.6388642413487133,929,712,1641,-
chr8,11702332,1.6666666666666667,763,572,1335,-
chr8,11702346,1.6695906432748535,570,512,1082,-
chr8,11702382,1.1326873291582429,1487,1112,2599,-
chr8,11702394,0.6617136727869265,838,586,1424,-
chr8,11702411,2.03197461557237,554,481,1035,-
chr8,11702515,0.6035406718006728,2738,2111,4849,-
chr8,11702634,0.6733101780291321,1682,1298,2980,-
chr8,11703174,1.5888,661,599,1260,-
chr8,11703190,1.823738363547281,708,627,1335,-
chr8,11703228,2.0333590733590734,907,517,1424,-
chr8,11704619,1.6420922070146562,2783,1965,4748,-
chr8,11704622,0.5949736995908825,1017,753,1770,-
chr8,11704672,2.3765660422383967,1298,866,2164,-
chr8,11705231,0.8359624710380825,2969,2212,5181,-
chr8,11705238,0.72775722865211,1306,985,2291,-
chr8,11705256,1.6959208899876392,1091,808,1899,-
chr8,11705274,2.376982415792248,1209,772,1981,-
chr8,11705302,1.758053691275168,1208,744,1952,-
chr8,11705304,1.465234478886558,1054,786,1840,-
chr8,11705319,0.583499100123141,879,620,1499,-
chr8,11705588,3.290105193951348,1081,675,1756,-
chr8,11705589,1.8674857973312196,1284,840,2124,-
chr8,11705616,0.6406590413943356,940,611,1551,-
chr8,11705632,0.3587389781374562,659,486,1145,-
chr8,11705657,2.0051150895140664,1007,781,1788,-
chr8,11705658,1.9770470554395165,1655,1197,2852,-
chr8,11705659,1.0601082866844085,721,640,1361,-
chr8,11705660,1.0601082866844085,721,640,1361,-
chr8,11706587,3.4449760765550237,719,474,1193,-
chr8,11706635,0.6342563708787253,825,621,1446,-
chr8,11706656,1.839663865546218,841,475,1316,-
chr8,11708484,1.7575757575757576,1478,764,2242,-
chr8,11708488,1.532716608102597,2548,1765,4313,-
chr8,11710121,1.9390459363957602,1316,848,2164,-
chr8,11710176,3.1787372330547816,1168,717,1885,-
chr8,11710194,0.6800698651008957,1219,757,1976,-
chr8,11710865,0.5293594306049823,629,561,1190,-
chr8,11710908,1.7059180576631263,802,658,1460,-
chr8,11725523,3.568631164083502,1049,634,1683,-
chr8,11725600,2.521221638538514,690,376,1066,-
chr8,17504559,2.076923076923077,593,428,1021,-
chr8,17507455,3.0164404819068134,899,547,1446,-
chr8,17612245,1.5859822752995425,1641,1139,2780,-
chr8,17612278,2.0535714285714284,674,377,1051,-
chr8,17612279,2.0535714285714284,674,377,1051,-
chr8,17612280,1.944799114742935,702,533,1235,-
chr8,17612282,1.9763835140041208,1708,1088,2796,-
chr8,17612283,1.7756641076160065,725,358,1083,-
chr8,17612284,1.9970591414579646,1328,795,2123,-
chr8,17914997,1.564662807241329,765,434,1199,-
chr8,17914999,1.386067415730337,770,444,1214,-
chr8,17915000,3.4384364275117396,974,612,1586,-
chr8,17915091,1.3193341212732106,7596,5812,13408,-
chr8,17915101,1.3295320425223647,6576,4826,11402,-
chr8,17915106,1.2869464856801076,11438,7535,18973,-
chr8,17915108,1.3051712587983242,7451,5136,12587,-
chr8,17915119,1.3482480868763578,5545,3168,8713,-
chr8,17915121,1.3482480868763578,5545,3168,8713,-
chr8,17916348,1.613502716637978,3827,2221,6048,-
chr8,17916363,1.9055266308185739,3129,1740,4869,-
chr8,17916388,2.153217993079585,1323,849,2172,-
chr8,17916398,1.85390625,1129,639,1768,-
chr8,17917088,2.36430954957007,602,431,1033,-
chr8,17924575,1.6212892309300442,3422,2250,5672,-
chr8,17924581,1.5869401804082923,2651,2271,4922,-
chr8,17924586,1.8147318269729704,4634,3654,8288,-
chr8,17924587,1.8147318269729704,4634,3654,8288,-
chr8,17924597,0.9753850080830424,3952,2414,6366,-
chr8,17924598,0.7587424425634824,4481,3307,7788,-
chr8,17924599,0.8561810869111947,8433,5721,14154,-
chr8,17924604,1.34720798517276,1711,1322,3033,-
chr8,17924606,1.0463855092597678,2527,1690,4217,-
chr8,17924791,2.7947147507399803,898,745,1643,-
chr8,19297416,2.134942492199952,685,486,1171,-
chr8,19315978,2.8290224349192448,653,488,1141,-
chr8,19363542,2.6270229449062175,586,461,1047,-
chr8,21998168,0.595134123518403,635,457,1092,-
chr8,21998203,3.2113196477130335,641,458,1099,-
chr8,22079040,1.9983399550011398,873,552,1425,-
chr8,22879117,3.346456074775453,852,556,1408,-
chr8,22879348,1.3105436534739772,610,397,1007,-
chr8,22879763,9.13524208566108,469,536,1005,-
chr8,22879764,17.47683014277977,1505,1329,2834,-
chr8,22879765,17.189059780396136,1434,1186,2620,-
chr8,22879766,27.535203612207606,1028,664,1692,-
chr8,22886049,1.8770974336996815,602,448,1050,-
chr8,23154870,0.7156172722084839,1088,750,1838,-
chr8,23155043,2.064143501126972,708,483,1191,-
chr8,23155324,4.476747787045974,1152,910,2062,-
chr8,23155325,4.512855209742896,869,738,1607,-
chr8,23155326,4.6369987422428,1747,1410,3157,-
chr8,23155327,4.93298555377207,646,533,1179,-
chr8,23156365,2.5263123700623704,1110,961,2071,-
chr8,23156366,2.5263123700623704,1110,961,2071,-
chr8,23156458,2.2171691163678786,597,466,1063,-
chr8,23159576,1.9687233591594133,694,475,1169,-
chr8,23174463,1.7832642057635901,726,446,1172,-
chr8,23177408,2.9812351936161106,656,362,1018,-
chr8,23179727,1.0626370184779204,753,617,1370,-
chr8,23179728,1.6248581195527045,1277,990,2267,-
chr8,23190939,1.0564498451209257,748,614,1362,-
chr8,23191005,1.3194694378257088,712,462,1174,-
chr8,23198711,0.3881278538812785,679,437,1116,-
chr8,23217626,2.135707154960091,961,655,1616,-
chr8,23217652,1.5287881322903427,597,423,1020,-
chr8,25297167,0.8313847900810113,1541,1011,2552,-
chr8,25297168,0.8313847900810113,1541,1011,2552,-
chr8,27455592,1.243236823221382,1055,903,1958,-
chr8,27455606,1.686612166018245,892,763,1655,-
chr8,27455632,1.2966878083157154,551,472,1023,-
chr8,27455634,1.2966878083157154,551,472,1023,-
chr8,27456009,2.3640866873065014,829,424,1253,-
chr8,27456040,0.6207165446432439,795,562,1357,-
chr8,27457308,2.038836063695727,961,601,1562,-
chr8,27457315,2.3412698412698414,943,575,1518,-
chr8,27457324,0.62642051834883,733,542,1275,-
chr8,27457342,1.7083333333333333,573,503,1076,-
chr8,27457366,1.8313006237780467,561,466,1027,-
chr8,27457424,1.6636232846392205,858,501,1359,-
chr8,27457442,1.8071483313592973,785,462,1247,-
chr8,27457445,2.5858101629913706,557,446,1003,-
chr8,27457475,1.778151593113002,598,488,1086,-
chr8,27462452,0.5578512396694215,773,483,1256,-
chr8,27462520,0.4282222868780913,668,490,1158,-
chr8,27462553,1.7641456582633055,1503,1019,2522,-
chr8,27462554,1.7641456582633055,1503,1019,2522,-
chr8,27462604,1.4111127006262407,1279,832,2111,-
chr8,27462775,3.977272727272728,601,472,1073,-
chr8,27462776,1.759758288420709,861,470,1331,-
chr8,27462844,1.6617382332264732,1283,931,2214,-
chr8,27464032,1.850567465321564,1173,731,1904,-
chr8,27466582,0.6390034019909451,2005,1519,3524,-
chr8,27467999,1.6144714527981912,713,548,1261,-
chr8,27472189,3.0237486138450897,817,502,1319,-
chr8,27605740,1.713779502647065,2663,2083,4746,-
chr8,27605741,1.8352379375069008,3910,3018,6928,-
chr8,27605743,1.8865983724538875,2558,1950,4508,-
chr8,27605746,1.5721343873517786,1331,758,2089,-
chr8,27605769,2.302786962683042,1624,875,2499,-
chr8,27605770,2.302786962683042,1624,875,2499,-
chr8,27605773,2.3016113744075826,638,421,1059,-
chr8,27667928,1.7283757338551853,735,510,1245,-
chr8,27679931,2.08654310087311,1061,749,1810,-
chr8,27685627,2.499265169011127,743,432,1175,-
chr8,29193520,2.325355757601021,786,617,1403,-
chr8,29193653,5.859555343724534,427,670,1097,-
chr8,29194149,5.197341251652597,2621,2145,4766,-
chr8,29194150,5.197341251652597,2621,2145,4766,-
chr8,29194156,12.37258138597577,1316,903,2219,-
chr8,29195852,1.3139425587467364,1093,765,1858,-
chr8,29195853,1.3139425587467364,1093,765,1858,-
chr8,29195854,1.3139425587467364,1093,765,1858,-
chr8,29207950,5.607637023399454,609,471,1080,-
chr8,29920820,1.8012979613075102,2525,1783,4308,-
chr8,29920821,1.7911706349206349,1726,1187,2913,-
chr8,29920912,2.1746970977740205,680,506,1186,-
chr8,29921333,0.5609126984126984,1027,671,1698,-
chr8,29921396,1.6448376308123849,923,597,1520,-
chr8,29923523,2.1491833030853,763,550,1313,-
chr8,29923539,0.5696424106026508,669,464,1133,-
chr8,29923625,2.0134638922888617,657,429,1086,-
chr8,29923648,1.7513666734156714,691,448,1139,-
chr8,29924365,2.4445488721804507,866,559,1425,-
chr8,29924408,2.090909090909091,919,549,1468,-
chr8,29924426,0.5536358947911295,903,553,1456,-
chr8,29927175,0.505241935483871,715,495,1210,-
chr8,29927288,1.8179012345679009,835,593,1428,-
chr8,29927479,1.927734375,704,639,1343,-
chr8,29927482,1.7797619047619049,896,755,1651,-
chr8,29927483,2.515534738485558,1006,609,1615,-
chr8,29927489,1.5895779816513762,636,544,1180,-
chr8,29927532,1.8285033743549028,657,457,1114,-
chr8,29931519,0.3242620590352772,562,462,1024,-
chr8,29940405,2.244436061863448,679,481,1160,-
chr8,29940406,2.244436061863448,679,481,1160,-
chr8,30472145,2.0820959033557735,704,506,1210,-
chr8,30472147,2.0788705318409586,703,511,1214,-
chr8,30535716,3.451886843238588,890,658,1548,-
chr8,30537091,5.866825501523456,686,466,1152,-
chr8,30537155,5.609707446808511,766,563,1329,-
chr8,30537156,5.92422732911674,1118,760,1878,-
chr8,30537162,1.3351757065199192,784,450,1234,-
chr8,30546684,1.2037383177570091,671,427,1098,-
chr8,30546685,1.5517792447529297,834,592,1426,-
chr8,30651540,2.9160142217588283,601,529,1130,-
chr8,38033831,0.5579298748519854,4034,2147,6181,-
chr8,38033836,0.9800891758917588,2507,1083,3590,-
chr8,38033837,1.6335970785149116,1341,794,2135,-
chr8,38033838,0.9800891758917588,2507,1083,3590,-
chr8,38033850,0.5297150610583446,2439,1473,3912,-
chr8,38033851,1.019907083377612,3763,2048,5811,-
chr8,38033852,1.019907083377612,3763,2048,5811,-
chr8,38033892,2.03194484047231,1616,780,2396,-
chr8,38033893,2.1475119714600157,2296,1151,3447,-
chr8,38033895,2.409110889110889,1255,714,1969,-
chr8,38033897,2.651056570548096,1174,648,1822,-
chr8,38033899,2.8459038142620234,1128,602,1730,-
chr8,38033900,3.822454308093995,731,382,1113,-
chr8,38178651,2.253701480592237,879,594,1473,-
chr8,38178652,2.253701480592237,879,594,1473,-
chr8,38205119,1.81013811961018,992,838,1830,-
chr8,38205130,1.8566459135746332,1846,1413,3259,-
chr8,38205140,3.089430894308943,759,491,1250,-
chr8,38205142,1.7307692307692308,794,635,1429,-
chr8,38205152,1.9267604586478364,2635,1791,4426,-
chr8,38205153,1.8918172492701015,1917,1333,3250,-
chr8,38205159,2.372619291419209,798,513,1311,-
chr8,38205189,1.6853002070393377,813,482,1295,-
chr8,38205211,3.6270396270396272,777,329,1106,-
chr8,38205213,1.634090344998759,1144,473,1617,-
chr8,38205215,1.7517150780907897,1090,441,1531,-
chr8,38205216,1.5175018886930247,1047,417,1464,-
chr8,48649635,1.649764032533387,1059,865,1924,-
chr8,48649710,1.9152342830233102,829,684,1513,-
chr8,48649734,0.5757649724748901,1481,1103,2584,-
chr8,48649760,1.3706142111601765,793,529,1322,-
chr8,48649761,0.7393370119839334,903,645,1548,-
chr8,48649781,1.1477112794048656,684,346,1030,-
chr8,48649783,1.5181072963631166,1192,645,1837,-
chr8,48650080,1.4311202609113856,688,517,1205,-
chr8,48743247,2.690543719083119,905,484,1389,-
chr8,48743272,2.053185625059975,815,496,1311,-
chr8,52732302,2.0126138045126347,965,816,1781,-
chr8,53554999,2.8930157551183524,1296,1008,2304,-
chr8,53555000,3.0023970141229475,1431,1124,2555,-
chr8,53555001,2.827300303336704,681,429,1110,-
chr8,53597993,4.2826765440258505,669,351,1020,-
chr8,54959763,1.5475599274185847,830,565,1395,-
chr8,54960597,1.2922737309313341,761,599,1360,-
chr8,54965300,0.4927635166057535,744,586,1330,-
chr8,54965310,5.130774737271424,981,916,1897,-
chr8,56986633,1.1612901241686848,7355,5654,13009,-
chr8,56986665,0.7691103555698716,8216,6361,14577,-
chr8,56986697,1.0411704298025726,10660,8814,19474,-
chr8,56986699,1.090578661614455,15609,12966,28575,-
chr8,56986700,0.9703881369924698,10140,8444,18584,-
chr8,56986960,1.3975331772053081,3339,2624,5963,-
chr8,56986975,1.3318112243246925,6180,4850,11030,-
chr8,56987029,1.0398056102841264,9322,7467,16789,-
chr8,56987031,0.8995686659126788,5334,4511,9845,-
chr8,56987033,0.7788006029285098,1701,1547,3248,-
chr8,56987044,1.3325473338619702,2424,1466,3890,-
chr8,56987052,1.4037162162162158,1938,1399,3337,-
chr8,56987055,0.748319236608111,1441,1536,2977,-
chr8,56987057,0.7065821376321338,2003,2172,4175,-
chr8,56987058,0.7072250639386188,1228,1359,2587,-
chr8,56987064,1.204352848126748,2166,1795,3961,-
chr8,56987065,1.1615531352736221,1419,1350,2769,-
chr8,62414275,2.446640114379085,1368,1087,2455,-
chr8,62414276,2.446640114379085,1368,1087,2455,-
chr8,62414289,1.7269969666329625,731,644,1375,-
chr8,62414290,1.0734083282744444,1689,1214,2903,-
chr8,62414337,1.940578158458244,579,466,1045,-
chr8,62414985,5.772488373338443,587,430,1017,-
chr8,62415088,0.8254190876911776,726,482,1208,-
chr8,62415089,0.8254190876911776,726,482,1208,-
chr8,62430670,1.9419849537037042,865,431,1296,-
chr8,62430671,1.9419849537037042,865,431,1296,-
chr8,62438555,3.6797881068140708,693,373,1066,-
chr8,62438573,2.178262223465024,698,518,1216,-
chr8,62460656,2.085243450910209,663,495,1158,-
chr8,62479846,0.8406430081382825,801,568,1369,-
chr8,62489396,2.1304246925040613,1079,833,1912,-
chr8,62496520,1.6242176215695714,864,669,1533,-
chr8,62531561,1.804269547325103,609,431,1040,-
chr8,62537953,1.5593850662906277,3980,3077,7057,-
chr8,62537954,1.5593850662906277,3980,3077,7057,-
chr8,62538115,1.930943583145427,4204,3247,7451,-
chr8,62538126,1.448116046707596,1472,922,2394,-
chr8,62538158,0.6729561018969313,1040,838,1878,-
chr8,62538161,1.8305038335158819,1145,663,1808,-
chr8,62538162,1.375655010704455,3550,2307,5857,-
chr8,62538629,1.5035052338423125,1853,1156,3009,-
chr8,62538721,1.6651834081411547,1811,1455,3266,-
chr8,62538752,1.4013726429076316,1755,1328,3083,-
chr8,62538772,1.6984630633396345,3570,2421,5991,-
chr8,62550888,1.3220095693779903,2762,2089,4851,-
chr8,62563628,1.421845477696542,1628,1315,2943,-
chr8,62563655,1.9855957698969824,1814,1566,3380,-
chr8,62566201,1.4749596331948827,5766,4351,10117,-
chr8,62593579,1.3703460399925425,5451,3997,9448,-
chr8,62596625,1.538975401926874,1480,1270,2750,-
chr8,62596642,1.4209558823529411,2318,1495,3813,-
chr8,62596671,1.5718582147450282,3699,2715,6414,-
chr8,62596699,1.788702928870293,854,716,1570,-
chr8,62596700,1.3339770551364092,2089,1420,3509,-
chr8,62596713,1.6507220216606497,707,553,1260,-
chr8,62596716,0.58562874251497,651,500,1151,-
chr8,62596725,1.4835466977958727,1858,1411,3269,-
chr8,62596740,1.8518242294566778,1282,856,2138,-
chr8,62596744,1.637480798771121,655,557,1212,-
chr8,62626916,1.5170616113744078,872,632,1504,-
chr8,62626972,1.3174190580559344,948,826,1774,-
chr8,63927852,1.3904203448761656,3823,2708,6531,-
chr8,63927860,2.821302117205,907,658,1565,-
chr8,63927965,2.1432986049796927,970,808,1778,-
chr8,63928003,0.49733364247623457,714,453,1167,-
chr8,63930092,0.4949378171644284,2308,1418,3726,-
chr8,63930100,0.4480824510972446,1161,838,1999,-
chr8,63930116,0.569721540595327,889,720,1609,-
chr8,63930149,1.857347275729224,648,394,1042,-
chr8,63936658,2.719163629388068,674,400,1074,-
chr8,63938835,2.03840877914952,742,485,1227,-
chr8,63942766,0.48765050941648663,728,473,1201,-
chr8,66514907,2.591160220994475,669,542,1211,-
chr8,66514908,3.9994279650777367,1223,886,2109,-
chr8,67834322,1.053436174745265,7186,5846,13032,-
chr8,67834951,1.4595930964978585,1494,1175,2669,-
chr8,67834954,1.4252371701101139,4957,3282,8239,-
chr8,67834955,1.336612194758785,3560,2207,5767,-
chr8,67834958,2.192795363482614,2553,1723,4276,-
chr8,67837686,1.51396711340366,2476,1548,4024,-
chr8,67837730,2.0835447319465583,879,656,1535,-
chr8,67837747,1.6628785074405863,1548,1038,2586,-
chr8,67837748,1.6435747255732684,6912,3810,10722,-
chr8,67837749,1.664003137702785,4180,2134,6314,-
chr8,67837751,2.3258410107133214,1210,708,1918,-
chr8,67837752,2.119790284486354,3000,1517,4517,-
chr8,67837774,0.7036342118176832,830,342,1172,-
chr8,67837775,0.7525406653922452,2821,1124,3945,-
chr8,67958152,0.8545516031959314,1383,1098,2481,-
chr8,67958154,0.4875044111513907,1047,853,1900,-
chr8,67968821,0.9477894479726428,912,711,1623,-
chr8,67968822,0.9477894479726428,912,711,1623,-
chr8,67971666,1.5388253619694017,8029,5121,13150,-
chr8,67971669,1.3521747607905454,9024,5866,14890,-
chr8,67974090,1.5366498437875509,3196,1824,5020,-
chr8,67974095,1.3206249753713992,2763,1537,4300,-
chr8,67974096,1.4064291247095277,2167,1290,3457,-
chr8,67974104,1.676592101834965,2144,1202,3346,-
chr8,67974118,1.6053296925566345,1796,926,2722,-
chr8,67974120,1.5879875793545426,6383,4295,10678,-
chr8,67974121,1.572318049903185,4789,2575,7364,-
chr8,67974134,1.1795118718614284,1804,1057,2861,-
chr8,67974137,0.5352785145888594,1008,579,1587,-
chr8,67974143,1.6653846001978514,4043,2799,6842,-
chr8,67974145,1.9250603956333272,3715,2623,6338,-
chr8,67974151,1.5878393537631796,5386,3418,8804,-
chr8,67974152,1.7360774818401934,1433,867,2300,-
chr8,67974153,1.5354181215096232,3953,2551,6504,-
chr8,67974182,1.8947182740548143,1043,633,1676,-
chr8,67974200,1.3868763328564038,813,466,1279,-
chr8,71485865,3.828308207705192,652,397,1049,-
chr8,71485866,3.215205869204784,913,816,1729,-
chr8,71485943,1.5066969624491748,585,451,1036,-
chr8,71486067,1.8102223774595412,675,408,1083,-
chr8,71486089,2.386014344262295,620,487,1107,-
chr8,71486090,2.386014344262295,620,487,1107,-
chr8,71486199,2.11231884057971,582,455,1037,-
chr8,71486344,1.547892596157265,2286,1619,3905,-
chr8,71486489,2.0580544560393426,745,396,1141,-
chr8,71486564,3.264691358024692,600,404,1004,-
chr8,71486655,2.4932330827067672,828,699,1527,-
chr8,71486657,2.4932330827067672,828,699,1527,-
chr8,71487238,1.5512697828487303,1027,714,1741,-
chr8,71499405,1.7572223694672675,662,538,1200,-
chr8,71508527,0.46003898635477586,707,512,1219,-
chr8,71508542,1.9843518518518521,738,539,1277,-
chr8,71510243,1.5996010969832957,801,572,1373,-
chr8,71510475,0.5334503180522044,895,678,1573,-
chr8,71520526,2.217125382262997,1536,653,2189,-
chr8,71520527,2.051927838916469,3131,1733,4864,-
chr8,71520528,1.9167437557816838,1595,1080,2675,-
chr8,71570058,3.406260130871334,836,626,1462,-
chr8,74203341,1.3569991018140228,13000,9086,22086,-
chr8,74203348,1.26431769424494,3285,1811,5096,-
chr8,74203349,1.3603347280334728,2158,1194,3352,-
chr8,74203361,1.3778498594450022,4975,2620,7595,-
chr8,74203362,1.6357142548073025,9321,6813,16134,-
chr8,74203363,1.627947042810664,11861,7553,19414,-
chr8,74203364,1.7886618332042845,6886,4933,11819,-
chr8,74203366,1.5197992471769135,1441,796,2237,-
chr8,74204059,1.3342942964965425,14710,8876,23586,-
chr8,74204082,1.1987246499740694,28355,19303,47658,-
chr8,74204501,1.24427285733767,31911,22276,54187,-
chr8,74204525,1.3811761658284336,5917,3221,9138,-
chr8,74204536,1.2829955935187567,20914,13153,34067,-
chr8,74204537,1.393717100840483,17415,9370,26785,-
chr8,74204538,1.2726516708727598,17465,11895,29360,-
chr8,74204990,1.2206319454264067,9384,6932,16316,-
chr8,74205023,1.210381377024932,5649,4075,9724,-
chr8,74205835,1.0237420473135495,16497,12103,28600,-
chr8,74205836,1.0237420473135495,16497,12103,28600,-
chr8,74205839,0.7425520522016337,3948,2867,6815,-
chr8,74205849,0.6618990384615385,5506,4419,9925,-
chr8,74205850,0.7410743039812628,7936,6480,14416,-
chr8,74205852,0.7957053913742053,5101,4233,9334,-
chr8,74205853,1.5588102465438485,5471,3225,8696,-
chr8,74205859,1.437109712452178,1402,1094,2496,-
chr8,74205862,1.4105989873576914,5799,3114,8913,-
chr8,74205863,1.2377519937429597,7302,4298,11600,-
chr8,74205866,0.9542993668533148,6117,4131,10248,-
chr8,74205867,0.9723525448705367,7100,4915,12015,-
chr8,74205868,1.0917594195209332,3194,2730,5924,-
chr8,74205869,1.0596980306141353,1377,1140,2517,-
chr8,74858910,1.5796387520525452,649,608,1257,-
chr8,74858911,0.4249482401656313,820,551,1371,-
chr8,74868168,2.1472905305070626,1283,949,2232,-
chr8,74868169,1.7481108312342568,693,396,1089,-
chr8,74868278,1.9909504938782763,820,582,1402,-
chr8,74868280,1.9909504938782763,820,582,1402,-
chr8,80831282,0.5547434743474348,1711,1099,2810,-
chr8,80831284,2.057530223866366,1892,2016,3908,-
chr8,80831289,1.443252058888521,6994,6299,13293,-
chr8,80831290,1.7662507245176782,4858,4644,9502,-
chr8,80831292,2.004434589800444,3123,2910,6033,-
chr8,80831295,0.6709327852772199,1133,812,1945,-
chr8,80831303,1.2796621383203952,2320,1743,4063,-
chr8,80831307,1.4923455056179773,1882,1423,3305,-
chr8,80831309,1.567168705145052,911,760,1671,-
chr8,80831312,1.3899104196133898,1473,1110,2583,-
chr8,80831331,0.4325904486251809,794,690,1484,-
chr8,80831337,1.5633998487253975,1802,1414,3216,-
chr8,80831338,1.6847596221626957,1194,819,2013,-
chr8,80949167,4.133504263873544,572,477,1049,-
chr8,80949546,0.3602666666666667,771,374,1145,-
chr8,80949555,0.4528116156023132,735,386,1121,-
chr8,80949572,0.3359280882216662,724,395,1119,-
chr8,80950001,1.7667405764966742,663,450,1113,-
chr8,80963770,2.599522998100822,600,412,1012,-
chr8,80965655,2.2123143839804578,824,614,1438,-
chr8,86126813,2.4717101080737445,647,428,1075,-
chr8,86126814,2.4717101080737445,647,428,1075,-
chr8,86126823,3.0243589743589743,673,389,1062,-
chr8,86126825,3.0243589743589743,673,389,1062,-
chr8,86129652,1.6002883402414847,959,715,1674,-
chr8,86132541,3.44378591954023,766,463,1229,-
chr8,86132543,2.1424682395644283,786,550,1336,-
chr8,86132560,1.9930889423076923,602,415,1017,-
chr8,86132583,0.8163584485916989,1552,840,2392,-
chr8,86132584,0.8737992890829103,1361,759,2120,-
chr8,86132585,0.9609057418699188,1148,575,1723,-
chr8,92081893,1.9665354330708662,702,507,1209,-
chr8,92081921,2.1745959196787163,692,502,1194,-
chr8,93898594,1.385185647685648,619,481,1100,-
chr8,93966668,2.4416144172405425,743,505,1248,-
chr8,97243246,4.524886877828054,999,730,1729,-
chr8,97243333,1.975160123844863,1877,1458,3335,-
chr8,97243709,3.138179713114506,1498,1029,2527,-
chr8,97247751,1.5430930930930933,716,665,1381,-
chr8,97247757,1.98549064528446,649,581,1230,-
chr8,97247759,1.6103575278476463,1614,919,2533,-
chr8,97247761,1.2213203259241443,3550,2381,5931,-
chr8,97247762,1.9363507779349365,1331,706,2037,-
chr8,97247763,1.5943747966869355,3747,2309,6056,-
chr8,97247764,1.6636170875927097,4037,2783,6820,-
chr8,97247765,1.6828070654027143,1644,1332,2976,-
chr8,97247770,1.1955924420303141,1203,911,2114,-
chr8,97247771,0.5721549165571936,1621,815,2436,-
chr8,97247772,0.690068738641091,2160,1250,3410,-
chr8,99054935,1.6503580869983177,9484,6934,16418,-
chr8,99054995,0.8700949555682104,8759,6761,15520,-
chr8,99057272,1.4083678226535372,6298,5389,11687,-
chr8,99057281,1.3702470176885306,22051,16867,38918,-
chr8,99057294,1.1860827250608272,8704,5753,14457,-
chr8,99057597,1.2163896240296574,7035,4321,11356,-
chr8,99057600,1.293209854305736,7216,6127,13343,-
chr8,99057749,1.4851047784035571,21184,12224,33408,-
chr8,99057750,1.5682122494593391,4795,3614,8409,-
chr8,99057751,1.7074211213892727,22545,11058,33603,-
chr8,99057752,1.8665441773693452,12541,5030,17571,-
chr8,99057753,2.0207996705002693,16459,6512,22971,-
chr8,99057755,2.220877902071256,11782,4439,16221,-
chr8,99057756,2.384729337695204,7726,2858,10584,-
chr8,99057762,2.2979244369786183,3458,1132,4590,-
chr8,99057765,2.2207193082283188,13181,5934,19115,-
chr8,99057766,2.5818500687076273,8970,3572,12542,-
chr8,99057767,1.723161492978566,2554,1639,4193,-
chr8,99057769,1.7962985449901743,13878,4752,18630,-
chr8,99057770,0.9707178788453392,15366,5258,20624,-
chr8,99057771,0.9842311345347888,23382,9108,32490,-
chr8,99057772,0.9438839695349941,17667,6943,24610,-
chr8,99057773,0.8164718127915838,5641,1473,7114,-
chr8,100899823,1.0029291714499171,6427,4988,11415,-
chr8,100899825,0.9293442017703986,9722,7146,16868,-
chr8,100899827,0.8230937514610125,4683,3361,8044,-
chr8,100899831,1.3859764705882354,2387,1874,4261,-
chr8,100899834,1.2678660945552924,8153,6014,14167,-
chr8,100904137,1.5509705028274492,1887,1453,3340,-
chr8,100904189,1.4303903530894184,6162,3748,9910,-
chr8,100904190,1.3428821850794943,4305,2452,6757,-
chr8,100904191,1.3428821850794943,4305,2452,6757,-
chr8,100905886,0.7291490662957607,1936,1483,3419,-
chr8,100905895,0.2744784528704126,720,596,1316,-
chr8,100905900,0.7896058394630044,1724,1381,3105,-
chr8,100905901,1.614050558495003,645,566,1211,-
chr8,100905902,0.4473075048732943,1048,863,1911,-
chr8,100905908,0.42076450249711866,673,547,1220,-
chr8,100905909,0.42076450249711866,673,547,1220,-
chr8,101715332,1.3171180151741708,2876,2314,5190,-
chr8,101715572,0.7271841267096142,3918,2747,6665,-
chr8,101716565,1.5644229607250757,2087,1654,3741,-
chr8,101716597,1.7001552102769015,2262,1705,3967,-
chr8,101717263,1.659330985915493,2261,1631,3892,-
chr8,101717858,1.2704018926933427,3947,2959,6906,-
chr8,101717870,2.030723058089484,1606,1100,2706,-
chr8,101717877,2.0633314054366685,1426,909,2335,-
chr8,101717883,2.101769911504425,1329,790,2119,-
chr8,101717889,1.1547911143350345,2445,1726,4171,-
chr8,101717895,1.4708287895310797,1078,916,1994,-
chr8,101718908,1.8287258366244024,995,848,1843,-
chr8,101719019,1.3978109940374093,2086,1589,3675,-
chr8,101721819,1.3716922272834084,3251,2503,5754,-
chr8,101721840,2.054676093137632,1425,1000,2425,-
chr8,101721843,2.104075691411936,1371,915,2286,-
chr8,101721864,1.8287949603739082,877,517,1394,-
chr8,101724927,1.425196551331232,3126,2562,5688,-
chr8,101725318,1.8427139240506327,2675,1874,4549,-
chr8,101725348,1.48490360990361,3065,2287,5352,-
chr8,101727702,0.7789792539889402,3191,2232,5423,-
chr8,101730101,1.4025613395225465,3147,2495,5642,-
chr8,101730434,1.5806890689084239,4253,3394,7647,-
chr8,101730458,1.4012505958878048,3784,2858,6642,-
chr8,101730473,0.6744848234455033,3050,2349,5399,-
chr8,101733639,1.7318744473916887,1566,1217,2783,-
chr8,101733674,1.6098486713204094,2794,2160,4954,-
chr8,101733675,1.517283434940965,5216,4119,9335,-
chr8,101733677,1.7072100313479623,2722,2089,4811,-
chr8,101733719,4.400592672413794,1187,927,2114,-
chr8,101733722,0.9973146881491614,1553,1376,2929,-
chr8,101733723,0.9973146881491614,1553,1376,2929,-
chr8,101733731,2.534263392857143,840,447,1287,-
chr8,101733758,2.431346153846154,1344,649,1993,-
chr8,101733759,2.431346153846154,1344,649,1993,-
chr8,101733761,1.9329334787350052,708,523,1231,-
chr8,101733770,1.8180137791967736,697,540,1237,-
chr8,101733808,0.9225052540956626,1234,1081,2315,-
chr8,101733809,0.9225052540956626,1234,1081,2315,-
chr8,101733810,1.2171531629912065,1781,1431,3212,-
chr8,101733812,1.8559299781181624,588,456,1044,-
chr8,101733857,2.0407094172284364,619,454,1073,-
chr8,101733953,1.9773210489014883,629,580,1209,-
chr8,101733985,2.601558903139125,1873,1329,3202,-
chr8,101733986,2.994432846207377,1323,957,2280,-
chr8,101734062,1.8273248289887225,705,600,1305,-
chr8,101734065,1.761576354679803,744,608,1352,-
chr8,101734068,1.8604352364891996,723,592,1315,-
chr8,101734072,1.6181521430598922,690,541,1231,-
chr8,101734073,1.896875,606,399,1005,-
chr8,101734240,1.5306182613955788,2099,1553,3652,-
chr8,101734260,1.624755700325733,811,613,1424,-
chr8,101734267,1.959140911471975,679,497,1176,-
chr8,101734289,0.6816211071165822,1314,993,2307,-
chr8,101734290,0.8258803052617486,948,678,1626,-
chr8,101734297,1.2964262508122155,687,341,1028,-
chr8,101734299,1.2964262508122155,687,341,1028,-
chr8,101734305,1.9195854958589003,636,467,1103,-
chr8,101931105,1.8312943410982627,885,662,1547,-
chr8,101931123,2.5018141836173724,733,534,1267,-
chr8,101931195,2.332620528771384,922,642,1564,-
chr8,101931197,2.332620528771384,922,642,1564,-
chr8,101931611,1.7249298849679235,1203,862,2065,-
chr8,101931755,1.8040792540792543,672,428,1100,-
chr8,101932018,1.8383838383838385,769,494,1263,-
chr8,101932024,1.892146017699115,932,677,1609,-
chr8,101932047,0.9325312322544008,1050,586,1636,-
chr8,101932048,1.2399442146857411,1397,818,2215,-
chr8,101932220,0.9406099518459068,1171,889,2060,-
chr8,101932221,0.9406099518459068,1171,889,2060,-
chr8,101932225,1.6384076856252239,942,592,1534,-
chr8,101932272,1.882407407407408,855,539,1394,-
chr8,101932430,1.6040868454661557,1098,608,1706,-
chr8,101932443,2.2113740959894805,1084,584,1668,-
chr8,101932446,1.5632535885167462,1020,549,1569,-
chr8,101932449,0.5703106654116787,1666,1297,2963,-
chr8,101932629,0.6599131693198264,797,690,1487,-
chr8,101932710,1.460438829787234,763,511,1274,-
chr8,101932726,1.551056338028169,880,567,1447,-
chr8,101932728,1.8104993597951349,706,425,1131,-
chr8,101932875,1.8139298149742518,1825,1497,3322,-
chr8,101932877,1.8956618156618157,1102,974,2076,-
chr8,101932881,2.5742976149781107,1510,961,2471,-
chr8,101932882,2.442708438669228,1666,1118,2784,-
chr8,101932922,3.797570850202429,669,493,1162,-
chr8,101932923,3.1702027345591697,983,706,1689,-
chr8,101932925,2.7668759594989356,1090,695,1785,-
chr8,101936399,1.7660818713450293,603,436,1039,-
chr8,101937187,4.134146341463414,677,491,1168,-
chr8,101937190,2.0922253881490955,1027,592,1619,-
chr8,101960887,2.223913043478261,557,459,1016,-
chr8,101960896,2.0662057172595816,1792,1097,2889,-
chr8,101960897,1.9781409873403881,2981,2010,4991,-
chr8,101960968,1.6673101898978553,949,918,1867,-
chr8,101960972,0.5850285769640609,1420,1115,2535,-
chr8,101960973,0.5850285769640609,1420,1115,2535,-
chr8,101960995,3.138682672563576,640,486,1126,-
chr8,101961011,2.1099387947142905,1231,973,2204,-
chr8,101961012,2.170673076923077,902,688,1590,-
chr8,103661312,34.40376430371579,1276,1119,2395,-
chr8,103661313,38.01063300919178,1001,881,1882,-
chr8,103662427,1.7312918562918567,690,454,1144,-
chr8,103839708,26.810598332284684,668,465,1133,-
chr8,103851036,1.1414864096798587,607,451,1058,-
chr8,103851141,0.928803842578246,630,460,1090,-
chr8,103851142,0.928803842578246,630,460,1090,-
chr8,103855788,1.856775052434598,2548,1965,4513,-
chr8,103855790,1.845251198412412,4904,3666,8570,-
chr8,103855791,1.802968489058139,3606,2641,6247,-
chr8,103855792,1.802968489058139,3606,2641,6247,-
chr8,103855820,2.183757673342055,774,522,1296,-
chr8,103855828,2.279519450800916,686,436,1122,-
chr8,103855832,2.612836438923396,630,482,1112,-
chr8,103876074,0.9346056240810876,550,461,1011,-
chr8,103876075,1.3390821968888553,606,455,1061,-
chr8,104413856,2.4287300485773766,920,654,1574,-
chr8,104413858,2.4287300485773766,920,654,1574,-
chr8,106799703,6.126616096689941,638,441,1079,-
chr8,109228663,0.8200934579439252,4523,3637,8160,-
chr8,109240506,1.7870047371982856,4975,3874,8849,-
chr8,109254111,1.2416536931326758,6141,3853,9994,-
chr8,109260910,1.4146955254928972,10011,7063,17074,-
chr8,109260913,1.5857976691423143,3956,2225,6181,-
chr8,109260917,1.6940566183276766,2462,1851,4313,-
chr8,109260923,1.5784963606654785,3177,1682,4859,-
chr8,109260932,1.7055994320702812,5338,2654,7992,-
chr8,109260933,1.692856669127351,6826,3791,10617,-
chr8,109260938,1.6924019290662662,4745,2186,6931,-
chr8,109260940,1.6924019290662662,4745,2186,6931,-
chr8,109260943,1.1047989437905779,13628,7200,20828,-
chr8,109260944,1.0317349855522149,14632,7696,22328,-
chr8,109260945,0.8963154336545928,10110,5312,15422,-
chr8,109260946,1.1342366868050775,3480,1982,5462,-
chr8,109260951,0.691638358204191,1139,921,2060,-
chr8,109260952,0.6561191179561461,1331,1049,2380,-
chr8,109260953,0.3170675830469645,518,484,1002,-
chr8,109260957,0.7171679573952223,650,470,1120,-
chr8,110255203,2.3203481735159817,706,437,1143,-
chr8,110255339,0.34886366338013003,675,530,1205,-
chr8,110257658,0.9889518022372601,650,556,1206,-
chr8,110257659,0.9889518022372601,650,556,1206,-
chr8,110283353,0.49006901195084995,646,456,1102,-
chr8,110301987,2.017635658914729,717,429,1146,-
chr8,110308636,2.4229880504390304,748,560,1308,-
chr8,110308637,2.4229880504390304,748,560,1308,-
chr8,110308668,0.4036583030070869,842,680,1522,-
chr8,110308669,0.4036583030070869,842,680,1522,-
chr8,117657335,1.3977752958222651,2502,1967,4469,-
chr8,117657337,1.5227315429555732,5695,3830,9525,-
chr8,117657338,1.5227315429555732,5695,3830,9525,-
chr8,117658794,1.7815654190959815,1600,1226,2826,-
chr8,117661143,1.2556686652111684,7546,5563,13109,-
chr8,117668231,1.3249486652977414,6814,4869,11683,-
chr8,117668238,0.8023780121530241,6483,4603,11086,-
chr8,117669545,1.6186002670646455,4535,3072,7607,-
chr8,117671093,1.6568572031534994,3162,2456,5618,-
chr8,117671146,1.423824482273034,5989,4058,10047,-
chr8,117738372,1.7406133565845834,11474,7457,18931,-
chr8,117738381,1.4289128707048888,9260,5756,15016,-
chr8,117738397,0.9240252227028665,17578,10315,27893,-
chr8,117767917,1.098678179370924,7837,5061,12898,-
chr8,117767938,0.6328064283097613,2431,1748,4179,-
chr8,117767939,1.2213202671409875,6317,4149,10466,-
chr8,117767940,1.2213202671409875,6317,4149,10466,-
chr8,117767941,0.6704935495324891,2574,1784,4358,-
chr8,117767953,1.475432400057253,3930,2686,6616,-
chr8,117768005,1.6099770207766502,4832,3504,8336,-
chr8,117768039,0.4148851318223904,1264,1129,2393,-
chr8,117768041,1.5770833333333334,756,469,1225,-
chr8,117768048,2.309312471791786,613,390,1003,-
chr8,117768051,1.8066227418955705,1516,897,2413,-
chr8,117768052,1.8066227418955705,1516,897,2413,-
chr8,117768053,1.9458361011598992,2356,1491,3847,-
chr8,117768055,1.1472960397063383,568,508,1076,-
chr8,117768056,0.6989092727888365,765,677,1442,-
chr8,117858534,2.8251121076233185,944,668,1612,-
chr8,117858680,2.8914682539682546,1120,1007,2127,-
chr8,117858723,1.5100962189998643,1012,627,1639,-
chr8,117858738,0.9789010315487428,1914,1222,3136,-
chr8,117858745,1.725327812284334,749,566,1315,-
chr8,117859240,1.631298162418494,1151,722,1873,-
chr8,117859478,1.9194803288314737,1515,1047,2562,-
chr8,117859525,1.7501770322076524,1174,802,1976,-
chr8,117859568,2.293563218390805,906,724,1630,-
chr8,117859642,0.7115559599636033,1529,1098,2627,-
chr8,117859693,1.5845410628019325,983,620,1603,-
chr8,117859899,1.4563684667654422,1212,850,2062,-
chr8,117861218,1.638655462184874,1349,1019,2368,-
chr8,117862874,2.3218273127853752,17657,13189,30846,-
chr8,117862875,2.241941513978914,26171,19302,45473,-
chr8,117862877,2.234120225199544,25640,18416,44056,-
chr8,117862878,2.2162182327815314,16848,11926,28774,-
chr8,117862935,1.2884997906197655,3245,1790,5035,-
chr8,117862970,1.39193689745837,2646,1629,4275,-
chr8,117862973,2.0287805163297463,3771,2207,5978,-
chr8,117868973,1.8802681992337165,754,521,1275,-
chr8,117869634,1.4009489210352353,11502,7411,18913,-
chr8,117869641,1.473444734181257,3986,2450,6436,-
chr8,117869644,1.3888720130624195,18079,10706,28785,-
chr8,117869645,1.3601945870776366,23847,15292,39139,-
chr8,117869648,1.6845891505281954,6387,3612,9999,-
chr8,117869649,1.630979103864504,11176,6328,17504,-
chr8,117869660,1.290769015268245,4387,2419,6806,-
chr8,117869687,1.1468224592982272,5907,3779,9686,-
chr8,117869695,2.277420578260668,3783,2360,6143,-
chr8,117869710,1.4808921701742477,2434,1472,3906,-
chr8,117874081,1.6122301611432046,1437,1011,2448,-
chr8,117874156,1.5544692737430168,1112,715,1827,-
chr8,117875385,2.081446191558255,5707,3748,9455,-
chr8,117875386,2.081446191558255,5707,3748,9455,-
chr8,117875442,1.4641763764100024,5256,3202,8458,-
chr8,117875457,0.4534033805390589,1984,1193,3177,-
chr8,117875493,1.376403088582255,1350,787,2137,-
chr8,117878841,1.73724796604174,1753,1027,2780,-
chr8,117878863,0.3837716995003676,1420,912,2332,-
chr8,117878891,2.2916666666666665,923,671,1594,-
chr8,117878894,1.7427404718693285,834,579,1413,-
chr8,117878960,1.3090515363850606,1189,820,2009,-
chr8,117886854,1.973641304347826,806,459,1265,-
chr8,117886856,1.973641304347826,806,459,1265,-
chr8,117887010,1.1595347990111802,919,779,1698,-
chr8,118811905,12.630804511858557,910,1219,2129,-
chr8,118811906,11.760222452171824,1767,1690,3457,-
chr8,118811907,11.760222452171826,1767,1690,3457,-
chr8,118811908,16.99298510146185,1458,1218,2676,-
chr8,118811917,4.5753357218401325,774,295,1069,-
chr8,118811919,3.380630920023062,802,263,1065,-
chr8,120859254,3.44474686989657,677,500,1177,-
chr8,120859255,3.44474686989657,677,500,1177,-
chr8,120865386,1.9077615298087738,847,507,1354,-
chr8,120865391,2.152222944302152,1125,706,1831,-
chr8,120865392,1.711901081916538,922,646,1568,-
chr8,120865393,2.152222944302152,1125,706,1831,-
chr8,120865448,0.6637326223204632,625,464,1089,-
chr8,121426279,1.3888409752731925,1710,1470,3180,-
chr8,121455505,1.7816129032258063,1577,1239,2816,-
chr8,121455506,1.7816129032258063,1577,1239,2816,-
chr8,121457327,0.5992661461789531,2164,1410,3574,-
chr8,121457335,0.9825193045620352,2073,1253,3326,-
chr8,121457336,0.8463686937498873,2696,1740,4436,-
chr8,121457337,0.5898305084745763,956,766,1722,-
chr8,121706038,2.626980886867813,1351,905,2256,-
chr8,121706039,3.178839320963285,731,446,1177,-
chr8,124026345,2.6356609808102345,898,535,1433,-
chr8,124026347,2.5832294394362436,1240,799,2039,-
chr8,124026641,1.7746088334323624,639,373,1012,-
chr8,124026650,2.272227066474801,1158,765,1923,-
chr8,124026651,0.4393923465096719,642,463,1105,-
chr8,124026653,2.980657640232109,602,422,1024,-
chr8,124026720,3.332423001062054,645,506,1151,-
chr8,124026721,3.332423001062054,645,506,1151,-
chr8,124026951,3.808495174340948,618,475,1093,-
chr8,124042927,1.4846956435741483,1200,962,2162,-
chr8,124042928,1.203611294524377,1800,1334,3134,-
chr8,124042929,1.4846956435741483,1200,962,2162,-
chr8,124042944,3.1284854245880864,636,525,1161,-
chr8,124042945,3.1284854245880864,636,525,1161,-
chr8,124054221,0.4979806150440342,663,527,1190,-
chr8,124054354,2.7697382153742103,652,476,1128,-
chr8,124243969,2.7840891616505417,670,517,1187,-
chr8,124332849,2.459540425076093,716,608,1324,-
chr8,124333159,2.0842166569598137,616,504,1120,-
chr8,124333290,1.9473684210526316,665,512,1177,-
chr8,124340442,0.46875,602,401,1003,-
chr8,124340620,2.793833952897317,1208,868,2076,-
chr8,124340707,2.0027196223316914,2517,1855,4372,-
chr8,124340725,1.5258704328583024,3555,2220,5775,-
chr8,124340751,1.7237048665620096,1280,685,1965,-
chr8,124340756,1.965688632355299,1225,755,1980,-
chr8,124340795,1.692492603550296,677,415,1092,-
chr8,124346162,2.228131749460043,1178,925,2103,-
chr8,124346163,2.228131749460043,1178,925,2103,-
chr8,124346230,2.4214120301644795,1772,1530,3302,-
chr8,124346231,2.4214120301644795,1772,1530,3302,-
chr8,124346447,1.930614783226724,700,535,1235,-
chr8,124346487,3.079245283018868,863,635,1498,-
chr8,124346494,2.063828447159446,1315,984,2299,-
chr8,124346504,0.4671926364234056,645,389,1034,-
chr8,124348751,2.12087772704211,726,437,1163,-
chr8,124350013,2.2670200892857144,974,767,1741,-
chr8,124350014,2.2670200892857144,974,767,1741,-
chr8,124358357,3.109360660752524,700,466,1166,-
chr8,124358358,3.109360660752524,700,466,1166,-
chr8,124358385,2.962283044058745,709,427,1136,-
chr8,124358386,2.962283044058745,709,427,1136,-
chr8,124359400,1.5325493482118024,702,558,1260,-
chr8,124361529,2.126558595498711,731,609,1340,-
chr8,124369848,2.6220459869897876,1409,1072,2481,-
chr8,124373785,0.5557066096976759,1072,541,1613,-
chr8,124373794,1.1037137699295863,1454,1010,2464,-
chr8,124373817,1.8028503562945368,659,420,1079,-
chr8,124373831,2.094984326782623,1089,729,1818,-
chr8,124373834,1.919694626981059,684,397,1081,-
chr8,124373866,1.7928511117365606,636,373,1009,-
chr8,124382103,2.477432432432433,678,369,1047,-
chr8,124382173,2.7419354838709675,674,557,1231,-
chr8,124382175,2.7419354838709675,674,557,1231,-
chr8,124392806,1.8021836637490227,1507,1107,2614,-
chr8,125324354,13.782152760587548,574,960,1534,-
chr8,125324355,13.550543706108845,916,1496,2412,-
chr8,125324356,15.281560099508575,689,811,1500,-
chr8,125520884,1.2564208252199498,3273,1747,5020,-
chr8,125520922,1.9324644633797767,4324,2627,6951,-
chr8,125531091,1.5135094110503946,766,548,1314,-
chr8,125535179,0.5367156208277704,803,534,1337,-
chr8,125535242,2.5774334305508555,778,470,1248,-
chr8,125551305,2.26644288114852,1075,676,1751,-
chr8,125551306,2.26644288114852,1075,676,1751,-
chr8,126036765,4.485913750802433,1130,744,1874,-
chr8,128192041,0.4730769230769231,614,519,1133,-
chr8,128192066,2.066742081447964,608,441,1049,-
chr8,128192068,1.8970423178883458,963,794,1757,-
chr8,128217348,3.0769945924922566,721,631,1352,-
chr8,128217511,1.1055464439609635,950,699,1649,-
chr8,128217719,1.073603347883385,861,660,1521,-
chr8,128218590,0.6010733452593917,671,515,1186,-
chr8,128218744,4.768762564382664,2154,1362,3516,-
chr8,128218963,1.3766696229406865,3865,2825,6690,-
chr8,128218965,2.022816303340212,7334,5651,12985,-
chr8,128218966,2.022816303340212,7334,5651,12985,-
chr8,128218970,1.5868241439002861,6499,4698,11197,-
chr8,128218984,1.3717227442080069,5994,4514,10508,-
chr8,128218987,1.6304420041604246,5141,3888,9029,-
chr8,128218990,2.0079035497881565,4474,2860,7334,-
chr8,128218999,1.7470236311337628,4258,2626,6884,-
chr8,128219021,2.163006251047829,1703,970,2673,-
chr8,128219023,2.878048780487805,1997,1106,3103,-
chr8,128219026,1.8730754200859707,1562,852,2414,-
chr8,128219032,1.3116651498643945,7098,4367,11465,-
chr8,128219033,1.3116651498643945,7098,4367,11465,-
chr8,128219037,2.7000568343279343,1838,1172,3010,-
chr8,128219086,1.8377584216601952,1193,732,1925,-
chr8,128219130,3.160676532769556,649,429,1078,-
chr8,128219498,2.1197398921777535,579,555,1134,-
chr8,128219531,2.084261902482829,641,527,1168,-
chr8,128219637,0.924512839191404,922,577,1499,-
chr8,128219638,0.924512839191404,922,577,1499,-
chr8,128219695,1.6976343196082488,793,536,1329,-
chr8,128219719,1.7924324324324328,828,628,1456,-
chr8,128219769,0.5574502276582447,1337,973,2310,-
chr8,128219818,1.8470145991782496,1111,737,1848,-
chr8,128219832,1.6083990689253846,1156,813,1969,-
chr8,128219859,1.9097744360902256,1269,769,2038,-
chr8,128219966,2.08316041500399,1262,1073,2335,-
chr8,128220115,2.0969011313330053,734,534,1268,-
chr8,128220161,0.5581120943952802,730,564,1294,-
chr8,128220210,2.1216931216931214,801,449,1250,-
chr8,128220322,1.7888207822533568,720,570,1290,-
chr8,128220342,1.879223469040774,1146,788,1934,-
chr8,128220343,1.879223469040774,1146,788,1934,-
chr8,128220434,1.7162516382699868,872,762,1634,-
chr8,128220485,1.3391057120703025,941,741,1682,-
chr8,128220534,1.9867809698318173,1264,825,2089,-
chr8,128220535,1.9867809698318173,1264,825,2089,-
chr8,128220580,1.8988294314381273,756,467,1223,-
chr8,128220616,2.3692301755608365,1134,790,1924,-
chr8,128220636,1.220327395676686,1040,627,1667,-
chr8,128220808,1.9184067469389827,943,728,1671,-
chr8,128220960,1.9213649851632049,874,673,1547,-
chr8,128221116,2.0753570583129486,796,550,1346,-
chr8,128221118,2.2507088846880907,634,528,1162,-
chr8,128221128,1.7608517608517609,687,443,1130,-
chr8,128221132,1.1723813664880314,1254,941,2195,-
chr8,128221319,1.059750287722796,1296,1047,2343,-
chr8,128221322,0.6688130642591609,805,537,1342,-
chr8,128221325,0.4857749469214437,571,470,1041,-
chr8,128221328,2.392747805345334,1068,896,1964,-
chr8,128221475,1.6613333333333336,622,499,1121,-
chr8,128221579,1.713254013612511,1318,1012,2330,-
chr8,128221711,1.816266666666667,972,624,1596,-
chr8,128221740,1.631649688737974,658,588,1246,-
chr8,128221768,2.5625052087673974,1254,922,2176,-
chr8,128221769,2.5625052087673974,1254,922,2176,-
chr8,128221777,1.215976573245813,962,695,1657,-
chr8,128221798,1.760955580169997,654,437,1091,-
chr8,128221952,1.6548769771528995,728,568,1296,-
chr8,128231123,1.7660735269430925,1190,965,2155,-
chr8,128231175,0.5255403348554034,995,674,1669,-
chr8,128231185,1.4901248873438906,1180,862,2042,-
chr8,128231187,0.6750210970464134,841,789,1630,-
chr8,128231188,1.0338895558223289,1212,979,2191,-
chr8,128231189,1.0338895558223289,1212,979,2191,-
chr8,128231190,1.4816438356164383,675,656,1331,-
chr8,128231228,2.461034482758621,792,434,1226,-
chr8,128231229,2.461034482758621,792,434,1226,-
chr8,128241148,0.9051618518578842,52010,40422,92432,-
chr8,128241206,1.3641875332398923,119948,99247,219195,-
chr8,128241208,1.6055418243139117,128750,105284,234034,-
chr8,128241209,1.4079562080139003,123082,98521,221603,-
chr8,128241340,1.1775711507471778,9571,7868,17439,-
chr8,128241341,0.8979337334323324,11099,7924,19023,-
chr8,128241360,1.360286239597445,13336,10333,23669,-
chr8,128241362,1.360286239597445,13336,10333,23669,-
chr8,128241369,1.2916687128993438,11529,8348,19877,-
chr8,128241447,1.3400076234893157,3621,3030,6651,-
chr8,128241474,1.3395298008304672,6879,4687,11566,-
chr8,128241499,1.4786005868095422,1305,1205,2510,-
chr8,128241517,1.0446291965592416,3874,3047,6921,-
chr8,128241518,0.9641583749963166,2453,1668,4121,-
chr8,128241519,1.1630650021523892,1421,1379,2800,-
chr8,128241520,1.4964534547375306,1468,957,2425,-
chr8,128241521,1.5003518648838847,935,608,1543,-
chr8,128241528,0.3938484621155289,909,558,1467,-
chr8,128241532,0.4839325485205217,701,448,1149,-
chr8,128241533,1.0585871404399323,909,590,1499,-
chr8,128241534,1.0585871404399323,909,590,1499,-
chr8,128241535,1.2994600373998577,811,632,1443,-
chr8,130854018,2.56324415054235,720,548,1268,-
chr8,130854175,1.154174489899967,778,609,1387,-
chr8,130864427,2.3451678273841323,1836,1226,3062,-
chr8,130864446,0.6422535211267606,911,567,1478,-
chr8,130864488,1.9505766062602963,850,606,1456,-
chr8,130867935,3.131170906547775,731,633,1364,-
chr8,130874529,2.2438218731427866,780,577,1357,-
chr8,131140317,2.683299457163239,1552,1036,2588,-
chr8,131140318,3.316866933689364,1027,748,1775,-
chr8,131140319,2.683299457163239,1552,1036,2588,-
chr8,131199525,0.3342495037410292,596,530,1126,-
chr8,134250152,4.948463913620105,578,971,1549,-
chr8,134250153,7.5293238892310415,1124,1709,2833,-
chr8,134250154,8.824379332417665,992,1552,2544,-
chr8,134250584,4.027374895455975,827,739,1566,-
chr8,134250585,3.7985591314499043,987,905,1892,-
chr8,134250595,3.885967404981811,1060,854,1914,-
chr8,134250596,2.8281788631034206,689,556,1245,-
chr8,134250881,1.7082919130303489,709,541,1250,-
chr8,141668730,1.2780454384587445,672,467,1139,-
chr8,144661962,0.6260454846544491,2147,1940,4087,-
chr8,144662203,1.762980248917749,2686,1919,4605,-
chr8,144662257,1.2725402753614732,6587,4313,10900,-
chr8,144662294,1.260649909224518,3561,2151,5712,-
chr8,144662329,1.5085488126649076,2198,1515,3713,-
chr8,144662330,1.6916278755987315,2359,1646,4005,-
chr8,144662724,1.32133891650307,5996,3559,9555,-
chr8,144662725,1.3245600482711382,7742,4968,12710,-
chr8,144662859,1.4606137387387388,1788,1439,3227,-
chr8,144662860,1.091129054311841,4598,3214,7812,-
chr8,144662887,1.6167912960446635,4284,2778,7062,-
chr8,144662893,0.7680760047335694,4919,2686,7605,-
chr8,144662895,0.651495485312392,7742,4856,12598,-
chr8,144663232,1.7509025270758125,1357,1107,2464,-
chr8,144663263,1.87108550567566,1490,1118,2608,-
chr8,144663266,1.558864638210945,1431,1047,2478,-
chr8,144663418,1.4439431510309042,1722,1427,3149,-
chr8,144663438,1.0084360840305822,4302,2937,7239,-
chr8,144663462,0.6433460819679256,1376,1210,2586,-
chr8,144668938,1.4846391448675391,2363,1902,4265,-
chr8,144669008,1.2844518997357952,7922,5507,13429,-
chr8,144669009,1.1051548127340505,7467,5557,13024,-
chr8,144669016,1.5845007451564828,1771,1374,3145,-
chr8,144669017,0.6046439628482972,1889,1614,3503,-
chr8,144669019,1.418409205273575,4177,2292,6469,-
chr8,144669020,1.418409205273575,4177,2292,6469,-
chr8,144679571,1.4486473475758748,3337,1930,5267,-
chr8,144679572,1.2878298868437106,4942,3417,8359,-
chr8,144679573,1.4661775224992208,5031,3053,8084,-
chr8,144679575,1.8945400251581308,5536,2744,8280,-
chr8,144679577,2.0817734956922105,8326,3891,12217,-
chr8,144679578,1.6862582219093516,4311,2486,6797,-
chr8,144679579,1.5245098868162217,7902,3578,11480,-
chr8,144679581,0.7411934207657082,3537,1365,4902,-
chr8,144679582,0.6341484339053927,2886,1163,4049,-
chr8,144898822,0.6058052434456929,646,533,1179,-
chr8,144898840,0.49822284036470404,805,718,1523,-
chr8,144898867,2.1200760723437613,1511,1160,2671,-
chr8,144898967,1.9255437693191442,1211,845,2056,-
chr8,144898985,1.1991281826154414,841,698,1539,-
chr8,144899532,4.2105263157894735,719,341,1060,-
chr8,144899534,4.2105263157894735,719,341,1060,-
chr8,144899583,1.743646140289806,878,488,1366,-
chr8,144899585,1.5884125595411682,859,380,1239,-
chr8,144899927,1.4366333198462538,832,598,1430,-
chr8,144899943,1.2760285710470285,1094,741,1835,-
chr8,144900144,1.730403468288931,1150,680,1830,-
chr8,144900147,1.591637630662021,1141,664,1805,-
chr8,144900150,0.7525714285714287,877,629,1506,-
chr8,144900162,1.3896899783705838,1027,583,1610,-
chr8,144900204,1.8291936978683967,730,414,1144,-
chr8,144903852,1.70139870794643,1000,656,1656,-
chr8,144904067,0.3150097465886939,605,404,1009,-
chr8,144906503,2.95882908313638,978,1064,2042,-
chr8,144906504,3.2982386366360705,1092,1074,2166,-
chr8,144993328,2.435660736094636,1791,1307,3098,-
chr8,144993330,2.4123503102005484,879,716,1595,-
chr8,144993349,1.8709532579274066,687,508,1195,-
chr8,144993358,0.8176838478734414,811,527,1338,-
chr8,144993360,1.5481171548117154,739,477,1216,-
chr8,145006580,5.476635514018691,585,427,1012,-
chr8,145006582,2.8267973856209156,864,611,1475,-
chr8,145618724,1.836190476190476,481,524,1005,-
chr8,145618727,1.762527743444042,993,899,1892,-
chr8,145655890,2.1235232812100433,822,571,1393,-
chr8,145678792,1.68289156626506,581,497,1078,-
chr8,145678799,0.6310007524454477,598,442,1040,-
chr8,145678823,2.970509695128465,694,447,1141,-
chr8,146015281,1.238747560171608,12303,7091,19394,-
chr8,146015742,1.2342616914656055,23445,15498,38943,-
chr8,146015743,1.136542952930414,10669,8116,18785,-
chr8,146015815,1.1953546974139637,31224,23863,55087,-
chr8,146015833,1.2268129932623588,17215,13536,30751,-
chr8,146016730,1.225237592177267,22301,15246,37547,-
chr8,146016765,1.645485394542067,10892,6560,17452,-
chr8,146017162,1.404691530551175,16552,12609,29161,-
chr8,146017163,1.2772618496030066,36947,27425,64372,-
chr8,146017228,1.0754463808559545,25146,19836,44982,-
chr8,146017229,1.0149948044950738,16711,12991,29702,-
chr8,146017232,1.3062736387845069,15973,10955,26928,-
chr8,146017239,1.2533864541832669,6213,4779,10992,-
chr8,146017294,1.2496702888604452,32735,25384,58119,-
chr8,146017295,1.291534616214565,11562,9498,21060,-
chr8,146017299,0.759877418020237,722,657,1379,-
chr8,146017378,0.8186279855554124,10918,8891,19809,-
chr8,146017395,1.3380879210508432,10108,8233,18341,-
chr8,146017416,1.5347489926010984,22041,12061,34102,-
chr8,146017417,1.5347489926010984,22041,12061,34102,-
chr8,146017418,1.5216593021311087,27485,16280,43765,-
chr8,146017503,1.465393620442499,29398,20420,49818,-
chr8,146017756,1.5880151494197232,12541,8164,20705,-
chr8,146017770,0.8681048563132421,10736,6557,17293,-
chr8,146017773,0.9208465140512149,21818,14657,36475,-
chr8,146017774,0.9853258356269546,13584,9744,23328,-
chr8,146017775,0.9000519491405781,5555,3907,9462,-
chr8,146017776,1.3100605158544378,7623,5454,13077,-
chr8,146017779,1.5114861697140178,1559,809,2368,-
chr8,146017781,0.5631909833340112,2149,1400,3549,-
chr8,146017800,1.298454054534009,3076,1848,4924,-
chr8,146017803,0.8125836801700768,5905,3475,9380,-
chr8,146017804,0.6759249101958641,5384,3106,8490,-
chr8,146017805,0.6759249101958641,5384,3106,8490,-
chr9,2811408,1.9592592765659096,644,612,1256,-
chr9,2811418,2.2066974933364745,936,826,1762,-
chr9,2812274,3.413190244760627,1783,1228,3011,-
chr9,2812275,2.7490688165786787,3037,1936,4973,-
chr9,2812280,1.8323901200613526,844,510,1354,-
chr9,2812332,2.656532656635783,1044,550,1594,-
chr9,2812343,1.9238529124633907,738,438,1176,-
chr9,2812352,2.72437907251883,1066,645,1711,-
chr9,2831015,1.3423280443839507,600,438,1038,-
chr9,2838467,1.7275152156308835,540,485,1025,-
chr9,4712241,3.23895719014115,834,455,1289,-
chr9,4712502,3.063815939308741,698,444,1142,-
chr9,4712503,3.160572167690859,783,474,1257,-
chr9,4712777,2.0604612450271196,769,492,1261,-
chr9,4719293,1.8282828282828285,542,461,1003,-
chr9,7798429,0.6026420293378718,675,456,1131,-
chr9,7798552,0.5472547254725472,607,504,1111,-
chr9,7798599,2.6678391076559067,755,603,1358,-
chr9,7799531,6.969826847381191,742,550,1292,-
chr9,7799540,3.587430621972366,891,424,1315,-
chr9,7799544,21.159174610669975,1036,424,1460,-
chr9,7799545,15.287424859834692,1181,399,1580,-
chr9,7799547,35.70657276995305,1112,212,1324,-
chr9,7799548,24.715678385876195,1200,267,1467,-
chr9,7799549,24.715678385876195,1200,267,1467,-
chr9,7799552,21.081690040855406,861,190,1051,-
chr9,15464470,4.364023313431843,602,517,1119,-
chr9,15468724,1.8893453145057766,668,614,1282,-
chr9,15469960,1.5298140436967802,619,472,1091,-
chr9,15472729,1.360772727846966,4009,2543,6552,-
chr9,15474011,1.646953405017921,918,557,1475,-
chr9,15474018,2.296731173443502,931,656,1587,-
chr9,15474019,1.620258064516129,865,499,1364,-
chr9,19102598,1.1953061246997347,2361,1590,3951,-
chr9,19102599,1.4967370698036164,1746,1183,2929,-
chr9,19102600,0.3314203730272597,615,407,1022,-
chr9,19102613,1.8701340655790661,826,452,1278,-
chr9,19102614,1.8701340655790661,826,452,1278,-
chr9,19376307,1.730699755799986,64177,63111,127288,-
chr9,19376360,1.3203070705945668,95770,81776,177546,-
chr9,19376499,1.3808043404501067,49101,40158,89259,-
chr9,19376622,1.4649550792171482,14315,10729,25044,-
chr9,19378773,0.9005687325618429,20736,15190,35926,-
chr9,19378774,1.1635860192568854,15815,9897,25712,-
chr9,19378780,1.2257536243303737,32506,21824,54330,-
chr9,19378781,1.3011021887721206,18514,13192,31706,-
chr9,19378784,0.8417409739206835,14024,10950,24974,-
chr9,19379539,1.963658214306232,17276,13702,30978,-
chr9,19379584,1.222672612594727,23875,14800,38675,-
chr9,19379605,1.5849442915482954,10424,5279,15703,-
chr9,19380195,1.3512447964687193,17427,12077,29504,-
chr9,19380230,1.2209555581928058,20906,10729,31635,-
chr9,19380231,0.6163131952812309,19210,8419,27629,-
chr9,19380233,0.7356453730503933,35113,22212,57325,-
chr9,19380234,0.8371425156196941,18025,14382,32407,-
chr9,19380236,0.9501746799861364,4509,4205,8714,-
chr9,21968142,1.733099631748813,3866,2772,6638,-
chr9,21968226,1.3289821172564704,1956,1370,3326,-
chr9,21968238,0.4901659714209638,1346,1185,2531,-
chr9,21970920,1.6728090850653523,843,717,1560,-
chr9,21970922,1.679679777010712,1311,920,2231,-
chr9,21970923,0.6426895830913948,1651,1579,3230,-
chr9,21970924,0.6426895830913948,1651,1579,3230,-
chr9,21970932,1.9101187571172928,1020,682,1702,-
chr9,21970935,1.750806451612903,667,619,1286,-
chr9,21970945,1.6812928419500566,1506,1121,2627,-
chr9,21971021,2.178003830390663,971,632,1603,-
chr9,21974701,1.2895864381520117,922,527,1449,-
chr9,21974703,1.0906649882928474,1136,772,1908,-
chr9,21974710,2.3109304929867958,605,450,1055,-
chr9,21974737,3.2893947443123106,1272,993,2265,-
chr9,21974807,7.9523132230965246,1400,1387,2787,-
chr9,21974808,7.321672637385787,2256,1943,4199,-
chr9,21974809,7.180121647828665,2031,1789,3820,-
chr9,21974831,2.3754646840148697,638,537,1175,-
chr9,21974832,4.466175652994822,1861,1314,3175,-
chr9,21974833,4.466175652994822,1861,1314,3175,-
chr9,26841600,0.4419642857142857,560,447,1007,-
chr9,26841601,0.4419642857142857,560,447,1007,-
chr9,32571021,1.776299331318024,1455,925,2380,-
chr9,32572928,2.508214676889376,915,746,1661,-
chr9,32572930,1.4977941176470588,1357,1087,2444,-
chr9,32572931,1.1860123150445732,889,701,1590,-
chr9,32573035,3.848688353865593,662,544,1206,-
chr9,33110748,1.7684691546077682,773,706,1479,-
chr9,33110774,2.142372881355932,631,589,1220,-
chr9,33110972,0.9025467602043197,3891,3715,7606,-
chr9,33110973,0.7518755189959905,5339,4699,10038,-
chr9,33110974,0.7284537445619135,6060,5420,11480,-
chr9,33110975,0.5911919404646279,4103,3769,7872,-
chr9,33110976,0.5972073390987619,2304,2245,4549,-
chr9,33110980,0.9322708773258224,1903,2049,3952,-
chr9,33110981,0.5093555093555093,1224,1364,2588,-
chr9,33111020,1.8089802039044343,1853,1841,3694,-
chr9,33111039,9.675205997311599,3437,3101,6538,-
chr9,33111040,9.852791684636857,2848,2589,5437,-
chr9,33111048,4.384833376558646,1003,675,1678,-
chr9,33111123,1.8035865326822795,1256,893,2149,-
chr9,33111195,1.0292849830271027,1414,1107,2521,-
chr9,33111196,0.5238063835399631,610,445,1055,-
chr9,33111197,1.0292849830271027,1414,1107,2521,-
chr9,33111520,0.451177536231884,878,719,1597,-
chr9,33111583,1.4375894874160806,778,592,1370,-
chr9,33111600,3.1493212669683257,695,492,1187,-
chr9,33111614,2.1610054075174334,1147,728,1875,-
chr9,33111716,1.346317137058857,700,547,1247,-
chr9,33111726,2.085366208852752,754,509,1263,-
chr9,33111866,1.5686856738012658,761,573,1334,-
chr9,33111967,0.5224032586558045,809,490,1299,-
chr9,33112004,0.63024350317168,769,542,1311,-
chr9,33112494,2.0489713774597496,832,558,1390,-
chr9,33112506,2.099726775956284,635,548,1183,-
chr9,33112689,1.858653311074012,1001,598,1599,-
chr9,33112837,2.4242133077107857,840,542,1382,-
chr9,33112947,1.566818205952803,817,529,1346,-
chr9,33113135,0.6916402116402116,945,944,1889,-
chr9,33113140,1.6274047899489594,828,848,1676,-
chr9,33113150,3.240226628895184,816,705,1521,-
chr9,33113155,2.50231124807396,811,648,1459,-
chr9,33113188,1.560609443018194,716,577,1293,-
chr9,33113239,1.7714199772307089,1580,1120,2700,-
chr9,33113288,1.7598343685300204,679,551,1230,-
chr9,33113365,1.9348437500000002,1217,959,2176,-
chr9,33113366,1.9348437500000002,1217,959,2176,-
chr9,33113383,1.6647133757961785,593,470,1063,-
chr9,33113421,1.2367855910421093,1395,922,2317,-
chr9,33113424,0.9851673427991886,1226,815,2041,-
chr9,33113425,0.9851673427991886,1226,815,2041,-
chr9,33113796,1.3404765940259054,2186,1735,3921,-
chr9,33115996,0.4603224361845052,1081,769,1850,-
chr9,33116032,1.996758199847445,1414,1379,2793,-
chr9,33120449,4.237628613424792,960,627,1587,-
chr9,33120482,0.6278571428571429,878,699,1577,-
chr9,33120553,1.7842310188189492,1832,1339,3171,-
chr9,33120554,1.7842310188189492,1832,1339,3171,-
chr9,33135245,0.6258922198429693,1402,933,2335,-
chr9,33135247,1.452204665423947,1262,940,2202,-
chr9,33135253,1.7053902361537645,791,496,1287,-
chr9,33166769,2.3877159309021114,621,520,1141,-
chr9,33166770,2.3877159309021114,621,520,1141,-
chr9,33166833,2.0187403504846007,851,601,1452,-
chr9,33255107,1.6782628676470588,986,679,1665,-
chr9,33255149,0.6438152011922503,863,670,1533,-
chr9,33255184,1.518649310655574,2152,1612,3764,-
chr9,33255185,0.5937627895555373,805,642,1447,-
chr9,33255205,1.2621753901106239,3032,2372,5404,-
chr9,33255206,1.0755268022181146,1856,1622,3478,-
chr9,33255207,1.5460793502030616,706,581,1287,-
chr9,33255873,0.4007524007524007,1471,1035,2506,-
chr9,33255874,2.109823953297455,770,576,1346,-
chr9,33256871,1.835250453943424,6253,4552,10805,-
chr9,33258941,1.3008500590318772,3094,1749,4843,-
chr9,33258944,0.6450717544048385,6705,3557,10262,-
chr9,33258969,1.5300402685606225,12409,6851,19260,-
chr9,33258970,1.5300402685606225,12409,6851,19260,-
chr9,33258972,1.4549634273772205,1651,1154,2805,-
chr9,33261089,0.6073160136763636,5683,3755,9438,-
chr9,33261090,0.6073160136763636,5683,3755,9438,-
chr9,33261164,1.4760982971882282,1635,1050,2685,-
chr9,33262819,1.878727634194831,674,502,1176,-
chr9,33262821,0.6725073007926574,805,704,1509,-
chr9,33262824,1.370943879500783,1598,1118,2716,-
chr9,33262825,0.9647264006976238,1195,833,2028,-
chr9,33264259,1.902502171798864,1117,706,1823,-
chr9,33264419,2.506290668132607,875,655,1530,-
chr9,33441246,1.6875079425594104,812,548,1360,-
chr9,33441375,0.6067266736317608,718,540,1258,-
chr9,33441403,0.5225460345077569,635,626,1261,-
chr9,33441440,23.251063290529807,4107,3729,7836,-
chr9,33441441,17.453517926644775,5471,4406,9877,-
chr9,33441442,17.45351792664477,5471,4406,9877,-
chr9,33441443,19.145344142584317,4099,2996,7095,-
chr9,33441446,10.357662867949161,1820,647,2467,-
chr9,33441448,12.727272727272728,1743,435,2178,-
chr9,33441449,12.152731953777018,2267,637,2904,-
chr9,33441450,15.786563805850205,1753,365,2118,-
chr9,33441452,23.812740424420756,2427,379,2806,-
chr9,33441453,13.963186077643908,1813,248,2061,-
chr9,33441454,18.937976344120216,3958,600,4558,-
chr9,33441455,17.08123030399852,4782,778,5560,-
chr9,33441456,15.652963639497212,4702,716,5418,-
chr9,33441457,19.078926343878603,2926,530,3456,-
chr9,33441458,12.652531158906708,3790,502,4292,-
chr9,33441459,11.149270956835645,4112,539,4651,-
chr9,33441460,11.976718799130376,2343,240,2583,-
chr9,33441462,6.188932644768729,1464,157,1621,-
chr9,33441596,0.6003430531732419,545,582,1127,-
chr9,33441611,0.5069602755008004,870,777,1647,-
chr9,33441613,0.4555892013513445,1075,1003,2078,-
chr9,33441631,3.1059867071379577,821,1035,1856,-
chr9,33441632,3.157924003707136,630,829,1459,-
chr9,33441649,3.287832682672847,587,665,1252,-
chr9,33441678,6.634462333797524,940,1013,1953,-
chr9,33441692,0.40955438951426204,613,592,1205,-
chr9,33441695,0.39267660664266135,602,704,1306,-
chr9,33441696,0.3827330907265655,487,612,1099,-
chr9,33441697,0.3201919065498539,613,798,1411,-
chr9,33441701,5.7069960959427535,1122,1072,2194,-
chr9,33441702,10.107958506725776,996,886,1882,-
chr9,33441703,10.107958506725776,996,886,1882,-
chr9,33442134,1.7600018407304454,665,398,1063,-
chr9,33442140,1.427140415495314,679,403,1082,-
chr9,33442901,1.5272783596829005,956,812,1768,-
chr9,33442996,0.49105275877023136,854,1235,2089,-
chr9,33443021,3.8606858922188887,1033,1360,2393,-
chr9,33443035,53.793727614393106,2556,1671,4227,-
chr9,33443036,53.15740349242993,2824,1711,4535,-
chr9,33443037,60.042372989071026,1996,1365,3361,-
chr9,34087252,3.7604227769063403,568,435,1003,-
chr9,34087253,3.7604227769063403,568,435,1003,-
chr9,34634798,2.2325091388110496,832,705,1537,-
chr9,34634800,2.445761349939735,486,523,1009,-
chr9,34635179,3.51449425521823,1129,789,1918,-
chr9,34635237,3.420732177114921,2128,1481,3609,-
chr9,34635238,3.2281357882623705,686,473,1159,-
chr9,34635388,1.874405154801353,1077,739,1816,-
chr9,34635547,2.5549450549450547,774,454,1228,-
chr9,34637055,2.6916233277728714,645,559,1204,-
chr9,34637082,2.2672738501738046,587,504,1091,-
chr9,34637316,1.5567825389326664,666,406,1072,-
chr9,35059190,3.3878173828125,956,511,1467,-
chr9,35059192,2.945336086516597,1485,939,2424,-
chr9,35059673,0.9497006767308694,694,451,1145,-
chr9,35059675,0.9497006767308694,694,451,1145,-
chr9,35060324,2.179297423887588,726,426,1152,-
chr9,35060325,2.2913770559033377,911,578,1489,-
chr9,35061611,1.5373932765893246,671,476,1147,-
chr9,35074479,1.5826485125176273,2095,1412,3507,-
chr9,35074489,1.8941558344789242,2164,1380,3544,-
chr9,35077049,0.8070241274523298,794,556,1350,-
chr9,35100076,3.3432619448712217,574,465,1039,-
chr9,35101267,2.4140447346035088,709,489,1198,-
chr9,35101757,1.7521937842778792,660,546,1206,-
chr9,35101943,1.3713693722989373,1785,1228,3013,-
chr9,35102132,1.8812375249501,753,500,1253,-
chr9,35102186,1.95733380764678,810,659,1469,-
chr9,35657809,1.4457113855523602,1525,1284,2809,-
chr9,35657822,1.897163120567376,1069,563,1632,-
chr9,35657823,1.994736842105263,1515,759,2274,-
chr9,35657825,1.9671500875997665,973,466,1439,-
chr9,35684755,1.1035263386602807,1196,939,2135,-
chr9,35684756,0.8433055625683751,910,698,1608,-
chr9,35685088,2.333014354066986,741,384,1125,-
chr9,35685441,0.4195541230190706,567,437,1004,-
chr9,35685504,0.58944790076462,1352,948,2300,-
chr9,35689176,1.8150096926059265,677,470,1147,-
chr9,35689242,3.310520023909145,582,477,1059,-
chr9,35689243,3.310520023909145,582,477,1059,-
chr9,35689800,0.3758669595540084,601,505,1106,-
chr9,35689826,0.909269097079068,622,480,1102,-
chr9,36233971,1.7887640449438205,795,444,1239,-
chr9,36233977,1.3732870970903144,733,477,1210,-
chr9,37588545,1.601253427340384,1021,827,1848,-
chr9,37588600,2.4545170365739293,603,456,1059,-
chr9,37588814,2.028921998247152,925,651,1576,-
chr9,37588823,3.5591296121097447,911,603,1514,-
chr9,37588911,1.8787609357877153,1874,1348,3222,-
chr9,37588916,0.643048128342246,922,747,1669,-
chr9,37592481,1.70665832717348,1034,817,1851,-
chr9,37592483,1.70665832717348,1034,817,1851,-
chr9,37592544,2.544230769230769,881,467,1348,-
chr9,37592545,2.544230769230769,881,467,1348,-
chr9,37780814,1.0016107065014692,765,575,1340,-
chr9,37974786,1.9121375806243228,1776,1300,3076,-
chr9,37974787,1.9121375806243228,1776,1300,3076,-
chr9,37974788,2.3496150144369583,1394,1038,2432,-
chr9,37974794,2.809922896413007,761,470,1231,-
chr9,37974796,2.8292483820052183,1066,664,1730,-
chr9,72327916,1.861997081509277,637,532,1169,-
chr9,72327918,1.5449627313567784,1235,933,2168,-
chr9,72329541,2.2826086956521743,783,551,1334,-
chr9,72329542,1.9748195554923997,1511,931,2442,-
chr9,72999814,0.3697869498333076,820,515,1335,-
chr9,73001055,0.47966249759507573,770,555,1325,-
chr9,73002308,0.40084329925637957,860,1064,1924,-
chr9,73002335,4.107554946755494,516,738,1254,-
chr9,73002630,1.3249372673113842,1199,849,2048,-
chr9,73002631,0.9833333333333332,825,584,1409,-
chr9,73002632,0.9833333333333332,825,584,1409,-
chr9,74298649,1.6208551483420592,742,572,1314,-
chr9,74298736,0.47169462422401254,1151,1129,2280,-
chr9,74298737,0.47169462422401254,1151,1129,2280,-
chr9,74298777,5.048507358921668,1340,1637,2977,-
chr9,74298778,5.762593675005313,1942,2341,4283,-
chr9,74298781,28.224051765887463,2412,1608,4020,-
chr9,74298782,28.224051765887463,2412,1608,4020,-
chr9,74298847,0.9607743076818398,910,638,1548,-
chr9,74298848,1.345269725281532,1079,731,1810,-
chr9,74299043,2.584257206208426,517,491,1008,-
chr9,74299114,1.634354571177676,858,553,1411,-
chr9,74299347,2.51779593257723,875,662,1537,-
chr9,74299775,0.3317422434367542,833,837,1670,-
chr9,74299777,0.28554947559272736,1082,1128,2210,-
chr9,74299783,18.38857700756651,1083,963,2046,-
chr9,74299784,23.661581981741662,3652,3209,6861,-
chr9,74299785,24.965500798767483,3891,3251,7142,-
chr9,74299786,26.014525127886934,3528,2882,6410,-
chr9,74299787,33.641148325358856,711,303,1014,-
chr9,74299789,13.326640560350949,1382,307,1689,-
chr9,74299790,14.087719298245617,1021,227,1248,-
chr9,74299791,13.178705229527496,1284,281,1565,-
chr9,74313058,2.134763948497854,828,698,1526,-
chr9,74313087,3.027318718381113,791,592,1383,-
chr9,74315638,0.9501821451255021,1216,809,2025,-
chr9,74319686,1.964760097587422,603,433,1036,-
chr9,74332973,0.5214823690516945,676,507,1183,-
chr9,74340528,2.764736567553469,794,638,1432,-
chr9,74340529,2.764736567553469,794,638,1432,-
chr9,74340531,0.48894868345185466,635,472,1107,-
chr9,74345699,3.3980495366359853,602,440,1042,-
chr9,74345744,2.441088516746412,906,607,1513,-
chr9,74345746,2.441088516746412,906,607,1513,-
chr9,74349729,0.8807633845634183,744,572,1316,-
chr9,74349730,0.8807633845634183,744,572,1316,-
chr9,74359961,0.690969096909691,657,605,1262,-
chr9,74360009,1.8992971827109633,1082,745,1827,-
chr9,74360011,1.0416585932958728,671,396,1067,-
chr9,74969605,1.7849787711678295,1015,660,1675,-
chr9,74969910,2.128272943665697,618,397,1015,-
chr9,74970463,1.162419564334,1250,910,2160,-
chr9,74970506,2.486544517606642,598,498,1096,-
chr9,74970592,2.360341151385928,573,468,1041,-
chr9,74971882,0.570730288041897,612,490,1102,-
chr9,74971933,0.5899782135076252,676,509,1185,-
chr9,79000608,2.686040195545899,644,525,1169,-
chr9,79000614,3.3975460122699386,638,488,1126,-
chr9,79000877,1.519558859371192,977,745,1722,-
chr9,79001145,2.049556035517159,550,462,1012,-
chr9,79001228,1.388373940677966,698,471,1169,-
chr9,79001345,1.906832298136646,613,482,1095,-
chr9,79001374,2.8550925925925927,880,539,1419,-
chr9,79001421,1.608421052631579,763,474,1237,-
chr9,79001483,1.654142145767315,1217,751,1968,-
chr9,79001788,0.5131380684046484,1129,768,1897,-
chr9,79001821,1.5420900531369444,918,630,1548,-
chr9,79001841,2.1581732108047897,749,566,1315,-
chr9,79001859,1.939473684210526,736,512,1248,-
chr9,79001881,0.7541333545158332,1463,922,2385,-
chr9,79007459,2.1057579318448885,839,554,1393,-
chr9,79007481,1.3718487015978864,1167,829,1996,-
chr9,79007482,2.216843259042747,808,482,1290,-
chr9,79007483,2.216843259042747,808,482,1290,-
chr9,86275540,0.21271665251680333,558,716,1274,-
chr9,86275917,1.852534562211981,602,433,1035,-
chr9,86276019,2.1552926011296645,662,455,1117,-
chr9,86281338,2.6017520215633425,593,423,1016,-
chr9,86281339,2.6017520215633425,593,423,1016,-
chr9,86292789,2.359033880629808,716,501,1217,-
chr9,86294911,2.6186490027939406,878,608,1486,-
chr9,86403583,1.9520875251509056,721,567,1288,-
chr9,86583368,2.4912067919951486,789,484,1273,-
chr9,86583544,1.5494461470664822,1501,1160,2661,-
chr9,86583545,1.8167656146620315,1837,1487,3324,-
chr9,86583559,2.052132009345794,610,427,1037,-
chr9,86583772,2.109979272494753,938,739,1677,-
chr9,86583773,1.8462677263518776,676,413,1089,-
chr9,86583931,2.2249742002063986,783,611,1394,-
chr9,86583932,2.390958011753877,3116,1947,5063,-
chr9,86583934,2.366198643381964,6581,4871,11452,-
chr9,86583937,6.472734920023409,4827,3583,8410,-
chr9,86584035,0.7152035329782058,2547,2257,4804,-
chr9,86584073,0.7604260654565906,1827,1398,3225,-
chr9,86584089,101.00457303491174,14788,6162,20950,-
chr9,86584090,101.00457303491174,14788,6162,20950,-
chr9,86584096,7.2478991596638656,1494,237,1731,-
chr9,86584217,1.4589735907203698,1481,1148,2629,-
chr9,86585094,1.3007322396676757,3157,2028,5185,-
chr9,86585134,2.308791824640315,3934,2965,6899,-
chr9,86585202,1.3032941670163658,3332,2382,5714,-
chr9,86585233,0.8144110775542766,3272,2288,5560,-
chr9,86585239,1.3002639844886585,10761,7903,18664,-
chr9,86585670,1.4338179588008226,5151,3660,8811,-
chr9,86585693,0.6769981481731796,1854,1328,3182,-
chr9,86585731,1.344604755131071,1837,1294,3131,-
chr9,86585733,0.6988480042372258,2499,1836,4335,-
chr9,86586214,1.4540392910727682,1610,991,2601,-
chr9,86586618,1.6326988579442996,925,712,1637,-
chr9,86586621,1.6289866883998914,982,817,1799,-
chr9,86586803,0.6399893468273521,800,652,1452,-
chr9,86586816,2.3285348688419707,752,520,1272,-
chr9,86586834,2.929328621908128,828,565,1393,-
chr9,86586906,1.597974564295808,1356,964,2320,-
chr9,86586920,1.59823677581864,1221,793,2014,-
chr9,86587068,0.537477800209475,3078,2485,5563,-
chr9,86587760,1.5154934965570008,3305,2613,5918,-
chr9,86587773,1.351361725597758,2810,2163,4973,-
chr9,86588836,1.621163866569272,2106,1368,3474,-
chr9,86593130,1.4297338103934203,35675,27778,63453,-
chr9,86593133,1.4719696395245803,33126,25128,58254,-
chr9,86593145,0.6321041365826814,97720,72781,170501,-
chr9,86593146,0.6068671070247278,73519,55045,128564,-
chr9,86593147,0.6438585866855441,115172,84884,200056,-
chr9,86593156,1.285270392569579,19088,13889,32977,-
chr9,86593160,1.3125264425033834,55959,42921,98880,-
chr9,86593161,1.3231998606772755,46473,36460,82933,-
chr9,86593170,1.2154640262714445,12123,8372,20495,-
chr9,86593171,1.2570645317872895,25824,17602,43426,-
chr9,86593172,1.2942457432716228,13701,9230,22931,-
chr9,86593294,1.3272739729700542,18417,12644,31061,-
chr9,86593295,1.344446869921657,14160,10179,24339,-
chr9,86593308,2.296278046335392,5630,3796,9426,-
chr9,86593345,1.5051495016611296,1065,839,1904,-
chr9,86593355,1.6510482846251588,1154,786,1940,-
chr9,86595082,2.126989566308702,869,576,1445,-
chr9,86595478,2.12406015037594,677,607,1284,-
chr9,88648231,1.7108246622146297,2753,2054,4807,-
chr9,88648234,1.6638028853947155,5131,3657,8788,-
chr9,88648235,1.4613771811109282,6372,4523,10895,-
chr9,88648239,0.6757116496638615,2910,1911,4821,-
chr9,88648244,1.3702397294664783,5560,3818,9378,-
chr9,88648258,1.4215027741612016,3237,2063,5300,-
chr9,88648262,1.54339319217368,4247,2582,6829,-
chr9,88648263,1.54339319217368,4247,2582,6829,-
chr9,88648264,1.54339319217368,4247,2582,6829,-
chr9,88648273,1.4498319497285597,3663,2435,6098,-
chr9,88648274,1.2201986754966887,2210,1187,3397,-
chr9,88648281,2.041482624008499,1297,802,2099,-
chr9,88648282,0.5901202918556497,854,460,1314,-
chr9,88648284,1.855106888361045,780,420,1200,-
chr9,88648294,1.905034324942792,665,367,1032,-
chr9,88648304,2.075615326059376,817,562,1379,-
chr9,88648307,1.648648648648649,727,480,1207,-
chr9,88650286,2.197265760291822,943,545,1488,-
chr9,88655727,0.2010920074349442,576,537,1113,-
chr9,88880656,1.817434210526316,844,623,1467,-
chr9,88880657,1.817434210526316,844,623,1467,-
chr9,88880689,1.0093896713615025,644,425,1069,-
chr9,88880690,1.0093896713615025,644,425,1069,-
chr9,94172285,4.649936779860471,889,506,1395,-
chr9,94793860,1.381440281030445,2177,1463,3640,-
chr9,94793863,1.5494709702258092,3540,2270,5810,-
chr9,94793866,1.7678571428571428,3464,2199,5663,-
chr9,94793867,1.7678571428571428,3464,2199,5663,-
chr9,94793876,1.4691908498193165,2662,1574,4236,-
chr9,94793917,2.26653883029722,787,446,1233,-
chr9,94793922,1.6008762322015333,1217,663,1880,-
chr9,94793935,3.0067124167270634,1648,869,2517,-
chr9,94794634,3.966830167133811,621,393,1014,-
chr9,94821526,2.228008860447945,1483,1194,2677,-
chr9,94821556,2.152629513343799,1166,727,1893,-
chr9,94821563,1.5806615460413407,1764,1133,2897,-
chr9,94821568,1.6746506986027945,838,500,1338,-
chr9,94830333,1.2272945396724475,784,528,1312,-
chr9,94874809,2.1330602335373423,795,516,1311,-
chr9,94972990,1.9445100354191263,731,483,1214,-
chr9,94973163,1.6299019607843137,740,662,1402,-
chr9,94973170,2.474764595103578,772,589,1361,-
chr9,94984872,2.8537303664921465,645,381,1026,-
chr9,94984875,2.0325618395442855,1134,878,2012,-
chr9,94984918,0.5521456604259152,612,470,1082,-
chr9,94985770,0.3740284974093263,846,771,1617,-
chr9,94991318,1.757947409733124,873,727,1600,-
chr9,94991319,0.6229622933131143,970,646,1616,-
chr9,94991388,1.8934065305655627,945,602,1547,-
chr9,95003153,2.251758736016607,780,597,1377,-
chr9,95003223,1.7407407407407407,845,683,1528,-
chr9,95004603,1.675932958630817,870,680,1550,-
chr9,95005551,0.5509325681492109,791,560,1351,-
chr9,95007329,0.5316315886359453,721,378,1099,-
chr9,95012554,1.742845117845118,1009,659,1668,-
chr9,95013091,1.6355796229442436,698,553,1251,-
chr9,95014161,1.5514820592823713,818,640,1458,-
chr9,95015666,2.135875402792696,775,531,1306,-
chr9,95015723,1.665318302387268,760,579,1339,-
chr9,95019029,0.5743835995936836,621,441,1062,-
chr9,95021163,1.4789579158316637,845,498,1343,-
chr9,95022470,0.5180433039294307,713,608,1321,-
chr9,95022476,1.1233060741947258,1359,1107,2466,-
chr9,95022485,1.844097995545657,620,448,1068,-
chr9,95025335,1.0436383158217657,1133,766,1899,-
chr9,95025336,1.0436383158217657,1133,766,1899,-
chr9,95027284,2.479677963900792,615,452,1067,-
chr9,95027785,2.045507433742728,585,454,1039,-
chr9,95032188,1.827163461538461,690,415,1105,-
chr9,95032211,2.968985456456983,705,438,1143,-
chr9,95032249,1.8043778901766705,1390,1015,2405,-
chr9,95033838,1.7517123287671232,692,510,1202,-
chr9,95040186,2.010869565217391,839,643,1482,-
chr9,95048048,1.6627486259361721,1261,874,2135,-
chr9,95051590,1.6226265251606382,724,512,1236,-
chr9,95051690,1.7477012218163497,554,466,1020,-
chr9,99149245,2.1494130743272755,1287,1089,2376,-
chr9,99149246,2.068449290411907,901,855,1756,-
chr9,100449430,6.104710144927536,580,459,1039,-
chr9,102744948,2.8411867681682685,1379,1030,2409,-
chr9,102744951,1.7912890643030095,2551,1914,4465,-
chr9,102744952,1.7143160014840726,1243,992,2235,-
chr9,102784486,2.544349138011722,679,450,1129,-
chr9,104152658,3.705523132905514,809,604,1413,-
chr9,104152868,2.038752052545156,775,434,1209,-
chr9,104152884,1.6551724137931032,815,441,1256,-
chr9,111641734,3.119728943262259,700,487,1187,-
chr9,111641735,2.990094629470321,684,449,1133,-
chr9,111705102,2.5130111524163565,675,537,1212,-
chr9,111714599,0.6361635597371763,1608,888,2496,-
chr9,111714617,3.5692090395480225,664,353,1017,-
chr9,111714632,2.1260061919504643,653,379,1032,-
chr9,111714769,2.971297359357061,646,468,1114,-
chr9,111735072,2.375412397985761,569,442,1011,-
chr9,111735075,0.5027829313543599,812,615,1427,-
chr9,111739313,0.3470380194518125,627,376,1003,-
chr9,111741632,2.135004137604918,859,768,1627,-
chr9,111741634,2.135004137604918,859,768,1627,-
chr9,111745503,2.590250028542071,708,460,1168,-
chr9,111745530,5.580357142857143,624,383,1007,-
chr9,111746687,1.9708942489216814,1065,740,1805,-
chr9,111775623,1.1996920229171422,890,735,1625,-
chr9,111775624,0.2869981497253958,697,430,1127,-
chr9,111775625,0.49211850323213824,1729,1156,2885,-
chr9,111775626,0.49418011452368543,878,564,1442,-
chr9,113007071,1.377058269949966,4269,3252,7521,-
chr9,113013694,1.421468803213553,4120,3094,7214,-
chr9,113013708,1.1895416764440714,5571,4213,9784,-
chr9,113018760,1.0779631174889635,29940,18093,48033,-
chr9,113018784,1.1215129906365968,60097,40095,100192,-
chr9,113018786,1.3034867105967314,108295,67625,175920,-
chr9,113018787,1.528511474731435,81830,49174,131004,-
chr9,113018788,1.438842360921391,57137,34846,91983,-
chr9,113018789,1.4893634795933297,20784,10122,30906,-
chr9,113018799,1.4910361433438355,10621,4549,15170,-
chr9,113018800,1.5253095568880604,24088,11708,35796,-
chr9,113018803,1.4116217345123523,15752,8204,23956,-
chr9,113018805,1.3542762524276586,14361,7266,21627,-
chr9,113018807,1.452086826421965,14468,7273,21741,-
chr9,113018814,0.758693080811851,30275,13410,43685,-
chr9,113018815,0.8228793018987105,36770,16446,53216,-
chr9,113018816,0.8418691808797933,22780,10367,33147,-
chr9,113018817,0.7490469070147273,22170,9921,32091,-
chr9,113018818,0.8459246985763298,10691,6086,16777,-
chr9,113018820,0.7200533867323823,10572,5416,15988,-
chr9,113018823,1.180414574206646,2454,1145,3599,-
chr9,113018825,1.308609465291493,3577,1673,5250,-
chr9,113018826,1.47458094407562,5653,3074,8727,-
chr9,113018827,1.767231030616128,4123,2469,6592,-
chr9,113018828,1.7373283375679414,3349,2005,5354,-
chr9,113018833,2.379292929292929,672,395,1067,-
chr9,113018834,1.3592093441150046,975,529,1504,-
chr9,113018838,1.7961844197138317,806,369,1175,-
chr9,113018841,0.9209431677309129,2693,1222,3915,-
chr9,113018843,0.846770804267675,4250,2014,6264,-
chr9,113018845,0.8770121859485482,1601,827,2428,-
chr9,113018846,2.4379358437935843,873,477,1350,-
chr9,113018858,1.6048812299573838,750,341,1091,-
chr9,113018869,0.7399861363382287,885,442,1327,-
chr9,114136264,0.8679704484654752,4069,2869,6938,-
chr9,114136266,0.49797106224089177,2833,1916,4749,-
chr9,114136267,0.6163358778625955,1100,654,1754,-
chr9,114136290,0.5804311774461027,699,401,1100,-
chr9,114136299,1.9452690166975881,931,538,1469,-
chr9,114136300,2.4428205128205125,1360,779,2139,-
chr9,114136302,2.8855955178022774,886,502,1388,-
chr9,114332384,1.698515244247988,1269,864,2133,-
chr9,114332407,0.7594978371261989,1670,1226,2896,-
chr9,114332408,2.0392003680012114,2876,2171,5047,-
chr9,114332418,1.4310581140350875,984,759,1743,-
chr9,114332470,1.879787051348102,841,646,1487,-
chr9,114332477,0.395979492714517,586,435,1021,-
chr9,114341196,0.8489176659599716,4379,3269,7648,-
chr9,114341197,0.9231168831168832,3553,2485,6038,-
chr9,114341198,1.5050275482093665,1065,659,1724,-
chr9,114345767,1.606400281878602,1550,1133,2683,-
chr9,114345808,2.1654649657977445,688,600,1288,-
chr9,114359693,1.6294978517722876,782,531,1313,-
chr9,114359704,1.869872122762149,702,424,1126,-
chr9,114361643,1.8686056994314855,1164,778,1942,-
chr9,114361646,1.290375994909744,1120,645,1765,-
chr9,114361675,1.6446420411052274,1334,811,2145,-
chr9,114361677,2.058657178356773,873,482,1355,-
chr9,114985888,3.2564848484848485,706,549,1255,-
chr9,114985889,0.4913113503433076,827,501,1328,-
chr9,114985892,1.5503721765913758,652,486,1138,-
chr9,114985893,1.752569169960474,738,459,1197,-
chr9,114985899,0.5609867519415258,613,397,1010,-
chr9,114985912,2.1971408523982956,876,681,1557,-
chr9,114985914,1.8914285714285717,661,509,1170,-
chr9,116035668,2.939763198268767,656,446,1102,-
chr9,116037681,6.13013022743152,987,728,1715,-
chr9,116169702,1.7941227014951024,695,505,1200,-
chr9,116169755,1.7648565573770492,688,487,1175,-
chr9,116169837,4.150119776417354,581,420,1001,-
chr9,116169865,2.496928746928747,812,517,1329,-
chr9,116169867,2.496928746928747,812,517,1329,-
chr9,116170287,0.8434306117542585,1464,1171,2635,-
chr9,116170288,1.073395939352605,929,777,1706,-
chr9,116170910,1.3405425663472967,1642,1144,2786,-
chr9,116170953,1.8108377961332485,569,478,1047,-
chr9,116171238,2.402556089239396,6049,4864,10913,-
chr9,116171239,2.402556089239396,6049,4864,10913,-
chr9,116171247,1.4112250266649544,10478,7601,18079,-
chr9,116171903,1.7773497536295932,2615,1500,4115,-
chr9,116171906,1.7479928462641023,4073,2377,6450,-
chr9,116171915,2.0593467011642947,1414,772,2186,-
chr9,116171916,1.6442307692307694,1880,1429,3309,-
chr9,116171921,1.528467242752957,1246,665,1911,-
chr9,116171931,0.5537921817574339,1104,573,1677,-
chr9,116171949,2.748696844993141,1397,809,2206,-
chr9,116171951,2.103803259937089,1050,537,1587,-
chr9,116171960,0.5337964199839701,665,393,1058,-
chr9,116171983,0.4236215033958789,919,510,1429,-
chr9,116171991,1.6795708278961867,723,417,1140,-
chr9,116171994,0.3561497326203208,665,373,1038,-
chr9,123367326,1.482365904192169,999,913,1912,-
chr9,123367329,2.652766272218109,1935,1609,3544,-
chr9,123367330,2.9887688069506253,1719,1572,3291,-
chr9,123367332,2.737182874960869,1971,1653,3624,-
chr9,123367334,2.1096835859620433,3383,2431,5814,-
chr9,123367335,2.4639146103762637,1845,1372,3217,-
chr9,123367336,2.826864535768645,1563,1167,2730,-
chr9,123367380,2.1285363901091863,853,650,1503,-
chr9,123595631,1.3980825993595234,1729,1010,2739,-
chr9,123595632,1.7533432458510074,1925,1259,3184,-
chr9,123595653,1.2975843430586238,841,578,1419,-
chr9,123636295,0.46841498438683155,657,539,1196,-
chr9,123636930,1.9943548621844973,849,621,1470,-
chr9,123941782,5.542784163473819,619,521,1140,-
chr9,123941783,5.542784163473819,619,521,1140,-
chr9,123942144,2.085016147231625,1306,658,1964,-
chr9,123942145,2.085016147231625,1306,658,1964,-
chr9,123942735,1.8067618798829377,973,731,1704,-
chr9,123945212,0.5969696969696969,590,439,1029,-
chr9,123949295,0.5508684863523574,591,415,1006,-
chr9,124101472,1.823161597534289,2164,1508,3672,-
chr9,124101650,1.6292514453037015,1084,700,1784,-
chr9,124102608,1.3049454591938405,6184,4696,10880,-
chr9,124102684,1.4270919635459816,2596,1665,4261,-
chr9,124102685,1.4270919635459816,2596,1665,4261,-
chr9,124102693,1.3258546299369398,3328,2299,5627,-
chr9,124102760,1.8590051405177448,2278,1325,3603,-
chr9,124102761,1.8590051405177448,2278,1325,3603,-
chr9,124102762,0.6820363906366187,6858,4288,11146,-
chr9,124102763,0.6949826660204231,6052,3637,9689,-
chr9,124102774,0.6094351597207531,1107,814,1921,-
chr9,124102791,0.633066415449835,959,771,1730,-
chr9,124102817,1.8237552155771903,885,718,1603,-
chr9,124102831,0.626231632175833,1220,934,2154,-
chr9,124102839,0.9872897098609944,1354,1028,2382,-
chr9,124102909,1.767272727272727,728,399,1127,-
chr9,124102910,1.0621221443699893,1735,1159,2894,-
chr9,124102925,0.3686823104693141,816,553,1369,-
chr9,124102926,0.3686823104693141,816,553,1369,-
chr9,124103149,1.5217651075452372,1697,1211,2908,-
chr9,124103153,2.954177897574124,684,529,1213,-
chr9,124103163,1.891734972677596,572,487,1059,-
chr9,124103447,1.566077003121748,804,712,1516,-
chr9,124103485,1.9873887678018358,2128,1423,3551,-
chr9,124103562,0.6045218680504078,698,638,1336,-
chr9,124103613,1.4765698327593744,2974,2402,5376,-
chr9,124103619,1.9583092067168506,711,627,1338,-
chr9,124103642,0.6529304029304029,827,727,1554,-
chr9,124103644,1.9141604010025064,1221,797,2018,-
chr9,124103666,2.124889743299785,1467,1194,2661,-
chr9,124103667,1.9024903447860695,2489,1820,4309,-
chr9,124103684,1.2422333205442933,2164,1676,3840,-
chr9,124111416,2.479093786440113,1062,827,1889,-
chr9,124111519,0.5132753909620149,2032,1541,3573,-
chr9,124111542,1.4938218907260965,1126,855,1981,-
chr9,124111554,1.5290511224297303,1130,836,1966,-
chr9,124116919,0.643291257597008,1203,965,2168,-
chr9,124118348,0.61495673671199,994,808,1802,-
chr9,124118398,1.7862938596491231,1480,1139,2619,-
chr9,124118400,1.702279713655207,2522,1801,4323,-
chr9,124118414,2.043850267379679,636,439,1075,-
chr9,124118425,1.4781715684132324,824,466,1290,-
chr9,124132407,1.817445286195286,750,395,1145,-
chr9,124132525,0.3006664773581439,719,456,1175,-
chr9,124132526,0.8623261439225962,743,725,1468,-
chr9,124132527,0.6991557622508292,2274,1845,4119,-
chr9,124132528,0.9192143224742461,1205,1108,2313,-
chr9,124906469,2.5978062157221204,811,546,1357,-
chr9,124906483,0.5975973789588642,1025,614,1639,-
chr9,124906524,0.4681442469460903,799,650,1449,-
chr9,124906536,1.6200983331334693,964,537,1501,-
chr9,124906538,1.1966687445691186,1822,1383,3205,-
chr9,124906539,1.1966687445691186,1822,1383,3205,-
chr9,124906552,1.878647261477888,667,430,1097,-
chr9,124906570,2.181889841363681,691,596,1287,-
chr9,124910402,3.055950687529635,1288,702,1990,-
chr9,124910412,1.9506701503028856,4297,2676,6973,-
chr9,124910502,1.7552566279221629,1007,740,1747,-
chr9,124914557,1.8740148354195645,873,718,1591,-
chr9,124914586,1.805990541250657,1073,864,1937,-
chr9,124914589,1.7633532934131737,817,667,1484,-
chr9,124914677,0.6254263972710574,680,617,1297,-
chr9,124914678,0.5258069314294214,504,497,1001,-
chr9,124914681,0.491037429181759,621,581,1202,-
chr9,124921917,0.508263888888889,562,479,1041,-
chr9,124921918,0.49523460410557185,578,495,1073,-
chr9,124921924,0.4548880514298381,607,693,1300,-
chr9,124921926,0.4548880514298381,607,693,1300,-
chr9,124921946,2.5768654465722842,1975,1757,3732,-
chr9,124921947,2.698767685988133,656,625,1281,-
chr9,124921948,2.5131539946376846,1319,1132,2451,-
chr9,124921966,5.952714775979063,881,819,1700,-
chr9,124921967,7.848059551658277,1476,1226,2702,-
chr9,125652780,3.40727442171927,904,459,1363,-
chr9,125652782,3.466351209253417,693,316,1009,-
chr9,127115820,2.417094017094017,706,584,1290,-
chr9,127115905,1.8236609312724803,937,761,1698,-
chr9,127115906,1.40500059672992,1384,1196,2580,-
chr9,127115907,1.3493661446681582,1973,1340,3313,-
chr9,127115937,1.5114553078089996,3580,2473,6053,-
chr9,127115940,1.5638111490329922,1882,1171,3053,-
chr9,127115941,1.537328995662329,898,665,1563,-
chr9,127115967,2.0071794871794872,926,674,1600,-
chr9,127119096,1.6192086150763838,1929,1209,3138,-
chr9,127119097,0.507093795093795,1416,1154,2570,-
chr9,127119144,1.3883330951180712,4870,3542,8412,-
chr9,127119180,1.3790525377355591,2437,1548,3985,-
chr9,127167699,1.628648733432672,2386,1554,3940,-
chr9,127174680,1.4882371346956338,2614,1971,4585,-
chr9,127177153,1.477678113585623,2370,1456,3826,-
chr9,127177652,1.43576505798728,1856,1214,3070,-
chr9,127177655,1.5920246811253858,1757,1142,2899,-
chr9,127177661,4.0414814814814815,681,524,1205,-
chr9,127177674,1.6219911599798027,1812,1274,3086,-
chr9,127177687,1.7895258140398664,1313,787,2100,-
chr9,127177694,2.2841530054644807,846,670,1516,-
chr9,127177712,1.9047619047619049,759,398,1157,-
chr9,127177717,0.6328819568454253,1394,792,2186,-
chr9,127177718,0.59002355502913,1557,1030,2587,-
chr9,127177720,0.9618421052631577,644,449,1093,-
chr9,127620254,1.6095448713544651,31756,26512,58268,-
chr9,127620255,1.5460196324315838,44695,33541,78236,-
chr9,127620260,1.7146963306636784,7872,5560,13432,-
chr9,127620312,1.4440123945809757,31820,20233,52053,-
chr9,127620338,1.512366094257574,10566,7005,17571,-
chr9,127622529,1.1933103105309117,93220,70642,163862,-
chr9,127622530,1.1933103105309117,93220,70642,163862,-
chr9,127623700,1.2222532671637663,49932,33859,83791,-
chr9,127623701,1.2222532671637663,49932,33859,83791,-
chr9,127623705,1.2570032419809527,13273,7982,21255,-
chr9,127623733,1.167429608765729,19428,12325,31753,-
chr9,127623803,1.3744546479428217,11312,8659,19971,-
chr9,127623810,0.8564297650558969,15080,10068,25148,-
chr9,127623829,1.1900052266787235,44720,31692,76412,-
chr9,127623830,1.2204242935400345,45225,32077,77302,-
chr9,127624191,0.4124770413722256,6624,4588,11212,-
chr9,127624229,0.7830334780910365,2887,2444,5331,-
chr9,127624230,1.2604059280296005,10567,6421,16988,-
chr9,127624231,1.2323618871471191,5208,3410,8618,-
chr9,127624232,1.185246198695784,15056,9045,24101,-
chr9,127624233,1.0290451839968373,24308,15391,39699,-
chr9,127624234,0.8546000546000545,6135,4365,10500,-
chr9,127624235,1.1489502895752894,11719,6655,18374,-
chr9,127624236,1.1578794495465907,10168,6091,16259,-
chr9,127624237,1.1856122493208185,9365,5674,15039,-
chr9,127624243,0.9174041297935104,932,338,1270,-
chr9,127624244,0.8884053437591467,1125,418,1543,-
chr9,127998647,8.862727183249392,11899,9486,21385,-
chr9,127998657,0.9629450459166851,6250,3992,10242,-
chr9,127998658,1.1506649317476214,11684,7544,19228,-
chr9,127998664,3.9965596298121255,10487,6999,17486,-
chr9,127998672,1.5167100561704718,4951,3238,8189,-
chr9,127998678,2.454746136865342,3335,2264,5599,-
chr9,127998679,2.84163369400527,5473,3730,9203,-
chr9,127999033,1.8863086066475896,2363,1651,4014,-
chr9,127999068,1.491959097256633,2069,1123,3192,-
chr9,127999271,1.925063442304821,2975,1826,4801,-
chr9,128000876,0.7544165937402861,4606,3189,7795,-
chr9,128001337,0.7093919805479529,5913,4606,10519,-
chr9,128001358,1.349708299599897,8400,6035,14435,-
chr9,128001534,4.517809174160689,6708,4952,11660,-
chr9,128001562,1.6857414965986397,1510,1049,2559,-
chr9,128001563,1.4877581055166573,2223,1318,3541,-
chr9,128001565,1.440410373325734,1403,956,2359,-
chr9,128002534,1.5072005707364824,2188,1628,3816,-
chr9,128002578,1.374599528501481,1894,1397,3291,-
chr9,128002971,0.6888958110432439,1753,1570,3323,-
chr9,128002996,1.6874630054224695,3306,2853,6159,-
chr9,128002997,1.7241647772019424,4833,3953,8786,-
chr9,128003067,1.487531565656566,1130,1055,2185,-
chr9,128003114,1.4758601553829078,1181,951,2132,-
chr9,128003156,1.5830346475507766,1049,836,1885,-
chr9,128003171,1.6110844169494578,1554,937,2491,-
chr9,128003172,1.4520826987511422,1016,783,1799,-
chr9,128003174,1.544603524229075,934,680,1614,-
chr9,128003335,1.516136082173818,967,741,1708,-
chr9,128003338,1.3954248366013071,825,707,1532,-
chr9,128003407,1.1025248546134254,2499,1801,4300,-
chr9,128003473,1.2292257315869153,3759,3053,6812,-
chr9,128003474,1.1030707151646968,2546,2104,4650,-
chr9,128003588,2.351164254247955,933,680,1613,-
chr9,128003597,0.7324166399490758,1460,1243,2703,-
chr9,128003598,1.5615468409586055,609,611,1220,-
chr9,128003600,0.5776991150442478,815,564,1379,-
chr9,128003613,2.039374944822107,699,481,1180,-
chr9,128200708,1.7286665121361635,1683,1312,2995,-
chr9,128200709,1.2050600291393054,3407,2231,5638,-
chr9,128200712,1.7694793536804314,769,556,1325,-
chr9,128200768,1.1068178905549149,750,458,1208,-
chr9,128200769,1.1068178905549149,750,458,1208,-
chr9,128200838,1.5647570983398447,873,535,1408,-
chr9,128246809,3.07290728143716,682,613,1295,-
chr9,128419965,2.443123543123543,668,584,1252,-
chr9,128419968,2.4247460757156047,807,455,1262,-
chr9,128419977,0.5320450885668276,707,404,1111,-
chr9,128419997,1.8573360754369082,1296,920,2216,-
chr9,128420004,3.4945054945054945,688,454,1142,-
chr9,128420037,1.8318391741374624,612,408,1020,-
chr9,130211567,1.2134459189958078,45486,29498,74984,-
chr9,130211573,1.0265587590894234,46515,31812,78327,-
chr9,130211574,1.1099879716131205,33653,25710,59363,-
chr9,130211641,0.5858493843353941,2306,1546,3852,-
chr9,130211976,1.329368131868132,12781,9799,22580,-
chr9,130211979,1.215393789387141,29131,19579,48710,-
chr9,130213028,1.3360664095562835,68263,41463,109726,-
chr9,130213029,1.3360664095562835,68263,41463,109726,-
chr9,130213370,3.7908729245176707,618,396,1014,-
chr9,130213570,1.000745534459599,21541,11136,32677,-
chr9,130213679,0.7646232983070936,19798,18650,38448,-
chr9,130213681,0.9701531865693198,30081,28105,58186,-
chr9,130213683,0.9852690615365115,35354,29385,64739,-
chr9,130213684,1.0162811924232822,6227,4929,11156,-
chr9,130267729,0.6543715846994536,957,731,1688,-
chr9,130268113,0.5407533248606942,1029,873,1902,-
chr9,130268139,3.6966019417475726,1522,1235,2757,-
chr9,130268140,4.582397603151356,3544,2607,6151,-
chr9,130268141,4.759572415497125,3824,2829,6653,-
chr9,130268244,4.194235229010917,1700,1185,2885,-
chr9,130268259,2.406868686868687,965,549,1514,-
chr9,130268260,2.406868686868687,965,549,1514,-
chr9,130268475,2.2936806791118878,1141,1237,2378,-
chr9,130268476,2.464301554447917,875,1085,1960,-
chr9,130268514,2.8436934952315074,1410,1268,2678,-
chr9,130268516,3.738442041013226,3163,2662,5825,-
chr9,130268517,4.524455640158289,2444,2007,4451,-
chr9,130268527,5.920988011988013,907,523,1430,-
chr9,130268528,6.65,734,349,1083,-
chr9,130268544,3.6288132508752176,745,435,1180,-
chr9,130268572,7.233920962468258,1500,868,2368,-
chr9,130268573,4.556462585034014,590,440,1030,-
chr9,130268574,9.734425966181606,1839,1005,2844,-
chr9,130268598,3.1584287961585567,2351,1292,3643,-
chr9,130268599,3.189595518716688,2152,1164,3316,-
chr9,130268841,2.3371598639455784,716,391,1107,-
chr9,130268909,0.6413281773006106,2051,1476,3527,-
chr9,130268955,1.5772629310344828,713,639,1352,-
chr9,130268966,0.522768670309654,573,548,1121,-
chr9,130268968,0.4537549407114624,614,574,1188,-
chr9,130268973,0.6181423961274707,532,535,1067,-
chr9,130268981,3.787150760711586,1137,1174,2311,-
chr9,130269004,20.27010914604528,2629,2301,4930,-
chr9,130269006,18.099565654904872,3943,3070,7013,-
chr9,130269007,22.625731461219726,2630,1877,4507,-
chr9,130269012,5.0739549930880266,1813,846,2659,-
chr9,130269013,4.616925064599482,1020,386,1406,-
chr9,130269314,3.626889506800218,854,483,1337,-
chr9,130269325,2.218856548971717,719,388,1107,-
chr9,130269523,2.3230490018148817,863,512,1375,-
chr9,130269524,2.3230490018148817,863,512,1375,-
chr9,130269525,1.1363154035410135,643,467,1110,-
chr9,130270228,0.634134419551935,555,490,1045,-
chr9,130270420,0.5127717391304348,665,551,1216,-
chr9,130270702,1.0852480228525163,1374,893,2267,-
chr9,130270734,0.627906976744186,701,493,1194,-
chr9,130271349,2.1575887392900857,640,515,1155,-
chr9,130271408,2.0324214792299897,766,610,1376,-
chr9,130279173,2.40438295804664,1653,1180,2833,-
chr9,130279186,1.294295170354289,984,723,1707,-
chr9,130279284,3.213355592654424,801,598,1399,-
chr9,130279285,3.213355592654424,801,598,1399,-
chr9,130280129,2.3372035524138153,1441,891,2332,-
chr9,130280179,1.6372971602434077,629,492,1121,-
chr9,130280208,2.741751122158019,846,665,1511,-
chr9,130286080,1.9349962207105065,719,566,1285,-
chr9,130286113,1.736281503649622,1411,951,2362,-
chr9,130287393,2.0366946778711483,660,419,1079,-
chr9,130289481,0.432213608957795,771,515,1286,-
chr9,130289530,1.679327521793275,650,510,1160,-
chr9,130289575,3.297542352660463,690,380,1070,-
chr9,130294008,1.399350170492753,4772,3474,8246,-
chr9,130294013,1.5232863492534818,2431,2133,4564,-
chr9,130294014,1.5465903288948195,4384,3322,7706,-
chr9,130294020,1.8443597177971232,2642,1806,4448,-
chr9,130294023,1.4531024531024532,1557,901,2458,-
chr9,130294044,1.332205377326713,3135,2279,5414,-
chr9,130294045,1.689745520252974,1351,1144,2495,-
chr9,130294055,1.7246330364568137,1695,1153,2848,-
chr9,130294057,1.4087581699346403,828,629,1457,-
chr9,130331234,1.9380811386421488,454,620,1074,-
chr9,130331235,2.522166797722241,734,790,1524,-
chr9,130331236,6.923300806564728,660,805,1465,-
chr9,130635312,1.5926229508196723,1942,1589,3531,-
chr9,130635318,1.3863264420401669,3230,2065,5295,-
chr9,130635330,1.0889004658466552,2113,1335,3448,-
chr9,130635333,1.9231109147149799,815,437,1252,-
chr9,130635339,0.6885328254021412,1289,892,2181,-
chr9,130636892,0.6262787727315539,1238,865,2103,-
chr9,130636897,1.7341855129465746,857,677,1534,-
chr9,130636915,2.187178740969963,1002,741,1743,-
chr9,130674751,1.5406013257575757,684,351,1035,-
chr9,130674752,1.734615384615385,901,454,1355,-
chr9,130674753,1.734615384615385,901,454,1355,-
chr9,130674754,2.8251879699248126,667,335,1002,-
chr9,130883423,2.59047619047619,611,404,1015,-
chr9,130886044,2.956714761376249,887,476,1363,-
chr9,130886046,2.956714761376249,887,476,1363,-
chr9,130886803,4.378511235955056,644,533,1177,-
chr9,130886804,4.378511235955056,644,533,1177,-
chr9,130931734,0.6615322339315848,699,424,1123,-
chr9,130942762,1.9202893462812494,688,456,1144,-
chr9,131018436,3.691482226693495,515,496,1011,-
chr9,131018437,3.691482226693495,515,496,1011,-
chr9,131022757,0.5863669457590098,757,535,1292,-
chr9,131022762,2.028701756118254,1177,911,2088,-
chr9,131022767,2.1431518496835884,1302,1086,2388,-
chr9,131022768,2.0995553564575657,1876,1480,3356,-
chr9,131024926,0.5827511513234227,840,653,1493,-
chr9,131396003,5.24383912742062,1161,847,2008,-
chr9,131396004,6.517824074074074,760,539,1299,-
chr9,131396155,1.7757823986557446,913,528,1441,-
chr9,131396223,1.6166941241076331,735,606,1341,-
chr9,131396238,0.4963846003517686,761,601,1362,-
chr9,131396244,1.890604738889544,593,498,1091,-
chr9,131396570,0.5735887096774194,568,479,1047,-
chr9,131396994,1.1739605580375245,1065,714,1779,-
chr9,131397026,0.9446022727272728,664,571,1235,-
chr9,131397028,1.4666799659138385,897,737,1634,-
chr9,131403072,0.5881696428571428,526,503,1029,-
chr9,131403079,1.8577368577368576,694,480,1174,-
chr9,131418821,1.0733333333333333,712,464,1176,-
chr9,131418822,1.0733333333333333,712,464,1176,-
chr9,131860925,2.479517118543439,736,488,1224,-
chr9,131860926,2.479517118543439,736,488,1224,-
chr9,131860927,2.085544951870186,888,595,1483,-
chr9,131940236,2.638655462184874,627,461,1088,-
chr9,131940237,2.638655462184874,627,461,1088,-
chr9,132575967,1.9868659420289858,748,482,1230,-
chr9,132575969,1.5546988667202164,952,666,1618,-
chr9,132576333,1.3393885772192295,732,550,1282,-
chr9,132581080,3.0409556313993176,593,585,1178,-
chr9,132581081,3.1156649120769155,978,821,1799,-
chr9,132593216,2.3353024023043365,676,479,1155,-
chr9,132593280,2.680565897244973,799,473,1272,-
chr9,132593282,2.680565897244973,799,473,1272,-
chr9,135251442,3.4236641221374047,505,523,1028,-
chr9,135251443,3.4236641221374047,505,523,1028,-
chr9,135277015,0.49934277785891634,788,500,1288,-
chr9,135277016,2.248563828598252,1377,1077,2454,-
chr9,135277017,1.7571288743882545,815,612,1427,-
chr9,135277018,2.2699549070042626,2614,1936,4550,-
chr9,135277019,2.293543543543544,1879,1331,3210,-
chr9,135277020,2.293543543543544,1879,1331,3210,-
chr9,135277051,0.5145352804694964,579,430,1009,-
chr9,135487534,1.6800322042910116,1763,1476,3239,-
chr9,135487535,1.7923079215266977,2576,2118,4694,-
chr9,135487538,3.35390625,635,511,1146,-
chr9,135487546,2.663615560640733,581,436,1017,-
chr9,135487557,1.7,798,563,1361,-
chr9,135487570,1.3624217223411654,797,577,1374,-
chr9,136219341,1.238709040654522,684,460,1144,-
chr9,136219421,2.5155405405405404,656,443,1099,-
chr9,136219423,2.5155405405405404,656,443,1099,-
chr9,136228494,6.390253536371004,4051,9309,13360,-
chr9,136228498,28.556848202703716,8196,7266,15462,-
chr9,136228499,28.556848202703712,8196,7266,15462,-
chr9,136228500,16.79176755447942,2773,2182,4955,-
chr9,136228505,1.5916244331821816,917,488,1405,-
chr9,136228507,1.8675382782112104,2214,1125,3339,-
chr9,136228508,2.6014644121462656,2571,1245,3816,-
chr9,136228509,2.2589655496432397,4785,2370,7155,-
chr9,136228510,3.7147811363379573,5863,2975,8838,-
chr9,136228512,4.727356603164239,4131,2125,6256,-
chr9,136228531,1.095932690681549,1057,647,1704,-
chr9,136228532,1.406589308309861,1647,966,2613,-
chr9,136228654,0.6163316341252284,711,561,1272,-
chr9,136228916,1.835224884405212,1035,792,1827,-
chr9,136228951,1.4713225549960245,1290,769,2059,-
chr9,136228952,1.4767487684729064,1152,874,2026,-
chr9,136228983,3.204752604166667,894,575,1469,-
chr9,136229241,0.7328850855745721,1634,1226,2860,-
chr9,136229375,2.199760109772804,1098,683,1781,-
chr9,136229380,6.5375647668393775,720,385,1105,-
chr9,136229383,2.660377358490566,704,370,1074,-
chr9,136229891,1.8123936816524908,1016,822,1838,-
chr9,136230003,0.6675471698113207,975,847,1822,-
chr9,136230018,2.155528554070474,886,822,1708,-
chr9,136230027,1.4865853658536583,1218,819,2037,-
chr9,136230078,1.4884639668128656,1097,938,2035,-
chr9,136230105,1.8214988381725354,1700,1165,2865,-
chr9,136230289,2.486230876216968,871,718,1589,-
chr9,136230296,1.5014813351767724,1447,995,2442,-
chr9,136230340,1.7319766183156526,799,595,1394,-
chr9,136230360,1.4046922548345933,1153,834,1987,-
chr9,136230584,1.5585295206110426,2474,1797,4271,-
chr9,136230634,0.6724994688106156,1662,1246,2908,-
chr9,136231737,2.0142109955628187,2195,1849,4044,-
chr9,136231798,1.2113658619458034,2048,1537,3585,-
chr9,136231843,1.0783898720731346,2334,1450,3784,-
chr9,136231849,0.5425335368302675,920,632,1552,-
chr9,136231862,0.5953058321479374,836,591,1427,-
chr9,136234152,0.5186682520808562,726,579,1305,-
chr9,136234211,1.872171945701357,1654,883,2537,-
chr9,136234212,1.872171945701357,1654,883,2537,-
chr9,136234270,1.6440923096271145,768,588,1356,-
chr9,136242823,2.6345776031434185,595,508,1103,-
chr9,136242825,2.6345776031434185,595,508,1103,-
chr9,138825313,2.070381620858963,819,654,1473,-
chr9,138825315,1.6151966229726729,726,642,1368,-
chr9,138825316,2.5688457172664627,847,724,1571,-
chr9,138830115,0.689392080172954,559,467,1026,-
chr9,138845554,1.2626715035567355,718,607,1325,-
chr9,139099408,1.8087999999999997,645,499,1144,-
chr9,139100493,2.00377358490566,707,317,1024,-
chr9,139100512,1.3282826906491192,868,434,1302,-
chr9,139101048,0.8733052330994954,677,572,1249,-
chr9,139115634,0.9105896787056208,624,482,1106,-
chr9,139115635,0.9105896787056208,624,482,1106,-
chr9,139115645,5.1048859162916385,711,498,1209,-
chr9,139115929,1.3666922320624315,599,426,1025,-
chr9,139297267,2.6382080989789123,1039,665,1704,-
chr9,139297305,2.658045701364833,648,451,1099,-
chr9,139299126,1.696298998521539,621,486,1107,-
chr9,139304578,2.2088161271834745,1080,818,1898,-
chr9,139304579,2.2088161271834745,1080,818,1898,-
chr9,139304602,4.535175879396984,721,397,1118,-
chr9,139304603,4.535175879396984,721,397,1118,-
chr9,139619240,1.5101587770723548,3500,2496,5996,-
chr9,139619274,1.4647649193695318,1260,930,2190,-
chr9,139619275,2.627627627627628,599,443,1042,-
chr9,139619290,0.6011437433362411,885,723,1608,-
chr9,139619315,2.318250115580213,1134,720,1854,-
chr9,139619316,2.1381578947368425,779,455,1234,-
chr9,139619550,2.937019062632554,722,480,1202,-
chr9,139620858,0.54645733585718,1711,1282,2993,-
chr9,139620859,0.5329726346815791,2474,1892,4366,-
chr9,139620861,0.4935440112540193,1592,1243,2835,-
chr9,139622427,8.4931944542825,640,598,1238,-
chr9,139622429,7.379277546334894,640,643,1283,-
chr9,139622477,16.854209772043493,822,482,1304,-
chr9,139756721,1.6926879505664263,1173,970,2143,-
chr9,139756740,2.049483958716697,1688,1292,2980,-
chr9,139756741,2.049483958716697,1688,1292,2980,-
chr9,139757374,1.6982591876208897,877,751,1628,-
chr9,139757449,1.6421232426374104,3251,2498,5749,-
chr9,139757773,0.6395051404397658,962,700,1662,-
chr9,139757827,1.4592183371650138,3865,3170,7035,-
chr9,139757830,1.233237094880222,9496,6306,15802,-
chr9,139757833,1.421215836157785,6063,4311,10374,-
chr9,139757835,1.421215836157785,6063,4311,10374,-
chr9,139758274,1.4544036601850887,3151,2607,5758,-
chr9,139758276,1.5555340453938582,4568,3744,8312,-
chr9,139758277,1.5366110887906788,2913,2357,5270,-
chr9,139758315,1.4947602393991433,4499,3421,7920,-
chr9,139760643,1.6775325888532882,2108,1691,3799,-
chr9,139760661,1.641170915958451,1184,705,1889,-
chr9,139760669,1.7146029461046361,3498,2245,5743,-
chr9,139760670,1.8506209751609937,1462,1086,2548,-
chr9,139760671,1.6061291000841045,2036,1159,3195,-
chr9,139760718,1.8412745681953546,686,437,1123,-
chr9,139760722,0.6345832365672774,1527,797,2324,-
chr9,139760728,6.127320954907161,629,376,1005,-
chr9,139760748,2.6891668721323843,899,503,1402,-
chr9,139760752,0.7516184230630593,1154,495,1649,-
chr9,139836552,2.6612103174603177,724,503,1227,-
chr9,139836553,2.427687930133809,1313,847,2160,-
chr9,139837836,1.84816247582205,1889,989,2878,-
chr9,139837837,1.867483978524543,4268,2466,6734,-
chr9,139837838,1.757752587133967,1954,1298,3252,-
chr9,139837840,1.687536999340505,1917,1136,3053,-
chr9,139837848,0.5308388157894737,1290,683,1973,-
chr9,139837849,0.959217757413018,1813,985,2798,-
chr9,140006636,1.864703827501495,1001,744,1745,-
chr9,140007718,0.6015960374243258,642,394,1036,-
chr9,140007725,2.0455598455598456,882,664,1546,-
chr9,140007727,2.0455598455598456,882,664,1546,-
chr9,140008472,1.7200072538190554,637,484,1121,-
chr9,140008715,1.5117740353136764,667,439,1106,-
chr9,140008800,1.6506633614832273,992,643,1635,-
chr9,140008947,1.4168245496217835,655,461,1116,-
chr9,140008964,1.369290912981604,636,482,1118,-
chr9,140099416,1.6525630165535172,718,551,1269,-
chr9,140099520,0.9306130718900597,650,499,1149,-
chr9,140476703,18.385727819002174,1856,1439,3295,-
chr9,140476704,18.385727819002174,1856,1439,3295,-
chr9,140477051,1.0972536473282672,946,663,1609,-
chr10,871204,1.6967673153704779,1048,737,1785,-
chr10,871211,1.7029017659064691,1009,763,1772,-
chr10,871213,1.7029017659064691,1009,763,1772,-
chr10,1086175,2.0328601472134595,835,633,1468,-
chr10,1086228,0.5943287037037036,1026,782,1808,-
chr10,1086247,1.6545939933259177,906,724,1630,-
chr10,1086265,1.9141440776289413,697,498,1195,-
chr10,1086266,1.7378472222222223,714,383,1097,-
chr10,1086702,1.4767998219650609,1105,816,1921,-
chr10,1086782,1.660853432282004,1118,615,1733,-
chr10,1086880,1.5204301075268818,1211,929,2140,-
chr10,1087260,2.7657199378267627,850,673,1523,-
chr10,1088574,1.9651695692025661,1439,1090,2529,-
chr10,1088575,1.9651695692025661,1439,1090,2529,-
chr10,1089267,2.168274163759491,1173,885,2058,-
chr10,1090036,0.5427542754275427,602,504,1106,-
chr10,1090069,1.9419496166484118,590,497,1087,-
chr10,1090081,2.165399449035813,913,725,1638,-
chr10,1090082,2.165399449035813,913,725,1638,-
chr10,1090085,1.1475181260457334,822,651,1473,-
chr10,1090086,1.1475181260457334,822,651,1473,-
chr10,1090099,1.9376409925878182,924,641,1565,-
chr10,1090101,1.9376409925878182,924,641,1565,-
chr10,5807486,1.4854215918045706,1304,845,2149,-
chr10,5807568,1.7978486646884273,916,673,1589,-
chr10,5807675,1.3989881956155144,1585,1185,2770,-
chr10,5807728,1.991647331786543,1072,861,1933,-
chr10,5807729,1.991647331786543,1072,861,1933,-
chr10,5807929,1.634917601087326,2594,1743,4337,-
chr10,5807981,1.5941128040279822,4119,3045,7164,-
chr10,5808109,1.4764988808990904,2066,1264,3330,-
chr10,5808110,0.4991081382385731,1627,1299,2926,-
chr10,5808212,1.8578428673677256,1183,885,2068,-
chr10,5810188,2.3969509564216884,640,408,1048,-
chr10,5810196,0.586568715180556,1310,706,2016,-
chr10,5810198,0.9005445454488566,1887,1194,3081,-
chr10,5810230,2.790476723049229,1112,637,1749,-
chr10,5810232,3.079107505070993,758,376,1134,-
chr10,5810346,1.7290980539138625,10625,8078,18703,-
chr10,5815822,1.4103553317946835,15242,9237,24479,-
chr10,5815841,1.308629283489097,4941,2674,7615,-
chr10,5815846,1.7583257513090527,18163,11697,29860,-
chr10,5815870,0.7446519246519245,3496,2034,5530,-
chr10,5815891,1.603525953784142,4359,2460,6819,-
chr10,5815900,1.6200732402007325,1895,1009,2904,-
chr10,5827115,1.6916889397989054,1413,872,2285,-
chr10,5827149,0.5190474604496252,1997,1200,3197,-
chr10,5827995,1.5913046505151769,1114,797,1911,-
chr10,5842577,2.4180402467388005,853,681,1534,-
chr10,5842648,1.8970692090395482,920,530,1450,-
chr10,5842650,1.8642033898305084,886,589,1475,-
chr10,5842664,1.6846736652051746,3204,2123,5327,-
chr10,5842665,0.8686383112132929,2077,1366,3443,-
chr10,5842667,0.5772203218041303,1339,876,2215,-
chr10,5855201,1.5185419141719112,1547,1072,2619,-
chr10,5855384,3.66969696969697,864,329,1193,-
chr10,5855386,3.5607942765988856,1106,464,1570,-
chr10,5994483,1.097458833368061,835,629,1464,-
chr10,12209746,1.0833361480498245,2134,1456,3590,-
chr10,12209794,1.7277389277389281,980,584,1564,-
chr10,12209797,0.5587167070217918,922,531,1453,-
chr10,12212741,0.5831896551724138,901,579,1480,-
chr10,12212746,1.8016507271059872,572,448,1020,-
chr10,12214789,1.5806182121971597,1117,740,1857,-
chr10,12215760,0.6294544956140351,834,607,1441,-
chr10,12215766,1.9707602339181285,673,607,1280,-
chr10,12215786,1.588595312733244,625,461,1086,-
chr10,12215793,0.6361803980851599,706,566,1272,-
chr10,12219862,2.1973333333333334,823,599,1422,-
chr10,12228279,1.758396598846037,1231,889,2120,-
chr10,12228291,1.505428226779252,959,828,1787,-
chr10,12228326,2.7985235607113754,972,906,1878,-
chr10,12228328,2.3268159202226726,2606,2090,4696,-
chr10,12237785,0.6828318656229616,778,583,1361,-
chr10,13364905,1.062277220192437,695,448,1143,-
chr10,13364906,1.062277220192437,695,448,1143,-
chr10,14563992,2.2480409670120283,1387,932,2319,-
chr10,14563993,2.2480409670120283,1387,932,2319,-
chr10,14572434,2.8834546833359203,763,518,1281,-
chr10,16794926,2.391099450824475,1101,769,1870,-
chr10,16806496,1.1694719978741561,1301,1210,2511,-
chr10,16824040,3.172151898734177,536,473,1009,-
chr10,16824043,2.0238357370912694,854,585,1439,-
chr10,16824044,2.1348609853744684,1481,1137,2618,-
chr10,16824060,0.9468599033816424,636,413,1049,-
chr10,16824061,0.9468599033816424,636,413,1049,-
chr10,17645740,2.5627422974903085,627,376,1003,-
chr10,17646004,3.388448249424994,718,542,1260,-
chr10,17659099,0.5549839220188892,615,471,1086,-
chr10,17659126,2.2397903195862345,615,437,1052,-
chr10,24873960,5.16585524180461,1037,710,1747,-
chr10,24874811,2.8360462511488467,713,542,1255,-
chr10,24884855,3.098167476832417,888,595,1483,-
chr10,24885737,2.3664856396714,599,456,1055,-
chr10,24896429,1.6044921552436004,2375,1556,3931,-
chr10,24896431,1.4472010904742647,6795,5134,11929,-
chr10,24896433,1.579815466875326,2232,2159,4391,-
chr10,24896438,1.7950666633766788,1833,1538,3371,-
chr10,24896439,1.7950666633766788,1833,1538,3371,-
chr10,24896448,1.729019941696979,1456,1061,2517,-
chr10,24896450,1.729019941696979,1456,1061,2517,-
chr10,24896494,3.482895783611774,596,418,1014,-
chr10,24896524,2.948347544218167,1045,616,1661,-
chr10,24896525,2.948347544218167,1045,616,1661,-
chr10,24896703,0.5513266637668551,584,417,1001,-
chr10,24896705,0.5392357839755368,844,610,1454,-
chr10,27057886,0.2522868832026302,578,486,1064,-
chr10,27399532,2.358583834335337,678,498,1176,-
chr10,27399780,3.4434058467379525,943,603,1546,-
chr10,27400168,0.6043158949645181,914,582,1496,-
chr10,27400611,2.0950570342205324,782,525,1307,-
chr10,27403500,2.1370087336244543,724,457,1181,-
chr10,27405156,0.9277558190601668,1013,758,1771,-
chr10,27405158,0.9277558190601668,1013,758,1771,-
chr10,27405179,2.070022306274852,666,490,1156,-
chr10,27405215,0.572812291249165,685,498,1183,-
chr10,27409472,0.5752239846110098,2720,1738,4458,-
chr10,27409473,0.5033349901144203,3198,2067,5265,-
chr10,27411860,1.7173099078341012,794,495,1289,-
chr10,27412479,1.693505338078292,809,561,1370,-
chr10,27412487,0.5289366053169734,738,488,1226,-
chr10,27423768,0.2220459212245659,792,486,1278,-
chr10,27431334,1.7403051493960584,656,428,1084,-
chr10,27431362,2.2350267379679143,642,373,1015,-
chr10,27431393,2.195121951219512,647,368,1015,-
chr10,27443136,0.8425549535713766,849,583,1432,-
chr10,27443137,1.6288568206773142,855,573,1428,-
chr10,27443238,6.833716204712135,809,554,1363,-
chr10,28812479,1.5727669710786183,578,457,1035,-
chr10,29759282,2.629619014256446,715,448,1163,-
chr10,29770594,2.963144963144963,602,406,1008,-
chr10,30602822,1.548640574202342,861,637,1498,-
chr10,32298294,1.9252635032823886,848,637,1485,-
chr10,32298456,1.78518895287206,937,651,1588,-
chr10,32298841,3.7072544853879497,832,771,1603,-
chr10,32298843,3.7072544853879497,832,771,1603,-
chr10,32299087,2.7143292682926825,613,409,1022,-
chr10,32299088,2.7143292682926825,613,409,1022,-
chr10,32299403,2.572087912087912,995,519,1514,-
chr10,32299404,2.48051191885038,1214,736,1950,-
chr10,32299524,3.531068296278187,589,415,1004,-
chr10,32306185,3.8276222089435734,1127,794,1921,-
chr10,32306186,4.348666246586852,646,528,1174,-
chr10,32308877,0.6758035662761845,2150,1208,3358,-
chr10,32308878,1.4000254024703902,1916,1226,3142,-
chr10,32309952,0.6710036760610449,1627,954,2581,-
chr10,32309957,3.102625298329356,1349,837,2186,-
chr10,32309966,2.025346724055476,1209,696,1905,-
chr10,32309984,1.681777125437507,960,520,1480,-
chr10,32310025,4.126142057176541,699,376,1075,-
chr10,32310176,2.513715710723192,839,400,1239,-
chr10,32310184,1.5690192603010877,1176,661,1837,-
chr10,32311909,2.640918198680847,619,444,1063,-
chr10,32321693,2.389799288617886,1074,983,2057,-
chr10,32321695,2.180957128614158,1574,1415,2989,-
chr10,32321696,1.8276683328432808,1018,894,1912,-
chr10,33189808,1.4899846017329579,2260,1647,3907,-
chr10,33189823,1.5739564929328622,1628,1131,2759,-
chr10,33189840,1.568192623609802,5120,3359,8479,-
chr10,33189852,1.866684289364702,1114,581,1695,-
chr10,33189860,2.569105691056911,868,450,1318,-
chr10,33189883,0.8246317849088609,1611,922,2533,-
chr10,33189884,0.8027156137472786,1555,978,2533,-
chr10,33189886,1.066326530612245,989,629,1618,-
chr10,33189887,1.8378680500930142,1802,1074,2876,-
chr10,33189889,1.7497725711527394,1385,882,2267,-
chr10,33189895,1.5527428176282823,808,543,1351,-
chr10,33189900,0.4336901121304791,687,403,1090,-
chr10,33190446,1.3824357220217218,2993,2118,5111,-
chr10,33190457,1.4691837883429917,3569,2547,6116,-
chr10,33190460,1.515519334142535,1310,710,2020,-
chr10,33190465,1.7065092165898617,789,495,1284,-
chr10,33190469,1.5686098654708522,953,668,1621,-
chr10,33190474,1.6922722029988466,1047,764,1811,-
chr10,33190476,1.5869391559046733,768,517,1285,-
chr10,33190481,2.44756711409396,1166,595,1761,-
chr10,33190483,2.0808930434838233,2132,1106,3238,-
chr10,33190485,2.751213729253698,1082,520,1602,-
chr10,33190497,2.632027257240204,1029,586,1615,-
chr10,33190498,2.632027257240204,1029,586,1615,-
chr10,33200524,1.3952028480308536,3093,2424,5517,-
chr10,33201003,0.7346201193877314,2136,1904,4040,-
chr10,33201021,1.3695154812140935,3065,2313,5378,-
chr10,33212564,1.3602671735572098,2830,1769,4599,-
chr10,33212566,0.7703375760929717,2319,1806,4125,-
chr10,33214814,1.6351309588532033,5387,3777,9164,-
chr10,33217131,1.3115876250463134,3826,2698,6524,-
chr10,33218792,1.3118315331312436,253434,188211,441645,-
chr10,33218794,1.2262380498714707,335278,251086,586364,-
chr10,33218795,1.1422775766971185,167523,129524,297047,-
chr10,33218799,1.6064296182089914,24960,21402,46362,-
chr10,33218814,1.106026353752507,40714,24904,65618,-
chr10,33218816,1.040473415886352,71827,48327,120154,-
chr10,33218826,1.3072808279445245,12999,9904,22903,-
chr10,33218846,1.1524657705394268,98740,69660,168400,-
chr10,33218847,1.1570407799632592,108866,75966,184832,-
chr10,33218848,1.169775257548214,130686,92009,222695,-
chr10,33218849,1.0821316454290808,93458,65431,158889,-
chr10,33218882,1.5080043925326945,6090,4451,10541,-
chr10,33218924,1.3574309185959672,2943,2368,5311,-
chr10,33224449,1.4335125448028676,1683,1439,3122,-
chr10,33224483,0.6522282608695653,1090,799,1889,-
chr10,33224485,1.3379897785349233,1631,1173,2804,-
chr10,33247088,2.1951901565995526,784,446,1230,-
chr10,33247124,1.0904276240165294,882,735,1617,-
chr10,33502417,6.981766249295923,6484,4232,10716,-
chr10,33502418,6.981766249295923,6484,4232,10716,-
chr10,33502429,2.120045623039635,1486,667,2153,-
chr10,33502431,2.120045623039635,1486,667,2153,-
chr10,33502432,2.2884979702300403,1207,738,1945,-
chr10,33502434,2.2884979702300403,1207,738,1945,-
chr10,33502443,1.2891741683944837,1069,528,1597,-
chr10,33502486,2.284375,730,319,1049,-
chr10,34620064,3.355319759105248,1169,950,2119,-
chr10,34620088,0.874390243902439,1433,819,2252,-
chr10,34620089,1.1465600306540666,2202,1334,3536,-
chr10,34620116,1.8330058939096268,932,508,1440,-
chr10,34620118,1.8330058939096268,932,508,1440,-
chr10,36812334,1.053984071862084,893,689,1582,-
chr10,43882014,1.6242308138859862,1141,956,2097,-
chr10,43882085,0.5130780498012136,1225,1061,2286,-
chr10,43882144,2.188782489740082,639,429,1068,-
chr10,43882166,2.005987532808399,660,507,1167,-
chr10,43882249,2.029319041614124,941,731,1672,-
chr10,43882427,1.7184801381692574,1591,1157,2748,-
chr10,43882437,0.6291479083413425,1950,1491,3441,-
chr10,43882439,1.126375298516881,2636,1936,4572,-
chr10,43882463,3.0639764486249734,1015,732,1747,-
chr10,43882481,1.6679447852760738,1304,977,2281,-
chr10,43882509,1.5683111954459203,1217,867,2084,-
chr10,43882568,1.9010560146923785,1182,659,1841,-
chr10,43882598,1.6451839785771605,1797,1092,2889,-
chr10,43882613,2.3577860169491527,613,471,1084,-
chr10,43882676,1.1945087637380838,2217,1426,3643,-
chr10,43882793,2.824451410658307,847,637,1484,-
chr10,43882859,1.7861343790367912,5835,4343,10178,-
chr10,43882860,2.1121894215011845,3465,2772,6237,-
chr10,43882883,1.5374921235034658,1359,1057,2416,-
chr10,43882955,1.4118412491867274,1518,1112,2630,-
chr10,43882965,1.9790090771558244,896,660,1556,-
chr10,43883129,1.50173044387816,1909,1382,3291,-
chr10,43883192,1.4735755242792414,1096,977,2073,-
chr10,43883249,1.447830101569714,1279,759,2038,-
chr10,43883331,1.8363939899833055,699,598,1297,-
chr10,43891928,1.3270913067249863,1386,867,2253,-
chr10,43891973,1.60156994673395,771,614,1385,-
chr10,43892030,1.6594285714285717,725,624,1349,-
chr10,43892033,1.558857142857143,929,624,1553,-
chr10,43903187,1.9382459683748967,652,443,1095,-
chr10,43903230,1.6888752541369965,752,432,1184,-
chr10,43903231,1.292792792792793,692,406,1098,-
chr10,43903232,1.292792792792793,692,406,1098,-
chr10,51592246,0.619445372535917,720,510,1230,-
chr10,51592257,1.519834850593138,1327,1028,2355,-
chr10,51592575,1.7103572636087008,541,466,1007,-
chr10,52279631,3.2829500479009495,840,695,1535,-
chr10,53457230,0.1887906976744185,450,859,1309,-
chr10,53457231,0.1887906976744185,450,859,1309,-
chr10,53457234,0.24133811230585422,403,836,1239,-
chr10,53457235,0.2473304351496222,585,1246,1831,-
chr10,53457237,0.1832727272727272,377,824,1201,-
chr10,53457264,77.92753937061644,1161,1296,2457,-
chr10,53457265,78.46792489470295,1069,1068,2137,-
chr10,53458070,1.5521008168442094,1970,1571,3541,-
chr10,53458075,2.185555555555556,1404,1124,2528,-
chr10,53458076,1.4654070125576457,2410,1849,4259,-
chr10,53458081,2.6552287581699345,649,475,1124,-
chr10,53458104,0.4070149253731343,908,499,1407,-
chr10,53458105,0.4070149253731343,908,499,1407,-
chr10,53458175,1.266403909692196,592,415,1007,-
chr10,58117653,0.8506944444444445,594,543,1137,-
chr10,58117654,0.8506944444444445,594,543,1137,-
chr10,58117696,5.920300995922632,602,432,1034,-
chr10,58118192,0.33355860405438725,624,457,1081,-
chr10,65662214,0.3729672835716165,1118,876,1994,-
chr10,65662217,3.0079320467178814,859,592,1451,-
chr10,65662228,1.790725675235926,1078,877,1955,-
chr10,65662230,1.790725675235926,1078,877,1955,-
chr10,69565436,2.883966087955144,662,468,1130,-
chr10,69583084,0.4386481394253414,744,578,1322,-
chr10,69597770,1.9698331193838254,681,655,1336,-
chr10,69597783,1.7070135746606334,502,519,1021,-
chr10,69597823,1.8865624210337482,721,508,1229,-
chr10,69597852,0.38758071865418053,651,516,1167,-
chr10,69597884,1.1801712591842668,678,473,1151,-
chr10,69684914,2.996734581005825,882,608,1490,-
chr10,69714786,3.818956336528221,814,625,1439,-
chr10,69714788,3.5026297772129475,1093,800,1893,-
chr10,69748548,0.5888281503434581,1638,1079,2717,-
chr10,69748572,2.1710044414915783,1433,1178,2611,-
chr10,69748574,1.9254355400696863,613,409,1022,-
chr10,69748589,1.3602275243841704,1367,1036,2403,-
chr10,69749978,1.7297993151933937,1120,811,1931,-
chr10,69749992,0.3554054054054054,788,554,1342,-
chr10,69749993,0.8998101279823969,1152,808,1960,-
chr10,69749999,2.8988270816180637,965,619,1584,-
chr10,69750001,3.039672192214565,679,412,1091,-
chr10,71876510,3.9379781855955676,760,570,1330,-
chr10,71910689,4.339441124945183,1152,806,1958,-
chr10,71911948,1.9198526498397541,783,596,1379,-
chr10,71917523,2.033423765599566,693,484,1177,-
chr10,71921414,1.7604119993461846,3987,2794,6781,-
chr10,71921415,2.080822463444415,3166,2183,5349,-
chr10,71921417,2.1028094834023743,5853,3545,9398,-
chr10,71921418,1.8624645096706667,4788,2805,7593,-
chr10,71921419,2.0515056687015853,2665,1543,4208,-
chr10,71921621,1.911900871459695,738,611,1349,-
chr10,71921645,1.4108439201451903,690,455,1145,-
chr10,71921657,2.472597793902576,1227,858,2085,-
chr10,71921673,1.8261060972925385,1036,648,1684,-
chr10,71921675,1.8261060972925385,1036,648,1684,-
chr10,71964638,2.022346716464364,1225,944,2169,-
chr10,71964649,1.594521535411786,1579,894,2473,-
chr10,71964656,1.8159634240387796,890,625,1515,-
chr10,71974268,1.776740740740741,1252,1049,2301,-
chr10,71978526,1.665260736196319,1633,1303,2936,-
chr10,71978549,1.6810805760026577,2023,1578,3601,-
chr10,71978555,1.4093423714513085,1908,1468,3376,-
chr10,71990148,0.6661542403279529,1699,1300,2999,-
chr10,71990153,0.6783553574271614,1481,1141,2622,-
chr10,71993046,1.1191272729197925,1843,1224,3067,-
chr10,71993048,1.6144240570846073,723,653,1376,-
chr10,71993070,1.5912236987818382,626,503,1129,-
chr10,71993081,0.8603939661660287,1222,1001,2223,-
chr10,71993083,0.7114201418661869,1642,1384,3026,-
chr10,71993119,0.46913976767838983,625,478,1103,-
chr10,71993120,0.46913976767838983,625,478,1103,-
chr10,73576123,1.696259029927761,1528,1519,3047,-
chr10,73576222,9.239485232381957,25137,16702,41839,-
chr10,73576223,9.23948523238196,25137,16702,41839,-
chr10,73576224,9.23948523238196,25137,16702,41839,-
chr10,73576492,0.5788490241647484,12925,17350,30275,-
chr10,73576494,0.5932398240160563,18916,25534,44450,-
chr10,73576495,0.6468370711190654,12223,16658,28881,-
chr10,73576504,14.741305080454865,37208,50902,88110,-
chr10,73576505,14.741305080454861,37208,50902,88110,-
chr10,73576511,20.193333284288883,50910,26944,77854,-
chr10,73576512,20.792769326020718,54589,27724,82313,-
chr10,73576513,20.715698869048804,46480,21135,67615,-
chr10,73576514,5.886497064579256,11185,2554,13739,-
chr10,73576520,5.795402735562309,10168,1959,12127,-
chr10,73576521,4.077116433002851,32036,6420,38456,-
chr10,73576522,3.5150492429317977,16788,3511,20299,-
chr10,73576523,3.79710362734286,34942,7365,42307,-
chr10,73576744,1.2177581327977425,4796,3997,8793,-
chr10,73576784,1.5539144366102684,11024,7891,18915,-
chr10,73576849,1.374170893484198,3521,2562,6083,-
chr10,73577013,1.9097283010915294,12079,8933,21012,-
chr10,73577177,1.2727477436547303,10821,7695,18516,-
chr10,73577222,1.2256495584282605,4255,2403,6658,-
chr10,73578479,1.4238375882984338,9203,6809,16012,-
chr10,73578833,1.5747643481995524,4097,3402,7499,-
chr10,73579299,1.177824263923246,6109,3885,9994,-
chr10,73579300,1.2507288629737607,4454,3674,8128,-
chr10,73579333,1.3152251261384615,6774,5512,12286,-
chr10,73579334,1.3152251261384615,6774,5512,12286,-
chr10,73579477,1.4847600763126407,3878,2386,6264,-
chr10,73580046,1.2116906213443877,6452,5017,11469,-
chr10,73580093,1.013925296418375,873,692,1565,-
chr10,73581637,0.8359689406511316,7808,5712,13520,-
chr10,73581638,1.2424433452267385,4368,4032,8400,-
chr10,73581672,1.2994816625898513,10376,7530,17906,-
chr10,73581673,1.2546475718496908,4090,3681,7771,-
chr10,73585621,1.2620784336458482,6813,4392,11205,-
chr10,73585646,0.8499044218879297,6299,4897,11196,-
chr10,73587772,1.566745057862016,4077,3204,7281,-
chr10,73587819,1.4966637397630183,7651,5897,13548,-
chr10,73587912,1.4140265792018665,9347,6491,15838,-
chr10,73588737,1.4279616303439786,6549,4401,10950,-
chr10,73588781,1.694635223211157,4884,3754,8638,-
chr10,73588784,1.3559778081163008,4620,3436,8056,-
chr10,73590885,1.2264198965693431,11366,8831,20197,-
chr10,73590886,1.3192472359684488,9344,6922,16266,-
chr10,73590887,1.3192472359684488,9344,6922,16266,-
chr10,73591676,1.4914964495485228,4860,4147,9007,-
chr10,73594141,1.476238077322079,5483,3396,8879,-
chr10,73594153,1.1425402868239667,16777,12362,29139,-
chr10,73594170,1.3422994175443337,10012,6811,16823,-
chr10,73594201,1.1953575349220718,8075,6157,14232,-
chr10,73594233,1.2462777257669595,6092,4715,10807,-
chr10,73594234,1.2504350176518497,19786,14987,34773,-
chr10,73594235,1.1827376576827942,9827,8077,17904,-
chr10,73594236,1.316211515631842,20378,15940,36318,-
chr10,73594237,1.3570155748012371,14731,11422,26153,-
chr10,73594238,1.5299952077130772,7603,5596,13199,-
chr10,73594239,0.9829591887972385,5332,3449,8781,-
chr10,73594242,1.9364319652420396,2109,1458,3567,-
chr10,73594246,1.5458451592557554,1704,1358,3062,-
chr10,73610977,1.6818329195998396,4052,2558,6610,-
chr10,73610991,1.286104964539007,1857,1249,3106,-
chr10,73611005,0.9248644890288875,5162,3327,8489,-
chr10,73611006,0.9189360801324469,3669,2475,6144,-
chr10,73611008,1.0258800634053706,1333,950,2283,-
chr10,73611029,1.5008155736763518,882,692,1574,-
chr10,73611041,0.46981481703822064,759,503,1262,-
chr10,73921395,1.3894657537261998,1257,1088,2345,-
chr10,73921396,1.8686393805309736,698,677,1375,-
chr10,73956629,3.3919513037280797,722,481,1203,-
chr10,74236995,1.5128299336416102,840,588,1428,-
chr10,74767529,0.6187350835322196,609,418,1027,-
chr10,74769570,1.562566465792272,579,454,1033,-
chr10,74810814,2.3960946918232406,886,676,1562,-
chr10,74813126,2.4362204724409446,818,634,1452,-
chr10,74813127,2.4362204724409446,818,634,1452,-
chr10,74833543,0.38007533943672445,1613,1575,3188,-
chr10,74833558,0.4362005856515373,700,682,1382,-
chr10,74833569,2.3111239682534648,1248,1127,2375,-
chr10,74834575,2.3402712656836027,999,854,1853,-
chr10,75002705,0.38083510429638506,987,742,1729,-
chr10,75002910,14.676492814060452,1796,1110,2906,-
chr10,75002911,16.316739561686486,1457,963,2420,-
chr10,75003121,2.3210623115170144,860,602,1462,-
chr10,75003269,2.289035087719298,613,455,1068,-
chr10,75003271,3.045538915130431,1473,872,2345,-
chr10,75003272,3.6782296650717696,860,417,1277,-
chr10,75005907,1.464923347222519,879,574,1453,-
chr10,75005927,1.8280642590525766,677,467,1144,-
chr10,75006467,3.323155216284987,652,392,1044,-
chr10,75006468,3.323155216284987,652,392,1044,-
chr10,75010655,1.5957868390864531,1092,668,1760,-
chr10,75010715,1.697585513078471,648,496,1144,-
chr10,75010737,1.502268602540835,902,695,1597,-
chr10,75011532,0.5721767594108019,873,610,1483,-
chr10,75011607,0.5125815470643057,824,554,1378,-
chr10,75011633,1.8849649621869151,848,496,1344,-
chr10,75011699,1.6128205128205126,628,389,1017,-
chr10,75011715,2.897078255114716,819,510,1329,-
chr10,75012382,1.2077471359589393,569,508,1077,-
chr10,75135917,1.933189655172414,620,463,1083,-
chr10,75138735,2.0548340548340547,711,503,1214,-
chr10,75139790,1.8512937062937065,998,714,1712,-
chr10,75139846,1.4229080296413672,1799,1317,3116,-
chr10,75139924,1.8405228758169931,767,611,1378,-
chr10,75139937,3.12720156555773,657,510,1167,-
chr10,75142994,1.7664008506113766,897,626,1523,-
chr10,75143058,0.5817107721984447,964,625,1589,-
chr10,75143404,1.772685417713042,1032,723,1755,-
chr10,75147463,1.8938566552901024,894,585,1479,-
chr10,75147495,3.5125364431486883,752,489,1241,-
chr10,75158054,2.3301114261887217,555,461,1016,-
chr10,75173811,1.0672406348080234,1250,1025,2275,-
chr10,75182042,1.688715953307393,681,513,1194,-
chr10,75182043,1.9527186761229316,589,422,1011,-
chr10,75182044,1.9527186761229316,589,422,1011,-
chr10,75231258,1.9751119960179195,1023,573,1596,-
chr10,75231295,0.9361903474381509,830,568,1398,-
chr10,75231297,1.2333816314598745,1212,836,2048,-
chr10,75231298,0.9361397650706577,784,540,1324,-
chr10,75572479,0.5025462342535513,624,454,1078,-
chr10,75881699,1.8625187092215516,623,444,1067,-
chr10,75882364,2.692292907937728,823,472,1295,-
chr10,75882365,1.9616320778700858,1123,736,1859,-
chr10,75882540,1.148912642910763,583,435,1018,-
chr10,75882745,3.4824094735892106,685,497,1182,-
chr10,75888981,2.669387755102041,653,454,1107,-
chr10,75888982,2.669387755102041,653,454,1107,-
chr10,75893812,0.4584790046116618,671,487,1158,-
chr10,77160118,1.6681800444058614,1796,1330,3126,-
chr10,77160125,1.1748992439348938,1166,808,1974,-
chr10,79601675,1.827049916307324,2009,1528,3537,-
chr10,79601676,2.096904253962552,3957,2776,6733,-
chr10,79601678,1.955294451542465,3874,2645,6519,-
chr10,79601679,2.0253670634920637,1872,1343,3215,-
chr10,79601685,1.8391692514438276,1299,788,2087,-
chr10,79601724,1.7744353096463608,739,402,1141,-
chr10,79601774,6.83463719596883,691,436,1127,-
chr10,81917446,1.855919395465995,613,396,1009,-
chr10,81917513,0.4744910625620656,694,423,1117,-
chr10,81917779,1.354159733777038,793,600,1393,-
chr10,81917780,1.519212297447854,1047,781,1828,-
chr10,81921750,1.137680741701494,891,567,1458,-
chr10,81925842,1.630258977568114,638,610,1248,-
chr10,81925846,1.1594065798032152,1798,1300,3098,-
chr10,81925935,1.6298701298701297,752,573,1325,-
chr10,81926672,0.4833333333333334,724,524,1248,-
chr10,81926692,1.94979079497908,698,477,1175,-
chr10,81926721,2.7188030093044224,1028,654,1682,-
chr10,81926991,1.13109243697479,672,594,1266,-
chr10,81926992,1.612870599929331,1247,896,2143,-
chr10,88259745,2.450555261766261,661,426,1087,-
chr10,88259746,0.45666356011183606,769,406,1175,-
chr10,88259747,1.4148246033029768,1430,832,2262,-
chr10,88810453,0.5084512578616353,596,476,1072,-
chr10,88810685,1.7522269104547583,597,473,1070,-
chr10,88810925,2.1060299819969535,1388,952,2340,-
chr10,88810927,2.1976656626506026,897,663,1560,-
chr10,88811257,0.5701836290071585,686,458,1144,-
chr10,88811427,2.088340763713898,844,736,1580,-
chr10,88811428,2.088340763713898,844,736,1580,-
chr10,88818941,2.065331092173166,841,527,1368,-
chr10,88820541,1.4575263688511653,874,613,1487,-
chr10,89513031,2.0027527682501094,4947,4151,9098,-
chr10,89513032,1.6242822050939423,5730,4761,10491,-
chr10,89513073,1.6856566011235958,1037,711,1748,-
chr10,89513355,2.613168724279835,888,503,1391,-
chr10,89513356,2.665860957642725,1310,723,2033,-
chr10,89513358,3.301587301587302,857,461,1318,-
chr10,89513369,2.064430819243394,783,488,1271,-
chr10,89513609,1.8643031784841075,609,408,1017,-
chr10,89513679,1.5776930776930778,952,665,1617,-
chr10,89513904,3.1815696993361966,678,393,1071,-
chr10,89513992,1.1333333333333335,798,704,1502,-
chr10,89513993,1.984986963084946,1127,955,2082,-
chr10,89514170,1.653629316420014,721,472,1193,-
chr10,89514263,0.47685707834725666,703,411,1114,-
chr10,89514423,1.7176974892835273,1704,1632,3336,-
chr10,89514448,1.542491082994694,1401,1198,2599,-
chr10,89514504,2.2084714044456613,2260,1634,3894,-
chr10,89514505,2.2084714044456613,2260,1634,3894,-
chr10,89514508,2.2320543202838157,1991,1296,3287,-
chr10,89516622,2.092753132456419,1180,937,2117,-
chr10,89544298,1.6119410256022844,1639,1137,2776,-
chr10,89544304,2.0350256285086648,574,481,1055,-
chr10,89544350,2.219771241830065,987,543,1530,-
chr10,89544351,2.182615722326832,1336,777,2113,-
chr10,89550139,2.042931162102146,689,578,1267,-
chr10,89552434,1.5467576791808872,1235,878,2113,-
chr10,89552457,1.0890267927420252,1903,1575,3478,-
chr10,89552492,1.7325452237384957,752,547,1299,-
chr10,89552500,1.6240000000000003,782,674,1456,-
chr10,89574201,2.5099029510794213,684,560,1244,-
chr10,89574233,3.71024811218986,592,514,1106,-
chr10,89574358,2.0324701437937525,899,657,1556,-
chr10,89574365,0.9271857923497268,616,487,1103,-
chr10,89574367,0.9271857923497268,616,487,1103,-
chr10,90974207,1.1079545454545454,584,439,1023,-
chr10,90974209,1.1079545454545454,584,439,1023,-
chr10,95066578,0.39574388650364,635,486,1121,-
chr10,95069914,2.779287439613527,788,620,1408,-
chr10,95069916,2.779287439613527,788,620,1408,-
chr10,95072797,3.0672699849170435,655,509,1164,-
chr10,95072798,3.0672699849170435,655,509,1164,-
chr10,95072915,1.7797101449275363,613,413,1026,-
chr10,95076511,1.6503700008314626,862,632,1494,-
chr10,95079630,1.8531427907517135,637,452,1089,-
chr10,95082843,2.016217264243725,1001,826,1827,-
chr10,95082915,2.2625421132379318,792,578,1370,-
chr10,95089560,1.190359645096297,1186,885,2071,-
chr10,95093037,0.5994664192089085,607,465,1072,-
chr10,95093524,2.0243478260869567,581,459,1040,-
chr10,95093525,2.374296940122004,1327,1076,2403,-
chr10,95093527,2.8407054871220607,1111,892,2003,-
chr10,95093528,3.912989279481426,729,572,1301,-
chr10,95093601,1.0065230769230769,845,624,1469,-
chr10,95093602,1.0065230769230769,845,624,1469,-
chr10,95097593,1.6864608076009502,638,420,1058,-
chr10,95097613,1.6349067599067602,723,527,1250,-
chr10,95097617,2.2770215126666877,777,592,1369,-
chr10,95097662,0.5290815604509647,700,492,1192,-
chr10,95103658,2.535350918657229,657,440,1097,-
chr10,95109572,1.2440744104469321,972,707,1679,-
chr10,95109622,3.7970829091779796,870,619,1489,-
chr10,95116449,0.8613438999633447,1503,1189,2692,-
chr10,95116450,0.45106754621723605,1453,1051,2504,-
chr10,95116452,2.3535870431799566,923,663,1586,-
chr10,95116489,3.1597094839776205,1284,930,2214,-
chr10,95121230,1.9673835125448025,997,719,1716,-
chr10,95121232,2.071656049924582,1428,988,2416,-
chr10,95126174,3.1481102168202546,858,627,1485,-
chr10,95129453,0.4330013420922512,612,428,1040,-
chr10,95132724,2.6539275355728025,702,476,1178,-
chr10,95132807,2.859380594617587,744,546,1290,-
chr10,95134583,2.1487394323671496,759,529,1288,-
chr10,95134634,2.31719746013618,2893,2206,5099,-
chr10,95134663,1.5970010615711254,4349,2354,6703,-
chr10,95134665,1.5970010615711254,4349,2354,6703,-
chr10,95137095,0.7640781898513858,3356,1924,5280,-
chr10,95137096,1.1297984252520836,6273,3791,10064,-
chr10,95137097,1.2077103494064707,7649,4656,12305,-
chr10,95137099,1.5642781479187529,2814,1780,4594,-
chr10,95137102,1.4684490441282163,1276,772,2048,-
chr10,95137109,1.893838282727172,972,665,1637,-
chr10,95139741,3.0773176941748908,771,534,1305,-
chr10,95147598,0.5192189610708584,603,478,1081,-
chr10,95157191,1.9908322376775835,1272,891,2163,-
chr10,95162019,1.7157278588394975,1617,1262,2879,-
chr10,95162020,1.7157278588394975,1617,1262,2879,-
chr10,95168631,2.1383345227826194,721,468,1189,-
chr10,95241919,2.4615477091516555,823,628,1451,-
chr10,95720356,0.5317209239037997,1077,477,1554,-
chr10,95720358,0.6260525936198078,2018,989,3007,-
chr10,95720359,1.0531062604941237,783,378,1161,-
chr10,96097625,2.465242881072027,608,397,1005,-
chr10,96097627,2.652506033751237,1462,877,2339,-
chr10,96112125,1.6189251552614286,1697,1330,3027,-
chr10,96112140,2.248581560283688,745,563,1308,-
chr10,96112149,0.974440583678004,1978,1334,3312,-
chr10,96112151,0.5599078033976473,1977,1511,3488,-
chr10,96112658,2.1053905283043455,680,400,1080,-
chr10,97007051,2.241795627163539,785,693,1478,-
chr10,97007052,0.7454501915708812,565,521,1086,-
chr10,97007067,1.0591423216939544,697,574,1271,-
chr10,97031469,1.541489330505115,701,441,1142,-
chr10,97365812,2.073440285204991,726,560,1286,-
chr10,97369980,4.582578397212544,821,573,1394,-
chr10,97373772,0.42444685137786337,761,552,1313,-
chr10,97373861,0.4839854733667303,959,668,1627,-
chr10,97380892,3.1538163796047765,625,445,1070,-
chr10,97386509,0.42334096109839814,665,683,1348,-
chr10,97387211,2.4619565217391304,905,527,1432,-
chr10,97387212,1.741488753366008,1406,895,2301,-
chr10,97392804,0.4948883102144472,979,669,1648,-
chr10,97397048,2.8163398098816614,1133,886,2019,-
chr10,97397162,0.3418449505406027,742,620,1362,-
chr10,97397164,0.3418449505406027,742,620,1362,-
chr10,98280889,8.730009868725503,1794,1343,3137,-
chr10,98281071,2.018956711364462,2221,1713,3934,-
chr10,98281076,1.924332314576217,3931,2705,6636,-
chr10,98281078,1.924332314576217,3931,2705,6636,-
chr10,98281098,6.060575547024629,6834,4188,11022,-
chr10,98281117,1.79677272245114,3760,2102,5862,-
chr10,98281119,1.6854277527629962,2439,1395,3834,-
chr10,98281164,0.5820783132530121,772,497,1269,-
chr10,98281181,1.3586752784726603,1392,854,2246,-
chr10,98281401,1.5298485730926032,1105,807,1912,-
chr10,98282010,2.697732997481108,611,396,1007,-
chr10,98286997,2.1137883634118677,1673,1158,2831,-
chr10,98286998,2.04853833425262,1237,832,2069,-
chr10,98287895,0.4602015113350126,608,396,1004,-
chr10,98321791,2.3345396845181567,2445,1543,3988,-
chr10,98321875,1.6782857142857142,889,624,1513,-
chr10,98336475,2.0100841913597294,909,658,1567,-
chr10,99437318,1.8752377329783183,679,477,1156,-
chr10,99437358,1.9050000000000002,634,499,1133,-
chr10,99437697,3.330341113105925,741,556,1297,-
chr10,99437699,3.330341113105925,741,556,1297,-
chr10,99437734,3.037278852725012,862,655,1517,-
chr10,99446689,1.4995111357231325,1037,799,1836,-
chr10,99446911,4.56408345752608,874,487,1361,-
chr10,99446913,5.283495806113768,727,440,1167,-
chr10,101157166,1.0455580865603644,764,438,1202,-
chr10,101157167,1.0455580865603644,764,438,1202,-
chr10,101157415,4.488030267692866,798,556,1354,-
chr10,101163229,1.3092233009708738,898,720,1618,-
chr10,101163230,1.3092233009708738,898,720,1618,-
chr10,101163231,1.3092233009708738,898,720,1618,-
chr10,101659726,1.8847675568743816,823,673,1496,-
chr10,101659727,1.687098031572793,1193,732,1925,-
chr10,101659729,1.7777744568427225,2317,1544,3861,-
chr10,101659738,2.659066383757129,864,582,1446,-
chr10,101910731,0.28720701627889145,933,662,1595,-
chr10,101911045,1.852978681982693,722,509,1231,-
chr10,101914621,1.1862506450163126,716,590,1306,-
chr10,101943585,1.0570954750059227,581,468,1049,-
chr10,101943587,1.0570954750059227,581,468,1049,-
chr10,101945339,3.1488377416756466,1413,978,2391,-
chr10,101945340,2.950485357380001,1121,807,1928,-
chr10,102040703,2.0054240764511135,2188,1335,3523,-
chr10,102040711,1.9718857290924403,1521,1076,2597,-
chr10,102040712,1.9718857290924403,1521,1076,2597,-
chr10,102040777,2.7817207225584184,736,464,1200,-
chr10,102283564,2.0469696969696973,771,659,1430,-
chr10,102283648,2.119701629723901,1498,1346,2844,-
chr10,102283662,1.5259631323571208,4444,3226,7670,-
chr10,102286200,0.6911764705882353,1127,911,2038,-
chr10,102286243,1.8503312705498247,1483,1181,2664,-
chr10,102286254,0.6377540331028703,760,665,1425,-
chr10,102286272,1.8323250490516683,722,555,1277,-
chr10,102286282,2.111111111111111,607,557,1164,-
chr10,102286745,1.5968586387434551,731,572,1303,-
chr10,102289182,0.3819887087962119,838,577,1415,-
chr10,102289191,0.5277221108884436,789,498,1287,-
chr10,102289211,1.740969036697248,693,435,1128,-
chr10,102289625,1.302118171683389,583,574,1157,-
chr10,102746888,2.807861265394186,802,574,1376,-
chr10,102746913,1.8966326697508002,662,484,1146,-
chr10,103541220,0.4161819554670246,1435,1784,3219,-
chr10,103541221,0.3530071455672514,1887,2859,4746,-
chr10,103541222,0.36677686914648167,1674,2470,4144,-
chr10,103541269,2.9334544009835746,662,877,1539,-
chr10,103541276,15.680576565608419,2218,2017,4235,-
chr10,103541277,18.016403213752753,3064,2115,5179,-
chr10,103541279,16.993626848645253,3364,371,3735,-
chr10,103541280,24.959398347587104,3706,287,3993,-
chr10,103541281,26.224348912462776,4441,315,4756,-
chr10,103541282,34.07458996168195,3513,187,3700,-
chr10,103541283,30.419378252888613,2666,114,2780,-
chr10,103541284,31.85010034521493,1842,79,1921,-
chr10,103541514,2.216746916777706,665,458,1123,-
chr10,103542019,2.136634799214026,964,675,1639,-
chr10,103542037,1.1866350296011656,1017,672,1689,-
chr10,103542082,2.284533700940199,793,509,1302,-
chr10,103542604,2.0806595365418894,666,509,1175,-
chr10,103542605,2.0806595365418894,666,509,1175,-
chr10,103867991,0.3559898765185148,559,521,1080,-
chr10,103867998,0.41873301703575894,603,611,1214,-
chr10,103868031,7.523765020026702,516,534,1050,-
chr10,103868032,7.523765020026702,516,534,1050,-
chr10,104183315,2.6385184210725225,869,561,1430,-
chr10,104183818,3.2177967620076187,645,413,1058,-
chr10,104183897,2.842085052984904,984,718,1702,-
chr10,104184080,6.634408602150537,616,402,1018,-
chr10,104184082,6.634408602150537,616,402,1018,-
chr10,104245461,0.8954089059758294,621,470,1091,-
chr10,104459148,2.767899408284024,692,519,1211,-
chr10,104459175,1.5950285796630082,1192,892,2084,-
chr10,104459224,3.213256444581745,614,439,1053,-
chr10,105152135,1.2726358582448682,3135,2077,5212,-
chr10,105152150,1.26068194856701,2731,1705,4436,-
chr10,105152161,1.4927369018346888,1997,1554,3551,-
chr10,105156181,0.6137184115523465,1529,1107,2636,-
chr10,105156182,1.5622368160132512,5822,3309,9131,-
chr10,105156183,1.5622368160132512,5822,3309,9131,-
chr10,105156184,1.5622368160132512,5822,3309,9131,-
chr10,105156198,1.69188609555582,1064,762,1826,-
chr10,105156208,0.6968516408703143,2321,1112,3433,-
chr10,105156209,0.6589805032327171,5034,3287,8321,-
chr10,105156210,0.5308451219654484,2135,1842,3977,-
chr10,105156212,0.4377759381898455,500,603,1103,-
chr10,105156218,1.7527571406793374,632,490,1122,-
chr10,105360606,4.752507552893682,405,669,1074,-
chr10,105362243,2.570744680851064,715,469,1184,-
chr10,105659937,2.3596000535941584,1582,1297,2879,-
chr10,105659939,1.9486648524703318,2039,1616,3655,-
chr10,105659943,1.8564862104187947,726,533,1259,-
chr10,105659946,1.8301886792452833,678,476,1154,-
chr10,105659950,2.8411195286195285,586,431,1017,-
chr10,106073070,1.748163983574216,600,461,1061,-
chr10,106073071,1.5851947937736348,600,496,1096,-
chr10,106073458,3.9324148381622015,664,466,1130,-
chr10,106073878,2.517421161705708,752,569,1321,-
chr10,106073897,1.2310698583292623,719,533,1252,-
chr10,106073899,1.2310698583292623,719,533,1252,-
chr10,111628459,1.4944553163731245,710,510,1220,-
chr10,111628460,1.4944553163731245,710,510,1220,-
chr10,111628461,1.4944553163731245,710,510,1220,-
chr10,111643898,1.6148314079436838,645,455,1100,-
chr10,112058528,2.2947584165890453,641,490,1131,-
chr10,112063272,1.8870332234527203,635,467,1102,-
chr10,114198139,2.329491984906985,840,476,1316,-
chr10,114201969,2.453211805555556,957,639,1596,-
chr10,114201971,2.453211805555556,957,639,1596,-
chr10,114202024,3.5397827279819905,595,411,1006,-
chr10,116192761,1.1915735394656544,5267,3432,8699,-
chr10,116192762,1.1014991768978473,4173,2566,6739,-
chr10,116192792,0.5666005492828806,1060,677,1737,-
chr10,116192793,2.494243122045813,1371,891,2262,-
chr10,116192794,2.3888568516052664,1793,1189,2982,-
chr10,116192815,1.6976146788990825,770,435,1205,-
chr10,118674937,1.123250867591242,779,583,1362,-
chr10,119633250,0.9825507590883116,874,449,1323,-
chr10,120489893,3.1738288284955285,647,575,1222,-
chr10,120513928,0.6508369588763608,1177,722,1899,-
chr10,120513930,2.1558536181487,823,670,1493,-
chr10,120513931,2.0041536273115224,1193,949,2142,-
chr10,120513933,1.8857554994590693,768,589,1357,-
chr10,120513942,2.0304121983914207,654,372,1026,-
chr10,120513943,2.2876400487570954,831,482,1313,-
chr10,120794855,1.6912286359238955,616,442,1058,-
chr10,120795250,2.123402555910543,817,625,1442,-
chr10,120795251,2.1646354985294183,1064,770,1834,-
chr10,120795252,2.289306104523496,718,505,1223,-
chr10,120795517,1.9030579643998173,1302,938,2240,-
chr10,120795562,0.8942020665901264,1262,1004,2266,-
chr10,120795563,0.8942020665901264,1262,1004,2266,-
chr10,120795620,2.3561878109452734,865,535,1400,-
chr10,120795752,0.5826450662739323,1901,1357,3258,-
chr10,120795754,0.5826450662739323,1901,1357,3258,-
chr10,120796737,2.4437005663143574,2418,1543,3961,-
chr10,120796771,1.602418745275888,847,566,1413,-
chr10,120796780,1.6824841824841823,859,571,1430,-
chr10,120797881,2.360534099834556,6555,4602,11157,-
chr10,120797883,2.360534099834556,6555,4602,11157,-
chr10,120797898,1.5233974826113423,5332,3302,8634,-
chr10,120797932,1.7372505531289368,6199,4160,10359,-
chr10,120797933,1.7306713984079938,8132,5384,13516,-
chr10,120797934,1.7306713984079938,8132,5384,13516,-
chr10,120797935,1.725534558058209,5991,3910,9901,-
chr10,120801570,2.051431344007763,603,457,1060,-
chr10,120801606,1.1425681909180117,886,688,1574,-
chr10,120801650,1.8284727390642255,690,585,1275,-
chr10,120801808,1.7529378442807724,662,457,1119,-
chr10,120801866,4.57196029776675,669,402,1071,-
chr10,120801867,3.2697368421052637,993,591,1584,-
chr10,120801869,3.0195195972138937,1403,903,2306,-
chr10,120801870,3.6892620232172475,961,535,1496,-
chr10,120803584,1.7947925860547216,1659,823,2482,-
chr10,120803597,2.9079981507165975,1019,617,1636,-
chr10,120809329,1.3843691322682918,6367,3807,10174,-
chr10,120809330,1.6515372722979706,9367,6049,15416,-
chr10,120809339,1.4423966580668572,6627,4488,11115,-
chr10,120809340,1.619705104065951,5326,3655,8981,-
chr10,120809344,1.6559549049528948,4638,2889,7527,-
chr10,120809379,1.7491624843224722,2422,1453,3875,-
chr10,120809404,0.6558592922229286,1237,725,1962,-
chr10,120809424,1.8380905511811023,829,507,1336,-
chr10,120809466,0.6187146448774355,899,591,1490,-
chr10,120810166,1.5561686763403504,3016,2096,5112,-
chr10,120810172,1.6591774193548388,2508,2324,4832,-
chr10,120810177,2.393970893970894,2302,1975,4277,-
chr10,120810738,1.488799500013211,3327,2325,5652,-
chr10,120810797,1.77161629434954,1283,760,2043,-
chr10,120810809,1.994583036350677,847,609,1456,-
chr10,120810826,1.5206741412554452,1091,736,1827,-
chr10,120816511,1.4752724224643754,1319,1192,2511,-
chr10,120816514,1.7756225094351556,1275,1102,2377,-
chr10,120816515,1.656475051440329,1537,1151,2688,-
chr10,120816528,1.466953060024703,2941,1980,4921,-
chr10,120817546,0.6335113484646195,1094,748,1842,-
chr10,120817582,2.9342881213142373,1246,1186,2432,-
chr10,120817583,2.3207085579899314,3419,2972,6391,-
chr10,120817585,2.0711856409228835,2793,2359,5152,-
chr10,120817708,1.9736842105263157,644,515,1159,-
chr10,120818861,1.782713437922322,819,548,1367,-
chr10,120818866,0.6211817168338908,795,597,1392,-
chr10,120819121,1.7379530916844352,626,468,1094,-
chr10,120819143,3.072204344328238,610,451,1061,-
chr10,120819218,1.865748031496063,676,507,1183,-
chr10,120820285,1.3532287935740532,2863,1958,4821,-
chr10,120820286,1.2778317370206036,4455,3374,7829,-
chr10,120820287,1.3532287935740532,2863,1958,4821,-
chr10,120820289,1.808733197957134,1460,1283,2743,-
chr10,120820328,1.820376809904642,1177,841,2018,-
chr10,120820350,2.159921448087432,616,487,1103,-
chr10,120824958,2.6427450980392155,585,424,1009,-
chr10,120824961,0.24294935451837144,698,529,1227,-
chr10,120824983,2.405959031657356,645,536,1181,-
chr10,120825065,4.53735255570118,576,435,1011,-
chr10,120829024,1.6894389839420785,907,602,1509,-
chr10,120829048,0.6338028169014085,944,709,1653,-
chr10,120829142,2.6169590643274856,894,557,1451,-
chr10,120830560,2.2558049535603715,803,543,1346,-
chr10,120832443,0.5518575851393189,712,475,1187,-
chr10,120832975,0.565679022606383,1088,751,1839,-
chr10,120833047,0.8945115045714443,1011,882,1893,-
chr10,120833048,0.8945115045714443,1011,882,1893,-
chr10,120833311,1.824949207639171,801,534,1335,-
chr10,120833431,1.3271800994855114,1538,1137,2675,-
chr10,120833432,2.106363085782645,1363,1038,2401,-
chr10,120840161,0.88147733806591,1133,784,1917,-
chr10,120840162,1.0870080045469614,764,490,1254,-
chr10,120927441,1.7810807374443738,1892,1429,3321,-
chr10,120928036,1.6270358306188926,1943,1227,3170,-
chr10,120928690,1.5388530287984112,1077,847,1924,-
chr10,120928775,0.7388806367534543,1520,1150,2670,-
chr10,120933253,1.9256445288635635,2166,1428,3594,-
chr10,120933254,0.68758014015208,1707,1411,3118,-
chr10,120934059,2.189249720044793,1699,1139,2838,-
chr10,120934060,1.473279352226721,1212,987,2199,-
chr10,120934061,2.189249720044793,1699,1139,2838,-
chr10,120936595,2.797131147540984,584,487,1071,-
chr10,120936610,0.4660486093710849,743,613,1356,-
chr10,120936617,1.7044394141228085,1402,981,2383,-
chr10,120936654,2.191726581223299,808,456,1264,-
chr10,120938303,1.3517330547837965,1446,1130,2576,-
chr10,120938305,1.3517330547837965,1446,1130,2576,-
chr10,121259765,0.5190751848235459,1144,855,1999,-
chr10,121259766,0.5190751848235459,1144,855,1999,-
chr10,121335146,1.8845639804799799,1397,1044,2441,-
chr10,121335216,1.6601438952073515,594,434,1028,-
chr10,121336178,2.1199249530956847,855,532,1387,-
chr10,121336179,2.1199249530956847,855,532,1387,-
chr10,121337038,2.517482517482517,599,428,1027,-
chr10,121338241,0.46230007616146235,606,504,1110,-
chr10,121347738,2.412939351008568,760,548,1308,-
chr10,121347739,1.6998401150032107,1154,839,1993,-
chr10,121347748,1.3286230010886986,667,479,1146,-
chr10,121590996,0.5169506258692629,938,718,1656,-
chr10,121595118,2.3876201923076925,684,519,1203,-
chr10,121595200,3.29089166856965,805,553,1358,-
chr10,121596534,3.168202408347479,723,591,1314,-
chr10,121600363,2.142195790394735,1442,1048,2490,-
chr10,121602877,2.8230038447228076,888,578,1466,-
chr10,121607177,0.4745938921377518,663,404,1067,-
chr10,121612700,2.5278782399035564,670,473,1143,-
chr10,123238227,4.447145593648965,689,436,1125,-
chr10,123239093,2.131124913733609,771,689,1460,-
chr10,123239095,2.131124913733609,771,689,1460,-
chr10,123239101,1.9332275445167226,886,716,1602,-
chr10,123239102,1.5466666666666666,637,527,1164,-
chr10,123353410,0.9782706921339084,915,540,1455,-
chr10,123353412,0.7693645640074211,1326,783,2109,-
chr10,123353414,0.3302759364883613,856,498,1354,-
chr10,123718915,1.1606529394950391,611,438,1049,-
chr10,123720973,6.242753915497101,770,466,1236,-
chr10,126086036,1.9394128021579,718,458,1176,-
chr10,126086444,0.5822306238185255,692,528,1220,-
chr10,126086520,2.4112085460570096,748,594,1342,-
chr10,126089539,1.1245479298917018,834,669,1503,-
chr10,126089544,1.1333352936598224,823,652,1475,-
chr10,127504819,0.8290359235728647,693,416,1109,-
chr10,127569558,3.1772,610,499,1109,-
chr10,127569572,1.2319561971129915,824,636,1460,-
chr10,127569574,1.2319561971129915,824,636,1460,-
chr10,133781552,1.9454242457976794,899,707,1606,-
chr10,133781693,2.296037230212209,953,668,1621,-
chr10,133781830,2.21,857,659,1516,-
chr10,133781850,1.7043399638336347,753,552,1305,-
chr10,133781920,2.367003367003367,873,620,1493,-
chr10,133781921,2.2267044495026256,1372,943,2315,-
chr10,133781925,0.6747510331278369,663,508,1171,-
chr10,133784226,1.948393893314396,1236,705,1941,-
chr10,133784456,1.5557274401473298,861,904,1765,-
chr10,133784465,1.8631758679567445,1363,1254,2617,-
chr10,133784466,1.433491064675163,2017,1828,3845,-
chr10,133784469,1.9371180760890994,633,533,1166,-
chr10,133786545,4.156503198294243,721,468,1189,-
chr10,133786548,2.0153110047846887,701,439,1140,-
chr10,133786551,0.5903093721565059,864,627,1491,-
chr10,135102463,2.3011465916522202,1686,833,2519,-
chr10,135102513,1.3448532144184318,1973,1559,3532,-
chr10,135102514,1.3849233398323735,2838,2064,4902,-
chr10,135102520,0.799239665843072,1333,824,2157,-
chr10,135102521,1.0683157568238213,598,415,1013,-
chr10,135103355,1.2470180706517244,1624,944,2568,-
chr10,135103357,0.9453125,1088,575,1663,-
chr10,135179540,1.2248119120632188,738,574,1312,-
chr11,319801,2.1099702380952383,2577,1919,4496,-
chr11,319885,1.453758825300327,3184,2552,5736,-
chr11,319906,1.4103789689313757,4793,2725,7518,-
chr11,319907,1.4103789689313757,4793,2725,7518,-
chr11,319913,1.3278490566037733,2314,1589,3903,-
chr11,319919,1.4613832342280124,6043,3693,9736,-
chr11,319920,1.4895274177620836,4145,2682,6827,-
chr11,319922,1.9192221912461669,1643,843,2486,-
chr11,319928,1.6405618362452896,1639,972,2611,-
chr11,319931,1.5918272037361354,1202,570,1772,-
chr11,320623,1.4160197901561031,2074,1233,3307,-
chr11,320679,1.6830880174537608,5421,4106,9527,-
chr11,320847,0.9519613413305343,21204,12663,33867,-
chr11,320857,1.0957949795337096,2190,1979,4169,-
chr11,320858,1.0519543326942675,936,918,1854,-
chr11,320859,1.1309053722941094,1254,1061,2315,-
chr11,320876,1.8717850972710763,1193,1054,2247,-
chr11,320877,2.471246081381345,1106,885,1991,-
chr11,320878,2.126230152583881,979,834,1813,-
chr11,494591,1.9824424428426755,998,898,1896,-
chr11,494651,1.0542815542815542,798,593,1391,-
chr11,494652,1.0542815542815542,798,593,1391,-
chr11,494961,1.6316909282162018,874,740,1614,-
chr11,498057,1.6456604883789347,735,514,1249,-
chr11,498097,1.7407164700742683,612,435,1047,-
chr11,498126,1.6073740272794395,1180,849,2029,-
chr11,498127,2.120867834905963,892,576,1468,-
chr11,498837,2.899330357142857,837,447,1284,-
chr11,498838,2.899330357142857,837,447,1284,-
chr11,499081,1.1761703052025634,1273,836,2109,-
chr11,499083,1.1761703052025634,1273,836,2109,-
chr11,499134,1.5197110420310593,699,428,1127,-
chr11,499918,2.3544968535026296,630,444,1074,-
chr11,502151,1.95045008985504,1134,865,1999,-
chr11,502152,3.0427511996510104,674,528,1202,-
chr11,506767,0.6000245843908533,1012,518,1530,-
chr11,691528,1.4435359235628609,1458,824,2282,-
chr11,691529,0.8829465731788187,1124,645,1769,-
chr11,691531,0.343463460873984,667,342,1009,-
chr11,840447,3.3192809522829574,750,606,1356,-
chr11,840470,1.9066620910194487,738,479,1217,-
chr11,842497,1.9615770946939848,800,587,1387,-
chr11,842506,2.1136523929471034,616,396,1012,-
chr11,842507,1.7376283155849634,760,510,1270,-
chr11,1774088,20.09025359361443,3004,1998,5002,-
chr11,1774089,20.6379699864646,5027,3441,8468,-
chr11,1774090,20.6379699864646,5027,3441,8468,-
chr11,1774091,27.374035087719303,1695,949,2644,-
chr11,1774096,5.080749670564412,3950,2162,6112,-
chr11,1774097,4.7724184369157125,4400,2388,6788,-
chr11,1774098,4.850461538461539,1125,649,1774,-
chr11,1774099,4.573028237585199,908,473,1381,-
chr11,1774233,2.4319123539749308,934,599,1533,-
chr11,1774257,1.256229907992462,820,513,1333,-
chr11,1774320,0.7287226330288532,717,417,1134,-
chr11,1774321,0.7287226330288532,717,417,1134,-
chr11,1774477,1.5806658130601792,822,496,1318,-
chr11,1774545,0.5521978021978022,1004,909,1913,-
chr11,1774547,0.5521978021978022,1004,909,1913,-
chr11,1774593,0.2991616844420587,666,559,1225,-
chr11,1774638,0.9550592776399227,865,402,1267,-
chr11,1774640,0.6603671119800152,1279,593,1872,-
chr11,1774642,0.8356125356125356,837,389,1226,-
chr11,1774791,2.389705882352941,688,423,1111,-
chr11,1775127,1.8374600129604635,1127,778,1905,-
chr11,1776198,0.5482464454976304,722,421,1143,-
chr11,1776250,2.33625678119349,890,552,1442,-
chr11,1778580,2.0979492248580227,1531,1147,2678,-
chr11,1780299,1.9229166666666664,1632,959,2591,-
chr11,1780301,2.06476146858799,2099,1349,3448,-
chr11,1780316,2.1772040713822762,1610,1169,2779,-
chr11,1780771,0.6123076923076922,795,449,1244,-
chr11,1782552,1.3197481106645,1006,706,1712,-
chr11,1782629,1.8893671975893245,626,403,1029,-
chr11,1785156,0.6342725857224434,592,469,1061,-
chr11,2016477,0.8194927017788459,5296,4529,9825,-
chr11,2016514,1.1512891178129327,12839,9142,21981,-
chr11,2016519,1.2990283736618475,13917,8527,22444,-
chr11,2016520,1.2990283736618475,13917,8527,22444,-
chr11,2016852,2.1225033643788893,3143,2420,5563,-
chr11,2016881,1.236262928287829,3602,2660,6262,-
chr11,2016926,1.1698950181786043,17079,11953,29032,-
chr11,2017228,1.062086725787372,2198,1719,3917,-
chr11,2017229,1.018620178041543,1655,1279,2934,-
chr11,2017326,1.4091228731540753,4346,3562,7908,-
chr11,2017392,1.2441996850742911,24810,16652,41462,-
chr11,2017393,1.2441996850742911,24810,16652,41462,-
chr11,2017420,1.2192928252660489,7846,4854,12700,-
chr11,2017596,1.354326595503066,2918,2589,5507,-
chr11,2017604,1.3212400926716281,18724,14060,32784,-
chr11,2017610,1.4948281023480283,5200,4067,9267,-
chr11,2017836,2.460458983517105,6634,5141,11775,-
chr11,2017885,2.666302259305049,7410,6509,13919,-
chr11,2017903,1.2663131402669692,14205,6618,20823,-
chr11,2017904,1.3638489664390911,18584,8568,27152,-
chr11,2017905,1.7953455129710982,22900,10430,33330,-
chr11,2017906,2.0124051431943246,18016,8096,26112,-
chr11,2017907,3.807922530014645,20164,10659,30823,-
chr11,2017910,19.042863087806907,4575,2669,7244,-
chr11,2017911,24.482170527647693,17257,7968,25225,-
chr11,2017912,29.098047608007537,11229,5728,16957,-
chr11,2017972,1.177102600883399,5281,3865,9146,-
chr11,2018030,1.3452907264677962,8841,5810,14651,-
chr11,2018032,1.466060629163798,3735,2992,6727,-
chr11,2018074,1.1845076460802926,6437,3949,10386,-
chr11,2018075,1.622869802317655,1497,1303,2800,-
chr11,2018113,1.689034369885434,1375,1195,2570,-
chr11,2018125,1.508171578197104,7894,5678,13572,-
chr11,2018201,3.4718955792505697,19197,15011,34208,-
chr11,2018279,0.8103671669008358,11845,8094,19939,-
chr11,2018280,1.3645130509518364,2859,2761,5620,-
chr11,2018284,0.5131683542089319,6079,5537,11616,-
chr11,2018312,1.0316922550586407,7155,7204,14359,-
chr11,2018391,6.017915502157626,15562,11524,27086,-
chr11,2018394,9.6578685871538,45567,26487,72054,-
chr11,2018395,9.657868587153802,45567,26487,72054,-
chr11,2018396,9.657868587153802,45567,26487,72054,-
chr11,2018401,2.133010542756736,2528,984,3512,-
chr11,2018404,7.636704964183654,15384,6700,22084,-
chr11,2018408,3.437230612454617,15169,5580,20749,-
chr11,2018448,1.5659936292784076,21990,16281,38271,-
chr11,2018450,1.5686462421752867,15427,12325,27752,-
chr11,2018504,1.275172231054584,6467,4283,10750,-
chr11,2018510,6.492734126944125,17744,14490,32234,-
chr11,2018511,6.925248301097753,6623,5738,12361,-
chr11,2018512,6.832612668606578,15111,12697,27808,-
chr11,2018543,1.270293537628091,6947,3780,10727,-
chr11,2018547,1.478935537834278,13213,6730,19943,-
chr11,2018549,2.4540323917141187,32948,19250,52198,-
chr11,2018550,2.698581178411307,28820,17202,46022,-
chr11,2018583,0.3856861692610485,2535,1619,4154,-
chr11,2018584,0.3910776384702562,11985,7795,19780,-
chr11,2018637,1.2038898346587066,5735,3755,9490,-
chr11,2018694,0.7351003563954734,6978,4684,11662,-
chr11,2018700,3.149338170972842,19038,12826,31864,-
chr11,2018702,4.997538458364908,42879,30978,73857,-
chr11,2018703,6.3498036809075575,33247,24364,57611,-
chr11,2018768,1.229379350348028,3495,3447,6942,-
chr11,2018789,0.7227976948741279,3346,2354,5700,-
chr11,2018791,1.7303003409780937,2645,2438,5083,-
chr11,2018858,1.7519032691446483,2375,2540,4915,-
chr11,2018907,2.5208897503922216,15226,12515,27741,-
chr11,2018908,2.890921985815603,4538,4229,8767,-
chr11,2018959,0.5022116903633491,3178,3797,6975,-
chr11,2018975,1.429474220404005,6053,5710,11763,-
chr11,2018984,5.295066102573728,14408,20770,35178,-
chr11,2018992,2.1233977511844366,12058,20082,32140,-
chr11,2018993,2.658736173389597,29593,37272,66865,-
chr11,2018994,2.658736173389597,29593,37272,66865,-
chr11,2019002,2.712318084522199,16159,12854,29013,-
chr11,2019003,4.226650753879248,26507,24439,50946,-
chr11,2019004,4.226650753879248,26507,24439,50946,-
chr11,2019012,4.570323283327458,22739,15240,37979,-
chr11,2019013,4.865517641401859,33807,22514,56321,-
chr11,2019014,4.816485805247728,36593,23236,59829,-
chr11,2019015,5.855943143656945,28760,17561,46321,-
chr11,2019016,4.689506202529985,8648,2648,11296,-
chr11,2019021,4.637623862419662,21708,7870,29578,-
chr11,2019022,4.637623862419662,21708,7870,29578,-
chr11,2019023,4.637623862419662,21708,7870,29578,-
chr11,2019029,3.407082864657906,12103,2918,15021,-
chr11,2019030,4.181036161839147,21607,4781,26388,-
chr11,2019031,4.06148820478971,26611,5145,31756,-
chr11,2019032,4.713049010982236,23269,4098,27367,-
chr11,2019033,5.4814411603494575,17151,2533,19684,-
chr11,2019034,5.418038538349436,2867,193,3060,-
chr11,2019039,2.6597379103162764,11451,640,12091,-
chr11,2019040,2.1246537957745266,13095,651,13746,-
chr11,2019041,2.298821791620694,16040,817,16857,-
chr11,2019042,2.3121797309793344,11874,558,12432,-
chr11,2019043,2.6061303511064593,4828,252,5080,-
chr11,2019046,7.59620199254696,2377,58,2435,-
chr11,2019047,6.4366333157802345,2058,52,2110,-
chr11,2019051,5.4813757939640615,1093,25,1118,-
chr11,2950398,2.044297425571696,617,408,1025,-
chr11,2950421,1.9247604147641426,1237,757,1994,-
chr11,2950426,1.3190286967413072,838,437,1275,-
chr11,2950427,2.4520123839009282,1033,645,1678,-
chr11,2950428,2.4520123839009282,1033,645,1678,-
chr11,2950451,2.0954545954846213,794,407,1201,-
chr11,2965783,0.6582902039034731,620,552,1172,-
chr11,2965798,2.872640949925397,1033,857,1890,-
chr11,2965835,5.959552275448815,3789,2625,6414,-
chr11,2965836,5.959552275448815,3789,2625,6414,-
chr11,2965965,1.144360585930159,920,649,1569,-
chr11,2965996,2.8992251809357072,652,468,1120,-
chr11,2966202,2.3884007029876977,905,568,1473,-
chr11,2966211,1.5027289266221953,589,484,1073,-
chr11,2966214,1.915648854961832,716,523,1239,-
chr11,2966344,0.6419672131147541,978,724,1702,-
chr11,2966393,1.4377094121230585,1179,870,2049,-
chr11,2966419,0.49691651835602835,666,652,1318,-
chr11,2966442,0.56,615,549,1164,-
chr11,2966474,0.5875956463907329,797,875,1672,-
chr11,2966505,9.791129032258064,638,495,1133,-
chr11,2966514,1.9079848119077776,805,658,1463,-
chr11,2966523,13.961278587518963,4471,2897,7368,-
chr11,2966524,13.961278587518965,4471,2897,7368,-
chr11,2966525,15.320174198986424,3607,2323,5930,-
chr11,2966529,17.34145025616119,1211,536,1747,-
chr11,2966729,0.7512366714301418,1138,826,1964,-
chr11,2966758,1.6798768388641807,1410,924,2334,-
chr11,2966759,1.6798768388641807,1410,924,2334,-
chr11,2966779,9.092403388635553,1283,896,2179,-
chr11,2979747,2.092128279883382,935,734,1669,-
chr11,2981043,1.6178497178497175,1158,909,2067,-
chr11,2985961,1.3293378995433789,2328,1751,4079,-
chr11,2991064,1.5926846100759144,1048,827,1875,-
chr11,2991134,1.6445147679324892,1558,947,2505,-
chr11,2993353,1.4444798424467098,4559,3327,7886,-
chr11,2993365,1.3652663906013849,18655,13593,32248,-
chr11,2993366,1.4163797568822072,7767,5230,12997,-
chr11,2993369,1.744721317174008,7078,4513,11591,-
chr11,2993370,1.744721317174008,7078,4513,11591,-
chr11,2993399,0.6435798840626851,2215,1458,3673,-
chr11,3000444,1.3813722087238227,1065,644,1709,-
chr11,3000451,1.787420135227343,1129,657,1786,-
chr11,3000457,2.5882352941176467,1463,914,2377,-
chr11,3000458,0.5344086021505376,1135,619,1754,-
chr11,3013499,2.492137881168375,1031,541,1572,-
chr11,3013502,0.5336038115371002,2243,1275,3518,-
chr11,3013514,2.0395150071481027,732,521,1253,-
chr11,3022260,1.5477548261732774,915,606,1521,-
chr11,3022286,2.130434782608696,734,620,1354,-
chr11,3022395,1.707612172914445,2270,2003,4273,-
chr11,3022396,1.7602095625832717,3326,2896,6222,-
chr11,3022398,1.8152898466509406,3139,2673,5812,-
chr11,3022417,1.8960384153661463,2085,1665,3750,-
chr11,3022418,1.8960384153661463,2085,1665,3750,-
chr11,3022426,0.6359706822025936,751,625,1376,-
chr11,3022441,1.8292243367935408,724,577,1301,-
chr11,3023266,1.6185930691014736,1599,1263,2862,-
chr11,3023267,1.6185930691014736,1599,1263,2862,-
chr11,3023773,2.2293794186959937,773,602,1375,-
chr11,3023785,2.1825933323091107,860,565,1425,-
chr11,3028119,0.6513095701495858,936,733,1669,-
chr11,3028121,1.8328173374613004,591,475,1066,-
chr11,3028125,2.298206278026906,573,445,1018,-
chr11,3033483,1.6831210191082802,754,784,1538,-
chr11,3033489,1.626684758028042,733,736,1469,-
chr11,3033492,2.138814533609084,2546,2034,4580,-
chr11,3033494,1.9689694726540592,4288,3345,7633,-
chr11,3033495,2.10019364555691,1815,1527,3342,-
chr11,3033496,1.894809297036545,2980,2258,5238,-
chr11,3037025,1.9106294536817103,584,420,1004,-
chr11,3037074,0.3974391057724391,732,443,1175,-
chr11,3038357,2.8626889419252186,691,418,1109,-
chr11,3038369,1.7006493506493503,678,384,1062,-
chr11,3038455,3.841002044989775,682,488,1170,-
chr11,3039164,1.4514189514189513,1954,1385,3339,-
chr11,3039173,2.4807860262008736,873,686,1559,-
chr11,3039678,1.7198961376176565,756,473,1229,-
chr11,3039861,0.670735871477494,1669,1149,2818,-
chr11,3039862,1.779578606158833,731,616,1347,-
chr11,3040388,2.2357142857142858,938,783,1721,-
chr11,3040390,2.2357142857142858,938,783,1721,-
chr11,3040405,2.6956641753904664,793,547,1340,-
chr11,3041546,0.6591678761490083,871,623,1494,-
chr11,3047916,0.5484706810116601,748,432,1180,-
chr11,3047977,1.5563899655469422,1090,863,1953,-
chr11,3048000,1.7485492471769137,990,796,1786,-
chr11,3048003,1.079930367768152,2041,1480,3521,-
chr11,3050294,1.776011773362767,861,754,1615,-
chr11,3050302,2.7567340067340065,785,647,1432,-
chr11,3050535,0.6036789297658863,683,597,1280,-
chr11,3050590,2.3224896411883984,711,596,1307,-
chr11,3059392,0.48810728744939264,642,519,1161,-
chr11,3060502,2.955601564297216,802,620,1422,-
chr11,3061137,1.2110290367438084,2535,2057,4592,-
chr11,3062189,1.478369125427949,949,594,1543,-
chr11,3063414,1.5410202655485676,595,476,1071,-
chr11,3063428,1.747567160606694,921,686,1607,-
chr11,3078591,2.139690721649485,592,484,1076,-
chr11,3078646,1.4606316734179245,838,424,1262,-
chr11,3108722,2.8257842438229512,577,646,1223,-
chr11,3697834,2.9145094279322468,1494,1042,2536,-
chr11,3697835,2.9145094279322468,1494,1042,2536,-
chr11,3697836,0.3952366195936075,743,460,1203,-
chr11,3700793,0.3278333333333333,842,599,1441,-
chr11,3700794,0.3278333333333333,842,599,1441,-
chr11,3716700,1.2564867590727662,620,453,1073,-
chr11,3720457,3.88508461235734,616,461,1077,-
chr11,3720477,0.46130350769985545,1698,1091,2789,-
chr11,3720478,0.4829176273317963,1151,733,1884,-
chr11,3722037,0.9342193126731514,1379,1027,2406,-
chr11,3727721,2.180451127819549,579,436,1015,-
chr11,3735052,2.1908525621816,3271,2271,5542,-
chr11,3735053,2.1908525621816,3271,2271,5542,-
chr11,3735054,1.7317743762882367,4610,3269,7879,-
chr11,3735082,1.463476070528967,1161,793,1954,-
chr11,3735087,2.664707977207977,1094,701,1795,-
chr11,3735191,3.8328173374613006,1237,866,2103,-
chr11,3740646,1.5548757170172087,855,522,1377,-
chr11,3740671,2.062442070407118,1627,1043,2670,-
chr11,3740689,2.0447277602763,1458,895,2353,-
chr11,3741985,0.3265700483091787,675,413,1088,-
chr11,3741988,2.440087145969499,559,458,1017,-
chr11,3744608,2.5958329472944897,682,560,1242,-
chr11,3765874,2.6036721898790867,917,637,1554,-
chr11,3774548,2.509314586994728,1693,1137,2830,-
chr11,3774549,2.558303615515444,2506,1656,4162,-
chr11,3774551,2.8431281434506888,1650,1075,2725,-
chr11,3774572,0.5354581673306773,671,501,1172,-
chr11,3797173,1.4534252207895677,731,496,1227,-
chr11,3797206,0.3914294522659542,585,525,1110,-
chr11,3797207,1.057525438050024,976,794,1770,-
chr11,6497867,36.707977961544806,948,845,1793,-
chr11,6497868,29.358435659930954,1329,1042,2371,-
chr11,6497869,7.826432313619726,831,497,1328,-
chr11,6497877,37.899631701846516,1018,423,1441,-
chr11,6497878,51.34390696579212,748,266,1014,-
chr11,6498278,3.6084270232125966,963,735,1698,-
chr11,6498988,5.036714975845411,801,459,1260,-
chr11,6498999,1.3310032216040357,979,702,1681,-
chr11,6500455,1.91466138800696,595,456,1051,-
chr11,6632210,1.9214285714285717,806,524,1330,-
chr11,6632495,1.6997677705977379,782,618,1400,-
chr11,6632533,1.7753588330271624,1332,1144,2476,-
chr11,6632677,1.0496514464970377,1468,1207,2675,-
chr11,6632678,1.321008676389224,2036,1664,3700,-
chr11,6632909,1.8399399036997661,1054,875,1929,-
chr11,6635475,2.4206828097529742,602,444,1046,-
chr11,6638264,1.6459478292011662,671,502,1173,-
chr11,6703309,1.9929368892659216,1976,1580,3556,-
chr11,6703310,2.091102232369356,1198,875,2073,-
chr11,6703415,0.6119733924611973,735,450,1185,-
chr11,6703442,2.269850187265918,712,444,1156,-
chr11,6703560,1.979814960459224,1520,1178,2698,-
chr11,6703583,0.5820158102766798,805,597,1402,-
chr11,6703586,2.258928571428572,896,545,1441,-
chr11,6703622,2.2602506575893546,912,561,1473,-
chr11,6704443,1.117139935593131,945,596,1541,-
chr11,6704489,0.27961039191067777,820,469,1289,-
chr11,6704537,1.3479988914402419,1535,862,2397,-
chr11,6704539,1.4570599199079133,1699,1074,2773,-
chr11,8737357,2.2467007593367425,833,601,1434,-
chr11,8969451,10.50317609042815,634,1065,1699,-
chr11,8969457,25.61860867709948,771,854,1625,-
chr11,8969458,29.686356682028837,557,562,1119,-
chr11,9192177,1.6594420039896736,3436,2252,5688,-
chr11,9192197,1.42974314068885,802,570,1372,-
chr11,9192203,1.946190595926578,1289,872,2161,-
chr11,9192204,0.6482371794871795,808,383,1191,-
chr11,9192205,1.946190595926578,1289,872,2161,-
chr11,9192206,1.7193650793650794,676,449,1125,-
chr11,10818848,1.877425614489004,2024,1545,3569,-
chr11,10819107,1.6909113764927717,1200,924,2124,-
chr11,10820817,0.7787811340339219,3954,2679,6633,-
chr11,10820882,2.502127659574468,1043,704,1747,-
chr11,10821746,1.699917471980406,9121,7248,16369,-
chr11,10821747,1.699917471980406,9121,7248,16369,-
chr11,10821757,0.8540429176227257,5232,3189,8421,-
chr11,10821760,0.6779109681484352,6399,4168,10567,-
chr11,10821772,1.412005092497996,3034,2134,5168,-
chr11,10821783,1.3896086720355196,3032,1840,4872,-
chr11,10821821,1.4171510860575205,3286,2257,5543,-
chr11,10821831,1.33642105604988,2254,1383,3637,-
chr11,10821838,0.768645983151839,2493,1569,4062,-
chr11,10822170,1.5885809149943044,4359,3041,7400,-
chr11,10822318,0.516005451588846,2111,1724,3835,-
chr11,10822321,2.588062883026912,882,833,1715,-
chr11,10822347,1.6754850088183422,664,566,1230,-
chr11,10823232,1.836734693877551,746,580,1326,-
chr11,10823301,1.4727379323822554,941,730,1671,-
chr11,10823639,1.6849634582491062,1805,1089,2894,-
chr11,10823640,1.6849634582491062,1805,1089,2894,-
chr11,10824588,1.7062695225345827,804,663,1467,-
chr11,10825481,1.0877680962964347,3796,2825,6621,-
chr11,10825487,1.943934114665822,1082,860,1942,-
chr11,10825695,0.6755846917080084,1270,912,2182,-
chr11,10825838,1.029956560937628,1838,1742,3580,-
chr11,10825839,1.029956560937628,1838,1742,3580,-
chr11,10825846,1.870920032639739,1333,816,2149,-
chr11,10825936,1.5947712418300652,853,611,1464,-
chr11,10827489,1.69072055867104,840,726,1566,-
chr11,10827505,0.5743073047858942,930,793,1723,-
chr11,10827557,2.194609788359788,1717,1159,2876,-
chr11,10827558,0.4581527347781217,682,509,1191,-
chr11,10827569,5.069448111961975,661,540,1201,-
chr11,10827579,2.292620985551139,1990,1173,3163,-
chr11,10827580,2.292620985551139,1990,1173,3163,-
chr11,10828393,0.5386540600667408,595,463,1058,-
chr11,10874454,2.934873817097731,603,967,1570,-
chr11,10874455,3.172226004084411,465,677,1142,-
chr11,10874457,3.421580928481807,605,796,1401,-
chr11,10874458,3.5061071501227086,641,736,1377,-
chr11,10874459,3.673065735892961,450,572,1022,-
chr11,14482772,1.6836990048933476,708,516,1224,-
chr11,14486568,2.679893282895765,696,544,1240,-
chr11,14512154,1.6549043745746321,2651,1823,4474,-
chr11,14512155,1.572052401746725,1449,1144,2593,-
chr11,14512157,0.6296061795618589,903,595,1498,-
chr11,14512162,1.8915467429912778,1622,1016,2638,-
chr11,14512165,1.7955143346551676,2001,1432,3433,-
chr11,14512166,1.900670503767875,1231,886,2117,-
chr11,14526649,1.610314207650273,1839,1535,3374,-
chr11,14529212,1.84435987509758,921,731,1652,-
chr11,14529225,1.908139163740824,1683,1204,2887,-
chr11,14529226,1.908139163740824,1683,1204,2887,-
chr11,14529265,1.7761672473867594,943,699,1642,-
chr11,14541883,0.5000935805739649,2017,1369,3386,-
chr11,16996240,1.7719980554205155,728,560,1288,-
chr11,16996252,1.6703839333898696,3162,2179,5341,-
chr11,16996254,1.8186561491283013,4306,2971,7277,-
chr11,16996255,1.6106196646491115,3474,2455,5929,-
chr11,16996265,1.937201365187713,2353,1464,3817,-
chr11,16996266,1.9228212074019804,3871,2361,6232,-
chr11,16996268,2.075236766446812,2205,1313,3518,-
chr11,16996269,2.3666666666666667,780,449,1229,-
chr11,16996270,2.3666666666666667,780,449,1229,-
chr11,16996273,3.075250108742932,706,362,1068,-
chr11,16996274,1.9028603576613525,2902,1807,4709,-
chr11,16996293,2.307344979683078,1000,683,1683,-
chr11,17097015,1.2779148498530641,35376,27636,63012,-
chr11,17097043,1.1803804856612305,76396,52614,129010,-
chr11,17097044,1.2009809516669259,59510,39505,99015,-
chr11,17097057,0.9543378132432774,37145,25399,62544,-
chr11,17097156,0.9034192416965612,19376,14430,33806,-
chr11,17097166,1.138812552564192,13662,8712,22374,-
chr11,17098719,1.5339082633286725,35506,26514,62020,-
chr11,17098740,1.2672902306322311,27193,18998,46191,-
chr11,17098757,0.825228570901294,16133,10542,26675,-
chr11,17099001,1.469816440023116,21381,14642,36023,-
chr11,17099016,1.6894205314246498,7831,3688,11519,-
chr11,17099173,2.048609512585131,7584,3241,10825,-
chr11,17099190,1.638093330961264,8115,5262,13377,-
chr11,17099201,1.5193107203748073,12093,5976,18069,-
chr11,17099206,1.9865457782162335,17894,6964,24858,-
chr11,17099207,2.3336159909886214,17839,5193,23032,-
chr11,17099208,2.3336159909886214,17839,5193,23032,-
chr11,17099209,2.2152932261769682,15345,5179,20524,-
chr11,17099212,0.965155468580126,2009,1313,3322,-
chr11,17099213,0.8428498008428214,11378,4950,16328,-
chr11,17099214,0.8256302781814036,11011,5208,16219,-
chr11,17099216,0.8163760334225623,2572,1454,4026,-
chr11,17109474,6.230814210077654,1132,964,2096,-
chr11,17109475,4.836265294999802,1199,934,2133,-
chr11,17109476,6.0182075905268535,1442,1195,2637,-
chr11,18313214,1.186513394880439,625,485,1110,-
chr11,18502038,0.541411819179779,1244,925,2169,-
chr11,18503382,1.6850806451612903,596,495,1091,-
chr11,18505468,1.8574967511371019,2588,1823,4411,-
chr11,18505469,0.5669585038595037,3455,1745,5200,-
chr11,18505476,2.275316954534195,6314,4036,10350,-
chr11,18505477,2.275316954534195,6314,4036,10350,-
chr11,18505478,2.0162801154483967,8220,5176,13396,-
chr11,18505480,1.7534246575342467,3959,2408,6367,-
chr11,18505482,0.3487980769230769,1450,639,2089,-
chr11,18505485,0.5693464052287582,1966,1070,3036,-
chr11,18505489,1.367422584128652,1377,845,2222,-
chr11,18505491,0.9640775622957214,2663,1444,4107,-
chr11,18505525,1.9879931389365353,721,417,1138,-
chr11,18536335,1.816265060240964,669,414,1083,-
chr11,18548336,0.947634525099314,655,425,1080,-
chr11,18548337,0.947634525099314,655,425,1080,-
chr11,18633976,2.6139088729016784,653,555,1208,-
chr11,18633977,2.6139088729016784,653,555,1208,-
chr11,18633980,4.162857142857142,610,454,1064,-
chr11,18633982,4.162857142857142,610,454,1064,-
chr11,18633988,1.5534079750784797,721,508,1229,-
chr11,18633989,0.8864735266304904,598,421,1019,-
chr11,18634002,1.6676496989995844,799,636,1435,-
chr11,27387904,2.5279068250049965,989,707,1696,-
chr11,27389221,3.154964581338306,1020,693,1713,-
chr11,27389231,2.9287671371840664,642,501,1143,-
chr11,27389462,2.15933750498405,995,700,1695,-
chr11,27390213,2.1322343206002325,697,486,1183,-
chr11,27390366,1.8738475177304963,918,751,1669,-
chr11,27390382,1.6971441078986476,1723,1391,3114,-
chr11,27390394,2.46839852692346,774,590,1364,-
chr11,27390397,1.9117215339117755,1498,1212,2710,-
chr11,27390401,1.7867141085237215,1415,1092,2507,-
chr11,27390412,2.80925970581143,931,637,1568,-
chr11,27390413,2.766171965512678,1488,1101,2589,-
chr11,27393833,1.078042328042328,651,503,1154,-
chr11,27393835,1.078042328042328,651,503,1154,-
chr11,27393881,1.4335141171949375,677,457,1134,-
chr11,27911775,1.7730819560897593,1613,1316,2929,-
chr11,27911779,1.7891573038443012,2134,1645,3779,-
chr11,27911801,0.7313285238817153,1974,1738,3712,-
chr11,27911807,2.045880861850444,1152,788,1940,-
chr11,27911810,0.988150537050616,2492,2011,4503,-
chr11,27911813,2.405268811170484,1330,866,2196,-
chr11,27911817,1.6055053642010164,1557,919,2476,-
chr11,27911818,1.6055053642010164,1557,919,2476,-
chr11,27911820,1.8614136644070376,1320,690,2010,-
chr11,27911822,1.230395326577003,2300,1632,3932,-
chr11,27911834,1.717616580310881,815,771,1586,-
chr11,27911844,2.042102533068212,1195,1075,2270,-
chr11,27911845,1.780543574003067,1502,1236,2738,-
chr11,27911854,2.264505323603302,822,642,1464,-
chr11,27911855,2.264505323603302,822,642,1464,-
chr11,33120636,2.0736396220267186,687,557,1244,-
chr11,33120637,2.0736396220267186,687,557,1244,-
chr11,33127122,2.2174633945143327,2357,1864,4221,-
chr11,33127123,2.2174633945143327,2357,1864,4221,-
chr11,33127126,2.3577524893314368,1121,813,1934,-
chr11,33127155,1.5867283270938854,771,477,1248,-
chr11,33127158,2.824949113114277,669,361,1030,-
chr11,33127202,2.6771186440677965,809,589,1398,-
chr11,33127208,1.9289737722232003,706,493,1199,-
chr11,33727339,3.677808345188125,645,447,1092,-
chr11,33727957,3.2823344216381973,692,562,1254,-
chr11,33728058,1.8088439788634467,541,468,1009,-
chr11,33728070,1.2042254665849923,1050,687,1737,-
chr11,33728097,1.230636429019144,809,590,1399,-
chr11,33728099,1.2120176354984642,838,585,1423,-
chr11,33729931,0.33538906728792567,495,771,1266,-
chr11,33729938,0.46026427954658194,491,834,1325,-
chr11,33729981,0.2137337160521086,439,1293,1732,-
chr11,33729982,0.20911748527516724,723,2160,2883,-
chr11,33729997,3.037563451776649,271,1181,1452,-
chr11,33729998,5.953273610115773,595,1865,2460,-
chr11,33729999,7.048586673591134,1041,2872,3913,-
chr11,33730372,1.7382541881849098,551,466,1017,-
chr11,33730679,1.560449961775092,3383,2112,5495,-
chr11,33730791,1.6006533991720284,1210,977,2187,-
chr11,33730925,1.6637885751805648,1876,1522,3398,-
chr11,33730941,1.841882058836659,2062,1571,3633,-
chr11,33731066,1.3105611766761438,3928,2806,6734,-
chr11,33731165,1.7022549760645,1080,881,1961,-
chr11,33731299,1.432516588204767,1309,1017,2326,-
chr11,33731352,0.8104513743475551,2783,2082,4865,-
chr11,33731432,1.24832936612889,4264,2849,7113,-
chr11,33738945,0.7899280798008547,4000,2970,6970,-
chr11,33738988,1.3307191044882256,8554,5964,14518,-
chr11,33743935,1.744390546781016,2442,1764,4206,-
chr11,33743986,1.386232431737047,2672,2107,4779,-
chr11,33743993,1.2361496631766902,3541,1997,5538,-
chr11,33743998,1.3900401852906037,8406,5277,13683,-
chr11,33743999,1.4026976896167302,6243,3587,9830,-
chr11,33757945,1.3998111964656277,3355,2126,5481,-
chr11,33757949,1.001016214574829,2172,1618,3790,-
chr11,33757950,1.4614921168507728,6085,3734,9819,-
chr11,33757952,2.068348384054777,4055,1990,6045,-
chr11,33757953,2.3182521025230405,4756,2508,7264,-
chr11,33757955,2.1298821718413823,3914,2226,6140,-
chr11,33757957,2.0246326707000866,936,711,1647,-
chr11,33757962,2.3615099134382973,1591,716,2307,-
chr11,33757965,1.5443805645754307,2078,1163,3241,-
chr11,33757967,1.1358561906111597,4490,2089,6579,-
chr11,33757968,0.9955070021620964,2938,1181,4119,-
chr11,33757969,1.016863864335393,1951,716,2667,-
chr11,36295624,1.8663623200263633,584,427,1011,-
chr11,36296154,2.339828521232462,550,451,1001,-
chr11,36300141,3.189609897969704,591,430,1021,-
chr11,45937792,3.541595849471825,696,543,1239,-
chr11,46450190,0.5627765486725663,2034,1468,3502,-
chr11,46450237,1.469284202067585,830,646,1476,-
chr11,46771848,10.255694007750744,2304,1638,3942,-
chr11,46771849,7.0367721228794124,871,726,1597,-
chr11,46772687,3.0051344004832377,795,472,1267,-
chr11,46772689,3.0051344004832377,795,472,1267,-
chr11,46773074,2.7674281078034886,1028,665,1693,-
chr11,46773075,3.143890960456597,828,599,1427,-
chr11,46776542,2.393501805054152,883,553,1436,-
chr11,46776544,2.393501805054152,883,553,1436,-
chr11,46780521,1.221677215914846,1493,997,2490,-
chr11,46780527,1.710134529147982,680,445,1125,-
chr11,46784679,2.9201331114808653,779,600,1379,-
chr11,46784681,2.9201331114808653,779,600,1379,-
chr11,46784715,1.371024949604572,652,466,1118,-
chr11,46792483,2.3257517838939856,744,653,1397,-
chr11,46792502,2.8566001899335225,1151,728,1879,-
chr11,46792504,2.3900659133709983,1715,1061,2776,-
chr11,46792505,2.235892612859097,1136,687,1823,-
chr11,46792509,1.4334941361989684,1384,951,2335,-
chr11,46792511,0.7973642141381058,1226,926,2152,-
chr11,46792513,0.9896445358401881,769,591,1360,-
chr11,46797888,2.4452794233895854,960,719,1679,-
chr11,46799032,0.43403208759395834,876,592,1468,-
chr11,46799857,1.2599452197730532,919,450,1369,-
chr11,46799859,1.2599452197730532,919,450,1369,-
chr11,46801761,1.6997420551562,910,684,1594,-
chr11,46806125,1.3128159604608598,876,593,1469,-
chr11,46817309,1.5383226814721513,592,479,1071,-
chr11,47199161,0.5149451393132407,785,629,1414,-
chr11,47199165,29.06121247059523,2930,1963,4893,-
chr11,47199166,29.06121247059523,2930,1963,4893,-
chr11,47199167,25.615163704874604,2059,1512,3571,-
chr11,47199208,0.3204047495590695,785,486,1271,-
chr11,47199294,5.9077450755398235,874,1019,1893,-
chr11,47199309,5.621610747042446,1115,856,1971,-
chr11,47199310,5.448914847650539,709,539,1248,-
chr11,47199314,6.86752856720954,763,538,1301,-
chr11,47199327,16.033950383892694,1005,620,1625,-
chr11,47199328,17.610065704928246,1269,735,2004,-
chr11,47201780,0.5157057061002472,613,434,1047,-
chr11,47201877,1.9598912419360288,3933,3335,7268,-
chr11,47201878,1.8636700327890114,5585,4581,10166,-
chr11,47201879,1.9598912419360288,3933,3335,7268,-
chr11,47202009,1.4364735401459854,1144,821,1965,-
chr11,47202010,0.7054551728464772,1096,923,2019,-
chr11,47202012,1.7261608553312204,1732,1250,2982,-
chr11,47202016,0.5649663710493423,903,633,1536,-
chr11,47202018,0.6245031492692472,816,710,1526,-
chr11,47202019,0.6771745475773497,799,570,1369,-
chr11,47202021,1.2806611262230607,1860,1571,3431,-
chr11,47202022,0.9451254373727902,1354,1197,2551,-
chr11,47202032,0.4751417596488019,763,709,1472,-
chr11,47202034,0.4751417596488019,763,709,1472,-
chr11,47202038,0.5334040296924708,502,532,1034,-
chr11,47202039,0.5334040296924708,502,532,1034,-
chr11,47202059,0.2528581163507304,558,470,1028,-
chr11,47440449,2.437725622807301,564,477,1041,-
chr11,47441841,1.6947508076172817,1622,1102,2724,-
chr11,47441889,1.6170347527268614,1272,739,2011,-
chr11,47444229,1.6311399443929564,659,497,1156,-
chr11,47444382,0.5807877147434127,750,420,1170,-
chr11,47445711,2.00814822000194,940,792,1732,-
chr11,47445729,2.022458123766357,1587,1028,2615,-
chr11,47446165,1.5039839989904449,2232,1619,3851,-
chr11,47446175,1.7253528832476204,583,480,1063,-
chr11,47446250,1.6204795597484276,1454,953,2407,-
chr11,47446706,1.5162616822429906,1520,1069,2589,-
chr11,47446720,1.1090435556712581,2337,1594,3931,-
chr11,47446788,1.7237204182718768,755,552,1307,-
chr11,47447457,1.3129567161674747,41381,27334,68715,-
chr11,47447458,1.4041743731181817,57069,37108,94177,-
chr11,47447460,1.5232705602248215,36991,23218,60209,-
chr11,47447464,2.381756735730334,3298,2262,5560,-
chr11,47447469,1.6334360796461072,6117,3873,9990,-
chr11,47447470,1.7109212652966983,8969,5611,14580,-
chr11,47447472,1.8854080412181433,5854,3622,9476,-
chr11,47447476,1.4045472061657034,7972,4324,12296,-
chr11,47447478,1.5656139688519095,16072,9137,25209,-
chr11,47447484,1.6563953488372094,2232,1246,3478,-
chr11,47447493,1.6095155890353632,1984,1061,3045,-
chr11,47447498,1.639021689674313,3905,1986,5891,-
chr11,47447766,1.4717780620402945,1346,635,1981,-
chr11,47447786,1.3666767848942645,1867,1136,3003,-
chr11,47447788,1.8103194619588063,748,365,1113,-
chr11,47447789,0.627190440094529,1081,546,1627,-
chr11,47447800,0.6062701048830573,2564,1412,3976,-
chr11,47447806,1.3852146960791776,1892,1121,3013,-
chr11,47447807,1.3720259308284968,1629,965,2594,-
chr11,47640449,1.72012550425818,737,484,1221,-
chr11,47640453,2.299081035923141,773,512,1285,-
chr11,47647245,1.851890756302521,859,594,1453,-
chr11,47650548,2.6264044943820224,560,444,1004,-
chr11,47652594,1.8353669015294722,711,505,1216,-
chr11,47656271,0.6242857142857143,643,489,1132,-
chr11,47660286,4.138402390540823,3184,2386,5570,-
chr11,47660287,4.399992560453923,2069,1488,3557,-
chr11,47660564,0.5187997107736804,573,460,1033,-
chr11,47660565,0.5102770992178055,939,710,1649,-
chr11,47660567,0.5102770992178055,939,710,1649,-
chr11,47660596,0.9700245700245699,704,549,1253,-
chr11,47660598,0.9700245700245699,704,549,1253,-
chr11,47738992,2.1948318527885124,1095,861,1956,-
chr11,47738993,3.11296738265712,601,418,1019,-
chr11,47738994,3.11296738265712,601,418,1019,-
chr11,47741485,2.723707664884136,763,527,1290,-
chr11,47741486,2.723707664884136,763,527,1290,-
chr11,47744548,0.5371145087164673,663,456,1119,-
chr11,47744549,0.5334200737101713,674,468,1142,-
chr11,47753092,1.7044976944392904,580,421,1001,-
chr11,47755617,5.0,587,419,1006,-
chr11,47755619,5.0,587,419,1006,-
chr11,47758206,7.786666666666668,583,449,1032,-
chr11,47767876,3.0144122243445044,619,442,1061,-
chr11,47767878,3.0144122243445044,619,442,1061,-
chr11,47800332,3.0051107177520846,648,390,1038,-
chr11,47800464,0.4233571807101219,580,443,1023,-
chr11,47800465,0.4233571807101219,580,443,1023,-
chr11,47800558,2.039965871839777,1107,1141,2248,-
chr11,47800560,2.039965871839777,1107,1141,2248,-
chr11,47800570,2.389303482587065,1242,1071,2313,-
chr11,47800571,1.6911341668257482,1995,1643,3638,-
chr11,47800572,2.389303482587065,1242,1071,2313,-
chr11,47827706,1.0423634336677816,594,482,1076,-
chr11,47827708,1.797614771748712,770,614,1384,-
chr11,47828659,1.2978436656829246,759,545,1304,-
chr11,47834965,6.5644044094327745,614,427,1041,-
chr11,47837536,5.655573037848364,851,623,1474,-
chr11,47869456,2.1999597451429853,609,434,1043,-
chr11,57093626,0.5398032762012773,2004,2094,4098,-
chr11,57093638,0.5459244033830726,1404,1347,2751,-
chr11,57093651,17.362215624825296,4539,3722,8261,-
chr11,57093652,17.362215624825296,4539,3722,8261,-
chr11,57093684,0.3395508184240579,668,425,1093,-
chr11,57093797,1.8268551236749115,791,565,1356,-
chr11,57093810,1.9636121666446318,1059,731,1790,-
chr11,57093821,0.5356354300385109,672,474,1146,-
chr11,57093822,0.5112326420070248,1126,809,1935,-
chr11,57093827,0.8166174398007536,849,651,1500,-
chr11,57094319,2.515507246376812,1020,599,1619,-
chr11,57094339,1.955715571557156,775,504,1279,-
chr11,57094342,2.1113854595336075,591,485,1076,-
chr11,57094903,2.462597370951142,1325,1005,2330,-
chr11,57094934,0.9994805194805197,1247,839,2086,-
chr11,57094935,0.9994805194805197,1247,839,2086,-
chr11,57094944,3.571049949031601,603,544,1147,-
chr11,57094948,2.269519254971055,866,684,1550,-
chr11,57094950,1.738225313575415,1902,1455,3357,-
chr11,57095293,0.7171162273933707,1569,952,2521,-
chr11,57095316,1.5725490196078433,1202,629,1831,-
chr11,57095324,1.9995743775271333,1043,761,1804,-
chr11,57095325,1.4985461865354508,1004,525,1529,-
chr11,57095341,1.7309749510141397,1107,820,1927,-
chr11,57095342,2.142857142857143,749,559,1308,-
chr11,57095351,1.9082687338501287,1476,773,2249,-
chr11,57095352,1.9082687338501287,1476,773,2249,-
chr11,57095821,0.4845714285714286,635,374,1009,-
chr11,57097817,3.644112478031635,637,568,1205,-
chr11,57099165,1.663804945054945,854,623,1477,-
chr11,57099240,0.6591880341880342,616,431,1047,-
chr11,57099276,2.003715498938429,754,470,1224,-
chr11,57099282,1.5510204081632653,743,433,1176,-
chr11,57099288,2.20658078534844,676,378,1054,-
chr11,57099652,1.8336162988115448,539,495,1034,-
chr11,57099653,1.1449793957961838,1196,785,1981,-
chr11,57099660,0.5472876210116286,561,528,1089,-
chr11,57099742,1.655626168224299,691,534,1225,-
chr11,57099751,2.893000444403016,1191,892,2083,-
chr11,57100267,2.212080341837444,761,611,1372,-
chr11,57101977,0.6166134185303515,771,625,1396,-
chr11,57101990,1.682,753,499,1252,-
chr11,57102081,1.869111111111111,646,449,1095,-
chr11,57296260,0.48141592920353976,849,564,1413,-
chr11,57296262,0.48141592920353976,849,564,1413,-
chr11,57298183,2.503747454216176,739,495,1234,-
chr11,59376067,0.32341091466054,882,638,1520,-
chr11,59376068,0.32341091466054,882,638,1520,-
chr11,59404556,50.268976480846575,720,677,1397,-
chr11,59573808,0.37717961675088807,1004,813,1817,-
chr11,59573857,1.4109411187614178,1424,1015,2439,-
chr11,59573858,1.886193110247001,983,588,1571,-
chr11,59574028,1.4570422535211267,2068,1419,3487,-
chr11,59574031,1.1955017801657404,2125,1565,3690,-
chr11,59574032,0.9898127022868362,1065,801,1866,-
chr11,59574039,2.24296875,869,511,1380,-
chr11,59574055,2.120229483661761,679,421,1100,-
chr11,59574070,0.9598353200248936,801,632,1433,-
chr11,59574071,1.3295484906318724,1388,975,2363,-
chr11,59574269,2.7350467726868866,634,409,1043,-
chr11,59577360,2.907249129471352,573,485,1058,-
chr11,59577361,2.970127740825928,754,645,1399,-
chr11,60658245,6.203540129115406,2098,1803,3901,-
chr11,60658246,6.17505784422607,1681,1518,3199,-
chr11,60658254,13.366536458333332,837,511,1348,-
chr11,60658256,9.325072793900109,2332,1593,3925,-
chr11,60658257,10.849015728086854,1361,945,2306,-
chr11,60658323,2.4617508558160983,779,599,1378,-
chr11,60658470,0.155738819158095,490,760,1250,-
chr11,60658472,0.155738819158095,490,760,1250,-
chr11,60658514,0.3771062288461068,709,733,1442,-
chr11,60658515,0.43105976901570037,562,779,1341,-
chr11,60658518,0.1793686303753418,327,744,1071,-
chr11,60658519,0.27279379197743864,849,1519,2368,-
chr11,60658521,0.2503053650286573,295,733,1028,-
chr11,60658523,1.9936491769762419,711,898,1609,-
chr11,60658524,3.2725400457665907,314,873,1187,-
chr11,60658525,3.225733361951949,1189,2006,3195,-
chr11,60658526,3.9030069377050083,767,1463,2230,-
chr11,60665406,0.6858571343033352,738,585,1323,-
chr11,60665419,1.7756232686980609,640,436,1076,-
chr11,60666626,2.1745027125669067,1080,909,1989,-
chr11,60666627,2.3238731218697826,695,598,1293,-
chr11,60666641,1.644736842105263,624,379,1003,-
chr11,60669007,2.0268941255597808,1078,770,1848,-
chr11,60669878,2.401412523981733,1079,750,1829,-
chr11,60671224,0.999404761904762,656,539,1195,-
chr11,60671225,0.8069024137906683,1026,813,1839,-
chr11,60671327,1.1738669626704314,768,599,1367,-
chr11,60674004,1.7540489833745863,649,481,1130,-
chr11,60674056,0.27186165443871135,814,523,1337,-
chr11,60900800,1.3633891640162101,694,359,1053,-
chr11,61067135,0.6215720175555259,1015,1029,2044,-
chr11,61067164,9.789704721386315,5097,4277,9374,-
chr11,61067165,9.789704721386313,5097,4277,9374,-
chr11,61067172,12.427808302808304,1521,1007,2528,-
chr11,61067173,18.79597379919432,5597,3162,8759,-
chr11,61067174,18.795973799194318,5597,3162,8759,-
chr11,61067179,5.007666102256337,2190,1129,3319,-
chr11,61067180,3.7764487094507384,3776,1605,5381,-
chr11,61067181,4.447104981264225,3886,1728,5614,-
chr11,61067446,0.522231257114978,668,558,1226,-
chr11,61068341,6.154890219560878,592,500,1092,-
chr11,61068378,1.9449124606255952,1179,802,1981,-
chr11,61069785,2.0406993686255466,893,709,1602,-
chr11,61069794,1.6363224575558697,1744,1178,2922,-
chr11,61069801,1.0573805060918464,2148,1319,3467,-
chr11,61069803,1.2735678376064632,2900,1821,4721,-
chr11,61069811,2.5119863013698627,651,437,1088,-
chr11,61069822,1.830787309048178,1598,961,2559,-
chr11,61069824,1.5083229123436228,2131,1333,3464,-
chr11,61071349,3.801670146137787,606,478,1084,-
chr11,61071362,1.6243240485664727,994,593,1587,-
chr11,61077403,0.601159114857745,1140,948,2088,-
chr11,61077407,0.6518695729222045,1050,890,1940,-
chr11,61077792,1.9541401874445068,1912,1367,3279,-
chr11,61077794,2.205395381694556,998,780,1778,-
chr11,61077818,0.5587155963302752,782,653,1435,-
chr11,61077873,2.517206982543641,720,400,1120,-
chr11,61080988,1.3854496955055615,2001,1073,3074,-
chr11,61080993,0.6902080286661512,1917,996,2913,-
chr11,61080994,1.6393324134305802,1635,1067,2702,-
chr11,61081032,0.570884456591266,934,592,1526,-
chr11,61081048,1.88616535105941,907,580,1487,-
chr11,61081060,2.590842249378835,865,532,1397,-
chr11,61081565,1.503611971104231,557,458,1015,-
chr11,61083807,1.8588949605343048,711,548,1259,-
chr11,61083852,1.1018129849760607,1969,1396,3365,-
chr11,61084013,1.505354689252592,2540,1785,4325,-
chr11,61089150,3.017579951218029,1132,902,2034,-
chr11,61091547,1.6658882089452938,5984,3700,9684,-
chr11,61091549,1.2967773335694135,9559,5741,15300,-
chr11,61091564,0.7166900342100835,2718,1620,4338,-
chr11,61091589,1.4951269251460673,2133,962,3095,-
chr11,61093102,1.3717583668964894,2364,1539,3903,-
chr11,61093106,1.6293333333333333,1409,749,2158,-
chr11,61093113,1.6701388888888888,1026,631,1657,-
chr11,61093114,1.4852475589964615,2167,1138,3305,-
chr11,61093116,1.4852475589964615,2167,1138,3305,-
chr11,61093125,2.015574896930829,879,471,1350,-
chr11,61094258,2.037142857142857,942,573,1515,-
chr11,61094344,1.6404886561954624,939,572,1511,-
chr11,61096933,2.301538461538461,923,649,1572,-
chr11,61096938,0.5643519501180597,1544,1124,2668,-
chr11,61096948,1.7492925218186048,1233,886,2119,-
chr11,61097025,1.821852722404595,2183,1542,3725,-
chr11,61099046,1.639781362485002,819,576,1395,-
chr11,61099099,0.603235211413518,1018,668,1686,-
chr11,61099159,2.4183006511605134,1238,793,2031,-
chr11,61100411,0.4024506126531633,618,464,1082,-
chr11,61116638,19.50299604114757,1126,1205,2331,-
chr11,61116639,19.502996041147565,1126,1205,2331,-
chr11,61116643,10.684726476652267,870,481,1351,-
chr11,61116644,11.94673935043993,735,413,1148,-
chr11,61178532,2.279980657640232,819,751,1570,-
chr11,61178539,2.131854834418328,1449,1005,2454,-
chr11,61178548,1.2278859844868877,1072,577,1649,-
chr11,61178551,1.4826692581794625,596,440,1036,-
chr11,61196677,1.659493670886076,683,394,1077,-
chr11,61196678,1.659493670886076,683,394,1077,-
chr11,61196679,1.659493670886076,683,394,1077,-
chr11,61556684,2.1149650814765546,1246,969,2215,-
chr11,61557336,1.8509509066784608,1673,1291,2964,-
chr11,61557354,0.705654527583121,1923,1560,3483,-
chr11,61558039,1.5271972736748063,3191,2311,5502,-
chr11,61558052,0.5779005524861879,1045,904,1949,-
chr11,61558055,1.4111781084509074,1946,1671,3617,-
chr11,61560031,1.6052684438061768,1503,1240,2743,-
chr11,61567280,2.75143560295324,1031,847,1878,-
chr11,61567351,0.6317103620474407,1517,917,2434,-
chr11,61567390,0.7202258238537309,4950,3774,8724,-
chr11,61567391,1.0276315789473685,1484,1349,2833,-
chr11,61567419,2.386024844720497,590,459,1049,-
chr11,61567491,2.01044733981471,1365,912,2277,-
chr11,61567615,1.6106194690265483,701,564,1265,-
chr11,61567635,2.3207457883778155,790,586,1376,-
chr11,61567663,1.1298170443194364,1282,826,2108,-
chr11,61567664,1.1298170443194364,1282,826,2108,-
chr11,61567665,1.1298170443194364,1282,826,2108,-
chr11,61567671,1.2215533018105122,1335,988,2323,-
chr11,61567673,1.3898528160906078,2183,1516,3699,-
chr11,61567674,0.7512777496933644,1274,897,2171,-
chr11,61567675,1.0288309862142162,2178,1556,3734,-
chr11,61567676,1.005787037037037,868,575,1443,-
chr11,61567798,2.887832699619772,881,525,1406,-
chr11,61568005,1.5921929887447128,1032,753,1785,-
chr11,61568040,1.5557074504442925,1137,846,1983,-
chr11,61568102,1.6073563218390807,873,599,1472,-
chr11,61568210,1.4805693559693986,1011,762,1773,-
chr11,61568688,1.5606062446109563,1976,1228,3204,-
chr11,61568742,1.60317666600938,2328,1585,3913,-
chr11,61568881,1.4299136488838569,1566,1002,2568,-
chr11,61568928,1.3976721919693615,1353,982,2335,-
chr11,61568945,2.19308012120358,818,616,1434,-
chr11,61569104,1.7194581280788177,715,579,1294,-
chr11,61569124,1.6638680659670164,894,574,1468,-
chr11,61569247,0.6314156431803492,4069,2974,7043,-
chr11,61569248,0.6314156431803492,4069,2974,7043,-
chr11,61569249,0.6314156431803492,4069,2974,7043,-
chr11,61569262,2.5396353547364248,1164,840,2004,-
chr11,61569316,2.070465419747716,594,417,1011,-
chr11,61569343,1.6286554538545417,807,570,1377,-
chr11,61569344,1.6286554538545417,807,570,1377,-
chr11,61569359,2.4904060029794874,797,510,1307,-
chr11,61569460,0.4271762817605627,674,497,1171,-
chr11,61569628,0.5714044753296702,1601,1358,2959,-
chr11,61569643,0.6581494386372435,679,573,1252,-
chr11,61569649,4.981143042432033,5217,4131,9348,-
chr11,61569650,4.981143042432032,5217,4131,9348,-
chr11,61569764,3.864419345969748,5275,4164,9439,-
chr11,61569765,3.864419345969747,5275,4164,9439,-
chr11,61569809,2.112592968863626,1174,864,2038,-
chr11,61569886,0.5374287721489345,764,556,1320,-
chr11,61569891,1.6162820372598343,1030,668,1698,-
chr11,61569931,1.99296357615894,962,603,1565,-
chr11,61570278,2.823325942350333,1178,901,2079,-
chr11,61570279,2.823325942350333,1178,901,2079,-
chr11,61570372,0.5640163265306123,750,624,1374,-
chr11,61570566,1.6516318812158564,906,648,1554,-
chr11,61570864,2.4687981510015407,753,648,1401,-
chr11,61578269,0.5827284249337481,594,525,1119,-
chr11,61578276,0.5016891891891893,593,443,1036,-
chr11,61578282,1.823272540457231,545,457,1002,-
chr11,61578302,0.47540167458701066,807,490,1297,-
chr11,61578475,0.5219572576544691,1144,845,1989,-
chr11,61580027,1.7178109786805438,757,517,1274,-
chr11,61580042,2.250139176667879,1177,796,1973,-
chr11,61580782,1.0928844694762736,1322,1117,2439,-
chr11,61580799,1.7126148705096076,573,440,1013,-
chr11,61580805,2.041510611735331,843,533,1376,-
chr11,61584100,1.478392572943907,1167,875,2042,-
chr11,61584102,1.4631787275374657,922,779,1701,-
chr11,61643630,1.8095100864553315,1287,693,1980,-
chr11,61643632,1.5866672475096422,5646,3143,8789,-
chr11,61643633,1.847927973344466,2759,1606,4365,-
chr11,61643636,2.24764083500143,1047,537,1584,-
chr11,61643641,1.564510746228808,1266,680,1946,-
chr11,61643649,1.9125568086180775,908,456,1364,-
chr11,61643838,1.689795918367347,827,440,1267,-
chr11,61643858,1.7481736140954018,677,357,1034,-
chr11,61643870,0.5715262154133759,1784,952,2736,-
chr11,61643906,1.6468507585489718,4823,2639,7462,-
chr11,61643909,1.829589327869001,3339,2334,5673,-
chr11,61643912,1.7948089076416442,3037,2542,5579,-
chr11,61643913,1.5840974743209428,7114,4888,12002,-
chr11,61643914,0.9570985789289993,4939,2507,7446,-
chr11,61643915,1.956879400229262,4001,3118,7119,-
chr11,61643917,1.624001111346743,5558,3774,9332,-
chr11,61643918,0.3847121432027092,993,476,1469,-
chr11,61643919,1.698539455710833,4269,3037,7306,-
chr11,61643920,1.6311532278534564,3047,2119,5166,-
chr11,61643921,1.6311532278534564,3047,2119,5166,-
chr11,61643923,0.9034837093715895,2119,1094,3213,-
chr11,61643924,1.2503962574371936,2760,1360,4120,-
chr11,61644351,0.4707492302429011,1289,789,2078,-
chr11,61644352,0.4908412111980145,1714,1007,2721,-
chr11,61646243,0.45308875784613356,910,599,1509,-
chr11,61646787,1.9678068440655114,670,518,1188,-
chr11,61732257,1.2054396543864,45781,30155,75936,-
chr11,61732278,1.265618271985584,40414,24686,65100,-
chr11,61732287,1.348197050722215,24367,13702,38069,-
chr11,61732552,1.1234874580186904,25313,18854,44167,-
chr11,61732584,1.1033997112638485,2052,1481,3533,-
chr11,61732842,1.2581032470559035,41538,26556,68094,-
chr11,61732880,1.2170507946035158,23534,17081,40615,-
chr11,61732898,1.270564507696169,32934,17791,50725,-
chr11,61732899,1.270564507696169,32934,17791,50725,-
chr11,61732906,1.2738472296676333,29743,16729,46472,-
chr11,61732907,1.3947342157395104,15564,9380,24944,-
chr11,61734853,1.369647435897436,9965,4949,14914,-
chr11,61734859,1.444154159718362,3801,3083,6884,-
chr11,61734863,1.337608834965958,3513,2842,6355,-
chr11,61734865,1.157948573480898,8770,4342,13112,-
chr11,61734907,1.3934578946266383,24128,14044,38172,-
chr11,61734908,1.3943692496185676,24227,12071,36298,-
chr11,61734910,1.3396656990198423,18353,9554,27907,-
chr11,61734911,1.2516770266770267,3168,2375,5543,-
chr11,61734916,0.8396335350043215,6353,2924,9277,-
chr11,61734921,1.5570838496489054,1638,1344,2982,-
chr11,61734924,1.4678625435351222,6772,3579,10351,-
chr11,61734925,1.0816916207290284,4033,2734,6767,-
chr11,61734928,0.7336501569584932,1277,975,2252,-
chr11,61734931,1.8685638847283539,6271,3286,9557,-
chr11,61735049,1.3048403215613658,2710,2451,5161,-
chr11,61735054,1.6523791910532843,2489,2241,4730,-
chr11,61735060,1.3439752832131822,4407,3883,8290,-
chr11,61735062,1.4535338321759506,12091,8991,21082,-
chr11,61735063,1.3840793528505395,6141,5279,11420,-
chr11,61735065,1.4368062368096035,3994,3420,7414,-
chr11,61735071,1.9325830653804927,1481,1243,2724,-
chr11,61735072,1.5705382583674496,6708,4613,11321,-
chr11,61735093,1.4320702121702718,996,726,1722,-
chr11,61735096,0.570651659888395,1096,969,2065,-
chr11,61735097,1.5349067502888267,743,497,1240,-
chr11,61735098,1.006714060807634,4204,3162,7366,-
chr11,61735099,1.1028715935102305,4175,3111,7286,-
chr11,62283792,15.568329123065485,1081,1254,2335,-
chr11,62283793,15.568329123065485,1081,1254,2335,-
chr11,62284858,3.0115922517340774,850,640,1490,-
chr11,62327283,1.4863636363636363,10136,6819,16955,-
chr11,62327599,1.151263872535511,10009,5906,15915,-
chr11,62327793,1.43909433077198,8504,5595,14099,-
chr11,62327808,1.4162861939057316,6856,4129,10985,-
chr11,62327816,1.3262074021026762,31323,20701,52024,-
chr11,62327818,1.3865573389320074,21341,12327,33668,-
chr11,62327828,1.7461261759822913,4206,2183,6389,-
chr11,62327839,1.827621483375959,3572,1954,5526,-
chr11,62327840,1.4517044250787423,3528,2803,6331,-
chr11,62327841,1.2068915263722428,2642,2091,4733,-
chr11,62327845,1.39991544055471,5427,4049,9476,-
chr11,62327846,1.4124019772883858,7937,5854,13791,-
chr11,62327848,1.5253015538544867,6911,5101,12012,-
chr11,62327857,1.389672479203913,5534,3152,8686,-
chr11,62327858,0.7567164179104479,1286,937,2223,-
chr11,62327865,1.3598266631231677,2356,1381,3737,-
chr11,62327866,1.710222222222222,961,499,1460,-
chr11,62327871,1.7852167570074202,2706,1649,4355,-
chr11,62327872,1.747033493242591,1933,1252,3185,-
chr11,62327874,0.8600146041836693,851,750,1601,-
chr11,62327875,0.7181684757442333,1203,1052,2255,-
chr11,62327877,0.8260059159609384,754,666,1420,-
chr11,62334939,1.154684547074901,16462,9714,26176,-
chr11,62334994,1.2151534808265934,37606,28016,65622,-
chr11,62335000,1.1507532202896442,749,545,1294,-
chr11,62338443,1.287130806525667,39497,26350,65847,-
chr11,62338444,1.287130806525667,39497,26350,65847,-
chr11,62338467,1.3727224677538885,13416,8061,21477,-
chr11,62338469,1.3727224677538885,13416,8061,21477,-
chr11,62338476,1.2268119609536994,15017,9579,24596,-
chr11,62339019,1.2086747437962508,9707,5894,15601,-
chr11,62339048,1.6304697237113852,23311,16234,39545,-
chr11,62339058,1.1868896283621833,5087,3072,8159,-
chr11,62339071,1.2855210760766258,11201,6209,17410,-
chr11,62339076,1.2051351355116815,4886,2836,7722,-
chr11,62340124,2.1707157387551055,15514,12301,27815,-
chr11,62340158,1.2110098563160525,25241,16955,42196,-
chr11,62340177,1.5579435483870967,10448,6879,17327,-
chr11,62340179,1.559236567911625,15336,9971,25307,-
chr11,62340180,1.5616078275191685,16645,9573,26218,-
chr11,62340192,1.0526890933874622,14833,7414,22247,-
chr11,62340193,0.9616841295780064,10718,4943,15661,-
chr11,62340195,1.1302830676813185,7164,4329,11493,-
chr11,62340196,1.225714701683228,17913,11350,29263,-
chr11,62340203,1.309062709590879,2838,1703,4541,-
chr11,62340209,1.3838849173158323,8043,4690,12733,-
chr11,62341321,1.4138298327325434,2885,1997,4882,-
chr11,62341326,1.722207758396251,1224,834,2058,-
chr11,62341330,1.9071532543148264,1078,686,1764,-
chr11,62341333,0.9511440357952822,4848,2491,7339,-
chr11,62341334,0.8853454449462962,4955,2556,7511,-
chr11,62341335,0.8853454449462962,4955,2556,7511,-
chr11,62364145,1.9121517378854977,681,443,1124,-
chr11,62365173,1.9042263948091462,822,596,1418,-
chr11,62368151,0.1978797267535182,588,622,1210,-
chr11,62384544,11.506041572253299,545,509,1054,-
chr11,62392372,0.5336169140954641,1911,2679,4590,-
chr11,62392373,0.453756124806418,1464,1654,3118,-
chr11,62392390,10.763264852735235,6988,9175,16163,-
chr11,62392391,10.763264852735237,6988,9175,16163,-
chr11,62392398,10.524488163668934,6891,5798,12689,-
chr11,62392399,10.524488163668934,6891,5798,12689,-
chr11,62392404,1.9741499870753776,3783,1831,5614,-
chr11,62392405,1.988956132656902,5317,2049,7366,-
chr11,62392406,2.541761544974963,6972,2597,9569,-
chr11,62392407,2.6748447204968944,3131,1149,4280,-
chr11,62392408,3.8882326684323387,5976,2418,8394,-
chr11,62392409,7.588219940838698,1761,820,2581,-
chr11,62392411,10.282256293985698,7797,1864,9661,-
chr11,62392412,13.329415675815227,9518,1849,11367,-
chr11,62392413,13.276131282409711,11824,2044,13868,-
chr11,62392414,15.775552042574345,9341,1277,10618,-
chr11,62392415,13.188036308870174,8218,866,9084,-
chr11,62392417,8.554769211685304,4996,369,5365,-
chr11,62392418,10.106434775001404,6746,443,7189,-
chr11,62392419,11.847861547162275,10031,659,10690,-
chr11,62392420,13.508091780470506,9819,620,10439,-
chr11,62392421,15.28621859817715,7978,487,8465,-
chr11,62392422,21.396298293201692,3116,207,3323,-
chr11,62392589,0.6888888888888889,2428,1734,4162,-
chr11,62392726,1.4701347240330291,2140,1474,3614,-
chr11,62392873,0.4813408056737178,15335,10885,26220,-
chr11,62392874,0.4735679680095823,12393,9020,21413,-
chr11,62392969,1.759712667272761,5569,3833,9402,-
chr11,62392970,1.7110244109701511,4026,2618,6644,-
chr11,62393120,0.7559591523479445,4265,3093,7358,-
chr11,62393249,14.76568881075966,18961,14883,33844,-
chr11,62393250,14.76568881075966,18961,14883,33844,-
chr11,62393251,14.76568881075966,18961,14883,33844,-
chr11,62393255,13.399528559110744,9630,4332,13962,-
chr11,62393256,14.424670364216423,6550,2627,9177,-
chr11,62393309,0.6779115842110452,3833,2301,6134,-
chr11,62393540,1.3231821006836544,2128,1608,3736,-
chr11,62393542,2.065680868251905,2261,1603,3864,-
chr11,62393616,1.3581424936386768,2134,1571,3705,-
chr11,62394093,1.0792171625764164,3448,2346,5794,-
chr11,62394337,1.508780450640916,1740,1418,3158,-
chr11,62394380,1.454697111875717,1743,1389,3132,-
chr11,62394395,1.375386518243661,1667,1322,2989,-
chr11,62394534,1.806988352745424,1628,1201,2829,-
chr11,62394801,1.5720156555772993,1384,1021,2405,-
chr11,62394810,1.8345409194679252,2367,1885,4252,-
chr11,62396468,4.186002931690948,3809,2888,6697,-
chr11,62396470,8.524081421484832,5446,4283,9729,-
chr11,62396473,6.682472978121961,3557,2398,5955,-
chr11,62396480,2.2145345596432557,858,597,1455,-
chr11,62396727,1.435270935960591,1213,811,2024,-
chr11,62396746,0.5685131195335277,714,538,1252,-
chr11,62396748,1.6578831796223101,754,620,1374,-
chr11,62397103,1.9840490797546013,1022,814,1836,-
chr11,62397305,1.110830807520761,2519,1990,4509,-
chr11,62397694,2.057730590577306,1328,1095,2423,-
chr11,62397724,1.7659090909090909,1294,1044,2338,-
chr11,62397893,1.4672809024850455,1090,873,1963,-
chr11,62397895,1.39749597817724,1331,985,2316,-
chr11,62397897,1.6002424242424242,942,749,1691,-
chr11,62397912,3.416485138078842,934,748,1682,-
chr11,62397954,1.8758573388203017,1093,728,1821,-
chr11,62398254,1.6876937799043064,1277,949,2226,-
chr11,62398639,1.5532510544458882,2765,2158,4923,-
chr11,62398641,1.5532510544458882,2765,2158,4923,-
chr11,62398642,1.5562596006144391,1620,923,2543,-
chr11,62400091,1.0850948461691048,2202,1823,4025,-
chr11,62400118,1.8774155291809842,2092,1690,3782,-
chr11,62400175,1.4857755083432116,1206,996,2202,-
chr11,62400204,1.3879093198992445,1652,1190,2842,-
chr11,62400714,1.647658335355496,1454,950,2404,-
chr11,62400717,1.1950820358435703,4435,3208,7643,-
chr11,62400718,1.269781563079242,5492,4146,9638,-
chr11,62400719,0.65380063723259,1196,844,2040,-
chr11,62400920,3.091870540265036,1054,871,1925,-
chr11,62402409,1.5397658866259951,3711,2803,6514,-
chr11,62402410,1.49520328536355,5855,4222,10077,-
chr11,62406471,1.7344950769519067,5365,3951,9316,-
chr11,62406849,1.4997570830622837,3999,3200,7199,-
chr11,62407131,0.7822843631129844,2407,1774,4181,-
chr11,62407132,1.5593901826101524,1431,1269,2700,-
chr11,62407138,1.3671162960262486,1499,1265,2764,-
chr11,62407155,1.3576387626767474,1799,1341,3140,-
chr11,62407178,0.5519228964759185,1210,920,2130,-
chr11,62414073,1.3858880090497738,1088,543,1631,-
chr11,62414082,0.5299232586384286,3840,2314,6154,-
chr11,62414083,0.5477378499267644,5638,3752,9390,-
chr11,62414084,0.5266060106253859,5308,3426,8734,-
chr11,62414085,0.6017699115044248,747,582,1329,-
chr11,62414086,0.4058131317786586,1015,570,1585,-
chr11,62430386,2.3244931871053507,1248,1002,2250,-
chr11,62430400,0.7642055959571058,1859,1097,2956,-
chr11,62430406,0.5577718773412631,2786,1765,4551,-
chr11,62430407,0.5991260502354812,5011,3276,8287,-
chr11,62430410,0.5311445508435932,1819,1274,3093,-
chr11,62430411,0.5726875483659686,2394,1735,4129,-
chr11,62430418,1.3822341857335128,1026,742,1768,-
chr11,62430419,1.0886570492100769,1630,1219,2849,-
chr11,62430769,5.3569241046115685,569,445,1014,-
chr11,62432434,3.4223887137707014,890,566,1456,-
chr11,62444054,2.597153366384136,579,480,1059,-
chr11,62444073,2.5212450592885376,728,505,1233,-
chr11,62444089,0.5358391608391608,612,415,1027,-
chr11,62444094,2.33411174945522,1604,1203,2807,-
chr11,62444096,2.440279542566709,1168,786,1954,-
chr11,62444349,1.2793850752642255,748,645,1393,-
chr11,62444351,1.2793850752642255,748,645,1393,-
chr11,62444378,2.0160349854227406,921,636,1557,-
chr11,62444379,2.0160349854227406,921,636,1557,-
chr11,62444465,1.7598086124401913,612,494,1106,-
chr11,62445422,2.27340394494349,30468,24309,54777,-
chr11,62445423,2.27340394494349,30468,24309,54777,-
chr11,62445424,2.708805279227814,13509,12011,25520,-
chr11,62445455,1.46637930153931,2909,2082,4991,-
chr11,62445460,1.2754843104214044,9881,6340,16221,-
chr11,62445461,1.3336077382177405,3439,1848,5287,-
chr11,62445470,1.774322169059011,1334,683,2017,-
chr11,62445489,1.7981643105460707,5449,3484,8933,-
chr11,62445491,1.6227224280566408,1826,1158,2984,-
chr11,62445492,0.5878129958589728,1641,956,2597,-
chr11,62445493,2.124040920716112,1660,1036,2696,-
chr11,62445503,2.8718096255805348,1518,838,2356,-
chr11,62445551,1.0594067188447256,1834,1123,2957,-
chr11,62445874,0.6027866869086725,1564,1140,2704,-
chr11,62482588,0.1920987654320987,388,629,1017,-
chr11,62482589,0.1920987654320987,388,629,1017,-
chr11,62487621,2.028591498085122,1709,1179,2888,-
chr11,62488820,2.1426106891210495,744,435,1179,-
chr11,62488849,0.37519445036052,1020,549,1569,-
chr11,62490178,3.0357385279529634,763,529,1292,-
chr11,62562435,1.2547256112105756,1230,903,2133,-
chr11,62562436,0.7174574209245743,673,547,1220,-
chr11,62591948,1.8945955839131856,635,399,1034,-
chr11,62601295,0.5480039843690139,595,420,1015,-
chr11,62601303,3.724750448394701,821,562,1383,-
chr11,62601939,1.6188498120968517,830,631,1461,-
chr11,62609158,0.9187058089911531,1007,643,1650,-
chr11,62609206,0.5830808015177898,911,544,1455,-
chr11,62619585,1.8425101130103112,1589,1150,2739,-
chr11,62619761,1.649282920469361,1149,884,2033,-
chr11,62620033,1.4255016809343914,1370,945,2315,-
chr11,62620090,2.5164750957854407,820,579,1399,-
chr11,62620112,3.43010752688172,791,557,1348,-
chr11,62621438,0.9878735956223685,10071,7680,17751,-
chr11,62621439,0.9816252720022879,32519,26485,59004,-
chr11,62621440,0.985735133664521,31407,25574,56981,-
chr11,62621993,0.6998998998999,1291,998,2289,-
chr11,62622166,0.9249617124575397,55489,42325,97814,-
chr11,62622167,0.9162097287249631,20638,17618,38256,-
chr11,62622404,1.6545166402535658,898,630,1528,-
chr11,62622553,0.9679046139939528,9965,6573,16538,-
chr11,62622554,0.9929610353698415,11213,7356,18569,-
chr11,62622555,0.9929610353698415,11213,7356,18569,-
chr11,62622835,0.9031640571282636,7329,5449,12778,-
chr11,62622836,1.1228382735823097,1148,1185,2333,-
chr11,62622837,0.9549692703071269,9678,7597,17275,-
chr11,62622838,1.0346471095650784,2582,2413,4995,-
chr11,62622901,4.010315925209542,621,516,1137,-
chr11,62623353,0.8242643913360888,860,521,1381,-
chr11,63342413,2.412492345376607,937,709,1646,-
chr11,63342439,0.5163633523392954,600,412,1012,-
chr11,63357688,0.9768674500780672,950,565,1515,-
chr11,63357690,0.9768674500780672,950,565,1515,-
chr11,63357724,3.8649437915989937,697,466,1163,-
chr11,63381536,2.219336370883191,600,425,1025,-
chr11,63396820,1.4583284495090376,2563,2006,4569,-
chr11,63396826,2.5374316939890718,752,609,1361,-
chr11,63396829,2.2003553368867026,699,541,1240,-
chr11,63396866,0.8919069652152358,1166,987,2153,-
chr11,63396867,1.1692109044079433,1859,1419,3278,-
chr11,63396873,3.106546929144863,1767,1201,2968,-
chr11,63414026,2.190342691083422,677,538,1215,-
chr11,63426300,1.455334987593052,611,402,1013,-
chr11,63426301,1.455334987593052,611,402,1013,-
chr11,63426302,1.455334987593052,611,402,1013,-
chr11,63767779,1.3388871747403066,565,462,1027,-
chr11,63767780,1.3388871747403066,565,462,1027,-
chr11,63767781,1.5757597008612756,793,646,1439,-
chr11,63919793,1.7596115338406086,702,453,1155,-
chr11,63933179,1.8542671298143913,843,718,1561,-
chr11,63991414,3.591263895502555,1330,1188,2518,-
chr11,63991416,3.3929157723012433,900,816,1716,-
chr11,64012038,1.7558578987150415,605,440,1045,-
chr11,64012411,0.4744690851600222,1387,1075,2462,-
chr11,64012412,0.4744690851600222,1387,1075,2462,-
chr11,64012413,1.624335747939845,6076,4892,10968,-
chr11,64012414,1.556101029653572,5346,4132,9478,-
chr11,64012415,1.5525424939932295,4475,3341,7816,-
chr11,64012417,1.5687243219227218,3915,3184,7099,-
chr11,64012418,1.7013966713811197,1983,1765,3748,-
chr11,64012423,2.177583567746099,1167,957,2124,-
chr11,64012715,6.9857236232418085,625,457,1082,-
chr11,64084280,0.8424388587547993,3775,2647,6422,-
chr11,64084334,1.5614811393993353,4997,3893,8890,-
chr11,64084337,0.7275251081897608,1781,1323,3104,-
chr11,64084338,1.6636031612980482,1821,1192,3013,-
chr11,64084339,0.622951609793715,1550,1367,2917,-
chr11,64084350,1.8595421944015829,2969,1817,4786,-
chr11,64084351,1.7640869421864753,2884,2079,4963,-
chr11,64084355,0.4776964833608685,1103,891,1994,-
chr11,64084369,2.1000964310902166,2404,1531,3935,-
chr11,64084572,2.105479529919299,2342,2002,4344,-
chr11,64084605,1.7331784909909913,984,767,1751,-
chr11,64084611,1.473067666855333,3023,2009,5032,-
chr11,64084737,1.3788098693759072,2224,1377,3601,-
chr11,64084740,1.6065709932691075,3455,2338,5793,-
chr11,64084780,1.7679750417180586,1522,1252,2774,-
chr11,64084809,0.5702440180052121,995,803,1798,-
chr11,64084833,1.8335244648318043,1085,871,1956,-
chr11,64084996,0.6798327137546468,1063,806,1869,-
chr11,64085012,0.9319051134152565,5945,4476,10421,-
chr11,64085013,1.0427841705278824,6015,4318,10333,-
chr11,64085015,1.341032093582932,1610,942,2552,-
chr11,64536991,6.447867000741916,870,617,1487,-
chr11,64536992,6.827973788913246,1191,869,2060,-
chr11,64627687,1.8572316876010448,785,730,1515,-
chr11,64627688,1.9187587363712608,1115,1021,2136,-
chr11,64627690,2.24614287412338,1026,894,1920,-
chr11,64627691,2.771244850025028,946,786,1732,-
chr11,64627693,3.3172043010752685,616,495,1111,-
chr11,64627695,1.6601144060427449,690,538,1228,-
chr11,64845179,3.1625,626,379,1005,-
chr11,64845180,3.1625,626,379,1005,-
chr11,64845494,1.3072625698324023,782,536,1318,-
chr11,64845496,0.840232310982203,1385,1055,2440,-
chr11,64845684,1.546274784619078,809,662,1471,-
chr11,64845706,2.206453708023431,742,628,1370,-
chr11,64845707,2.206453708023431,742,628,1370,-
chr11,64846066,1.1205767674538365,895,590,1485,-
chr11,64846067,1.386835336184896,1471,1075,2546,-
chr11,64850988,1.2062316777206932,759,571,1330,-
chr11,64888178,1.428281126985539,7465,5172,12637,-
chr11,64888180,1.6484982510362467,4558,3598,8156,-
chr11,64888181,1.544352614655213,7041,4733,11774,-
chr11,64888994,1.405374649859944,3379,2855,6234,-
chr11,64889042,1.2438573478171755,3633,2974,6607,-
chr11,64889080,1.2715917555165013,9163,5708,14871,-
chr11,64889232,0.8558796946776546,5582,4155,9737,-
chr11,64889567,2.012172772375543,5902,4674,10576,-
chr11,64889586,1.3554282685454677,13460,8944,22404,-
chr11,64889589,1.331966079626927,4471,2385,6856,-
chr11,64889592,1.613729508196721,1574,1219,2793,-
chr11,64889596,1.8375448671931087,3937,1989,5926,-
chr11,64889601,1.4740383338497631,3599,1652,5251,-
chr11,64889603,0.8608024788448834,2498,1659,4157,-
chr11,64889605,0.6804332041265342,8889,5127,14016,-
chr11,64889606,0.6622055686700488,6136,3168,9304,-
chr11,64889607,0.6654690382941059,7501,4185,11686,-
chr11,64889610,1.3851598843948505,1317,726,2043,-
chr11,64889624,2.004078605858361,1080,557,1637,-
chr11,64889630,1.6629638944779788,1830,851,2681,-
chr11,64889631,1.6629638944779788,1830,851,2681,-
chr11,64889648,2.103252713102203,1666,840,2506,-
chr11,64889649,2.3981386451867848,1834,816,2650,-
chr11,64889651,2.4126528340094584,1240,506,1746,-
chr11,64889656,1.6642578357310287,915,344,1259,-
chr11,64894998,4.812950957023739,556,453,1009,-
chr11,65429487,0.5959578051591171,995,777,1772,-
chr11,65429528,1.4224888878742568,1564,1127,2691,-
chr11,65429529,1.7735077036182432,1437,1042,2479,-
chr11,65429534,2.600053110613136,1694,1121,2815,-
chr11,65429655,2.058747993579454,725,444,1169,-
chr11,65429657,1.9475747243739376,1147,664,1811,-
chr11,65487237,4.119291355243415,795,714,1509,-
chr11,65487238,2.4901002506265666,640,569,1209,-
chr11,65622457,0.9716496898248613,5532,4262,9794,-
chr11,65622464,0.7700260604953083,3370,2926,6296,-
chr11,65622514,1.6478620221228517,7349,4422,11771,-
chr11,65622515,1.6478620221228517,7349,4422,11771,-
chr11,65622586,0.7637344118638354,3501,2966,6467,-
chr11,65622630,1.3320388349514565,1721,1544,3265,-
chr11,65622636,1.4218882466281308,970,864,1834,-
chr11,65622639,1.661286466727846,1682,1456,3138,-
chr11,65622640,1.5886821337346841,2838,2466,5304,-
chr11,65622644,1.27443294560704,2479,1681,4160,-
chr11,65622645,1.2049366068466623,3394,2322,5716,-
chr11,65622647,1.019136626613262,915,641,1556,-
chr11,65622648,0.5013618859772706,627,506,1133,-
chr11,65622650,1.2147084410571845,1548,916,2464,-
chr11,65622651,1.2147084410571845,1548,916,2464,-
chr11,65622665,1.901586717368438,1906,1110,3016,-
chr11,65622667,1.7084700200473848,1414,707,2121,-
chr11,65622688,39.4265354258881,5906,2145,8051,-
chr11,65622689,39.09398440883812,5326,1934,7260,-
chr11,65622828,1.669462481962482,2248,1583,3831,-
chr11,65623408,1.381261271787744,10661,7558,18219,-
chr11,65623488,1.2280868403881937,21260,17056,38316,-
chr11,65623498,1.626039034117833,7985,6330,14315,-
chr11,65623499,1.4774087195349248,13926,10295,24221,-
chr11,65623582,1.2324771279554012,13396,10215,23611,-
chr11,65623585,1.2672665404072574,4498,3737,8235,-
chr11,65623618,1.4118643997391342,5839,4912,10751,-
chr11,65623619,1.3801274414154039,10155,8404,18559,-
chr11,65623627,1.375215890789171,5357,4424,9781,-
chr11,65623628,1.375215890789171,5357,4424,9781,-
chr11,65625571,1.3013976771979774,10713,8230,18943,-
chr11,65625592,1.8270107171215861,3628,3166,6794,-
chr11,65625603,1.9359762678006507,5751,4424,10175,-
chr11,65625613,1.5662191582002902,2135,1271,3406,-
chr11,65625615,1.1274654106564617,1914,1342,3256,-
chr11,65625617,1.1274654106564617,1914,1342,3256,-
chr11,65625623,1.7815612099727125,1468,808,2276,-
chr11,65625627,1.6386138613861387,1323,706,2029,-
chr11,65625628,1.7504202965000766,880,726,1606,-
chr11,65625632,1.6626553821740282,1142,596,1738,-
chr11,65625640,1.1801886792452831,1806,909,2715,-
chr11,65625642,1.1801886792452831,1806,909,2715,-
chr11,65651490,2.4775853028663826,676,402,1078,-
chr11,65653105,2.178311700762885,1012,873,1885,-
chr11,65653106,2.253872633390706,581,580,1161,-
chr11,65655512,1.0358575874984204,634,387,1021,-
chr11,66052138,1.878924853430709,1031,784,1815,-
chr11,66052164,0.855297157622739,992,620,1612,-
chr11,66052165,0.855297157622739,992,620,1612,-
chr11,66052434,1.7272217540450925,3396,2601,5997,-
chr11,66052435,1.7896949574765657,2270,1697,3967,-
chr11,66052891,2.68144107804855,907,691,1598,-
chr11,66052921,1.0638120972770737,852,565,1417,-
chr11,66052923,1.0638120972770737,852,565,1417,-
chr11,66055076,1.5372886753198063,2341,1611,3952,-
chr11,66055077,1.2310468757896995,3105,2041,5146,-
chr11,66055078,0.9194739686542965,1407,975,2382,-
chr11,66055100,1.6759639851242905,684,392,1076,-
chr11,66055320,1.5647382920110195,851,593,1444,-
chr11,66055561,3.267338470657973,847,481,1328,-
chr11,66055570,2.1023761031907675,552,490,1042,-
chr11,66055604,2.1231634885901847,565,456,1021,-
chr11,66055641,0.4525416724066676,656,426,1082,-
chr11,66055677,1.9839656619322594,1005,685,1690,-
chr11,66055728,1.871820533349757,777,472,1249,-
chr11,66056511,0.7961177696717039,678,605,1283,-
chr11,66056512,0.7961177696717039,678,605,1283,-
chr11,66056600,0.4621923694064287,871,608,1479,-
chr11,66056601,0.4857335629645029,1013,722,1735,-
chr11,66107611,2.469212620995304,675,410,1085,-
chr11,66107617,2.8404109589041098,637,437,1074,-
chr11,66109700,0.6052372211603414,723,520,1243,-
chr11,66113097,9.640676106941166,933,803,1736,-
chr11,66113101,6.792258224581038,960,698,1658,-
chr11,66114277,2.356181692450574,512,517,1029,-
chr11,66203349,1.7234042553191489,758,516,1274,-
chr11,66203485,2.0010351201478747,795,540,1335,-
chr11,66203495,1.7460954930834447,601,497,1098,-
chr11,66203578,2.3671516160106907,1209,954,2163,-
chr11,66204616,1.789260777975612,4125,2721,6846,-
chr11,66204619,1.9849025769956,1532,1074,2606,-
chr11,66204627,1.4273345315308277,1426,954,2380,-
chr11,66204629,1.2522866289372894,3504,2057,5561,-
chr11,66204630,1.4449805150556911,7565,4757,12322,-
chr11,66204631,1.54911270571048,2184,1368,3552,-
chr11,66204667,1.1084228323768248,1368,856,2224,-
chr11,66204668,1.1084228323768248,1368,856,2224,-
chr11,66204669,1.7162939948046656,935,676,1611,-
chr11,66205647,1.960446150944214,4237,3380,7617,-
chr11,66205672,1.6922855648535564,1220,955,2175,-
chr11,66205710,0.6982336004980157,996,904,1900,-
chr11,66205714,1.672700502338472,622,501,1123,-
chr11,66205716,2.0380896226415097,822,794,1616,-
chr11,66205717,0.5231707317073171,593,409,1002,-
chr11,66206114,1.9892852173912559,606,465,1071,-
chr11,66206123,1.764636364671443,1019,728,1747,-
chr11,66206124,1.8250992522041534,901,553,1454,-
chr11,66206294,0.7296550834161166,727,534,1261,-
chr11,66335463,1.614114335341419,8658,5981,14639,-
chr11,66335464,1.6115163590927974,5445,4408,9853,-
chr11,66335465,1.614114335341419,8658,5981,14639,-
chr11,66335471,0.9477246842398723,4267,2396,6663,-
chr11,66335472,0.5619625118025666,3682,1868,5550,-
chr11,66335476,2.9426209579382445,930,456,1386,-
chr11,66335479,0.4559466019417475,866,411,1277,-
chr11,66335485,1.7341176470588235,736,373,1109,-
chr11,66335496,0.49404855539824855,672,488,1160,-
chr11,66335500,2.319408474337688,1126,662,1788,-
chr11,66616053,16.85863921794934,1909,1708,3617,-
chr11,66616054,16.85863921794934,1909,1708,3617,-
chr11,66616536,1.0413244578129697,776,571,1347,-
chr11,66617246,2.0100946410346374,886,549,1435,-
chr11,66617549,1.551924689458242,1247,1054,2301,-
chr11,66620027,1.2400756143667298,1024,574,1598,-
chr11,66620028,1.2400756143667298,1024,574,1598,-
chr11,66620029,1.4659720561889915,1291,784,2075,-
chr11,66638350,0.7529490736803501,565,626,1191,-
chr11,66638352,1.168987933910536,625,671,1296,-
chr11,66638535,13.658047094727456,561,470,1031,-
chr11,66639338,2.124138815714231,680,428,1108,-
chr11,66639547,1.6713857129567695,582,502,1084,-
chr11,67166011,1.8903782829310674,1013,721,1734,-
chr11,67168239,1.9205443371378406,624,535,1159,-
chr11,67168591,2.7318375177245806,711,630,1341,-
chr11,67168592,2.7318375177245806,711,630,1341,-
chr11,67168644,3.115784008307373,705,641,1346,-
chr11,67168645,3.115784008307373,705,641,1346,-
chr11,67206334,18.3819018957396,759,454,1213,-
chr11,67206335,21.635689741815188,660,346,1006,-
chr11,67210037,3.5676753887142727,716,375,1091,-
chr11,67450236,0.7989348364435143,3833,2810,6643,-
chr11,67450240,1.6047896266848507,2068,1532,3600,-
chr11,67450246,1.5797932330827067,1292,911,2203,-
chr11,67450257,2.8461123110151187,752,462,1214,-
chr11,67450258,1.7558032378676183,5672,3849,9521,-
chr11,67450259,1.7750435553883768,3546,2585,6131,-
chr11,67450260,2.0745695135107995,4600,3173,7773,-
chr11,67450262,2.690403005464481,684,365,1049,-
chr11,67450270,1.2872456151173073,1335,1159,2494,-
chr11,67450277,1.3526603164420943,3387,2506,5893,-
chr11,67450278,1.3382144813732653,3552,2737,6289,-
chr11,67450279,1.3382144813732653,3552,2737,6289,-
chr11,67450280,1.405997459996882,2733,2150,4883,-
chr11,67821291,2.381566713156672,660,477,1137,-
chr11,67821302,1.7364746945898777,994,572,1566,-
chr11,67821315,0.4523809523809524,645,363,1008,-
chr11,67821325,2.2490391465651998,917,621,1538,-
chr11,67821332,3.6370903277378095,699,416,1115,-
chr11,67821333,3.6370903277378095,699,416,1115,-
chr11,68035708,4.231798282774563,641,408,1049,-
chr11,68227683,1.6211458125282707,1670,997,2667,-
chr11,68227684,1.6211458125282707,1670,997,2667,-
chr11,68660418,1.784100886748476,1841,1366,3207,-
chr11,68660425,1.913861167900456,1434,971,2405,-
chr11,68660905,0.5474711623779946,616,482,1098,-
chr11,68664078,2.0641586989545173,699,588,1287,-
chr11,68664079,2.0641586989545173,699,588,1287,-
chr11,68665440,2.307590759075908,873,605,1478,-
chr11,68665470,0.6224462244622445,727,541,1268,-
chr11,69488025,8.691224164748625,884,653,1537,-
chr11,69488026,10.78853046594982,601,402,1003,-
chr11,71145702,2.64494303380251,607,523,1130,-
chr11,71145734,2.069990412272291,761,446,1207,-
chr11,71145735,2.5720212670172318,1008,651,1659,-
chr11,71145988,0.923347280334728,612,477,1089,-
chr11,71145989,0.923347280334728,612,477,1089,-
chr11,71146199,1.1656904000936565,1198,954,2152,-
chr11,71146233,0.4656940961932984,680,534,1214,-
chr11,71146272,1.9544383346425769,621,401,1022,-
chr11,71146311,0.918727272727273,651,499,1150,-
chr11,71146312,0.918727272727273,651,499,1150,-
chr11,71146349,4.996684350132626,684,376,1060,-
chr11,71146350,3.716337522441652,1034,556,1590,-
chr11,71146352,2.9960753532182105,693,363,1056,-
chr11,71155083,2.3421619583530213,870,607,1477,-
chr11,71159349,6.412299764302176,1537,1227,2764,-
chr11,71159350,6.412299764302176,1537,1227,2764,-
chr11,71725303,3.505425219941349,612,619,1231,-
chr11,71725305,3.505425219941349,612,619,1231,-
chr11,71725317,0.4617021276595745,557,469,1026,-
chr11,71725319,0.4617021276595745,557,469,1026,-
chr11,71727568,3.344862459546926,718,411,1129,-
chr11,71727570,3.344862459546926,718,411,1129,-
chr11,71729249,1.3780837909614756,1546,1032,2578,-
chr11,71729250,1.7442021194900938,1016,765,1781,-
chr11,71729293,1.0224137931034485,592,419,1011,-
chr11,71729294,1.0669656600090645,1150,722,1872,-
chr11,71729447,2.7447226157679436,899,506,1405,-
chr11,71729449,0.4661096663531234,1052,582,1634,-
chr11,71729450,0.8102441948508956,1853,1016,2869,-
chr11,71808484,0.4166796503265325,1167,1036,2203,-
chr11,71808486,0.42442255434782605,734,639,1373,-
chr11,71808554,7.607429644725249,1436,1403,2839,-
chr11,71808562,7.143211362985609,1403,1052,2455,-
chr11,71808575,2.4402091951057363,801,514,1315,-
chr11,71808644,8.685509748680781,3590,2334,5924,-
chr11,71808645,9.878414732901861,3679,2334,6013,-
chr11,71808646,9.267848141140842,4213,2651,6864,-
chr11,71808647,11.910448802793711,1879,1158,3037,-
chr11,71808673,3.784090909090909,924,439,1363,-
chr11,71808675,3.784090909090909,924,439,1363,-
chr11,71809345,1.1130001821604227,779,765,1544,-
chr11,71809347,1.1130001821604227,779,765,1544,-
chr11,71809431,2.3792642181417993,580,489,1069,-
chr11,71810228,1.4030650466315766,1082,701,1783,-
chr11,71810229,0.9978364015942304,847,478,1325,-
chr11,72289984,1.7501237293160514,1061,821,1882,-
chr11,72289986,2.272282089219514,635,528,1163,-
chr11,72289987,1.918442109322279,795,505,1300,-
chr11,72289989,1.918442109322279,795,505,1300,-
chr11,73387334,2.897248736664795,644,410,1054,-
chr11,73387806,1.3417217851984802,9246,6641,15887,-
chr11,73387836,0.662249423265319,2027,1608,3635,-
chr11,73387837,1.5428620218579234,1667,975,2642,-
chr11,73387841,0.4107158769634568,1689,1386,3075,-
chr11,73387855,2.2952251552795033,1074,735,1809,-
chr11,73387860,1.7098727759775552,2120,1573,3693,-
chr11,73387874,1.8421885995777625,848,587,1435,-
chr11,73387882,1.62410394265233,724,495,1219,-
chr11,73388212,3.73974609375,850,511,1361,-
chr11,73388265,2.3873883830793945,1245,822,2067,-
chr11,73388278,1.0797184604000913,970,779,1749,-
chr11,73388301,0.34578434178419093,908,737,1645,-
chr11,73388302,2.6044005388414906,695,392,1087,-
chr11,73388461,1.3472098254677447,885,700,1585,-
chr11,73388840,0.60258728613159,721,552,1273,-
chr11,73418497,1.8482871125611744,823,612,1435,-
chr11,73418516,1.7188306028912763,1379,870,2249,-
chr11,73427362,2.2097289306192116,908,591,1499,-
chr11,73441852,2.843524982603035,1073,811,1884,-
chr11,73583937,2.589641434262948,849,752,1601,-
chr11,73583974,2.647887323943662,610,496,1106,-
chr11,73584035,0.6643679277354184,1139,697,1836,-
chr11,73584082,1.882953925507117,925,610,1535,-
chr11,73584083,1.7341819203782327,1209,1102,2311,-
chr11,73584091,2.0236893203883497,578,514,1092,-
chr11,73584237,2.257099236641221,879,654,1533,-
chr11,73584238,2.257099236641221,879,654,1533,-
chr11,73584310,2.4917323321714395,906,532,1438,-
chr11,73587878,0.5630804568854252,1128,613,1741,-
chr11,73587880,0.5005128262357733,1451,987,2438,-
chr11,76061937,0.5456819525843335,805,591,1396,-
chr11,76063426,1.950393356643357,1070,623,1693,-
chr11,76063427,2.2524427223719674,1572,895,2467,-
chr11,76063429,2.5403707953378825,1025,570,1595,-
chr11,76063450,2.532916666608857,1214,641,1855,-
chr11,76063460,2.9482498648949287,1218,641,1859,-
chr11,76063625,2.0874330665289405,802,537,1339,-
chr11,77327477,1.5430464206016161,3353,2320,5673,-
chr11,77327516,2.915233030966531,1164,833,1997,-
chr11,77327659,1.3110487900460468,2378,1383,3761,-
chr11,77330700,1.6085419211308325,2161,1599,3760,-
chr11,77333659,0.6978021978021978,1142,881,2023,-
chr11,77336029,0.6203703703703703,1272,890,2162,-
chr11,77340898,0.6117546117546118,867,665,1532,-
chr11,77348646,0.9508792048929664,994,871,1865,-
chr11,77348647,0.9508792048929664,994,871,1865,-
chr11,77348648,0.3506845193320294,776,577,1353,-
chr11,77348649,1.9263397475687976,664,536,1200,-
chr11,77348650,1.9710144927536237,783,482,1265,-
chr11,77348794,1.3799861336479713,815,607,1422,-
chr11,77348815,2.2373519382394385,832,635,1467,-
chr11,77348817,2.4588359788359786,627,377,1004,-
chr11,77411934,2.647695939519372,1251,908,2159,-
chr11,77411936,2.647695939519372,1251,908,2159,-
chr11,77614653,1.82345601996257,631,457,1088,-
chr11,77781025,1.555352835673202,2066,1405,3471,-
chr11,77784129,1.598984302293332,2255,1782,4037,-
chr11,77784131,1.472815809784218,4111,3126,7237,-
chr11,77784164,1.5488798370672097,1520,981,2501,-
chr11,77784171,1.4322167365645626,1207,896,2103,-
chr11,77784174,0.6486264862648626,1129,812,1941,-
chr11,77790660,1.5373474278994927,2135,1409,3544,-
chr11,77790687,1.6344916344916345,634,443,1077,-
chr11,77790746,3.7700854700854696,801,389,1190,-
chr11,77790808,2.3053489702517163,596,436,1032,-
chr11,77790833,1.6211128178773395,1897,1297,3194,-
chr11,77790885,1.1323265928254167,1476,1054,2530,-
chr11,77815433,1.9729865957341342,925,644,1569,-
chr11,77820500,2.6917081540864043,676,502,1178,-
chr11,78154745,1.962189054726368,985,803,1788,-
chr11,78154746,1.962189054726368,985,803,1788,-
chr11,82535584,4.146823848717073,739,670,1409,-
chr11,82535918,1.8800458144720442,1120,767,1887,-
chr11,82549535,2.22640853053451,950,657,1607,-
chr11,82560159,0.4182092417386535,609,428,1037,-
chr11,82611347,2.673494790285466,767,639,1406,-
chr11,82687297,2.5322092935671834,956,587,1543,-
chr11,82972784,2.654791592447453,1619,801,2420,-
chr11,82972847,2.1161795208738448,1985,1180,3165,-
chr11,82972876,2.07673786407767,921,514,1435,-
chr11,82985003,1.6219512195121952,1203,687,1890,-
chr11,82985007,1.9879885993485344,1115,613,1728,-
chr11,82985018,2.2596660808435853,972,568,1540,-
chr11,85374366,1.4088117849069037,604,430,1034,-
chr11,85374794,0.9268876685875667,574,463,1037,-
chr11,85668881,5.462636004326735,1546,1362,2908,-
chr11,85669045,0.6852272727272727,1205,1011,2216,-
chr11,85669058,3.3119810825013136,1691,1383,3074,-
chr11,85669060,18.630849522566784,9456,7618,17074,-
chr11,85669061,19.865196177454234,9209,7201,16410,-
chr11,85669062,19.865196177454234,9209,7201,16410,-
chr11,85669063,19.15905808477237,1837,1224,3061,-
chr11,85669205,0.5173422232512332,2218,1633,3851,-
chr11,85669267,1.768124630141982,2157,1453,3610,-
chr11,85669489,2.743622828784119,1083,649,1732,-
chr11,85670018,0.61366930171278,1201,879,2080,-
chr11,85685780,0.5788192088140195,724,532,1256,-
chr11,85685847,2.082116067903672,585,446,1031,-
chr11,85687682,0.5152546093064092,625,535,1160,-
chr11,85692221,0.6899825921823073,871,711,1582,-
chr11,85692950,1.706648697214735,654,529,1183,-
chr11,85693000,1.8067080745341613,605,482,1087,-
chr11,85693020,1.960248238846025,805,541,1346,-
chr11,85694962,0.4301075268817204,587,440,1027,-
chr11,85707929,0.5404698030491396,589,492,1081,-
chr11,85707947,1.900437636761488,578,456,1034,-
chr11,85712163,1.8385838583858385,765,605,1370,-
chr11,85712183,1.7543517002255649,1812,1215,3027,-
chr11,85722094,1.596,930,749,1679,-
chr11,85722100,1.6514778325123152,893,695,1588,-
chr11,85722127,1.5668740279937792,805,642,1447,-
chr11,85725989,2.0686383601756955,840,682,1522,-
chr11,85742516,1.8832236842105263,686,575,1261,-
chr11,85742652,1.95906432748538,669,512,1181,-
chr11,85779706,2.736467306515083,1084,826,1910,-
chr11,85779834,3.392478116081501,797,798,1595,-
chr11,85779874,3.0997765108276174,532,514,1046,-
chr11,85780035,7.1426148609282345,2216,1826,4042,-
chr11,85780036,7.1426148609282345,2216,1826,4042,-
chr11,85780042,14.187163267263934,2766,1728,4494,-
chr11,85780043,14.495096516512218,3102,1868,4970,-
chr11,85780044,17.929003021148038,1143,661,1804,-
chr11,85780045,52.16045845272206,665,348,1013,-
chr11,85780122,0.9387725834522149,1049,587,1636,-
chr11,88027152,2.3724724264705883,1399,1023,2422,-
chr11,88027154,0.6049661399548533,602,442,1044,-
chr11,88027289,1.8848823586205112,1823,1255,3078,-
chr11,88027378,2.5672564854840685,1541,1279,2820,-
chr11,88027640,2.08149820079586,1506,1146,2652,-
chr11,88029361,1.7452631578947366,828,569,1397,-
chr11,88029363,0.4385957775698653,1197,805,2002,-
chr11,88045611,2.4421083245257784,3034,2679,5713,-
chr11,88045622,0.5125581395348837,753,558,1311,-
chr11,88045643,12.199558933902996,2575,2077,4652,-
chr11,88059447,1.897475442219457,1226,1005,2231,-
chr11,88059448,1.9427931931141176,867,740,1607,-
chr11,88068237,0.732890447699608,1305,924,2229,-
chr11,88068238,3.111917098445596,1154,964,2118,-
chr11,88068243,0.5510162222636582,1018,864,1882,-
chr11,88070683,1.5225538060027606,1319,1048,2367,-
chr11,88070688,1.7367655613728912,852,572,1424,-
chr11,88070701,2.0052675585284283,826,519,1345,-
chr11,88070764,2.2964669738863286,779,433,1212,-
chr11,89934870,1.6206382650701476,875,670,1545,-
chr11,89935717,1.8125,710,473,1183,-
chr11,89936583,4.380330722367276,718,382,1100,-
chr11,89938660,2.003997715591091,637,411,1048,-
chr11,89943740,1.7681050656660418,759,532,1291,-
chr11,89944416,2.3352272727272725,684,439,1123,-
chr11,89947205,1.5602232006868133,1064,762,1826,-
chr11,89956105,2.6962391537444734,777,413,1190,-
chr11,89956106,3.178165798269429,881,550,1431,-
chr11,93463539,0.9794753088633299,3257,2461,5718,-
chr11,93465417,1.823019483306154,2123,1527,3650,-
chr11,93466669,0.4202189610994642,655,476,1131,-
chr11,93468402,1.2244633587489098,956,785,1741,-
chr11,93469889,1.6134298067317525,1286,914,2200,-
chr11,93470362,1.9021287642782967,861,641,1502,-
chr11,93471373,1.7822913360837829,701,410,1111,-
chr11,93471409,1.5185185185185184,942,689,1631,-
chr11,93471411,1.9579104796496103,631,406,1037,-
chr11,93471412,1.8909216253740633,1753,1184,2937,-
chr11,93471598,3.0602752728998577,805,601,1406,-
chr11,93471602,3.2009803921568625,652,458,1110,-
chr11,93471603,2.0035674289390983,1492,1085,2577,-
chr11,93472464,0.3818181818181818,594,424,1018,-
chr11,93472494,0.6222044728434504,778,625,1403,-
chr11,93474529,1.138681383868059,1233,1139,2372,-
chr11,93474531,0.9398884239888424,585,477,1062,-
chr11,93474552,1.5792750696053433,592,694,1286,-
chr11,93474589,14.51482805074243,1023,825,1848,-
chr11,93474592,26.342121851768017,1471,773,2244,-
chr11,93474593,30.516189614520716,873,502,1375,-
chr11,93474596,7.185210396508543,1078,370,1448,-
chr11,94170395,0.2722929936305732,683,470,1153,-
chr11,94170396,0.2722929936305732,683,470,1153,-
chr11,94180429,2.939128050452427,793,520,1313,-
chr11,94180600,6.003766263828125,613,396,1009,-
chr11,94192673,1.6871346578903836,717,546,1263,-
chr11,94201000,2.3558823529411765,711,479,1190,-
chr11,94201002,2.9352352022218366,993,653,1646,-
chr11,94201020,0.10094596257178416,1298,805,2103,-
chr11,94696626,0.5850804485616772,799,585,1384,-
chr11,94704202,2.0651080945198594,794,458,1252,-
chr11,94704560,1.959261498525253,1068,721,1789,-
chr11,95568311,2.4932456959266274,664,465,1129,-
chr11,95578119,1.6591672961565402,755,627,1382,-
chr11,95580900,5.145332752467016,658,495,1153,-
chr11,95583833,2.164691663718901,2318,1541,3859,-
chr11,95583835,2.164691663718901,2318,1541,3859,-
chr11,95583850,1.6795677799607074,1647,1017,2664,-
chr11,95583851,1.6795677799607074,1647,1017,2664,-
chr11,95583856,2.964784576037773,684,390,1074,-
chr11,95590742,1.7873536299765809,635,426,1061,-
chr11,95590760,0.8911661021635446,954,628,1582,-
chr11,95590762,0.8911661021635446,954,628,1582,-
chr11,95621402,3.054956896551724,629,463,1092,-
chr11,95621404,3.054956896551724,629,463,1092,-
chr11,102267282,2.555086372360844,623,520,1143,-
chr11,102267302,1.595588235294118,811,543,1354,-
chr11,102268082,2.798796726493907,1630,1220,2850,-
chr11,102268634,1.6122540250447228,720,515,1235,-
chr11,102268638,2.007175925925926,666,479,1145,-
chr11,102268639,1.7441498599580376,2043,1402,3445,-
chr11,102268640,1.7441498599580376,2043,1402,3445,-
chr11,102268667,1.9322680995475112,910,543,1453,-
chr11,102268703,3.0212922173274595,822,453,1275,-
chr11,102269169,1.4095640858815874,1237,847,2084,-
chr11,102269239,3.3977695167286246,913,537,1450,-
chr11,102269367,2.188337801608579,652,372,1024,-
chr11,102272335,0.7045921024415649,1149,805,1954,-
chr11,102272679,2.1382827324478177,600,495,1095,-
chr11,102272684,0.5177434030937216,568,470,1038,-
chr11,102272779,1.7820131030375221,747,510,1257,-
chr11,102272782,0.5886860491322965,652,521,1173,-
chr11,102272800,1.9220212102308165,710,457,1167,-
chr11,102319563,1.2350308263331502,639,572,1211,-
chr11,102933109,1.5861426256077795,850,616,1466,-
chr11,102937235,1.5863131935881627,2200,1621,3821,-
chr11,102937238,1.4919831223628692,2001,1154,3155,-
chr11,102937258,1.842825308171843,1389,908,2297,-
chr11,102953500,1.6734029227557412,690,478,1168,-
chr11,104813673,2.094206680584551,641,478,1119,-
chr11,104817879,1.969607947868817,624,505,1129,-
chr11,104819313,1.7633949955790504,1236,854,2090,-
chr11,104820380,2.930577636459989,789,628,1417,-
chr11,104821669,0.5888214904679376,754,576,1330,-
chr11,104822670,2.842415586318025,3609,1516,5125,-
chr11,104822672,1.6298226950354606,7010,4699,11709,-
chr11,104822678,0.6643713559058115,5119,2512,7631,-
chr11,104822679,0.5756012738604614,1732,1088,2820,-
chr11,104822687,1.199194226456003,6690,3690,10380,-
chr11,104822724,1.4937178037441887,2014,1136,3150,-
chr11,104825478,0.5793233082706767,1272,664,1936,-
chr11,104825506,2.1024942604770613,1227,828,2055,-
chr11,104825714,1.3661155347032683,1235,1030,2265,-
chr11,104825716,1.683828168195324,1679,1353,3032,-
chr11,104839293,3.145772186793624,1003,456,1459,-
chr11,104839305,1.3992726876208605,878,436,1314,-
chr11,104897579,3.233632676709154,949,862,1811,-
chr11,104897583,2.1250684481436863,923,793,1716,-
chr11,104904986,4.471403072798747,839,506,1345,-
chr11,104904987,4.471403072798747,839,506,1345,-
chr11,104905142,2.7528409090909087,662,415,1077,-
chr11,104905143,2.7528409090909087,662,415,1077,-
chr11,104912396,1.402214266772739,1626,1256,2882,-
chr11,104912427,2.1044117647058824,953,679,1632,-
chr11,104915168,1.1283672364730382,2671,1831,4502,-
chr11,104915184,1.661959268618998,859,650,1509,-
chr11,104915209,2.3727891156462584,1089,587,1676,-
chr11,104915326,1.564916821699156,2181,1584,3765,-
chr11,104915363,1.7823609226594301,1641,1209,2850,-
chr11,104915384,1.4504690279799448,1236,915,2151,-
chr11,104916031,1.8108392056374119,1962,1114,3076,-
chr11,104916032,1.8321853335568223,2667,1648,4315,-
chr11,104916045,0.6458443780286651,1349,677,2026,-
chr11,104916048,2.2059458767624727,860,576,1436,-
chr11,104916058,2.386726807953018,1235,728,1963,-
chr11,104916060,1.0274295702537035,1359,681,2040,-
chr11,104916061,0.7093463553115746,1245,696,1941,-
chr11,105879251,8.496259855047766,1139,1028,2167,-
chr11,105879252,10.142537084195581,806,654,1460,-
chr11,105880570,3.395616241466044,755,505,1260,-
chr11,105880571,3.3668758858068437,722,448,1170,-
chr11,107676192,0.6059370360372518,679,485,1164,-
chr11,110100350,1.9517257646041355,855,552,1407,-
chr11,110100688,1.0793169322734062,964,651,1615,-
chr11,110101255,0.8881308411214952,730,534,1264,-
chr11,110101256,0.7445603869707382,938,761,1699,-
chr11,110101260,1.3510627024443338,1042,872,1914,-
chr11,110101261,2.134070796460177,688,451,1139,-
chr11,110102544,2.019770237777184,629,393,1022,-
chr11,110102663,2.1446040520811165,1000,635,1635,-
chr11,110118501,1.4289851917290968,4277,3189,7466,-
chr11,110118502,2.089791772473337,2285,1789,4074,-
chr11,110118525,1.695281124497992,1841,1327,3168,-
chr11,110118526,1.695281124497992,1841,1327,3168,-
chr11,110124726,1.9917726887192537,1020,785,1805,-
chr11,110124763,3.033070866141732,855,507,1362,-
chr11,110124806,1.7986928104575162,687,458,1145,-
chr11,110124833,2.391374504914185,626,400,1026,-
chr11,110128595,0.5503056884635832,636,417,1053,-
chr11,110134866,1.7865498483458893,580,428,1008,-
chr11,110135510,0.3986710963455149,959,601,1560,-
chr11,110135511,0.3986710963455149,959,601,1560,-
chr11,111956003,2.5008309380647766,1076,645,1721,-
chr11,111956022,1.860369817991074,697,562,1259,-
chr11,111957377,2.7455946802422155,619,418,1037,-
chr11,118886601,1.0165039896476167,5558,4107,9665,-
chr11,118886609,1.391980825479363,2224,1447,3671,-
chr11,118886612,0.6869363807868198,2528,1477,4005,-
chr11,118886614,1.021526652522937,4254,3574,7828,-
chr11,118886615,1.630853994490358,1812,1154,2966,-
chr11,118886631,2.2249344692005244,1508,871,2379,-
chr11,118886635,1.8716619981325862,1705,839,2544,-
chr11,118888675,0.83857489979241,9146,5303,14449,-
chr11,118888693,1.2579306224190352,9716,7204,16920,-
chr11,118888741,1.5461344657655798,6504,5659,12163,-
chr11,118888747,1.426102023705206,6043,5116,11159,-
chr11,118889011,1.5611664749898948,16396,11107,27503,-
chr11,118889035,1.2078854535080983,20722,13612,34334,-
chr11,118889041,1.4704294812053431,3489,2959,6448,-
chr11,118889048,1.6045341702187457,6116,2884,9000,-
chr11,118889050,0.9104528604861717,8027,6668,14695,-
chr11,118889051,0.8243476051487704,20652,12897,33549,-
chr11,118889052,0.8450159237229529,30254,19913,50167,-
chr11,118889053,0.826076909539119,19444,10783,30227,-
chr11,118889056,0.3300943790971221,1419,958,2377,-
chr11,118916148,6.0845543326988665,885,758,1643,-
chr11,118916149,5.638070498018758,601,462,1063,-
chr11,118919020,3.8033256538291753,632,418,1050,-
chr11,118919539,2.5550660792951545,608,453,1061,-
chr11,118919541,2.5550660792951545,608,453,1061,-
chr11,119179402,2.186498223450454,1203,744,1947,-
chr11,119179454,2.1791744840525324,1615,1247,2862,-
chr11,119179455,2.1791744840525324,1615,1247,2862,-
chr11,119179612,3.2536231884057965,897,735,1632,-
chr11,119179642,1.6388243335611756,998,626,1624,-
chr11,119179648,1.961089918256131,946,733,1679,-
chr11,119179686,1.418970189701897,1121,737,1858,-
chr11,119179690,0.445863900834809,704,535,1239,-
chr11,119179691,1.9743689320388347,655,514,1169,-
chr11,119179709,1.8023553507424481,879,557,1436,-
chr11,119179719,2.2190875475682184,1390,897,2287,-
chr11,119179874,0.3800330943188085,688,517,1205,-
chr11,119179893,0.4873590442875695,1357,1074,2431,-
chr11,119180282,2.818767507002801,693,509,1202,-
chr11,119180297,1.951004193334805,779,590,1369,-
chr11,119180401,0.3714607691224116,585,457,1042,-
chr11,119180604,0.6424147293398947,796,567,1363,-
chr11,119180615,0.5266892115907433,610,456,1066,-
chr11,119180620,1.9170015990250007,1839,1231,3070,-
chr11,119180622,1.9667529987798502,1601,1212,2813,-
chr11,119181136,1.7121212121212122,677,485,1162,-
chr11,119181137,1.8633802816901412,685,496,1181,-
chr11,119181508,1.6367309697601669,865,547,1412,-
chr11,119181519,1.5809716599190284,780,493,1273,-
chr11,119181520,0.9454037813813235,1637,1308,2945,-
chr11,119181521,0.5988295129937992,1145,925,2070,-
chr11,119181889,1.937899141158335,549,477,1026,-
chr11,119182016,0.4876344086021505,906,719,1625,-
chr11,119182018,0.986421058968207,1711,1400,3111,-
chr11,119182019,1.3079710144927537,1234,1034,2268,-
chr11,119182020,1.4338562534179216,1697,1335,3032,-
chr11,119182114,3.7045009784735803,630,510,1140,-
chr11,119182119,0.4855901890648952,730,514,1244,-
chr11,119182120,1.8507021433850703,625,491,1116,-
chr11,119182258,0.5206477732793522,642,474,1116,-
chr11,119182522,2.310014885950046,924,695,1619,-
chr11,119182765,2.396296632477081,799,478,1277,-
chr11,119182801,1.0883190720749125,1091,845,1936,-
chr11,119183016,0.5198098256735341,737,630,1367,-
chr11,119183044,1.1172366148531951,1865,1157,3022,-
chr11,119183045,1.1172366148531951,1865,1157,3022,-
chr11,119183059,0.6307247308372168,784,507,1291,-
chr11,119183063,3.392202277552596,702,470,1172,-
chr11,119183244,2.3714611129189715,582,438,1020,-
chr11,119183293,2.946107784431138,819,500,1319,-
chr11,119183350,1.701,728,499,1227,-
chr11,119183652,1.573083995004387,1719,1274,2993,-
chr11,119185203,1.5698552021020853,719,576,1295,-
chr11,119185236,3.1565543071161053,601,444,1045,-
chr11,119185402,1.6308668076109938,664,472,1136,-
chr11,119185442,1.8556786703601107,637,379,1016,-
chr11,122928444,1.3187442583744335,5795,4313,10108,-
chr11,122928446,1.332926608250975,12808,9860,22668,-
chr11,122928447,1.3123666669827152,5427,3964,9391,-
chr11,122928456,1.4569361277445112,2407,1669,4076,-
chr11,122929069,1.7224080577684981,17153,15661,32814,-
chr11,122929072,1.3789518328338404,26446,24674,51120,-
chr11,122929098,1.5618414346980354,22378,16095,38473,-
chr11,122929099,1.4360861995297378,16924,11530,28454,-
chr11,122929125,1.6077868262591168,4951,3757,8708,-
chr11,122929798,1.3548911164880748,4125,2892,7017,-
chr11,122930311,1.0742229841814241,12774,8736,21510,-
chr11,122930318,1.400572840137141,3965,2845,6810,-
chr11,122930411,1.5093108831400537,3530,2831,6361,-
chr11,122930419,1.363400387502803,9529,6624,16153,-
chr11,122930426,1.519005083452633,3028,2200,5228,-
chr11,122930650,1.1801452188680204,18841,12883,31724,-
chr11,122930870,1.2037448613999822,10531,7681,18212,-
chr11,122930876,0.786938649297556,5210,3930,9140,-
chr11,122931325,1.3661957302750973,11238,7351,18589,-
chr11,122931377,1.3592800401520133,9451,7706,17157,-
chr11,122931482,1.4654506014592783,5743,3687,9430,-
chr11,122931866,1.4879549811113475,3110,2410,5520,-
chr11,122931910,1.7742115027829315,3405,2694,6099,-
chr11,122931958,1.3808183466827868,2657,2035,4692,-
chr11,122931989,1.2694976479216313,6154,4037,10191,-
chr11,122932836,1.3608233184408898,10911,6997,17908,-
chr11,122932837,1.3229178251467406,8437,4979,13416,-
chr11,122932838,0.919777230844826,15440,9967,25407,-
chr11,122932839,0.943018030616621,4045,3231,7276,-
chr11,122932840,0.8423624033490724,12273,8425,20698,-
chr11,122932841,0.8244051703641562,2871,2278,5149,-
chr11,122932843,0.84487723678356,4149,3249,7398,-
chr11,122932845,0.9622491683476098,4784,3747,8531,-
chr11,122932846,0.9831240997038776,1845,1365,3210,-
chr11,122941158,2.372615641392465,750,698,1448,-
chr11,122941554,2.319036621577037,780,432,1212,-
chr11,122941555,2.319036621577037,780,432,1212,-
chr11,122941591,3.6046799003333603,623,486,1109,-
chr11,122941592,4.038643459125228,820,571,1391,-
chr11,122943023,1.2649184664411108,614,403,1017,-
chr11,122943876,3.856238715446854,1481,1124,2605,-
chr11,122944073,1.724116359086644,688,555,1243,-
chr11,122944095,2.06031746031746,648,489,1137,-
chr11,122944107,1.176621835443038,1321,947,2268,-
chr11,122944109,1.176621835443038,1321,947,2268,-
chr11,122953909,3.0079744816586924,942,527,1469,-
chr11,122953911,3.0079744816586924,942,527,1469,-
chr11,122955230,0.5177250978686386,1057,835,1892,-
chr11,122955231,0.5177250978686386,1057,835,1892,-
chr11,126133309,1.1378156346836357,628,500,1128,-
chr11,126133530,0.2824916943521595,772,699,1471,-
chr11,126133531,0.2824916943521595,772,699,1471,-
chr11,126133821,2.7862500000000003,742,399,1141,-
chr11,126133823,2.7862500000000003,742,399,1141,-
chr11,134037979,1.4485243689687048,600,424,1024,-
chr11,134073961,2.538308389796648,978,841,1819,-
chr11,134073963,1.0448273822561278,823,708,1531,-
chr11,134079238,4.575539568345324,635,416,1051,-
chr11,134079239,4.575539568345324,635,416,1051,-
chr11,134119761,2.1624063989108238,2082,1807,3889,-
chr11,134119763,1.8594856576304097,5242,3937,9179,-
chr11,134119764,2.1147923455036426,4184,2642,6826,-
chr11,134119767,1.6609706083390292,971,759,1730,-
chr11,134119770,1.867503344988022,1755,1047,2802,-
chr11,134119782,0.5768833849329206,730,322,1052,-
chr11,134119794,1.5071600412418378,597,405,1002,-
chr11,134119798,1.5983266083926613,1480,767,2247,-
chr11,134119799,1.5864151873767258,756,506,1262,-
chr11,134119800,1.0541267942583732,939,417,1356,-
chr11,134120175,1.9028657616892908,995,662,1657,-
chr11,134120176,1.9028657616892908,995,662,1657,-
chr11,134120204,2.650205761316873,804,485,1289,-
chr11,134120205,2.1492812116629176,1036,617,1653,-
chr12,6438728,2.2278823529411764,652,424,1076,-
chr12,6438730,2.2278823529411764,652,424,1076,-
chr12,6439132,3.6404828233928823,623,386,1009,-
chr12,6439849,0.6165338645418327,618,501,1119,-
chr12,6440041,2.820581592320723,688,505,1193,-
chr12,6440086,1.6393579162565306,1030,842,1872,-
chr12,6440087,1.4623632280820364,2262,1724,3986,-
chr12,6442300,1.7946105072463767,633,383,1016,-
chr12,6442660,1.8691056910569104,626,409,1035,-
chr12,6443288,0.4831957706209203,688,500,1188,-
chr12,6451201,0.6720282435416661,644,380,1024,-
chr12,6451204,1.687977768727691,665,375,1040,-
chr12,6601490,2.1778106297181097,4074,2818,6892,-
chr12,6601522,1.3999202778885027,1755,1032,2787,-
chr12,6601564,1.4251665351004748,1686,1016,2702,-
chr12,6601610,1.753009708737864,731,617,1348,-
chr12,6601611,0.5562851147363433,1173,868,2041,-
chr12,6602085,2.0855670103092785,577,484,1061,-
chr12,6602129,1.9949912638322655,518,504,1022,-
chr12,6602238,1.6057416267942584,838,569,1407,-
chr12,6602413,0.3736361679781209,746,499,1245,-
chr12,6602416,0.7943426436577121,569,461,1030,-
chr12,6602417,0.7145078143579942,927,839,1766,-
chr12,6675448,1.0506598446334305,1042,621,1663,-
chr12,6675449,1.6712840795226827,974,577,1551,-
chr12,6675450,1.2979645822617385,767,438,1205,-
chr12,6687262,1.5409095772279597,818,615,1433,-
chr12,6692521,2.6781696879033294,584,569,1153,-
chr12,6692530,4.793608862047875,528,487,1015,-
chr12,6700697,3.0938589547616133,862,633,1495,-
chr12,6701618,5.774617732377694,650,503,1153,-
chr12,6701619,5.774617732377694,650,503,1153,-
chr12,6702694,2.275904834271022,631,524,1155,-
chr12,6708974,2.1633086166359616,783,456,1239,-
chr12,6711274,5.625713567513216,1007,541,1548,-
chr12,6711276,5.658189889655264,812,434,1246,-
chr12,6788679,0.5240418118466899,751,454,1205,-
chr12,6857245,0.5838709677419355,542,495,1037,-
chr12,6857252,1.3038540979368032,936,798,1734,-
chr12,6857253,1.7018584420719651,806,561,1367,-
chr12,6857286,0.5934195064629847,605,413,1018,-
chr12,6857551,2.01768396582563,1948,1382,3330,-
chr12,6857591,1.0960451586853284,1739,1132,2871,-
chr12,6857592,0.8763713951407529,1383,834,2217,-
chr12,6857638,0.5788423153692615,695,500,1195,-
chr12,6858029,9.474129581193138,1235,781,2016,-
chr12,6859379,2.1971350784376655,1440,1144,2584,-
chr12,6859407,0.49832327297116036,742,567,1309,-
chr12,6859415,0.6325827716465446,898,586,1484,-
chr12,6859903,1.4936378466557911,871,612,1483,-
chr12,6859912,1.851530190239868,813,557,1370,-
chr12,6859913,2.503734827264239,864,509,1373,-
chr12,6860836,2.5985774146907854,932,614,1546,-
chr12,6862116,2.2076612903225805,875,495,1370,-
chr12,6862117,2.2076612903225805,875,495,1370,-
chr12,6862220,5.374254588984979,935,642,1577,-
chr12,6862225,6.470688251998019,647,452,1099,-
chr12,7074565,3.151621551428251,1639,1170,2809,-
chr12,7074667,0.4768860212226492,4921,3532,8453,-
chr12,7074716,1.5585741757266967,2627,1918,4545,-
chr12,7074728,1.8140151430047853,1467,946,2413,-
chr12,7074749,1.6488974819315934,730,556,1286,-
chr12,7074854,1.7241287339971552,901,702,1603,-
chr12,7075637,1.4316637024328887,3844,2759,6603,-
chr12,7076349,0.7310474168435952,1948,1412,3360,-
chr12,7076379,1.7289795918367346,1058,804,1862,-
chr12,7076405,1.9207270891189092,950,698,1648,-
chr12,7076876,1.8158567774936063,1703,1103,2806,-
chr12,7076881,1.2126367570117962,3275,2602,5877,-
chr12,7076907,0.5912366114897761,1517,909,2426,-
chr12,7076908,2.262286324786325,846,623,1469,-
chr12,7077070,1.511111111111111,866,713,1579,-
chr12,7077071,1.7988974113135185,789,595,1384,-
chr12,7077144,2.3063284955246663,1596,1185,2781,-
chr12,7077173,1.7908178777743995,759,597,1356,-
chr12,7077607,2.00480413895048,774,614,1388,-
chr12,7078689,1.6087159824184043,1097,866,1963,-
chr12,7078710,1.6233552631578947,1315,1063,2378,-
chr12,7079391,1.5262345679012346,1117,863,1980,-
chr12,7079582,1.9857481994784827,13945,13793,27738,-
chr12,7079584,1.9857481994784827,13945,13793,27738,-
chr12,7079587,1.5810676639752108,8147,7593,15740,-
chr12,7079588,1.8003525010041612,4253,4175,8428,-
chr12,7079594,1.6279058817281125,5919,5136,11055,-
chr12,7079595,1.6299835723433191,5694,4900,10594,-
chr12,7079596,1.6299835723433191,5694,4900,10594,-
chr12,7079597,1.649582525592308,6668,5495,12163,-
chr12,7079599,1.5251380774635006,2527,2022,4549,-
chr12,7079601,1.5351562499999998,1178,879,2057,-
chr12,7079608,1.7117267535455387,2189,1561,3750,-
chr12,7079632,0.5844965844965845,614,454,1068,-
chr12,7079633,1.9321349330976716,2576,1503,4079,-
chr12,7079635,1.8931145007468653,2986,2017,5003,-
chr12,7079636,1.6584806755549564,1446,750,2196,-
chr12,7079638,1.8224154135338344,2084,1063,3147,-
chr12,7079640,1.973583056007017,1318,656,1974,-
chr12,7079695,0.5041420118343195,638,454,1092,-
chr12,7079696,1.4111111111111112,888,629,1517,-
chr12,7079714,0.5001203717078337,610,482,1092,-
chr12,7079716,0.3960160547049204,591,433,1024,-
chr12,7079815,0.401953125,685,383,1068,-
chr12,7079824,0.6790326050875933,1128,711,1839,-
chr12,7187893,1.1540969889442776,776,646,1422,-
chr12,7241483,2.855633802816901,810,709,1519,-
chr12,7241485,2.889493059542706,1204,1020,2224,-
chr12,7241487,3.320373250388802,792,642,1434,-
chr12,7244208,2.7909475393070844,603,484,1087,-
chr12,8074201,1.455455922206281,716,473,1189,-
chr12,8086482,2.698481561822126,621,460,1081,-
chr12,8086483,2.698481561822126,621,460,1081,-
chr12,9094263,1.2503934972349506,1384,1072,2456,-
chr12,9096123,2.575353066127637,845,625,1470,-
chr12,9096129,2.501808951597332,739,504,1243,-
chr12,9098071,3.344117536130974,1088,720,1808,-
chr12,9098073,1.099070340501792,784,495,1279,-
chr12,9098138,1.109055215983574,1047,628,1675,-
chr12,9225283,3.489574217254401,742,526,1268,-
chr12,9259127,2.9321116201582678,703,342,1045,-
chr12,9259128,3.551089758612608,1044,501,1545,-
chr12,9259130,4.454638124362895,689,326,1015,-
chr12,9265058,0.9614457831325302,650,414,1064,-
chr12,9265059,1.6542882649752177,946,633,1579,-
chr12,10311049,2.0485312899106005,801,521,1322,-
chr12,10311311,2.5735294117647056,804,551,1355,-
chr12,10311394,1.866492877758123,715,466,1181,-
chr12,10311397,0.5340879699362515,1096,980,2076,-
chr12,10311398,0.5340879699362515,1096,980,2076,-
chr12,10311417,1.7811846689895467,638,573,1211,-
chr12,10311572,1.5238236164545724,1354,1089,2443,-
chr12,10311823,0.6456722020018197,840,627,1467,-
chr12,10311824,1.7153005464480875,802,670,1472,-
chr12,10311854,1.771366489618542,637,435,1072,-
chr12,10311855,1.4322072586167542,1067,673,1740,-
chr12,10311868,0.3663461538461538,634,399,1033,-
chr12,10312504,1.5366686759091823,1911,1421,3332,-
chr12,10312506,1.5366686759091823,1911,1421,3332,-
chr12,10312516,0.7032598387861545,1446,1109,2555,-
chr12,10312600,1.36849109596054,1716,1340,3056,-
chr12,10312619,2.8755964553510567,766,488,1254,-
chr12,10312948,2.6269388686131387,742,547,1289,-
chr12,10312958,2.5102459016393444,699,487,1186,-
chr12,10312961,2.706535947712418,1312,764,2076,-
chr12,10312962,2.706535947712418,1312,764,2076,-
chr12,10313463,2.4907023495414,966,757,1723,-
chr12,10319375,2.0250704643228006,1240,748,1988,-
chr12,10319388,1.80619366094795,1211,723,1934,-
chr12,10321703,1.9809291828529723,1426,1111,2537,-
chr12,10324656,1.7321628468744474,2799,1542,4341,-
chr12,10324657,1.7321628468744474,2799,1542,4341,-
chr12,10324686,1.9253208868144687,1715,856,2571,-
chr12,10324721,2.3517318408628514,3575,1499,5074,-
chr12,10324723,2.2820577472177384,4842,1992,6834,-
chr12,10324727,2.878885968831928,2003,715,2718,-
chr12,10324730,0.5910797922157366,3721,1356,5077,-
chr12,10324733,1.6817638670615647,1297,694,1991,-
chr12,10324734,1.3885424452064425,1863,966,2829,-
chr12,10324735,1.4146205659774667,2453,1259,3712,-
chr12,10324736,1.1055663460713423,1156,565,1721,-
chr12,10583781,2.467785843920145,881,550,1431,-
chr12,10583782,2.467785843920145,881,550,1431,-
chr12,10587917,1.8889822210951919,857,628,1485,-
chr12,10587918,1.192468619246862,683,477,1160,-
chr12,10758798,30.524218373184112,3238,2795,6033,-
chr12,10758799,30.524218373184112,3238,2795,6033,-
chr12,10758800,26.241473653387025,2587,2313,4900,-
chr12,10758819,4.2750779666967205,1073,450,1523,-
chr12,10852113,1.8132284382284385,888,659,1547,-
chr12,10852197,1.4750428557023292,1218,843,2061,-
chr12,10852223,0.4957356076759062,557,468,1025,-
chr12,10853865,1.9276209426688227,619,472,1091,-
chr12,10854611,2.0235040431266844,781,529,1310,-
chr12,10854613,2.0235040431266844,781,529,1310,-
chr12,10856678,1.8600563909774437,732,379,1111,-
chr12,10865852,1.273279911577784,863,422,1285,-
chr12,10865854,1.070225377187002,1370,836,2206,-
chr12,10871683,2.451639892904953,636,497,1133,-
chr12,10875456,1.7519523759390578,634,455,1089,-
chr12,10875917,3.3694292118544613,761,397,1158,-
chr12,10875918,3.4860815501067037,810,497,1307,-
chr12,10875921,0.48793513515359166,1247,612,1859,-
chr12,14939687,0.4934210526315788,599,417,1016,-
chr12,14939809,1.649299317283507,611,505,1116,-
chr12,14940052,2.0524870584369,2511,1622,4133,-
chr12,14940055,2.743621082699333,2102,1582,3684,-
chr12,14940056,2.359709781810894,4335,2893,7228,-
chr12,14940058,2.2333364149024684,2055,1491,3546,-
chr12,14940059,1.6186882300089849,1125,524,1649,-
chr12,14940063,1.734804613607495,3569,2214,5783,-
chr12,14940065,2.1737843501734533,1799,1156,2955,-
chr12,14940067,3.619338422391857,888,392,1280,-
chr12,14940070,1.9686059394349105,3879,1931,5810,-
chr12,14940071,1.9261761075298311,2246,1267,3513,-
chr12,14940072,1.9686059394349105,3879,1931,5810,-
chr12,14940178,1.241078253727979,760,507,1267,-
chr12,14947484,0.3319099378881987,854,551,1405,-
chr12,14947485,0.3319099378881987,854,551,1405,-
chr12,14947488,1.1523072819418514,647,488,1135,-
chr12,14947490,1.1523072819418514,647,488,1135,-
chr12,14947552,1.9029523531131247,743,621,1364,-
chr12,14947553,1.0879199999960485,746,623,1369,-
chr12,15261430,1.0341256444180849,1192,952,2144,-
chr12,15261432,1.0341256444180849,1192,952,2144,-
chr12,15262020,2.271062271062271,774,454,1228,-
chr12,15262021,1.7596042517575283,1009,658,1667,-
chr12,15262159,1.1134359467692805,730,461,1191,-
chr12,15262160,1.5234546354775982,930,616,1546,-
chr12,15262299,3.405328256423591,618,533,1151,-
chr12,15262406,9.485054446988979,977,911,1888,-
chr12,15262410,13.38444509518648,2679,1957,4636,-
chr12,15262411,10.060929374792455,3214,2220,5434,-
chr12,15262412,10.868419925681767,2338,1715,4053,-
chr12,15262413,9.708463338788892,1330,742,2072,-
chr12,15264299,3.0875389408099685,582,427,1009,-
chr12,15370487,3.0321204057341844,639,460,1099,-
chr12,15374132,2.270779777206512,635,388,1023,-
chr12,15374134,2.270779777206512,635,388,1023,-
chr12,16553441,1.9230769230769231,474,558,1032,-
chr12,16553442,1.6527274202824547,683,769,1452,-
chr12,21622663,1.9174603174603173,603,454,1057,-
chr12,21623143,1.7606995230524642,838,628,1466,-
chr12,21627850,1.115480498592682,1260,828,2088,-
chr12,21627851,1.115480498592682,1260,828,2088,-
chr12,21627882,3.0521308980213084,616,437,1053,-
chr12,21628424,0.6182993097371127,841,618,1459,-
chr12,21628615,0.4373638344226579,583,458,1041,-
chr12,21628654,2.3569542253521125,594,425,1019,-
chr12,21630743,1.0797764227642277,1104,655,1759,-
chr12,21630745,1.0797764227642277,1104,655,1759,-
chr12,21636502,2.647366889729416,673,490,1163,-
chr12,21644530,2.207070707070707,645,395,1040,-
chr12,21654123,0.44082053536893323,630,515,1145,-
chr12,21654511,0.9966628183456727,6024,4387,10411,-
chr12,21654517,1.5148362289146482,3953,3238,7191,-
chr12,21654518,1.171471574309646,7497,5729,13226,-
chr12,21654519,0.5208584518929347,1781,1130,2911,-
chr12,21654520,1.3186779913367817,3685,2912,6597,-
chr12,21654527,0.4934949733885275,1668,1067,2735,-
chr12,21654534,1.3906208917101752,1254,673,1927,-
chr12,21654538,1.5367197839052955,1072,680,1752,-
chr12,21654539,1.3354700854700854,624,467,1091,-
chr12,21654541,0.6375227686703097,699,365,1064,-
chr12,21790037,1.23746538558362,7149,5607,12756,-
chr12,21791346,1.1377640668005735,9786,7030,16816,-
chr12,21791382,1.5064937149829027,4489,3729,8218,-
chr12,21796953,1.3768693729784602,79971,56736,136707,-
chr12,21796954,1.3768693729784602,79971,56736,136707,-
chr12,21796959,1.8238819233867647,22387,21084,43471,-
chr12,21796981,1.4441890558551336,34756,28477,63233,-
chr12,21796983,1.3425623678141103,171688,122734,294422,-
chr12,21796984,1.3374758816574694,153829,107969,261798,-
chr12,21797004,1.3138755502285393,22154,13668,35822,-
chr12,21797044,0.951962886387654,857,696,1553,-
chr12,21799868,1.149395842161357,13770,9670,23440,-
chr12,21799894,1.2566108112141972,38473,27071,65544,-
chr12,21799911,0.8291149928264943,10884,8672,19556,-
chr12,21799951,0.9801256214996446,708,506,1214,-
chr12,21807606,1.1776698855328898,15721,11328,27049,-
chr12,21807607,0.7491015094414929,14376,11277,25653,-
chr12,21810729,1.3090263392672914,12678,10150,22828,-
chr12,21810730,1.2847581282788816,18171,13605,31776,-
chr12,21810733,1.3030276006599188,3437,2734,6171,-
chr12,21810739,1.097939739371105,5500,3641,9141,-
chr12,21810743,0.7369884739331709,9345,6590,15935,-
chr12,21810747,0.8248545995143659,4281,3091,7372,-
chr12,21810752,0.6878394550308387,933,764,1697,-
chr12,21810753,1.012816626975536,2069,1549,3618,-
chr12,21810754,1.306874212977713,1459,1037,2496,-
chr12,21810755,1.1521994925517953,3202,2523,5725,-
chr12,21810764,1.576668139637649,891,583,1474,-
chr12,21810769,0.9342046207815953,2609,1973,4582,-
chr12,21810770,0.8855704169944923,1480,929,2409,-
chr12,21810771,0.9881207721498102,1129,1044,2173,-
chr12,25380323,2.7777777777777777,1074,1160,2234,-
chr12,25380324,0.3884676573130691,1092,952,2044,-
chr12,25380325,2.1895915404551127,2677,2615,5292,-
chr12,25380326,2.7571929672839786,1965,1876,3841,-
chr12,25380328,3.300551172592672,1017,973,1990,-
chr12,25398223,2.4932811480756687,658,510,1168,-
chr12,25398225,1.968420381915149,860,687,1547,-
chr12,27058242,2.1833989080312275,777,613,1390,-
chr12,27058454,0.6817694241147868,973,715,1688,-
chr12,27064191,4.32409381663113,701,468,1169,-
chr12,27064192,4.32409381663113,701,468,1169,-
chr12,27075564,4.509064809060382,1228,837,2065,-
chr12,27078769,1.2639699037745136,690,464,1154,-
chr12,27078780,2.130119828566879,843,573,1416,-
chr12,27089530,1.7958115979499034,1439,1398,2837,-
chr12,27089531,1.7958115979499034,1439,1398,2837,-
chr12,27089569,2.298550724637681,670,659,1329,-
chr12,27089571,2.298550724637681,670,659,1329,-
chr12,27089572,2.0774248761574707,1282,1144,2426,-
chr12,27089574,1.8908510772730143,842,832,1674,-
chr12,27126719,0.4867628012519676,847,613,1460,-
chr12,27126860,6.901584296706811,623,495,1118,-
chr12,27126901,3.4636556104446004,817,653,1470,-
chr12,27126903,3.4636556104446004,817,653,1470,-
chr12,27128470,1.8449037776193873,718,609,1327,-
chr12,27128475,2.1110594795539037,648,537,1185,-
chr12,27143462,1.7252986387118592,712,482,1194,-
chr12,27152463,1.015015015015015,1013,702,1715,-
chr12,27152465,0.887768921247988,1438,1044,2482,-
chr12,29496180,1.7800102249488752,940,651,1591,-
chr12,29496185,1.7775231053604434,828,540,1368,-
chr12,29496186,0.4341728336118405,969,567,1536,-
chr12,29496194,0.520639534883721,596,429,1025,-
chr12,29496205,0.5269586459605653,754,520,1274,-
chr12,29498381,0.45221907784220844,1080,807,1887,-
chr12,29498415,2.288988836502638,1259,892,2151,-
chr12,29502050,2.140515463917526,768,484,1252,-
chr12,29502087,2.490706319702602,669,537,1206,-
chr12,29502961,1.751782421648931,2443,1882,4325,-
chr12,29502971,1.6583093523202928,1891,1426,3317,-
chr12,29502996,1.904899034240562,1465,1138,2603,-
chr12,29502997,1.904899034240562,1465,1138,2603,-
chr12,29502998,1.572047244094488,967,634,1601,-
chr12,29510581,2.5482685517144645,956,646,1602,-
chr12,29524485,2.32709899482848,1118,700,1818,-
chr12,29655933,3.982580528774109,723,522,1245,-
chr12,29655935,3.689364230540701,721,560,1281,-
chr12,29658834,2.0859502986256984,1000,533,1533,-
chr12,30783555,2.135265700483092,1767,1655,3422,-
chr12,30783556,2.135265700483092,1767,1655,3422,-
chr12,30783557,2.135265700483092,1767,1655,3422,-
chr12,30783583,2.877300613496933,803,651,1454,-
chr12,30783584,2.877300613496933,803,651,1454,-
chr12,30783602,2.4186655770483543,970,881,1851,-
chr12,30783603,2.3782028148682786,658,651,1309,-
chr12,31434068,1.0141012909632572,1331,1006,2337,-
chr12,31434069,1.0141012909632572,1331,1006,2337,-
chr12,31434388,4.170909090909091,836,494,1330,-
chr12,31434390,4.170909090909091,836,494,1330,-
chr12,31434778,1.91915078620525,1130,768,1898,-
chr12,31434856,1.9121942934782612,833,511,1344,-
chr12,31435076,2.4692129660053985,660,422,1082,-
chr12,31435358,0.47020665352496027,1135,789,1924,-
chr12,31435393,2.297911741414289,657,391,1048,-
chr12,31446753,1.4214751788644038,866,584,1450,-
chr12,31862244,3.087912087912088,561,493,1054,-
chr12,31862246,3.087912087912088,561,493,1054,-
chr12,32900266,0.2703550488321884,828,623,1451,-
chr12,32902914,3.666165663955109,589,413,1002,-
chr12,32903025,2.5408433717283625,784,554,1338,-
chr12,32903768,2.60891279491317,635,462,1097,-
chr12,33021922,2.8524103420060256,620,402,1022,-
chr12,39233740,5.6078364638302505,616,405,1021,-
chr12,42555436,2.28045118082941,630,704,1334,-
chr12,42555445,1.3280873605112922,904,947,1851,-
chr12,42555446,0.8880258899676375,489,514,1003,-
chr12,42555456,2.9776963949496684,514,496,1010,-
chr12,42706817,1.9271255060728745,951,512,1463,-
chr12,42706978,1.9950564971751408,564,471,1035,-
chr12,42706982,1.6477355371900828,732,604,1336,-
chr12,42706992,1.8002496878901373,823,533,1356,-
chr12,42707678,1.5882901668129938,826,535,1361,-
chr12,42707699,2.8579142240049364,740,462,1202,-
chr12,42707703,1.8850877192982454,613,479,1092,-
chr12,42707754,2.0825806451612903,537,464,1001,-
chr12,42707755,0.6561795766868455,989,741,1730,-
chr12,42707773,1.7123230292368266,729,518,1247,-
chr12,42717878,1.112902559867878,1146,864,2010,-
chr12,42717879,1.112902559867878,1146,864,2010,-
chr12,42717894,3.292353047078945,807,504,1311,-
chr12,42719827,2.4019743995249563,652,459,1111,-
chr12,42719883,1.0622854049541133,1140,898,2038,-
chr12,42719884,1.3179750802243348,970,662,1632,-
chr12,42719885,1.0622854049541133,1140,898,2038,-
chr12,42719895,0.3976346080948018,817,504,1321,-
chr12,44187780,1.9072311993432647,1147,766,1913,-
chr12,44187784,2.1043537788159647,1199,835,2034,-
chr12,44188138,1.7163841807909606,881,589,1470,-
chr12,44188141,1.7452440033085197,843,557,1400,-
chr12,44188616,1.8888888888888888,611,404,1015,-
chr12,44188863,1.5113138686131389,908,684,1592,-
chr12,44188869,0.5764705882352942,804,574,1378,-
chr12,44188876,1.7054333183655142,843,523,1366,-
chr12,44188877,0.5595804051260851,1273,943,2216,-
chr12,44188878,0.5595804051260851,1273,943,2216,-
chr12,44188881,0.5299599771297885,805,529,1334,-
chr12,44189426,0.5034393110545415,714,498,1212,-
chr12,44189510,3.105312667434177,939,740,1679,-
chr12,44189511,2.724904214559387,634,434,1068,-
chr12,44190840,1.325102056362934,7315,4674,11989,-
chr12,44190844,1.4626056679309298,14294,8756,23050,-
chr12,44190846,1.559437340459238,10269,6164,16433,-
chr12,44190867,1.1244607546923713,6901,4448,11349,-
chr12,44190898,0.7542767988252569,1416,907,2323,-
chr12,44191118,1.9473279507881585,1012,577,1589,-
chr12,44191120,1.5367473751874867,1955,1076,3031,-
chr12,44191122,1.6213341346153851,1172,639,1811,-
chr12,44191126,2.193069947612144,4546,2339,6885,-
chr12,44191127,1.7176653022953894,3463,1788,5251,-
chr12,44191130,1.5810560920484897,854,627,1481,-
chr12,44191136,1.4893484619054531,1435,678,2113,-
chr12,44191148,0.547394540942928,1102,519,1621,-
chr12,44191534,3.074905422446406,761,609,1370,-
chr12,44191547,0.5407698675496688,602,452,1054,-
chr12,44193225,2.1372259177137227,693,450,1143,-
chr12,44194287,2.4621848739495795,585,461,1046,-
chr12,44194289,2.4621848739495795,585,461,1046,-
chr12,46316781,1.5119832679464378,4816,3601,8417,-
chr12,46316782,1.641101153512879,3330,2600,5930,-
chr12,46316783,1.5466320949777608,5555,4121,9676,-
chr12,46316785,2.0167348161187206,2919,2057,4976,-
chr12,46316786,1.7747622622622623,2116,1439,3555,-
chr12,46316787,1.826084903733031,2688,1808,4496,-
chr12,46320201,2.8602069056592176,631,390,1021,-
chr12,46322342,3.5460449750747074,604,436,1040,-
chr12,46322417,2.7679895398735916,607,403,1010,-
chr12,46577040,2.5247863247863247,632,539,1171,-
chr12,46577069,2.337890625,664,511,1175,-
chr12,46577080,1.7830882352941175,969,628,1597,-
chr12,46577121,2.7290029469548136,634,508,1142,-
chr12,46577232,0.6450304259634888,1483,951,2434,-
chr12,46577309,0.6558633455655506,917,580,1497,-
chr12,46577660,2.565359477124183,784,467,1251,-
chr12,46577699,1.1151596145597384,1270,856,2126,-
chr12,46577712,1.6926889714993805,682,537,1219,-
chr12,46578249,0.702716275497393,1251,856,2107,-
chr12,46578275,2.7064779489175996,1238,858,2096,-
chr12,46578662,2.137531234382809,1155,689,1844,-
chr12,46578663,2.137531234382809,1155,689,1844,-
chr12,46578713,1.4579356922625166,661,416,1077,-
chr12,46578715,0.4227707194262386,912,690,1602,-
chr12,46578912,2.7538062720241654,856,712,1568,-
chr12,46579148,2.7913950838272528,1167,797,1964,-
chr12,46579209,0.6575928779318609,834,530,1364,-
chr12,46579260,1.6813922356091031,627,497,1124,-
chr12,46579545,16.495894084723897,2890,2467,5357,-
chr12,46579546,19.639523215805443,3843,2923,6766,-
chr12,46579547,19.639523215805443,3843,2923,6766,-
chr12,46579548,38.92702273167936,2862,1918,4780,-
chr12,46579554,5.435296015365037,975,414,1389,-
chr12,46579560,4.09338382399592,864,361,1225,-
chr12,46579561,3.9767268120355714,1802,650,2452,-
chr12,46579563,4.866236165197786,753,267,1020,-
chr12,46579790,0.529114124631888,1433,1050,2483,-
chr12,46579858,2.71904755823215,997,821,1818,-
chr12,46579986,1.881038374717833,640,442,1082,-
chr12,46580350,1.7841082257813716,1615,1089,2704,-
chr12,46580351,1.734698957032429,2735,1817,4552,-
chr12,46580701,2.239395181761261,1330,1067,2397,-
chr12,46580934,0.594180225281602,632,469,1101,-
chr12,46581031,1.9010631373399873,673,418,1091,-
chr12,46581241,1.920854021847071,666,529,1195,-
chr12,46581280,2.307314678448699,751,387,1138,-
chr12,46581446,2.904858299595141,614,493,1107,-
chr12,46581447,2.904858299595141,614,493,1107,-
chr12,46582017,1.7028112449799198,847,580,1427,-
chr12,46582115,2.437231503579953,665,418,1083,-
chr12,46582183,2.092536614590032,1163,696,1859,-
chr12,46582708,1.8221280032303653,1082,761,1843,-
chr12,46582709,1.8221280032303653,1082,761,1843,-
chr12,46582736,1.0826157744139568,1192,876,2068,-
chr12,46582751,0.3473528541851523,733,734,1467,-
chr12,46582752,0.3473528541851523,733,734,1467,-
chr12,46582815,0.4642249496720566,1152,1304,2456,-
chr12,46591509,1.9578307576328684,1457,1515,2972,-
chr12,46591510,2.0969410479471677,3290,3307,6597,-
chr12,46591545,1.8740828804347829,1040,919,1959,-
chr12,46591830,0.5907172995780591,629,473,1102,-
chr12,46596812,0.5130787037037037,681,479,1160,-
chr12,46598091,0.602920108513427,988,618,1606,-
chr12,46601322,1.7702691511387167,667,482,1149,-
chr12,46601346,1.675,937,615,1552,-
chr12,46633642,2.299408783783784,604,443,1047,-
chr12,46752048,4.813548508950844,2887,2563,5450,-
chr12,46752206,1.4421561149249935,1417,1103,2520,-
chr12,46752489,1.675081675081675,2631,1553,4184,-
chr12,46752576,1.55533896469569,2170,1538,3708,-
chr12,46752684,0.7002800263194137,2691,1827,4518,-
chr12,46752812,1.4769403824521934,1211,1015,2226,-
chr12,46752876,1.8963607594936709,798,631,1429,-
chr12,46752926,1.4998506036726262,3957,2918,6875,-
chr12,46752977,1.3630544647731075,2920,2083,5003,-
chr12,46753083,1.542712449218098,1458,1056,2514,-
chr12,46753594,1.4865963478695907,1677,1431,3108,-
chr12,46753959,1.6190819081908188,1498,1110,2608,-
chr12,46754684,1.4522875816993464,2771,1784,4555,-
chr12,46754690,2.110091586939498,1568,1276,2844,-
chr12,46754897,1.6560950714494018,1651,1015,2666,-
chr12,46756846,0.523540060511691,1687,1205,2892,-
chr12,46757542,1.5206824146981626,1472,1142,2614,-
chr12,46757721,1.3677074302594885,3932,2728,6660,-
chr12,46758263,2.1023694983117696,1758,1365,3123,-
chr12,46758959,1.4480829895656393,1680,1267,2947,-
chr12,46765062,1.3443145102070788,1722,1237,2959,-
chr12,46765072,1.5853340292275575,1124,957,2081,-
chr12,46765126,1.7805129751165323,1764,1390,3154,-
chr12,46765127,1.7813193406499914,2860,2018,4878,-
chr12,46765128,1.7805129751165323,1764,1390,3154,-
chr12,46766446,1.4849466875508195,1476,1008,2484,-
chr12,46766472,2.42262283035209,1805,1327,3132,-
chr12,46766525,1.0161790017211705,614,580,1194,-
chr12,46766526,1.0161790017211705,614,580,1194,-
chr12,48084357,1.784632350037649,755,614,1369,-
chr12,48459422,1.7046853180583443,1431,950,2381,-
chr12,48459423,1.858453135621668,1833,1207,3040,-
chr12,48541858,9.455360313962888,646,948,1594,-
chr12,49087526,3.214358115534837,903,603,1506,-
chr12,49087542,1.2134634634634631,745,431,1176,-
chr12,49087543,1.2134634634634631,745,431,1176,-
chr12,49224135,0.3980013937253801,1101,898,1999,-
chr12,49224136,0.4133537206931702,810,653,1463,-
chr12,49225879,2.9350938593700286,674,448,1122,-
chr12,49225880,2.9350938593700286,674,448,1122,-
chr12,49225881,2.9350938593700286,674,448,1122,-
chr12,49225967,0.4443393505962355,1378,1116,2494,-
chr12,49225968,0.6902340392337488,1046,890,1936,-
chr12,49227204,1.5591174645295212,2601,1688,4289,-
chr12,49227205,1.5069342816603053,6028,4730,10758,-
chr12,49227207,1.464854878917379,3473,3327,6800,-
chr12,49227208,1.6735427536045644,3265,2992,6257,-
chr12,49227209,1.6735427536045644,3265,2992,6257,-
chr12,49227210,1.5298486704989809,2833,2457,5290,-
chr12,49227235,1.6174170398396004,1338,957,2295,-
chr12,49228142,1.8154772470309128,686,459,1145,-
chr12,49228253,2.220042643923241,1369,1004,2373,-
chr12,49228271,0.4960192217629451,1217,732,1949,-
chr12,49228272,0.5214751859159206,858,598,1456,-
chr12,49228273,0.6327739738177174,1273,793,2066,-
chr12,49228275,0.6386428812415654,976,607,1583,-
chr12,49229912,1.7206851119894595,652,461,1113,-
chr12,49230505,1.4861506587588167,642,488,1130,-
chr12,49230817,3.130596631616371,890,631,1521,-
chr12,49231388,3.374484371133479,2304,1650,3954,-
chr12,49231389,3.2695833333333333,930,699,1629,-
chr12,49231842,2.5301888349392856,1094,750,1844,-
chr12,49233658,0.43725924776898395,755,494,1249,-
chr12,49233809,1.08130081300813,797,491,1288,-
chr12,49233810,1.08130081300813,797,491,1288,-
chr12,49237815,1.734657489347755,2923,2699,5622,-
chr12,49237817,1.705676020725338,8616,6856,15472,-
chr12,49237818,1.6558019767771817,8374,6492,14866,-
chr12,49237819,0.6622914957615532,1210,635,1845,-
chr12,49237820,1.860238015259849,3812,3205,7017,-
chr12,49237821,1.7062091836734694,2440,1999,4439,-
chr12,49237832,1.5201149425287357,1586,1043,2629,-
chr12,49239361,1.2662769114929338,2855,1883,4738,-
chr12,49239370,1.5120362190989989,2075,1351,3426,-
chr12,49239371,2.0327793167128347,1035,721,1756,-
chr12,49239372,0.9644764110691212,1040,630,1670,-
chr12,49245922,0.34347461799739215,1061,812,1873,-
chr12,49245923,0.25805597597393426,1104,856,1960,-
chr12,49330759,0.174822695035461,492,704,1196,-
chr12,49330760,0.174822695035461,492,704,1196,-
chr12,49330761,0.174822695035461,492,704,1196,-
chr12,49330773,11.630389135429365,1219,1589,2808,-
chr12,49330774,11.630389135429365,1219,1589,2808,-
chr12,49330775,9.837826961770626,842,709,1551,-
chr12,49331744,8.257597832703476,1090,1087,2177,-
chr12,49331745,8.257597832703476,1090,1087,2177,-
chr12,49331749,5.012321448785819,1183,889,2072,-
chr12,49331750,5.212382817160183,1921,1477,3398,-
chr12,49331751,5.212382817160183,1921,1477,3398,-
chr12,49332103,7.583211198596256,887,723,1610,-
chr12,49332312,5.762080902784123,618,485,1103,-
chr12,49332421,3.7993763820469115,755,489,1244,-
chr12,49332554,1.7761904761904763,1118,737,1855,-
chr12,49332610,2.2303895908076563,1051,711,1762,-
chr12,49332687,1.2486658993407973,822,502,1324,-
chr12,49332689,1.2486658993407973,822,502,1324,-
chr12,49333444,1.26613088819397,3645,3007,6652,-
chr12,49333445,1.4470511772308272,2867,2379,5246,-
chr12,49333496,1.4270214709913205,1274,795,2069,-
chr12,49333524,0.5758663176669254,1457,1030,2487,-
chr12,49333790,1.7471319311663482,644,522,1166,-
chr12,49333821,1.0748349051297796,1547,1194,2741,-
chr12,49334767,2.927607467770448,1357,858,2215,-
chr12,49334864,1.2518709369204004,1716,1120,2836,-
chr12,49334871,0.4912825580574574,579,456,1035,-
chr12,49334882,2.183186580746717,1137,700,1837,-
chr12,49351164,2.581623117712649,605,435,1040,-
chr12,49351192,8.415984455450596,1336,1074,2410,-
chr12,49351193,10.660849756631514,731,604,1335,-
chr12,49351198,6.253107299629317,1498,855,2353,-
chr12,49351199,6.46097130265482,1397,742,2139,-
chr12,49351205,5.631968368866277,823,366,1189,-
chr12,49359188,8.211567500542966,938,771,1709,-
chr12,49359375,1.3850672121566334,776,579,1355,-
chr12,49359588,1.5274827014910826,728,661,1389,-
chr12,49359647,0.3922491178109329,527,556,1083,-
chr12,49359673,4.174214625483461,1307,1214,2521,-
chr12,49359825,3.735028248587571,600,530,1130,-
chr12,49359827,3.735028248587571,600,530,1130,-
chr12,49359850,3.144866385372715,1117,710,1827,-
chr12,49359851,3.3760531477845253,1390,929,2319,-
chr12,49360191,2.0991882786573828,587,485,1072,-
chr12,49360202,8.714857243592958,942,725,1667,-
chr12,49360217,5.316753120324354,751,443,1194,-
chr12,49361748,0.9280228612252187,865,508,1373,-
chr12,49361750,0.9280228612252187,865,508,1373,-
chr12,49364130,2.617728531855956,782,550,1332,-
chr12,49364131,2.617728531855956,782,550,1332,-
chr12,49365485,0.44847935726304594,642,509,1151,-
chr12,49365517,0.38689552196077737,709,907,1616,-
chr12,49365538,6.506042244104378,986,1116,2102,-
chr12,49365539,6.506042244104378,986,1116,2102,-
chr12,49365540,7.425249169435215,446,601,1047,-
chr12,49396127,5.594252681707412,1983,2588,4571,-
chr12,49396130,9.519503260037409,1939,2182,4121,-
chr12,49396133,3.6369803268954675,1917,2047,3964,-
chr12,49396142,7.005970370745569,4288,3711,7999,-
chr12,49396143,6.376487001384972,3775,3075,6850,-
chr12,49396150,1.8006779661016947,663,471,1134,-
chr12,49396175,18.34767835483373,5193,3403,8596,-
chr12,49396176,18.34767835483373,5193,3403,8596,-
chr12,49396182,7.897832242193807,5829,2549,8378,-
chr12,49396183,8.441885182191376,7053,3167,10220,-
chr12,49396184,8.441885182191376,7053,3167,10220,-
chr12,49396187,6.40503785167447,1293,406,1699,-
chr12,49396471,0.567941751129564,1282,861,2143,-
chr12,49396473,0.3975442397977609,1375,974,2349,-
chr12,49396509,1.8630948419301168,902,600,1502,-
chr12,49396511,0.63359291084855,1088,797,1885,-
chr12,49396517,1.5973639455782311,662,503,1165,-
chr12,49396518,0.5317679558011049,769,542,1311,-
chr12,49396521,3.178473514653223,1309,965,2274,-
chr12,49396574,2.018552875695733,815,538,1353,-
chr12,49396608,2.5009781089892877,838,564,1402,-
chr12,49396649,1.925087108013937,714,450,1164,-
chr12,49396694,2.6356589147286824,747,472,1219,-
chr12,49397058,1.6846504559270514,738,657,1395,-
chr12,49397346,1.8686200940980289,847,578,1425,-
chr12,49397354,0.6442205726405089,809,655,1464,-
chr12,49397546,2.622746185852982,609,514,1123,-
chr12,49397588,0.37315251572327035,862,529,1391,-
chr12,49397632,2.372762372762373,844,517,1361,-
chr12,49397697,2.0963794837412,757,627,1384,-
chr12,49398381,1.8338303821062445,936,739,1675,-
chr12,49398937,0.6285665904665144,927,761,1688,-
chr12,49399139,0.5037352843301326,2175,1558,3733,-
chr12,49399554,1.7881274131274132,987,776,1763,-
chr12,49399620,1.5479890018543383,1125,801,1926,-
chr12,49399627,1.734394904458599,777,627,1404,-
chr12,49412524,0.4373669808452417,821,571,1392,-
chr12,49412526,0.44449037605768454,1193,909,2102,-
chr12,49521759,2.3250517447382326,16639,11461,28100,-
chr12,49521827,1.2406565010665176,12572,10513,23085,-
chr12,49521846,1.1786326187311653,12569,8579,21148,-
chr12,49521852,1.5652120316703402,14559,10409,24968,-
chr12,49521855,1.4180160370690345,17072,11983,29055,-
chr12,49521884,1.3367197169830496,6438,3634,10072,-
chr12,49521904,1.3116255829447034,2974,1500,4474,-
chr12,49521915,1.5224241215415266,4507,2110,6617,-
chr12,49521916,1.291345103120265,6009,3257,9266,-
chr12,49521981,0.6730523627075351,1115,647,1762,-
chr12,49521987,1.585888470503855,1082,857,1939,-
chr12,49522127,1.4736694122103913,10457,6883,17340,-
chr12,49522143,1.422103775985229,9518,6548,16066,-
chr12,49522165,1.681441491942332,5382,2593,7975,-
chr12,49522167,1.730857885252085,4129,1925,6054,-
chr12,49522185,0.538659793814433,923,678,1601,-
chr12,49522187,1.5983317669172932,2720,1861,4581,-
chr12,49522189,1.5983317669172932,2720,1861,4581,-
chr12,49522202,0.5169844400613631,673,506,1179,-
chr12,49522314,1.8715790043583007,1502,900,2402,-
chr12,49522334,0.8294881038211969,1715,1386,3101,-
chr12,49522335,0.6715556318234001,4060,3053,7113,-
chr12,49522338,1.6093531468531466,1082,879,1961,-
chr12,49522341,1.2764550264550265,1157,647,1804,-
chr12,49522342,1.2764550264550265,1157,647,1804,-
chr12,49522346,1.6435522047865345,871,670,1541,-
chr12,49522350,1.8300739957716703,830,343,1173,-
chr12,49522353,0.507593236681704,736,408,1144,-
chr12,49522354,0.507593236681704,736,408,1144,-
chr12,49522360,2.5465849542588157,1023,416,1439,-
chr12,49522362,2.5465849542588157,1023,416,1439,-
chr12,49522368,1.7447701958776083,830,534,1364,-
chr12,49522369,1.7447701958776083,830,534,1364,-
chr12,49523058,1.4744041743054574,9019,5064,14083,-
chr12,49523061,1.3299320704578648,12227,7188,19415,-
chr12,49523079,1.3889790341827022,7823,5775,13598,-
chr12,49523095,1.4229913176701916,5559,2846,8405,-
chr12,49523168,1.2250653192546046,5971,4666,10637,-
chr12,49523360,1.373770619903967,5072,3825,8897,-
chr12,49523390,1.328637127404425,16754,9503,26257,-
chr12,49523392,1.2820898145174482,13334,7269,20603,-
chr12,49523393,1.387913434054716,3089,1974,5063,-
chr12,49523397,1.4469964664310957,2768,1697,4465,-
chr12,49523404,1.2729929403583058,7956,5216,13172,-
chr12,49523437,1.3604118993135013,4222,1956,6178,-
chr12,49525085,1.2355974808508143,17337,10192,27529,-
chr12,49525096,1.3425519702252007,22813,16141,38954,-
chr12,49525097,1.3425519702252007,22813,16141,38954,-
chr12,49525153,1.845324088542962,24265,11455,35720,-
chr12,49525154,2.2966460436339955,9403,3983,13386,-
chr12,49525156,1.802666401341112,25848,12021,37869,-
chr12,49525158,1.7583340047666587,47151,20664,67815,-
chr12,49525160,1.7915420735587624,35438,15029,50467,-
chr12,49525165,4.897463524130191,2536,824,3360,-
chr12,49525167,2.394445941652925,17929,6090,24019,-
chr12,49525168,2.248771017787522,33750,11753,45503,-
chr12,49525169,2.267153797409623,44721,15931,60652,-
chr12,49525170,2.2207103314125773,38604,13771,52375,-
chr12,49525177,0.9007643187798121,13513,4372,17885,-
chr12,49525178,0.8762663334166704,5449,1642,7091,-
chr12,49952264,1.8550404060076446,895,781,1676,-
chr12,49952266,1.6831627286487594,555,548,1103,-
chr12,49952269,3.739048273039501,657,477,1134,-
chr12,49953285,2.3810465641952985,794,631,1425,-
chr12,49953286,2.600105287243618,1099,838,1937,-
chr12,49953287,2.3810465641952985,794,631,1425,-
chr12,49958608,1.064427245423456,612,470,1082,-
chr12,50383219,0.3561130182202271,612,540,1152,-
chr12,50383288,1.8417293233082703,638,398,1036,-
chr12,50383289,2.5737548431279667,812,677,1489,-
chr12,50383409,2.359408033826638,557,472,1029,-
chr12,50383434,0.5544113907958301,622,436,1058,-
chr12,50383481,0.3748361730013106,519,544,1063,-
chr12,50383562,0.5201624606179099,1060,1212,2272,-
chr12,50383604,27.920089158915744,3517,2508,6025,-
chr12,50383605,27.920089158915744,3517,2508,6025,-
chr12,50383609,171.80195276330014,4018,1063,5081,-
chr12,50383610,171.80195276330014,4018,1063,5081,-
chr12,50383611,143.7593103448276,1398,289,1687,-
chr12,50383619,11.274137931034485,1005,115,1120,-
chr12,50383620,9.084715496066591,2529,294,2823,-
chr12,50383622,7.556923076923077,1227,124,1351,-
chr12,50383753,4.203603013575915,4494,3100,7594,-
chr12,50383754,4.563050193363368,5063,3614,8677,-
chr12,50383755,4.177863840483214,3032,2192,5224,-
chr12,50383810,0.48589751979582485,674,412,1086,-
chr12,50384009,1.7103448275862065,751,469,1220,-
chr12,50384478,2.1457192575271193,985,705,1690,-
chr12,50385849,5.220750883802792,733,564,1297,-
chr12,50388092,2.93448275862069,665,434,1099,-
chr12,50390843,1.5195301978665738,808,553,1361,-
chr12,50390981,0.9297619047619048,1348,854,2202,-
chr12,50390982,0.9297619047619048,1348,854,2202,-
chr12,50399099,1.7082162921348314,694,444,1138,-
chr12,50399116,2.7137530688151075,1076,715,1791,-
chr12,50400294,1.958013172800058,3712,2887,6599,-
chr12,50400296,1.7894231229225193,7908,5793,13701,-
chr12,50400297,1.7374723576045141,6882,4897,11779,-
chr12,50400298,1.7447283890400653,9726,6762,16488,-
chr12,50400300,1.762878483386924,2844,1865,4709,-
chr12,50400325,1.9740023894862604,1086,674,1760,-
chr12,50400327,1.708924949290061,673,492,1165,-
chr12,50400331,2.178396493941737,649,430,1079,-
chr12,50400380,0.468641014141285,1023,758,1781,-
chr12,50569708,1.9054732174116,627,450,1077,-
chr12,50569837,2.209223891025088,1029,798,1827,-
chr12,50570989,2.358173076923077,653,467,1120,-
chr12,50571039,4.251552795031055,1183,643,1826,-
chr12,50571041,4.251552795031055,1183,643,1826,-
chr12,50571444,1.5000501108005477,1726,1008,2734,-
chr12,50571450,1.1102386946651788,2191,1451,3642,-
chr12,50571474,3.901580756013746,886,484,1370,-
chr12,50571478,0.2971022727272728,746,399,1145,-
chr12,50571481,1.563231325402966,1399,775,2174,-
chr12,50571483,2.109353412544902,984,516,1500,-
chr12,50571816,1.441399111326031,696,659,1355,-
chr12,50599777,2.843061326056662,739,462,1201,-
chr12,50615935,5.899296738685974,761,550,1311,-
chr12,51380454,2.107018894817741,734,479,1213,-
chr12,51381198,16.76566446727346,757,950,1707,-
chr12,51381219,5.542781806187289,1097,649,1746,-
chr12,51381220,5.542781806187289,1097,649,1746,-
chr12,52564434,1.3856028284076833,596,474,1070,-
chr12,52565227,1.091805274500439,877,627,1504,-
chr12,53291077,2.083178582482204,1416,717,2133,-
chr12,53291269,1.3249983570727963,9681,7401,17082,-
chr12,53291308,1.4293057022150828,64565,37640,102205,-
chr12,53291311,1.0014832884698621,187977,116136,304113,-
chr12,53291312,0.9878694927642534,151838,99385,251223,-
chr12,53291315,1.049414774971821,62882,41805,104687,-
chr12,53291335,1.321488639291014,30143,16166,46309,-
chr12,53291341,2.022317395343295,32665,14769,47434,-
chr12,53291342,2.6994171171107757,69494,41116,110610,-
chr12,53291357,1.643687105057074,38240,16478,54718,-
chr12,53291359,1.6148437522921768,51949,25457,77406,-
chr12,53291374,1.4978517722878624,5577,2659,8236,-
chr12,53291375,1.6514215972907609,28371,17116,45487,-
chr12,53291376,0.8322853782830263,8165,2550,10715,-
chr12,53291377,1.6514215972907609,28371,17116,45487,-
chr12,53291394,1.5730297075986235,15025,7790,22815,-
chr12,53291397,1.6245783764072512,16828,7530,24358,-
chr12,53292249,1.6067186228654458,27810,11313,39123,-
chr12,53292250,1.6067186228654458,27810,11313,39123,-
chr12,53292275,0.8362434596480101,7337,3263,10600,-
chr12,53292283,0.7580745855211477,10226,5091,15317,-
chr12,53292285,0.7580745855211477,10226,5091,15317,-
chr12,53292490,1.1007089209512284,2652,1764,4416,-
chr12,53292624,1.372873437314014,4758,2751,7509,-
chr12,53292629,1.269041034456985,3086,1573,4659,-
chr12,53293731,1.5960508417360284,20623,16868,37491,-
chr12,53293732,1.2972238450762759,38756,29010,67766,-
chr12,53293733,1.249136135419567,105483,66136,171619,-
chr12,53293734,1.28278524417741,82628,52765,135393,-
chr12,53293735,1.3536648357793,63878,39800,103678,-
chr12,53293736,1.2149436498286674,35686,23005,58691,-
chr12,53293739,1.591106401532942,5232,3662,8894,-
chr12,53293742,0.9905307581098103,22538,13305,35843,-
chr12,53293749,1.1563937408639378,14438,8224,22662,-
chr12,53293763,1.399318947843914,5752,2714,8466,-
chr12,53293771,0.6262770960592464,6901,4268,11169,-
chr12,53293777,0.4414859633958435,5734,3657,9391,-
chr12,53293778,1.6703060581216813,5872,2768,8640,-
chr12,53293809,1.3624767773800353,4685,3043,7728,-
chr12,53293820,0.6313864710537009,1513,873,2386,-
chr12,53294378,1.5134624630809783,5223,3467,8690,-
chr12,53294986,1.0659657735008947,7297,5102,12399,-
chr12,53294987,1.0659657735008947,7297,5102,12399,-
chr12,53295659,1.8261880381563749,6631,4488,11119,-
chr12,53295816,1.4429583005507474,1571,983,2554,-
chr12,53295833,1.6101057408566577,3236,1687,4923,-
chr12,53295834,1.7864195043320572,1208,708,1916,-
chr12,53295836,1.3969589848909572,5534,3654,9188,-
chr12,53298538,1.4922907131496088,1482,1140,2622,-
chr12,53298570,1.3441919174642702,2826,2197,5023,-
chr12,53298631,1.2355618811082798,4285,2407,6692,-
chr12,53298691,1.5359987700940687,3295,1841,5136,-
chr12,53298694,1.6353251877306862,3245,1745,4990,-
chr12,53298704,1.3739278793105043,1806,1562,3368,-
chr12,53298818,2.368962787015044,615,420,1035,-
chr12,53298835,1.2432534166166862,1533,729,2262,-
chr12,53298837,1.3765726973020251,1363,622,1985,-
chr12,53298840,0.6954910866777625,939,502,1441,-
chr12,53605594,0.17448263863453226,636,386,1022,-
chr12,53702245,0.3037366334254475,631,405,1036,-
chr12,53702247,0.3037366334254475,631,405,1036,-
chr12,53936967,1.5395848246241943,848,380,1228,-
chr12,53936976,2.899110939311944,999,596,1595,-
chr12,53936977,2.899110939311944,999,596,1595,-
chr12,53936989,0.5440677966101695,962,530,1492,-
chr12,53937024,1.529096823368649,923,505,1428,-
chr12,54059034,1.4751676326855323,2595,2094,4689,-
chr12,54059205,1.708210664049722,2610,2037,4647,-
chr12,54062971,3.7182855752569215,22397,16732,39129,-
chr12,54062972,3.7182855752569215,22397,16732,39129,-
chr12,54062973,3.0808775805500805,7707,5790,13497,-
chr12,54063115,1.3703891583663497,2868,2389,5257,-
chr12,54066402,1.4282567652611706,2141,1361,3502,-
chr12,54069853,1.5471287703016239,1134,861,1995,-
chr12,54069861,1.670867309117865,881,638,1519,-
chr12,54069863,0.8724391089264895,1657,893,2550,-
chr12,54069865,0.8118590069610369,2135,1225,3360,-
chr12,54575470,2.0982126507758316,820,525,1345,-
chr12,54645913,1.7517241379310344,634,405,1039,-
chr12,56119644,1.2440165659197395,4474,2692,7166,-
chr12,56119933,1.2614341935029854,3477,2657,6134,-
chr12,56119937,1.3170731707317072,3239,2459,5698,-
chr12,56120528,0.9286685877273441,22131,15769,37900,-
chr12,56120679,1.3038990213523132,3686,2809,6495,-
chr12,56120941,1.367894813327205,7086,5398,12484,-
chr12,56120942,1.3341248506571088,4551,2975,7526,-
chr12,56121106,1.3523018979548969,8074,5761,13835,-
chr12,56122093,1.5007573195452468,6300,4981,11281,-
chr12,56122094,1.4629335237787857,4369,3508,7877,-
chr12,56122103,0.7041656273384884,1881,1476,3357,-
chr12,56122106,1.414646851539758,1398,1069,2467,-
chr12,56122109,1.547289700521277,1488,1197,2685,-
chr12,56122110,1.4999708935674785,1226,936,2162,-
chr12,56122128,1.4963713080168775,1858,1026,2884,-
chr12,56122763,2.332989903152689,998,632,1630,-
chr12,56122765,1.673263438960223,2972,1305,4277,-
chr12,56122766,1.691981694279836,4762,2559,7321,-
chr12,56122769,1.858604940301923,2105,1133,3238,-
chr12,56122788,1.8343400803367311,3382,1384,4766,-
chr12,56122789,2.0696141638089807,4690,1847,6537,-
chr12,56122791,1.0424565271879187,5662,2626,8288,-
chr12,56122792,0.9733462857206376,4000,1955,5955,-
chr12,56151329,2.244854843162906,1403,871,2274,-
chr12,56188615,2.3856432068052325,1264,732,1996,-
chr12,56189825,0.6144481163090563,2027,1729,3756,-
chr12,56189849,2.113071047850218,3393,3707,7100,-
chr12,56189851,2.122652603439522,4087,4436,8523,-
chr12,56189853,2.457210344618739,1398,1500,2898,-
chr12,56194359,2.1699984503331784,736,716,1452,-
chr12,56194362,2.112170120306005,1638,1483,3121,-
chr12,56194408,2.260282660871437,1805,1366,3171,-
chr12,56197420,1.7970588235294116,610,424,1034,-
chr12,56197447,2.9445936050768857,831,481,1312,-
chr12,56211487,0.8136211969488035,1267,1203,2470,-
chr12,56211489,0.9853749211554462,1502,1413,2915,-
chr12,56295357,5.205913038981647,632,461,1093,-
chr12,56295565,5.062722007757512,499,595,1094,-
chr12,56295566,4.762493605463841,542,572,1114,-
chr12,56295824,1.8635941942199636,608,440,1048,-
chr12,56575541,0.619399102176625,645,442,1087,-
chr12,56599465,0.6127484151285114,707,530,1237,-
chr12,56599540,8.892039271087677,2245,2214,4459,-
chr12,56599541,10.384137982537418,2409,2371,4780,-
chr12,56599542,10.384137982537418,2409,2371,4780,-
chr12,56599543,15.514869888475836,490,537,1027,-
chr12,56599556,18.64104797037161,1177,744,1921,-
chr12,56665666,1.695361513936028,633,462,1095,-
chr12,56665747,2.286158438005224,592,472,1064,-
chr12,56666147,5.103832155855278,744,518,1262,-
chr12,56666155,1.6901311249137336,710,482,1192,-
chr12,56666417,1.3860671172975207,772,631,1403,-
chr12,56666424,1.6096071672953887,679,514,1193,-
chr12,56666561,1.1957582464819596,834,540,1374,-
chr12,56666705,2.089866626075804,692,513,1205,-
chr12,56666708,2.91945165476963,836,535,1371,-
chr12,56666709,2.638149268918432,1518,945,2463,-
chr12,56666710,2.638149268918432,1518,945,2463,-
chr12,56666713,1.8152345512016912,668,461,1129,-
chr12,56666728,0.6342538798896105,663,420,1083,-
chr12,56666866,2.1067577666275223,597,550,1147,-
chr12,56666880,2.781818181818182,764,549,1313,-
chr12,56666882,2.781818181818182,764,549,1313,-
chr12,56667394,3.2880668257756565,598,418,1016,-
chr12,56667415,0.5378323108384457,525,488,1013,-
chr12,56667461,0.5380427653154927,630,461,1091,-
chr12,56667553,2.336686787391013,535,496,1031,-
chr12,56668580,2.1914191419141917,995,807,1802,-
chr12,56668582,2.1914191419141917,995,807,1802,-
chr12,56669917,0.4974554707379135,900,785,1685,-
chr12,56669924,2.7776548672566364,836,677,1513,-
chr12,56669952,0.5769584446293295,731,556,1287,-
chr12,56669970,2.50544425087108,766,573,1339,-
chr12,56676213,2.694091903719913,683,456,1139,-
chr12,56676260,2.0904438204692872,916,748,1664,-
chr12,56676274,1.6261703190006196,629,411,1040,-
chr12,56677593,1.105567226890756,841,671,1512,-
chr12,56677594,1.7176618251248192,1216,943,2159,-
chr12,56680425,1.0888156173130266,742,578,1320,-
chr12,56680427,1.0888156173130266,742,578,1320,-
chr12,56704285,1.4608601485148516,2626,2367,4993,-
chr12,56704286,1.6376065959055908,3159,2815,5974,-
chr12,56704287,1.4608601485148516,2626,2367,4993,-
chr12,56704305,1.8719069893566536,1174,893,2067,-
chr12,56705002,1.4723033963244363,1416,1043,2459,-
chr12,56705042,1.4850528789659223,1238,924,2162,-
chr12,56705095,2.106207928197457,767,572,1339,-
chr12,56705137,0.6350267379679143,949,703,1652,-
chr12,56705151,1.376149963950973,1445,949,2394,-
chr12,56708716,1.584988962472406,1435,905,2340,-
chr12,56708730,1.5755570490616757,801,666,1467,-
chr12,56708934,0.4175070028011204,541,475,1016,-
chr12,56708998,0.4429314935850883,562,485,1047,-
chr12,56709656,1.752712215320911,813,482,1295,-
chr12,56709795,0.5612702033927405,664,431,1095,-
chr12,56811110,0.7659468659924367,792,439,1231,-
chr12,56997480,1.8918677057044677,1159,1030,2189,-
chr12,56997481,1.9700621603045405,1446,1189,2635,-
chr12,57033002,0.6225255625023876,5313,4314,9627,-
chr12,57033068,1.407995710599511,6463,4115,10578,-
chr12,57033866,1.1538124277544555,8580,6912,15492,-
chr12,57033968,1.304604773878245,4365,3321,7686,-
chr12,57036255,1.0980036800827968,18326,14551,32877,-
chr12,57036279,1.638514072847682,8333,5284,13617,-
chr12,57036281,1.4380151387720772,3707,2951,6658,-
chr12,57037651,1.2261963624412036,8616,5536,14152,-
chr12,57038735,1.444269825918762,2756,2255,5011,-
chr12,57038883,0.7236831263755661,1142,806,1948,-
chr12,57039016,1.1641430484266906,6730,4480,11210,-
chr12,57039035,0.9845585940284055,6789,5896,12685,-
chr12,57039037,1.0834060663146936,9061,7679,16740,-
chr12,57039044,1.5897971111940343,4644,3684,8328,-
chr12,57039049,1.3706769086515922,2643,2132,4775,-
chr12,57039102,1.6129769779335832,4169,3241,7410,-
chr12,57039117,0.7427579667814638,2096,1623,3719,-
chr12,57039663,1.466790180639185,1623,1269,2892,-
chr12,57039689,1.6551724137931034,1007,782,1789,-
chr12,57039690,1.4819935425117972,2294,1284,3578,-
chr12,57039699,2.591932288852872,2333,1850,4183,-
chr12,57039701,2.7661302971837802,5163,3585,8748,-
chr12,57039746,0.638660801093538,1353,792,2145,-
chr12,57057471,2.1115738498789347,990,825,1815,-
chr12,57057742,2.1828103683492497,1039,732,1771,-
chr12,57057846,1.3940949940073588,3887,2782,6669,-
chr12,57058033,1.6887393906207224,1027,690,1717,-
chr12,57058583,1.4836101398601398,1673,1143,2816,-
chr12,57060000,2.032876712328767,1165,802,1967,-
chr12,57060008,1.5422550278134362,1108,737,1845,-
chr12,57060017,1.538441634052463,1080,718,1798,-
chr12,57066545,1.5973007098168472,2501,1776,4277,-
chr12,57066825,1.9068014705882352,942,639,1581,-
chr12,57081899,3.121317559730921,840,478,1318,-
chr12,57081901,3.121317559730921,840,478,1318,-
chr12,57081905,2.4918836880978823,630,402,1032,-
chr12,57106638,1.3808316899352846,7605,4530,12135,-
chr12,57106974,0.20531089834477045,646,467,1113,-
chr12,57107356,1.5307233249562044,87407,60495,147902,-
chr12,57107363,1.6162323728503214,157775,104970,262745,-
chr12,57107364,1.6217809275266086,231250,151876,383126,-
chr12,57107366,1.6512637565259383,151039,97966,249005,-
chr12,57107374,1.5355729122924888,30055,19439,49494,-
chr12,57107389,1.0389638871332738,82323,48468,130791,-
chr12,57107401,1.3183550497467411,61270,32487,93757,-
chr12,57107402,1.3183550497467411,61270,32487,93757,-
chr12,57107403,1.1407537095445632,123526,71219,194745,-
chr12,57107467,0.9949549783229397,4191,1648,5839,-
chr12,57107468,0.9949549783229397,4191,1648,5839,-
chr12,57108159,1.1854394202306826,8834,6261,15095,-
chr12,57108186,0.7073313428928637,9117,6421,15538,-
chr12,57108206,1.442296391601288,14455,11188,25643,-
chr12,57108460,1.0981818205632508,20325,11966,32291,-
chr12,57118261,2.340163315163924,21191,13092,34283,-
chr12,57118286,0.9865387224676243,7955,5869,13824,-
chr12,57118287,0.9044797439706037,18860,12408,31268,-
chr12,57118842,2.030027149321267,1900,1699,3599,-
chr12,57118844,4.853490325689794,2725,2311,5036,-
chr12,57118902,1.883506343713956,780,577,1357,-
chr12,57118903,1.883506343713956,780,577,1357,-
chr12,57119048,1.4237458193979933,3740,2989,6729,-
chr12,57119066,1.2055753100633195,11565,7947,19512,-
chr12,57119070,0.754895760492176,6008,3818,9826,-
chr12,57119080,0.8018832885451488,2158,1605,3763,-
chr12,57119082,0.6978952351102737,10644,7160,17804,-
chr12,57119084,0.8411056089505988,13852,9575,23427,-
chr12,57119085,0.9991127364099115,9760,7415,17175,-
chr12,57119092,1.6712962962962965,721,539,1260,-
chr12,57119123,0.8417256503911412,1182,912,2094,-
chr12,57119124,1.0528234090883253,1165,898,2063,-
chr12,57125487,1.9080610021786493,603,509,1112,-
chr12,57132255,2.233846153846154,967,749,1716,-
chr12,57132267,6.278225806451613,864,619,1483,-
chr12,57133103,1.7665165386982693,1312,953,2265,-
chr12,57133104,1.1451373845627637,836,536,1372,-
chr12,57133107,0.4518034852606223,707,465,1172,-
chr12,57136807,1.6838820083463566,640,458,1098,-
chr12,57139884,1.4766467298934833,620,381,1001,-
chr12,57144926,1.1445139334088945,1046,1028,2074,-
chr12,57144929,2.1448979958366268,773,754,1527,-
chr12,57144936,2.6357020004745384,586,473,1059,-
chr12,57144953,2.503090866216094,598,569,1167,-
chr12,57911513,2.5723839009287928,576,474,1050,-
chr12,57911514,2.5723839009287928,576,474,1050,-
chr12,57924420,1.5377673234888467,1160,851,2011,-
chr12,57924421,0.9010830324909744,831,553,1384,-
chr12,57924428,1.4954787629758608,969,705,1674,-
chr12,57924429,1.2306801994301997,600,467,1067,-
chr12,57924443,2.3581491501807568,591,454,1045,-
chr12,57929566,2.3953129818069683,970,845,1815,-
chr12,57929567,1.4586181444754662,1032,662,1694,-
chr12,57929572,2.1487252124645893,887,705,1592,-
chr12,57929593,2.2658532076169347,765,600,1365,-
chr12,57929599,0.4857581442947297,711,532,1243,-
chr12,57929600,2.277270131353512,637,411,1048,-
chr12,57929604,2.082722451625885,1028,707,1735,-
chr12,57929616,1.2744784568283047,965,653,1618,-
chr12,57939851,2.016504126031508,831,558,1389,-
chr12,57939852,2.016504126031508,831,558,1389,-
chr12,57939854,1.4091778202676863,736,522,1258,-
chr12,57939856,1.1051047310115985,1072,778,1850,-
chr12,58142188,1.7717245089792728,1276,840,2116,-
chr12,58142386,1.5579648874554537,2251,1724,3975,-
chr12,58142387,0.8904440154440155,1434,1175,2609,-
chr12,58143060,1.03428927680798,1658,1202,2860,-
chr12,58143062,0.8794848584595129,2374,1735,4109,-
chr12,58143064,1.072054856115108,1495,1111,2606,-
chr12,58143245,2.000111982082867,1347,939,2286,-
chr12,58143247,2.000111982082867,1347,939,2286,-
chr12,58144498,1.6956253850893406,859,540,1399,-
chr12,58144502,1.8658424908424909,814,503,1317,-
chr12,58144542,2.1638655462184877,617,419,1036,-
chr12,58144724,0.6107350096711798,841,563,1404,-
chr12,58144853,3.883882149046793,746,576,1322,-
chr12,58144867,0.6454024300790362,1692,1326,3018,-
chr12,58145000,1.6440920716112533,973,574,1547,-
chr12,58145326,0.48768472906403953,647,405,1052,-
chr12,58145428,3.192044676367853,1020,784,1804,-
chr12,58145436,2.65934065934066,549,454,1003,-
chr12,58145468,2.1544787077826726,785,680,1465,-
chr12,58145469,0.25329230793813834,1273,868,2141,-
chr12,58145470,2.1544787077826726,785,680,1465,-
chr12,58145509,1.6698330254807074,836,627,1463,-
chr12,58146092,0.5357561733116365,908,586,1494,-
chr12,58146099,4.71751984023595,766,598,1364,-
chr12,58220791,4.439616302133362,532,506,1038,-
chr12,58220793,2.036970781156828,487,515,1002,-
chr12,65108967,2.787243838242249,655,403,1058,-
chr12,65109044,1.1053747925835078,911,414,1325,-
chr12,65109045,1.2490167391136993,1119,522,1641,-
chr12,65109046,1.1053747925835078,911,414,1325,-
chr12,65110143,0.44222462203023755,755,462,1217,-
chr12,65110150,1.9137393861367367,1183,830,2013,-
chr12,66524529,1.1022000673196857,808,673,1481,-
chr12,75893682,2.5984941289099894,902,649,1551,-
chr12,75897722,4.590527950310559,798,643,1441,-
chr12,75900308,1.9001678046616575,866,643,1509,-
chr12,75905348,2.861585677749361,755,390,1145,-
chr12,75905349,2.291650772379825,1226,717,1943,-
chr12,75905350,2.861585677749361,755,390,1145,-
chr12,76440659,2.41206983805668,614,493,1107,-
chr12,76442183,1.726253687315634,1000,564,1564,-
chr12,76453959,1.0927950793600452,10069,7277,17346,-
chr12,76461198,1.4251375957267858,3273,2221,5494,-
chr12,76462771,1.71716850948353,2202,1550,3752,-
chr12,76478354,1.356466703357182,3017,2369,5386,-
chr12,76478356,1.444850445995734,4435,3455,7890,-
chr12,76478357,1.528256629556495,2888,2230,5118,-
chr12,76478359,1.4324710459920358,1847,981,2828,-
chr12,76478400,0.5615806805708012,1278,910,2188,-
chr12,76478407,0.6185597829211364,2180,1640,3820,-
chr12,76478408,0.6185597829211364,2180,1640,3820,-
chr12,76478431,4.260355029585799,799,389,1188,-
chr12,76478460,2.09660842754368,799,277,1076,-
chr12,76478462,1.1392163826681365,1632,711,2343,-
chr12,76478463,1.0211274697387769,974,286,1260,-
chr12,76478464,1.0211274697387769,974,286,1260,-
chr12,76765339,0.6650570676031606,1514,937,2451,-
chr12,76767128,1.7212320328542094,805,486,1291,-
chr12,76767129,1.731845698296592,1331,808,2139,-
chr12,76767154,1.61012728144896,1719,1061,2780,-
chr12,77254150,3.1220556745182013,539,466,1005,-
chr12,77254151,3.1220556745182013,539,466,1005,-
chr12,79984715,2.5368642925019054,772,529,1301,-
chr12,80083620,2.080693631503918,959,652,1611,-
chr12,80083622,2.3217462809299545,878,636,1514,-
chr12,80083623,2.1274234400184207,782,504,1286,-
chr12,82746899,2.124468607074877,670,435,1105,-
chr12,82750923,1.4321919706229378,827,573,1400,-
chr12,82750979,1.7710619621914312,1787,1577,3364,-
chr12,82750983,2.11132627712627,3020,2604,5624,-
chr12,82750984,1.995813953488372,1838,1805,3643,-
chr12,82750997,0.9821604304656142,2001,1614,3615,-
chr12,82750998,1.0942728442728442,1610,1331,2941,-
chr12,82751020,2.0861372812920598,929,742,1671,-
chr12,82751022,2.0211802837997226,1878,1436,3314,-
chr12,82751023,1.950431034482759,904,695,1599,-
chr12,82751027,1.3476119083315488,1143,804,1947,-
chr12,82751028,1.5097310320235364,1373,983,2356,-
chr12,82751029,1.3476119083315488,1143,804,1947,-
chr12,89984557,6.552459441085364,1156,1352,2508,-
chr12,89984558,9.941981591215457,688,691,1379,-
chr12,90028823,2.2956651482837818,674,531,1205,-
chr12,92537249,0.5754927860191018,707,531,1238,-
chr12,92537346,2.3865689865689865,673,454,1127,-
chr12,92537588,2.588621056362992,634,433,1067,-
chr12,92537592,7.771270509268598,2715,2038,4753,-
chr12,92537775,4.289088741211328,1496,960,2456,-
chr12,92537949,2.1846991967655804,879,594,1473,-
chr12,92538204,1.2583781616821486,595,439,1034,-
chr12,92539241,1.075120701521504,594,453,1047,-
chr12,92539462,0.7973642090988989,584,449,1033,-
chr12,93171779,4.494209039548022,676,589,1265,-
chr12,93171780,4.494209039548022,676,589,1265,-
chr12,93803427,1.3384314782374345,684,361,1045,-
chr12,93803429,0.905445555268716,1332,797,2129,-
chr12,93804539,0.5931150586323,600,521,1121,-
chr12,93804943,1.959752321981424,632,417,1049,-
chr12,93804952,1.217308331957738,767,628,1395,-
chr12,93805072,0.4293291731669266,687,640,1327,-
chr12,93805074,0.4293291731669266,687,640,1327,-
chr12,93835662,0.46562571886737364,613,508,1121,-
chr12,95365282,2.150343361674297,906,555,1461,-
chr12,95365379,1.311355575213783,1160,770,1930,-
chr12,95396528,2.0424478918816025,739,552,1291,-
chr12,95396593,0.5346650998824912,649,459,1108,-
chr12,95396596,0.4495995581331124,591,425,1016,-
chr12,96052277,2.4758021958656373,737,524,1261,-
chr12,96052899,2.214593077642657,1690,1068,2758,-
chr12,96052960,1.6606606606606604,789,443,1232,-
chr12,96052962,0.3977202826223592,894,563,1457,-
chr12,96059690,1.5157192188548008,1311,913,2224,-
chr12,96394726,0.5828054298642534,755,662,1417,-
chr12,96396759,2.277078706452569,1439,1227,2666,-
chr12,96396765,1.6263044464609804,924,550,1474,-
chr12,96397626,2.002510985561833,659,530,1189,-
chr12,96397678,3.4273684210526314,591,474,1065,-
chr12,96402907,0.7220218461317139,1494,982,2476,-
chr12,96408726,0.4789342027600551,851,756,1607,-
chr12,96408761,4.170926693599154,4171,3190,7361,-
chr12,96409375,3.453488372093023,1007,601,1608,-
chr12,96410850,1.673202614379085,735,611,1346,-
chr12,96410870,1.809045226130653,719,596,1315,-
chr12,96410879,0.6333333333333333,835,527,1362,-
chr12,96412625,1.7296222664015906,869,502,1371,-
chr12,96412972,0.7159065320986994,12862,7806,20668,-
chr12,96413001,1.1230312659708124,7931,4922,12853,-
chr12,96413002,1.4674370178384262,9401,5895,15296,-
chr12,96413004,1.0708514945716106,12299,7688,19987,-
chr12,96413005,1.0825795924242445,12658,8021,20679,-
chr12,96413015,1.6986500200685704,5965,3811,9776,-
chr12,96414870,0.7225252701814873,1872,1210,3082,-
chr12,96414895,2.641601807682651,1912,1137,3049,-
chr12,96415934,1.607708888043616,1584,955,2539,-
chr12,96421292,1.8811851851851853,906,624,1530,-
chr12,96422934,0.5589241747251806,1498,1188,2686,-
chr12,96422954,2.075510204081633,677,489,1166,-
chr12,96422961,1.122865275142315,788,805,1593,-
chr12,96422962,1.122865275142315,788,805,1593,-
chr12,96429238,3.2261073843983863,715,550,1265,-
chr12,99007430,0.6354252683732452,1538,1037,2575,-
chr12,99007984,2.1871812975602105,819,606,1425,-
chr12,99020278,1.613905242500701,4111,3566,7677,-
chr12,99020279,1.4280373671463245,5257,4327,9584,-
chr12,99020281,1.4026660012061472,2839,1780,4619,-
chr12,99020293,1.4363294048608737,2195,1351,3546,-
chr12,99020321,1.5597667638483963,1283,685,1968,-
chr12,99020348,0.3478083588175331,852,435,1287,-
chr12,99020349,0.4699248120300752,674,377,1051,-
chr12,99020360,2.1091062774536122,1895,1181,3076,-
chr12,99020386,2.336743215031315,860,478,1338,-
chr12,101789237,3.076555023923445,642,417,1059,-
chr12,101789403,2.350839964633068,577,434,1011,-
chr12,101789432,1.1817187811204783,1131,753,1884,-
chr12,101794920,0.576890655105973,870,691,1561,-
chr12,101799752,1.0455486542443064,1009,896,1905,-
chr12,101799754,3.256911026357203,2028,1864,3892,-
chr12,101799757,10.41170481231407,2142,1823,3965,-
chr12,101799758,9.881840473047866,2451,2120,4571,-
chr12,101801428,8.93045982731547,3690,2409,6099,-
chr12,101801429,7.490160982245432,3130,1979,5109,-
chr12,101801430,8.93045982731547,3690,2409,6099,-
chr12,101801494,2.254201680672269,739,475,1214,-
chr12,101801496,1.6492317512139056,2599,2158,4757,-
chr12,101801497,1.3935965440724933,2099,1833,3932,-
chr12,101801514,0.3424122174122174,1004,890,1894,-
chr12,101801515,0.3424122174122174,1004,890,1894,-
chr12,101801521,1.7815334467120183,810,503,1313,-
chr12,101801523,1.7815334467120183,810,503,1313,-
chr12,102468094,0.5722670579603815,839,657,1496,-
chr12,102468847,0.557323123382226,688,487,1175,-
chr12,102479552,2.139412997903564,627,476,1103,-
chr12,102505976,2.1312269819732506,732,468,1200,-
chr12,102512278,1.798136645962733,771,482,1253,-
chr12,104345376,2.1514159730877997,678,477,1155,-
chr12,104383206,3.513716775509222,664,471,1135,-
chr12,105433537,2.383413661039602,1279,1076,2355,-
chr12,105433546,2.475547082228117,1085,927,2012,-
chr12,105433548,2.475547082228117,1085,927,2012,-
chr12,106632655,2.178978899452929,772,568,1340,-
chr12,106633859,2.3566286998215973,2022,1663,3685,-
chr12,106633861,2.3525593471810087,1474,1347,2821,-
chr12,106633865,2.713767438725691,1637,1066,2703,-
chr12,106633867,2.8442115187779895,1284,770,2054,-
chr12,106633868,1.895650214108632,646,492,1138,-
chr12,106634100,1.6067220151534791,711,571,1282,-
chr12,107386744,0.5682220256523661,570,531,1101,-
chr12,107391755,3.321069797782126,591,510,1101,-
chr12,108916761,7.414026179381351,747,535,1282,-
chr12,108918189,1.5626105229235911,1588,1177,2765,-
chr12,108918191,1.8252789437807202,1287,977,2264,-
chr12,108918203,1.9614155934910649,1354,953,2307,-
chr12,108918204,1.9614155934910649,1354,953,2307,-
chr12,108926040,1.5427097421729945,963,601,1564,-
chr12,108926048,0.4035472299721004,674,385,1059,-
chr12,108926049,0.4035472299721004,674,385,1059,-
chr12,108926052,0.596816976127321,674,350,1024,-
chr12,108942883,2.0702558452806863,1564,969,2533,-
chr12,108942884,2.228915130524278,1347,913,2260,-
chr12,108942885,1.9511494242506193,1660,1085,2745,-
chr12,108942906,2.830432402846196,807,434,1241,-
chr12,108942907,2.830432402846196,807,434,1241,-
chr12,108942908,2.830432402846196,807,434,1241,-
chr12,109040050,0.6470923373679408,675,557,1232,-
chr12,109040440,0.4656597321174123,816,637,1453,-
chr12,109040442,0.4656597321174123,816,637,1453,-
chr12,109040507,1.643255549231645,801,501,1302,-
chr12,109040517,0.37422578828828823,817,591,1408,-
chr12,109040520,0.6881628787878789,675,527,1202,-
chr12,109040523,0.8737514327820534,695,590,1285,-
chr12,109040524,0.6150121065375302,1015,867,1882,-
chr12,109040526,0.3295575221238938,664,564,1228,-
chr12,109041084,10.674019607843135,669,407,1076,-
chr12,109041085,8.699552995734548,1063,716,1779,-
chr12,109041086,10.674019607843135,669,407,1076,-
chr12,109042420,2.452800753908364,850,507,1357,-
chr12,109046065,2.3793939393939394,603,439,1042,-
chr12,109046066,2.3793939393939394,603,439,1042,-
chr12,109527844,2.765780584610825,772,710,1482,-
chr12,109527846,2.377858002406739,623,553,1176,-
chr12,109998896,1.442416202505202,791,526,1317,-
chr12,109998898,2.1554878048780486,706,532,1238,-
chr12,109998899,2.1554878048780486,706,532,1238,-
chr12,109999588,0.6324147311794757,602,428,1030,-
chr12,110002958,3.331941544885177,683,478,1161,-
chr12,110002959,3.331941544885177,683,478,1161,-
chr12,110006645,2.443461253277204,668,473,1141,-
chr12,110006659,2.341987504402138,583,480,1063,-
chr12,110825567,1.2652701989086428,598,493,1091,-
chr12,110825568,1.2652701989086428,598,493,1091,-
chr12,110841337,2.3095017635440405,825,497,1322,-
chr12,110872781,27.58742070945061,10801,8886,19687,-
chr12,110872782,35.85150765911315,5422,4810,10232,-
chr12,110872805,5.777038269550749,895,600,1495,-
chr12,110872826,1.937998632322772,1307,641,1948,-
chr12,110872910,1.4574714825847068,21498,15730,37228,-
chr12,110872916,1.1128789923542766,65438,48185,113623,-
chr12,110872917,1.2425615277835331,51011,35231,86242,-
chr12,110872918,1.1160790269583853,61777,46690,108467,-
chr12,110872919,1.2399207252859603,30978,21910,52888,-
chr12,110872920,1.0766371389318663,29519,20128,49647,-
chr12,110872932,1.3986133245392542,10793,6844,17637,-
chr12,110872938,1.4700704523438957,9428,5719,15147,-
chr12,110872945,1.622924325009507,3969,2253,6222,-
chr12,110872963,1.3490688356267206,10371,6886,17257,-
chr12,110872964,1.3757335350136597,6803,3867,10670,-
chr12,110872974,1.527014652014652,2989,2365,5354,-
chr12,110872981,1.884634639490525,2712,1966,4678,-
chr12,110873933,1.1627755652271465,3360,2542,5902,-
chr12,110873952,0.5244669860054475,1395,1182,2577,-
chr12,110888066,1.590815671162492,1456,864,2320,-
chr12,110888067,1.3722277722277725,1211,1000,2211,-
chr12,110888086,1.7588816385716874,1108,612,1720,-
chr12,110888113,2.549019607843137,909,475,1384,-
chr12,110888115,2.549019607843137,909,475,1384,-
chr12,110888121,1.318217586270974,1037,727,1764,-
chr12,110888122,0.9567522141056304,739,498,1237,-
chr12,110888123,1.4358577505855634,679,413,1092,-
chr12,110890608,3.410980439733956,1048,669,1717,-
chr12,110893480,2.6871896722939423,593,476,1069,-
chr12,110933923,2.9380455609963807,599,426,1025,-
chr12,110933924,0.4464285714285714,1169,909,2078,-
chr12,110933950,1.9140145170295924,856,596,1452,-
chr12,110933984,1.0635252033805165,1417,1013,2430,-
chr12,110933997,1.221546302749683,1190,806,1996,-
chr12,110939912,1.4909962201295508,717,611,1328,-
chr12,110972918,6.076723889492565,623,714,1337,-
chr12,110972919,7.845698495989648,572,684,1256,-
chr12,110974291,1.9816358741831233,1739,1182,2921,-
chr12,110974296,1.6571549355316002,783,497,1280,-
chr12,110974402,0.7829824146618902,1031,628,1659,-
chr12,110974403,0.8058435539075871,1137,616,1753,-
chr12,111158161,1.7960812772133523,692,370,1062,-
chr12,111158300,1.0188847750423093,1186,712,1898,-
chr12,111158494,1.7850151640474223,892,557,1449,-
chr12,111158887,2.4656084656084656,931,692,1623,-
chr12,111158888,2.4656084656084656,931,692,1623,-
chr12,111160065,2.690718954248366,663,509,1172,-
chr12,111160066,2.690718954248366,663,509,1172,-
chr12,111160294,1.0767982675970662,1359,1004,2363,-
chr12,111160369,1.9297423863816239,1218,873,2091,-
chr12,111160411,0.6137367624810892,921,660,1581,-
chr12,111160476,2.5322061191626406,594,413,1007,-
chr12,111168398,0.4386662877711471,841,611,1452,-
chr12,111169582,2.0473007712082265,723,388,1111,-
chr12,111169630,0.44864518882014076,750,544,1294,-
chr12,111180478,0.4174301777255159,628,617,1245,-
chr12,111180490,0.5388619540895563,513,521,1034,-
chr12,111180500,0.4449395135136132,685,861,1546,-
chr12,111180501,0.4449395135136132,685,861,1546,-
chr12,111180517,11.848614474036669,928,707,1635,-
chr12,111180518,12.414398634897776,837,576,1413,-
chr12,112082234,4.4310289149480395,560,474,1034,-
chr12,112096557,4.164602000010222,1041,686,1727,-
chr12,112096559,4.495791245791246,762,539,1301,-
chr12,112509853,2.1483612610053964,2720,2514,5234,-
chr12,112509855,2.1483612610053964,2720,2514,5234,-
chr12,112509861,2.2545773472729955,2380,1922,4302,-
chr12,112509862,2.2545773472729955,2380,1922,4302,-
chr12,112512483,1.458641413126118,1978,1459,3437,-
chr12,112512495,1.9256334858702826,1638,1156,2794,-
chr12,112512498,1.6379284732685453,1561,1053,2614,-
chr12,112512501,1.941005291005291,666,419,1085,-
chr12,112512510,2.3162162162162163,1713,998,2711,-
chr12,112512511,2.3162162162162163,1713,998,2711,-
chr12,112512512,2.600894640410676,2250,1288,3538,-
chr12,112512514,3.1469515372589894,1097,605,1702,-
chr12,112512518,3.0791208791208784,933,454,1387,-
chr12,112512520,3.0791208791208784,933,454,1387,-
chr12,112843714,1.452615752781075,38987,29918,68905,-
chr12,112843715,1.4533520949786778,57255,43604,100859,-
chr12,112843717,1.4738296156507213,55213,41297,96510,-
chr12,112843718,1.2058972962669463,85358,64615,149973,-
chr12,112843734,1.1318537842809955,60973,45056,106029,-
chr12,112843808,1.262053353314427,27648,21120,48768,-
chr12,112843812,1.2483051268425798,24632,18579,43211,-
chr12,112844146,0.8016113030068317,604,603,1207,-
chr12,112844147,0.9060322493655217,656,569,1225,-
chr12,112844686,1.198154739877942,10393,5895,16288,-
chr12,112844690,1.3211867178698196,9183,5105,14288,-
chr12,112846047,1.3502150891570095,8496,4636,13132,-
chr12,112846134,1.3319830629258584,8498,6361,14859,-
chr12,112846279,1.1613224012568786,18259,12350,30609,-
chr12,112846339,1.6051956086848926,4245,2726,6971,-
chr12,112846357,1.3176470588235294,1567,1189,2756,-
chr12,112846371,3.111033519553072,890,536,1426,-
chr12,112846380,0.6695173543192466,1337,1156,2493,-
chr12,112847395,1.3453772876222696,10318,6731,17049,-
chr12,112847396,1.3193041033301116,6929,4787,11716,-
chr12,112847397,1.44975650980388,7786,4636,12422,-
chr12,112847398,1.6034306608263815,9029,5618,14647,-
chr12,112847405,0.7848785094874215,3410,1838,5248,-
chr12,112847406,1.2824002146336675,3346,2931,6277,-
chr12,112847407,1.0481499802687835,8086,5922,14008,-
chr12,112847408,1.2087437662018075,5849,4867,10716,-
chr12,112847412,0.536128936035559,2104,1508,3612,-
chr12,112847417,0.9146753383927065,3522,2896,6418,-
chr12,112847418,0.9146753383927065,3522,2896,6418,-
chr12,112847419,0.899877334599557,820,779,1599,-
chr12,113596739,2.0573722685863554,1533,993,2526,-
chr12,113596741,2.740349451442503,1123,641,1764,-
chr12,113600769,3.5473261129653033,896,618,1514,-
chr12,113600779,3.437539164107781,850,563,1413,-
chr12,113601076,2.9168341468083065,621,386,1007,-
chr12,113601077,3.051003832374491,730,484,1214,-
chr12,113610288,0.4828150572831423,707,467,1174,-
chr12,113610289,0.4828150572831423,707,467,1174,-
chr12,113610304,0.40868425110082734,701,488,1189,-
chr12,113614698,1.393576773511237,634,464,1098,-
chr12,120123762,2.528391683820182,902,623,1525,-
chr12,120123785,1.4308641975308642,731,404,1135,-
chr12,120534230,36.598655847517676,1291,605,1896,-
chr12,120534231,36.598655847517676,1291,605,1896,-
chr12,120534239,33.43065892280765,914,316,1230,-
chr12,120565484,1.7218202651825176,1118,744,1862,-
chr12,120565487,2.327765674170903,1201,764,1965,-
chr12,120565501,2.546128290314337,971,601,1572,-
chr12,120634569,0.7457835110488553,29261,21884,51145,-
chr12,120634576,0.9065722121434792,38833,29167,68000,-
chr12,120634577,1.231670636869504,54989,40564,95553,-
chr12,120634579,1.7670341197482062,18786,15233,34019,-
chr12,120634580,1.4363334990991534,38674,29395,68069,-
chr12,120634582,1.4640042883218067,27317,19508,46825,-
chr12,120634602,1.2795734528541531,26103,17883,43986,-
chr12,120634603,1.1709004803297896,15905,11595,27500,-
chr12,120634624,1.175930711559546,6809,4557,11366,-
chr12,120634627,1.2880383709846377,6217,4066,10283,-
chr12,120635126,0.5859008028124048,51120,28716,79836,-
chr12,120635128,0.8802445910084243,162539,105063,267602,-
chr12,120635129,0.9492383037343423,135906,90460,226366,-
chr12,120635130,0.9492383037343423,135906,90460,226366,-
chr12,120635149,1.3156228502515774,29623,17744,47367,-
chr12,120636411,1.1645121529364355,57913,43732,101645,-
chr12,120636465,1.1711025037694667,30360,18858,49218,-
chr12,120636472,1.3202243328797865,15632,8857,24489,-
chr12,120636483,1.498355359122494,35218,22693,57911,-
chr12,120636712,1.3034058294461492,33529,22794,56323,-
chr12,120636720,1.555031848802232,16643,8107,24750,-
chr12,120636721,1.5980553450370645,24456,11778,36234,-
chr12,120636723,1.4730486931239852,22127,12561,34688,-
chr12,120637130,1.4263385648777895,61900,37950,99850,-
chr12,120637131,1.4263385648777895,61900,37950,99850,-
chr12,120637132,0.8615976656190936,12778,10089,22867,-
chr12,120637134,1.184528208707834,28666,15700,44366,-
chr12,120637135,1.2068148340669163,41129,23575,64704,-
chr12,120637276,1.2598559575757826,38855,26745,65600,-
chr12,120637285,1.3010442357139111,17247,10335,27582,-
chr12,120638548,1.184095645543488,11940,7820,19760,-
chr12,120638549,1.3566025515229507,13282,7411,20693,-
chr12,120638552,1.4459416769245852,12443,6716,19159,-
chr12,120638557,0.6462315098987078,9611,7346,16957,-
chr12,120638558,1.7185898422898043,28267,19037,47304,-
chr12,120638575,1.3832304091086693,8131,3726,11857,-
chr12,120638635,0.6154920125804788,2130,1665,3795,-
chr12,120638663,1.798484271625667,2252,1396,3648,-
chr12,120638887,1.212452857343184,5738,3955,9693,-
chr12,120638901,0.8052550697562297,3143,3016,6159,-
chr12,120638905,1.3795014105104433,19312,11463,30775,-
chr12,120638906,1.4015300283937118,16661,8867,25528,-
chr12,120638909,0.8986407016725146,12548,7963,20511,-
chr12,120638910,0.7892901810405065,8855,4802,13657,-
chr12,120638913,0.9008729657855188,4846,3437,8283,-
chr12,120638915,0.9355383855201479,3078,2134,5212,-
chr12,120649223,12.67110219754413,674,506,1180,-
chr12,120881846,1.5376029002889382,683,479,1162,-
chr12,120882738,1.9526833168963698,627,469,1096,-
chr12,120899691,2.8674242424242427,756,527,1283,-
chr12,120899756,0.7004160887656034,1009,720,1729,-
chr12,120899793,0.6384450165462785,1323,1024,2347,-
chr12,120901814,1.9191594093146536,653,555,1208,-
chr12,120901815,1.8683105702290477,798,606,1404,-
chr12,120901822,0.5106382978723404,725,516,1241,-
chr12,120901878,1.762545899632803,623,558,1181,-
chr12,120903477,4.125589671562658,1714,1349,3063,-
chr12,120903581,2.7843406221281115,1124,655,1779,-
chr12,120907275,1.1782100877845558,904,610,1514,-
chr12,120907276,0.9486442801194301,1257,964,2221,-
chr12,120941234,5.707904425352093,695,457,1152,-
chr12,120941628,3.5638777984382712,608,538,1146,-
chr12,120954496,1.0670219324313495,985,908,1893,-
chr12,121746313,3.5186746987951807,707,414,1121,-
chr12,121746315,3.5186746987951807,707,414,1121,-
chr12,121756096,1.8502080443828015,695,411,1106,-
chr12,121756108,0.4915617924607734,1072,762,1834,-
chr12,121757592,1.6304190169218373,986,729,1715,-
chr12,121758253,1.1689223057644111,635,569,1204,-
chr12,121758255,1.1689223057644111,635,569,1204,-
chr12,121758257,2.353318913072868,1054,568,1622,-
chr12,121758258,2.5764143140994387,1274,716,1990,-
chr12,121769165,0.6083037421469545,916,522,1438,-
chr12,121769167,0.4656941649899396,1542,993,2535,-
chr12,121769168,0.4656941649899396,1542,993,2535,-
chr12,121769193,2.1481007255655142,718,425,1143,-
chr12,121769200,0.9904126984126984,820,699,1519,-
chr12,121769201,0.9904126984126984,820,699,1519,-
chr12,121773370,1.152125863373199,1072,743,1815,-
chr12,121773509,1.9081119885139983,885,596,1481,-
chr12,121773517,1.92777482740308,604,537,1141,-
chr12,121783662,2.2160714285714285,802,559,1361,-
chr12,121785653,1.995126113306983,682,568,1250,-
chr12,121790043,3.1408812408731817,1211,644,1855,-
chr12,121790102,2.6442048517520216,653,370,1023,-
chr12,122216761,1.748033692467086,853,595,1448,-
chr12,122216767,1.6312050910925873,762,595,1357,-
chr12,122218791,2.6037331640473065,966,649,1615,-
chr12,122218792,2.037892479320635,892,608,1500,-
chr12,122218892,0.9942370333249811,1023,613,1636,-
chr12,122218893,0.9942370333249811,1023,613,1636,-
chr12,122231489,5.0918307617047205,1193,524,1717,-
chr12,122231490,5.880204525418599,1376,606,1982,-
chr12,122693063,1.6568995532437023,1361,972,2333,-
chr12,122693076,0.361247947454844,1559,1091,2650,-
chr12,122693090,2.0475477854584248,1988,1200,3188,-
chr12,122693095,1.82545372648614,2652,1452,4104,-
chr12,122693097,1.8454958872082912,1797,910,2707,-
chr12,122693105,2.0076335877862594,788,392,1180,-
chr12,122693108,0.9080234833659492,1391,656,2047,-
chr12,122693109,0.9425250443592635,2870,1739,4609,-
chr12,122693110,1.3562956513203162,2379,1728,4107,-
chr12,122693119,1.381959602007566,1016,558,1574,-
chr12,122701108,0.31991134180897207,692,433,1125,-
chr12,122756426,1.900310559006211,632,459,1091,-
chr12,122756435,2.832174462705436,617,451,1068,-
chr12,122756436,2.832174462705436,617,451,1068,-
chr12,122756852,2.3311296185288084,658,505,1163,-
chr12,122757128,3.074862637362637,725,545,1270,-
chr12,122757129,3.074862637362637,725,545,1270,-
chr12,122763369,3.2131480784673476,624,422,1046,-
chr12,122763587,3.3642793987621573,760,434,1194,-
chr12,122763589,3.3642793987621573,760,434,1194,-
chr12,122763610,1.9129831627749665,680,469,1149,-
chr12,122794312,1.9192415287446405,771,646,1417,-
chr12,122819249,1.9270743363850984,1216,826,2042,-
chr12,122819250,1.9270743363850984,1216,826,2042,-
chr12,122825391,1.8158456706235466,933,583,1516,-
chr12,122825610,2.446836268754077,1704,1532,3236,-
chr12,122825618,1.9085015226529718,2829,2082,4911,-
chr12,122825638,1.0679252635298173,2005,1421,3426,-
chr12,122825681,1.0400722156045266,886,735,1621,-
chr12,122825682,0.7688180791951055,2345,1642,3987,-
chr12,122825683,0.6792089142374313,886,525,1411,-
chr12,122848577,6.359004630516476,615,527,1142,-
chr12,122862025,0.4498311169451798,591,429,1020,-
chr12,122862082,5.671150335505655,624,454,1078,-
chr12,122865077,3.21989612537186,791,505,1296,-
chr12,122990214,2.719701747059006,794,569,1363,-
chr12,122999688,2.818972775750772,647,508,1155,-
chr12,122999691,1.8316719485190107,1279,1123,2402,-
chr12,122999692,1.7267020762916463,595,435,1030,-
chr12,122999697,2.0763756505329165,1196,1001,2197,-
chr12,122999753,3.2278603932733776,718,484,1202,-
chr12,123001873,1.8394053737557736,926,808,1734,-
chr12,123001886,0.5853859914682813,708,558,1266,-
chr12,123001897,1.4893650543563888,821,576,1397,-
chr12,123001903,1.9555805547367253,1223,880,2103,-
chr12,123001909,0.5333333333333333,639,407,1046,-
chr12,123001963,2.7651589399596332,595,426,1021,-
chr12,123006813,2.480554587861434,652,466,1118,-
chr12,123006834,3.0098166471028844,709,456,1165,-
chr12,123353080,1.118655462184874,639,424,1063,-
chr12,123353081,1.803561491374513,925,598,1523,-
chr12,123353083,4.481548102958297,838,588,1426,-
chr12,123745778,2.2008693361433087,1022,948,1970,-
chr12,123746080,2.77810650887574,625,506,1131,-
chr12,123746174,1.369374751095181,1494,1214,2708,-
chr12,123746236,0.6602710455450181,1288,935,2223,-
chr12,123746250,1.873687611729769,1650,1178,2828,-
chr12,123746309,1.5974877650897226,858,612,1470,-
chr12,123746344,2.7496543037260652,914,723,1637,-
chr12,123749816,3.6604674127715606,966,433,1399,-
chr12,123749842,1.8248109345729548,796,496,1292,-
chr12,123749854,0.48695528956493134,1067,584,1651,-
chr12,123804468,3.1924705882352944,847,499,1346,-
chr12,123804470,3.1924705882352944,847,499,1346,-
chr12,124105834,1.322304203880215,609,521,1130,-
chr12,124105936,2.191739430029094,751,429,1180,-
chr12,124106161,2.4716568451255494,616,450,1066,-
chr12,124109384,0.49757031966886217,999,660,1659,-
chr12,124114755,1.8617885601823927,808,580,1388,-
chr12,124816957,1.8790599419065221,592,540,1132,-
chr12,124816959,1.8790599419065221,592,540,1132,-
chr12,125262269,2.8942016190279243,1213,759,1972,-
chr12,125262270,3.450245614035088,792,474,1266,-
chr12,125262737,1.5181404384367674,957,612,1569,-
chr12,125262738,1.0846553610503282,720,456,1176,-
chr12,125267284,1.690151304186392,568,512,1080,-
chr12,125279762,1.6231406098725658,965,917,1882,-
chr12,125294807,1.8845303860585088,1135,717,1852,-
chr12,125298758,1.7713625866050808,589,432,1021,-
chr12,125298796,1.7018181818181817,527,483,1010,-
chr12,125299571,2.169554586014517,707,589,1296,-
chr12,125302200,1.9141214524618448,924,800,1724,-
chr12,125348157,1.5067474221808261,600,561,1161,-
chr12,125348210,2.4370529618051444,758,588,1346,-
chr12,125396315,1.2662646998066915,6339,4297,10636,-
chr12,125396396,0.7632144083869715,2807,2308,5115,-
chr12,125396407,1.4318285563481439,9683,7017,16700,-
chr12,125396408,1.5362170297235234,4082,3145,7227,-
chr12,125396416,1.840809361287177,1677,1171,2848,-
chr12,125396419,1.077146874905208,5438,4149,9587,-
chr12,125396420,0.7271701971888934,3901,3094,6995,-
chr12,125396421,0.7104371921182265,2768,2183,4951,-
chr12,125396422,0.7104371921182265,2768,2183,4951,-
chr12,125396426,1.7941616463821466,4328,2714,7042,-
chr12,125396428,1.9170152148875552,3299,1832,5131,-
chr12,125396429,1.4754999290880728,1014,640,1654,-
chr12,125396432,1.555496688741722,1467,754,2221,-
chr12,125396442,1.848063899982636,733,442,1175,-
chr12,125396443,1.892316513761468,1137,544,1681,-
chr12,125396456,1.8079058107261168,984,437,1421,-
chr12,125396458,2.081987199024688,620,385,1005,-
chr12,125396459,0.5856649709302325,613,511,1124,-
chr12,125396461,1.6747191011235956,812,355,1167,-
chr12,125396477,2.2025375869793664,1529,857,2386,-
chr12,125396478,1.3255585724099577,1038,396,1434,-
chr12,125396480,1.4292692939244662,940,347,1287,-
chr12,125396482,1.6076498104566033,1359,585,1944,-
chr12,125396483,2.598885077186964,776,264,1040,-
chr12,125397160,1.2734126950113864,8779,6379,15158,-
chr12,125397161,1.2663857583516462,4958,4052,9010,-
chr12,125397166,1.241014066640501,5805,3844,9649,-
chr12,125397209,1.2827054166350003,7489,4936,12425,-
chr12,125397215,1.552967683073229,8068,6124,14192,-
chr12,125397216,1.304140439559863,15354,10190,25544,-
chr12,125397217,1.304140439559863,15354,10190,25544,-
chr12,125397227,1.4810001230163614,2208,1477,3685,-
chr12,125397307,1.5056683986773736,2549,2116,4665,-
chr12,125397319,1.306183524817888,5044,2734,7778,-
chr12,125397320,1.298906081351096,3603,1796,5399,-
chr12,125397334,1.1916977856061644,2805,1820,4625,-
chr12,125397335,1.0644047135310848,1689,1283,2972,-
chr12,125397337,3.2363013698630136,944,437,1381,-
chr12,125397344,1.774146757679181,716,292,1008,-
chr12,125397358,1.879145253751339,1215,780,1995,-
chr12,125397359,0.9477586878947983,1090,739,1829,-
chr12,125397374,1.449666345242944,733,453,1186,-
chr12,125397375,0.3571250519318654,613,414,1027,-
chr12,125397377,1.6313229808108638,835,557,1392,-
chr12,125397547,1.3213200680002062,8453,6585,15038,-
chr12,125397619,2.951939736346516,4733,2949,7682,-
chr12,125397622,1.4461078157528586,4669,2794,7463,-
chr12,125397682,1.4518234537556798,9252,6214,15466,-
chr12,125397683,1.507654200475871,8462,5549,14011,-
chr12,125397685,1.504220148921808,5492,3560,9052,-
chr12,125397688,1.410226490186836,8591,5021,13612,-
chr12,125397689,1.4133853604135613,8908,5348,14256,-
chr12,125397768,1.2937024858052169,2286,1602,3888,-
chr12,125397857,1.255184830009782,24742,18244,42986,-
chr12,125397859,1.3322157419259424,38581,27032,65613,-
chr12,125397860,1.5117792499147176,18810,11497,30307,-
chr12,125397861,1.4792771588255729,11442,6766,18208,-
chr12,125397869,2.01528991262907,2387,1258,3645,-
chr12,125397876,1.393336075689017,2043,1000,3043,-
chr12,125397889,2.3945098039215686,1633,1274,2907,-
chr12,125397890,1.918954248366013,1467,662,2129,-
chr12,125397893,1.4886592018374962,1463,1031,2494,-
chr12,125397899,1.933411063609276,1147,497,1644,-
chr12,125397900,1.449178590355061,1242,628,1870,-
chr12,125397904,1.4772141376969459,2165,1182,3347,-
chr12,125398004,1.3536333909566158,4061,2526,6587,-
chr12,125398044,1.9858684766885502,2643,1891,4534,-
chr12,125398078,1.9340042964961455,5730,3396,9126,-
chr12,125398132,1.3118655539121764,5844,4271,10115,-
chr12,125398139,0.8114143721049922,2828,1855,4683,-
chr12,125398176,1.782296434933592,6002,4361,10363,-
chr12,125398177,1.782296434933592,6002,4361,10363,-
chr12,125398286,1.3550363995861328,20610,13975,34585,-
chr12,125398290,1.5513511367644173,19446,12765,32211,-
chr12,125398306,1.4906747444118826,8689,5453,14142,-
chr12,125399144,1.5682099041728381,49181,29757,78938,-
chr12,125399146,1.638294461143142,38175,23946,62121,-
chr12,125399195,0.9460420297152624,15506,9011,24517,-
chr12,125399196,0.9113756154455974,18774,10665,29439,-
chr12,125399199,1.0106811587359472,908,631,1539,-
chr12,133304702,2.5688227629975198,954,720,1674,-
chr12,133304703,2.5224586886656377,1245,918,2163,-
chr12,133304704,2.4611665155636144,1526,1102,2628,-
chr12,133304705,2.136524822695036,1204,845,2049,-
chr12,133304706,2.262174878778201,1032,728,1760,-
chr12,133311101,1.834402332361516,571,489,1060,-
chr12,133318030,1.840637450199203,2474,1756,4230,-
chr12,133318031,1.840637450199203,2474,1756,4230,-
chr12,133318059,2.1392369813422443,667,398,1065,-
chr13,20325459,3.3839557017969057,607,418,1025,-
chr13,23932556,2.3348931142544176,1770,1119,2889,-
chr13,23932557,2.023809523809524,1444,685,2129,-
chr13,23932558,2.649719495091164,1144,919,2063,-
chr13,23932559,2.575646189125213,2372,1477,3849,-
chr13,23932561,2.776979565772669,1064,782,1846,-
chr13,23932563,3.379501385041551,1036,721,1757,-
chr13,23932565,3.32165948275862,684,463,1147,-
chr13,25044062,1.4330241756304323,651,560,1211,-
chr13,26788832,1.0966781843745828,2064,1434,3498,-
chr13,26788833,1.3086510525144857,1535,1041,2576,-
chr13,26788885,3.010843373493976,713,414,1127,-
chr13,28009948,1.0151342451874368,696,563,1259,-
chr13,28009949,1.0151342451874368,696,563,1259,-
chr13,28009955,4.745547518839491,793,548,1341,-
chr13,28010013,3.2950228740695473,596,430,1026,-
chr13,30084180,1.0957098230723017,570,432,1002,-
chr13,30086554,0.3062788439310062,2198,934,3132,-
chr13,30086555,0.226926010678871,968,413,1381,-
chr13,31035137,2.306616729088639,595,444,1039,-
chr13,31035157,3.4533333333333336,839,449,1288,-
chr13,31035159,3.4533333333333336,839,449,1288,-
chr13,31035348,1.725689404934688,1188,688,1876,-
chr13,31035377,3.0365552814532406,676,342,1018,-
chr13,31035380,1.6317449775859207,935,633,1568,-
chr13,31035523,0.6458793872406439,756,572,1328,-
chr13,31035527,0.3285648889906157,637,513,1150,-
chr13,31035532,0.39641751650548024,881,1040,1921,-
chr13,31035538,3.9645919742919324,1361,1783,3144,-
chr13,31035539,4.955986181167151,2087,2517,4604,-
chr13,31035542,2.8745779270440615,1234,732,1966,-
chr13,31037721,1.4491465149359888,1140,702,1842,-
chr13,31037734,1.6706192358366274,950,758,1708,-
chr13,31037735,1.775671649147642,1343,763,2106,-
chr13,31037754,1.8667804711505636,700,504,1204,-
chr13,31040020,0.4840994962216625,614,396,1010,-
chr13,31040041,0.5015229816215476,861,478,1339,-
chr13,31040047,1.3765425110381524,771,583,1354,-
chr13,31040071,0.5242807699390457,858,511,1369,-
chr13,31711591,2.3856858846918487,799,502,1301,-
chr13,31711593,2.3856858846918487,799,502,1301,-
chr13,31724246,2.8195615514333894,835,592,1427,-
chr13,31724247,0.6046283618168602,1051,938,1989,-
chr13,31724248,2.298098434004474,586,595,1181,-
chr13,31724252,1.2088194444444444,1338,863,2201,-
chr13,31724253,2.4795658356926635,1880,1356,3236,-
chr13,33110155,2.2061162897807542,2031,1190,3221,-
chr13,33110156,2.3668465831122494,1175,642,1817,-
chr13,33110163,1.4987273833047519,1455,890,2345,-
chr13,33110164,1.5360918972332016,1322,735,2057,-
chr13,33110166,2.367531442838239,2028,1225,3253,-
chr13,33112924,1.118784977330233,848,769,1617,-
chr13,36878191,2.26572527264704,660,434,1094,-
chr13,36900770,2.634161695418798,628,437,1065,-
chr13,36909597,4.647741520835294,761,492,1253,-
chr13,36909908,1.9836614364592022,966,841,1807,-
chr13,41507741,2.4622601993800783,667,518,1185,-
chr13,41507743,3.410690734800351,1501,1134,2635,-
chr13,41507745,3.4904862579281186,634,472,1106,-
chr13,41507748,1.084478160148052,759,530,1289,-
chr13,45007988,1.5541493958902906,2013,1563,3576,-
chr13,45008308,0.7008777712243693,4697,3514,8211,-
chr13,45008309,1.3615716838760925,1589,1258,2847,-
chr13,45008310,0.7008777712243693,4697,3514,8211,-
chr13,45008311,2.015905688622755,1196,1001,2197,-
chr13,45008486,1.4799578503688091,2089,1624,3713,-
chr13,45008687,1.4777023546365666,2178,1648,3826,-
chr13,45008694,1.3648152081563296,2357,1711,4068,-
chr13,45008719,1.1372245062497386,3846,2647,6493,-
chr13,45008744,1.1548807616945094,1947,1583,3530,-
chr13,45008754,1.7077213707960837,1210,782,1992,-
chr13,45008755,0.6952004517221908,1025,758,1783,-
chr13,45008764,1.43392542202066,784,587,1371,-
chr13,45008772,0.5387900355871885,756,561,1317,-
chr13,45008773,1.8542987233282742,669,486,1155,-
chr13,45008790,2.0161290322580645,1174,681,1855,-
chr13,45008791,2.0359227130416504,2134,1397,3531,-
chr13,45010195,1.574710125239919,2851,1741,4592,-
chr13,45010666,1.3845143502236117,2602,1705,4307,-
chr13,45010782,2.6782210595160234,1637,1389,3026,-
chr13,45010827,1.5060781783631398,3329,2315,5644,-
chr13,45010886,1.4215248989872489,1289,1120,2409,-
chr13,45010924,1.5769628796400446,673,634,1307,-
chr13,45010960,1.35168863261944,886,606,1492,-
chr13,45010989,0.6276681312268392,1540,1127,2667,-
chr13,45911271,1.4315532555448742,2511,1908,4419,-
chr13,45911415,1.2102283693240283,18831,12332,31163,-
chr13,45911435,1.266565253234524,28614,23326,51940,-
chr13,45911494,1.1214673745292918,15946,12357,28303,-
chr13,45912911,0.6443900565195505,2113,1490,3603,-
chr13,45912912,0.9958562751887382,773,668,1441,-
chr13,45914167,1.288076114813444,13329,11118,24447,-
chr13,45914224,1.2224665246660285,80962,58260,139222,-
chr13,45914226,1.249893762043122,52826,36932,89758,-
chr13,45914297,0.8680685240068448,11108,8572,19680,-
chr13,45914319,0.5969451688113614,1909,1460,3369,-
chr13,45914848,1.854656232888095,34969,26905,61874,-
chr13,45915193,1.411356415703968,40393,34070,74463,-
chr13,45915196,1.666068393464636,10607,10155,20762,-
chr13,45915199,1.4184100137195623,29602,26507,56109,-
chr13,45915200,1.4191433980671628,38775,34426,73201,-
chr13,45915201,1.3343127373120724,75578,59452,135030,-
chr13,45915202,1.3627757466667592,37323,32482,69805,-
chr13,45915203,1.2526365461481734,66521,49882,116403,-
chr13,45915240,1.0554436273380994,19923,12879,32802,-
chr13,45915244,1.512413846611408,5921,4548,10469,-
chr13,45915257,1.1183373771804461,46168,31992,78160,-
chr13,45915258,1.0960010270789997,36001,27088,63089,-
chr13,45915317,0.8440080884280466,20531,14146,34677,-
chr13,45915318,0.770008272425551,11726,7060,18786,-
chr13,45915319,0.8376260302866841,4364,3129,7493,-
chr13,45964550,0.551981351981352,591,519,1110,-
chr13,45964555,1.6485303314571609,658,491,1149,-
chr13,45964561,1.9628595548575305,1020,826,1846,-
chr13,45964568,1.094648707681107,969,669,1638,-
chr13,45964569,1.094648707681107,969,669,1638,-
chr13,45964573,0.3994897049579235,1089,776,1865,-
chr13,45964574,0.44405722670579595,806,563,1369,-
chr13,45964578,1.6643836820686675,683,561,1244,-
chr13,46542119,2.091090425531915,628,375,1003,-
chr13,46542131,2.1920239741816507,770,481,1251,-
chr13,46542133,2.186662907091499,1127,691,1818,-
chr13,46542134,2.3372926656993886,975,610,1585,-
chr13,46542139,2.1923896870700825,763,439,1202,-
chr13,46549893,2.7699551569506724,638,445,1083,-
chr13,46549894,2.7699551569506724,638,445,1083,-
chr13,46584564,3.4007633587786263,791,523,1314,-
chr13,46584592,2.6813532691635666,801,512,1313,-
chr13,47345551,2.1326127624194555,683,565,1248,-
chr13,47351649,4.727963525835866,731,657,1388,-
chr13,47354127,0.5312689738919247,804,620,1424,-
chr13,47354129,2.220715835140998,584,460,1044,-
chr13,47354146,1.8111097605445483,595,432,1027,-
chr13,47355648,1.1687351831332375,1388,980,2368,-
chr13,47355658,0.579411132602622,673,395,1068,-
chr13,47365534,1.7522448979591838,635,489,1124,-
chr13,47367553,2.5245653817082387,834,587,1421,-
chr13,47371281,0.4271681666546816,1565,1128,2693,-
chr13,50235155,3.3755719369598367,680,561,1241,-
chr13,50235157,3.315014478134787,1104,805,1909,-
chr13,50237294,0.4250900205761316,600,431,1031,-
chr13,50237295,0.4250900205761316,600,431,1031,-
chr13,50280288,2.233649470971986,925,628,1553,-
chr13,50280290,2.993037534432531,1689,1269,2958,-
chr13,51943143,1.9536958068756927,1679,1180,2859,-
chr13,51950234,3.422566371681416,713,451,1164,-
chr13,51950288,1.7846502319775035,2829,1670,4499,-
chr13,51950289,1.7846502319775035,2829,1670,4499,-
chr13,51952455,0.6313993871503967,921,464,1385,-
chr13,51952456,0.24629923198868484,795,427,1222,-
chr13,55014876,1.6838267707227896,2169,1490,3659,-
chr13,55014878,1.456255707762557,1138,875,2013,-
chr13,55014879,0.7369338264617671,1586,1122,2708,-
chr13,55014880,1.4246231155778895,1052,795,1847,-
chr13,55014881,0.9994805194805194,665,494,1159,-
chr13,55014887,2.3876847290640395,1047,579,1626,-
chr13,55014888,2.3876847290640395,1047,579,1626,-
chr13,55014893,1.725563909774436,773,601,1374,-
chr13,60435546,2.031194093832047,1431,1075,2506,-
chr13,60435547,2.1775002668374426,886,693,1579,-
chr13,60453386,1.033465928744379,702,412,1114,-
chr13,60453387,1.5666750445509776,1299,845,2144,-
chr13,60453388,1.8969367479903796,1197,832,2029,-
chr13,73283591,1.844511652730831,767,510,1277,-
chr13,73283916,3.6037100696529363,1339,932,2271,-
chr13,73284132,0.6024663107042969,676,413,1089,-
chr13,73284173,1.545167436640305,1183,890,2073,-
chr13,73293124,1.867481078210065,585,442,1027,-
chr13,73301687,1.5552052297899266,1049,667,1716,-
chr13,73336182,2.315098574382923,611,501,1112,-
chr13,75860946,1.7183077852345134,844,533,1377,-
chr13,76100752,0.6303030303030303,1405,1220,2625,-
chr13,76104344,0.7219179008588625,1524,1115,2639,-
chr13,76104394,0.9776543535825191,2714,1736,4450,-
chr13,76104395,0.6383993188590888,651,521,1172,-
chr13,76104396,1.148389659716301,1768,1063,2831,-
chr13,77579729,0.6601163741881303,801,536,1337,-
chr13,79951570,2.1724947807933197,674,478,1152,-
chr13,95226968,2.0298316779409196,605,480,1085,-
chr13,95672316,2.512061403508772,710,512,1222,-
chr13,95672399,1.4803552809752705,744,574,1318,-
chr13,95672911,2.090949227373068,591,452,1043,-
chr13,95705435,2.7226425226458497,1497,1200,2697,-
chr13,95705437,2.5196124677963643,977,888,1865,-
chr13,95723997,1.2092675829766901,657,444,1101,-
chr13,95813547,0.571593200806684,743,533,1276,-
chr13,95830262,3.0995618508707117,763,562,1325,-
chr13,95838958,2.0147172734314487,3467,2581,6048,-
chr13,95838960,2.0147172734314487,3467,2581,6048,-
chr13,95838978,1.4993648911846895,1361,722,2083,-
chr13,95838982,1.5703324808184145,1227,781,2008,-
chr13,95838985,0.675744736045657,2140,1144,3284,-
chr13,95838986,0.675744736045657,2140,1144,3284,-
chr13,95838991,2.5689145951267536,834,477,1311,-
chr13,95838997,1.6261343012704172,895,512,1407,-
chr13,95839000,2.032714412024757,1451,782,2233,-
chr13,95839001,2.032714412024757,1451,782,2233,-
chr13,95839007,2.6797853309481217,641,386,1027,-
chr13,95839018,1.3285752984615238,1109,625,1734,-
chr13,95861777,2.746547565175994,586,436,1022,-
chr13,99134524,1.9969539711191335,570,553,1123,-
chr13,99171627,0.4141791044776119,961,727,1688,-
chr13,99171629,0.8235544547255125,1350,976,2326,-
chr13,101278143,1.1617703225758824,1408,931,2339,-
chr13,101278145,1.5845590406993917,924,593,1517,-
chr13,101278332,0.8005140118354771,905,590,1495,-
chr13,103418907,3.176663289381946,928,725,1653,-
chr13,103441420,2.594117647058824,566,509,1075,-
chr13,107196357,0.49540043520294513,1005,713,1718,-
chr13,107209565,0.3358488900657575,760,580,1340,-
chr13,107209664,40.75482727436741,1833,1747,3580,-
chr13,107209665,40.95271687016146,1715,1647,3362,-
chr13,107209691,2.57715296323992,675,360,1035,-
chr13,107209978,2.3331947524020693,952,655,1607,-
chr13,107209979,2.1670427619059933,1481,971,2452,-
chr13,107209989,3.249525510773697,1187,688,1875,-
chr13,107209990,3.249525510773697,1187,688,1875,-
chr13,107209991,3.249525510773697,1187,688,1875,-
chr13,107211446,2.892831695332132,1407,1463,2870,-
chr13,107211447,3.557859620017881,972,977,1949,-
chr13,107211453,20.20073072608316,711,635,1346,-
chr13,111175536,1.3420971325552564,1562,1168,2730,-
chr13,111175605,3.017967591684656,648,455,1103,-
chr13,111175762,0.18913189901725594,324,874,1198,-
chr13,111175771,0.23740001127692947,726,1558,2284,-
chr13,111175776,0.21268520408517733,551,1096,1647,-
chr13,111175799,6.831288343558282,458,977,1435,-
chr13,111175800,9.311672295752354,1627,2274,3901,-
chr13,111175801,10.295462561755729,1786,2317,4103,-
chr13,111175802,15.733258928571432,665,511,1176,-
chr13,111175992,3.5327785207919407,595,492,1087,-
chr13,111176150,0.9612191071603008,655,352,1007,-
chr13,111176151,0.9612191071603008,655,352,1007,-
chr13,111176222,2.626500600240096,760,391,1151,-
chr13,111176223,2.626500600240096,760,391,1151,-
chr13,111176374,1.6107376315792648,4120,3966,8086,-
chr13,111176375,1.6107376315792648,4120,3966,8086,-
chr13,111176378,1.422824635053907,1728,1783,3511,-
chr13,111176379,1.4752443159154367,2474,2506,4980,-
chr13,111176381,1.4767894810858344,2321,2149,4470,-
chr13,111176396,0.4825366295708103,1184,1203,2387,-
chr13,111176398,0.4593141170651628,1320,1327,2647,-
chr13,111176402,2.2845301226930532,585,713,1298,-
chr13,111176417,3.533697632058288,484,548,1032,-
chr13,111176418,3.7099838240483685,1473,1468,2941,-
chr13,111176420,3.4745435658297814,1245,1181,2426,-
chr13,111176421,2.5958831100778768,662,672,1334,-
chr13,111296813,0.5228998404023795,635,666,1301,-
chr13,111545408,1.5333726041053064,751,760,1511,-
chr13,111545427,2.124652507505838,578,528,1106,-
chr13,111545428,1.8402283990519288,588,545,1133,-
chr13,111545484,0.4982796106853531,870,714,1584,-
chr13,111562995,1.6704293692254033,557,502,1059,-
chr13,113176648,2.445814281610211,608,447,1055,-
chr13,113200022,1.9837194740137762,1691,1596,3287,-
chr13,113200023,1.9837194740137762,1691,1596,3287,-
chr13,113200026,1.6893983624065507,1520,1324,2844,-
chr13,113200028,1.6893983624065507,1520,1324,2844,-
chr13,113200048,0.2396313364055299,649,464,1113,-
chr13,113200071,2.737556561085973,604,441,1045,-
chr13,113200072,2.737556561085973,604,441,1045,-
chr13,113209234,2.1236519607843136,558,479,1037,-
chr13,113212662,2.094060674135162,2814,2505,5319,-
chr13,113212668,1.106429135966835,10034,7174,17208,-
chr13,113212669,1.461969213510096,4822,3822,8644,-
chr13,113212673,1.660002390604878,7293,5268,12561,-
chr13,113212675,2.0556501377699083,4196,3078,7274,-
chr13,113212685,1.385877856466092,3451,2441,5892,-
chr13,113212686,1.4046254399195577,1602,1070,2672,-
chr13,113212687,1.49806131392175,6257,4129,10386,-
chr13,113212688,1.6451429630825725,2806,1688,4494,-
chr13,113212691,1.7430497279445605,1369,900,2269,-
chr13,113212706,1.7105232643599582,3172,1923,5095,-
chr13,113212708,2.137505489679403,2862,1517,4379,-
chr13,113212710,2.514055577929924,1835,954,2789,-
chr13,113212720,1.731829853745674,830,506,1336,-
chr13,113223474,0.49248547277625565,818,537,1355,-
chr13,113223512,5.010917030567685,594,457,1051,-
chr13,113832143,1.9777703826955073,1747,1201,2948,-
chr13,113832314,2.377307692307693,882,649,1531,-
chr13,113832430,2.4339594575764725,833,629,1462,-
chr13,113832435,3.5154883773670766,781,611,1392,-
chr13,113832545,1.0379146063783562,2629,1951,4580,-
chr13,113833293,1.5147662561250166,1063,838,1901,-
chr13,113834270,0.5918111925621312,992,657,1649,-
chr13,113834305,1.5211842105263158,1050,799,1849,-
chr13,113838780,1.952013596944921,3027,2568,5595,-
chr13,113841518,2.0237895186551933,1484,1197,2681,-
chr13,113845263,1.952560317621908,684,516,1200,-
chr13,113849417,1.7325291181364393,1070,600,1670,-
chr13,113850501,0.6712314871170623,1017,635,1652,-
chr13,113850502,1.4668060509162464,1216,864,2080,-
chr13,113851513,1.4885266457680253,1318,956,2274,-
chr13,113852527,0.595539033457249,889,537,1426,-
chr13,113854775,2.9416666666666664,705,415,1120,-
chr13,114748726,2.205360843598639,936,736,1672,-
chr13,114748769,2.4878048780487805,662,368,1030,-
chr13,114748770,1.8560239622843377,922,558,1480,-
chr13,114748771,2.4878048780487805,662,368,1030,-
chr14,19890429,2.471565827536399,1130,637,1767,-
chr14,19890430,2.106311274509804,824,407,1231,-
chr14,20779804,1.5971225829915185,1982,1575,3557,-
chr14,20779841,1.742619409552764,946,861,1807,-
chr14,20779885,2.035405282331512,940,731,1671,-
chr14,20781659,1.6721419185282527,1017,760,1777,-
chr14,20781704,1.7430260869565215,782,574,1356,-
chr14,20781874,1.8731922398589065,987,629,1616,-
chr14,20781903,2.067535379010789,867,548,1415,-
chr14,20784434,1.688744354110208,1015,674,1689,-
chr14,20784491,0.4250992063492063,856,755,1611,-
chr14,20784525,1.7075821441267585,933,678,1611,-
chr14,20784559,1.6529615016975723,1459,1017,2476,-
chr14,20784563,1.5734265734265735,674,450,1124,-
chr14,20784649,1.9575980867429386,796,572,1368,-
chr14,20784654,2.3583387692976734,747,510,1257,-
chr14,20794948,2.026129705704088,1227,957,2184,-
chr14,20797363,1.3747681772789957,1651,1236,2887,-
chr14,20797527,1.6588566226233832,1173,787,1960,-
chr14,20797529,1.6801321407306626,1436,813,2249,-
chr14,20797530,0.758371631224889,951,628,1579,-
chr14,20801424,1.2895074526383805,1027,604,1631,-
chr14,20801425,0.9874301675977651,706,357,1063,-
chr14,20811263,0.5842657342657344,556,454,1010,-
chr14,20811271,0.7300504263694135,1654,1080,2734,-
chr14,20811567,0.9210124548011248,5209,3039,8248,-
chr14,20811569,0.9210124548011248,5209,3039,8248,-
chr14,20926352,12.471531327813167,834,1024,1858,-
chr14,20926353,9.147428056856649,871,1005,1876,-
chr14,20926354,11.119623554592415,1027,1284,2311,-
chr14,21678807,4.15738188335168,563,442,1005,-
chr14,21678976,1.7579621076989562,2292,1542,3834,-
chr14,21678990,1.4822503253090435,1278,927,2205,-
chr14,21678995,1.461921027462768,1048,562,1610,-
chr14,21679291,1.3507049282595134,1482,1144,2626,-
chr14,21679305,1.3926340147622391,3413,2383,5796,-
chr14,21679313,2.722222222222222,937,669,1606,-
chr14,21679322,1.620698571826391,1380,881,2261,-
chr14,21679323,0.6459215868666173,1194,1006,2200,-
chr14,21679329,1.6614583333333333,1043,959,2002,-
chr14,21679347,1.5313548387096774,965,774,1739,-
chr14,21679348,0.531716784591195,940,767,1707,-
chr14,21679349,2.5,809,485,1294,-
chr14,21679357,1.6133447390932423,819,667,1486,-
chr14,21679594,1.3258036739380024,2594,1741,4335,-
chr14,21679607,5.004355210415137,16508,9230,25738,-
chr14,21679609,5.286098942336997,10265,5365,15630,-
chr14,21679630,1.894221173909099,2519,1056,3575,-
chr14,21681120,1.639500734214391,2029,1361,3390,-
chr14,21681121,1.3637326437188595,3564,2080,5644,-
chr14,21681124,1.4861808950020838,2926,2314,5240,-
chr14,21681130,1.4005510101220635,3131,1770,4901,-
chr14,21681192,1.6171599283339846,9059,5857,14916,-
chr14,21681193,1.4668916885238852,2200,1788,3988,-
chr14,21681194,1.6171599283339846,9059,5857,14916,-
chr14,21681199,1.501577287066246,1478,950,2428,-
chr14,21681212,1.6073273768581904,6922,3867,10789,-
chr14,21681213,1.5169192567856833,4320,2289,6609,-
chr14,21681214,1.7502716987623046,2602,1578,4180,-
chr14,21699171,1.2418741071413266,6515,4173,10688,-
chr14,21699191,1.5032598337531962,5493,3086,8579,-
chr14,21699193,1.5531387560972931,7141,4114,11255,-
chr14,21699205,1.60049569771792,1368,791,2159,-
chr14,21699227,1.5801275217999906,5042,3297,8339,-
chr14,21699229,1.457792325877432,3271,2443,5714,-
chr14,21702227,1.324317577786588,3109,1973,5082,-
chr14,21702242,1.4634468874590456,2797,2067,4864,-
chr14,21737485,1.5187867883198756,9220,6243,15463,-
chr14,21737486,1.5187867883198756,9220,6243,15463,-
chr14,21737487,0.7540561931143649,2265,1671,3936,-
chr14,21737493,1.5969054121378583,4372,2718,7090,-
chr14,21737495,1.5969054121378583,4372,2718,7090,-
chr14,21737498,1.5382183034356949,2107,1264,3371,-
chr14,21737574,1.396598952109569,1186,988,2174,-
chr14,21737577,0.6008738726522664,2748,1803,4551,-
chr14,21737582,0.6680675094136633,1281,831,2112,-
chr14,21737583,0.5859271736222518,3973,3132,7105,-
chr14,21737584,0.5859271736222518,3973,3132,7105,-
chr14,21737585,0.5586193382856888,3317,2455,5772,-
chr14,21819949,1.8132816728877108,1969,1327,3296,-
chr14,21819951,1.6330296390266406,1179,666,1845,-
chr14,21820067,1.8245986862813963,13066,7744,20810,-
chr14,21820068,1.8857939422890455,14126,8274,22400,-
chr14,21820070,1.7572910893611324,12452,7110,19562,-
chr14,21820073,2.190007163323782,1746,1046,2792,-
chr14,21820105,0.9362514985909351,3616,2167,5783,-
chr14,21820106,1.075742295371856,4680,2715,7395,-
chr14,21820202,1.730769230769231,899,519,1418,-
chr14,21820214,2.3953076844675905,948,542,1490,-
chr14,21820605,1.0795187201720775,802,512,1314,-
chr14,21820607,1.0795187201720775,802,512,1314,-
chr14,21822685,1.2791062164424611,802,563,1365,-
chr14,21827704,0.2406881313131313,609,395,1004,-
chr14,21829120,1.9742975880791536,759,484,1243,-
chr14,21829318,2.688683712121212,830,575,1405,-
chr14,21829319,2.903441031285767,1333,1008,2341,-
chr14,21831195,2.3787777195275144,1174,842,2016,-
chr14,21831218,2.832427088482452,763,475,1238,-
chr14,21831221,1.8789144050104385,611,478,1089,-
chr14,21831288,0.4853185595567867,583,474,1057,-
chr14,21831421,1.6412234178332459,8251,5855,14106,-
chr14,21831423,1.8895402653502005,4592,3240,7832,-
chr14,21831443,1.6515021459227468,1819,1164,2983,-
chr14,21831455,1.6507463448288469,3019,1854,4873,-
chr14,21831458,1.9275860351611136,1415,872,2287,-
chr14,21831618,1.8051080081155269,1649,930,2579,-
chr14,21831619,1.914316874148737,2301,1451,3752,-
chr14,21831627,1.5715099715099714,1181,701,1882,-
chr14,21831630,2.0099954566106315,1105,638,1743,-
chr14,21833031,1.9492056630282075,667,486,1153,-
chr14,21833043,0.6171934813518538,626,445,1071,-
chr14,21833044,1.5727069351230427,569,446,1015,-
chr14,21833285,0.4607918263090677,655,434,1089,-
chr14,21836594,2.123656078778531,872,630,1502,-
chr14,21838052,2.049211090099579,829,611,1440,-
chr14,21838631,1.6986412239879223,1435,1366,2801,-
chr14,21840045,0.5986459608323134,1268,1031,2299,-
chr14,21841499,1.6974358974358974,661,584,1245,-
chr14,21852066,1.43399676565655,712,492,1204,-
chr14,21852069,3.3829947911766247,881,575,1456,-
chr14,21896285,0.9809702694733573,616,471,1087,-
chr14,21966474,2.3156614520409806,1450,943,2393,-
chr14,21966476,3.7880124917395914,987,596,1583,-
chr14,21967237,1.5531246553757312,619,468,1087,-
chr14,21969115,2.326857076198604,707,499,1206,-
chr14,21979333,5.098096543319419,715,663,1378,-
chr14,21979334,4.80439830208613,561,496,1057,-
chr14,23044056,1.473006810897436,1755,1247,3002,-
chr14,23044078,1.48106100795756,1550,974,2524,-
chr14,23044112,0.5473397926228115,1287,953,2240,-
chr14,23057878,1.6207633587786257,1326,1178,2504,-
chr14,23057932,1.7065266316579144,1033,859,1892,-
chr14,23057990,2.3251084193210705,896,742,1638,-
chr14,23058025,2.033231707317073,854,655,1509,-
chr14,23058062,1.683772357723577,808,614,1422,-
chr14,23058066,1.8845473723128046,1923,1263,3186,-
chr14,23058080,1.9611362420351186,1752,978,2730,-
chr14,23058081,1.9611362420351186,1752,978,2730,-
chr14,23374566,2.2720125786163523,1189,953,2142,-
chr14,23374571,1.4597457627118644,1112,825,1937,-
chr14,23374577,1.6641975308641976,1010,728,1738,-
chr14,23374589,1.4284399447768066,969,614,1583,-
chr14,23374602,2.4522875816993466,669,424,1093,-
chr14,23374643,2.0187419925639176,815,542,1357,-
chr14,23374829,3.5936759707487886,850,510,1360,-
chr14,23394160,3.041392861799276,823,631,1454,-
chr14,23394181,0.42170352564584146,733,528,1261,-
chr14,23395476,2.542081659273861,731,501,1232,-
chr14,23397356,0.4472072455480685,631,420,1051,-
chr14,23397414,3.008138528138528,807,524,1331,-
chr14,23397415,3.008138528138528,807,524,1331,-
chr14,23398536,14.623635941490594,669,335,1004,-
chr14,23398573,0.6976164349089561,878,495,1373,-
chr14,23415596,2.6240409207161126,1025,764,1789,-
chr14,23415598,2.6240409207161126,1025,764,1789,-
chr14,23417099,0.3197294124224297,816,576,1392,-
chr14,23417101,0.3197294124224297,816,576,1392,-
chr14,23417182,2.517652868378424,903,559,1462,-
chr14,23421656,1.8274257071249551,703,531,1234,-
chr14,23421812,1.9039615846338533,609,489,1098,-
chr14,23421840,1.730629049676026,692,462,1154,-
chr14,23421859,1.4417801082153523,1667,1192,2859,-
chr14,23421883,1.2941983044914114,1192,809,2001,-
chr14,23424321,2.41106413693545,994,745,1739,-
chr14,23424322,2.255973365994405,1407,1079,2486,-
chr14,23495247,1.5661088911088912,1717,1429,3146,-
chr14,23495333,1.834435385504269,1269,841,2110,-
chr14,23495355,1.6642185663924791,1132,735,1867,-
chr14,23495430,1.325060149423832,1525,1042,2567,-
chr14,23495485,1.5722192614044594,2966,2103,5069,-
chr14,23495578,2.336444444444444,1501,899,2400,-
chr14,23502599,1.2216728629851799,2585,1703,4288,-
chr14,23502680,1.4317924153959527,1422,1195,2617,-
chr14,23502698,0.702714027849407,1520,1107,2627,-
chr14,23502713,0.6152420948616601,1464,919,2383,-
chr14,23502754,1.7652611705475143,934,680,1614,-
chr14,23503926,1.7490844711091142,3086,2155,5241,-
chr14,23503932,1.5973432959734328,935,656,1591,-
chr14,23503933,0.3560317632981616,1090,633,1723,-
chr14,23504000,0.6382447748778207,1022,814,1836,-
chr14,23504009,0.5189137134052388,708,589,1297,-
chr14,23504067,1.6376158403808172,850,636,1486,-
chr14,23504089,2.208609271523179,666,452,1118,-
chr14,23504091,1.3613983907386678,2322,1327,3649,-
chr14,23504093,1.5246442820291688,2737,1576,4313,-
chr14,23504094,2.4449851042701094,848,529,1377,-
chr14,23504102,3.3258380398821226,1014,512,1526,-
chr14,23504106,1.5635528059509272,871,491,1362,-
chr14,23504108,1.3492940385477363,786,484,1270,-
chr14,23528456,5.168004731548973,594,834,1428,-
chr14,23528480,26.15643577218433,4407,1407,5814,-
chr14,23528481,29.068141910293047,6047,1823,7870,-
chr14,23528482,29.48966206612947,5876,1777,7653,-
chr14,23528483,33.06571074650453,3413,1019,4432,-
chr14,23528513,4.670055702645999,2590,553,3143,-
chr14,23528514,4.798674209252381,2262,473,2735,-
chr14,23528591,3.285874354218272,1291,949,2240,-
chr14,23532199,0.6474021025626796,690,453,1143,-
chr14,23549624,1.8819776714513559,707,398,1105,-
chr14,23549630,2.357760814249364,1242,654,1896,-
chr14,23549632,2.357760814249364,1242,654,1896,-
chr14,23549634,1.5790065815379422,801,612,1413,-
chr14,23549655,2.3090196078431373,643,424,1067,-
chr14,23549659,2.8142889808821727,920,515,1435,-
chr14,23549965,6.30092341118957,724,788,1512,-
chr14,23549968,2.142356241234222,704,712,1416,-
chr14,23549971,2.4911654774040093,681,653,1334,-
chr14,23549977,2.2613430127041743,622,550,1172,-
chr14,23550998,2.8752921999114918,970,685,1655,-
chr14,23550999,3.536697247706422,770,544,1314,-
chr14,23551021,1.5310876487347076,570,441,1011,-
chr14,23551023,2.1378790509740635,659,461,1120,-
chr14,24614946,2.974899287263713,599,460,1059,-
chr14,24614976,4.438341344617312,680,424,1104,-
chr14,24615812,0.33774472169792574,745,569,1314,-
chr14,24686219,1.6560969151330598,806,580,1386,-
chr14,24686227,1.495908625980225,1079,837,1916,-
chr14,24686320,1.492231075697211,1361,1003,2364,-
chr14,24686321,2.062753688550995,1333,912,2245,-
chr14,24687353,1.5513621794871797,1018,779,1797,-
chr14,24687389,1.7960501121505552,937,676,1613,-
chr14,24687392,1.4954474819636812,2268,1681,3949,-
chr14,24701468,0.57703213610586,1516,1057,2573,-
chr14,24701485,1.522966316069764,836,608,1444,-
chr14,24701486,0.561997226074896,1012,720,1732,-
chr14,24701506,0.47436729396495786,687,535,1222,-
chr14,24701542,0.6308109942314217,675,420,1095,-
chr14,24701543,2.3864420236869988,2758,1575,4333,-
chr14,24701544,2.6140819964349378,1675,747,2422,-
chr14,24701551,1.4870909742540148,1700,1203,2903,-
chr14,24701552,2.2846153846153845,659,519,1178,-
chr14,24701553,0.8630608341996099,1489,956,2445,-
chr14,24701566,2.1258907363420425,715,420,1135,-
chr14,24701567,2.1258907363420425,715,420,1135,-
chr14,24701570,1.0820245719398014,1080,310,1390,-
chr14,24701571,1.3242942317000697,1842,728,2570,-
chr14,24701572,1.0576241706119385,1542,512,2054,-
chr14,24711119,3.8783044037792225,635,543,1178,-
chr14,31570240,2.503350083752094,853,596,1449,-
chr14,31570241,2.503350083752094,853,596,1449,-
chr14,31575974,1.6939312072442911,3218,2328,5546,-
chr14,31575989,1.4705457454965716,1202,840,2042,-
chr14,31575991,0.5141303798959789,1489,981,2470,-
chr14,31576022,2.898673920435226,774,518,1292,-
chr14,31578742,1.4695892748611603,727,379,1106,-
chr14,31602548,1.8089166838245956,755,489,1244,-
chr14,31637631,3.292021444339325,948,1056,2004,-
chr14,31637632,3.292021444339325,948,1056,2004,-
chr14,34903924,47.453938563833184,17617,10402,28019,-
chr14,34903925,46.57618429521866,22548,11083,33631,-
chr14,34903926,43.11700691896696,24802,9211,34013,-
chr14,34903927,32.89743914069394,19784,3961,23745,-
chr14,34903928,6.449530316462534,17504,2412,19916,-
chr14,34903930,9.197689182326052,2682,357,3039,-
chr14,34903934,5.3628084537648215,3488,515,4003,-
chr14,34903935,11.674004192872117,1590,211,1801,-
chr14,34903937,5.988826815642458,1071,178,1249,-
chr14,34903940,4.898968350610473,2495,391,2886,-
chr14,34904144,1.485167837626854,1521,914,2435,-
chr14,34904410,0.6198042912290151,862,710,1572,-
chr14,34904419,1.4939099917423615,1058,691,1749,-
chr14,34904421,1.7472832369942195,686,518,1204,-
chr14,34904476,1.5312333864965444,561,455,1016,-
chr14,34931304,1.7260073260073259,743,584,1327,-
chr14,34931305,1.883600917431193,656,435,1091,-
chr14,34931331,0.5126262626262627,695,527,1222,-
chr14,34931333,2.340118667275217,753,625,1378,-
chr14,34931334,2.340118667275217,753,625,1378,-
chr14,34931346,2.8459821428571432,560,447,1007,-
chr14,34931357,1.4824157142227874,1246,925,2171,-
chr14,35005320,3.229126418790109,735,505,1240,-
chr14,35032024,1.9473684210526319,702,455,1157,-
chr14,35032217,2.1927409261576973,656,422,1078,-
chr14,35032305,2.0087066504975057,1193,937,2130,-
chr14,35032306,2.038095238095238,748,419,1167,-
chr14,35037170,2.476842105263158,723,474,1197,-
chr14,35037894,0.9822530864197531,1272,971,2243,-
chr14,35037895,1.1832592995854,1412,1159,2571,-
chr14,35037896,0.9822530864197531,1272,971,2243,-
chr14,35037898,0.7198183760683761,636,467,1103,-
chr14,35045046,0.652769091793482,853,532,1385,-
chr14,35078930,2.642259117354903,930,521,1451,-
chr14,35078931,2.642259117354903,930,521,1451,-
chr14,35180448,1.7397744126863364,796,520,1316,-
chr14,35181443,2.049979347377117,708,537,1245,-
chr14,35182042,0.5298180592991913,628,423,1051,-
chr14,35182070,1.754310344827586,626,455,1081,-
chr14,35870831,2.4855324074074074,858,575,1433,-
chr14,35870832,2.4855324074074074,858,575,1433,-
chr14,35870836,4.341336867209588,601,564,1165,-
chr14,35870947,2.113159472422062,612,416,1028,-
chr14,35871063,2.189931350114416,989,873,1862,-
chr14,35871065,2.189931350114416,989,873,1862,-
chr14,35871087,3.1570155902004458,566,448,1014,-
chr14,35871104,2.1618768328445745,775,619,1394,-
chr14,35871106,2.1618768328445745,775,619,1394,-
chr14,35871684,1.7622628422953883,687,588,1275,-
chr14,35871722,2.621155681017919,751,575,1326,-
chr14,35872974,0.6510674211672624,613,478,1091,-
chr14,36784110,2.271871096189881,2216,1600,3816,-
chr14,36784112,2.271871096189881,2216,1600,3816,-
chr14,36784116,1.5371775417298938,1012,658,1670,-
chr14,36784119,0.6531061022539857,1055,641,1696,-
chr14,36785972,2.4084375,1100,639,1739,-
chr14,36785974,2.4084375,1100,639,1739,-
chr14,36785992,0.4646666666666667,696,374,1070,-
chr14,36785994,0.4646666666666667,696,374,1070,-
chr14,39502128,6.115438596491228,600,474,1074,-
chr14,39502130,6.115438596491228,600,474,1074,-
chr14,39502430,2.214080459770115,669,434,1103,-
chr14,39508282,0.4835291831986946,842,658,1500,-
chr14,39509968,1.6252355308023285,982,688,1670,-
chr14,39514447,0.6079002079002079,601,480,1081,-
chr14,39514460,1.8713840676457498,724,534,1258,-
chr14,39524403,2.027197409735893,1420,1045,2465,-
chr14,39524404,2.287177597641857,756,589,1345,-
chr14,39524484,1.5637820425731195,692,549,1241,-
chr14,39534149,1.6615286961121396,1635,994,2629,-
chr14,39534150,1.4860496793791351,2808,1650,4458,-
chr14,39543641,0.3823232323232323,756,593,1349,-
chr14,39543643,0.3823232323232323,756,593,1349,-
chr14,39545230,2.0111343075852472,577,478,1055,-
chr14,39545258,2.0357374918778426,722,512,1234,-
chr14,39545266,0.3979151280219348,905,698,1603,-
chr14,39545296,2.7714232848725513,827,632,1459,-
chr14,39555104,1.9542064265943602,1024,780,1804,-
chr14,39560731,1.7833033303330332,633,403,1036,-
chr14,45585234,4.565701559020044,573,448,1021,-
chr14,45587251,1.8084227910817505,656,518,1174,-
chr14,45587268,1.7377849278000632,1660,1272,2932,-
chr14,45587274,2.128983499181257,625,466,1091,-
chr14,45590697,1.6170867836427971,2172,1734,3906,-
chr14,45590699,1.6170867836427971,2172,1734,3906,-
chr14,45590738,3.3327014218009476,878,632,1510,-
chr14,45590757,1.7675281167743473,868,596,1464,-
chr14,45603557,1.6093495934959348,748,573,1321,-
chr14,45603603,2.2395173859569217,854,488,1342,-
chr14,45603660,3.015272550774081,1880,714,2594,-
chr14,45603673,5.236882322975038,1027,301,1328,-
chr14,45603675,3.9353291226078393,2363,759,3122,-
chr14,45603679,1.6423417965522942,1277,270,1547,-
chr14,45603680,1.6792986176054883,2971,750,3721,-
chr14,45603681,1.2654618508960223,3581,849,4430,-
chr14,45603683,0.9670195372297866,1245,221,1466,-
chr14,45705024,0.647171516356407,745,502,1247,-
chr14,45706857,1.9228645122136248,1423,1013,2436,-
chr14,45706893,1.4313371616078752,1453,1149,2602,-
chr14,45706898,2.5390625,779,479,1258,-
chr14,45706902,2.708530805687204,761,421,1182,-
chr14,50044529,1.8883039213695347,3178,2140,5318,-
chr14,50044530,1.8883039213695347,3178,2140,5318,-
chr14,50044538,1.768871925360475,1260,785,2045,-
chr14,50044545,1.5448682308462136,1262,781,2043,-
chr14,50044563,2.000473484848485,844,479,1323,-
chr14,50050393,0.6843020367610532,550,609,1159,-
chr14,50052672,1.2267581917745776,21217,14256,35473,-
chr14,50052673,1.194038052509813,14523,11465,25988,-
chr14,50052695,1.3657919925329163,25674,17420,43094,-
chr14,50053026,1.8493727320132562,55960,27925,83885,-
chr14,50053028,1.6889058730944817,60269,29725,89994,-
chr14,50053029,1.6573960797472005,88032,48518,136550,-
chr14,50053091,0.882603871229271,166877,78861,245738,-
chr14,50053093,0.9285378874811393,172715,84645,257360,-
chr14,50053094,0.8565658788345302,61132,28198,89330,-
chr14,50053097,0.3629812063009305,1097,598,1695,-
chr14,50053101,1.511263557986465,1481,937,2418,-
chr14,50053102,1.524295354348014,1629,1057,2686,-
chr14,50053121,1.8143788348615764,932,577,1509,-
chr14,50053128,0.9323450559848603,738,372,1110,-
chr14,50053129,0.7549162671113891,678,467,1145,-
chr14,50053130,0.8084063134298095,1615,963,2578,-
chr14,50053131,0.6744554112770553,1397,878,2275,-
chr14,50085533,0.7394090343031813,2511,1814,4325,-
chr14,50085640,1.7001089663760898,4853,3211,8064,-
chr14,50085641,1.7001089663760898,4853,3211,8064,-
chr14,50085743,1.5760902714242149,2431,2185,4616,-
chr14,50085748,1.780078169716594,2176,1852,4028,-
chr14,50085772,2.13028413028413,1536,1208,2744,-
chr14,50085807,0.614625724503638,1245,953,2198,-
chr14,50085848,1.052687269295884,3064,2103,5167,-
chr14,50085849,1.052687269295884,3064,2103,5167,-
chr14,50085854,1.8743756243756244,789,727,1516,-
chr14,50087307,0.611222828689074,981,707,1688,-
chr14,50087324,1.4663601532567048,597,434,1031,-
chr14,50087325,0.5105658056580565,1338,812,2150,-
chr14,50087326,0.5105658056580565,1338,812,2150,-
chr14,50087338,2.4787015780117434,629,390,1019,-
chr14,50087342,0.4463289703591427,808,410,1218,-
chr14,50117010,1.2609635137523754,686,478,1164,-
chr14,50329312,1.7242267449867903,36414,32453,68867,-
chr14,50329316,1.133620747782056,432268,332301,764569,-
chr14,50329317,1.1344825006698427,445783,344619,790402,-
chr14,50329336,1.0560711710160424,107899,86051,193950,-
chr14,50329341,1.2123821708300573,131533,100863,232396,-
chr14,50329351,1.275933046274171,81031,49320,130351,-
chr14,50329352,1.2490007851612102,129134,82665,211799,-
chr14,50329354,1.2637643496887017,150625,93270,243895,-
chr14,50329355,1.24314495864495,251769,177819,429588,-
chr14,50329356,1.247332262908435,304189,216021,520210,-
chr14,50329357,1.252379223847072,330444,237726,568170,-
chr14,50329358,1.2750519108203167,215909,158350,374259,-
chr14,50329359,1.306538334702339,182741,130189,312930,-
chr14,50329366,1.439853512860734,65211,42684,107895,-
chr14,50329367,1.6001749144578927,29146,15859,45005,-
chr14,50329369,1.3301836240893006,77151,51690,128841,-
chr14,50329370,1.0106624071403076,28653,14169,42822,-
chr14,50329371,1.3575468500441334,49459,37020,86479,-
chr14,50329375,1.1715340052325067,21447,15622,37069,-
chr14,50329385,0.9345285398962067,14406,6746,21152,-
chr14,50329386,1.1891029714239132,33107,21022,54129,-
chr14,50329394,0.9644137208037148,62888,41946,104834,-
chr14,50329395,0.9687455573816455,54909,37515,92424,-
chr14,50329396,1.0335456720697818,71909,46883,118792,-
chr14,50329397,1.0352334140887067,9502,5365,14867,-
chr14,50329398,1.3764107834983534,17834,9352,27186,-
chr14,50329399,1.4933224692406566,25112,13320,38432,-
chr14,50329401,1.1937250192180568,26592,15778,42370,-
chr14,50329403,1.5405070987613227,9457,3952,13409,-
chr14,50329404,1.7613249100800736,10173,4420,14593,-
chr14,50329406,1.7093062765455405,10652,4074,14726,-
chr14,50329407,1.1743687806001724,19712,12243,31955,-
chr14,50329408,1.2678189962919193,21915,12980,34895,-
chr14,50329409,1.8200038175224278,9534,3379,12913,-
chr14,50329410,1.77757986779874,9362,3721,13083,-
chr14,50329412,1.7340028816001356,2406,1310,3716,-
chr14,50329413,1.467762019988728,3389,1382,4771,-
chr14,50329420,1.4016047469515929,2924,867,3791,-
chr14,50329437,0.6843696027633851,4754,1691,6445,-
chr14,50329438,0.6843696027633851,4754,1691,6445,-
chr14,50329566,0.994907576146902,31314,22945,54259,-
chr14,50329567,0.9935196704728642,8546,6427,14973,-
chr14,50575790,2.0861445170388846,668,498,1166,-
chr14,50949122,1.7328898847304928,765,554,1319,-
chr14,51132056,1.7551356666400917,1500,1016,2516,-
chr14,51132058,1.7728714373442185,2190,1456,3646,-
chr14,51132059,1.7185293753354527,1410,913,2323,-
chr14,51132069,2.386904761904762,801,511,1312,-
chr14,51132071,1.4759254281020138,1405,980,2385,-
chr14,51132195,1.4094669320672684,629,466,1095,-
chr14,51371983,20.96365216689034,1267,920,2187,-
chr14,51375663,1.4380636015487802,720,532,1252,-
chr14,51378476,3.006060606060606,575,539,1114,-
chr14,51378905,2.0569223373707306,813,608,1421,-
chr14,51379765,2.7394276396249495,614,501,1115,-
chr14,51382083,1.9425408052410342,886,710,1596,-
chr14,51382086,3.0680882869962622,1217,927,2144,-
chr14,51383384,1.3690367596092354,627,396,1023,-
chr14,51398412,0.5941770647653001,624,494,1118,-
chr14,51404508,2.3768700112493377,1033,698,1731,-
chr14,51404550,1.8191872844504424,698,517,1215,-
chr14,53112942,2.305323785018929,1100,819,1919,-
chr14,53118978,0.5452585405746998,771,548,1319,-
chr14,53119794,2.082124887731025,911,587,1498,-
chr14,53120015,1.7458075904677848,687,411,1098,-
chr14,53120022,1.855921052631579,650,379,1029,-
chr14,53124713,1.99886685552408,671,352,1023,-
chr14,53133110,1.7077134818167479,1257,859,2116,-
chr14,53138571,2.909385696270942,645,426,1071,-
chr14,53150589,1.0136883273164865,878,553,1431,-
chr14,53150590,1.4258870214752568,1285,815,2100,-
chr14,53150592,1.092278719397363,840,530,1370,-
chr14,53244816,8.830757424054118,797,492,1289,-
chr14,53244817,8.319913595840047,978,610,1588,-
chr14,53247425,4.105660631157908,761,518,1279,-
chr14,53248591,2.251054852320675,872,631,1503,-
chr14,53248592,2.1630490405671132,1277,938,2215,-
chr14,53331256,1.8268560707585098,638,532,1170,-
chr14,53331257,0.3643003412969283,1778,1171,2949,-
chr14,53331259,0.3676907213736225,2372,1514,3886,-
chr14,53331270,1.9385026737967916,724,492,1216,-
chr14,53331305,2.4681764935572037,1031,787,1818,-
chr14,53331306,2.4681764935572037,1031,787,1818,-
chr14,53341960,5.427455636420148,628,533,1161,-
chr14,53345341,4.276434661461793,737,573,1310,-
chr14,53345381,3.1016200294550806,818,678,1496,-
chr14,53345382,3.1016200294550806,818,678,1496,-
chr14,53385911,2.158782394076512,655,441,1096,-
chr14,53385912,2.158782394076512,655,441,1096,-
chr14,54893981,1.8538538538538536,925,702,1627,-
chr14,54894550,0.4631404866016369,1270,990,2260,-
chr14,54903092,1.7307053941908712,1163,722,1885,-
chr14,54944269,1.8616600790513835,941,758,1699,-
chr14,54944319,1.772363053613054,838,527,1365,-
chr14,54944515,2.5555808455717264,2313,1459,3772,-
chr14,54944519,1.9056398582744212,3461,1937,5398,-
chr14,54944520,1.7225628320946256,2613,1346,3959,-
chr14,54944523,2.076943893198629,1534,963,2497,-
chr14,54944525,2.076943893198629,1534,963,2497,-
chr14,54944539,1.021527412025403,1911,949,2860,-
chr14,54944543,2.2797894736842106,832,379,1211,-
chr14,54944554,2.9958582666487388,1685,740,2425,-
chr14,54944595,2.5983695652173915,682,344,1026,-
chr14,55625355,2.998091231537751,637,455,1092,-
chr14,55625372,3.131270903010033,748,459,1207,-
chr14,55625374,3.131270903010033,748,459,1207,-
chr14,55647936,4.270926837770709,763,536,1299,-
chr14,55655713,2.7447427654178855,644,418,1062,-
chr14,58878680,2.685483870967742,899,619,1518,-
chr14,58878682,2.685483870967742,899,619,1518,-
chr14,58893804,2.3006609279156343,624,401,1025,-
chr14,60616093,2.90785279629093,668,492,1160,-
chr14,60616095,2.90785279629093,668,492,1160,-
chr14,60616193,1.5535781936422273,691,511,1202,-
chr14,60622781,0.28324982316255076,609,474,1083,-
chr14,61446276,2.0322181518231885,1213,876,2089,-
chr14,61446278,2.0322181518231885,1213,876,2089,-
chr14,64151757,1.726115978306216,992,845,1837,-
chr14,64151761,1.6379585326953747,1105,626,1731,-
chr14,64151768,0.4429621036349574,1184,861,2045,-
chr14,64151769,2.178319623971798,1482,1183,2665,-
chr14,64151771,2.178319623971798,1482,1183,2665,-
chr14,64151772,0.6674402179396629,979,747,1726,-
chr14,64151774,1.9486107973797155,638,465,1103,-
chr14,65542417,15.212926214314603,359,773,1132,-
chr14,67805289,0.9417087036592202,618,542,1160,-
chr14,67805290,0.650058769753167,904,805,1709,-
chr14,67805292,0.27134325004619825,777,674,1451,-
chr14,67819698,3.3695615371593024,621,536,1157,-
chr14,67819700,3.3695615371593024,621,536,1157,-
chr14,67819743,2.008817708638933,808,617,1425,-
chr14,68117950,0.41521292201793925,533,605,1138,-
chr14,68117957,8.000800086850147,548,601,1149,-
chr14,68117960,22.287303371717183,1232,1160,2392,-
chr14,68129227,2.891725921137686,1166,883,2049,-
chr14,68129236,1.8453802803515318,1908,1235,3143,-
chr14,68129241,0.6562148707242653,1400,957,2357,-
chr14,68129243,1.5774349667271628,744,521,1265,-
chr14,68129245,1.6635506003430531,1140,635,1775,-
chr14,68129246,1.6635506003430531,1140,635,1775,-
chr14,68129248,1.7068212161670104,1124,748,1872,-
chr14,68129250,2.016873900020418,2087,1318,3405,-
chr14,68129251,1.893608132572065,1045,667,1712,-
chr14,68141134,2.427984585624297,712,394,1106,-
chr14,68141141,1.5300104493884665,702,456,1158,-
chr14,68143951,2.260026298487837,624,506,1130,-
chr14,68144027,1.4703560432620195,1489,955,2444,-
chr14,68144066,1.0518299132642268,677,488,1165,-
chr14,68144068,1.0518299132642268,677,488,1165,-
chr14,68144069,1.1652787926352919,1002,693,1695,-
chr14,68144227,3.7503386004514674,638,442,1080,-
chr14,68144376,1.96059493915395,1159,667,1826,-
chr14,68144434,1.900319829424307,574,468,1042,-
chr14,68144437,3.512094102054341,730,502,1232,-
chr14,68144518,0.6368382448116667,819,538,1357,-
chr14,68144609,1.9174291938997823,676,458,1134,-
chr14,68144752,2.311273021655535,1141,731,1872,-
chr14,68144894,1.0758802431005219,1970,1420,3390,-
chr14,68144988,0.24624999999999997,590,479,1069,-
chr14,68144997,0.6247508967716222,854,578,1432,-
chr14,68145042,2.041158432708688,880,586,1466,-
chr14,68151748,0.5778824833702882,833,655,1488,-
chr14,68151789,4.1982836495031615,714,491,1205,-
chr14,68151830,1.538125,748,559,1307,-
chr14,68151852,1.8329129886506936,611,487,1098,-
chr14,68151874,2.7610125858123573,584,436,1020,-
chr14,68156932,0.5143410555981063,1416,1038,2454,-
chr14,68156967,2.0084721004966406,624,488,1112,-
chr14,68157011,3.0818181818181816,564,439,1003,-
chr14,68157055,2.123812351543943,621,420,1041,-
chr14,68157103,4.144628099173554,589,483,1072,-
chr14,68157109,0.5810833567218636,646,508,1154,-
chr14,68157957,2.0531969309462914,1337,1034,2371,-
chr14,68157959,2.0531969309462914,1337,1034,2371,-
chr14,68159194,0.4820157189089227,801,514,1315,-
chr14,68159744,0.48623463853756216,975,787,1762,-
chr14,68162352,1.1389211833376494,1012,741,1753,-
chr14,68162414,2.0634483251460156,730,605,1335,-
chr14,68162447,1.9729943266517205,1159,645,1804,-
chr14,68162449,2.383677795442501,691,332,1023,-
chr14,69341117,0.6375772066148635,639,477,1116,-
chr14,69341127,9.183240825262642,3042,2622,5664,-
chr14,69341129,9.183240825262642,3042,2622,5664,-
chr14,69341318,2.0264092373354003,1003,686,1689,-
chr14,69341426,1.5752800208687103,625,424,1049,-
chr14,69341727,1.4950147830771352,581,505,1086,-
chr14,69347683,1.9220844518061337,2883,1834,4717,-
chr14,69349182,1.5971214693625562,1532,835,2367,-
chr14,69349230,1.1593468776200226,1558,716,2274,-
chr14,69349243,0.960756722951845,1228,532,1760,-
chr14,69349244,0.960756722951845,1228,532,1760,-
chr14,69349253,2.89014830369579,1579,820,2399,-
chr14,69349255,3.2093533065400073,1097,594,1691,-
chr14,69349654,2.3745173745173744,819,517,1336,-
chr14,69349676,2.645208845208845,768,406,1174,-
chr14,69349677,2.284155211172649,1295,743,2038,-
chr14,69349695,3.310895947846364,673,374,1047,-
chr14,69352288,2.836583539892466,702,440,1142,-
chr14,69369243,2.216022008007861,981,614,1595,-
chr14,69387766,2.5884765625,913,511,1424,-
chr14,69387767,2.5884765625,913,511,1424,-
chr14,69392388,1.794227605802303,856,742,1598,-
chr14,69445673,0.4677884615384615,972,779,1751,-
chr14,69445674,1.59468728565193,672,552,1224,-
chr14,69445675,0.4677884615384615,972,779,1751,-
chr14,69847020,1.5460219581892016,1334,1089,2423,-
chr14,69847048,1.5083774597428488,2937,2036,4973,-
chr14,69847171,0.5303071501168147,2308,2764,5072,-
chr14,69847220,25.041456558252364,17911,16974,34885,-
chr14,69847221,25.041456558252367,17911,16974,34885,-
chr14,69847222,25.64156194482904,23740,17812,41552,-
chr14,69847224,7.2729773932364825,21942,3112,25054,-
chr14,69847225,7.957073732599357,17227,2309,19536,-
chr14,69847226,7.769728672241638,14539,1916,16455,-
chr14,69847227,14.555498721227622,3556,424,3980,-
chr14,69847229,9.83641695547854,4985,604,5589,-
chr14,69847230,9.83641695547854,4985,604,5589,-
chr14,69847231,8.643897014281624,9967,1302,11269,-
chr14,69847233,6.994189519557369,7845,1065,8910,-
chr14,69847294,0.7013283107574786,4023,2639,6662,-
chr14,69847346,1.3805051813471505,1714,1350,3064,-
chr14,69861559,1.1476036990499423,4005,3054,7059,-
chr14,69864960,1.5500969618616678,2397,1393,3790,-
chr14,69865005,0.5600857431023918,8378,5673,14051,-
chr14,69865006,0.5222349743279976,3231,1891,5122,-
chr14,69865010,0.9508126588828275,2458,1657,4115,-
chr14,70809441,1.8172990063233967,618,491,1109,-
chr14,70826269,2.9742460306840637,1156,819,1975,-
chr14,70826303,0.6066017316017316,648,461,1109,-
chr14,70826355,1.2429740745863256,926,775,1701,-
chr14,70826399,0.34010720494747115,816,531,1347,-
chr14,70833495,2.2434449377103287,963,599,1562,-
chr14,70833548,2.383740071933814,639,455,1094,-
chr14,71059655,2.2215100103649554,1789,1593,3382,-
chr14,71059682,0.7091395169695048,1564,1521,3085,-
chr14,71060025,1.2269928985889393,1605,1327,2932,-
chr14,71060040,2.33511811023622,673,634,1307,-
chr14,73742913,1.757235111217412,4897,3502,8399,-
chr14,73742914,1.757235111217412,4897,3502,8399,-
chr14,73742915,1.757235111217412,4897,3502,8399,-
chr14,73742933,1.9311111111111112,1263,799,2062,-
chr14,73742937,1.9549931287219424,1190,707,1897,-
chr14,73742954,1.1382910032319138,2207,1488,3695,-
chr14,73742956,1.7986651835372638,832,526,1358,-
chr14,73742974,1.4444692239072257,634,379,1013,-
chr14,73742986,1.1981819856392626,1284,809,2093,-
chr14,73742993,3.331019522776573,697,460,1157,-
chr14,74946977,1.4895552700294277,1260,1048,2308,-
chr14,74946979,1.8015318015318011,1081,727,1808,-
chr14,74947420,1.7166353578789508,3031,2252,5283,-
chr14,74951234,2.310761047463175,752,610,1362,-
chr14,74951278,1.476190476190476,929,853,1782,-
chr14,74953064,4.431451612903225,627,495,1122,-
chr14,74959907,2.591269841269841,652,377,1029,-
chr14,74959958,1.8438417385126193,1195,783,1978,-
chr14,74960007,0.9711292093704249,848,682,1530,-
chr14,74960008,0.7713934386624377,1709,1188,2897,-
chr14,74960009,0.5478413324567171,861,506,1367,-
chr14,74960010,0.539596402400075,1081,670,1751,-
chr14,75520229,2.4122294471676704,697,468,1165,-
chr14,75572656,0.276534212046706,592,433,1025,-
chr14,75583918,1.3077519607804198,1108,706,1814,-
chr14,75583955,1.3525531535080981,752,451,1203,-
chr14,75598740,1.361936845138762,678,415,1093,-
chr14,75600671,1.9869025306496606,682,506,1188,-
chr14,75601393,1.5179853229119502,1864,1299,3163,-
chr14,75601457,1.7771203155818538,741,545,1286,-
chr14,75601468,0.6450472667488696,1120,810,1930,-
chr14,75601504,1.4823032223983097,1097,630,1727,-
chr14,75601544,1.6826772883473913,694,581,1275,-
chr14,75601704,1.7614929094592489,961,712,1673,-
chr14,75614376,2.3673392062138867,780,620,1400,-
chr14,75614381,1.7899285358151902,717,546,1263,-
chr14,75614412,1.565506742061766,1160,1044,2204,-
chr14,75618825,0.613611525086935,771,670,1441,-
chr14,75643100,0.6162532768703368,763,550,1313,-
chr14,75643107,1.8718181818181816,780,549,1329,-
chr14,75643141,2.199275362318841,606,413,1019,-
chr14,75643169,1.9015481373971936,1122,847,1969,-
chr14,75643170,1.9015481373971936,1122,847,1969,-
chr14,75643171,0.581512522427311,909,666,1575,-
chr14,75643174,1.634064757827134,1061,807,1868,-
chr14,75643220,1.6654977070407337,1028,673,1701,-
chr14,75643261,1.8351799264112567,1193,823,2016,-
chr14,76117661,3.0519991015274037,1086,847,1933,-
chr14,76117662,3.0519991015274037,1086,847,1933,-
chr14,76117663,3.0519991015274037,1086,847,1933,-
chr14,76117726,1.4736414524170378,675,500,1175,-
chr14,77804925,1.2435998372268535,619,393,1012,-
chr14,78184321,2.0495409590442284,853,610,1463,-
chr14,78184354,2.4231640813579527,714,435,1149,-
chr14,78184487,2.539078156312625,723,498,1221,-
chr14,78184521,0.6083409809319874,627,466,1093,-
chr14,78189575,3.9056216843160443,587,466,1053,-
chr14,78198887,1.4075250836120403,2214,1494,3708,-
chr14,78198904,1.500675839600735,1697,945,2642,-
chr14,78198910,1.3820641625756365,1561,921,2482,-
chr14,78198925,1.8856150437178103,2421,1264,3685,-
chr14,78198927,1.7747608167462754,6042,3246,9288,-
chr14,78198929,1.909191763340457,6589,3594,10183,-
chr14,78198931,2.082813044293791,2252,1113,3365,-
chr14,78198936,2.357207035257223,2564,1414,3978,-
chr14,78201301,0.40754320929506505,1543,760,2303,-
chr14,78202281,1.1565637188197098,1099,681,1780,-
chr14,78217752,3.1915236051502145,660,465,1125,-
chr14,78217753,3.1915236051502145,660,465,1125,-
chr14,90397918,1.7322834339364732,742,422,1164,-
chr14,91925189,2.2046235201011957,1010,889,1899,-
chr14,91929094,2.0747869709853592,2139,1677,3816,-
chr14,91929095,2.0747869709853592,2139,1677,3816,-
chr14,91929096,2.0747869709853592,2139,1677,3816,-
chr14,91929098,3.0692132468897846,603,438,1041,-
chr14,92253872,0.9219878365741517,1697,1173,2870,-
chr14,92253880,1.0515094544491512,572,460,1032,-
chr14,92583845,1.6388999126914836,1353,1171,2524,-
chr14,92583969,1.5751513556199002,879,654,1533,-
chr14,92583976,2.585647897979034,824,486,1310,-
chr14,92588019,1.7758405977584053,743,437,1180,-
chr14,92588029,1.1541063849329283,1290,667,1957,-
chr14,92588036,0.7416720785309674,1310,696,2006,-
chr14,93180760,3.8803508944769485,600,448,1048,-
chr14,93407084,2.230829596412556,736,445,1181,-
chr14,93407091,1.747709938801404,660,491,1151,-
chr14,93407119,3.1737037037037035,778,359,1137,-
chr14,94517803,2.728401191658392,941,635,1576,-
chr14,94517804,2.728401191658392,941,635,1576,-
chr14,94521361,1.7251415872105529,751,480,1231,-
chr14,94521411,2.8339608812559636,1122,830,1952,-
chr14,94526944,2.759108575522714,688,445,1133,-
chr14,94527296,1.3041120570434774,1003,817,1820,-
chr14,94527297,0.8580237397872669,505,498,1003,-
chr14,94528480,3.8950217522814157,620,389,1009,-
chr14,94528958,2.3312883435582825,721,488,1209,-
chr14,94528959,2.8883205456095484,1077,713,1790,-
chr14,94528961,3.3071960297766747,713,464,1177,-
chr14,94545400,0.8386265561596488,914,715,1629,-
chr14,94545565,2.580718469224274,759,541,1300,-
chr14,94545609,2.36005400601586,717,502,1219,-
chr14,94545862,1.8809041835357623,668,467,1135,-
chr14,94546090,0.9242063492063493,547,503,1050,-
chr14,94546091,0.9242063492063493,547,503,1050,-
chr14,94547547,0.736738828042103,788,440,1228,-
chr14,99439202,1.5253324051514097,1973,1689,3662,-
chr14,99439203,1.5253324051514097,1973,1689,3662,-
chr14,99439204,1.400379644295059,2412,1605,4017,-
chr14,99439216,2.149546204620462,612,605,1217,-
chr14,99439218,1.8363273453093814,1279,1001,2280,-
chr14,99439219,1.8363273453093814,1279,1001,2280,-
chr14,99439227,1.017051641643293,2541,1671,4212,-
chr14,99439228,1.017051641643293,2541,1671,4212,-
chr14,99439246,1.3033150798401785,595,502,1097,-
chr14,99439248,1.468739926367045,3128,2182,5310,-
chr14,99439250,1.5010544561606238,4426,3058,7484,-
chr14,99439252,1.4551052523547792,2773,1882,4655,-
chr14,100800534,2.0567685589519646,627,457,1084,-
chr14,100800667,1.6056938211160976,1287,1025,2312,-
chr14,100800855,0.5997938409998712,734,596,1330,-
chr14,100800858,2.777777777777778,924,591,1515,-
chr14,100800898,2.21517022154776,1142,801,1943,-
chr14,100801253,2.056761268781302,1000,598,1598,-
chr14,100801260,2.687127024722933,787,620,1407,-
chr14,100801263,2.1104688503532434,635,518,1153,-
chr14,100801298,0.6081477816262576,837,644,1481,-
chr14,100801305,1.6478873239436622,809,638,1447,-
chr14,100803408,1.5498085063495264,1038,604,1642,-
chr14,100803535,0.9818208830242704,2169,1396,3565,-
chr14,100803536,1.2260922656180717,3094,1993,5087,-
chr14,100808747,0.6529696407571628,1752,1532,3284,-
chr14,100808751,0.4473324213406293,653,515,1168,-
chr14,100808796,1.5491368286445015,1030,919,1949,-
chr14,100808801,1.80256351216517,1893,1514,3407,-
chr14,100808802,0.3824779339653481,779,664,1443,-
chr14,100808803,1.80256351216517,1893,1514,3407,-
chr14,100808805,2.639957264957265,705,623,1328,-
chr14,100808831,1.7489481065918653,811,643,1454,-
chr14,100808859,3.5369991225504536,833,525,1358,-
chr14,100808863,2.063492063492064,689,482,1171,-
chr14,100808895,0.46331817704330946,1675,1255,2930,-
chr14,100809633,1.662915548213917,825,667,1492,-
chr14,100813129,2.5918874560375147,1127,852,1979,-
chr14,100813163,1.6978823529411766,1311,849,2160,-
chr14,100820131,2.0901147626499736,1033,567,1600,-
chr14,100820152,1.770967741935484,731,619,1350,-
chr14,100820851,0.606826677159158,1193,883,2076,-
chr14,100820859,2.0177893738140416,1085,815,1900,-
chr14,100828146,1.6326264274061992,833,612,1445,-
chr14,100828219,1.508579272477694,1098,650,1748,-
chr14,100835542,0.582441113490364,655,466,1121,-
chr14,100835577,0.9258236402383676,2539,1890,4429,-
chr14,100835578,0.7888427144753161,1647,1120,2767,-
chr14,100835579,0.7888427144753161,1647,1120,2767,-
chr14,100841802,0.834255438859715,658,495,1153,-
chr14,100841804,0.7368610143471164,916,661,1577,-
chr14,100841809,0.42697460951957955,720,512,1232,-
chr14,100841811,0.8565494799998237,1242,914,2156,-
chr14,100841812,1.1064575349398345,991,797,1788,-
chr14,102547663,1.6239867564790507,2942,2304,5246,-
chr14,102547726,1.5797722604042503,5369,4584,9953,-
chr14,102547859,0.8789546188786205,14249,10314,24563,-
chr14,102547865,1.5233469771901942,5417,5042,10459,-
chr14,102547884,1.4049515820290506,7393,5991,13384,-
chr14,102547885,1.364944260643528,14842,10889,25731,-
chr14,102547946,1.749757090518236,7899,6339,14238,-
chr14,102547951,1.4612004037580557,2067,1589,3656,-
chr14,102548593,0.7083684108086421,12664,9079,21743,-
chr14,102548629,1.4755210070656166,6830,4762,11592,-
chr14,102550154,1.6422389387689071,23643,16483,40126,-
chr14,102550162,0.8692864099780097,42617,24567,67184,-
chr14,102550163,0.9163199995012239,64269,45127,109396,-
chr14,102550180,1.177816718153908,31399,18874,50273,-
chr14,102550192,1.78729248377363,13875,8853,22728,-
chr14,102550216,0.802337895832179,8406,5035,13441,-
chr14,102550241,1.8618836751492265,27579,15813,43392,-
chr14,102550275,1.5754817346436694,3760,2592,6352,-
chr14,102550283,1.816893856791943,5933,3778,9711,-
chr14,102550285,1.2707279245291034,14302,8500,22802,-
chr14,102550301,1.7277490889884446,5544,3248,8792,-
chr14,102550798,1.954330773337714,2771,1872,4643,-
chr14,102551138,1.3856476108100646,5826,3722,9548,-
chr14,102551643,1.5325109480854175,27400,18138,45538,-
chr14,102551725,1.3892227099462142,3778,2752,6530,-
chr14,102551734,1.009687937332342,11597,7211,18808,-
chr14,102551740,1.2654452301054648,3043,2085,5128,-
chr14,102551743,0.9293221898537106,18768,11421,30189,-
chr14,102551745,0.8055333206276605,18721,11447,30168,-
chr14,102551746,0.9265823473950869,16995,10895,27890,-
chr14,102551747,1.2533445595207484,10320,6766,17086,-
chr14,102552235,1.2351623542523555,7892,5200,13092,-
chr14,102552237,1.107838316174905,10721,7597,18318,-
chr14,102552263,1.5971946411813338,3850,2221,6071,-
chr14,102552428,1.2040176241016636,13853,9016,22869,-
chr14,102552436,1.5130529847510978,6959,5564,12523,-
chr14,102552440,1.567049238531253,12380,9624,22004,-
chr14,102552441,1.567049238531253,12380,9624,22004,-
chr14,102552452,1.0519606086991597,33182,23524,56706,-
chr14,102552453,0.8867684613465142,23037,17122,40159,-
chr14,102552456,1.553402083918516,4941,3691,8632,-
chr14,102552692,1.3510908612985193,2055,1129,3184,-
chr14,102552698,1.3187473147286146,6598,3448,10046,-
chr14,102552705,1.638888888888889,1847,1007,2854,-
chr14,102553380,0.9632602643765511,11711,5266,16977,-
chr14,103434844,1.3848192012756697,550,532,1082,-
chr14,103986138,1.540142276422764,1298,737,2035,-
chr14,103986161,0.45839365538950017,992,749,1741,-
chr14,103986204,1.565126050420168,744,407,1151,-
chr14,103986349,3.35312057056794,2027,1411,3438,-
chr14,103986472,1.5611745513866229,1101,612,1713,-
chr14,103986645,2.497736220472441,768,634,1402,-
chr14,103986846,1.4970291336570407,1142,727,1869,-
chr14,103986866,1.814926372155288,747,497,1244,-
chr14,103986918,0.6342703349282297,706,531,1237,-
chr14,103986919,1.5187978927203063,589,463,1052,-
chr14,103986920,1.002764713984927,1922,1141,3063,-
chr14,103986921,1.002764713984927,1922,1141,3063,-
chr14,103987735,2.3489792198323003,780,421,1201,-
chr14,103988272,1.2923303053479318,851,605,1456,-
chr14,103988465,2.294612300772465,756,486,1242,-
chr14,104378972,1.1018099774623105,66432,43116,109548,-
chr14,104378973,1.229931612821503,101940,64399,166339,-
chr14,104378974,1.187684107871038,138292,85748,224040,-
chr14,104378975,1.241918658401324,126219,77182,203401,-
chr14,104378976,1.218181071849743,109360,66318,175678,-
chr14,104378977,1.309962927264245,77967,47325,125292,-
chr14,104378978,1.8452386622889767,21645,15292,36937,-
chr14,104378979,1.835898791244505,16855,11610,28465,-
chr14,104378980,1.968306079724168,12363,8346,20709,-
chr14,104378984,1.6754832655101897,7197,4280,11477,-
chr14,104378985,1.6754832655101897,7197,4280,11477,-
chr14,104379031,0.7995664040891983,533,538,1071,-
chr14,104379032,0.7995664040891983,533,538,1071,-
chr14,104381448,1.6264979029358897,2412,1668,4080,-
chr14,104381470,1.8455709070745345,1996,1272,3268,-
chr14,104387845,0.7538147129797851,3287,2504,5791,-
chr14,104387846,0.6864496496745437,1750,1312,3062,-
chr14,104387862,0.5181209499222068,1130,997,2127,-
chr14,104387864,0.8273524785091965,2367,2252,4619,-
chr14,104387865,0.9049179627141467,1332,1294,2626,-
chr14,105235810,3.878731343283582,755,401,1156,-
chr14,105236075,2.9640742870649914,1083,1224,2307,-
chr14,105236088,4.241057764962405,1088,950,2038,-
chr14,105236090,3.715318114133287,633,507,1140,-
chr14,105236094,19.458141117414083,690,476,1166,-
chr14,105239335,2.4735876538504256,584,590,1174,-
chr14,105239337,2.9549702022317677,621,618,1239,-
chr14,105239627,2.505881608335254,638,442,1080,-
chr14,105476562,1.6766118809689652,559,446,1005,-
chr14,105476774,1.935483870967742,1409,650,2059,-
chr14,105476775,1.935483870967742,1409,650,2059,-
chr14,105476780,0.4857594936708861,920,473,1393,-
chr14,105476784,0.5840896358543418,801,424,1225,-
chr14,106444601,1.4950944975181397,2016,1371,3387,-
chr15,23006281,2.039473684210526,619,398,1017,-
chr15,23006501,2.445565960080233,1014,598,1612,-
chr15,23006595,1.0866228009184173,962,682,1644,-
chr15,23006607,2.069983165951069,717,526,1243,-
chr15,23006629,5.101382488479263,655,433,1088,-
chr15,23006630,5.101382488479263,655,433,1088,-
chr15,23006809,2.089591681025578,853,688,1541,-
chr15,25584381,2.0819898664210044,903,667,1570,-
chr15,25584387,1.4118698668932312,1504,1055,2559,-
chr15,25584388,1.249496733978268,2951,1964,4915,-
chr15,25584390,1.4825396825396826,1400,944,2344,-
chr15,25584396,1.7022493161821084,2055,1275,3330,-
chr15,25584397,1.6258667044007358,1531,954,2485,-
chr15,25585336,0.6886715068432652,1090,681,1771,-
chr15,25585337,0.6886715068432652,1090,681,1771,-
chr15,25599567,2.2441966344200766,691,518,1209,-
chr15,25616186,2.064540719095413,624,462,1086,-
chr15,25654283,1.6080944524108323,565,443,1008,-
chr15,25683686,5.1838122430128335,549,566,1115,-
chr15,25683687,4.788337620348155,588,853,1441,-
chr15,32810314,1.5999999999999999,747,769,1516,-
chr15,32810323,2.299472338148289,1012,778,1790,-
chr15,32810378,1.9996465650541193,741,502,1243,-
chr15,32810379,2.0865566565898335,949,606,1555,-
chr15,34376447,2.2150037792894937,1246,755,2001,-
chr15,34376479,1.6350563430375484,1664,1170,2834,-
chr15,34376507,2.203994866035617,784,541,1325,-
chr15,34376545,1.806247806247806,663,517,1180,-
chr15,34393824,1.1235667402315404,1654,1284,2938,-
chr15,34393825,0.3976039320090108,705,513,1218,-
chr15,34393871,1.1399807731991538,29494,20416,49910,-
chr15,34393872,1.1912069247321102,32298,22724,55022,-
chr15,34393873,1.4007167327228278,38152,28219,66371,-
chr15,34393874,1.6524093650588683,20109,16686,36795,-
chr15,34393884,0.6306291588496103,3700,3011,6711,-
chr15,34393887,0.5953785461720549,5520,4813,10333,-
chr15,34393892,3.7330767997434666,2175,1385,3560,-
chr15,34393893,5.350889633897284,4702,4213,8915,-
chr15,34393903,0.605481162069191,10078,7803,17881,-
chr15,34393904,0.6193124270267786,10798,7906,18704,-
chr15,34393906,0.628438970094086,3234,1983,5217,-
chr15,34393914,0.7444059001732044,3020,2516,5536,-
chr15,34393920,2.6409158762136,2995,2589,5584,-
chr15,34393924,28.19564579976549,12937,9094,22031,-
chr15,34393925,28.195645799765497,12937,9094,22031,-
chr15,34393926,28.19564579976549,12937,9094,22031,-
chr15,34393931,20.9071703461198,8281,2775,11056,-
chr15,34393932,20.9071703461198,8281,2775,11056,-
chr15,34393935,5.731452455590387,1096,260,1356,-
chr15,34393941,2.895384615384616,940,259,1199,-
chr15,34393943,3.012232805615823,3423,854,4277,-
chr15,34393978,0.4643756971298296,2953,1197,4150,-
chr15,34393981,0.5772985781990521,936,421,1357,-
chr15,34394019,1.2699111782813806,755,529,1284,-
chr15,34394021,1.8050872817955117,695,400,1095,-
chr15,34394024,3.2698412698412698,720,503,1223,-
chr15,34394026,3.2698412698412698,720,503,1223,-
chr15,34634252,2.5114942528735638,873,695,1568,-
chr15,34634288,2.254032258064516,988,735,1723,-
chr15,34634289,1.4117305833064775,1340,1069,2409,-
chr15,34635284,1.5283604570887863,2877,1630,4507,-
chr15,34635285,1.5335845497348874,5004,3203,8207,-
chr15,34635301,0.6885428511754195,1379,1050,2429,-
chr15,34635303,1.5425191815856778,964,475,1439,-
chr15,34635327,0.6271666756311058,2028,1646,3674,-
chr15,34635358,1.0072867342429503,2095,1782,3877,-
chr15,34635359,1.0658668675421574,2243,1901,4144,-
chr15,34635360,1.0215655685050933,703,640,1343,-
chr15,34652390,2.377961857060297,1542,1073,2615,-
chr15,34652391,1.9709922434958747,1955,1344,3299,-
chr15,34653642,1.7086820083682006,593,477,1070,-
chr15,34653643,1.7086820083682006,593,477,1070,-
chr15,35271842,7.3956843892285375,593,508,1101,-
chr15,35271843,6.175839826445684,775,780,1555,-
chr15,35271844,4.560850728114001,533,563,1096,-
chr15,40328534,0.2884760403098649,2103,1508,3611,-
chr15,40328560,1.3640469171423195,1976,1191,3167,-
chr15,40328569,1.456367924528302,1044,847,1891,-
chr15,40328581,2.095070995328949,1430,1162,2592,-
chr15,40328634,1.665940450254176,1146,917,2063,-
chr15,40329190,0.7657315203709013,2559,1956,4515,-
chr15,40330567,1.626493921285803,4655,3375,8030,-
chr15,40330568,1.2500871365476638,8517,5824,14341,-
chr15,40331093,1.385911330049261,1562,1224,2786,-
chr15,40331337,1.900359421486182,1453,818,2271,-
chr15,40331338,1.7712177121771218,2374,1354,3728,-
chr15,40331339,1.8201059971981046,3827,2172,5999,-
chr15,40331347,1.4375795441397663,993,515,1508,-
chr15,40331350,2.440097259062776,1161,695,1856,-
chr15,40331351,1.716067761213912,2416,1578,3994,-
chr15,40331352,1.716067761213912,2416,1578,3994,-
chr15,40331361,0.7473539378474856,2160,1236,3396,-
chr15,40331362,0.8678278868248873,852,612,1464,-
chr15,40331363,0.7081871616755337,889,472,1361,-
chr15,41028328,2.750987443657711,672,477,1149,-
chr15,41028678,16.726648174193215,1597,1093,2690,-
chr15,41164491,5.048271900625574,602,524,1126,-
chr15,41164626,3.5139632853789298,567,562,1129,-
chr15,41164639,6.208679613453789,602,408,1010,-
chr15,41164844,1.8944688031007137,4489,3643,8132,-
chr15,41164845,2.5768564338262285,1856,1660,3516,-
chr15,41164852,3.209358687546607,1564,1191,2755,-
chr15,41164854,3.209358687546607,1564,1191,2755,-
chr15,41164865,2.1562046327407076,1411,953,2364,-
chr15,41164890,0.5901935606601038,729,488,1217,-
chr15,41601916,1.5419816577154695,661,475,1136,-
chr15,41605515,4.054090876275061,822,802,1624,-
chr15,41605525,0.849537037037037,733,512,1245,-
chr15,41605527,1.5858619714347897,1065,801,1866,-
chr15,42451365,0.5199684115523465,837,553,1390,-
chr15,42451377,1.5988287072467875,1888,1217,3105,-
chr15,42451404,2.3457402073772595,601,424,1025,-
chr15,42451411,3.717039648334008,600,414,1014,-
chr15,42454547,4.436898749114939,697,418,1115,-
chr15,42454549,3.5978936929836283,711,397,1108,-
chr15,44097651,3.277472628171729,649,455,1104,-
chr15,44105261,1.5244019138755978,1592,1120,2712,-
chr15,44105280,2.8595573440643864,1937,1064,3001,-
chr15,44105282,2.8595573440643864,1937,1064,3001,-
chr15,44105296,2.415183169045167,1538,970,2508,-
chr15,44105459,2.280451127819549,1010,664,1674,-
chr15,44105485,1.8799082142109205,961,642,1603,-
chr15,44105486,0.5626868296113944,1279,725,2004,-
chr15,44105488,1.921717171717172,760,485,1245,-
chr15,44105492,2.079195535026944,696,432,1128,-
chr15,45490801,2.0887909319899247,641,396,1037,-
chr15,45492609,1.2716480920175823,585,615,1200,-
chr15,45492624,0.7421596244131455,607,425,1032,-
chr15,49054746,2.4653846153846155,640,675,1315,-
chr15,49054748,2.4653846153846155,640,675,1315,-
chr15,49054754,2.961078809043779,529,495,1024,-
chr15,49419754,2.558219178082192,746,583,1329,-
chr15,49420237,1.716261121234859,592,490,1082,-
chr15,49426265,0.59209874318663,1271,842,2113,-
chr15,49426693,2.9792,930,624,1554,-
chr15,49437217,1.9326622971285892,798,533,1331,-
chr15,50578281,1.6938991531947654,606,432,1038,-
chr15,50578294,2.1954190165092258,722,483,1205,-
chr15,50601960,3.8240610564370354,679,382,1061,-
chr15,51829872,1.7232447394688155,935,587,1522,-
chr15,52230417,2.13239886668538,597,496,1093,-
chr15,52258038,1.0874890911357686,942,616,1558,-
chr15,52258039,1.0874890911357686,942,616,1558,-
chr15,52258463,1.5182260371959944,1233,698,1931,-
chr15,52258469,1.8411343612334805,742,453,1195,-
chr15,52258513,0.4023357664233576,847,547,1394,-
chr15,52258515,0.7194623027469316,1230,811,2041,-
chr15,52258516,0.922842401500938,786,532,1318,-
chr15,52258528,1.7844101123595504,725,355,1080,-
chr15,52839849,2.0585856890297505,718,461,1179,-
chr15,52841953,3.0877697841726617,811,694,1505,-
chr15,52841956,2.4422844908154766,1528,1200,2728,-
chr15,52841957,2.4422844908154766,1528,1200,2728,-
chr15,52841964,3.5974842767295594,659,476,1135,-
chr15,52841968,2.062382797849732,610,420,1030,-
chr15,52841971,2.1975472323500167,764,430,1194,-
chr15,52844062,1.568717477808387,999,725,1724,-
chr15,52844147,2.3092779764751317,712,515,1227,-
chr15,52849368,1.2720518094074218,1243,928,2171,-
chr15,52849398,2.4785987211366725,1183,897,2080,-
chr15,52861120,2.884929194908453,608,407,1015,-
chr15,55473649,1.3804341408694625,2191,1707,3898,-
chr15,55473809,1.599711885587337,1462,1107,2569,-
chr15,55473810,1.4105693081635702,1887,1180,3067,-
chr15,55473836,1.550783334141728,1420,777,2197,-
chr15,55474342,1.3467558553778518,1845,1335,3180,-
chr15,55475531,1.5698170731707315,2709,1599,4308,-
chr15,55477598,1.6920657594868436,13662,11127,24789,-
chr15,55483202,1.0890707534146078,7920,5380,13300,-
chr15,55483212,1.3655569485962415,7077,4734,11811,-
chr15,55483216,0.6689887640449438,2976,1779,4755,-
chr15,55485009,1.6915052160953803,1815,1341,3156,-
chr15,55489047,1.5167145970591462,3281,2771,6052,-
chr15,55489071,1.5138021628887397,1876,1258,3134,-
chr15,55489087,1.6402,1528,1099,2627,-
chr15,55489115,1.8501514798415288,933,612,1545,-
chr15,55489120,1.782962962962963,746,485,1231,-
chr15,55489128,1.0176672115363086,987,628,1615,-
chr15,55489130,1.1816464464128291,1361,860,2221,-
chr15,55489132,1.575873148140729,1489,910,2399,-
chr15,55489133,1.7539172120342978,1798,1179,2977,-
chr15,55489134,1.6278688524590164,1323,759,2082,-
chr15,55489135,1.602961432506887,949,527,1476,-
chr15,55651327,1.9024472008045592,680,470,1150,-
chr15,55651418,1.316171637574354,8745,4833,13578,-
chr15,55651420,1.356283392934317,5362,2952,8314,-
chr15,55651424,1.392077707913814,5082,2668,7750,-
chr15,55651429,1.371391878669276,2274,1167,3441,-
chr15,55651443,1.7099013518450858,1559,781,2340,-
chr15,55651589,1.6989234931782855,951,598,1549,-
chr15,55651688,1.59764786676968,1005,705,1710,-
chr15,55651724,1.4999534110294013,8426,4967,13393,-
chr15,55651741,1.3121441351294028,4730,3051,7781,-
chr15,55651775,1.5161960640508494,3543,1817,5360,-
chr15,55652037,3.1122495654560427,971,642,1613,-
chr15,55652236,1.0513343533201096,1589,1143,2732,-
chr15,55652303,3.118884540117417,749,583,1332,-
chr15,55652334,1.8631379962192816,769,574,1343,-
chr15,55652690,0.5856851491723188,1028,726,1754,-
chr15,55652702,2.085167958656331,916,773,1689,-
chr15,55653124,3.0382466695315857,706,536,1242,-
chr15,55664108,2.430684699915469,638,506,1144,-
chr15,55664131,1.686290322580645,860,559,1419,-
chr15,55664192,1.5708171206225678,733,513,1246,-
chr15,55669306,2.124745158002039,666,435,1101,-
chr15,55670542,2.6202531645569622,1011,631,1642,-
chr15,55670543,2.023155139434209,627,472,1099,-
chr15,55681598,1.8700488175520364,1089,784,1873,-
chr15,55681612,2.346357953676273,800,585,1385,-
chr15,55681628,4.604717563232227,864,543,1407,-
chr15,55837256,1.8475308785213262,752,625,1377,-
chr15,55837258,2.272189349112426,575,506,1081,-
chr15,56166188,3.4337957124842373,777,609,1386,-
chr15,56166202,1.655813953488372,711,429,1140,-
chr15,58919946,0.8466359174303297,659,432,1091,-
chr15,59171880,2.3225806451612905,575,433,1008,-
chr15,59171882,2.3225806451612905,575,433,1008,-
chr15,59179705,3.0350877192982453,691,443,1134,-
chr15,59179706,3.0350877192982453,691,443,1134,-
chr15,59179707,2.975862183586033,894,617,1511,-
chr15,59186302,3.352874346739377,526,488,1014,-
chr15,59186337,2.3584229390681006,704,464,1168,-
chr15,59191862,1.9818232739424586,748,657,1405,-
chr15,59428916,0.47036256615697314,469,568,1037,-
chr15,59428920,0.4161655069194139,571,823,1394,-
chr15,59428921,0.3865468595508571,663,984,1647,-
chr15,59430400,3.1493915523069975,697,439,1136,-
chr15,59464131,2.390705258866694,601,444,1045,-
chr15,59500978,2.278674991840663,866,546,1412,-
chr15,59502720,0.8208678909952606,738,421,1159,-
chr15,59502722,0.8208678909952606,738,421,1159,-
chr15,59515297,4.316935529049462,691,447,1138,-
chr15,59931191,3.4804292929292937,1042,692,1734,-
chr15,59942924,1.6893004115226338,820,503,1323,-
chr15,59963431,2.638039215686274,650,424,1074,-
chr15,59963432,2.0553080319880626,853,597,1450,-
chr15,59970126,2.52925842750395,845,557,1402,-
chr15,59971913,1.840944881889764,667,380,1047,-
chr15,59974635,0.8399311531841653,609,414,1023,-
chr15,59974637,0.8399311531841653,609,414,1023,-
chr15,60639709,1.278548578943975,9938,7211,17149,-
chr15,60639802,1.4164859507017378,10053,5797,15850,-
chr15,60639803,1.3822316370780843,18112,11980,30092,-
chr15,60639804,1.4444095477386936,4388,3183,7571,-
chr15,60641309,1.682531515307435,2179,1520,3699,-
chr15,60641317,0.7262351349971929,3397,2798,6195,-
chr15,60641318,0.6545165850040885,2828,1996,4824,-
chr15,60644586,1.399526541017937,1617,1045,2662,-
chr15,60646377,0.7225033236881206,3622,2691,6313,-
chr15,60646380,0.7883737689166465,3281,2483,5764,-
chr15,60646381,1.3521941519410674,4479,2841,7320,-
chr15,60646398,1.6075541550056192,3285,1972,5257,-
chr15,60646408,1.5358322730418088,2896,1643,4539,-
chr15,60653155,1.8178316073247025,8747,7148,15895,-
chr15,60653156,1.9185005767012686,4577,3467,8044,-
chr15,60653170,1.287252870586204,4084,2573,6657,-
chr15,60653173,1.1894795984863742,3858,2820,6678,-
chr15,60653190,1.6286992102007802,2722,1581,4303,-
chr15,60656677,1.592020295202952,2713,2167,4880,-
chr15,60656695,1.4073449228406656,8818,5942,14760,-
chr15,60674600,1.970790564440876,2111,1588,3699,-
chr15,60674619,1.3398367888186071,3800,2398,6198,-
chr15,60674634,1.367064935064935,2837,1749,4586,-
chr15,60674636,1.813467492260062,1277,815,2092,-
chr15,60674639,1.5581420388474956,2438,1497,3935,-
chr15,60678229,1.5770732911953098,3554,2197,5751,-
chr15,60678257,0.7338374530211044,1888,1152,3040,-
chr15,60678275,1.782699038519858,1925,1642,3567,-
chr15,60689526,1.2666604927827674,606,574,1180,-
chr15,60690149,1.778381695450162,827,670,1497,-
chr15,60690161,1.884526558891455,655,432,1087,-
chr15,60690179,1.440313888012506,537,598,1135,-
chr15,60690181,0.35232111320442416,913,929,1842,-
chr15,60690183,1.0784593437945793,755,700,1455,-
chr15,60740262,2.572758758025812,670,504,1174,-
chr15,63447823,0.483744221879815,1091,879,1970,-
chr15,63449612,1.500643103359572,1822,1253,3075,-
chr15,63449673,0.9078478002378122,1017,579,1596,-
chr15,64364852,2.130965909090909,576,439,1015,-
chr15,64365122,1.5740540540540542,1455,924,2379,-
chr15,64365141,1.941221042432965,3404,2762,6166,-
chr15,64381024,0.686689581604836,851,714,1565,-
chr15,64385863,1.6512672811059907,1302,839,2141,-
chr15,64385864,1.6512672811059907,1302,839,2141,-
chr15,64385875,3.250097922230709,884,623,1507,-
chr15,64448102,0.6812580168536589,1997,1526,3523,-
chr15,64448104,1.766958741948587,1014,906,1920,-
chr15,64448205,0.7963267363106283,3282,2002,5284,-
chr15,64448261,1.308748480717302,4829,3832,8661,-
chr15,64448298,1.2830438213143056,12699,10995,23694,-
chr15,64448299,1.235840166004679,27709,21736,49445,-
chr15,64448300,1.420299848428937,12620,11464,24084,-
chr15,64448301,1.1847492678952514,19101,15402,34503,-
chr15,64448311,1.8751329243353785,2887,2444,5331,-
chr15,64448324,2.006250070887438,12400,8830,21230,-
chr15,64448932,1.3546699582672077,2425,1907,4332,-
chr15,64448938,1.703381802324707,2359,1821,4180,-
chr15,64449017,1.3018242122719734,4089,2453,6542,-
chr15,64449104,1.4161047168479028,1932,1551,3483,-
chr15,64454348,1.4168886165644623,3185,2577,5762,-
chr15,64454349,1.3259953089788599,1801,1516,3317,-
chr15,64455063,1.2994776239969843,2285,1796,4081,-
chr15,64455076,1.1325483278691078,6230,4495,10725,-
chr15,64455079,1.2780510387130375,2453,1570,4023,-
chr15,64455081,1.6723670911663635,1117,969,2086,-
chr15,64455162,1.4025,1835,999,2834,-
chr15,64455174,1.6902915632754345,1556,805,2361,-
chr15,64455200,2.9520420792079207,1826,807,2633,-
chr15,64455201,2.1946272201058723,1108,696,1804,-
chr15,64455202,2.5651320562678444,4349,2292,6641,-
chr15,64455203,2.1728359138488296,2552,1349,3901,-
chr15,64455205,1.8289967460373324,964,651,1615,-
chr15,64455207,1.6898832085786901,1985,998,2983,-
chr15,64455208,1.7503564482122078,2624,1397,4021,-
chr15,64455213,1.774258496424794,1266,466,1732,-
chr15,64455215,0.8007054574818869,1502,435,1937,-
chr15,64455217,0.7091222693287579,1280,454,1734,-
chr15,64668946,2.2396915856520283,785,627,1412,-
chr15,64669060,1.761369863894362,1835,1478,3313,-
chr15,64673162,1.9147214441332088,768,611,1379,-
chr15,64673184,0.5620685017484085,1474,1173,2647,-
chr15,64673530,1.8937355618969969,870,668,1538,-
chr15,64673581,0.4943466172381835,1015,829,1844,-
chr15,64673605,1.0336675838794753,2152,1782,3934,-
chr15,64673609,0.5963945578231292,796,599,1395,-
chr15,64673610,1.8504672897196264,549,534,1083,-
chr15,64673627,0.5949940958164642,972,740,1712,-
chr15,64673633,1.1345183486238533,760,544,1304,-
chr15,64673634,1.1345183486238533,760,544,1304,-
chr15,64673636,1.00811291733269,1237,933,2170,-
chr15,64673637,1.00811291733269,1237,933,2170,-
chr15,64673638,1.878366166636544,546,502,1048,-
chr15,64979819,6.34191870614944,468,594,1062,-
chr15,64979828,18.258289376678576,958,580,1538,-
chr15,64979829,17.65351137562813,851,473,1324,-
chr15,64980080,0.67006838956826,776,586,1362,-
chr15,64980133,2.8242618568770688,602,495,1097,-
chr15,64980166,2.201673866090713,698,462,1160,-
chr15,64980168,2.201673866090713,698,462,1160,-
chr15,64980547,7.586496895536885,515,558,1073,-
chr15,64980548,5.324558365798583,619,589,1208,-
chr15,64980569,10.973056077694235,861,539,1400,-
chr15,64980570,9.728361221197096,1138,796,1934,-
chr15,64980571,6.683237696132329,858,617,1475,-
chr15,64980587,6.9593148050878515,657,350,1007,-
chr15,64980588,6.2695483064409245,804,421,1225,-
chr15,64980772,5.161953799013097,556,475,1031,-
chr15,64995388,1.069460580912863,788,722,1510,-
chr15,64995390,1.069460580912863,788,722,1510,-
chr15,64995408,2.5977188021374946,703,411,1114,-
chr15,65255778,2.777167085427136,654,397,1051,-
chr15,65255814,2.3410452948908342,705,608,1313,-
chr15,65255997,1.9021169141054726,1767,1238,3005,-
chr15,65255998,0.9994169096209914,856,685,1541,-
chr15,65447350,1.5584709519454913,6143,4090,10233,-
chr15,65447353,2.174186452116145,4489,3125,7614,-
chr15,65447355,1.6401312598316298,9143,6231,15374,-
chr15,65447386,0.6369132503766264,2735,1986,4721,-
chr15,65447387,1.7113762816250833,1286,696,1982,-
chr15,65447394,1.4714714714714716,2604,1562,4166,-
chr15,65447395,1.5500185840240206,3725,2122,5847,-
chr15,65447412,0.5544337253865468,1906,1080,2986,-
chr15,65447413,0.5544337253865468,1906,1080,2986,-
chr15,65448035,1.2088026138766097,1533,945,2478,-
chr15,65448036,1.6139162933485713,2691,1656,4347,-
chr15,65448079,0.5397417503586801,683,339,1022,-
chr15,65448146,0.351387273633494,704,462,1166,-
chr15,65448147,0.351387273633494,704,462,1166,-
chr15,65450136,4.557362637362637,575,454,1029,-
chr15,65450137,4.557362637362637,575,454,1029,-
chr15,65450180,3.1545261603354087,1031,718,1749,-
chr15,65450182,3.4233460743672475,1514,1093,2607,-
chr15,65454944,3.197581182664971,798,559,1357,-
chr15,65983582,2.1059069731462414,2007,1310,3317,-
chr15,65983583,1.923957304291256,1596,1077,2673,-
chr15,65983584,1.923957304291256,1596,1077,2673,-
chr15,66786259,0.9525094441446303,705,435,1140,-
chr15,66786260,2.2708664864573644,924,600,1524,-
chr15,66791797,1.2976984430654144,21484,17206,38690,-
chr15,66791801,1.2963964827109988,48912,37389,86301,-
chr15,66791813,1.3044362385422257,46392,33782,80174,-
chr15,66791814,1.2266224579211036,109558,78477,188035,-
chr15,66791815,1.2266224579211036,109558,78477,188035,-
chr15,66791832,1.0789464939938391,52976,42211,95187,-
chr15,66791833,1.1749696534629206,76947,56390,133337,-
chr15,66791851,1.4672024021219467,9190,5464,14654,-
chr15,66791971,1.6636606259555387,128141,99475,227616,-
chr15,66791974,1.394845385328054,70713,42072,112785,-
chr15,66791975,1.5406572135717966,152604,106691,259295,-
chr15,66791988,1.4940617605548612,35112,24798,59910,-
chr15,66792396,1.3138441362694848,92631,63063,155694,-
chr15,66792397,1.3138441362694848,92631,63063,155694,-
chr15,66792398,1.3138441362694848,92631,63063,155694,-
chr15,66793296,1.4398644034143566,102136,69900,172036,-
chr15,66793335,1.1608480967648316,171784,110476,282260,-
chr15,66793336,1.0769116575160995,113521,67329,180850,-
chr15,66793339,1.2149259247103228,100253,65529,165782,-
chr15,66793344,0.8946277083957088,40292,23994,64286,-
chr15,66793360,1.3407153201048834,177984,110031,288015,-
chr15,66793361,1.3415033810948935,147061,92911,239972,-
chr15,66793368,1.272313542548162,106920,59655,166575,-
chr15,66793369,1.2811949150285757,142924,81487,224411,-
chr15,66793376,1.5179809925507024,23132,11533,34665,-
chr15,66793443,0.9912913867162504,689,420,1109,-
chr15,66794250,0.6098097024926293,575,454,1029,-
chr15,66795021,1.2184132788993882,16500,12420,28920,-
chr15,66795026,1.5026414636284553,15261,11539,26800,-
chr15,66795404,0.8385753970014195,14754,11271,26025,-
chr15,66795415,0.9891611478475281,39511,28714,68225,-
chr15,66795650,1.0222690399661472,903,644,1547,-
chr15,66795734,1.1221698501322364,28078,17014,45092,-
chr15,66795753,1.206388309233695,22157,18268,40425,-
chr15,66795832,1.1526418188334584,67894,52810,120704,-
chr15,66795833,1.1526418188334584,67894,52810,120704,-
chr15,66795841,1.2641988039570562,15717,12510,28227,-
chr15,66795850,1.0978091613099408,39153,30418,69571,-
chr15,66795852,1.0677169643348554,25883,20164,46047,-
chr15,66797132,1.1769106210740758,10637,6843,17480,-
chr15,66797135,1.186886683741033,16892,12780,29672,-
chr15,66797136,1.3477287939836993,7949,5860,13809,-
chr15,66797143,1.252134797765866,13917,8324,22241,-
chr15,66797145,1.252134797765866,13917,8324,22241,-
chr15,66797155,1.4083610348595237,4996,2861,7857,-
chr15,66797159,1.2398901069429709,8736,5493,14229,-
chr15,66797170,1.0444425049861648,6598,4109,10707,-
chr15,66797178,0.7767711962833915,2279,2049,4328,-
chr15,66797179,1.2524980709876543,2200,1619,3819,-
chr15,66797183,1.0818322982352573,5787,4371,10158,-
chr15,66797184,1.0687620571010283,4369,3585,7954,-
chr15,67494227,0.2794987207420844,744,1357,2101,-
chr15,67494228,0.299488764712876,457,646,1103,-
chr15,67494231,14.373882570518354,2150,2897,5047,-
chr15,67494232,14.373882570518354,2150,2897,5047,-
chr15,67494233,16.968540750205204,2112,2321,4433,-
chr15,67494886,1.6429163616177205,637,401,1038,-
chr15,69071336,1.874338001840636,1137,822,1959,-
chr15,69071370,2.116465863453816,645,497,1142,-
chr15,69071453,0.6294643862559532,1264,1041,2305,-
chr15,69071765,2.283897576903248,885,758,1643,-
chr15,69071767,2.201780619209693,1474,1150,2624,-
chr15,69072217,0.32115885881596795,565,775,1340,-
chr15,69072218,0.3110047846889952,449,569,1018,-
chr15,69072237,22.984577877858325,1741,1394,3135,-
chr15,69072238,23.478375077186957,2103,1508,3611,-
chr15,69072239,24.91884176773568,1911,1259,3170,-
chr15,69072240,54.641379675021376,1073,592,1665,-
chr15,69072251,22.09540023487517,1513,163,1676,-
chr15,69072252,21.104597672007753,1909,204,2113,-
chr15,69072253,32.4054054054054,980,73,1053,-
chr15,69072254,14.422970992970995,999,111,1110,-
chr15,69072255,10.215936958179418,1171,84,1255,-
chr15,69072331,0.4247812548017597,496,523,1019,-
chr15,69072804,0.5352112676056339,740,851,1591,-
chr15,69072807,15.45794678539558,6143,12346,18489,-
chr15,69072810,6.488031923539259,5815,4621,10436,-
chr15,69072812,5.648310112024959,4059,3825,7884,-
chr15,69075298,2.950693645163081,4208,2203,6411,-
chr15,69075303,2.6653003445411256,1872,847,2719,-
chr15,69075308,2.916340782122905,2197,715,2912,-
chr15,69075309,2.916340782122905,2197,715,2912,-
chr15,69075313,4.560092045993587,4839,1988,6827,-
chr15,69075316,2.31760538477165,2219,789,3008,-
chr15,69075324,4.201930200197505,2775,1187,3962,-
chr15,69075328,4.410709013054505,4148,1623,5771,-
chr15,69075331,1.5028549676437,1597,628,2225,-
chr15,69075385,1.9866201941946202,2543,1334,3877,-
chr15,69076865,0.5880355537800859,767,588,1355,-
chr15,69079826,2.0019601754075578,2346,1642,3988,-
chr15,69080113,1.5900090751588152,1185,1053,2238,-
chr15,69080214,1.824532147489346,915,770,1685,-
chr15,69080236,2.0006791171477083,981,619,1600,-
chr15,69080238,1.9516296712312187,1460,967,2427,-
chr15,69113134,1.6815467464862537,8344,7308,15652,-
chr15,69113135,1.7449632382200073,10962,9481,20443,-
chr15,69113136,1.7449632382200073,10962,9481,20443,-
chr15,69113137,1.7199989798669457,10529,8853,19382,-
chr15,69113139,1.531329199826792,7353,5878,13231,-
chr15,69113141,1.1040945355233005,8374,6058,14432,-
chr15,69113146,2.2027972027972025,674,428,1102,-
chr15,69113165,1.8341283712004386,2956,2129,5085,-
chr15,69113167,1.7347231394772442,6534,4565,11099,-
chr15,69113169,1.8227733166870017,4014,2710,6724,-
chr15,69113171,1.5981185621189826,2587,1703,4290,-
chr15,69113175,0.8055056949202511,3411,2199,5610,-
chr15,69113177,0.9487813514357875,7092,4439,11531,-
chr15,69113178,1.2264339810044074,2358,1423,3781,-
chr15,69113179,1.0845314667967327,3681,2240,5921,-
chr15,69113206,1.7650878984627894,1464,874,2338,-
chr15,69113211,2.0713635704579754,1355,636,1991,-
chr15,69113213,1.9859977255038477,1083,567,1650,-
chr15,70342272,3.1765540231863354,527,514,1041,-
chr15,70386905,1.5163819163179213,4187,2305,6492,-
chr15,70386907,1.4868251370057588,5752,3519,9271,-
chr15,70386910,1.626294972591477,2202,1538,3740,-
chr15,70386913,2.038599508599509,1316,924,2240,-
chr15,70387925,1.7342095655348666,999,663,1662,-
chr15,70387926,1.4383003663003664,1066,524,1590,-
chr15,70387959,3.576923076923077,743,367,1110,-
chr15,70388513,1.3142429076123658,840,610,1450,-
chr15,70388514,0.4426190197671408,688,446,1134,-
chr15,71457138,0.43989717760671776,1608,1701,3309,-
chr15,71457139,0.44179104477611936,1295,1339,2634,-
chr15,71457144,0.5411420408580613,837,858,1695,-
chr15,71457145,0.5721305721305722,651,813,1464,-
chr15,71457147,0.4933695311684243,944,941,1885,-
chr15,71457148,0.4854989120082053,1970,2226,4196,-
chr15,71457151,0.5090545288343753,575,776,1351,-
chr15,71457153,4.794456035767511,968,1374,2342,-
chr15,71457154,8.318610201928616,1822,2486,4308,-
chr15,71457157,3.0330560783930793,1189,779,1968,-
chr15,71457181,2.270086478542989,915,525,1440,-
chr15,72491449,1.3247173906002008,6291,4015,10306,-
chr15,72491666,1.71640866873065,2575,1954,4529,-
chr15,72491716,1.32449611550548,10736,7148,17884,-
chr15,72491723,1.1918165552311897,6660,3884,10544,-
chr15,72491760,1.5930161993934666,6538,3731,10269,-
chr15,72491860,1.2153250188964473,4061,2645,6706,-
chr15,72491898,0.7755522859019853,27575,15449,43024,-
chr15,72491911,1.3162902923821198,7646,5340,12986,-
chr15,72491913,1.3162902923821198,7646,5340,12986,-
chr15,72491925,0.7760977379630651,7305,4073,11378,-
chr15,72491933,1.423351635746295,5092,3321,8413,-
chr15,72491934,1.186895237397321,10329,6190,16519,-
chr15,72491935,1.4314773225948012,6523,4187,10710,-
chr15,72491936,1.3539444713290272,9730,6146,15876,-
chr15,72491937,1.0777252824440746,5007,2983,7990,-
chr15,72491939,1.292677777931588,2540,1536,4076,-
chr15,72491940,1.2572077409162716,2260,1265,3525,-
chr15,72491946,1.9664698593191925,1926,1075,3001,-
chr15,72491948,1.6492934307185594,2815,1603,4418,-
chr15,72491950,0.620791170051265,4287,2490,6777,-
chr15,72491951,0.6261278037675447,5083,2927,8010,-
chr15,72491952,0.6255648539000839,4709,2766,7475,-
chr15,72491958,1.7467689822294026,864,618,1482,-
chr15,72491969,0.4891288486794104,837,622,1459,-
chr15,72492819,1.223182329481542,5598,3387,8985,-
chr15,72492822,1.3484446504266512,10305,6134,16439,-
chr15,72492823,1.387087612234565,11954,7428,19382,-
chr15,72492834,1.351594675764903,4920,2775,7695,-
chr15,72492937,0.7983214342376646,2490,1909,4399,-
chr15,72492952,1.652970548408937,1795,1476,3271,-
chr15,72492976,1.1241064009821946,6976,5806,12782,-
chr15,72494804,0.7550512464634603,1854,1440,3294,-
chr15,72494818,1.3492956861221386,7223,4910,12133,-
chr15,72494874,1.4841362126245845,3530,2837,6367,-
chr15,72494932,1.2401626044376415,12297,8287,20584,-
chr15,72499207,1.817442236463049,2400,1863,4263,-
chr15,72499554,1.1723279253026704,14524,11927,26451,-
chr15,72499555,1.2517301247435757,28216,21754,49970,-
chr15,72499563,0.8514676550573953,5906,4753,10659,-
chr15,72499610,1.3028538007982078,9172,6148,15320,-
chr15,72500988,1.2807807328214904,10752,7710,18462,-
chr15,72501110,0.7511090518304276,11406,7826,19232,-
chr15,72501129,1.308572699071476,2331,1833,4164,-
chr15,72501171,2.14596836919886,2135,1652,3787,-
chr15,72501203,1.25379917356541,13682,10167,23849,-
chr15,72502018,1.3170956173341557,8096,5484,13580,-
chr15,72502060,1.5543765830558165,2776,2410,5186,-
chr15,72502093,1.4518748489243414,5913,4727,10640,-
chr15,72502094,1.3399458815082301,14811,10440,25251,-
chr15,72502156,1.2955843127819378,6867,4516,11383,-
chr15,72502765,1.6427834887311257,4996,4397,9393,-
chr15,72523491,1.4125230202578267,1377,1085,2462,-
chr15,72523496,0.7427629540606437,3609,2742,6351,-
chr15,72523520,1.592267110495078,4653,2957,7610,-
chr15,72523523,1.2485150625625216,2661,1444,4105,-
chr15,72523526,1.1377892379964183,1879,1432,3311,-
chr15,72523528,0.9160254588643334,2254,1793,4047,-
chr15,72523530,0.9160254588643334,2254,1793,4047,-
chr15,72523531,2.2194530979577705,1602,855,2457,-
chr15,72523534,1.6331692774876203,2144,1278,3422,-
chr15,72523541,0.5377532556563313,2651,1719,4370,-
chr15,72523553,1.8440251838124204,541,522,1063,-
chr15,72636286,1.1243986608910768,701,503,1204,-
chr15,72636426,0.5489566613162119,629,444,1073,-
chr15,72637850,1.1339128072796416,1011,795,1806,-
chr15,72637852,1.1339128072796416,1011,795,1806,-
chr15,72638596,3.505434782608696,644,367,1011,-
chr15,72638925,1.870183486238532,603,435,1038,-
chr15,72640397,1.954537567239285,703,677,1380,-
chr15,72640400,2.415730337078652,773,533,1306,-
chr15,72641448,0.6346153846153847,899,599,1498,-
chr15,72641523,2.1243086816720256,1000,621,1621,-
chr15,72641561,2.6829174664107485,722,520,1242,-
chr15,72641589,0.4794425087108014,773,614,1387,-
chr15,72641599,1.082326491251354,1224,903,2127,-
chr15,72643475,2.9714285714285715,551,482,1033,-
chr15,72643479,2.03931963772918,576,502,1078,-
chr15,72645442,1.9044117647058825,776,458,1234,-
chr15,72645453,2.259453781512605,716,447,1163,-
chr15,72645514,1.722877358490566,973,741,1714,-
chr15,72647951,1.58974358974359,743,623,1366,-
chr15,72647954,2.130320150659134,807,530,1337,-
chr15,72648955,0.3900815217391304,637,367,1004,-
chr15,72668221,1.6049274018146393,1372,897,2269,-
chr15,72668222,2.017338092809791,1011,582,1593,-
chr15,72668324,0.6645844704519449,865,698,1563,-
chr15,73044020,1.0077220077220077,854,664,1518,-
chr15,73044021,1.0077220077220077,854,664,1518,-
chr15,73044247,1.0557387872552473,707,492,1199,-
chr15,73044619,0.5635179153094463,864,613,1477,-
chr15,73044728,1.6025020177562552,721,530,1251,-
chr15,73047990,2.868596881959911,804,448,1252,-
chr15,73047991,2.868596881959911,804,448,1252,-
chr15,73067332,3.129881012233953,643,458,1101,-
chr15,73067333,3.0128834792511925,961,668,1629,-
chr15,73067335,3.0821849576622946,951,633,1584,-
chr15,73067336,3.334552845528455,630,409,1039,-
chr15,73067435,1.1860280113380541,622,499,1121,-
chr15,73852653,2.031620553359684,1027,758,1785,-
chr15,73852786,1.9039451114922807,739,423,1162,-
chr15,73854282,2.217860976918948,1201,827,2028,-
chr15,73854283,2.217860976918948,1201,827,2028,-
chr15,73862722,1.5303470031545745,4547,3169,7716,-
chr15,73862723,1.3569650912097904,10613,8017,18630,-
chr15,73862729,1.4135593220338984,2918,2064,4982,-
chr15,73862732,1.846812193037176,4891,3779,8670,-
chr15,73862733,1.9521596858638743,4574,3819,8393,-
chr15,73862735,1.4845609031523805,6875,5235,12110,-
chr15,73862736,1.959463946796811,2845,2232,5077,-
chr15,73862738,1.5995575221238938,1445,903,2348,-
chr15,73862753,2.0035082443742795,1051,738,1789,-
chr15,73862760,1.8483358049158214,1869,1151,3020,-
chr15,73866025,2.505641188622279,656,433,1089,-
chr15,73866064,2.256891162262006,721,413,1134,-
chr15,73866084,1.973684210526316,899,588,1487,-
chr15,73866096,1.5077902496230524,749,507,1256,-
chr15,73884331,2.9366521775096177,750,496,1246,-
chr15,74743857,3.4415531966020674,1814,1014,2828,-
chr15,74743859,3.965517241379311,1034,521,1555,-
chr15,74751232,0.7584430756159728,620,427,1047,-
chr15,74751234,1.2893029811819101,608,421,1029,-
chr15,75212764,0.7650504260077902,2046,1438,3484,-
chr15,75221478,1.6105456365760051,1015,921,1936,-
chr15,75221529,1.912699239504115,1019,661,1680,-
chr15,75221536,1.6015539803707743,757,523,1280,-
chr15,75221547,2.0994424849243374,658,516,1174,-
chr15,75230288,4.664807368062943,912,546,1458,-
chr15,75230290,5.425562511251374,899,526,1425,-
chr15,75230316,1.8484328780296437,629,559,1188,-
chr15,75247716,2.823529411764706,623,424,1047,-
chr15,75247718,2.823529411764706,623,424,1047,-
chr15,75703946,1.3298903624361764,1210,937,2147,-
chr15,75703947,1.3298903624361764,1210,937,2147,-
chr15,75913387,1.6928571428571426,1049,1224,2273,-
chr15,75913389,1.491149328939101,3513,3258,6771,-
chr15,75913390,1.3273290180627655,3411,2906,6317,-
chr15,75913391,1.4084794793454838,3847,3351,7198,-
chr15,75913392,1.1277506112469438,1844,1226,3070,-
chr15,75913393,2.0164495328332674,1385,1340,2725,-
chr15,75913394,1.639250650482541,3213,2392,5605,-
chr15,75913396,2.344601624936353,912,716,1628,-
chr15,75931513,0.3522720266354275,878,661,1539,-
chr15,75931514,0.3522720266354275,878,661,1539,-
chr15,75931651,3.628015564202335,665,513,1178,-
chr15,75931653,3.628015564202335,665,513,1178,-
chr15,75931745,0.46543509842391506,932,751,1683,-
chr15,76518250,1.4167153711279952,1514,1159,2673,-
chr15,76518255,1.65,1949,1299,3248,-
chr15,76566783,2.506271576524741,1012,789,1801,-
chr15,76566800,2.07508015675098,1012,801,1813,-
chr15,76578026,0.6459982611083147,2228,1680,3908,-
chr15,76578057,1.531301351709515,1255,1154,2409,-
chr15,76578716,1.1858861038842574,4525,3472,7997,-
chr15,76578718,1.5163706272193056,3893,3183,7076,-
chr15,76584823,1.8239465630885123,1126,943,2069,-
chr15,76585003,1.1127634449206254,2870,2227,5097,-
chr15,76585026,1.7627539991353218,1040,770,1810,-
chr15,76588030,1.666666666666667,684,547,1231,-
chr15,76588056,2.0805583062417488,1235,979,2214,-
chr15,76588058,0.4328257311606063,810,597,1407,-
chr15,76603703,1.8868374032162,703,437,1140,-
chr15,76603714,5.053398058252427,693,411,1104,-
chr15,76603758,0.6325309886900787,2343,1667,4010,-
chr15,76603783,1.0821126806511598,619,405,1024,-
chr15,77338630,1.4193853427895982,1263,939,2202,-
chr15,77338746,1.83381512605042,1185,849,2034,-
chr15,77338764,1.9423476968796436,1031,672,1703,-
chr15,77338772,1.8226829645675384,759,561,1320,-
chr15,77338841,2.3239247311827955,740,495,1235,-
chr15,77339025,1.86096256684492,927,747,1674,-
chr15,77339226,1.583151326053042,825,640,1465,-
chr15,77344731,1.5628190148207366,1181,706,1887,-
chr15,77344732,1.6904727552541725,949,716,1665,-
chr15,77344778,1.52831541218638,1065,619,1684,-
chr15,77344788,1.851821949512891,982,562,1544,-
chr15,77345125,3.4379051075965785,779,550,1329,-
chr15,77345128,2.434077079107505,899,492,1391,-
chr15,77345207,0.5303370786516853,1651,1259,2910,-
chr15,77345215,1.6596701649175412,1270,898,2168,-
chr15,77346581,1.6897571277719112,1142,946,2088,-
chr15,77348415,1.964349376114082,1159,679,1838,-
chr15,77348582,0.372972972972973,643,591,1234,-
chr15,77348583,1.67236887129864,1430,1162,2592,-
chr15,77363237,2.5415142133408386,773,560,1333,-
chr15,77363254,1.1774496415158755,889,807,1696,-
chr15,77363255,1.1774496415158755,889,807,1696,-
chr15,77363280,2.4203870413679542,641,520,1161,-
chr15,77363344,2.2295827344459247,715,419,1134,-
chr15,77363387,0.48888154159457736,728,598,1326,-
chr15,77363406,8.933643893959834,2773,1603,4376,-
chr15,77363407,8.933643893959834,2773,1603,4376,-
chr15,77363408,8.933643893959834,2773,1603,4376,-
chr15,77363450,0.6088142671026204,1063,518,1581,-
chr15,78575728,2.4957039911308203,620,450,1070,-
chr15,78575775,1.7482943469785577,573,455,1028,-
chr15,78577673,2.062046204620462,780,605,1385,-
chr15,78578415,4.241005291005291,696,419,1115,-
chr15,78578472,3.2189781021897814,734,410,1144,-
chr15,78580636,0.7211915338385159,689,558,1247,-
chr15,78580642,1.0904390852557853,1213,851,2064,-
chr15,78582041,1.6386946386946386,1035,615,1650,-
chr15,78582404,0.5859847358509267,738,530,1268,-
chr15,78584970,1.8376897973565987,1019,934,1953,-
chr15,78585015,0.9647331154684096,1416,917,2333,-
chr15,78585016,0.9647331154684096,1416,917,2333,-
chr15,78585018,1.0153936925940306,776,706,1482,-
chr15,78585056,3.4019025104131484,901,674,1575,-
chr15,78591932,0.5779286073403721,846,363,1209,-
chr15,78591933,0.5544794141290524,1393,686,2079,-
chr15,80137538,3.211694408877507,601,425,1026,-
chr15,80137539,3.211694408877507,601,425,1026,-
chr15,81271480,0.725845147219193,639,654,1293,-
chr15,81271487,5.000321429874165,1548,1283,2831,-
chr15,81271488,5.000321429874164,1548,1283,2831,-
chr15,81281937,1.6611569311722663,2037,1327,3364,-
chr15,81281956,1.6761677869480132,787,510,1297,-
chr15,81281999,2.228951912022859,665,473,1138,-
chr15,82422832,1.7584576793695785,807,931,1738,-
chr15,82422840,1.9647202531138612,631,558,1189,-
chr15,82431105,0.5059195873871762,663,448,1111,-
chr15,82444673,1.765207759599186,625,497,1122,-
chr15,82450164,3.906664552943958,532,498,1030,-
chr15,83207122,0.6465367683494337,1317,993,2310,-
chr15,83207643,0.8492884747015599,26877,19180,46057,-
chr15,83207657,1.2255017565799593,47147,33013,80160,-
chr15,83208755,1.2758746874663052,42131,25631,67762,-
chr15,83208756,1.1142441248208534,56598,40332,96930,-
chr15,83208757,1.2349540217123942,132482,88576,221058,-
chr15,83208759,1.2153661253233927,72525,46047,118572,-
chr15,83208766,1.1177901106542154,56584,34175,90759,-
chr15,83208767,1.2579087349032692,135242,87934,223176,-
chr15,83208768,1.2579087349032696,135242,87934,223176,-
chr15,83208769,1.2666438920174594,119965,79337,199302,-
chr15,83208776,1.2528336161653266,65892,41968,107860,-
chr15,83208777,1.2528336161653266,65892,41968,107860,-
chr15,83208794,1.236149750192732,16101,7092,23193,-
chr15,83208795,1.2540863750985596,26178,14360,40538,-
chr15,83208798,1.2173146043719618,5722,4436,10158,-
chr15,83208807,1.3461150233347978,5037,3934,8971,-
chr15,83209181,0.9457271813841267,23175,17479,40654,-
chr15,83209195,1.0624641904342131,11670,8982,20652,-
chr15,83209198,1.2049378194025284,13019,7030,20049,-
chr15,83209199,1.2049489152311073,27201,17965,45166,-
chr15,83209200,1.0987785140067676,33838,22613,56451,-
chr15,83209202,1.0435423650866873,9618,5014,14632,-
chr15,83209203,1.0481999440902439,10804,7023,17827,-
chr15,83209204,1.3015858072071373,3700,3214,6914,-
chr15,83209206,1.6788859966130028,3165,1815,4980,-
chr15,83209207,0.9644985901155819,2972,1395,4367,-
chr15,83209209,0.8702665651774848,2025,928,2953,-
chr15,83685445,3.2082262210796912,623,388,1011,-
chr15,83686501,2.6549295774647885,584,425,1009,-
chr15,83710490,0.5590455734427833,1642,796,2438,-
chr15,83710491,0.9930556348924996,3850,2215,6065,-
chr15,83710492,1.2923529606123845,1880,1311,3191,-
chr15,83710544,2.516284987277354,637,392,1029,-
chr15,83710641,1.4014242143581706,729,484,1213,-
chr15,83807791,2.1285846438482885,766,422,1188,-
chr15,83807793,2.1285846438482885,766,422,1188,-
chr15,83807940,2.3028259567684426,628,450,1078,-
chr15,83807944,5.123333333333334,794,499,1293,-
chr15,83807945,5.123333333333334,794,499,1293,-
chr15,83820004,1.2988093419241766,634,424,1058,-
chr15,85212893,1.893344863618348,1221,956,2177,-
chr15,85212974,1.8001526896875732,1056,945,2001,-
chr15,85213050,3.9179445320507065,8877,6696,15573,-
chr15,85213051,4.471015687149301,5541,3969,9510,-
chr15,85213223,1.44674970805761,1905,1467,3372,-
chr15,85224026,1.5790511606941628,2241,1478,3719,-
chr15,85230944,1.4213363610796177,4103,3172,7275,-
chr15,85230956,1.4467872359843235,3771,2786,6557,-
chr15,85234800,1.6439161283490415,1571,1348,2919,-
chr15,85259268,1.3405742821473154,1828,1394,3222,-
chr15,85259289,1.7792985457656116,1039,834,1873,-
chr15,85259293,0.620875104427736,1080,1025,2105,-
chr15,85259298,1.3522016814044229,2786,1983,4769,-
chr15,85259300,1.090479937057435,1583,1239,2822,-
chr15,85259341,1.3010005061599628,1915,1403,3318,-
chr15,85259342,1.0202972865732685,821,602,1423,-
chr15,89002985,2.3033751862520555,576,441,1017,-
chr15,89003014,1.7361793230429845,824,626,1450,-
chr15,89008933,0.3254164707852796,546,471,1017,-
chr15,89008953,1.0696995884438287,803,667,1470,-
chr15,89008954,1.3058969072164948,608,484,1092,-
chr15,89010389,2.565986164922587,678,450,1128,-
chr15,89860658,3.0759767103236046,592,412,1004,-
chr15,89862269,0.6253380026705876,687,532,1219,-
chr15,89862278,2.6435234774723195,903,704,1607,-
chr15,89862280,3.7453672843308223,862,641,1503,-
chr15,89866115,2.931211498973306,570,486,1056,-
chr15,89866123,2.6796657381615594,961,717,1678,-
chr15,89866125,2.6796657381615594,961,717,1678,-
chr15,89877967,4.910755148741418,1072,436,1508,-
chr15,89877971,2.377599089834423,1783,667,2450,-
chr15,89877985,0.4628384563003785,904,491,1395,-
chr15,89878045,0.8279631627460134,926,508,1434,-
chr15,90630676,1.2556007365140391,7356,6632,13988,-
chr15,90630679,1.4433862433862432,2045,1511,3556,-
chr15,90630682,1.5599259559398178,5469,5056,10525,-
chr15,90630683,1.6165682232730474,3533,3668,7201,-
chr15,90630688,2.4147544018630573,1732,1628,3360,-
chr15,90630718,1.6941627843244724,1123,711,1834,-
chr15,90630728,2.0425974025974027,982,769,1751,-
chr15,90630731,1.6586695083812497,2781,1919,4700,-
chr15,90630733,1.616580310880829,1819,1350,3169,-
chr15,90630734,0.7112072418489145,771,683,1454,-
chr15,90630743,1.720183486238532,624,435,1059,-
chr15,90630748,2.657937806873977,559,469,1028,-
chr15,90630796,0.43934030029879445,636,550,1186,-
chr15,90631608,8.300056113899839,575,493,1068,-
chr15,90773729,0.6215516654178872,729,553,1282,-
chr15,90774186,2.1974159224776746,770,553,1323,-
chr15,90774220,2.0391326661534515,690,432,1122,-
chr15,90774590,1.754017094017094,661,449,1110,-
chr15,90774652,0.6828640009367133,728,588,1316,-
chr15,90774699,2.01049873132561,941,865,1806,-
chr15,90775474,0.9983664237245539,907,691,1598,-
chr15,90775475,1.2759896504175345,1335,942,2277,-
chr15,90777102,6.616257958327104,1238,837,2075,-
chr15,90777167,0.4204937781159721,1196,808,2004,-
chr15,91509425,2.329074719318621,639,614,1253,-
chr15,91509557,1.823187862895673,627,561,1188,-
chr15,91509629,0.6382928996117526,2741,1704,4445,-
chr15,91509631,1.5132534942429654,2978,1787,4765,-
chr15,91509632,1.5132534942429654,2978,1787,4765,-
chr15,91509636,1.694945277408743,787,478,1265,-
chr15,91509643,0.6034440941062333,932,650,1582,-
chr15,91509652,0.6132218844984801,806,610,1416,-
chr15,91509725,2.653401283680053,1247,801,2048,-
chr15,91509806,1.6717062634989204,773,462,1235,-
chr15,91509823,2.5756070640176603,717,452,1169,-
chr15,91510391,2.375238095238095,869,749,1618,-
chr15,91510392,2.375238095238095,869,749,1618,-
chr15,91513708,2.5750636132315523,643,392,1035,-
chr15,91517388,1.7875776189974537,1080,695,1775,-
chr15,91517459,2.5121161362367395,702,596,1298,-
chr15,91517462,1.5448504983388707,836,601,1437,-
chr15,91519943,1.6028852207713995,1194,890,2084,-
chr15,91519944,1.1072754584307736,1838,1239,3077,-
chr15,91520000,1.6516464471403811,952,576,1528,-
chr15,91522467,1.8397115917914588,962,600,1562,-
chr15,91522513,2.26312206191006,1640,1265,2905,-
chr15,91522514,2.4512045732952226,1034,789,1823,-
chr15,91523515,1.5874519088487715,893,653,1546,-
chr15,91523533,1.9559471365638765,628,453,1081,-
chr15,91523586,1.9671666666666667,813,499,1312,-
chr15,91524164,1.893777656607177,1236,1162,2398,-
chr15,91524166,1.634148662796231,1716,1500,3216,-
chr15,91524170,1.6602613374327437,3077,2601,5678,-
chr15,91524171,1.660737818974618,4097,3483,7580,-
chr15,91524174,1.56630241029218,939,781,1720,-
chr15,91524182,1.483601424601777,1284,1001,2285,-
chr15,91524203,1.8029311114417497,654,516,1170,-
chr15,91525140,1.8816891146102444,2469,1800,4269,-
chr15,91527353,1.6834405144694533,848,621,1469,-
chr15,91528009,1.750017569751915,672,458,1130,-
chr15,91528019,0.4728857157856055,562,442,1004,-
chr15,91528030,1.017110266159696,641,525,1166,-
chr15,91528031,1.017110266159696,641,525,1166,-
chr15,91537663,3.5615902140672775,850,676,1526,-
chr15,91549636,2.5297980684811234,1565,1138,2703,-
chr15,91549638,2.402682996012214,2303,1641,3944,-
chr15,91549639,1.873228663446055,1500,1034,2534,-
chr15,101716207,1.8076134032368358,914,641,1555,-
chr15,101716208,1.8076134032368358,914,641,1555,-
chr15,101716249,5.159653465346535,757,403,1160,-
chr15,101717165,4.347211225477259,727,536,1263,-
chr15,101717619,2.1955369945209053,777,572,1349,-
chr15,101717701,1.9446998198919354,829,501,1330,-
chr15,101718396,1.5111464968152863,948,627,1575,-
chr15,101718397,1.5111464968152863,948,627,1575,-
chr15,101718398,1.5111464968152863,948,627,1575,-
chr15,101812529,0.5925663716814159,743,564,1307,-
chr15,101812811,2.2986965076242005,602,427,1029,-
chr15,101815550,1.1528695504873339,1460,1051,2511,-
chr15,101815552,0.9317456279419806,1498,996,2494,-
chr15,101821910,1.7010481901717531,2045,1401,3446,-
chr15,101821914,1.5957991417601445,1033,717,1750,-
chr15,101825184,1.688079820446425,23789,17682,41471,-
chr15,101825186,1.893142715934841,15236,11932,27168,-
chr15,101825191,1.1725049097981066,16909,11163,28072,-
chr15,101825210,1.0838631346799927,15771,9725,25496,-
chr15,101825932,1.401314620714159,1631,865,2496,-
chr15,101825942,1.711311255865322,3972,2050,6022,-
chr15,101826002,0.6275968501444343,1219,682,1901,-
chr15,101827882,1.7389855072463771,922,689,1611,-
chr15,101832184,2.4687540182589687,892,706,1598,-
chr15,101833261,2.032894736842105,926,531,1457,-
chr15,101833292,0.480500200247373,1332,1088,2420,-
chr15,101833301,0.6054658647251241,603,485,1088,-
chr15,101835360,1.3131194668445274,749,527,1276,-
chr15,102182233,0.4376576576576577,693,554,1247,-
chr15,102182234,0.4376576576576577,693,554,1247,-
chr15,102182637,4.571920202218716,720,549,1269,-
chr15,102182756,3.083457228496314,596,485,1081,-
chr15,102182757,1.1522633744855968,559,485,1044,-
chr15,102182758,1.1522633744855968,559,485,1044,-
chr16,101631,1.3444169055707655,792,619,1411,-
chr16,103505,1.7695590327169273,1243,816,2059,-
chr16,103510,1.7608447177924127,2695,1933,4628,-
chr16,103512,1.7101628125938828,3710,2549,6259,-
chr16,103518,1.9723798148701104,1200,787,1987,-
chr16,103535,2.80004329120633,2315,1630,3945,-
chr16,103558,3.5703050067139843,845,400,1245,-
chr16,103560,3.5703050067139843,845,400,1245,-
chr16,103572,2.0706436499891576,834,576,1410,-
chr16,417762,2.4543946932006637,813,602,1415,-
chr16,417763,2.4543946932006637,813,602,1415,-
chr16,419069,1.7154418197725283,681,380,1061,-
chr16,419101,5.314285714285714,719,524,1243,-
chr16,419103,5.314285714285714,719,524,1243,-
chr16,419932,1.6347302182069328,771,682,1453,-
chr16,419954,3.936503196526653,1524,1034,2558,-
chr16,419964,1.8011001623091707,694,430,1124,-
chr16,420072,1.3740743838439022,1140,674,1814,-
chr16,420073,0.9739865796488648,882,472,1354,-
chr16,420509,0.4615051221434199,688,539,1227,-
chr16,686232,0.3399138340332305,708,502,1210,-
chr16,1400202,0.435885491507501,673,548,1221,-
chr16,1470110,1.7632556568726783,907,422,1329,-
chr16,1470116,1.1577609900951962,1386,1026,2412,-
chr16,1470122,1.9458198051948048,891,703,1594,-
chr16,1470124,1.5404009304871376,1216,608,1824,-
chr16,1470136,2.230593607305936,976,437,1413,-
chr16,1470138,2.230593607305936,976,437,1413,-
chr16,1470192,2.9037416241847884,1210,709,1919,-
chr16,1470194,2.6869220681446357,1533,861,2394,-
chr16,1470196,2.70098531943687,832,412,1244,-
chr16,1616249,3.1210416242985892,623,414,1037,-
chr16,1822057,3.4487240450150582,988,700,1688,-
chr16,1822058,4.125656607246391,3151,2222,5373,-
chr16,1822059,4.124934305246969,3557,2575,6132,-
chr16,1822221,1.8308557653676174,650,523,1173,-
chr16,1822274,1.7437437437437433,870,628,1498,-
chr16,1822341,0.46720193910013624,770,482,1252,-
chr16,1822342,0.5090814737934614,653,469,1122,-
chr16,1822360,0.5561983471074381,672,483,1155,-
chr16,1822631,1.8398874223602484,1662,919,2581,-
chr16,1822639,1.5152585119798236,1501,792,2293,-
chr16,1822642,0.4652586996336996,738,447,1185,-
chr16,1822645,0.5816498316498316,690,428,1118,-
chr16,1822646,1.298788725545716,2923,1423,4346,-
chr16,1822648,1.1053566499033811,1629,753,2382,-
chr16,1822801,0.540650406504065,1672,955,2627,-
chr16,1822807,1.0674548385382376,2483,1392,3875,-
chr16,1822812,1.047230915979452,2177,1206,3383,-
chr16,1822840,2.153470715835141,721,460,1181,-
chr16,1822886,0.7875161770981536,1249,828,2077,-
chr16,1822887,0.9961884961884964,919,591,1510,-
chr16,1823082,2.1377317069743698,900,562,1462,-
chr16,1859252,2.267010830919624,653,485,1138,-
chr16,1866954,1.5251758240629048,1669,1194,2863,-
chr16,1866955,1.9382757018650028,1191,792,1983,-
chr16,1867211,1.275161987041037,737,462,1199,-
chr16,1867213,1.275161987041037,737,462,1199,-
chr16,2012201,1.2755232630509095,49096,35062,84158,-
chr16,2012250,0.8055181766850834,10765,9491,20256,-
chr16,2012538,1.2693434269029291,36060,24049,60109,-
chr16,2012539,1.2911643774561938,26777,19256,46033,-
chr16,2012562,1.4101923788383277,4265,3603,7868,-
chr16,2012563,1.508517217719623,11430,5772,17202,-
chr16,2012565,1.3625779361241892,3893,3251,7144,-
chr16,2012657,0.6754419910393978,1351,923,2274,-
chr16,2012759,1.228568907098511,23508,14604,38112,-
chr16,2012771,1.1814592503668135,7270,4997,12267,-
chr16,2012908,0.830369651927408,34820,20598,55418,-
chr16,2012910,0.830369651927408,34820,20598,55418,-
chr16,2013157,1.2195158045723915,62850,30311,93161,-
chr16,2013183,1.249235920026606,17929,10657,28586,-
chr16,2013184,0.8720698569820906,26240,12154,38394,-
chr16,2013186,1.1040053126182403,16141,9393,25534,-
chr16,2013198,1.2216839497819931,34578,18809,53387,-
chr16,2013199,1.2441170275082167,34491,19523,54014,-
chr16,2013200,1.0401936002983854,18857,14287,33144,-
chr16,2013201,1.0921522014512426,46580,30950,77530,-
chr16,2013202,0.8649930455774325,65029,39515,104544,-
chr16,2013203,0.8465017922657396,50270,30508,80778,-
chr16,2013204,1.2487090770006024,33647,21712,55359,-
chr16,2013205,1.5898899306971055,17324,9316,26640,-
chr16,2013208,1.0461652130440005,38272,19249,57521,-
chr16,2013209,1.2068624171678035,21561,10961,32522,-
chr16,2013210,1.2400946501439618,25319,13736,39055,-
chr16,2013216,1.3027114686863732,18637,9182,27819,-
chr16,2013217,1.405963252881061,11005,5255,16260,-
chr16,2013222,1.276331597917501,3186,1588,4774,-
chr16,2013242,1.28707896078495,6165,3738,9903,-
chr16,2013246,1.070551222901395,4510,1934,6444,-
chr16,2013248,0.8854642475010551,7499,3286,10785,-
chr16,2013250,0.699672117679131,3784,1617,5401,-
chr16,2013252,1.384850543478261,1962,1103,3065,-
chr16,2013256,1.1002698096900168,1954,1055,3009,-
chr16,2013257,0.9177449869977182,1475,689,2164,-
chr16,2014278,1.605322992762351,2318,1216,3534,-
chr16,2014279,1.7095575621477788,4622,2266,6888,-
chr16,2014280,1.6969056164516445,1860,844,2704,-
chr16,2014281,1.6969056164516445,1860,844,2704,-
chr16,2014293,0.5327389871141744,1093,751,1844,-
chr16,2014298,0.4985027878249886,6267,4628,10895,-
chr16,2014299,0.505982200742618,2974,2526,5500,-
chr16,2014300,0.5469226118131636,5111,3890,9001,-
chr16,2014457,1.3409754081949967,7677,4602,12279,-
chr16,2014459,1.3409754081949967,7677,4602,12279,-
chr16,2014466,1.2760196361123357,3269,1885,5154,-
chr16,2014479,1.0655139675864083,4190,2980,7170,-
chr16,2014488,1.424745643784353,1964,1005,2969,-
chr16,2014491,3.5169538281022454,11780,8275,20055,-
chr16,2014492,3.5169538281022454,11780,8275,20055,-
chr16,2014503,1.5930207429862193,2799,1353,4152,-
chr16,2014506,2.2283857142144217,5220,2153,7373,-
chr16,2014507,2.127071949833144,4034,1473,5507,-
chr16,2014508,2.1373152567383737,5296,1895,7191,-
chr16,2014510,2.9581979725233865,2561,880,3441,-
chr16,2014518,1.7435006435006437,1177,369,1546,-
chr16,2014535,1.6866414835164836,1253,895,2148,-
chr16,2014618,1.2773198345851593,7394,3863,11257,-
chr16,2014627,1.3078138424696348,2121,1625,3746,-
chr16,2014628,0.8167723749119098,2988,1385,4373,-
chr16,2014811,1.0970435375308851,4871,2133,7004,-
chr16,2014812,0.9288959971301306,6904,3040,9944,-
chr16,2014813,0.7606649937264743,2424,1593,4017,-
chr16,2014814,0.7301164906347707,8031,4332,12363,-
chr16,2014816,1.3338242374465432,1681,1053,2734,-
chr16,2014817,0.7486073179257606,2464,1465,3929,-
chr16,2014818,1.1392735273938284,2880,1925,4805,-
chr16,2014822,0.9114001219264376,1195,702,1897,-
chr16,2014823,0.9114001219264376,1195,702,1897,-
chr16,2014826,0.6065690901136295,1117,792,1909,-
chr16,2048455,1.856336907158575,978,805,1783,-
chr16,2048456,1.856336907158575,978,805,1783,-
chr16,2052372,2.3043478260869565,635,551,1186,-
chr16,2052373,2.1192323998850897,1186,905,2091,-
chr16,2205105,0.9602891166466161,2303,1546,3849,-
chr16,2205295,1.4002582701739432,633,482,1115,-
chr16,2263816,1.5729166666666665,754,559,1313,-
chr16,2263823,1.1373981051858797,1550,1065,2615,-
chr16,2263957,0.45175311563375065,619,521,1140,-
chr16,2263992,0.9374776279680229,872,492,1364,-
chr16,2263993,0.9374776279680229,872,492,1364,-
chr16,2289988,1.07152946131936,1817,1611,3428,-
chr16,2289990,0.4707860445565363,1119,1091,2210,-
chr16,2289994,2.582411504424779,643,451,1094,-
chr16,2290061,2.3999219156689224,682,451,1133,-
chr16,2290064,2.01601788042466,655,412,1067,-
chr16,2294411,2.4078221100772748,693,372,1065,-
chr16,2294412,2.4078221100772748,693,372,1065,-
chr16,2296976,1.6138081209171258,585,421,1006,-
chr16,2303250,1.4791720554971577,2889,1666,4555,-
chr16,2303259,2.0599024125779346,3916,2974,6890,-
chr16,2303314,2.317490494296578,741,525,1266,-
chr16,2303638,0.5830445225546266,668,502,1170,-
chr16,2303769,2.0860054498203158,1272,879,2151,-
chr16,2303771,2.134488188976378,752,507,1259,-
chr16,2303933,1.7194960193095519,1596,1303,2899,-
chr16,2303935,1.7194960193095519,1596,1303,2899,-
chr16,2312380,2.2512624845696334,742,468,1210,-
chr16,2312382,2.2512624845696334,742,468,1210,-
chr16,2312776,1.30873876474702,1460,904,2364,-
chr16,2312777,0.7875902837365215,1314,858,2172,-
chr16,2314221,1.6301518475717272,1447,1184,2631,-
chr16,2314222,1.6301518475717272,1447,1184,2631,-
chr16,2314625,1.3864758899735992,693,542,1235,-
chr16,2318059,3.2880725414444916,1352,937,2289,-
chr16,2318060,3.786028899470216,1525,1084,2609,-
chr16,2827053,0.5649617871840095,1363,971,2334,-
chr16,2827123,2.2416675484075763,1176,726,1902,-
chr16,2827253,3.398080180688877,707,643,1350,-
chr16,2827256,1.256834075015893,658,571,1229,-
chr16,3072679,10.486858123193741,1349,1109,2458,-
chr16,3072682,5.216625563600732,718,697,1415,-
chr16,3072687,14.085361722092603,2452,1480,3932,-
chr16,3072688,14.610141533819125,2479,1556,4035,-
chr16,3072690,8.508064516129032,632,371,1003,-
chr16,3073942,0.41763066932705645,1020,575,1595,-
chr16,3708229,1.697482547070023,943,651,1594,-
chr16,3708851,0.9411171352918928,932,720,1652,-
chr16,3708852,1.1659102614241137,1713,1298,3011,-
chr16,3711995,0.5140708393983503,651,457,1108,-
chr16,3712035,1.7531400966183577,763,719,1482,-
chr16,3712041,1.6568698732289335,1468,1340,2808,-
chr16,3712042,1.895367467781261,2147,1913,4060,-
chr16,3712044,2.06096382395194,1408,1234,2642,-
chr16,3712064,1.9900107991360687,566,462,1028,-
chr16,3712086,2.15285265049416,660,423,1083,-
chr16,3712101,1.9907961297288315,1020,725,1745,-
chr16,3713444,1.8647518049989795,8092,7257,15349,-
chr16,3713445,1.8038416915296691,11865,10477,22342,-
chr16,3713447,1.846588206017756,7762,6767,14529,-
chr16,3713464,0.9946456287201015,6355,5024,11379,-
chr16,3713486,0.5413156531757692,2528,2125,4653,-
chr16,3713501,1.733794508041295,1874,1472,3346,-
chr16,3713511,0.7136032944406314,1528,1174,2702,-
chr16,3714288,0.7560197554853857,1458,1073,2531,-
chr16,3714290,1.767458580471931,2298,1626,3924,-
chr16,3714302,1.8411730205278591,871,681,1552,-
chr16,3714305,1.6553271911174106,1000,746,1746,-
chr16,3714319,1.0665504271119162,1614,1097,2711,-
chr16,3714326,2.3965857871691734,1509,1004,2513,-
chr16,3714350,1.4612737204382555,889,458,1347,-
chr16,3714356,2.248379052369077,783,400,1183,-
chr16,3716116,1.850498844562525,1554,1416,2970,-
chr16,3716118,1.850498844562525,1554,1416,2970,-
chr16,3721728,2.1848013816925733,758,578,1336,-
chr16,3721764,1.798858695652174,1002,574,1576,-
chr16,3721771,1.1149121573640575,1783,1224,3007,-
chr16,3721773,1.696298400075736,577,502,1079,-
chr16,3724341,3.1621329667092213,804,598,1402,-
chr16,3724355,0.6706245933636955,664,579,1243,-
chr16,3724362,2.5238805970149256,800,602,1402,-
chr16,3724389,2.0854696673189825,1092,729,1821,-
chr16,3724403,1.7144020853698272,618,557,1175,-
chr16,3724418,2.854494902687674,659,497,1156,-
chr16,3725355,2.8608634111818825,651,470,1121,-
chr16,3726095,1.721664275466284,899,696,1595,-
chr16,3726131,1.5245898177671728,2279,1632,3911,-
chr16,3726132,1.5245898177671728,2279,1632,3911,-
chr16,3727503,1.570034692718803,1425,1111,2536,-
chr16,3727550,1.6698445291874453,689,486,1175,-
chr16,3727603,1.4502840909090908,1020,747,1767,-
chr16,3727615,1.6917093986792515,2477,1852,4329,-
chr16,3729723,1.81370119987258,1989,1486,3475,-
chr16,3729724,1.746529481264273,2975,2138,5113,-
chr16,3729733,1.4779083350511921,1131,692,1823,-
chr16,3729775,1.715542521994135,1979,1209,3188,-
chr16,3736019,0.5112496148803378,2723,1630,4353,-
chr16,3736048,1.5066666666666666,1242,758,2000,-
chr16,3736114,0.6365011452526038,1051,856,1907,-
chr16,3739101,0.5914023995619057,1032,757,1789,-
chr16,3739132,1.4840116279069768,1020,687,1707,-
chr16,3740840,1.9189560439560442,634,545,1179,-
chr16,3740855,2.823061630218688,780,502,1282,-
chr16,3740896,1.7884615384615383,650,447,1097,-
chr16,3740934,2.018133284241532,876,678,1554,-
chr16,3740935,2.018133284241532,876,678,1554,-
chr16,4013196,3.4814685720924827,921,905,1826,-
chr16,4013197,2.8507424631879386,1448,1270,2718,-
chr16,4013206,2.076166692679881,738,595,1333,-
chr16,4013207,1.5427827218639978,1115,881,1996,-
chr16,4164315,2.6128818061088976,786,501,1287,-
chr16,4164316,1.82407474078341,1250,991,2241,-
chr16,4164317,1.4003430361676177,1867,1460,3327,-
chr16,4391370,2.288074133763094,630,437,1067,-
chr16,4516218,1.5053263680954856,2813,2175,4988,-
chr16,4516222,2.5573188642297646,994,765,1759,-
chr16,4516267,1.2386934673366834,1393,795,2188,-
chr16,4516269,1.2386934673366834,1393,795,2188,-
chr16,4516293,1.9050279329608937,743,536,1279,-
chr16,4516311,1.4907226862139016,1423,861,2284,-
chr16,4516312,1.6810378462738975,1230,698,1928,-
chr16,8948825,0.41339409615352574,473,622,1095,-
chr16,8948849,27.43909049320714,2721,1704,4425,-
chr16,8948850,27.413408959498568,2878,1749,4627,-
chr16,8948851,27.413408959498568,2878,1749,4627,-
chr16,8948856,8.45196829778118,2484,475,2959,-
chr16,8948857,8.774365584502924,1969,370,2339,-
chr16,8948858,9.208381412370832,1740,307,2047,-
chr16,8949171,1.691744661969583,1048,719,1767,-
chr16,8952300,3.384234828496042,661,378,1039,-
chr16,8952302,3.3014187570784634,865,544,1409,-
chr16,8952313,1.5518714400827436,715,527,1242,-
chr16,8953037,1.7213013064430744,821,522,1343,-
chr16,10623322,0.9603873631443008,890,637,1527,-
chr16,10624238,4.525613173591116,638,506,1144,-
chr16,10626880,0.4536975349766822,680,473,1153,-
chr16,10626881,0.4536975349766822,680,473,1153,-
chr16,11642035,2.0500625782227786,1169,939,2108,-
chr16,11642073,0.7417031146905377,1879,1300,3179,-
chr16,11642082,1.9054441260744988,909,697,1606,-
chr16,11642085,1.73421926910299,869,644,1513,-
chr16,11642241,0.9596207812571766,4414,3249,7663,-
chr16,11642370,1.9463786865475277,7427,6514,13941,-
chr16,11642386,1.2573172774716135,26856,21701,48557,-
chr16,11642388,1.3058121301604049,21625,16780,38405,-
chr16,11642389,1.248797029862291,11645,8266,19911,-
chr16,11642390,1.2437702309771193,24366,18626,42992,-
chr16,11642391,1.2577110761497334,29792,21866,51658,-
chr16,11642392,1.1221455159228246,29810,22863,52673,-
chr16,11642395,1.076777806385548,13374,10588,23962,-
chr16,11642418,1.3559119983208197,11138,8541,19679,-
chr16,11642424,1.8365479060362737,4859,3893,8752,-
chr16,11642427,1.5986713282220348,4471,3515,7986,-
chr16,11642431,1.2360555592949887,5590,3441,9031,-
chr16,11642432,1.4509451584404118,6379,4348,10727,-
chr16,11642436,1.621309231266819,5497,3754,9251,-
chr16,11642443,1.7482613491701164,6629,4398,11027,-
chr16,11642444,1.626208054313751,4938,3440,8378,-
chr16,11642445,1.626208054313751,4938,3440,8378,-
chr16,11642447,1.835762736325588,794,532,1326,-
chr16,11642468,1.4104477611940296,1484,1004,2488,-
chr16,11642541,0.6009187607851597,2742,1951,4693,-
chr16,11642543,0.6009187607851597,2742,1951,4693,-
chr16,11642567,1.7009311533103602,702,592,1294,-
chr16,11642611,0.3999214145383104,726,508,1234,-
chr16,11642615,0.42293770241950834,1849,1447,3296,-
chr16,11642616,0.42293770241950834,1849,1447,3296,-
chr16,11642617,1.1950799288403298,2484,1879,4363,-
chr16,11642672,2.9229008977292734,614,436,1050,-
chr16,11642825,1.519242457164631,3445,2102,5547,-
chr16,11642826,1.6255063054548118,4687,3069,7756,-
chr16,11642881,1.6731203007518796,773,664,1437,-
chr16,11643116,1.5975301018832977,1231,789,2020,-
chr16,11643120,1.7853441894892672,1205,771,1976,-
chr16,11643194,0.6474195961106957,1622,954,2576,-
chr16,11643216,1.2785099279564225,883,812,1695,-
chr16,11643230,1.8320999074930615,698,563,1261,-
chr16,11643262,2.18586255259467,828,712,1540,-
chr16,11643326,0.5516783513915445,610,522,1132,-
chr16,11643373,0.4364079212114794,633,496,1129,-
chr16,11643596,2.1071512862874675,743,445,1188,-
chr16,11647464,1.5437430786267996,1257,776,2033,-
chr16,11650373,1.9112455874936958,757,660,1417,-
chr16,11650378,0.6389786897143234,744,658,1402,-
chr16,11650384,2.7722974699718885,677,601,1278,-
chr16,11650402,1.7054421768707482,653,587,1240,-
chr16,11650403,1.7493421547252086,1107,848,1955,-
chr16,11650405,1.848585274168414,2172,1513,3685,-
chr16,11650492,1.8140116763969976,724,544,1268,-
chr16,11650501,0.5833220338983052,955,589,1544,-
chr16,11931268,0.7498972498704455,762,522,1284,-
chr16,11931448,0.6790010659357393,1273,795,2068,-
chr16,11931470,1.2862662327925778,2102,1493,3595,-
chr16,11931480,1.5655111593372704,1388,868,2256,-
chr16,11931793,1.5866753190568896,1383,1004,2387,-
chr16,11933664,1.658710359408034,1170,1074,2244,-
chr16,11935774,1.5099438792880633,5452,4091,9543,-
chr16,11940458,1.684567048442444,1889,1180,3069,-
chr16,11945270,1.9045562599049128,906,630,1536,-
chr16,11945271,1.595778748180495,576,457,1033,-
chr16,11945272,0.5794076724309283,582,515,1097,-
chr16,11945283,1.0024570024570023,951,813,1764,-
chr16,11945284,1.0024570024570023,951,813,1764,-
chr16,11945375,0.9063308291123138,1069,782,1851,-
chr16,11945376,1.2156779244603138,1002,685,1687,-
chr16,11945378,1.2986148817335288,751,567,1318,-
chr16,11966681,1.6145444295680362,715,616,1331,-
chr16,11966860,3.5256132756132756,673,503,1176,-
chr16,11966919,1.8718238283455677,1019,758,1777,-
chr16,11969761,1.833258878713424,1004,813,1817,-
chr16,11969769,1.7151090342679127,846,641,1487,-
chr16,11969949,1.837625178826896,1100,698,1798,-
chr16,11976877,0.44847954495733966,819,652,1471,-
chr16,11979106,1.801463393004468,1931,1485,3416,-
chr16,11980359,1.5687837718132696,1287,851,2138,-
chr16,11980786,2.014685900375269,1690,1216,2906,-
chr16,11984936,2.046053757918165,702,648,1350,-
chr16,11984974,2.543859649122807,579,455,1034,-
chr16,11984975,2.4855949294151545,594,533,1127,-
chr16,11990497,1.3421991971914118,2069,1533,3602,-
chr16,11990498,1.9406185412017918,1787,1468,3255,-
chr16,11991706,1.1068054325844956,3217,2879,6096,-
chr16,11991720,1.9215030674846625,1692,1303,2995,-
chr16,11991732,1.0423781242266763,2323,1795,4118,-
chr16,11991734,0.8568156356427932,4026,3326,7352,-
chr16,11991865,0.4996929878423186,625,478,1103,-
chr16,11991868,0.47027014767289405,1630,1360,2990,-
chr16,11991869,2.4236419205363307,792,482,1274,-
chr16,11991874,0.5956873315363882,662,370,1032,-
chr16,11991875,1.8633015206139856,1510,1213,2723,-
chr16,11991877,2.0202684742158428,902,626,1528,-
chr16,11991883,2.3175,926,479,1405,-
chr16,11991884,2.288951889195071,1395,871,2266,-
chr16,12009663,2.03517187687008,636,504,1140,-
chr16,14700365,1.8369665850269956,859,640,1499,-
chr16,15134960,1.621555204493593,595,421,1016,-
chr16,15154933,5.05487509263001,822,540,1362,-
chr16,15154935,5.24961527683404,819,521,1340,-
chr16,15959706,1.879608146429492,633,430,1063,-
chr16,15959846,2.2187578911926304,1136,787,1923,-
chr16,15960697,0.5781515280135823,640,495,1135,-
chr16,15961344,1.8996835443037974,620,473,1093,-
chr16,15961362,2.62731440762807,852,617,1469,-
chr16,18542886,2.0348521251034826,1210,682,1892,-
chr16,18542888,2.1580538443988133,804,486,1290,-
chr16,18555001,2.389611679069198,824,555,1379,-
chr16,18573216,0.8375171522695076,1270,1066,2336,-
chr16,18573217,0.4886494805694498,634,564,1198,-
chr16,18796126,1.217623426214434,18027,14860,32887,-
chr16,18799464,1.0032130204072616,666,492,1158,-
chr16,18800361,3.0642622194010043,11297,9671,20968,-
chr16,18800398,0.9443884008003812,30078,21080,51158,-
chr16,18800423,1.0209965150451223,23990,18666,42656,-
chr16,18800424,1.2579247025030775,19207,12184,31391,-
chr16,18800425,1.2200410070190382,31522,21853,53375,-
chr16,18800436,1.2682373079248686,8836,7132,15968,-
chr16,18800437,1.2088307662529094,16456,11805,28261,-
chr16,18801567,1.4754098360655734,863,731,1594,-
chr16,18801604,1.6541353383458648,1319,797,2116,-
chr16,18801611,2.5220855707604364,727,501,1228,-
chr16,18801614,1.8163924794359576,686,443,1129,-
chr16,18801640,1.2019511651515113,15575,10279,25854,-
chr16,18801642,1.1385701170782971,16776,10124,26900,-
chr16,18801643,1.3455940765090326,8752,5042,13794,-
chr16,18801646,1.7560006852119072,3779,2112,5891,-
chr16,18801651,1.0533997290618142,8770,6556,15326,-
chr16,18801652,0.805488028127868,9448,6932,16380,-
chr16,18801653,0.951353167282332,7833,5770,13603,-
chr16,18801654,1.053266395983953,11966,8897,20863,-
chr16,18801655,1.1206243501987323,13685,9292,22977,-
chr16,18801656,1.1070728719258853,13313,8989,22302,-
chr16,18801657,1.1707598084982995,9360,6090,15450,-
chr16,18801681,1.1745942603957575,1023,450,1473,-
chr16,18801683,0.901221119815497,1080,449,1529,-
chr16,18803132,1.7619701726844583,1094,727,1821,-
chr16,18803136,2.139720558882236,1071,667,1738,-
chr16,18804033,1.763861003861004,1268,874,2142,-
chr16,18804288,1.5401151800237394,1321,988,2309,-
chr16,18804442,0.5352722772277227,1037,807,1844,-
chr16,18805957,1.910174880763116,800,628,1428,-
chr16,18806854,1.7738006717776469,1152,906,2058,-
chr16,18806855,1.7738006717776469,1152,906,2058,-
chr16,18809250,1.6048857846610656,1033,800,1833,-
chr16,18809357,0.6752126186708861,880,631,1511,-
chr16,18810071,1.742864424057085,976,653,1629,-
chr16,18810088,1.7933416711333452,940,578,1518,-
chr16,18810092,1.7338603425559949,895,551,1446,-
chr16,18810141,2.1759508259700344,707,410,1117,-
chr16,18812776,2.1602069212185504,1511,1230,2741,-
chr16,18812777,2.4632352941176467,799,679,1478,-
chr16,18812849,4.365431489890648,1518,1153,2671,-
chr16,18812850,3.7129151291512925,773,541,1314,-
chr16,19514424,1.8211825860948667,636,404,1040,-
chr16,19514554,1.457182283640459,2752,3131,5883,-
chr16,19514555,1.7014865849061451,2117,2333,4450,-
chr16,19514560,2.006731234866828,726,825,1551,-
chr16,19514561,2.6855285799250925,890,873,1763,-
chr16,19514562,1.851890482398957,1059,1179,2238,-
chr16,19514564,1.8714934172193964,1708,1600,3308,-
chr16,19514565,1.9526039940393491,1781,1748,3529,-
chr16,19514566,1.9526039940393491,1781,1748,3529,-
chr16,19514567,2.308333333333333,830,731,1561,-
chr16,19514658,0.2800128825230535,994,735,1729,-
chr16,19516402,0.5564263322884012,993,615,1608,-
chr16,19519031,1.858751279426817,3177,1953,5130,-
chr16,19519037,1.6617796266233766,2684,1539,4223,-
chr16,19519068,2.1134456695097428,1243,873,2116,-
chr16,19519071,1.4851670242108488,2106,1254,3360,-
chr16,19519078,1.693612453032743,985,620,1605,-
chr16,19522165,0.43960064492124523,1250,732,1982,-
chr16,19522182,1.5510204081632653,968,594,1562,-
chr16,19522184,2.5711442786069654,1019,602,1621,-
chr16,19522185,2.5711442786069654,1019,602,1621,-
chr16,19522249,2.291692307692308,979,624,1603,-
chr16,19522250,2.291692307692308,979,624,1603,-
chr16,22357989,4.612832620177301,783,512,1295,-
chr16,22385574,1.5938144851155267,642,439,1081,-
chr16,23598605,0.3541844673292261,715,600,1315,-
chr16,23598629,1.5669614808370789,753,626,1379,-
chr16,23607473,1.573015703263697,1278,972,2250,-
chr16,23607516,1.9358876340270497,653,498,1151,-
chr16,23607595,2.960304054054054,700,443,1143,-
chr16,23607596,2.960304054054054,700,443,1143,-
chr16,23607616,4.7062766031578365,725,419,1144,-
chr16,27236516,2.8404300627236054,701,475,1176,-
chr16,27245545,3.2001590715695203,843,587,1430,-
chr16,27246601,1.8668831168831168,620,461,1081,-
chr16,27246602,2.354042214257268,1284,929,2213,-
chr16,27246604,2.232998225901833,1887,1334,3221,-
chr16,27246605,1.4784819439000711,2083,1415,3498,-
chr16,27246607,1.0663595617529882,1141,752,1893,-
chr16,28115961,2.4798927214228983,621,431,1052,-
chr16,28133073,0.8020904339922745,705,488,1193,-
chr16,28133074,1.1660725041182265,917,659,1576,-
chr16,28192312,2.2555233611010506,529,501,1030,-
chr16,28192313,1.9377541067377329,1090,922,2012,-
chr16,28192319,1.5678312251558595,873,639,1512,-
chr16,28222787,5.647777155243931,715,664,1379,-
chr16,28222788,6.636332469058928,879,742,1621,-
chr16,28222789,7.296555555555556,676,499,1175,-
chr16,28548865,2.476486041649274,738,626,1364,-
chr16,28549444,0.5012884618666484,772,760,1532,-
chr16,28549446,0.5012884618666484,772,760,1532,-
chr16,28549449,1.2640109534450443,569,473,1042,-
chr16,28550152,2.9435823092977924,685,502,1187,-
chr16,28550169,1.5640972339329586,867,619,1486,-
chr16,28550170,3.2361794724140025,691,475,1166,-
chr16,28854192,1.7922437673130194,646,493,1139,-
chr16,28854282,0.673877030901561,1281,729,2010,-
chr16,28854318,2.347953216374269,802,607,1409,-
chr16,28854342,1.613471322346393,904,792,1696,-
chr16,28854413,1.2759917580751132,1893,1470,3363,-
chr16,28855062,1.646043165467626,714,555,1269,-
chr16,28855120,2.560412224591329,654,602,1256,-
chr16,28855415,0.9994709414697999,1729,1378,3107,-
chr16,28855611,0.4922448979591835,602,454,1056,-
chr16,28855615,2.5471349353049906,635,540,1175,-
chr16,28855616,0.5874096097145644,1167,958,2125,-
chr16,28855626,1.7169825511432009,616,553,1169,-
chr16,28855639,2.6341982701264137,706,500,1206,-
chr16,28856100,1.580363431469221,862,686,1548,-
chr16,28856151,1.3127126403442069,3952,3008,6960,-
chr16,28856152,1.7212495708891176,2506,1941,4447,-
chr16,28856371,1.7590756558877363,1976,1191,3167,-
chr16,28856372,1.6206187410586552,1449,931,2380,-
chr16,28856646,0.623707561728395,1042,719,1761,-
chr16,28857234,1.2931948533732258,1532,1090,2622,-
chr16,28857235,1.069167458056347,964,584,1548,-
chr16,28857327,2.3629271924875748,1238,774,2012,-
chr16,28857401,1.9974697256224039,1252,962,2214,-
chr16,28857402,0.937908496732026,655,543,1198,-
chr16,29907159,3.0390823910271463,740,509,1249,-
chr16,30365357,0.9893457697186743,799,522,1321,-
chr16,30435110,2.0899049566904995,888,676,1564,-
chr16,30435195,2.740689175078316,761,506,1267,-
chr16,30435214,0.2979876160990712,714,441,1155,-
chr16,30435217,1.9088406240440503,623,466,1089,-
chr16,30435224,1.0850979749583787,1244,839,2083,-
chr16,30435255,2.4670912951167727,663,470,1133,-
chr16,30435257,2.73219491878384,983,685,1668,-
chr16,30435258,3.037998495109105,645,442,1087,-
chr16,30435409,1.05198409027842,668,568,1236,-
chr16,30435410,1.4845608864954618,1018,827,1845,-
chr16,30441259,11.057490113808104,2041,2031,4072,-
chr16,30441260,13.529347047030097,2593,2318,4911,-
chr16,30441261,12.610010092437033,2773,2419,5192,-
chr16,30441262,18.264323506268966,1831,1386,3217,-
chr16,30441269,8.383195331100016,868,349,1217,-
chr16,30441270,8.383195331100016,868,349,1217,-
chr16,30455190,1.0054347826086956,924,574,1498,-
chr16,30455192,1.0054347826086956,924,574,1498,-
chr16,30455361,2.334986772486773,613,431,1044,-
chr16,30455408,3.815396827712296,951,853,1804,-
chr16,30455425,2.071397756686799,581,487,1068,-
chr16,30456339,3.0662147196697696,735,567,1302,-
chr16,30456340,3.3548336063728175,711,485,1196,-
chr16,31102281,1.8665936815764783,769,555,1324,-
chr16,31102301,1.7643784786641927,950,692,1642,-
chr16,31102347,1.653048525159088,1299,826,2125,-
chr16,31102422,1.6020671834625322,898,521,1419,-
chr16,31102485,1.911100256441568,625,430,1055,-
chr16,31102560,0.5728692473832863,1188,925,2113,-
chr16,31104655,0.6621142544433606,772,688,1460,-
chr16,31104677,0.45503417530767837,1383,1157,2540,-
chr16,31104686,0.6397880619256561,643,513,1156,-
chr16,31104702,3.3926020619883817,1547,1358,2905,-
chr16,31104703,5.243161094224924,574,516,1090,-
chr16,31104715,3.5768346085757248,983,727,1710,-
chr16,31106053,0.49059475916059575,751,540,1291,-
chr16,31106055,0.833302609610321,999,764,1763,-
chr16,31106062,1.3896987199321575,846,570,1416,-
chr16,35036978,0.7504474551667796,1041,886,1927,-
chr16,35036979,0.9054310344827586,777,579,1356,-
chr16,46652265,1.2987138830162086,640,472,1112,-
chr16,46652266,1.056806564600572,825,602,1427,-
chr16,46652267,1.2987138830162086,640,472,1112,-
chr16,46693897,1.9375969396212955,1021,828,1849,-
chr16,46694475,2.2085717113075605,836,648,1484,-
chr16,46695719,1.676346991511039,1030,772,1802,-
chr16,46695739,4.0923996913580245,763,529,1292,-
chr16,46696238,0.3961810084337966,773,622,1395,-
chr16,46696909,2.1476190476190475,655,419,1074,-
chr16,46696972,1.9774305555555556,1138,863,2001,-
chr16,46696973,1.9774305555555556,1138,863,2001,-
chr16,46702889,2.6744116121810984,1234,992,2226,-
chr16,46702890,2.888310185185185,712,539,1251,-
chr16,46708308,1.8820297951582867,696,536,1232,-
chr16,46714686,1.15678914614131,1209,819,2028,-
chr16,46714695,2.0057425213675213,652,415,1067,-
chr16,46717432,2.5587237916133163,665,471,1136,-
chr16,46990604,3.5304960693955003,813,433,1246,-
chr16,46990606,3.5304960693955003,813,433,1246,-
chr16,46990677,0.5947136563876653,593,453,1046,-
chr16,46990781,3.102517985611511,620,416,1036,-
chr16,46992940,2.01077337437476,870,564,1434,-
chr16,46992974,0.6211610857935407,626,514,1140,-
chr16,46992980,1.925648979179645,1153,761,1914,-
chr16,46992987,1.947732788499842,1523,976,2499,-
chr16,46992988,2.063363696956232,987,642,1629,-
chr16,46998558,1.5625386231615377,1555,1043,2598,-
chr16,46998559,0.5841247342310418,633,414,1047,-
chr16,46998565,0.8651250104814687,4510,2513,7023,-
chr16,46998566,0.6197276560447916,3201,1701,4902,-
chr16,46998567,1.4458734324876057,1152,634,1786,-
chr16,46998600,1.850496031746032,810,419,1229,-
chr16,46998603,1.8143209323173464,770,387,1157,-
chr16,46998605,3.170588235294118,734,424,1158,-
chr16,46998623,4.732962079024132,775,418,1193,-
chr16,46998647,5.248100303951368,726,328,1054,-
chr16,46998703,1.179483112827677,694,438,1132,-
chr16,47005338,2.3797905113986446,567,540,1107,-
chr16,47005339,2.7043618891158183,881,825,1706,-
chr16,47005368,3.6415057608858423,1354,930,2284,-
chr16,47005461,2.3324154713114758,2555,2047,4602,-
chr16,47005465,1.7291587623650768,2418,1836,4254,-
chr16,47005471,1.7602426116429803,2165,1505,3670,-
chr16,47005822,1.4461848862802642,1545,939,2484,-
chr16,47005828,1.7211034482758618,1467,869,2336,-
chr16,47005829,2.10063849194284,1322,758,2080,-
chr16,47005830,0.6218604369666525,1369,1208,2577,-
chr16,47005833,2.851272534464475,1194,655,1849,-
chr16,47005841,1.4855292450920867,1100,548,1648,-
chr16,47005846,1.8259599634162753,1988,1429,3417,-
chr16,47005855,0.5031080031080031,1553,890,2443,-
chr16,47005856,0.47234702243051807,2329,1264,3593,-
chr16,47005860,1.4273079111468938,2054,1532,3586,-
chr16,47005862,1.7759464232457394,1831,1414,3245,-
chr16,47007409,1.9140001812907903,1156,787,1943,-
chr16,47007410,1.35855620393813,2122,1525,3647,-
chr16,47007411,0.7252066452549031,966,738,1704,-
chr16,47007412,0.7252066452549031,966,738,1704,-
chr16,47007418,2.3255242743250633,1128,658,1786,-
chr16,47007419,2.3381377259208422,1021,563,1584,-
chr16,47007421,2.24024334251607,672,362,1034,-
chr16,47345163,2.5025919732441477,906,519,1425,-
chr16,47345165,2.5025919732441477,906,519,1425,-
chr16,47347664,1.8706337314790515,2722,2247,4969,-
chr16,47347692,1.84224468455908,1148,754,1902,-
chr16,47347712,1.749441825849665,859,694,1553,-
chr16,47347717,0.6271245121490622,796,610,1406,-
chr16,47494781,0.45093728576026604,564,466,1030,-
chr16,54952943,2.043354058141489,759,540,1299,-
chr16,56463947,4.986022269604359,618,468,1086,-
chr16,56463948,4.986022269604359,618,468,1086,-
chr16,56464037,1.6240764660294498,805,552,1357,-
chr16,56464486,1.8557173403930352,674,426,1100,-
chr16,56464913,2.046936523688994,656,518,1174,-
chr16,56464932,3.1364328088204085,1412,1053,2465,-
chr16,56465010,1.1502307264305158,685,511,1196,-
chr16,56465757,2.733296400594568,966,747,1713,-
chr16,56465897,1.8797595190380765,736,498,1234,-
chr16,56466508,3.5576923076923075,639,511,1150,-
chr16,56466604,1.7886792452830187,631,476,1107,-
chr16,56466638,1.5714600066013864,1034,744,1778,-
chr16,56468337,2.7497874149659864,994,671,1665,-
chr16,56468670,2.66146701595618,720,493,1213,-
chr16,56480555,0.6133000065776492,887,660,1547,-
chr16,56480586,2.5885733603786343,740,521,1261,-
chr16,56481762,1.9609838846480068,1019,654,1673,-
chr16,56481766,1.7740067584829884,1623,1269,2892,-
chr16,56481799,1.856113761811208,639,508,1147,-
chr16,56481830,2.2510840108401085,897,491,1388,-
chr16,56481868,2.789855072463768,734,413,1147,-
chr16,56481884,2.927991188214236,867,806,1673,-
chr16,56481886,2.0433079360864004,1435,1271,2706,-
chr16,56485058,2.5995906863836624,1030,719,1749,-
chr16,56485059,2.8522475027746945,622,423,1045,-
chr16,56485095,0.1573941890504697,661,443,1104,-
chr16,57187871,2.5138386653132065,851,672,1523,-
chr16,57188048,2.408078994614004,788,556,1344,-
chr16,57188049,2.408078994614004,788,556,1344,-
chr16,57188348,3.4724293898391507,663,398,1061,-
chr16,57462883,2.299031476997579,632,412,1044,-
chr16,57462884,2.299031476997579,632,412,1044,-
chr16,57466469,3.1703393135725437,928,640,1568,-
chr16,57466470,3.1703393135725437,928,640,1568,-
chr16,57468025,0.3178025812733591,735,564,1299,-
chr16,57474704,3.1173756774982597,655,398,1053,-
chr16,57792257,2.6931752159593505,597,460,1057,-
chr16,57792258,2.930432690473915,987,855,1842,-
chr16,57792515,26.52460227227783,782,632,1414,-
chr16,57792516,26.524602272277836,782,632,1414,-
chr16,57795062,1.3219692400287968,782,656,1438,-
chr16,57795376,2.2642895143555557,729,492,1221,-
chr16,57796066,0.7737234652897303,612,497,1109,-
chr16,57796067,0.7737234652897303,612,497,1109,-
chr16,57799449,3.388989795130862,717,500,1217,-
chr16,57800865,2.8970783904175956,1020,738,1758,-
chr16,57803860,0.7323075168419737,671,611,1282,-
chr16,58150834,2.32444750489147,614,454,1068,-
chr16,58194375,1.6704777671165745,655,483,1138,-
chr16,58194390,1.9191118160190328,549,484,1033,-
chr16,58194391,1.9191118160190328,549,484,1033,-
chr16,58194392,1.9191118160190328,549,484,1033,-
chr16,58554682,0.6682235055782407,601,488,1089,-
chr16,58555197,0.2850187988045888,656,450,1106,-
chr16,58555199,0.2850187988045888,656,450,1106,-
chr16,58557359,2.7788289304612253,664,397,1061,-
chr16,58559943,2.834706489328825,835,574,1409,-
chr16,58577644,2.092278291926972,774,532,1306,-
chr16,58580357,2.3867710465724983,1934,1234,3168,-
chr16,58580367,1.4240834644751412,921,601,1522,-
chr16,58585090,1.575535196784145,910,562,1472,-
chr16,58585098,0.7647297242820146,2462,1543,4005,-
chr16,58585100,0.4581219456419551,1802,1168,2970,-
chr16,58741112,1.4482179951373406,1351,1083,2434,-
chr16,58741492,1.5585919209977441,795,572,1367,-
chr16,58741528,2.56058527663466,699,485,1184,-
chr16,58741599,1.958628198149156,770,500,1270,-
chr16,58741642,3.7653556020781527,1046,828,1874,-
chr16,58741807,1.590316989992732,861,576,1437,-
chr16,58741869,2.243478260869565,601,459,1060,-
chr16,58742049,0.9161873068695032,802,600,1402,-
chr16,58742051,0.9161873068695032,802,600,1402,-
chr16,58742156,0.6104651162790697,699,399,1098,-
chr16,58742186,1.129558623963379,774,587,1361,-
chr16,58743382,1.4149324329785646,1513,1120,2633,-
chr16,58750062,0.5192841715519902,560,462,1022,-
chr16,58752201,1.432253393044757,1976,1632,3608,-
chr16,58752202,1.432253393044757,1976,1632,3608,-
chr16,58752203,0.48162143593266904,700,425,1125,-
chr16,58752482,2.065660733231168,648,498,1146,-
chr16,58753105,2.1303674192120403,549,501,1050,-
chr16,58756147,1.4273895633517082,730,538,1268,-
chr16,58756160,0.9329446064139942,703,538,1241,-
chr16,58756161,0.9329446064139942,703,538,1241,-
chr16,58757709,1.255861558153039,592,445,1037,-
chr16,61089356,2.4686868686868686,563,593,1156,-
chr16,61089358,1.8969764446792297,1886,1674,3560,-
chr16,61089360,1.6220607832179856,1323,1081,2404,-
chr16,61089365,0.505528804048324,1361,910,2271,-
chr16,61089369,1.221732092270336,1040,705,1745,-
chr16,61089370,1.221732092270336,1040,705,1745,-
chr16,61089371,1.221732092270336,1040,705,1745,-
chr16,66755378,0.3132756132756132,667,615,1282,-
chr16,66755379,0.3132756132756132,667,615,1282,-
chr16,66755431,5.377049329819378,941,955,1896,-
chr16,66755432,6.2387115101199555,658,607,1265,-
chr16,66755438,4.913012172089115,775,548,1323,-
chr16,66755439,6.942253121893425,1029,771,1800,-
chr16,66756833,5.9229538275203035,686,631,1317,-
chr16,66757121,7.939224159508668,793,820,1613,-
chr16,66766247,0.505034259613682,1273,829,2102,-
chr16,66766248,0.4934896718993029,1171,768,1939,-
chr16,66842949,1.8779546397125149,1069,771,1840,-
chr16,66844665,0.388401042169256,804,481,1285,-
chr16,66847536,1.7978494623655914,835,619,1454,-
chr16,66850491,2.8058844849539746,1758,1348,3106,-
chr16,66860661,1.6773932563087455,1168,884,2052,-
chr16,66860663,0.8556163021868788,625,502,1127,-
chr16,66966059,2.8378148400272294,666,451,1117,-
chr16,66966072,4.04375,646,479,1125,-
chr16,66966078,0.33374036265638773,1228,1050,2278,-
chr16,66966200,0.2957591738079543,672,443,1115,-
chr16,66966692,2.2563559322033897,567,471,1038,-
chr16,66967554,0.3,737,539,1276,-
chr16,66967626,4.696511627906977,576,429,1005,-
chr16,66967964,1.2171546071836923,1107,933,2040,-
chr16,66968149,2.4280217137359994,954,538,1492,-
chr16,66968151,2.4280217137359994,954,538,1492,-
chr16,66968163,2.878103837471783,824,442,1266,-
chr16,66968164,2.878103837471783,824,442,1266,-
chr16,66968228,0.6640813741035384,558,510,1068,-
chr16,66968229,0.6536710037174722,520,537,1057,-
chr16,66968231,0.7882131663965213,518,489,1007,-
chr16,67182281,2.0511695906432745,914,569,1483,-
chr16,67182353,0.31136102979341845,875,475,1350,-
chr16,67182357,5.695226226016182,1041,590,1631,-
chr16,68335105,0.737177177177177,968,554,1522,-
chr16,68335106,0.737177177177177,968,554,1522,-
chr16,68335107,1.2300187437421448,1261,787,2048,-
chr16,69152012,0.26843448687326027,512,934,1446,-
chr16,69152013,1.2560017806607522,394,952,1346,-
chr16,69152014,2.684255375034871,606,991,1597,-
chr16,69152015,3.657267451759185,1389,2276,3665,-
chr16,69152016,5.958853094384256,652,966,1618,-
chr16,69152022,2.10016155088853,439,618,1057,-
chr16,69152023,11.617794101696777,1503,1510,3013,-
chr16,69152024,12.900292052765547,1702,1535,3237,-
chr16,69152025,17.56644706350496,1116,854,1970,-
chr16,69154145,2.6466259678587347,647,441,1088,-
chr16,69154151,2.3168534287268634,1128,698,1826,-
chr16,69154385,3.6349328121174866,542,468,1010,-
chr16,69154510,0.45618042816939924,575,437,1012,-
chr16,69419766,0.6321327881401819,1596,540,2136,-
chr16,69419767,0.6321327881401819,1596,540,2136,-
chr16,69744984,1.1273055902445834,4152,2890,7042,-
chr16,69745028,2.0980675507197097,1254,1037,2291,-
chr16,69745155,0.6818995773941694,1359,1213,2572,-
chr16,69747027,1.71898090059947,1146,796,1942,-
chr16,69748882,0.6078187594971681,999,634,1633,-
chr16,69748944,3.6636952998379257,821,616,1437,-
chr16,69752098,1.5093567251461988,1156,854,2010,-
chr16,69752135,1.3927616330896773,1763,1105,2868,-
chr16,69752154,3.504390661811952,908,666,1574,-
chr16,69752388,1.6349033106652116,1269,830,2099,-
chr16,69752424,1.897342365815529,992,605,1597,-
chr16,69752431,1.326513145188203,1671,1197,2868,-
chr16,69752432,0.974390243902439,798,655,1453,-
chr16,69752435,2.348742903487429,723,410,1133,-
chr16,69760452,3.3718004068598337,713,391,1104,-
chr16,69775902,0.411688790560472,608,451,1059,-
chr16,69775944,0.5899750605922232,883,580,1463,-
chr16,69776379,1.854321050628543,664,442,1106,-
chr16,69783487,2.473239436619718,877,567,1444,-
chr16,69783488,2.473239436619718,877,567,1444,-
chr16,69786259,0.3726302776701456,669,609,1278,-
chr16,70286273,1.128502302431992,1271,1071,2342,-
chr16,70286379,1.388443797038116,1633,1372,3005,-
chr16,70286424,0.7574864458191025,1801,1404,3205,-
chr16,70286466,0.6638888888888889,1672,1259,2931,-
chr16,70286512,1.4765289571605764,1085,891,1976,-
chr16,70286544,1.578034112195603,1207,965,2172,-
chr16,70286550,1.5857920113239263,1194,961,2155,-
chr16,70286560,0.6729141767381907,2322,1787,4109,-
chr16,70286592,1.090224101694818,2060,1558,3618,-
chr16,70286598,1.841901603095633,685,602,1287,-
chr16,70286628,2.163763066202091,827,737,1564,-
chr16,70286632,0.6476735015772871,729,633,1362,-
chr16,70286664,3.952702702702703,584,443,1027,-
chr16,70287198,0.6787679017958627,1613,1059,2672,-
chr16,70287211,1.6796063422635321,1583,1022,2605,-
chr16,70287255,1.5461979660598453,3172,2311,5483,-
chr16,70287277,0.5748226916210077,2152,1656,3808,-
chr16,70287279,2.4145299145299144,1129,863,1992,-
chr16,70287883,1.4299065420560748,1478,1176,2654,-
chr16,70287903,1.2482469793482982,3640,2662,6302,-
chr16,70287906,1.9924066325739964,1117,716,1833,-
chr16,70287909,2.120159932659933,774,703,1477,-
chr16,70288542,1.5949815837937384,1413,904,2317,-
chr16,70288609,0.9938224828676859,2622,1896,4518,-
chr16,70288610,0.9938224828676859,2622,1896,4518,-
chr16,70288630,0.4941079271209288,1032,792,1824,-
chr16,70289718,2.7036048064085447,989,748,1737,-
chr16,70289728,1.9865156973751932,918,669,1587,-
chr16,70289730,1.7575757575757576,927,591,1518,-
chr16,70291998,1.4915646389665476,966,758,1724,-
chr16,70292931,1.432281591882036,1456,1189,2645,-
chr16,70292971,1.4638479487125413,13109,9337,22446,-
chr16,70293000,1.3906637668551545,3097,2298,5395,-
chr16,70293003,1.3230852255371142,5552,4024,9576,-
chr16,70293004,1.1491031989872775,7898,5683,13581,-
chr16,70293011,1.6131991381761706,4068,2487,6555,-
chr16,70293012,1.6131991381761706,4068,2487,6555,-
chr16,70295007,1.6878078241119783,2668,1949,4617,-
chr16,70296297,1.1437103464260905,2750,2187,4937,-
chr16,70296321,1.6976873009278493,942,746,1688,-
chr16,70296382,1.5725658297611758,1390,922,2312,-
chr16,70296384,1.5115303983228512,1235,953,2188,-
chr16,70298954,1.6991726673816456,1622,1283,2905,-
chr16,70298965,0.6596059348313535,891,821,1712,-
chr16,70298973,2.700832799487508,2386,1560,3946,-
chr16,70298974,4.077504524634701,5475,4202,9677,-
chr16,70299001,0.8345086169409681,4630,3289,7919,-
chr16,70299002,0.639985380116959,2368,1655,4023,-
chr16,70299507,1.5663406801926727,1021,805,1826,-
chr16,70301573,1.6436456802682642,1557,982,2539,-
chr16,70301596,0.6479236912156167,1780,1224,3004,-
chr16,70302234,1.686746987951807,2260,1614,3874,-
chr16,70302235,1.686746987951807,2260,1614,3874,-
chr16,70302237,1.0314318520187593,2400,1649,4049,-
chr16,70302246,1.8924127043090642,1044,672,1716,-
chr16,70302263,1.6849409448818893,1006,634,1640,-
chr16,70302265,0.4520475926950747,960,694,1654,-
chr16,70303552,2.2093153759820425,761,593,1354,-
chr16,70305782,1.915879953379953,1398,857,2255,-
chr16,70305788,1.450909090909091,1364,824,2188,-
chr16,70305834,1.4229113924050634,1248,947,2195,-
chr16,70310400,0.43125,1004,799,1803,-
chr16,70310955,1.5290949711268456,2246,1882,4128,-
chr16,70310958,2.1183752063084538,1358,860,2218,-
chr16,70310959,0.5586369593709043,887,762,1649,-
chr16,70310990,1.686965146130476,2680,1896,4576,-
chr16,70311054,1.5489989462592202,1139,948,2087,-
chr16,70316529,1.5306563706563705,1165,924,2089,-
chr16,70316651,1.3034263511126811,2807,2830,5637,-
chr16,70316675,0.6566887011938739,1803,1738,3541,-
chr16,70323329,0.732741458165187,1237,1238,2475,-
chr16,70323340,8.218226300090546,10193,8350,18543,-
chr16,70323341,8.218226300090546,10193,8350,18543,-
chr16,70323342,9.111516643000924,6523,5709,12232,-
chr16,70323348,2.2041738350201783,1813,1106,2919,-
chr16,70323351,2.236923794411414,3788,2504,6292,-
chr16,70323362,1.4181880921011356,852,461,1313,-
chr16,70323390,1.449889946439415,1228,711,1939,-
chr16,70323411,0.4084321887294104,640,430,1070,-
chr16,70515684,4.454574710759017,691,425,1116,-
chr16,70534922,0.9237809826825598,830,602,1432,-
chr16,70543917,2.182354041916168,932,667,1599,-
chr16,70546166,1.6460898108265487,2643,1660,4303,-
chr16,70546167,1.5939280673323226,2750,1738,4488,-
chr16,70546169,1.7167371512953364,5460,3195,8655,-
chr16,70546170,1.7560625917287709,4541,2620,7161,-
chr16,70546171,1.7560625917287709,4541,2620,7161,-
chr16,70546175,1.6060179257362357,677,354,1031,-
chr16,70546202,0.521433718344068,1043,498,1541,-
chr16,70546263,1.8277906377811903,686,336,1022,-
chr16,70834767,0.7517023045723321,735,424,1159,-
chr16,74487192,1.7574424319215751,1232,776,2008,-
chr16,74487193,1.8948732718894006,773,433,1206,-
chr16,74501710,4.0362545644235786,618,425,1043,-
chr16,74501711,4.0362545644235786,618,425,1043,-
chr16,74503934,1.9252440725244069,811,477,1288,-
chr16,74503935,1.9252440725244069,811,477,1288,-
chr16,74503959,4.001412221416208,627,433,1060,-
chr16,74519752,2.1903881256709954,1127,1001,2128,-
chr16,74519798,3.3488694960914573,652,471,1123,-
chr16,74519811,4.162027531317261,641,492,1133,-
chr16,74524914,2.538083864118896,616,470,1086,-
chr16,74524915,2.8339340541983717,922,680,1602,-
chr16,74524917,3.371194824961948,610,437,1047,-
chr16,74734425,2.435764680444776,1240,858,2098,-
chr16,74734426,3.185988103106411,617,444,1061,-
chr16,74734427,3.185988103106411,617,444,1061,-
chr16,75661740,2.017564966313763,1676,1038,2714,-
chr16,75661830,1.7077537898238484,1470,952,2422,-
chr16,75661854,1.9582417582417584,755,636,1391,-
chr16,75662477,1.8490495012234145,613,482,1095,-
chr16,75662508,2.396510066122968,1903,1326,3229,-
chr16,75663348,0.5969781066913352,1759,1080,2839,-
chr16,75663428,0.6473930084326379,1054,870,1924,-
chr16,75664341,1.5803791283955442,878,730,1608,-
chr16,75664343,1.468723433429316,2185,1429,3614,-
chr16,75664344,1.468723433429316,2185,1429,3614,-
chr16,75664395,1.9072342743033486,617,478,1095,-
chr16,75665349,2.8545119705340696,619,542,1161,-
chr16,75665363,1.635449670972459,1166,745,1911,-
chr16,75665374,1.5150075668404237,878,625,1503,-
chr16,75665375,1.6221941638608306,745,593,1338,-
chr16,75665618,1.4843051071609163,794,546,1340,-
chr16,75665718,1.7163166923231903,3495,2517,6012,-
chr16,75665721,2.8810513810513814,668,517,1185,-
chr16,75668097,0.6074038254889318,664,516,1180,-
chr16,75669853,1.9880552356988992,2178,1764,3942,-
chr16,75669962,1.6090885416666667,1260,799,2059,-
chr16,75670442,2.8401073281791582,1253,977,2230,-
chr16,75674140,2.4921316165951364,669,465,1134,-
chr16,75674235,1.6531473348833203,661,552,1213,-
chr16,75674246,1.898800208659364,909,567,1476,-
chr16,75675501,2.471869976781568,864,508,1372,-
chr16,75681511,3.2927860424725286,1080,689,1769,-
chr16,75681536,2.5472033145901154,2415,871,3286,-
chr16,75681538,2.5472033145901154,2415,871,3286,-
chr16,75681550,2.2413790925024495,1499,810,2309,-
chr16,75681562,0.8173015088638843,2458,967,3425,-
chr16,81010069,0.9652287581699346,922,764,1686,-
chr16,81010071,0.9652287581699346,922,764,1686,-
chr16,81031000,0.8898796433764529,1671,1350,3021,-
chr16,81031002,0.5108328479906814,1252,1009,2261,-
chr16,81031017,3.223266499582289,670,398,1068,-
chr16,81031021,1.728578230698806,953,609,1562,-
chr16,84087697,0.3521034539204452,716,595,1311,-
chr16,84087699,0.3783135856358259,1102,850,1952,-
chr16,84096962,2.578744479573756,599,421,1020,-
chr16,84101323,1.739010778914045,631,399,1030,-
chr16,84101958,2.614603174603175,567,449,1016,-
chr16,84101959,2.614603174603175,567,449,1016,-
chr16,84101963,0.9696818864750059,1066,772,1838,-
chr16,84101964,0.5105813136635055,801,583,1384,-
chr16,84103515,3.6344779732073365,575,473,1048,-
chr16,84108255,3.9484476014883207,620,490,1110,-
chr16,84125437,0.963040499880938,3374,2662,6036,-
chr16,84125446,2.506750465549348,1779,1431,3210,-
chr16,84125448,2.506750465549348,1779,1431,3210,-
chr16,84126853,1.66798418972332,632,505,1137,-
chr16,84126870,2.126152312703117,1189,776,1965,-
chr16,84126871,2.3603016010910847,1376,881,2257,-
chr16,84135581,1.1095985691573926,858,543,1401,-
chr16,84135582,1.1095985691573926,858,543,1401,-
chr16,84599373,1.2274802583769109,1093,571,1664,-
chr16,84599374,1.728713768789728,835,487,1322,-
chr16,84623726,2.933653827024164,887,498,1385,-
chr16,84623735,2.0564143629241394,756,420,1176,-
chr16,84623822,2.743961382453312,943,718,1661,-
chr16,84623823,2.476661792824204,733,522,1255,-
chr16,85711603,2.4559080590868447,735,602,1337,-
chr16,85711920,1.541933645361405,646,383,1029,-
chr16,85721161,0.3756303832611054,643,433,1076,-
chr16,85813152,1.074667344690228,633,436,1069,-
chr16,85813153,1.074667344690228,633,436,1069,-
chr16,87441222,2.5826155655537533,925,565,1490,-
chr16,87863681,39.746220711094224,17676,14666,32342,-
chr16,87863682,43.053790321806986,19022,14976,33998,-
chr16,87863683,35.72937097096071,14666,7780,22446,-
chr16,87863684,21.67766387076732,4056,1072,5128,-
chr16,87863685,5.446585378092228,6384,948,7332,-
chr16,87863686,6.718898439582917,10574,1950,12524,-
chr16,87863688,6.003867284331136,15344,2874,18218,-
chr16,87863689,6.032953595310275,9715,1846,11561,-
chr16,87863731,0.49782480893592,2189,944,3133,-
chr16,87863759,0.6286944326090045,3978,2346,6324,-
chr16,87863760,0.6286944326090045,3978,2346,6324,-
chr16,87863774,1.974166157944392,1394,973,2367,-
chr16,87863799,1.3962278106508874,1316,1039,2355,-
chr16,87863896,1.2768516711733058,3413,2473,5886,-
chr16,87864122,0.8269275212310901,5101,4029,9130,-
chr16,87864123,0.7939452929386176,8896,6380,15276,-
chr16,87864124,0.8099508443617305,7561,5422,12983,-
chr16,87864126,0.5668167060212516,1137,846,1983,-
chr16,87864163,2.1331775700934577,1493,855,2348,-
chr16,87864192,1.0989407776760847,2350,1836,4186,-
chr16,87864197,1.4544043690083293,1104,908,2012,-
chr16,87864239,1.6281625697990978,2668,1756,4424,-
chr16,87864347,1.5269686411149823,1327,1147,2474,-
chr16,87864361,1.5197199383350464,1202,972,2174,-
chr16,87864496,0.4768939059881824,1029,781,1810,-
chr16,87864536,1.6183949795025372,4305,2649,6954,-
chr16,87864538,1.5451589889930697,3125,1783,4908,-
chr16,87864539,1.7886513157894741,2174,1503,3677,-
chr16,87864540,1.7886513157894741,2174,1503,3677,-
chr16,87864582,1.8246282591786327,2745,1664,4409,-
chr16,87864585,1.5971669907985253,1447,732,2179,-
chr16,87864708,0.5265159599696452,2650,2007,4657,-
chr16,87864709,0.5265159599696452,2650,2007,4657,-
chr16,87864710,0.64891846921797,1637,1201,2838,-
chr16,87864745,1.882566700439041,1908,1174,3082,-
chr16,87864754,1.430469788165403,1524,1162,2686,-
chr16,87864869,1.3800438596491231,1797,1439,3236,-
chr16,87864947,1.541751192499589,1849,1494,3343,-
chr16,87864966,0.7387057387057387,1231,1091,2322,-
chr16,87864971,1.5503667096855358,4533,3369,7902,-
chr16,87864972,1.6040270170662914,4146,3061,7207,-
chr16,87864974,1.6112201369693098,4266,3015,7281,-
chr16,87864980,1.7928738538728155,5258,3489,8747,-
chr16,87864981,1.7928738538728155,5258,3489,8747,-
chr16,87864998,1.5252546561388705,2353,1411,3764,-
chr16,87864999,1.624365209627336,3313,2079,5392,-
chr16,87865060,4.515708358032009,585,481,1066,-
chr16,87865087,1.8966044415835213,872,477,1349,-
chr16,87865213,1.9073456790123453,1165,899,2064,-
chr16,87865231,1.6495905900234864,2169,1735,3904,-
chr16,87865244,0.995495539456067,2127,1375,3502,-
chr16,87865258,2.336597828401107,877,426,1303,-
chr16,87865389,1.715553847631857,1940,1486,3426,-
chr16,87865395,1.3330220341456298,1802,1334,3136,-
chr16,87865420,1.4465830051889743,1267,936,2203,-
chr16,87865536,1.4166598954524523,1432,1190,2622,-
chr16,87865549,1.4512866385475354,3002,2011,5013,-
chr16,87865584,1.9596747967479675,1047,819,1866,-
chr16,87865680,1.6939078751857355,1439,672,2111,-
chr16,87865804,0.770137437306442,2430,1740,4170,-
chr16,87865817,1.7892883345561263,1741,1362,3103,-
chr16,87865823,1.5375439994686857,1866,1194,3060,-
chr16,87865833,1.7263333598283126,1760,1093,2853,-
chr16,87865863,1.3819297972046911,1753,1006,2759,-
chr16,87865930,0.5879037143645633,6094,8601,14695,-
chr16,87865931,0.5732267832524091,4715,6650,11365,-
chr16,87865976,9.595880495524947,9003,11452,20455,-
chr16,87865977,9.595880495524947,9003,11452,20455,-
chr16,87865985,4.606242787702289,3501,2658,6159,-
chr16,87865986,4.414157726423693,10274,6795,17069,-
chr16,87865988,4.250174033259491,8526,5431,13957,-
chr16,87865992,7.960256158849026,4055,1975,6030,-
chr16,87865993,16.69289256198347,2303,1209,3512,-
chr16,87865994,10.660057844903799,13442,5125,18567,-
chr16,87865995,11.534265169678402,11423,4100,15523,-
chr16,87865996,10.414474552982691,7195,2236,9431,-
chr16,87866174,2.5167375570331063,3361,2711,6072,-
chr16,87866184,1.3924980047885078,2180,1252,3432,-
chr16,87866260,1.7635385810014086,1459,1198,2657,-
chr16,87866323,1.459772558228812,6110,4659,10769,-
chr16,87866351,1.9932417565146323,1837,1096,2933,-
chr16,87866419,1.0926130137042578,2664,2050,4714,-
chr16,87866420,1.866484024293636,1853,1081,2934,-
chr16,87866523,1.4834264432029791,1137,1073,2210,-
chr16,87866532,1.5684556407447974,2147,1220,3367,-
chr16,87866609,1.3960776518916054,2217,1676,3893,-
chr16,87866630,1.5072454119787853,2190,1668,3858,-
chr16,87868050,0.6002608695652174,1533,1149,2682,-
chr16,87868053,1.288412047019545,2096,1306,3402,-
chr16,87868072,1.030328647772057,3303,2267,5570,-
chr16,87868171,1.4487644745689847,4557,3187,7744,-
chr16,87870212,1.5993738621475848,1879,1506,3385,-
chr16,87871457,1.1464483887790309,3434,2685,6119,-
chr16,87871490,1.2849268140766117,1617,1234,2851,-
chr16,87871493,1.6538461538461537,1547,1169,2716,-
chr16,87871496,1.7091991970540856,4015,3198,7213,-
chr16,87871497,1.764189116160934,2950,2176,5126,-
chr16,87872395,1.5607427846968456,1634,1218,2852,-
chr16,87872412,1.8578539182775784,1604,1140,2744,-
chr16,87873335,1.375,2111,1343,3454,-
chr16,87873359,1.226462387154538,3182,2484,5666,-
chr16,87874687,1.4215296174909162,2360,1948,4308,-
chr16,87874744,1.2497641124119772,6726,5246,11972,-
chr16,87885364,1.7321227241483392,5105,3669,8774,-
chr16,87885382,1.5608132046516259,8127,4896,13023,-
chr16,87885383,1.382968792594758,7834,4967,12801,-
chr16,87885400,1.7806724845995894,1849,973,2822,-
chr16,87885403,0.7186526539408238,1435,988,2423,-
chr16,87885436,1.2336938482085986,4590,2767,7357,-
chr16,87885437,1.631953428201811,2000,1545,3545,-
chr16,87885438,0.9453194916771077,3017,1923,4940,-
chr16,87885439,1.7768769115134981,2887,2221,5108,-
chr16,87902557,2.412854030501089,885,407,1292,-
chr16,87902558,2.5556967009534883,1362,676,2038,-
chr16,87902670,1.045880568487686,1509,1310,2819,-
chr16,87902672,1.2051738662095262,2911,2148,5059,-
chr16,87902694,1.5748839456276673,3429,2571,6000,-
chr16,87902696,1.6673093101514302,2113,1782,3895,-
chr16,87902723,1.5794238683127573,807,647,1454,-
chr16,87902727,3.89043271139341,783,457,1240,-
chr16,87902741,1.5266925005698655,727,534,1261,-
chr16,87902747,1.8729423575223418,1533,1038,2571,-
chr16,87902748,1.9100809298788768,1152,721,1873,-
chr16,87902870,1.811607554122524,873,667,1540,-
chr16,87902873,1.7272727272727275,824,604,1428,-
chr16,87902882,1.5927927927927927,747,554,1301,-
chr16,87902897,2.216761363636364,866,439,1305,-
chr16,87902898,0.48686197523406827,619,472,1091,-
chr16,87902940,1.898573536645352,918,534,1452,-
chr16,87902954,2.0121517486662714,656,481,1137,-
chr16,87902958,1.9032716927453772,668,554,1222,-
chr16,87902973,1.8379849449913144,1344,784,2128,-
chr16,87902975,1.8379849449913144,1344,784,2128,-
chr16,87903030,0.9632822830891458,3072,2417,5489,-
chr16,87903032,0.9632822830891458,3072,2417,5489,-
chr16,87903039,1.6915360501567398,1253,956,2209,-
chr16,87903049,1.596463982797754,1027,760,1787,-
chr16,87903052,1.7807948442534909,941,664,1605,-
chr16,87903056,1.9005426666512903,1381,911,2292,-
chr16,87903061,1.815856777493606,780,505,1285,-
chr16,87903110,0.44065364284515235,1075,857,1932,-
chr16,87903112,0.4902632469980853,1433,1212,2645,-
chr16,88709762,2.3445306428513315,861,523,1384,-
chr16,88709792,1.078930389275217,601,480,1081,-
chr16,88709794,1.078930389275217,601,480,1081,-
chr16,88709817,0.5319314641744548,682,320,1002,-
chr16,88709959,1.907365833509383,24198,16476,40674,-
chr16,88709965,2.3897445100354195,5572,4234,9806,-
chr16,88712526,0.8076120543408455,15183,8952,24135,-
chr16,88712530,0.972399487686704,10374,7276,17650,-
chr16,88712533,1.4637099439380377,4428,2041,6469,-
chr16,88712546,1.2110827141272873,11736,7412,19148,-
chr16,88712568,1.425188254512132,2292,1320,3612,-
chr16,88712573,1.3236643723369386,1969,1129,3098,-
chr16,88713164,1.6687449173217677,1457,1053,2510,-
chr16,88713170,3.182253153545019,2479,1671,4150,-
chr16,88713186,1.7271062271062272,1352,1000,2352,-
chr16,88713190,1.6299122347393242,2102,1387,3489,-
chr16,88713192,2.514520304157903,1218,882,2100,-
chr16,88713213,1.8680143646854697,984,750,1734,-
chr16,88713237,1.4885017421602789,889,699,1588,-
chr16,88713532,1.5197860962566847,811,594,1405,-
chr16,88713553,1.9053992395437267,695,525,1220,-
chr16,88714485,1.8275303643724696,731,569,1300,-
chr16,88714518,1.681818181818182,665,539,1204,-
chr16,88717374,3.577662721893491,690,519,1209,-
chr16,88717390,1.7809442060085838,1481,698,2179,-
chr16,88717413,1.5622923588039865,835,601,1436,-
chr16,88717445,2.198636530791208,1523,666,2189,-
chr16,88717446,1.8173095570855249,3532,1401,4933,-
chr16,88717449,1.826596583507325,7891,3531,11422,-
chr16,88717451,2.1130133799802744,5406,1852,7258,-
chr16,88717452,2.5441589441168206,3506,1186,4692,-
chr16,88717460,0.7921743101611681,5096,2308,7404,-
chr16,88717465,4.386887201326952,601,511,1112,-
chr16,88717476,0.6256782715452065,627,388,1015,-
chr16,88875965,2.3552971975083223,896,778,1674,-
chr16,88876059,2.0367442113236467,1376,1105,2481,-
chr16,88876544,0.6336842105263157,601,474,1075,-
chr16,88876545,0.5161853161302172,1021,750,1771,-
chr16,88876546,0.5161853161302172,1021,750,1771,-
chr16,88876897,3.8647342995169076,703,413,1116,-
chr16,89348214,2.3833333333333333,662,611,1273,-
chr16,89348216,2.524112356485105,1262,1082,2344,-
chr16,89348218,2.856749672346002,920,762,1682,-
chr16,89348219,2.4526785714285717,602,479,1081,-
chr16,89484696,2.1515072083879425,1025,871,1896,-
chr16,89484705,1.7254210732471602,880,665,1545,-
chr16,89484709,1.538741302972802,788,557,1345,-
chr16,89484716,1.6741721854304636,631,452,1083,-
chr16,89484734,2.3741014958551157,825,549,1374,-
chr17,1247932,1.5986105245997768,6101,4564,10665,-
chr17,1248008,1.1341398617388498,3039,2240,5279,-
chr17,1248021,1.9120111576900074,2850,2272,5122,-
chr17,1248022,1.5278892072588348,940,697,1637,-
chr17,1248025,1.4181463201692508,2370,1653,4023,-
chr17,1248026,0.5388679245283019,713,529,1242,-
chr17,1248028,2.443671609168762,2050,1671,3721,-
chr17,1248029,0.5684104177595997,2143,1481,3624,-
chr17,1248235,19.764424551460614,25962,18166,44128,-
chr17,1248236,19.764424551460614,25962,18166,44128,-
chr17,1248373,1.4343363889996013,2878,2122,5000,-
chr17,1248510,1.3226033769514347,5403,4105,9508,-
chr17,1248516,1.4637276785714284,1762,1147,2909,-
chr17,1248536,1.5547307996832938,1365,841,2206,-
chr17,1248538,1.3105509697150013,2014,1278,3292,-
chr17,1248549,1.4482758620689655,1055,637,1692,-
chr17,1248644,0.6609991138679663,1363,975,2338,-
chr17,1248712,1.8468720821662,1203,881,2084,-
chr17,1264407,1.404229525862069,4799,3711,8510,-
chr17,1264408,1.4168484506706223,9331,6452,15783,-
chr17,1264509,1.3716117067725353,2929,1820,4749,-
chr17,1268250,1.6725642435069394,2274,1914,4188,-
chr17,1268292,1.3542764673491634,3467,2437,5904,-
chr17,1268296,1.5065731650303882,1830,1425,3255,-
chr17,1303381,1.1364414552052768,5370,3714,9084,-
chr17,1303383,1.136677479898297,4789,3679,8468,-
chr17,1303499,1.0679363087926548,6890,5005,11895,-
chr17,1303502,0.6735730592799813,3660,2444,6104,-
chr17,1303513,0.9238312144877858,8844,6365,15209,-
chr17,1303514,0.9238312144877859,8844,6365,15209,-
chr17,1303515,0.9454166108805285,2536,2309,4845,-
chr17,1339974,0.970544644846365,675,504,1179,-
chr17,1339975,0.970544644846365,675,504,1179,-
chr17,1367840,2.1341895346569277,995,738,1733,-
chr17,1437477,0.4565587734241908,736,586,1322,-
chr17,1437478,0.4565587734241908,736,586,1322,-
chr17,1494762,2.0363581581344095,1530,1360,2890,-
chr17,1494763,2.0814000380480504,1170,1073,2243,-
chr17,1494764,1.9812087912087912,893,779,1672,-
chr17,1558647,1.6796978531672409,844,538,1382,-
chr17,1558650,1.9505639836496946,1370,861,2231,-
chr17,1558750,1.0833333333333333,883,509,1392,-
chr17,1558752,1.0833333333333333,883,509,1392,-
chr17,1559809,2.041807209947586,657,494,1151,-
chr17,1561562,2.9999446532526277,708,591,1299,-
chr17,1562663,0.4799687950900593,1878,910,2788,-
chr17,1562664,0.4799687950900593,1878,910,2788,-
chr17,1562673,1.4636788898209896,1633,1326,2959,-
chr17,1562674,1.7510884154621005,3244,2244,5488,-
chr17,1562711,2.332039091471915,1189,766,1955,-
chr17,1562726,2.4428392232166365,1015,653,1668,-
chr17,1562728,2.4286620164870008,765,497,1262,-
chr17,1564092,2.419552900589563,583,446,1029,-
chr17,1564687,1.3187492632777196,1058,847,1905,-
chr17,1564688,0.9926973984481972,749,625,1374,-
chr17,1564944,2.6996924851047472,676,512,1188,-
chr17,1565218,2.458205463982566,1066,685,1751,-
chr17,1565219,3.0489974937343365,838,531,1369,-
chr17,1565220,3.0489974937343365,838,531,1369,-
chr17,1565242,2.699627600666026,643,427,1070,-
chr17,1582648,1.6952094923334087,621,411,1032,-
chr17,1582908,1.3558379682248496,613,403,1016,-
chr17,1585467,3.085830784913353,687,326,1013,-
chr17,1585469,3.085830784913353,687,326,1013,-
chr17,1586991,3.774509803921569,615,407,1022,-
chr17,1586993,3.774509803921569,615,407,1022,-
chr17,1587813,0.42476324550827765,2296,1511,3807,-
chr17,1587815,0.7138736968259046,3349,2296,5645,-
chr17,1587817,0.8835812581943849,1848,1365,3213,-
chr17,2228707,3.7362327642159063,740,562,1302,-
chr17,2237787,2.9490661523475397,693,514,1207,-
chr17,2238066,1.437025958765089,1415,850,2265,-
chr17,2238069,2.0266544117647056,1469,951,2420,-
chr17,2238078,2.117647058823529,1169,714,1883,-
chr17,2238094,2.382820706743093,1786,1002,2788,-
chr17,2238124,1.517468146321414,993,810,1803,-
chr17,2238132,2.1716772151898733,853,631,1484,-
chr17,2238143,2.1848863479183,1435,942,2377,-
chr17,2238144,2.1848863479183,1435,942,2377,-
chr17,2238555,0.40007963862314216,834,613,1447,-
chr17,2238556,0.410680228862047,645,483,1128,-
chr17,2593071,6.125166752890779,514,677,1191,-
chr17,3567563,0.49440267335004173,806,512,1318,-
chr17,3567983,0.9958302725741397,1147,828,1975,-
chr17,3567990,2.3078942603657437,688,525,1213,-
chr17,3567991,2.3078942603657437,688,525,1213,-
chr17,3568018,2.4338008920779575,702,531,1233,-
chr17,3568083,1.6964833608685392,598,445,1043,-
chr17,3568084,1.6964833608685392,598,445,1043,-
chr17,3568085,1.6964833608685392,598,445,1043,-
chr17,3576709,5.474150897202622,611,406,1017,-
chr17,3732659,1.614528101802757,782,413,1195,-
chr17,3743399,1.6311788089048755,2104,1005,3109,-
chr17,4841002,2.902507360438569,724,540,1264,-
chr17,4841653,2.3582887700534765,587,560,1147,-
chr17,4841654,2.3582887700534765,587,560,1147,-
chr17,4842493,0.28968265641259605,1306,1031,2337,-
chr17,4842494,0.2735835172921265,675,603,1278,-
chr17,4842495,0.4494671577347619,949,838,1787,-
chr17,4849024,1.3009646497458172,9022,6506,15528,-
chr17,4849025,1.2997335109926715,5573,3554,9127,-
chr17,4849228,1.7281484962406015,2941,1727,4668,-
chr17,4850037,1.497877358490566,2116,1589,3705,-
chr17,4850039,1.3258764111705288,3432,2804,6236,-
chr17,4850041,1.3042414696283569,2185,1692,3877,-
chr17,4850086,1.3972394621153348,3989,2577,6566,-
chr17,4851567,1.6841028823394322,4946,3310,8256,-
chr17,4851577,1.329440988021172,2267,1935,4202,-
chr17,4851579,1.7018702552542306,4401,2834,7235,-
chr17,4851615,1.322978892871366,1962,1673,3635,-
chr17,4851616,1.5073891625615763,1331,1035,2366,-
chr17,4851669,1.605203071953624,7802,5351,13153,-
chr17,4851670,1.4391348962033308,4797,2780,7577,-
chr17,4851672,1.788801791713326,1140,939,2079,-
chr17,4851700,1.3630255613951268,1073,735,1808,-
chr17,4851711,1.6111889563891524,2002,1535,3537,-
chr17,4851721,1.6197680282400402,802,660,1462,-
chr17,4851737,0.5759723137771918,698,491,1189,-
chr17,4851744,1.6667895855449866,2158,1314,3472,-
chr17,4851824,0.5846114540254823,4352,3274,7626,-
chr17,4851851,0.47846690534944014,1492,952,2444,-
chr17,4851855,1.499258002967988,883,800,1683,-
chr17,4862760,2.0266539386915046,744,487,1231,-
chr17,4862926,0.570524620340543,782,635,1417,-
chr17,4863098,1.2290617356544193,572,445,1017,-
chr17,4863818,1.7431939718035974,4780,3871,8651,-
chr17,4863822,1.7236635330041217,4402,3290,7692,-
chr17,4863837,1.7020819024725276,3276,2239,5515,-
chr17,4864085,1.7572860962566845,2897,1869,4766,-
chr17,4864087,1.4999999999999998,2474,1649,4123,-
chr17,4864093,0.717809704526972,2647,2169,4816,-
chr17,4864102,1.394426664585122,1847,1113,2960,-
chr17,4864107,1.9823146944083223,3810,3075,6885,-
chr17,4864108,1.9823146944083223,3810,3075,6885,-
chr17,4864110,1.9195320808224028,1519,867,2386,-
chr17,4864114,2.380952380952381,954,572,1526,-
chr17,4864117,1.5929689519753203,2334,1352,3686,-
chr17,4864126,1.520261938172386,2623,1808,4431,-
chr17,4864128,1.71828604381995,5008,3380,8388,-
chr17,4864129,1.84132255422578,3648,2441,6089,-
chr17,4864130,1.84132255422578,3648,2441,6089,-
chr17,4864131,1.3197906935528456,1534,882,2416,-
chr17,4864144,1.571840487459877,931,556,1487,-
chr17,5290771,2.2168947032491246,583,456,1039,-
chr17,5312097,2.2868552738796764,713,477,1190,-
chr17,5336281,1.498772504091653,2012,1585,3597,-
chr17,5336383,1.3271092875242045,5645,3699,9344,-
chr17,5336641,1.3736477860646377,1613,1352,2965,-
chr17,5338211,1.633873850868233,1346,1067,2413,-
chr17,5341588,1.4901926483129604,1261,972,2233,-
chr17,5341590,2.055355737889176,1001,867,1868,-
chr17,5342174,2.75103734439834,560,481,1041,-
chr17,5342191,2.5743116980191854,1007,697,1704,-
chr17,5342193,2.5743116980191854,1007,697,1704,-
chr17,5342196,1.8310730430644773,591,466,1057,-
chr17,5342304,2.250632911392405,761,394,1155,-
chr17,5342432,2.9571688712591637,1576,1317,2893,-
chr17,5342434,0.9307465982232794,1385,882,2267,-
chr17,5342435,0.7925540890444226,1902,1277,3179,-
chr17,5383852,1.355100609366415,681,496,1177,-
chr17,5384708,3.7341789179503997,583,536,1119,-
chr17,7143872,1.6808588957055215,720,651,1371,-
chr17,7144114,1.7500859993120057,813,611,1424,-
chr17,7144115,1.3856538568853995,2019,1335,3354,-
chr17,7144116,1.4863080127148003,2269,1494,3763,-
chr17,7144667,2.107619457597934,917,605,1522,-
chr17,7144719,0.6201937481274344,809,588,1397,-
chr17,7144946,2.065603448275862,1140,724,1864,-
chr17,7144949,2.0034777424483305,1033,628,1661,-
chr17,7144987,1.6925688912106567,863,493,1356,-
chr17,7144989,0.6390672524501521,731,537,1268,-
chr17,7144990,2.684757505773672,774,432,1206,-
chr17,7145631,1.64385733574979,1628,1044,2672,-
chr17,7145633,2.021637122002085,704,410,1114,-
chr17,7145645,0.5695674171515305,710,353,1063,-
chr17,7145661,1.320716282382221,901,496,1397,-
chr17,7145683,2.555498193082085,674,446,1120,-
chr17,7147032,0.30001044044522307,865,1319,2184,-
chr17,7147044,0.2648306735443128,663,1144,1807,-
chr17,7147057,2.352482395323399,1059,1444,2503,-
chr17,7147059,1.5535714285714286,698,931,1629,-
chr17,7147065,15.809634077366578,3001,3313,6314,-
chr17,7147066,16.318158054744845,3496,3386,6882,-
chr17,7147067,16.318158054744845,3496,3386,6882,-
chr17,7147068,24.782203758318417,1733,867,2600,-
chr17,7147076,10.224894566826686,1246,192,1438,-
chr17,7147077,10.224894566826686,1246,192,1438,-
chr17,7147078,9.198232565551006,1282,228,1510,-
chr17,7147169,0.5381048971312663,618,405,1023,-
chr17,7147455,9.638764808635662,1251,848,2099,-
chr17,7147456,7.2862488814587785,987,723,1710,-
chr17,7149661,2.0973782771535583,671,355,1026,-
chr17,7150176,2.9729254571026726,889,631,1520,-
chr17,7150178,2.9729254571026726,889,631,1520,-
chr17,7150622,3.9884156072598196,569,442,1011,-
chr17,7150646,3.0270043202941155,678,491,1169,-
chr17,7150648,0.25600339173184344,884,693,1577,-
chr17,7218304,2.3213488621351477,681,563,1244,-
chr17,7218330,2.9374724599899467,761,410,1171,-
chr17,7306642,2.130684220061598,766,570,1336,-
chr17,7306643,3.6603119584055452,659,576,1235,-
chr17,7307332,1.6764252696456086,799,648,1447,-
chr17,7307402,3.400101158825526,1877,876,2753,-
chr17,7307403,4.904944586530264,932,413,1345,-
chr17,7307404,4.904944586530264,932,413,1345,-
chr17,7307406,3.5583333333333336,853,439,1292,-
chr17,7307415,0.7910534200327578,705,308,1013,-
chr17,7494693,11.952411780819897,1958,1054,3012,-
chr17,7494694,13.46611829179596,1735,953,2688,-
chr17,7494695,11.846266119426371,1041,549,1590,-
chr17,7504809,2.2385503855744266,604,448,1052,-
chr17,7507082,2.3334925943621596,589,446,1035,-
chr17,7509420,1.141363683180554,598,510,1108,-
chr17,7509421,1.323566104731135,861,726,1587,-
chr17,7509423,2.053128126935722,812,676,1488,-
chr17,7529734,2.0444363102871597,837,533,1370,-
chr17,7529735,1.8630392156862745,612,407,1019,-
chr17,7529771,2.424826071925571,615,419,1034,-
chr17,7529773,1.9292650484626048,727,426,1153,-
chr17,7530085,2.1361597470880853,679,383,1062,-
chr17,7760103,3.5554960742326918,796,466,1262,-
chr17,7760423,0.8984602898034008,1106,808,1914,-
chr17,7760462,1.8857598582438455,1299,967,2266,-
chr17,7760466,2.7370059168149847,1252,680,1932,-
chr17,7760493,0.569887145609689,646,518,1164,-
chr17,7834333,0.4399350649350649,541,461,1002,-
chr17,7834335,0.4605100866521856,803,617,1420,-
chr17,7835263,0.70752160083983,728,316,1044,-
chr17,8110091,2.520111632218817,1573,1036,2609,-
chr17,8110092,2.4163424124513617,827,513,1340,-
chr17,8110511,0.9670682730923694,601,414,1015,-
chr17,8110512,1.1763607524238517,1140,810,1950,-
chr17,8110563,1.7122093023255816,836,687,1523,-
chr17,8110592,0.6548898744644065,725,501,1226,-
chr17,8110913,3.741273910471308,611,460,1071,-
chr17,8110915,3.741273910471308,611,460,1071,-
chr17,8280993,1.4442881677310435,24181,19271,43452,-
chr17,8281005,1.532037749009945,12236,7073,19309,-
chr17,8281010,0.7780705688171233,717,572,1289,-
chr17,8283125,1.3919615718627876,17096,9211,26307,-
chr17,8283127,1.4455668719895538,25027,13361,38388,-
chr17,8283128,1.4474524980597576,16186,8533,24719,-
chr17,8283145,1.555600993811824,4977,3013,7990,-
chr17,8283152,1.3643719693433398,9277,4720,13997,-
chr17,8283160,1.2315954706736607,8096,4550,12646,-
chr17,8283161,1.310605042222195,3762,2837,6599,-
chr17,8283180,1.6472989840577648,4203,2889,7092,-
chr17,8285576,1.9957624767652922,41186,27535,68721,-
chr17,8285582,0.7356371091000373,27849,21337,49186,-
chr17,8285589,1.2936443957661552,34854,23726,58580,-
chr17,8285590,1.2447813607202756,21255,13201,34456,-
chr17,8285619,1.1713260465667577,18279,13841,32120,-
chr17,8285624,1.0073049683012387,20959,14147,35106,-
chr17,8285626,0.9087143591060881,12128,7785,19913,-
chr17,8286492,1.3731641536841326,16581,11515,28096,-
chr17,8286493,1.1161449183139895,5939,3863,9802,-
chr17,8286494,1.4074611286843446,28938,18416,47354,-
chr17,8286501,1.5628590280259143,17449,8549,25998,-
chr17,8286502,1.5609195611693996,6590,3900,10490,-
chr17,8286503,1.3967801938074076,33173,16244,49417,-
chr17,8286504,1.3916129338387349,25256,11748,37004,-
chr17,8286505,1.5192406886196013,24501,10685,35186,-
chr17,8286506,1.2183883414251793,25185,11343,36528,-
chr17,8286508,0.9303714130039956,14936,5505,20441,-
chr17,8286509,0.8935534785576595,11108,4170,15278,-
chr17,8286510,0.8908350946205604,12602,4965,17567,-
chr17,8286511,0.8845916345428476,8671,3543,12214,-
chr17,8508187,2.029346448980558,1688,1703,3391,-
chr17,8508188,0.3294212163842649,864,868,1732,-
chr17,8508189,3.992033856111526,843,926,1769,-
chr17,8508190,2.763157894736842,557,588,1145,-
chr17,8508230,1.99692852027952,524,538,1062,-
chr17,10590083,3.7792613367455554,843,544,1387,-
chr17,12898364,1.0245215311004785,570,439,1009,-
chr17,12898365,1.0756458805820177,915,758,1673,-
chr17,16004894,3.1432443703085906,602,435,1037,-
chr17,16252609,3.643507224931456,678,461,1139,-
chr17,17150287,0.5169181034482758,737,463,1200,-
chr17,17150293,2.4555555555555557,701,539,1240,-
chr17,17168279,0.5462184873949579,909,577,1486,-
chr17,17171204,0.518324607329843,917,572,1489,-
chr17,17174079,1.552941176470588,689,574,1263,-
chr17,17179421,2.101293696669419,693,518,1211,-
chr17,17179423,2.101293696669419,693,518,1211,-
chr17,17184474,2.700146397058286,850,530,1380,-
chr17,17286694,1.9728320886443185,2218,1618,3836,-
chr17,17286695,1.9728320886443185,2218,1618,3836,-
chr17,17286698,3.618781094527364,758,803,1561,-
chr17,17286699,3.618781094527364,758,803,1561,-
chr17,17286701,1.0861501572778212,2797,1916,4713,-
chr17,17286704,0.7266724399220611,1643,1191,2834,-
chr17,17287276,1.4185728872445664,3342,2564,5906,-
chr17,17287279,1.3249646772664674,5753,4300,10053,-
chr17,17287280,1.1032581066128593,12461,9594,22055,-
chr17,17287282,1.3060407468302204,7729,5623,13352,-
chr17,17287283,1.2212447176014276,8942,6780,15722,-
chr17,17287285,1.439000839163441,7378,4885,12263,-
chr17,17287288,0.7596975244072525,1472,1433,2905,-
chr17,17287291,1.8012718600953896,2265,1294,3559,-
chr17,17287297,1.529416545667333,8537,4983,13520,-
chr17,17287298,1.4966854827037197,6939,3674,10613,-
chr17,17287299,1.4910924239282832,11623,6736,18359,-
chr17,17287300,1.4523036124372783,9483,5257,14740,-
chr17,17287302,1.4164051994621245,4344,2133,6477,-
chr17,17287303,1.6269940665434965,4018,2117,6135,-
chr17,17287304,0.6117070040337368,784,807,1591,-
chr17,17287309,1.714006423683843,645,681,1326,-
chr17,17287312,1.633525156319429,3196,1488,4684,-
chr17,17287313,1.8378752550276891,2292,939,3231,-
chr17,17287314,1.724780535010714,2353,1172,3525,-
chr17,17287315,2.1202708471310996,3583,1573,5156,-
chr17,17287317,1.8683174694052815,1373,627,2000,-
chr17,17287333,1.7655087876471947,1271,598,1869,-
chr17,17287335,0.823477493380406,932,308,1240,-
chr17,17726865,22.58992805755396,784,277,1061,-
chr17,17726917,0.9245570397762635,2337,778,3115,-
chr17,17726918,1.0062303163083663,1632,602,2234,-
chr17,17726919,1.0062303163083663,1632,602,2234,-
chr17,18148962,3.051812903932523,795,536,1331,-
chr17,18148963,3.051812903932523,795,536,1331,-
chr17,18151953,2.1574868681212425,2828,1627,4455,-
chr17,18151964,0.37665886026541767,964,487,1451,-
chr17,18151987,0.6528756535576268,717,414,1131,-
chr17,18232611,1.9577578307042105,1944,1456,3400,-
chr17,18232612,0.2536794354838709,718,495,1213,-
chr17,18232613,2.140244488336092,1805,1440,3245,-
chr17,18232614,2.0590147218150534,1181,922,2103,-
chr17,18232627,0.9225841624642224,966,758,1724,-
chr17,18232628,1.1212972275871054,1445,1098,2543,-
chr17,18243542,2.349404941494253,612,481,1093,-
chr17,18244105,3.5821812596006146,582,433,1015,-
chr17,18244107,3.5821812596006146,582,433,1015,-
chr17,18259237,1.4176158979910198,750,503,1253,-
chr17,19246588,3.61851500849275,612,440,1052,-
chr17,19349341,2.019598254238364,726,652,1378,-
chr17,19699549,4.12861708722898,705,513,1218,-
chr17,19861754,3.6827504411090928,515,495,1010,-
chr17,20905709,8.609541025329314,689,462,1151,-
chr17,26656214,0.3938535410378901,611,502,1113,-
chr17,26656271,2.7912723131430353,605,459,1064,-
chr17,26674334,2.500386440051465,732,573,1305,-
chr17,26674388,1.1281224110413774,760,585,1345,-
chr17,26674392,0.537040563702152,704,533,1237,-
chr17,26674394,0.4304267101523407,1340,982,2322,-
chr17,26674395,0.5296855921855922,630,503,1133,-
chr17,26674544,2.486127118315165,762,567,1329,-
chr17,26674995,6.6522952644287745,1325,980,2305,-
chr17,26674998,3.4434776220282703,649,434,1083,-
chr17,26675214,1.5591470258136926,2415,1759,4174,-
chr17,26675215,2.129850466160056,3638,3240,6878,-
chr17,26675217,1.6771319205411088,5191,4303,9494,-
chr17,26675218,0.6449095487981366,4010,2988,6998,-
chr17,26675221,1.4157018956408736,3253,2564,5817,-
chr17,26675222,1.4157018956408736,3253,2564,5817,-
chr17,26675228,1.7954521161648318,2739,2010,4749,-
chr17,26675230,1.7954521161648318,2739,2010,4749,-
chr17,26675242,1.4707482993197278,1080,804,1884,-
chr17,26676178,1.1348511383537654,809,570,1379,-
chr17,26676179,1.1348511383537654,809,570,1379,-
chr17,26676182,0.35286163129565024,919,776,1695,-
chr17,26676186,6.412507741973191,1448,1141,2589,-
chr17,26678730,0.9952474140341067,711,510,1221,-
chr17,26678732,0.9952474140341067,711,510,1221,-
chr17,26678781,2.273001508295626,684,509,1193,-
chr17,26678783,2.273001508295626,684,509,1193,-
chr17,26680788,0.4573118410979028,877,537,1414,-
chr17,26681517,0.8650227125243348,601,468,1069,-
chr17,26681518,0.8650227125243348,601,468,1069,-
chr17,26682836,1.240863309352518,615,555,1170,-
chr17,26682837,1.240863309352518,615,555,1170,-
chr17,26881217,2.32209265679168,920,667,1587,-
chr17,26881218,2.23573131362437,2108,1301,3409,-
chr17,26881219,2.1605087825560267,1188,634,1822,-
chr17,26881222,2.566035854825721,921,508,1429,-
chr17,26881891,2.1262174267229597,973,734,1707,-
chr17,26887197,0.89497303768743,617,425,1042,-
chr17,26900470,1.0165551250440297,665,500,1165,-
chr17,26900471,0.8523575617266418,901,649,1550,-
chr17,26901727,2.5801731718560443,662,468,1130,-
chr17,26905278,1.7876921277348805,637,514,1151,-
chr17,26905492,3.9649566786763186,678,451,1129,-
chr17,26906186,2.3676473627696053,674,519,1193,-
chr17,26910663,2.4267736199221104,3026,1948,4974,-
chr17,26910879,1.5222624887109988,2737,1798,4535,-
chr17,26910881,1.8002257754089868,2185,1421,3606,-
chr17,26910886,1.6923998257839719,941,573,1514,-
chr17,26910909,2.5729147340326146,1363,777,2140,-
chr17,26910927,2.288069400421409,1213,658,1871,-
chr17,26913451,2.1920490551561853,671,631,1302,-
chr17,26919459,1.5057686881769543,619,445,1064,-
chr17,26919693,4.597380469975439,744,487,1231,-
chr17,26925651,1.0556767730268075,611,465,1076,-
chr17,26942006,16.514969647096528,749,581,1330,-
chr17,26942007,18.462188253431936,830,725,1555,-
chr17,26950820,0.8849999999999999,884,624,1508,-
chr17,26950821,0.8849999999999999,884,624,1508,-
chr17,26950822,2.0649282068046366,959,651,1610,-
chr17,26969974,1.9186923635224031,1483,1132,2615,-
chr17,26969976,2.1821205038510407,1675,1300,2975,-
chr17,26969978,2.002493765586035,1605,1202,2807,-
chr17,26969979,1.929893092105263,1042,767,1809,-
chr17,26969983,2.535892634207241,649,355,1004,-
chr17,26969989,0.851333431560336,962,616,1578,-
chr17,26969990,0.7552602860839082,1281,832,2113,-
chr17,26969995,0.46990424076607373,686,472,1158,-
chr17,26969996,0.46990424076607373,686,472,1158,-
chr17,26982350,2.813615927300212,687,506,1193,-
chr17,26982450,2.9152083934665307,556,466,1022,-
chr17,27041532,2.0407418602196943,1020,637,1657,-
chr17,27041535,0.5953249759148257,1002,685,1687,-
chr17,27042893,1.1614611729137199,1015,698,1713,-
chr17,27251263,2.612179233853104,768,389,1157,-
chr17,27590483,2.687890924922948,686,459,1145,-
chr17,27590868,0.19830418319453172,669,1565,2234,-
chr17,27590869,0.0760233918128654,415,1139,1554,-
chr17,27590870,0.0737529645037129,541,1512,2053,-
chr17,27590872,5.640641553124543,1167,2537,3704,-
chr17,27590874,18.326133541851096,1747,3029,4776,-
chr17,27590875,34.67255528274434,1215,1940,3155,-
chr17,27590885,9.055727554179564,1052,170,1222,-
chr17,27613448,2.8569763413897564,709,440,1149,-
chr17,27614283,1.2786471362846892,599,418,1017,-
chr17,27614543,2.7741444866920157,1139,788,1927,-
chr17,27614544,2.7741444866920157,1139,788,1927,-
chr17,27614565,1.1195678416224046,686,435,1121,-
chr17,27614567,1.1195678416224046,686,435,1121,-
chr17,29231334,1.8922098448107925,1442,863,2305,-
chr17,30179201,2.9981819287090024,844,609,1453,-
chr17,30179296,0.8089172348204139,746,638,1384,-
chr17,30207752,1.5467098308668077,1141,703,1844,-
chr17,30211462,1.9674185463659146,784,493,1277,-
chr17,30214274,2.821547968002612,613,396,1009,-
chr17,30226721,0.9940527248235556,1041,719,1760,-
chr17,33750046,4.72941409755262,591,447,1038,-
chr17,34851810,0.7928853377942123,728,534,1262,-
chr17,34852036,3.8331562137809274,660,465,1125,-
chr17,34864932,1.4746832066819573,633,479,1112,-
chr17,35620687,2.138596313655645,989,596,1585,-
chr17,35979836,3.5320160098308957,745,425,1170,-
chr17,35986101,1.9394342659074033,1898,1153,3051,-
chr17,35986102,1.9394342659074033,1898,1153,3051,-
chr17,35986104,2.0664347435753565,681,468,1149,-
chr17,35986108,1.494341757827235,833,481,1314,-
chr17,35986115,0.6245098039215687,909,611,1520,-
chr17,35986138,1.8225694444444442,723,479,1202,-
chr17,37008862,1.0283091859364526,65202,48258,113460,-
chr17,37008865,1.3447747809513362,10800,7824,18624,-
chr17,37008886,1.1926293648346435,25926,18392,44318,-
chr17,37008930,1.3950954077996132,12780,7624,20404,-
chr17,37008934,1.4170651703068715,22544,13103,35647,-
chr17,37008936,1.4434645429080788,38531,24724,63255,-
chr17,37009297,1.1138852991011172,13451,9854,23305,-
chr17,37009962,1.306482641835303,5787,4621,10408,-
chr17,37009964,1.1852407110812726,8308,4950,13258,-
chr17,37009965,1.2207144835225698,4999,3924,8923,-
chr17,37009969,0.8010514350667802,4026,3059,7085,-
chr17,37009977,1.2916881280006636,15743,8766,24509,-
chr17,37009978,1.327572006363222,19906,10906,30812,-
chr17,37009979,1.3309120825347212,26719,15022,41741,-
chr17,37009980,1.3912988526369685,21590,11216,32806,-
chr17,37009981,1.3139223580944304,19571,10633,30204,-
chr17,37009982,1.5441924432563472,16161,8171,24332,-
chr17,37009984,1.6688274837833024,12178,5318,17496,-
chr17,37009985,1.6875675740015912,11291,4710,16001,-
chr17,37009986,1.1031774813971325,19307,9580,28887,-
chr17,37009987,1.0523766604665934,15392,7342,22734,-
chr17,37009988,0.7857624422096904,14180,7007,21187,-
chr17,37009989,0.6752831137055934,10170,5026,15196,-
chr17,37009990,0.6143519437964302,8235,4550,12785,-
chr17,37009992,0.6951008422327509,2714,2269,4983,-
chr17,37009994,0.9910288988259113,1551,1431,2982,-
chr17,37009999,2.2182600485618393,1186,907,2093,-
chr17,37010001,2.521212121212121,703,483,1186,-
chr17,37010016,0.5761253368255091,1500,1086,2586,-
chr17,37010018,0.481456975551659,538,500,1038,-
chr17,37010023,0.36955280175824207,473,594,1067,-
chr17,37025694,1.7750607533414338,898,822,1720,-
chr17,37025700,1.401354363822153,1892,1416,3308,-
chr17,37025706,2.2221901643090085,1177,907,2084,-
chr17,37025711,0.5178180140698881,897,666,1563,-
chr17,37025712,0.6384909494111464,1517,1010,2527,-
chr17,37025721,0.9586626565013637,622,492,1114,-
chr17,37025723,0.7791950010445509,1023,760,1783,-
chr17,37025730,2.973672055427252,665,432,1097,-
chr17,37025731,3.2924892737424347,808,521,1329,-
chr17,37566789,2.280449179383818,719,301,1020,-
chr17,37566790,2.280449179383818,719,301,1020,-
chr17,37886508,2.048549339097182,665,522,1187,-
chr17,37886511,2.33820327505494,1668,1064,2732,-
chr17,37886513,2.1741853436203056,1452,1079,2531,-
chr17,37886516,1.8960056335456186,1321,1256,2577,-
chr17,37886517,1.9312235294117648,752,849,1601,-
chr17,37886520,3.265817917506138,1055,779,1834,-
chr17,37886521,1.706734009460888,1731,1319,3050,-
chr17,37886522,0.8088978766430737,1099,758,1857,-
chr17,37886523,0.8088978766430737,1099,758,1857,-
chr17,38179405,1.8925274574947704,1280,920,2200,-
chr17,38179408,1.8420420024190336,1532,1096,2628,-
chr17,38179409,2.2674768120920645,1789,1311,3100,-
chr17,38179411,1.9566216164618861,1420,982,2402,-
chr17,38179422,2.6632346632346637,969,554,1523,-
chr17,38179423,2.6632346632346637,969,554,1523,-
chr17,38189328,3.930157146265807,611,489,1100,-
chr17,38545233,1.5108565477740172,1208,834,2042,-
chr17,38545580,2.5908096280087523,1183,913,2096,-
chr17,38545820,0.630769451704627,1330,940,2270,-
chr17,38545835,2.0064482579303173,741,640,1381,-
chr17,38546308,0.7414318782057165,1321,1010,2331,-
chr17,38546348,0.5716775599128541,655,539,1194,-
chr17,38546369,1.6701192718141873,625,530,1155,-
chr17,38546383,2.2234923578025847,1469,1052,2521,-
chr17,38547831,1.6538289451041128,1171,744,1915,-
chr17,38548899,1.7054866648492468,7868,8202,16070,-
chr17,38548900,1.8296606223730283,5361,5666,11027,-
chr17,38548903,1.7688596960881178,4783,4473,9256,-
chr17,38548908,1.5997542421760027,8178,6818,14996,-
chr17,38548910,1.546786434082367,9932,8494,18426,-
chr17,38548914,1.7603006293990262,5139,4072,9211,-
chr17,38548915,1.805004568363347,3539,2589,6128,-
chr17,38548920,1.883527521149097,3355,2503,5858,-
chr17,38551785,1.4646545454545457,1232,824,2056,-
chr17,38552637,1.4613427844628006,663,592,1255,-
chr17,38552642,1.5721556616521033,894,652,1546,-
chr17,38552645,2.4700546922687363,2242,1695,3937,-
chr17,38552646,2.0288815861264298,2204,1639,3843,-
chr17,38556217,0.6805261629113243,1024,830,1854,-
chr17,38556640,1.9008013015767384,2213,1562,3775,-
chr17,38556824,1.950476963669576,960,757,1717,-
chr17,38556831,1.6431428095317446,961,705,1666,-
chr17,38557218,1.5653952999474436,1126,700,1826,-
chr17,38557282,1.6752136752136757,783,571,1354,-
chr17,38559169,0.5603819281096998,1236,910,2146,-
chr17,38559208,1.991614691614692,990,554,1544,-
chr17,38559246,1.503188581840267,899,711,1610,-
chr17,38560449,2.5698672911787668,822,670,1492,-
chr17,38560464,1.9244760977609263,938,672,1610,-
chr17,38560646,1.7238749046529367,1129,827,1956,-
chr17,38562921,0.6194935152057245,1197,1117,2314,-
chr17,38562931,2.086323576916603,2450,1939,4389,-
chr17,38562934,1.578059071729958,1308,868,2176,-
chr17,38563153,1.7644549115980612,1054,770,1824,-
chr17,38564785,2.298961424332344,1032,673,1705,-
chr17,38567471,2.1510016850777007,998,762,1760,-
chr17,38567492,1.5183504340962906,1214,723,1937,-
chr17,38569191,1.6615970540758678,1242,943,2185,-
chr17,38573095,0.5577185792349727,851,731,1582,-
chr17,38574030,0.3386454183266932,560,501,1061,-
chr17,38574095,4.14249423481079,1640,1331,2971,-
chr17,38574096,3.7814275999961158,2627,2219,4846,-
chr17,38574097,3.7814275999961158,2627,2219,4846,-
chr17,38784470,1.3766461172474238,918,659,1577,-
chr17,38784471,1.0038461538461538,724,499,1223,-
chr17,38785151,7.695076001342106,1342,1001,2343,-
chr17,38787013,2.1093005075426827,1417,1106,2523,-
chr17,38787023,1.960610263522885,683,514,1197,-
chr17,38787026,0.9988755358774335,1397,1053,2450,-
chr17,38787027,1.2446011233502159,1802,1340,3142,-
chr17,38788546,1.210965382390721,1053,785,1838,-
chr17,38788570,0.4862196626902509,590,441,1031,-
chr17,38792670,2.1633825944170773,774,608,1382,-
chr17,38804062,4.936970250956038,1027,1005,2032,-
chr17,38804063,4.936970250956038,1027,1005,2032,-
chr17,38974651,1.709080841638981,1402,1049,2451,-
chr17,38974710,1.8472558727483408,1095,862,1957,-
chr17,38974732,1.8857142857142855,857,524,1381,-
chr17,38975048,1.8960447297577134,762,438,1200,-
chr17,38975060,1.8508158508158508,793,571,1364,-
chr17,39775789,1.3255360623781676,1495,1187,2682,-
chr17,39776791,1.4829179610160514,3162,2670,5832,-
chr17,39776801,1.349659229208925,2578,2124,4702,-
chr17,39776952,1.5998340248962657,1133,963,2096,-
chr17,39776991,1.468758280078612,9456,7158,16614,-
chr17,39776992,1.5151259265976016,5293,4268,9561,-
chr17,39777003,1.0395801762994004,5303,3781,9084,-
chr17,39777096,1.4340099077309878,9261,6400,15661,-
chr17,39777097,1.4602409638554217,6225,4564,10789,-
chr17,39777245,1.3072004198576077,3320,2426,5746,-
chr17,39777332,1.89642589709151,4431,3534,7965,-
chr17,39777335,1.409796830124455,2038,1665,3703,-
chr17,39777846,1.6441083652671171,3670,2718,6388,-
chr17,39777862,1.4171342491500596,3361,2391,5752,-
chr17,39777971,1.3330136723028576,5843,4012,9855,-
chr17,39778619,1.5759546002263214,3988,2746,6734,-
chr17,39778620,1.3460379160970466,2817,1670,4487,-
chr17,39778623,1.3468982563243697,2556,1510,4066,-
chr17,39778719,1.5279576856649395,2830,1543,4373,-
chr17,39779243,0.9952676900882569,8154,5910,14064,-
chr17,39779256,1.2701817841663807,3818,2466,6284,-
chr17,39780360,1.3988805511180933,5757,3817,9574,-
chr17,39780363,1.471605730020931,5387,3509,8896,-
chr17,39780367,1.679738562091503,5139,3455,8594,-
chr17,39780369,1.679738562091503,5139,3455,8594,-
chr17,39780372,2.077824920756217,8613,5069,13682,-
chr17,39780374,2.077824920756217,8613,5069,13682,-
chr17,39780462,1.828617106314948,1063,833,1896,-
chr17,39780495,0.6233859581568476,933,794,1727,-
chr17,39780586,0.6950741806070698,1562,1200,2762,-
chr17,39780592,1.178478976341953,2827,2244,5071,-
chr17,39780628,0.7122637073262486,1121,867,1988,-
chr17,39780727,2.200152788388082,639,475,1114,-
chr17,39780742,1.3530971157281915,1546,1016,2562,-
chr17,39780750,1.9485294117647056,1271,575,1846,-
chr17,39780821,1.6699175803007618,3411,1771,5182,-
chr17,39780822,1.5075263685880909,3300,1396,4696,-
chr17,39780824,0.8740914981911949,9109,4062,13171,-
chr17,39780826,0.862757682249883,8005,3594,11599,-
chr17,39780829,1.2079240435892293,521,495,1016,-
chr17,39910956,3.5474064737922832,567,434,1001,-
chr17,39911575,3.534035903470835,585,437,1022,-
chr17,39911668,4.756364486106253,579,448,1027,-
chr17,39911673,2.0813734815111813,945,655,1600,-
chr17,39913746,2.107525707273445,613,415,1028,-
chr17,39921015,4.527098943618721,693,470,1163,-
chr17,39958308,1.6826083414267357,683,513,1196,-
chr17,39958911,0.7662097170791368,617,428,1045,-
chr17,39959591,4.150240050583536,764,476,1240,-
chr17,39959593,4.330491193282473,1562,1014,2576,-
chr17,39959594,5.412183157549253,1473,1022,2495,-
chr17,39963117,1.6960032900092028,675,594,1269,-
chr17,39964170,1.4918573266843693,927,580,1507,-
chr17,39967153,3.5827759197324416,856,597,1453,-
chr17,39967429,2.023464113751305,664,509,1173,-
chr17,39968146,5.421812865497076,706,529,1235,-
chr17,39968147,5.4236611526550345,868,603,1471,-
chr17,39981524,4.505777784838854,564,472,1036,-
chr17,39987105,3.6078850855745723,786,408,1194,-
chr17,39987106,2.789581289359289,1034,582,1616,-
chr17,39991341,1.805921052631579,548,463,1011,-
chr17,39991342,1.4983659395120434,2218,1972,4190,-
chr17,39991345,1.6143776563448695,1186,914,2100,-
chr17,39991360,1.6087988321422448,3337,2701,6038,-
chr17,39991362,1.605416469847268,2548,1970,4518,-
chr17,39991366,1.629681752758676,1157,844,2001,-
chr17,39991467,0.6096774193548388,755,495,1250,-
chr17,40023735,1.660830745341615,1096,735,1831,-
chr17,40023782,0.6945856531913177,1075,728,1803,-
chr17,40024008,2.0577190781878363,1907,1369,3276,-
chr17,40024009,1.9415295617827264,1273,868,2141,-
chr17,40024011,0.5270419426048566,572,452,1024,-
chr17,40024040,1.8085539714867616,739,490,1229,-
chr17,40024146,1.6071808157300382,912,578,1490,-
chr17,40025747,2.545434567629931,701,478,1179,-
chr17,40025804,1.1303072579354791,1453,1062,2515,-
chr17,40028037,0.5793759166540232,715,506,1221,-
chr17,40028346,0.42758657934624855,664,526,1190,-
chr17,40028352,1.8659682874747245,726,557,1283,-
chr17,40030068,1.802127430981911,1039,661,1700,-
chr17,40030144,1.5522965097320418,925,700,1625,-
chr17,40035126,2.339880849315811,800,603,1403,-
chr17,40040483,1.856578947368421,2056,1209,3265,-
chr17,40040485,1.7299221990539506,4084,2574,6658,-
chr17,40040500,1.999424128995105,743,452,1195,-
chr17,40040505,1.2038629787982122,1392,924,2316,-
chr17,40042395,1.65270969037928,989,742,1731,-
chr17,40042412,1.27961491844987,882,663,1545,-
chr17,40049294,1.2182503118902224,724,532,1256,-
chr17,40049345,0.92282136468183,941,558,1499,-
chr17,40049346,0.92282136468183,941,558,1499,-
chr17,40049372,0.3217427733556766,575,461,1036,-
chr17,40049373,0.3217427733556766,575,461,1036,-
chr17,40054028,2.358219006950917,1428,1140,2568,-
chr17,40054076,2.061381816892728,677,458,1135,-
chr17,40058016,1.2974663667609208,945,675,1620,-
chr17,40061040,1.8212847606474367,1163,737,1900,-
chr17,40061785,2.1530920060331824,570,441,1011,-
chr17,40065801,1.870748299319728,624,440,1064,-
chr17,40065869,6.474148081553693,1446,1145,2591,-
chr17,40065870,8.651540454945811,1988,1547,3535,-
chr17,40066530,2.4329731892757103,759,440,1199,-
chr17,40066531,2.4329731892757103,759,440,1199,-
chr17,40070080,2.289293849658314,669,438,1107,-
chr17,40128532,8.843493672375091,712,1081,1793,-
chr17,40128535,16.43124910797464,869,1059,1928,-
chr17,40128544,18.882211968612243,1613,738,2351,-
chr17,40128545,26.004698410315196,1710,653,2363,-
chr17,40128546,23.584356427630723,2203,891,3094,-
chr17,40128547,34.22212163202654,1607,579,2186,-
chr17,40128733,1.8531354047034314,975,784,1759,-
chr17,40133967,1.854618434578296,1023,658,1681,-
chr17,40134311,1.6618820552744258,2276,1467,3743,-
chr17,40134316,2.078935395814377,1234,1098,2332,-
chr17,40134352,1.6273667495091948,5715,3823,9538,-
chr17,40140794,1.8435344827586209,657,463,1120,-
chr17,40141441,1.8111111111111111,3401,2915,6316,-
chr17,40141443,1.8612289477016588,5024,4239,9263,-
chr17,40141444,1.7503230073786198,3294,2726,6020,-
chr17,40141476,1.5353231106243157,1245,912,2157,-
chr17,40141479,1.762036455059711,2357,1664,4021,-
chr17,40141480,1.837174496055702,3513,2357,5870,-
chr17,40141513,1.8815207780725025,1329,1130,2459,-
chr17,40141517,3.1748133198789104,1228,990,2218,-
chr17,40141529,1.8684713500019503,1113,826,1939,-
chr17,40152561,1.136075690572505,784,578,1362,-
chr17,40169369,2.9304035870691676,598,442,1040,-
chr17,40277079,0.2596092453071127,534,954,1488,-
chr17,40277080,0.2195225279106858,765,1407,2172,-
chr17,40277082,0.2311007957559681,491,927,1418,-
chr17,40277088,11.176290500411291,1118,2941,4059,-
chr17,40277090,7.359154929577465,569,1703,2272,-
chr17,40277092,15.637482079019806,2834,3650,6484,-
chr17,40277093,21.180731215616714,3018,3267,6285,-
chr17,40277094,21.692857560101388,3204,3317,6521,-
chr17,40277095,27.371170796214635,1511,925,2436,-
chr17,40277097,7.439780200530544,1181,288,1469,-
chr17,40277103,7.774048981624936,2172,436,2608,-
chr17,40277104,9.632683491118074,3028,550,3578,-
chr17,40277105,12.84208115233859,2784,452,3236,-
chr17,40277106,21.21832403205194,2316,301,2617,-
chr17,40277107,36.97633075938956,1273,139,1412,-
chr17,40277335,8.607108745884213,1267,1009,2276,-
chr17,40277336,8.565049315835267,1648,1269,2917,-
chr17,40277341,6.440165770225921,848,482,1330,-
chr17,40277662,0.4635340216374946,607,677,1284,-
chr17,40277675,0.3938325991189427,446,680,1126,-
chr17,40277676,0.3938325991189427,446,680,1126,-
chr17,40277683,25.86181742044504,2876,2721,5597,-
chr17,40277684,24.544530176455712,3824,2965,6789,-
chr17,40277685,24.544530176455712,3824,2965,6789,-
chr17,40277686,27.281698234620983,3387,2014,5401,-
chr17,40277688,5.918922920493214,1340,307,1647,-
chr17,40277690,8.324640093366389,1471,337,1808,-
chr17,40277692,18.54945054945055,843,181,1024,-
chr17,40277694,17.19206349206349,987,213,1200,-
chr17,40280336,2.1983841958723556,829,556,1385,-
chr17,40280685,2.3885265303484426,916,523,1439,-
chr17,40280686,3.3210315695864825,678,345,1023,-
chr17,40280804,1.1549128676402471,1249,908,2157,-
chr17,40280805,0.6721560479849165,2872,1610,4482,-
chr17,40280807,0.6703125000000001,2573,1535,4108,-
chr17,40280809,0.9823813434412797,2137,1388,3525,-
chr17,40282420,1.695487861016065,3573,3356,6929,-
chr17,40282421,1.6942559727945754,4357,3975,8332,-
chr17,40282424,1.7039961327747342,674,641,1315,-
chr17,40282457,0.977236642912528,1230,1021,2251,-
chr17,40282458,0.977236642912528,1230,1021,2251,-
chr17,40282461,0.4977252047315741,546,470,1016,-
chr17,40282467,1.803986710963455,723,615,1338,-
chr17,40282468,1.803986710963455,723,615,1338,-
chr17,40282470,1.6434659090909092,1156,703,1859,-
chr17,40282471,1.6434659090909092,1156,703,1859,-
chr17,40282472,1.7501000725280411,1525,1052,2577,-
chr17,40351398,2.5504273504273507,1491,974,2465,-
chr17,40351460,3.1276722090261284,686,420,1106,-
chr17,40351498,1.0849939447319168,656,585,1241,-
chr17,40351499,1.3649299560456578,1177,943,2120,-
chr17,40352270,1.541988416988417,1064,783,1847,-
chr17,40352546,1.9652263048969618,1171,919,2090,-
chr17,40352603,1.9852923024177507,1098,813,1911,-
chr17,40352883,6.644122043147701,678,463,1141,-
chr17,40352985,0.98539435248296,1055,631,1686,-
chr17,40352987,0.98539435248296,1055,631,1686,-
chr17,40353142,5.071033451770924,669,500,1169,-
chr17,40353283,2.0410463939875707,613,406,1019,-
chr17,40353359,2.260236578707916,551,470,1021,-
chr17,40353532,0.3419983458408901,617,491,1108,-
chr17,40353711,1.6903057905009762,865,635,1500,-
chr17,40353842,1.1772819667907743,784,540,1324,-
chr17,40359619,2.188181818181818,746,549,1295,-
chr17,40359662,0.4902359238699444,941,775,1716,-
chr17,40362226,1.934029006013442,728,513,1241,-
chr17,40362283,3.2565327015523966,999,798,1797,-
chr17,40362296,1.824994489750937,919,697,1616,-
chr17,40364179,2.4257767775260723,722,472,1194,-
chr17,40369184,2.362139917695473,573,485,1058,-
chr17,40370178,0.265794559238888,595,433,1028,-
chr17,40375540,0.6041900868676545,738,514,1252,-
chr17,40376800,2.073818897637796,601,507,1108,-
chr17,40376826,2.141182744299436,1275,1086,2361,-
chr17,40376827,2.080922771920339,1003,821,1824,-
chr17,40376828,0.9008163527672431,1000,661,1661,-
chr17,40376830,1.3617077993580693,1477,1038,2515,-
chr17,40376860,2.348132000813517,557,490,1047,-
chr17,40379589,2.5827242524916945,597,429,1026,-
chr17,40384150,0.36340897750213036,687,879,1566,-
chr17,40384151,0.40617230795690107,735,857,1592,-
chr17,40466413,1.7780765330747188,2798,2078,4876,-
chr17,40466421,1.4444878356959523,5001,3606,8607,-
chr17,40466422,1.0902456612662852,2636,1704,4340,-
chr17,40466423,1.804790398860882,2365,1902,4267,-
chr17,40466428,1.3924469560076471,2512,1792,4304,-
chr17,40466429,1.6391329514725828,1935,1428,3363,-
chr17,40466433,0.2740615015974441,914,625,1539,-
chr17,40466439,1.6035915304207986,771,573,1344,-
chr17,40466444,0.4830065359477124,738,509,1247,-
chr17,40466448,0.4691091954022988,652,463,1115,-
chr17,40466449,0.48274687468065536,1180,946,2126,-
chr17,40466451,0.6047523904666762,1694,1385,3079,-
chr17,40466452,0.9240665566828614,1616,1300,2916,-
chr17,40467307,2.419398907103825,758,609,1367,-
chr17,40467309,2.419398907103825,758,609,1367,-
chr17,40467327,2.657263197635663,693,498,1191,-
chr17,40467486,7.359452093981747,2170,1758,3928,-
chr17,40467487,7.359452093981747,2170,1758,3928,-
chr17,40467639,3.353846153846154,653,539,1192,-
chr17,40467641,2.1099649862843908,1142,950,2092,-
chr17,40467717,3.3858055723149727,604,416,1020,-
chr17,40467793,2.587800369685767,949,540,1489,-
chr17,40467796,2.009498244889531,810,667,1477,-
chr17,40467802,2.5405755768732177,716,550,1266,-
chr17,40468849,1.416160055841024,884,657,1541,-
chr17,40474479,1.3264840182863846,760,607,1367,-
chr17,40475084,1.2905775845686875,681,542,1223,-
chr17,40475158,2.517094017094017,645,467,1112,-
chr17,40475159,2.517094017094017,645,467,1112,-
chr17,40481612,2.457567698259188,700,516,1216,-
chr17,40481614,2.457567698259188,700,516,1216,-
chr17,40489506,2.3620402053036784,1512,1335,2847,-
chr17,40489509,1.8460462955629215,2504,1799,4303,-
chr17,40489518,2.1888555221888555,2623,2071,4694,-
chr17,40489519,2.358601493197368,3830,2956,6786,-
chr17,40489521,2.2498672491807867,3377,2362,5739,-
chr17,40489524,1.493472584856397,1143,765,1908,-
chr17,40489530,0.6429067460317461,996,671,1667,-
chr17,40490794,1.6825256107171,588,422,1010,-
chr17,40491383,1.2672944520951894,704,542,1246,-
chr17,40500513,3.247744405013338,655,443,1098,-
chr17,40554601,4.019511278661697,1384,1041,2425,-
chr17,40554602,4.984954356165938,1561,1195,2756,-
chr17,40554730,23.2944660928118,1357,763,2120,-
chr17,40554731,20.01044427267373,686,446,1132,-
chr17,40554794,0.37307826560790985,619,382,1001,-
chr17,40555107,0.9848363344754685,710,472,1182,-
chr17,40555108,0.9848363344754685,710,472,1182,-
chr17,40555312,3.6307737322223907,1659,1294,2953,-
chr17,40555313,5.206731295820981,1811,1428,3239,-
chr17,40555314,5.206731295820981,1811,1428,3239,-
chr17,40555609,1.9448812548371281,958,655,1613,-
chr17,40555784,4.064332536873503,666,577,1243,-
chr17,40556062,6.818638630406876,1267,888,2155,-
chr17,40556063,8.099070495023222,2137,1545,3682,-
chr17,40556064,8.099070495023222,2137,1545,3682,-
chr17,40556269,1.9442949006519985,746,559,1305,-
chr17,40556346,2.6729643695722625,633,437,1070,-
chr17,40556571,3.0122254337015026,590,471,1061,-
chr17,40574935,0.43241849901380874,947,771,1718,-
chr17,40574936,0.4936024844720497,882,699,1581,-
chr17,40574938,1.106753307006856,1070,905,1975,-
chr17,40725623,2.029165354042037,621,433,1054,-
chr17,40725630,1.8555185487227517,1099,653,1752,-
chr17,40725632,2.644883485309017,680,422,1102,-
chr17,40950001,1.120049504950495,904,605,1509,-
chr17,40950003,1.120049504950495,904,605,1509,-
chr17,40950669,2.285765157811025,772,674,1446,-
chr17,40962269,1.787128712871287,721,504,1225,-
chr17,40962462,1.659622641509434,732,476,1208,-
chr17,40962585,0.9605390824808187,850,622,1472,-
chr17,40963702,2.18986780232455,1147,577,1724,-
chr17,40963765,2.27417683762719,1426,788,2214,-
chr17,40963807,0.3336100083525684,1453,878,2331,-
chr17,40963808,0.3528173953705868,1005,610,1615,-
chr17,40967959,0.92675852066715,638,393,1031,-
chr17,40967960,0.92675852066715,638,393,1031,-
chr17,40970586,2.642156862745098,769,359,1128,-
chr17,40970614,1.670191069128381,1352,821,2173,-
chr17,40970615,1.670191069128381,1352,821,2173,-
chr17,40970633,0.3120834060070868,1229,799,2028,-
chr17,40970634,0.5735867446393762,1176,835,2011,-
chr17,40970636,0.8012903225806454,758,549,1307,-
chr17,40971617,3.602698345872944,618,405,1023,-
chr17,41108534,1.2671539411433457,751,511,1262,-
chr17,41622373,0.8675384896545072,739,612,1351,-
chr17,41843668,1.4849580287029513,1636,1230,2866,-
chr17,41843677,1.678467987804878,830,655,1485,-
chr17,41843678,1.4948384948384947,1071,923,1994,-
chr17,41843681,1.5260737628384689,1832,1529,3361,-
chr17,41843682,1.5260737628384689,1832,1529,3361,-
chr17,41843685,1.135112341703178,1755,1324,3079,-
chr17,41843688,0.6854785478547856,803,605,1408,-
chr17,41843729,3.3031249420074924,753,523,1276,-
chr17,41843744,2.833245515912214,748,528,1276,-
chr17,41847132,1.1936684941285642,943,568,1511,-
chr17,42088760,0.2791422121896162,686,442,1128,-
chr17,42088925,1.0848394370751124,713,589,1302,-
chr17,42088994,2.5071810165277215,3982,3021,7003,-
chr17,42089011,1.7762651141961487,1183,811,1994,-
chr17,42089018,2.1571276217561324,1035,678,1713,-
chr17,42089026,2.550993377483444,1497,905,2402,-
chr17,42089028,1.7909196680304498,3307,2220,5527,-
chr17,42089038,1.888977111553052,1396,981,2377,-
chr17,42089047,1.8065903890160184,730,436,1166,-
chr17,42089057,0.5724530831099196,656,372,1028,-
chr17,42089086,3.2027108433734943,685,414,1099,-
chr17,42089088,3.2027108433734943,685,414,1099,-
chr17,42092321,0.42404945887316314,637,447,1084,-
chr17,42397061,1.8487394957983192,593,566,1159,-
chr17,42397063,0.6124249656469226,1167,837,2004,-
chr17,42397121,1.9949773982923154,661,542,1203,-
chr17,42397124,0.7553487977788845,1079,792,1871,-
chr17,42397136,1.9251247920133112,800,600,1400,-
chr17,42397194,1.6843679745918043,1051,827,1878,-
chr17,42397265,2.121856365050557,791,550,1341,-
chr17,42397267,2.121856365050557,791,550,1341,-
chr17,42397467,1.671539961013645,685,512,1197,-
chr17,42397468,1.6824413976116763,633,645,1278,-
chr17,42397570,1.8915599810336647,972,702,1674,-
chr17,42397581,1.79296875,577,511,1088,-
chr17,42397601,1.82682967677106,1009,852,1861,-
chr17,42397602,1.2940495890433317,1582,1384,2966,-
chr17,42397767,2.1491927512355846,708,606,1314,-
chr17,42397996,1.671985157699443,750,538,1288,-
chr17,42398080,0.6148837209302326,660,574,1234,-
chr17,42398564,1.9671662434562895,1469,972,2441,-
chr17,42398583,2.052604136787477,1471,888,2359,-
chr17,42398595,2.5778846153846158,765,389,1154,-
chr17,42398891,1.8997867803837956,593,468,1061,-
chr17,42398896,1.386031265758951,1194,660,1854,-
chr17,42398923,2.2407794015309674,574,478,1052,-
chr17,42399843,1.7097114794352366,1338,904,2242,-
chr17,42400184,2.098829416495398,733,588,1321,-
chr17,42400847,1.794756158613481,1513,1246,2759,-
chr17,42400862,1.9144736842105263,581,474,1055,-
chr17,42400889,1.7060251651609593,2048,1178,3226,-
chr17,42400890,1.7060251651609593,2048,1178,3226,-
chr17,42402120,1.1845700416865426,992,788,1780,-
chr17,42761276,1.6950018956470096,694,404,1098,-
chr17,42881804,0.3415002115088083,567,763,1330,-
chr17,42881805,0.3775621981783727,529,701,1230,-
chr17,42881820,2.713499127242934,406,672,1078,-
chr17,42928588,1.870422535211268,663,425,1088,-
chr17,42928597,1.859658906714392,978,609,1587,-
chr17,42928681,2.2493023255813958,743,429,1172,-
chr17,42929099,2.196082949308756,705,559,1264,-
chr17,42929100,2.1564562756374097,983,773,1756,-
chr17,42930685,3.411123227917121,543,523,1066,-
chr17,42930687,3.411123227917121,543,523,1066,-
chr17,42932357,3.0160505474164907,1068,903,1971,-
chr17,42934486,2.565121412803532,580,452,1032,-
chr17,42936460,1.819433198380567,641,389,1030,-
chr17,42936490,2.859797929623879,673,591,1264,-
chr17,42936505,3.730639730639731,553,461,1014,-
chr17,42936506,3.730639730639731,553,461,1014,-
chr17,42937407,1.826127870377381,1442,1566,3008,-
chr17,42937408,1.826127870377381,1442,1566,3008,-
chr17,42937807,1.54855674415825,631,576,1207,-
chr17,42937825,1.0310109859546657,1010,917,1927,-
chr17,42937826,1.408808835863412,1570,1477,3047,-
chr17,42937832,2.741696227023541,653,442,1095,-
chr17,42942317,1.9101513678655744,654,378,1032,-
chr17,42942350,2.9565366779138027,909,544,1453,-
chr17,42945192,1.9872770769899961,730,417,1147,-
chr17,42949857,1.7744419382437584,670,558,1228,-
chr17,42949876,1.5721804511278197,917,629,1546,-
chr17,42953346,2.0891936632982095,1310,1076,2386,-
chr17,42953395,1.4935828877005348,664,424,1088,-
chr17,42953398,1.5104259340806114,2047,1381,3428,-
chr17,42953400,1.5104259340806114,2047,1381,3428,-
chr17,42957996,3.6328273244781775,1093,743,1836,-
chr17,42960522,1.7403760602645475,2885,2198,5083,-
chr17,42960523,1.7403760602645475,2885,2198,5083,-
chr17,42961069,3.9832028085336204,1208,804,2012,-
chr17,42962649,1.5328282828282829,1213,791,2004,-
chr17,42963990,1.140509071695176,1031,828,1859,-
chr17,42964026,2.172439949995555,1076,792,1868,-
chr17,42976761,1.1753552871722186,1012,766,1778,-
chr17,42976762,0.8848534101982799,979,774,1753,-
chr17,43197806,1.61830148179134,742,438,1180,-
chr17,43197809,2.154475465028649,656,405,1061,-
chr17,43197812,1.0053443728175244,1155,642,1797,-
chr17,43197814,1.1872478440664929,1414,782,2196,-
chr17,43197816,0.6705259026687598,803,415,1218,-
chr17,45195880,0.10573567220147957,1110,878,1988,-
chr17,45195882,0.1909849761612479,3063,2709,5772,-
chr17,45195883,0.20467146687991025,2477,2268,4745,-
chr17,45195884,0.2135204737917721,2121,1919,4040,-
chr17,45197984,1.8687943262411344,611,422,1033,-
chr17,45199814,1.7827690972222223,1059,575,1634,-
chr17,45199822,2.1387557492132654,1003,764,1767,-
chr17,45199864,1.8391472868217056,948,687,1635,-
chr17,45199903,2.356784434203789,621,464,1085,-
chr17,45216138,3.0062370062370065,722,480,1202,-
chr17,45216140,3.0062370062370065,722,480,1202,-
chr17,45219310,1.46372657790927,3219,2027,5246,-
chr17,45219311,1.4731037162847662,4707,2927,7634,-
chr17,45219368,1.6481164383561644,769,437,1206,-
chr17,45219601,2.0518358531317493,683,462,1145,-
chr17,45219649,1.7768478756108304,679,452,1131,-
chr17,45232095,3.0935625399968405,628,479,1107,-
chr17,45247320,2.1537078651685397,598,444,1042,-
chr17,45249408,2.775902656979132,1165,758,1923,-
chr17,45249409,2.775902656979132,1165,758,1923,-
chr17,45900905,1.6279293739967895,921,711,1632,-
chr17,45900919,0.5666263299184426,1777,1157,2934,-
chr17,45900922,1.0304584099316847,1170,824,1994,-
chr17,45900925,1.2950983492505217,1263,814,2077,-
chr17,45900926,1.0250197439779027,2292,1507,3799,-
chr17,45900927,0.9432147119420036,2714,1794,4508,-
chr17,45900975,1.767032967032967,602,454,1056,-
chr17,45901649,1.1279947163020534,795,513,1308,-
chr17,45901735,4.073148040921885,664,392,1056,-
chr17,45901736,4.073148040921885,664,392,1056,-
chr17,46147825,3.816441341871537,1056,939,1995,-
chr17,46147826,3.4232044433247926,1705,1510,3215,-
chr17,46147854,3.6988388396558554,787,694,1481,-
chr17,46148268,0.18842433482688375,573,865,1438,-
chr17,46148325,9.82358859044006,1745,3007,4752,-
chr17,46148326,9.82358859044006,1745,3007,4752,-
chr17,46148332,5.329863371456955,1034,1290,2324,-
chr17,46148340,9.850837861946717,2138,1414,3552,-
chr17,46148341,9.850837861946717,2138,1414,3552,-
chr17,46148342,10.810530517113577,1820,1220,3040,-
chr17,46148345,49.86152134850689,1256,252,1508,-
chr17,46148346,49.86152134850689,1256,252,1508,-
chr17,46148347,49.86152134850689,1256,252,1508,-
chr17,46148549,1.6903106029351092,1398,721,2119,-
chr17,46148584,0.5637472283813747,677,351,1028,-
chr17,46148629,1.7311320754716983,733,423,1156,-
chr17,46148643,0.3164655205867515,1164,705,1869,-
chr17,46148644,0.3164655205867515,1164,705,1869,-
chr17,46148679,0.48899005059746614,584,438,1022,-
chr17,46153368,0.6210081711601468,873,538,1411,-
chr17,46153447,3.1169120928157072,1396,1244,2640,-
chr17,46153448,3.1169120928157072,1396,1244,2640,-
chr17,46153449,3.1169120928157072,1396,1244,2640,-
chr17,46685394,2.054288150042625,1985,1274,3259,-
chr17,46685395,2.054288150042625,1985,1274,3259,-
chr17,46685396,2.054288150042625,1985,1274,3259,-
chr17,46685399,0.4366735233617396,742,414,1156,-
chr17,47009077,1.8402061855670104,594,484,1078,-
chr17,47010601,0.5353893185886232,1303,944,2247,-
chr17,47013552,4.979313701630566,659,586,1245,-
chr17,47013553,3.35010656906055,1076,892,1968,-
chr17,47018399,2.159199066371409,1149,949,2098,-
chr17,47482297,2.4302246426140237,594,564,1158,-
chr17,47482552,0.6491365353480842,1457,871,2328,-
chr17,47482555,1.5896368829049368,846,644,1490,-
chr17,47484186,1.6080139372822302,922,573,1495,-
chr17,47486455,1.8039548022598868,720,589,1309,-
chr17,47486497,1.779511179365087,3008,2145,5153,-
chr17,47486499,2.7519527199834104,1224,850,2074,-
chr17,47486744,0.6730349054090061,870,694,1564,-
chr17,47486748,2.219903381642512,717,574,1291,-
chr17,47486765,1.574699848627926,2224,1632,3856,-
chr17,47486819,1.442561230099436,4074,2829,6903,-
chr17,47486834,2.121794871794872,992,683,1675,-
chr17,47490630,1.9384236453201968,786,559,1345,-
chr17,47490632,2.8902183899002996,1244,998,2242,-
chr17,47490635,1.154019074173247,1648,1096,2744,-
chr17,47492201,2.170074900472785,1665,950,2615,-
chr17,47492225,2.6206384998813195,700,382,1082,-
chr17,47492226,2.9891281385133244,2054,992,3046,-
chr17,47492232,1.953184934780566,1267,596,1863,-
chr17,47492236,0.703420523138833,1011,354,1365,-
chr17,47492238,0.703420523138833,1011,354,1365,-
chr17,47492241,0.8577790669389365,1178,455,1633,-
chr17,48445572,0.9605540499849444,769,566,1335,-
chr17,48445574,0.8314993891580277,1105,789,1894,-
chr17,48447869,5.34896401308615,544,523,1067,-
chr17,48447870,5.34896401308615,544,523,1067,-
chr17,48459111,1.005641347085304,1102,762,1864,-
chr17,48459112,1.005641347085304,1102,762,1864,-
chr17,48459283,3.803374518400425,841,578,1419,-
chr17,48459284,3.803374518400425,841,578,1419,-
chr17,48459389,1.25679544108745,692,530,1222,-
chr17,48459429,0.9937798460516918,687,565,1252,-
chr17,48459656,0.4910411622276028,623,471,1094,-
chr17,48459876,2.963633690730736,1152,856,2008,-
chr17,48459895,2.50391474554154,793,483,1276,-
chr17,48459896,2.50391474554154,793,483,1276,-
chr17,48460052,0.41584762724490637,1287,1803,3090,-
chr17,48460053,0.3937093801532641,954,1351,2305,-
chr17,48460054,0.42014661137027326,1399,1789,3188,-
chr17,48460083,7.654393805489302,1361,1906,3267,-
chr17,48460084,6.373241131264408,3277,3888,7165,-
chr17,48460085,6.373241131264408,3277,3888,7165,-
chr17,48460086,6.640900989631274,2813,3191,6004,-
chr17,48460239,1.6842226842226842,633,467,1100,-
chr17,48460427,1.525540892562087,763,580,1343,-
chr17,48460469,7.249692847930425,2203,1473,3676,-
chr17,48460470,7.503093116623931,1940,1291,3231,-
chr17,48469763,1.9773662551440332,743,485,1228,-
chr17,48469778,1.7583135391923992,657,420,1077,-
chr17,48469786,1.9877860235003095,597,461,1058,-
chr17,48470147,1.5741626794258374,657,417,1074,-
chr17,48470229,2.7301587301587302,601,440,1041,-
chr17,48772949,2.4901597592035194,716,616,1332,-
chr17,48772951,2.4901597592035194,716,616,1332,-
chr17,48939952,1.4383103448275862,1573,999,2572,-
chr17,48940070,1.4505407544183593,1691,1114,2805,-
chr17,48940468,1.8858752515090544,807,496,1303,-
chr17,48940516,3.179824561403509,724,436,1160,-
chr17,48940546,2.422330976980243,770,612,1382,-
chr17,48940547,2.422330976980243,770,612,1382,-
chr17,48940722,1.745686274509804,613,424,1037,-
chr17,48940775,5.777235772357724,645,409,1054,-
chr17,48940783,1.9320223738300566,1052,642,1694,-
chr17,48940807,1.700847689362866,621,476,1097,-
chr17,48940987,1.7243243243243245,824,554,1378,-
chr17,48941064,1.5338804713804717,984,593,1577,-
chr17,48941120,2.3811294509514855,1290,829,2119,-
chr17,48941301,1.908976516976387,2250,1717,3967,-
chr17,48941304,1.468741239136529,805,695,1500,-
chr17,48941305,0.3772453435030122,1240,977,2217,-
chr17,48941326,1.5505839089974176,3458,2554,6012,-
chr17,48941328,1.5505839089974176,3458,2554,6012,-
chr17,49270793,0.958132045088567,594,413,1007,-
chr17,49270794,0.760663759013244,804,591,1395,-
chr17,49270800,0.3334738681566702,679,465,1144,-
chr17,53042178,3.0856102249113775,800,484,1284,-
chr17,53470441,0.9910016203410528,1312,637,1949,-
chr17,53470463,2.6023255813953488,745,300,1045,-
chr17,53470465,2.6023255813953488,745,300,1045,-
chr17,55917043,0.5816566643110445,1561,1087,2648,-
chr17,55917049,1.6566507177033492,540,549,1089,-
chr17,55918613,2.879624735729387,702,472,1174,-
chr17,55926674,2.0771727181228825,1820,919,2739,-
chr17,55926687,0.625459446214163,1020,615,1635,-
chr17,55926714,1.656780970033982,691,497,1188,-
chr17,55926738,2.486379562786071,1423,839,2262,-
chr17,55926739,2.213070257855726,985,617,1602,-
chr17,55926758,3.64928484339359,678,396,1074,-
chr17,56080971,1.567708333333333,902,671,1573,-
chr17,56081059,1.8672945925489866,792,516,1308,-
chr17,56081402,0.6798515460643829,1104,853,1957,-
chr17,56081429,1.4575866188769415,914,712,1626,-
chr17,56081609,0.5925925925925926,727,503,1230,-
chr17,56081807,1.3858993190153193,2479,1659,4138,-
chr17,56082054,3.5809598127194704,705,465,1170,-
chr17,56082107,2.269393905569818,1098,577,1675,-
chr17,56082108,2.269393905569818,1098,577,1675,-
chr17,56082252,2.333333333333333,703,479,1182,-
chr17,56082425,0.677566155401989,1339,1046,2385,-
chr17,56082452,1.9717583497053046,650,508,1158,-
chr17,56082486,1.8366970219049965,596,477,1073,-
chr17,56082780,0.56473133790119,782,516,1298,-
chr17,56082803,1.651176051318603,701,609,1310,-
chr17,56082811,2.2747068676716915,678,596,1274,-
chr17,56082897,0.3850772179825673,818,642,1460,-
chr17,56082903,2.5210704665913632,828,676,1504,-
chr17,56082919,1.8993742177722155,541,469,1010,-
chr17,56083316,1.8913516655010885,800,551,1351,-
chr17,56423406,4.974340819789227,1865,1391,3256,-
chr17,56423407,3.6908032443746728,924,727,1651,-
chr17,56423409,2.676855895196506,612,457,1069,-
chr17,56423413,75.02511072540607,3115,1299,4414,-
chr17,56423414,66.46440614076762,3440,1365,4805,-
chr17,56423419,39.30722891566265,1304,165,1469,-
chr17,56423420,30.461242631761184,5436,822,6258,-
chr17,56423421,33.99465469495957,5847,864,6711,-
chr17,56423422,33.53041535228409,5416,804,6220,-
chr17,56423423,60.37288135593221,1232,176,1408,-
chr17,56423522,2.554256268097951,1253,808,2061,-
chr17,56423635,2.249533200358296,1172,885,2057,-
chr17,56423637,2.4336821611097585,799,586,1385,-
chr17,56428816,0.4913363656053715,697,485,1182,-
chr17,57188967,1.3593332144767338,1546,993,2539,-
chr17,57188979,0.7137745974955277,1175,727,1902,-
chr17,57189028,17.134615384615387,647,415,1062,-
chr17,57189037,2.169263965475905,1247,775,2022,-
chr17,57189038,2.169263965475905,1247,775,2022,-
chr17,57189054,3.0634683286300333,777,448,1225,-
chr17,57208656,2.095184085526026,687,427,1114,-
chr17,57774781,2.490980858044651,785,593,1378,-
chr17,57774939,1.9752871562826313,1134,662,1796,-
chr17,57774940,1.9752871562826313,1134,662,1796,-
chr17,57775041,3.3139842298410636,645,496,1141,-
chr17,57775180,2.3832976275499376,1125,782,1907,-
chr17,57775182,2.398428290766208,762,508,1270,-
chr17,57775296,0.5670997617227892,900,766,1666,-
chr17,57775311,1.942663311084364,806,702,1508,-
chr17,57775320,1.8333333333333333,681,557,1238,-
chr17,57784790,0.8755643515962352,756,530,1286,-
chr17,58160960,22.44556711082223,1113,697,1810,-
chr17,58160961,22.44556711082223,1113,697,1810,-
chr17,58160962,22.44556711082223,1113,697,1810,-
chr17,61822902,0.3539134662129314,839,604,1443,-
chr17,61822904,0.3539134662129314,839,604,1443,-
chr17,61822978,1.9171190265721514,516,593,1109,-
chr17,61823032,23.073588434596395,710,825,1535,-
chr17,61823842,2.684873949579832,567,815,1382,-
chr17,61823850,1.9221175166297118,1094,1352,2446,-
chr17,61823851,1.9221175166297118,1094,1352,2446,-
chr17,61823856,1.9267181620122797,511,560,1071,-
chr17,61824274,1.2728754106564117,587,491,1078,-
chr17,61829327,2.4262202556162955,878,602,1480,-
chr17,61829447,1.575571430995571,3094,1900,4994,-
chr17,61829448,1.575571430995571,3094,1900,4994,-
chr17,61829459,0.5104788999525842,1537,1109,2646,-
chr17,61829702,2.053146853146853,733,439,1172,-
chr17,61833673,1.8389112731466446,1044,721,1765,-
chr17,61838659,1.7202934946117459,733,485,1218,-
chr17,61843310,3.320022725628326,640,533,1173,-
chr17,61843371,3.1721873460054955,868,658,1526,-
chr17,61901308,0.22580232742572717,671,856,1527,-
chr17,61901475,0.15090487289938428,384,732,1116,-
chr17,61901500,18.59167270736638,437,639,1076,-
chr17,61904217,1.627799325321102,865,570,1435,-
chr17,62230474,2.003260234998038,704,446,1150,-
chr17,62496202,1.7275919189614972,4586,3334,7920,-
chr17,62496372,0.5401717157615525,1406,987,2393,-
chr17,62496706,2.0340435662421137,1067,812,1879,-
chr17,62496759,0.6272035071527458,2090,1575,3665,-
chr17,62497607,2.8118098159509204,872,651,1523,-
chr17,62498151,1.4978178538575875,3929,2825,6754,-
chr17,62499057,1.5466190894790413,2756,1711,4467,-
chr17,62499361,1.5063908509922637,1351,990,2341,-
chr17,62499398,1.3318755835094098,2084,1731,3815,-
chr17,62499591,1.2442824955245173,4214,3151,7365,-
chr17,62499601,1.455190644484671,1446,1288,2734,-
chr17,62499631,0.5194992778045258,1078,602,1680,-
chr17,62499663,0.4143835616438355,692,510,1202,-
chr17,62500114,1.5650345908343843,1387,968,2355,-
chr17,62500356,1.546638655462185,1635,1189,2824,-
chr17,62500397,1.8397190293742016,870,782,1652,-
chr17,62500906,2.000375445841937,1109,760,1869,-
chr17,62500913,1.6758898681423788,1114,860,1974,-
chr17,62500914,1.6758898681423788,1114,860,1974,-
chr17,62500919,2.3215317011927183,901,589,1490,-
chr17,62500937,3.4906415665909334,871,710,1581,-
chr17,62502303,1.9731530308340435,4294,3324,7618,-
chr17,62502304,1.9731530308340435,4294,3324,7618,-
chr17,63008521,1.121806353652464,2904,1843,4747,-
chr17,63008525,0.4624298388556943,1276,788,2064,-
chr17,63008526,1.5632894292468758,1128,704,1832,-
chr17,63008531,2.282516891891892,1034,665,1699,-
chr17,63008537,1.1984731518060547,2313,1484,3797,-
chr17,63008555,1.847715736040609,727,393,1120,-
chr17,63008556,1.7603108371647014,1462,859,2321,-
chr17,63008557,1.866932013769363,1067,663,1730,-
chr17,63008559,2.269578313253012,684,414,1098,-
chr17,65337040,1.4859083338062653,706,556,1262,-
chr17,65343575,2.556788955953266,622,437,1059,-
chr17,65344695,3.177349677788172,645,424,1069,-
chr17,66263501,0.3364362719920925,1752,3200,4952,-
chr17,66263507,0.3401069140085673,738,1201,1939,-
chr17,66263537,21.187959178948567,5636,5153,10789,-
chr17,66263538,19.68950363419029,7424,5464,12888,-
chr17,66263539,20.645226300099793,8427,5606,14033,-
chr17,66263540,10.245550798091216,6956,1493,8449,-
chr17,66263541,6.108270876217231,4075,631,4706,-
chr17,66263542,8.770772238514175,2424,309,2733,-
chr17,66263543,10.874953132923569,2237,275,2512,-
chr17,66263544,12.883928571428573,1442,167,1609,-
chr17,66263796,2.0244253771834733,1080,823,1903,-
chr17,66264187,1.9816579543563162,1446,1143,2589,-
chr17,66264265,0.2391919191919192,591,449,1040,-
chr17,66264439,2.243197922864716,1507,972,2479,-
chr17,66264440,2.467924361714806,2175,1385,3560,-
chr17,66264441,2.9832775919732444,668,413,1081,-
chr17,66264546,0.4969061876247505,765,500,1265,-
chr17,66264658,1.87192118226601,607,405,1012,-
chr17,66264774,1.2393319128725766,1459,1000,2459,-
chr17,66264980,1.6887826260211198,651,477,1128,-
chr17,66265023,2.013966119229277,598,406,1004,-
chr17,66265105,0.2908703590992088,530,529,1059,-
chr17,66265172,13.392471435210625,4345,5385,9730,-
chr17,66265173,13.392471435210625,4345,5385,9730,-
chr17,66265174,13.392471435210625,4345,5385,9730,-
chr17,66265182,30.15251225997424,2532,1190,3722,-
chr17,66265183,30.152512259974245,2532,1190,3722,-
chr17,66265194,8.71111111111111,930,189,1119,-
chr17,66267713,5.093167701863353,819,643,1462,-
chr17,66267736,2.9654157468727003,619,452,1071,-
chr17,66270094,2.193578464754707,1501,1047,2548,-
chr17,66270096,2.2411194942637738,1391,959,2350,-
chr17,71205149,1.978888888888889,547,479,1026,-
chr17,71205163,0.5285996055226824,803,506,1309,-
chr17,71280422,0.8218965571999527,689,439,1128,-
chr17,73036224,0.6832094931795497,1368,1015,2383,-
chr17,73038680,2.3524891632733484,832,661,1493,-
chr17,73038687,1.6358832715551332,2024,1425,3449,-
chr17,73038720,0.6125631543914318,2082,1721,3803,-
chr17,73038722,0.581015717099569,2037,1619,3656,-
chr17,73143653,1.577518423109065,636,479,1115,-
chr17,73143694,1.5938121535685785,13973,8049,22022,-
chr17,73143695,1.497835967240382,17335,9988,27323,-
chr17,73143697,1.4833708993001966,14334,8226,22560,-
chr17,73143698,1.6749334891891505,7819,4436,12255,-
chr17,73143699,1.6076113272395256,8359,4670,13029,-
chr17,73143706,1.5906197389278325,3655,1873,5528,-
chr17,73143712,1.5223460223341116,5962,2768,8730,-
chr17,73143714,1.5505710367219916,6889,3118,10007,-
chr17,73143715,1.5942823635131325,1974,776,2750,-
chr17,73143720,0.6635680379746837,1341,639,1980,-
chr17,73144685,1.8508194233373039,1101,789,1890,-
chr17,73150485,4.47893372883642,587,427,1014,-
chr17,73163963,4.13161743199766,1008,788,1796,-
chr17,73164344,1.6705901322154144,796,442,1238,-
chr17,73164359,1.9732149631990286,742,572,1314,-
chr17,73164361,2.4218449151058987,1152,590,1742,-
chr17,73164363,2.4218449151058987,1152,590,1742,-
chr17,73164379,2.297131807927812,791,320,1111,-
chr17,73164380,2.297131807927812,791,320,1111,-
chr17,73164381,0.415196207391467,1255,960,2215,-
chr17,73164383,0.3782248157248157,820,591,1411,-
chr17,73177173,1.531650417827298,1022,717,1739,-
chr17,73177175,0.5755329008341057,1214,746,1960,-
chr17,73177177,1.692702110712864,918,647,1565,-
chr17,73177181,2.072264672748806,1915,1470,3385,-
chr17,73177206,1.7587783496400708,1020,571,1591,-
chr17,73178962,3.024769433465086,882,758,1640,-
chr17,73178991,0.5386513157894737,654,575,1229,-
chr17,73179008,1.7314615384615384,548,499,1047,-
chr17,73179026,0.6555408388520971,695,452,1147,-
chr17,73179048,1.137688006980577,589,478,1067,-
chr17,73179052,4.372198963566207,617,428,1045,-
chr17,73316273,3.4161976235146967,574,491,1065,-
chr17,73316274,3.7667562404486636,823,709,1532,-
chr17,73316275,3.733353234825657,996,835,1831,-
chr17,73316280,11.450028705254537,1142,743,1885,-
chr17,73316281,18.235294117647054,712,390,1102,-
chr17,73316282,13.225135720822033,1678,1047,2725,-
chr17,73316283,19.45038757678191,890,501,1391,-
chr17,73316479,1.706180327682314,743,516,1259,-
chr17,73316481,2.4447635606398332,713,483,1196,-
chr17,73316601,2.5978591588647846,679,455,1134,-
chr17,73773987,1.5683237829745496,867,586,1453,-
chr17,73774204,2.1570381852833225,763,614,1377,-
chr17,73774676,0.7607552862968812,2016,1437,3453,-
chr17,73774683,1.8914575633049424,1497,1012,2509,-
chr17,73774685,1.804026006734886,2172,1356,3528,-
chr17,73774687,1.804026006734886,2172,1356,3528,-
chr17,73774697,2.1844354475933425,1213,740,1953,-
chr17,73774709,1.8318543216209278,991,556,1547,-
chr17,73774951,1.8137260627771048,1837,1365,3202,-
chr17,73774966,2.763373362445415,674,457,1131,-
chr17,73774987,1.7850378787878791,753,479,1232,-
chr17,73775130,1.5377045069892812,1442,902,2344,-
chr17,73775176,1.8395967932889083,1132,628,1760,-
chr17,73775188,1.9991754277468565,745,692,1437,-
chr17,73775227,1.536121054344289,1048,877,1925,-
chr17,73775256,1.0280918073730416,4279,2730,7009,-
chr17,73775257,0.8820947387672986,3444,2093,5537,-
chr17,73775258,0.8203609153874788,4294,2741,7035,-
chr17,73775261,0.5459183673469388,1283,1028,2311,-
chr17,73775262,0.5459183673469388,1283,1028,2311,-
chr17,73775263,1.6165099268547545,636,461,1097,-
chr17,73775820,1.3743448894369554,1485,1150,2635,-
chr17,73775853,0.6697491199311247,2664,2038,4702,-
chr17,73775858,0.8701306089004455,6694,5537,12231,-
chr17,73775859,0.9507206568610076,2498,2393,4891,-
chr17,73775860,0.9354491130504033,4292,3666,7958,-
chr17,73841956,2.2047144056278425,708,541,1249,-
chr17,73841980,3.2565230863123777,622,520,1142,-
chr17,73842704,1.6937856473393185,556,461,1017,-
chr17,73842727,28.97237901363074,1349,952,2301,-
chr17,73842728,28.97237901363074,1349,952,2301,-
chr17,73842779,3.05773499959439,705,379,1084,-
chr17,73843025,0.9457910787975454,678,479,1157,-
chr17,73844731,4.410133136094675,794,675,1469,-
chr17,73845786,0.524639377840763,1435,931,2366,-
chr17,73845788,0.5086432986371221,1369,936,2305,-
chr17,73851340,3.557698044007183,632,490,1122,-
chr17,73870656,3.8855430577402217,732,545,1277,-
chr17,74035312,2.277267418890885,655,457,1112,-
chr17,74046571,0.3344014811649932,586,452,1038,-
chr17,74046574,0.6033963627604481,667,436,1103,-
chr17,74046591,0.4942716607601124,960,710,1670,-
chr17,74053598,3.1430814338409157,619,545,1164,-
chr17,74063395,2.065034526051475,513,530,1043,-
chr17,74063401,1.9622734535208,1042,893,1935,-
chr17,74068456,0.36511419555147134,646,958,1604,-
chr17,74097810,5.042956973950774,532,551,1083,-
chr17,74097812,2.26908542676623,612,482,1094,-
chr17,74676636,1.7198183267389795,748,596,1344,-
chr17,74676638,3.3532899493853936,681,460,1141,-
chr17,74730421,1.578540772532189,612,465,1077,-
chr17,74730494,1.4998042669798397,612,523,1135,-
chr17,74730520,1.2259516240671022,1128,840,1968,-
chr17,74730753,2.5952107279693486,588,434,1022,-
chr17,74730876,1.9373323797604147,1666,1189,2855,-
chr17,74731073,1.722473361317404,1134,814,1948,-
chr17,74731092,1.8606802721088436,1051,734,1785,-
chr17,74731203,1.5228161668839637,1167,766,1933,-
chr17,74732242,2.308031496062992,915,634,1549,-
chr17,74732308,1.0159395973154364,864,595,1459,-
chr17,74732310,1.0159395973154364,864,595,1459,-
chr17,74732319,0.3945861655956484,755,611,1366,-
chr17,74732338,2.0390243902439025,703,655,1358,-
chr17,74732340,2.0390243902439025,703,655,1358,-
chr17,74732401,0.3015202702702702,611,443,1054,-
chr17,74732497,2.531836115326252,868,658,1526,-
chr17,74732499,2.531836115326252,868,658,1526,-
chr17,74733136,2.528320719756158,632,404,1036,-
chr17,74733401,1.6913356745445862,851,568,1419,-
chr17,76170346,2.9015799015799018,658,593,1251,-
chr17,76170347,2.9015799015799018,658,593,1251,-
chr17,76170365,2.242108190794048,700,422,1122,-
chr17,76170936,1.023267326732673,794,504,1298,-
chr17,76170937,1.023267326732673,794,504,1298,-
chr17,76170940,2.740106951871658,724,491,1215,-
chr17,76171008,0.865628090999011,760,673,1433,-
chr17,76171010,0.865628090999011,760,673,1433,-
chr17,76171247,2.4565502506068917,625,496,1121,-
chr17,76171652,2.0456020187454937,1260,1021,2281,-
chr17,76171653,1.7777634399646172,2101,1569,3670,-
chr17,76171654,2.0456020187454937,1260,1021,2281,-
chr17,76182873,2.0051089261615576,670,493,1163,-
chr17,76183127,0.49022312596597944,1831,1268,3099,-
chr17,76183131,0.719042336138332,1427,1078,2505,-
chr17,76183132,0.9032173318458272,932,750,1682,-
chr17,76793845,2.6650579150579152,752,443,1195,-
chr17,76793846,2.412211726397411,1241,687,1928,-
chr17,76849403,2.010752688172043,917,557,1474,-
chr17,76849443,1.688622754491018,845,500,1345,-
chr17,76849447,2.5672389127324746,775,465,1240,-
chr17,76849505,3.627594936708861,622,394,1016,-
chr17,76849575,2.3181779783020597,1331,1116,2447,-
chr17,76849610,2.8571428571428577,899,629,1528,-
chr17,76849816,1.5922909880564606,837,613,1450,-
chr17,76849839,2.0918162204723583,1209,835,2044,-
chr17,76850037,1.874217772215269,598,469,1067,-
chr17,76850071,3.427052150622341,852,576,1428,-
chr17,76850072,3.427052150622341,852,576,1428,-
chr17,76850235,1.812911392405063,681,394,1075,-
chr17,76850374,2.029364224137931,557,463,1020,-
chr17,76851651,1.6961662749706228,744,591,1335,-
chr17,76851655,1.5972954230235783,742,514,1256,-
chr17,76851715,2.322925748974049,2367,1763,4130,-
chr17,76851717,2.322925748974049,2367,1763,4130,-
chr17,76851827,2.046807432274078,1303,879,2182,-
chr17,76851917,1.3252259080603597,2084,1377,3461,-
chr17,76851918,0.9549452782535488,1529,930,2459,-
chr17,76851929,2.1651964715316763,674,386,1060,-
chr17,76866995,2.1092161734809127,746,465,1211,-
chr17,76869951,2.162638469284995,858,992,1850,-
chr17,76869959,1.8820722891566264,796,829,1625,-
chr17,76869965,2.197226140103432,718,708,1426,-
chr17,76921047,2.1163479052823315,714,487,1201,-
chr17,76921065,0.9862926566010177,767,561,1328,-
chr17,76921088,3.2254982254982254,694,406,1100,-
chr17,76921090,3.2254982254982254,694,406,1100,-
chr17,76967440,0.6304182286785378,860,775,1635,-
chr17,76967535,1.4057785987033347,3347,2438,5785,-
chr17,76967544,2.6993379579563737,1504,1222,2726,-
chr17,76967626,1.8579415918714377,2558,1772,4330,-
chr17,76967634,2.020594340653337,786,677,1463,-
chr17,76967722,2.469875758819053,2223,1735,3958,-
chr17,76967808,1.874994141715671,31263,22796,54059,-
chr17,76967809,1.874994141715671,31263,22796,54059,-
chr17,76967815,1.1835135361154978,26391,17830,44221,-
chr17,76967817,1.1835135361154978,26391,17830,44221,-
chr17,76967821,0.7333952373953977,10488,8179,18667,-
chr17,76967826,1.0506161813760044,19421,14176,33597,-
chr17,76967857,1.4084541006489535,16075,11433,27508,-
chr17,76967861,1.3495550549769164,6050,3448,9498,-
chr17,76967872,1.4205929062996294,3577,1888,5465,-
chr17,76967891,1.8047899327328696,7376,5011,12387,-
chr17,76967892,1.4287401548854837,5586,2974,8560,-
chr17,76967893,1.6511170393174104,12962,7985,20947,-
chr17,76967896,1.6606647583570877,5989,3508,9497,-
chr17,76967955,0.980733700731347,3774,2616,6390,-
chr17,76967970,1.5113958703707493,3372,2465,5837,-
chr17,76968136,1.4948708206686931,1547,1127,2674,-
chr17,76968202,1.7171665384944033,1569,1244,2813,-
chr17,76968204,1.554160125588697,1583,979,2562,-
chr17,76968225,2.180496493288776,2507,1717,4224,-
chr17,76968294,1.1023871727001517,4225,3378,7603,-
chr17,76968336,1.5312791783380018,1759,1385,3144,-
chr17,76968381,1.4013468968905478,2616,1879,4495,-
chr17,76968382,1.498585795097423,934,739,1673,-
chr17,76968384,1.687489643744822,1215,709,1924,-
chr17,76968385,1.743310442813166,1226,823,2049,-
chr17,76968514,1.376228079171367,1265,994,2259,-
chr17,76968559,1.6579666753449622,1212,667,1879,-
chr17,76968642,0.5894152703403006,1010,826,1836,-
chr17,76968657,2.144356236882927,999,842,1841,-
chr17,76968690,1.436772786037492,1165,883,2048,-
chr17,76969109,2.030858244937319,1295,731,2026,-
chr17,76969120,0.9578791201702895,1649,1256,2905,-
chr17,76969121,0.9578791201702895,1649,1256,2905,-
chr17,76969240,0.7859524727447605,1830,978,2808,-
chr17,76969246,1.971808832425892,1515,1159,2674,-
chr17,76969295,1.5663556732358361,2409,1711,4120,-
chr17,76969298,1.5101516683518703,1408,988,2396,-
chr17,76970849,2.1166532118556107,780,597,1377,-
chr17,76970862,1.7728395061728397,717,539,1256,-
chr17,76970870,1.818071099407505,1082,867,1949,-
chr17,76972088,2.243791390728477,694,603,1297,-
chr17,76972171,1.3198387180610525,1287,982,2269,-
chr17,76972174,1.9846909278153604,3458,2379,5837,-
chr17,76972177,1.3840286831812256,1010,779,1789,-
chr17,76972178,1.8555322757657386,1093,770,1863,-
chr17,76973272,1.364466484268126,1208,1031,2239,-
chr17,76975998,1.648131371244624,1643,1118,2761,-
chr17,76976004,1.7277365491651206,744,659,1403,-
chr17,76976014,2.032235182849937,572,487,1059,-
chr17,76976024,1.5354490032925234,1244,891,2135,-
chr17,76976025,1.5160947074192712,1467,1060,2527,-
chr17,76989658,1.1267031914883232,806,491,1297,-
chr17,76989717,1.5398950468648576,1021,689,1710,-
chr17,76989731,0.9442816193758252,1010,508,1518,-
chr17,76989732,0.9442816193758252,1010,508,1518,-
chr17,76993180,1.8535596114846835,913,693,1606,-
chr17,76993185,2.5187617260788,1610,1147,2757,-
chr17,76993186,2.5187617260788,1610,1147,2757,-
chr17,76993189,2.1516120777891503,1505,976,2481,-
chr17,76993190,2.1516120777891503,1505,976,2481,-
chr17,76993195,1.150648470770422,1208,737,1945,-
chr17,76993196,1.150648470770422,1208,737,1945,-
chr17,76993219,2.804685753964227,1212,638,1850,-
chr17,77807369,1.648898377044309,977,708,1685,-
chr17,77807451,1.2677190789194857,624,489,1113,-
chr17,77808694,3.9440593735696066,902,590,1492,-
chr17,77811647,2.7380952380952377,689,491,1180,-
chr17,77811653,2.330496936691627,667,451,1118,-
chr17,77811697,1.4225806451612903,1133,539,1672,-
chr17,77811698,1.6093104603133257,1465,697,2162,-
chr17,77811699,1.6093104603133257,1465,697,2162,-
chr17,77811700,1.345778177612132,1073,501,1574,-
chr17,78109178,1.798512319851232,840,716,1556,-
chr17,78109217,0.6021548284118116,1005,894,1899,-
chr17,78109223,1.6571604938271605,865,599,1464,-
chr17,78109825,1.547999290213823,996,662,1658,-
chr17,78109876,2.693498452012384,869,543,1412,-
chr17,78109886,1.8833444225140634,1544,1090,2634,-
chr17,78110035,2.258805031446541,652,529,1181,-
chr17,78110043,0.3117595710188303,624,485,1109,-
chr17,78110092,0.5159254628802763,618,508,1126,-
chr17,78110115,2.1437593984962406,527,474,1001,-
chr17,78111946,1.8273471959672336,579,528,1107,-
chr17,78111978,2.0145301148347787,613,501,1114,-
chr17,78112859,1.8156892612338158,744,504,1248,-
chr17,78112868,3.414845360824742,636,484,1120,-
chr17,78113808,1.7581231184470052,583,506,1089,-
chr17,78115121,2.1863468634686347,631,541,1172,-
chr17,78117977,2.587402597402597,686,549,1235,-
chr17,78118036,1.8264366467909046,2622,2872,5494,-
chr17,78118037,1.8591250261309158,2987,3105,6092,-
chr17,78120599,1.48012375186042,2881,2334,5215,-
chr17,78120602,1.6459578483799937,804,747,1551,-
chr17,78120603,1.6496565612975147,975,712,1687,-
chr17,78120606,0.5933333333333334,711,629,1340,-
chr17,78120613,0.4739027283511269,798,561,1359,-
chr17,78120687,0.4295652173913044,873,574,1447,-
chr17,78120688,0.4295652173913044,873,574,1447,-
chr17,78120717,0.9232774968394436,614,451,1065,-
chr17,78120718,0.9232774968394436,614,451,1065,-
chr17,78120744,2.854951451865,680,486,1166,-
chr17,78440807,1.645455486745626,979,686,1665,-
chr17,78441141,1.8409300184162063,726,542,1268,-
chr17,78441278,0.4985002762648985,742,617,1359,-
chr17,78441313,0.4155361748152813,725,683,1408,-
chr17,78441363,4.082614963744566,773,714,1487,-
chr17,78441372,3.603261181548589,1173,891,2064,-
chr17,78441379,7.570917822561184,1199,786,1985,-
chr17,78441711,0.9085382702403979,1095,845,1940,-
chr17,78441712,1.2480078846588978,1392,1120,2512,-
chr17,78441893,0.6222385861561119,974,678,1652,-
chr17,78441899,1.8775035319537936,705,572,1277,-
chr17,78442425,2.598825831702544,580,510,1090,-
chr17,78442450,1.6685912240184757,577,432,1009,-
chr17,78442533,1.916335031738857,813,550,1363,-
chr17,78442736,2.5641257206614982,622,462,1084,-
chr17,78442900,4.761502913401647,696,552,1248,-
chr17,78442902,4.761502913401647,696,552,1248,-
chr17,78443100,2.2812762346629456,873,509,1382,-
chr17,78443433,0.7660150831592839,571,477,1048,-
chr17,78444207,1.5318833438532722,775,510,1285,-
chr17,78444516,5.933368856127646,604,443,1047,-
chr17,78444661,1.576370170709794,695,635,1330,-
chr17,78444737,2.2750929368029738,647,537,1184,-
chr17,78444739,2.2750929368029738,647,537,1184,-
chr17,78449827,2.1804000952607767,690,500,1190,-
chr17,78449834,0.5843023255813953,602,515,1117,-
chr17,78449835,0.5843023255813953,602,515,1117,-
chr17,78449836,0.5843023255813953,602,515,1117,-
chr17,78798324,1.909090909090909,869,549,1418,-
chr17,78798641,2.900075585789872,1198,979,2177,-
chr17,78798642,2.4940991345397325,1584,1270,2854,-
chr17,78798643,2.5510354727255233,1718,1381,3099,-
chr17,78798644,2.45111801242236,1177,919,2096,-
chr17,79477195,1.309791428025964,7081,4655,11736,-
chr17,79477263,1.4414233875368325,7261,5235,12496,-
chr17,79477352,0.6635857261889962,64724,47546,112270,-
chr17,79477353,0.6695580565909907,36780,27482,64262,-
chr17,79477354,0.6992720018554937,16398,12688,29086,-
chr17,79477360,1.0009285800788772,10584,8354,18938,-
chr17,79477493,1.36383144326539,20271,14555,34826,-
chr17,79477648,0.9153604528668003,18766,14330,33096,-
chr17,79477649,0.9290050152366937,19905,14329,34234,-
chr17,79477726,0.8010268792952476,4550,3344,7894,-
chr17,79477761,1.6659365924491771,5098,4131,9229,-
chr17,79477776,0.7864092964637852,3003,2295,5298,-
chr17,79477782,1.2353429433085243,4058,3075,7133,-
chr17,79477859,0.5112915063932373,890,639,1529,-
chr17,79477989,2.069420118167914,24434,19947,44381,-
chr17,79478002,1.8843280632411064,13620,11384,25004,-
chr17,79478022,1.258413847026778,18939,13111,32050,-
chr17,79478058,1.7570729545884733,19289,14718,34007,-
chr17,79478089,1.3556254834998125,5310,3838,9148,-
chr17,79478374,1.293772670866743,5860,3491,9351,-
chr17,79478383,1.2642242882385368,7274,5677,12951,-
chr17,79478396,1.2162403331350389,5545,3361,8906,-
chr17,79478518,1.4250928106662408,3499,2664,6163,-
chr17,79478648,1.3057440451257991,4479,3311,7790,-
chr17,79478960,1.3367875819430977,8285,4904,13189,-
chr17,79478962,1.3305562650712741,13991,9674,23665,-
chr17,79479034,0.7670168292421481,2601,1963,4564,-
chr17,79479088,0.7735790192833983,2331,1932,4263,-
chr17,79479145,1.3240390937001032,11207,8027,19234,-
chr17,79479369,0.8310105341089888,4984,3101,8085,-
chr17,79479374,1.324958692841051,8994,6233,15227,-
chr17,79479375,1.2547281323877069,3464,2834,6298,-
chr17,79479806,1.384090909090909,2435,1539,3974,-
chr17,79479808,0.7768200990280579,2117,1861,3978,-
chr17,79479810,0.6458897922312556,879,737,1616,-
chr17,79479821,0.592115453250977,1590,1453,3043,-
chr17,79479824,0.7838666373114491,3985,3742,7727,-
chr17,79479825,0.8632670952659264,686,579,1265,-
chr17,79479826,0.8195410527354889,6286,5459,11745,-
chr17,79479827,0.8995783808068848,1615,1138,2753,-
chr17,79526180,2.318386424883765,664,339,1003,-
chr17,79534494,1.1827188138916336,563,478,1041,-
chr17,79564326,1.758058608058608,992,1007,1999,-
chr17,79564331,1.7527405346505405,2359,2025,4384,-
chr17,79567382,3.0175081893143565,721,680,1401,-
chr17,79567392,1.6299246430460077,1408,991,2399,-
chr17,79567394,1.6299246430460077,1408,991,2399,-
chr17,79567414,2.122540384388283,959,722,1681,-
chr17,79567423,2.8385860306643957,859,586,1445,-
chr17,79567425,2.8385860306643957,859,586,1445,-
chr17,79567449,2.3954545828940432,652,432,1084,-
chr17,79596783,0.4540619955914659,801,523,1324,-
chr17,79801119,1.3835168512482823,10370,7029,17399,-
chr17,79801120,1.3717062782987293,8771,5748,14519,-
chr17,79801121,1.3717062782987293,8771,5748,14519,-
chr17,79801174,1.2329301312614045,2577,1617,4194,-
chr17,79801202,1.3749469324807873,1866,1460,3326,-
chr17,79801263,1.5914434311769736,1786,967,2753,-
chr17,79801360,1.2505789104574383,2907,1865,4772,-
chr17,79801386,2.466065023718616,1348,1004,2352,-
chr17,79801637,2.106392251815981,2147,1474,3621,-
chr17,79801707,1.3316751529042032,2577,1968,4545,-
chr17,79801797,1.9183983993111728,2559,1906,4465,-
chr17,79801840,2.0208091647331785,1185,861,2046,-
chr17,79801962,1.2237215909090908,1722,1671,3393,-
chr17,79803026,2.5780825969578802,12075,9488,21563,-
chr17,79803027,2.8465996306325048,6701,5767,12468,-
chr17,79804428,1.3816340540495655,6610,5197,11807,-
chr17,79804430,1.3816340540495655,6610,5197,11807,-
chr17,79804437,1.84398766216948,2796,2177,4973,-
chr17,79804491,1.4195297763406092,5031,3710,8741,-
chr17,79804850,1.3069220693954005,8169,6168,14337,-
chr17,79804853,1.5427034072489685,2884,2323,5207,-
chr17,79813058,0.7857817498603564,2522,2094,4616,-
chr17,79813128,1.413571065095706,2699,1731,4430,-
chr17,79813133,1.3441838998185176,3954,2817,6771,-
chr17,79817092,1.5297556198258582,1561,1232,2793,-
chr17,79817101,1.6763262599469493,1486,1159,2645,-
chr17,79817181,1.479749276759884,2771,1707,4478,-
chr17,79817223,1.4052486145052336,7919,5363,13282,-
chr17,79817224,1.4172312740071042,4782,2852,7634,-
chr17,79818223,0.7570893246187362,1760,1274,3034,-
chr17,79818254,1.7117792604585573,3102,1867,4969,-
chr17,79818256,1.714271511073364,3992,2598,6590,-
chr17,79818276,0.42608695652173917,664,574,1238,-
chr17,79818279,1.815411941522066,617,562,1179,-
chr17,79818282,2.766910866910867,730,545,1275,-
chr17,79818285,2.0678738058209287,1094,642,1736,-
chr17,79818349,2.6876146788990827,650,544,1194,-
chr17,79818361,1.361588330632091,1083,616,1699,-
chr17,79818378,0.4542389713912564,2985,2226,5211,-
chr17,79818379,0.4542389713912564,2985,2226,5211,-
chr17,79818392,1.24843151083016,693,654,1347,-
chr17,79818394,1.2495887762155296,780,550,1330,-
chr17,79818410,1.3120822201714044,1006,696,1702,-
chr17,79826025,1.0551703346397348,624,534,1158,-
chr17,79826027,0.9082680110311718,914,773,1687,-
chr17,79826255,2.6648175080728387,707,471,1178,-
chr17,79826337,4.339638002684077,667,454,1121,-
chr17,79826897,2.4415946423455264,711,421,1132,-
chr17,79827434,3.128579641958999,587,444,1031,-
chr17,79827474,2.8892545618477876,656,385,1041,-
chr17,79827711,2.763851784464277,1023,760,1783,-
chr17,79829179,1.9603488299140477,918,758,1676,-
chr17,79829181,1.915876581578904,1272,1080,2352,-
chr17,79829195,4.443860957013191,664,541,1205,-
chr17,79845827,1.9167295648806322,1168,789,1957,-
chr17,79845830,0.476005547850208,623,411,1034,-
chr17,79846011,1.9768145161290325,813,681,1494,-
chr17,79846128,1.8215094994357737,1672,1139,2811,-
chr17,79846165,0.5240803397883522,559,478,1037,-
chr17,79846171,0.578713210130048,533,486,1019,-
chr17,79846172,1.5991536458333335,846,479,1325,-
chr17,79846180,1.758949266031419,682,352,1034,-
chr17,79846199,1.8979342723004695,1188,638,1826,-
chr17,79846200,1.8979342723004695,1188,638,1826,-
chr17,79846425,0.5299418058944997,940,760,1700,-
chr17,79847080,1.7032967032967032,729,510,1239,-
chr17,79847130,1.6575128160812287,2844,2191,5035,-
chr17,79847161,2.2860224331320103,756,609,1365,-
chr17,79847176,1.638843426077469,750,563,1313,-
chr17,79848594,0.6952736829138094,995,685,1680,-
chr17,79848613,1.171333714316815,1676,1360,3036,-
chr17,79848614,1.4181710165271486,3497,2541,6038,-
chr17,79848616,1.6678039444120831,1821,1181,3002,-
chr17,79848660,0.6325056583677273,612,517,1129,-
chr17,79848677,0.5343936381709742,671,502,1173,-
chr17,79848688,1.7199153407448204,1293,879,2172,-
chr17,79849222,1.4299860077599384,659,548,1207,-
chr17,79876979,1.598831641447998,944,680,1624,-
chr17,79876989,3.921161825726141,674,481,1155,-
chr17,79877023,2.745103686635945,705,495,1200,-
chr17,79877025,2.745103686635945,705,495,1200,-
chr17,79890354,18.013729977116707,655,436,1091,-
chr17,79890357,4.493923247082424,1970,1413,3383,-
chr17,79890370,5.815263519924276,2409,1605,4014,-
chr17,79890448,2.619704269812261,583,462,1045,-
chr17,79890453,0.6892327530625403,1068,704,1772,-
chr17,79890577,2.6677872860635694,601,408,1009,-
chr17,79890887,0.43602693602693604,776,593,1369,-
chr17,79890888,0.43602693602693604,776,593,1369,-
chr17,79890935,1.84116359891878,595,456,1051,-
chr17,79891090,2.903835464146748,652,513,1165,-
chr17,79891092,2.903835464146748,652,513,1165,-
chr17,79891093,0.9888665325285044,775,496,1271,-
chr17,79891095,0.9888665325285044,775,496,1271,-
chr17,79892850,2.428021978021978,981,727,1708,-
chr17,79892852,2.428021978021978,981,727,1708,-
chr17,79892896,1.7673992673992671,1157,1000,2157,-
chr17,79892898,1.754693508722931,2101,1678,3779,-
chr17,79893288,3.0957357560481245,1222,963,2185,-
chr17,79893364,0.41362430672775496,1008,714,1722,-
chr17,79894000,1.9458937198067632,847,689,1536,-
chr17,79894013,1.52459091744806,808,587,1395,-
chr17,79894050,0.6427368354148791,808,616,1424,-
chr17,79894652,0.9785860956292168,555,486,1041,-
chr17,79894653,1.5799028486362467,943,766,1709,-
chr17,79894701,3.2144737491262685,1670,1339,3009,-
chr17,79894702,3.2144737491262685,1670,1339,3009,-
chr17,79976658,1.7703703703703701,716,485,1201,-
chr17,79976778,2.144258375339441,677,535,1212,-
chr17,79976845,3.0877270064440543,726,568,1294,-
chr17,79976846,4.40516620482245,1512,1251,2763,-
chr17,79976856,2.859806114839672,766,446,1212,-
chr17,79976858,5.84940771591766,1092,685,1777,-
chr17,79977017,3.114249337969796,1296,904,2200,-
chr17,79994436,0.8681045488140833,645,450,1095,-
chr17,79994438,1.1664094645507208,866,599,1465,-
chr17,79994489,3.0083840265199413,597,412,1009,-
chr17,79994502,2.7220286328403014,577,444,1021,-
chr17,79994877,2.5279034292701046,755,632,1387,-
chr17,79994879,2.5279034292701046,755,632,1387,-
chr17,80020834,3.0488709259777593,695,531,1226,-
chr17,80021349,2.1539694537654897,851,588,1439,-
chr17,80022018,2.339316661102441,618,573,1191,-
chr17,80036361,1.7647617239415228,714,457,1171,-
chr17,80036373,1.5781038929141595,658,478,1136,-
chr17,80037317,2.2497852526799647,1061,819,1880,-
chr17,80037335,1.955232721876924,1446,1043,2489,-
chr17,80037356,1.850369725967812,708,417,1125,-
chr17,80037363,2.8392463290833283,575,497,1072,-
chr17,80038347,1.1212524983344436,917,473,1390,-
chr17,80038348,1.1212524983344436,917,473,1390,-
chr17,80038429,1.682671272901529,596,443,1039,-
chr17,80039050,2.871358004517752,694,392,1086,-
chr17,80039575,1.1045214327657076,1025,523,1548,-
chr17,80039577,1.1045214327657076,1025,523,1548,-
chr17,80039950,1.224617040091369,992,683,1675,-
chr17,80040232,2.9856215373961223,560,523,1083,-
chr17,80040254,0.5694773519163764,680,409,1089,-
chr17,80041422,0.4514555212229631,693,428,1121,-
chr17,80041757,0.8122179867532596,658,406,1064,-
chr17,80041759,1.7723949470442975,884,568,1452,-
chr17,80042765,6.5855457227138645,704,338,1042,-
chr17,80042766,6.5855457227138645,704,338,1042,-
chr17,80043145,2.1325740318906603,1056,438,1494,-
chr17,80043146,2.1325740318906603,1056,438,1494,-
chr17,80043159,1.5711664330058257,909,489,1398,-
chr17,80043225,0.4168676215716622,698,438,1136,-
chr17,80043722,1.4535033277118625,1508,886,2394,-
chr17,80043723,1.240683498602834,1355,762,2117,-
chr17,80043724,1.240683498602834,1355,762,2117,-
chr17,80047008,1.650039964919583,680,446,1126,-
chr17,80048816,1.5272461293133133,660,501,1161,-
chr17,80048885,1.9627013021288315,717,473,1190,-
chr17,80050796,0.7061562122181922,770,538,1308,-
chr17,80050798,1.1789616114272963,739,497,1236,-
chr17,80209400,0.4053800505915207,630,518,1148,-
chr17,80213413,7.02760979470226,1462,1302,2764,-
chr17,80213414,8.938100131524658,2409,1939,4348,-
chr17,80213415,8.938100131524658,2409,1939,4348,-
chr17,80213416,11.533652552385325,1909,1412,3321,-
chr17,80572877,10.87650916355846,1448,1551,2999,-
chr17,80572878,9.296668070941019,1264,1300,2564,-
chr17,80572879,5.320074005550416,638,563,1201,-
chr17,80573046,5.471897753035764,920,857,1777,-
chr17,80573047,5.369141712046618,1221,1251,2472,-
chr17,80573048,5.47949835631408,1133,1125,2258,-
chr17,80573435,0.7777692300879832,643,588,1231,-
chr17,80575192,1.7716320255913018,665,518,1183,-
chr17,80576963,2.407952688193125,908,587,1495,-
chr17,80601838,1.819513982171205,595,430,1025,-
chr17,80615116,1.3770974252651254,586,473,1059,-
chr18,224965,1.1425040812624705,1228,595,1823,-
chr18,224967,1.1425040812624705,1228,595,1823,-
chr18,6462188,1.5784332104397092,1825,1230,3055,-
chr18,6462189,1.4165171621565025,3679,2639,6318,-
chr18,9563029,5.641106201207835,952,598,1550,-
chr18,12340333,1.633399343901809,615,439,1054,-
chr18,12344152,2.8527395587113484,643,456,1099,-
chr18,12353113,2.8192396470223215,644,655,1299,-
chr18,12353119,3.223188405797101,555,459,1014,-
chr18,12353120,3.055299195914167,1095,941,2036,-
chr18,12356694,0.9900167927825029,640,468,1108,-
chr18,12358816,1.2366293017406484,640,510,1150,-
chr18,12366994,1.6984399649430324,1513,1140,2653,-
chr18,12367005,2.2375745229036217,1166,1150,2316,-
chr18,12367008,1.6016809311126268,1102,1056,2158,-
chr18,12367009,0.6298140770252324,1896,1505,3401,-
chr18,12367022,1.4241803278688523,833,731,1564,-
chr18,12367060,1.9103903243540408,1250,962,2212,-
chr18,12367070,2.5926615757124236,1043,766,1809,-
chr18,12367096,2.484346483223361,631,418,1049,-
chr18,12367110,3.534313725490197,617,407,1024,-
chr18,12367305,1.3246343043563023,1151,702,1853,-
chr18,12367325,20.26077239726351,1272,722,1994,-
chr18,12535522,2.7164482240783365,693,459,1152,-
chr18,18586663,1.9878700302240078,992,656,1648,-
chr18,18586666,1.361899247249566,783,470,1253,-
chr18,18586668,1.361899247249566,783,470,1253,-
chr18,18586703,0.7410503540519277,684,327,1011,-
chr18,18586704,0.6316056110979421,907,440,1347,-
chr18,18586705,1.1593348531898287,957,504,1461,-
chr18,19153828,2.998718477069968,857,667,1524,-
chr18,21112017,1.95783434209612,3084,2327,5411,-
chr18,21112018,1.9416367670228316,3702,2792,6494,-
chr18,21112020,2.315241429326075,2172,1666,3838,-
chr18,21112028,1.7221340107970784,985,669,1654,-
chr18,21112035,2.417142482282124,1513,929,2442,-
chr18,21112043,2.710969718392836,718,413,1131,-
chr18,21112060,1.4366680663034623,866,482,1348,-
chr18,33570084,1.067124308286906,1189,748,1937,-
chr18,33572285,3.622641509433962,575,476,1051,-
chr18,33572287,3.622641509433962,575,476,1051,-
chr18,33606919,1.7080436042300449,2694,2300,4994,-
chr18,33606938,1.2933882977023616,4129,3077,7206,-
chr18,33606939,1.3234146355630783,6361,4866,11227,-
chr18,33606942,1.39198772100806,6988,5334,12322,-
chr18,33606943,1.4595531378436764,3149,2425,5574,-
chr18,33606946,1.5828837535311482,2838,2046,4884,-
chr18,33606947,1.4834977569934282,5678,3991,9669,-
chr18,33606949,1.2736173686582597,4916,3401,8317,-
chr18,33606950,1.409040460094844,2694,1801,4495,-
chr18,33606953,2.095817490494297,688,525,1213,-
chr18,33606955,1.6878606511178509,1122,702,1824,-
chr18,33606966,1.548367547913037,1021,613,1634,-
chr18,33606973,1.5529083294555606,926,613,1539,-
chr18,33606978,0.5813418304124623,820,537,1357,-
chr18,33606979,1.791217964771684,997,725,1722,-
chr18,33606990,1.2695652923754746,1594,1071,2665,-
chr18,33607032,1.0820432817312693,1081,640,1721,-
chr18,33607034,1.0820432817312693,1081,640,1721,-
chr18,33610975,1.3329807055199088,769,574,1343,-
chr18,33688965,2.3449385052034057,1376,905,2281,-
chr18,33688975,1.945068664169788,1291,800,2091,-
chr18,33689026,1.638588640275387,1106,829,1935,-
chr18,33689168,1.788370520622042,1149,869,2018,-
chr18,33689369,1.5968957871396896,1107,819,1926,-
chr18,33689546,4.514326647564469,958,697,1655,-
chr18,33694066,1.9332244601705677,760,500,1260,-
chr18,33694082,2.2712418300653594,694,458,1152,-
chr18,33694138,0.5335263777033753,736,513,1249,-
chr18,33694140,0.5133333333333333,692,524,1216,-
chr18,33694240,0.7286273048984914,977,766,1743,-
chr18,33694293,3.4469798657718127,855,744,1599,-
chr18,33702197,0.7223383500557413,1480,1103,2583,-
chr18,33702198,0.6402583323408048,1997,1289,3286,-
chr18,33703550,1.8601523980277903,829,678,1507,-
chr18,33703563,1.4473067915690867,1235,853,2088,-
chr18,33703569,1.49346016646849,1255,840,2095,-
chr18,33706195,1.7708174178762413,853,538,1391,-
chr18,33706216,2.2444383785997,714,430,1144,-
chr18,33706250,0.4195922121723133,781,592,1373,-
chr18,33706256,1.5908412145345945,751,573,1324,-
chr18,33706291,1.7976863753213368,665,388,1053,-
chr18,33706444,2.629139891250618,850,475,1325,-
chr18,33706448,2.362594268476621,711,584,1295,-
chr18,33706555,0.6292486583184257,937,687,1624,-
chr18,33706575,0.6002935420743639,817,583,1400,-
chr18,33706592,1.2368534733222942,1398,1015,2413,-
chr18,33706799,1.4336065573770491,1112,731,1843,-
chr18,33706809,0.6745091372715682,1166,904,2070,-
chr18,33706856,1.7476555839727197,614,458,1072,-
chr18,33706904,0.5632411067193676,531,505,1036,-
chr18,33709213,0.3874322390644443,782,572,1354,-
chr18,33760039,1.7575348488480111,1215,960,2175,-
chr18,33760048,1.9367747098839532,604,440,1044,-
chr18,33760095,2.151707014276847,618,536,1154,-
chr18,33760104,2.239247311827957,594,495,1089,-
chr18,33760228,2.94345137717819,688,592,1280,-
chr18,33760299,1.5438271604938274,1036,764,1800,-
chr18,33760312,1.8274932614555257,677,423,1100,-
chr18,34376996,2.392824899165684,939,663,1602,-
chr18,34377000,2.771573604060914,623,393,1016,-
chr18,34378452,3.0206077953258066,704,455,1159,-
chr18,34380247,0.41453487794628613,844,636,1480,-
chr18,34385436,3.600293452682135,618,460,1078,-
chr18,34398901,1.4229400998795192,724,544,1268,-
chr18,43664227,1.73482280431433,1250,884,2134,-
chr18,43664583,1.6020685533621222,2556,1620,4176,-
chr18,43664603,1.7299088649544323,2087,1240,3327,-
chr18,43666131,1.3072664899423048,1862,1209,3071,-
chr18,43666434,1.481508739650414,1463,1086,2549,-
chr18,43666455,0.7603820895522387,1872,1674,3546,-
chr18,43667038,1.6966404025227553,2468,1886,4354,-
chr18,43667040,1.6966404025227553,2468,1886,4354,-
chr18,43667085,2.1594502802314373,3048,1954,5002,-
chr18,43667317,1.3334965008222113,2003,1654,3657,-
chr18,43667325,1.438649526818006,3884,2777,6661,-
chr18,43667400,1.3261212471738788,2072,1253,3325,-
chr18,43669636,0.7408528299114849,1800,1432,3232,-
chr18,43669940,1.4122045577026714,2173,1675,3848,-
chr18,43669949,1.357148779517113,5595,3768,9363,-
chr18,43669951,1.3270901644789421,9906,7032,16938,-
chr18,43671675,1.450480788736966,1299,1005,2304,-
chr18,43675069,1.3739459255057669,981,644,1625,-
chr18,43675088,0.4335939065945079,2079,1662,3741,-
chr18,43675089,0.4335939065945079,2079,1662,3741,-
chr18,43675090,1.9266726403823178,678,431,1109,-
chr18,43678155,3.3949886104783604,647,438,1085,-
chr18,43678199,1.575455693819382,1366,1019,2385,-
chr18,43678250,2.5567466664994267,1279,862,2141,-
chr18,44681841,6.093959731543624,680,595,1275,-
chr18,44681843,6.093959731543624,680,595,1275,-
chr18,44681969,1.2711959301268756,693,457,1150,-
chr18,44682600,0.5847514180847514,1401,971,2372,-
chr18,44683821,1.5233887848408063,2323,1564,3887,-
chr18,44683822,1.5233887848408063,2323,1564,3887,-
chr18,44683826,2.0412,971,624,1595,-
chr18,44683834,1.62199953390818,869,612,1481,-
chr18,44683855,0.5564533740991483,727,481,1208,-
chr18,44702682,2.022527306434596,628,405,1033,-
chr18,45368103,1.9277064220183489,617,435,1052,-
chr18,45368309,1.215202552880368,1033,680,1713,-
chr18,45371718,1.1563424261123822,991,648,1639,-
chr18,45372136,1.2023718229043934,845,723,1568,-
chr18,45395752,2.1257400744447508,1171,907,2078,-
chr18,45396901,2.7055726397902577,1076,707,1783,-
chr18,45422978,1.864406779661017,594,412,1006,-
chr18,47008317,7.031530993114271,627,433,1060,-
chr18,47008565,1.2575170377580902,705,440,1145,-
chr18,47008682,0.6191806331471136,804,536,1340,-
chr18,47015792,1.5357140510918859,17781,13469,31250,-
chr18,47015793,1.5399604038464836,6005,5447,11452,-
chr18,47015795,1.3014707288618586,2721,1802,4523,-
chr18,47015796,1.2354155008926118,6863,4589,11452,-
chr18,47015799,1.3755570870663911,2302,1450,3752,-
chr18,47015801,1.4856764533625322,3002,1588,4590,-
chr18,47015811,1.3761578044596914,2372,1154,3526,-
chr18,47015828,1.4038727280412848,4520,2343,6863,-
chr18,47016922,0.8768014563961113,1238,808,2046,-
chr18,47016923,0.8768014563961113,1238,808,2046,-
chr18,47017180,1.3095577054248042,6669,4935,11604,-
chr18,47017190,1.3152786126138158,8568,4990,13558,-
chr18,47017224,1.5253293853004637,5595,3287,8882,-
chr18,47017714,0.924703046238071,6685,9379,16064,-
chr18,47017715,0.924703046238071,6685,9379,16064,-
chr18,47017716,0.9820069917578446,5150,7202,12352,-
chr18,47017944,0.7864406712937448,11730,9847,21577,-
chr18,47017945,0.9956886746115864,17478,10723,28201,-
chr18,47017946,0.9049870761626919,29208,20570,49778,-
chr18,47017952,1.2498781415542224,16069,10728,26797,-
chr18,47018096,1.318023409522436,1890,1540,3430,-
chr18,47018098,1.237036347277607,9273,7846,17119,-
chr18,47018099,1.22296787458557,8296,7041,15337,-
chr18,47018138,0.5088495575221239,804,677,1481,-
chr18,47018194,1.7348017988007995,682,631,1313,-
chr18,47018200,1.7657053236908602,578,498,1076,-
chr18,47018837,1.2416928790778299,10328,6616,16944,-
chr18,47018838,0.8580345424534,3288,2949,6237,-
chr18,47018841,1.3943957594044092,6723,4875,11598,-
chr18,47018844,0.7637738116098024,1906,1755,3661,-
chr18,47018845,1.254635827423951,3263,1909,5172,-
chr18,47018846,1.538966448713741,3809,3323,7132,-
chr18,47018848,1.2709134247212726,11239,8646,19885,-
chr18,47018849,1.034149334866308,6859,4940,11799,-
chr18,47018850,1.9292057113814716,2890,2244,5134,-
chr18,47018884,0.6121408303889283,1445,856,2301,-
chr18,47317908,3.2727377666290653,691,528,1219,-
chr18,47317914,0.8115151515151515,720,524,1244,-
chr18,47317916,0.8115151515151515,720,524,1244,-
chr18,47318556,2.2058464833066824,687,516,1203,-
chr18,47318669,1.8185968130662904,607,406,1013,-
chr18,47323886,0.3426168011822212,547,462,1009,-
chr18,47323887,0.3426168011822212,547,462,1009,-
chr18,47329203,4.129533435615576,678,485,1163,-
chr18,51681409,1.8348027724308882,1016,766,1782,-
chr18,51681444,1.7740353172007848,650,416,1066,-
chr18,51686173,1.4917757009345796,693,534,1227,-
chr18,51690898,5.175015752993069,2165,1655,3820,-
chr18,51690919,2.0896895707288965,1966,1156,3122,-
chr18,51690921,1.525517162991589,1578,995,2573,-
chr18,51690925,1.6835562583040722,2272,1457,3729,-
chr18,51690935,1.4026808270904152,2248,1253,3501,-
chr18,51690944,1.6153336391904982,931,502,1433,-
chr18,51690947,1.812902783491019,852,441,1293,-
chr18,51690955,2.154559953603016,742,362,1104,-
chr18,51690958,1.7628481194372663,1841,1160,3001,-
chr18,51690959,1.7628481194372663,1841,1160,3001,-
chr18,51690964,2.381237973057935,1448,763,2211,-
chr18,51690976,4.178804347826088,698,367,1065,-
chr18,54270251,2.411347609897875,655,468,1123,-
chr18,55268029,1.001409869083585,903,661,1564,-
chr18,55268030,1.001409869083585,903,661,1564,-
chr18,55268916,3.593939393939394,592,461,1053,-
chr18,55268917,2.384764570060425,927,766,1693,-
chr18,55273934,0.42111173498034815,899,410,1309,-
chr18,55273944,2.1912780252123634,1066,595,1661,-
chr18,55273947,0.9875065249758864,1108,622,1730,-
chr18,55282902,3.103110574657034,842,585,1427,-
chr18,55289007,0.589821347903709,710,523,1233,-
chr18,56995265,1.839244282399735,715,430,1145,-
chr18,56995347,2.0020421423930195,673,566,1239,-
chr18,56995650,1.6850086956521737,733,574,1307,-
chr18,56995717,0.6589752906976744,1673,1151,2824,-
chr18,56995720,1.427927927927928,1584,1109,2693,-
chr18,56995892,1.902697089167344,5321,4084,9405,-
chr18,56995902,1.5242021142076778,1434,1162,2596,-
chr18,56995905,2.20019550342131,1323,989,2312,-
chr18,56995908,1.506296517809676,1276,911,2187,-
chr18,56996140,1.9071057132630633,1152,758,1910,-
chr18,56996236,0.4142053445850914,588,473,1061,-
chr18,56996307,2.947519181585678,685,574,1259,-
chr18,56996312,2.304705882352941,652,499,1151,-
chr18,56996536,1.6507141532183265,808,598,1406,-
chr18,56996549,1.7833384192859325,973,564,1537,-
chr18,56996582,2.0869070208728653,610,464,1074,-
chr18,56996834,1.7441408359434063,1537,1181,2718,-
chr18,56996914,2.255653266331658,683,397,1080,-
chr18,56997005,1.8163033175355447,736,421,1157,-
chr18,56997014,1.6334123014828463,715,392,1107,-
chr18,56997230,1.8348671112559485,1805,1337,3142,-
chr18,56997336,2.964285714285714,746,593,1339,-
chr18,56997420,2.1876519202722413,599,483,1082,-
chr18,56997475,1.4356389855770328,2046,1480,3526,-
chr18,56997830,1.9249042145593869,627,434,1061,-
chr18,56997879,1.9334465195246184,656,464,1120,-
chr18,56998170,3.6886956521739136,605,459,1064,-
chr18,56998765,1.9772010110724614,1061,822,1883,-
chr18,57000361,0.548782673254653,931,736,1667,-
chr18,57000420,1.7786458333333333,682,479,1161,-
chr18,57005851,2.6464097233328,590,480,1070,-
chr18,57006126,0.62548828125,548,511,1059,-
chr18,57013188,0.7807493665183851,7913,5374,13287,-
chr18,57013189,0.7807493665183851,7913,5374,13287,-
chr18,57013197,1.5259383300612082,3721,2473,6194,-
chr18,57013221,1.4042273180458624,2133,1179,3312,-
chr18,57013247,2.54855195911414,2067,1173,3240,-
chr18,57013268,1.6236572728421583,1167,578,1745,-
chr18,57014762,1.859889940023496,939,598,1537,-
chr18,57014769,0.541455525606469,836,524,1360,-
chr18,57021771,1.605145413870246,655,446,1101,-
chr18,57022592,0.5223092544241369,642,382,1024,-
chr18,57022837,2.240362811791383,1169,734,1903,-
chr18,57022869,0.312695085022129,838,476,1314,-
chr18,57022878,1.5628404669260698,1938,1027,2965,-
chr18,57022879,1.5628404669260698,1938,1027,2965,-
chr18,57022885,1.923306389530408,868,432,1300,-
chr18,57026330,1.2485515923284878,1104,719,1823,-
chr18,57026478,1.8217634566800165,964,553,1517,-
chr18,57026484,1.0451637514402357,2685,1291,3976,-
chr18,57026485,1.0451637514402357,2685,1291,3976,-
chr18,77733664,3.4898862506808537,619,382,1001,-
chr18,77748260,2.831694189892953,706,516,1222,-
chr19,281155,0.5105965048674884,819,470,1289,-
chr19,1009776,3.5535815580150554,614,401,1015,-
chr19,1010085,7.7332586083491766,1232,978,2210,-
chr19,1010086,7.733258608349175,1232,978,2210,-
chr19,1014275,1.963572412283544,661,536,1197,-
chr19,1088304,0.7716493692189809,624,476,1100,-
chr19,1089949,2.6941882268352417,635,459,1094,-
chr19,1090926,1.061489299893483,608,448,1056,-
chr19,1090928,1.7477326380846918,1079,725,1804,-
chr19,1090964,1.5181489956763285,811,526,1337,-
chr19,1093936,2.1120429204261195,869,561,1430,-
chr19,1095281,0.8333561985987991,896,614,1510,-
chr19,1095282,1.59405425492382,765,584,1349,-
chr19,1095284,4.136036625245258,743,555,1298,-
chr19,1123568,8.468013852085836,3658,3380,7038,-
chr19,1123569,8.468013852085834,3658,3380,7038,-
chr19,1123570,8.468013852085834,3658,3380,7038,-
chr19,1123576,8.094185719366,1108,791,1899,-
chr19,1123579,3.452279224387691,1047,633,1680,-
chr19,1123585,2.9734018518959275,1202,468,1670,-
chr19,1598141,1.5318360148292118,1605,1028,2633,-
chr19,1598142,1.500705086020495,1251,966,2217,-
chr19,1598167,1.6932427469702531,980,777,1757,-
chr19,1599438,1.5938412852969817,1454,1026,2480,-
chr19,1599544,0.5615898058252428,616,411,1027,-
chr19,1605397,2.005186262539204,704,520,1224,-
chr19,1611363,1.3650761421319797,746,393,1139,-
chr19,1611364,1.3650761421319797,746,393,1139,-
chr19,1611365,1.0844469625536641,908,543,1451,-
chr19,2121754,3.6332651670074974,819,488,1307,-
chr19,2121772,3.10868544600939,696,354,1050,-
chr19,2121800,2.498618784530387,736,361,1097,-
chr19,2121802,2.498618784530387,736,361,1097,-
chr19,2121847,2.436016821855754,955,430,1385,-
chr19,2321599,1.5552699699887316,1078,850,1928,-
chr19,2328405,0.5227004716981133,590,423,1013,-
chr19,2328433,1.6299212149746856,1118,762,1880,-
chr19,2328472,1.209183834699407,635,421,1056,-
chr19,2427445,1.7765333537018955,1066,740,1806,-
chr19,2427487,2.410887464119527,882,542,1424,-
chr19,2427573,0.7999056749144682,791,444,1235,-
chr19,3053047,0.5197149011325544,1070,770,1840,-
chr19,3053048,6.227515049138787,602,408,1010,-
chr19,3053204,19.774117898965297,2929,2171,5100,-
chr19,3053205,19.774117898965297,2929,2171,5100,-
chr19,3053224,4.433801351161974,1102,754,1856,-
chr19,3053479,1.6647844908714473,609,461,1070,-
chr19,3053710,0.5602678571428571,1003,1035,2038,-
chr19,3053712,0.5602678571428571,1003,1035,2038,-
chr19,3053738,0.4336860925551453,2749,3870,6619,-
chr19,3053740,0.5144194328191376,2976,3838,6814,-
chr19,3053743,0.29679235493188977,764,1601,2365,-
chr19,3053753,0.5675351831402862,1097,1372,2469,-
chr19,3053754,0.5259515570934257,1595,2022,3617,-
chr19,3053756,0.3858099347682668,2193,3360,5553,-
chr19,3053757,0.43649816368532257,2388,2956,5344,-
chr19,3053758,0.4990335170559341,2044,3244,5288,-
chr19,3053759,0.2931379080612925,879,1215,2094,-
chr19,3053771,3.495035460992908,671,939,1610,-
chr19,3053773,10.382838221098039,4208,4482,8690,-
chr19,3053774,11.73640728317564,4239,4132,8371,-
chr19,3053775,11.73640728317564,4239,4132,8371,-
chr19,3053776,11.621756487025948,1506,667,2173,-
chr19,3053778,3.4793564796345744,1669,583,2252,-
chr19,3053780,3.98978756304868,3192,1063,4255,-
chr19,3053781,4.181693026261898,3112,1014,4126,-
chr19,3053782,5.109646593455249,5240,1684,6924,-
chr19,3053783,9.804824376026186,4079,1290,5369,-
chr19,3053784,10.736152855138199,5808,1469,7277,-
chr19,3053785,15.901330780267878,4554,1067,5621,-
chr19,3053786,20.24629851592189,3681,780,4461,-
chr19,3053789,11.357660604969887,2013,249,2262,-
chr19,3053790,12.385950726675771,2093,260,2353,-
chr19,3053791,15.724867724867725,1485,188,1673,-
chr19,3053792,16.73305002133487,1699,226,1925,-
chr19,3053921,1.9118442831678129,742,414,1156,-
chr19,3055711,0.6026435112467772,1161,822,1983,-
chr19,3057686,0.891447601139037,5474,3624,9098,-
chr19,3057687,0.8862577619038201,5480,3505,8985,-
chr19,3057698,1.0407580120912947,3070,2226,5296,-
chr19,3057736,0.5808532997057587,952,731,1683,-
chr19,3061188,1.5823931446740531,2252,1547,3799,-
chr19,3061226,1.3127439562688143,1634,1392,3026,-
chr19,3061228,1.9330826979057405,1623,1390,3013,-
chr19,3061229,2.2031697556258414,1738,1409,3147,-
chr19,3061235,2.4430823117338,836,570,1406,-
chr19,3062183,2.15414168868906,1137,727,1864,-
chr19,3062185,1.9866211604095567,855,585,1440,-
chr19,3062194,1.9991823995907636,915,559,1474,-
chr19,3062196,2.4185959671396566,761,411,1172,-
chr19,3062887,2.590963855421687,781,331,1112,-
chr19,3062888,2.590963855421687,781,331,1112,-
chr19,3062913,1.9541511793507853,779,328,1107,-
chr19,3062914,0.73060834871577,777,377,1154,-
chr19,3538414,7.355703810664736,7620,13958,21578,-
chr19,3538415,7.355703810664736,7620,13958,21578,-
chr19,3538416,7.5716116813224685,6672,12801,19473,-
chr19,3538422,1.4776478033248543,3438,5176,8614,-
chr19,3538423,1.5986022214422975,4239,6046,10285,-
chr19,3538424,1.6875036443819371,4263,6095,10358,-
chr19,3538425,1.9448636829782708,3654,5242,8896,-
chr19,3538427,2.294686765800341,1727,2362,4089,-
chr19,3538433,3.216271743596768,1415,1787,3202,-
chr19,3538435,8.517348112472547,5208,5002,10210,-
chr19,3538436,11.337970885375281,5889,4722,10611,-
chr19,3538437,11.337970885375281,5889,4722,10611,-
chr19,3538438,12.067707764257113,4374,2984,7358,-
chr19,3538443,4.593534320133506,1249,352,1601,-
chr19,3538444,8.502128014249443,3643,1398,5041,-
chr19,3538445,12.649267373741543,4752,1703,6455,-
chr19,3538446,13.496838402951157,5004,1750,6754,-
chr19,3538447,16.850286884292206,3860,1277,5137,-
chr19,3538450,6.479704797047971,1755,270,2025,-
chr19,3538451,6.52861325351451,2011,319,2330,-
chr19,3538452,6.479704797047971,1755,270,2025,-
chr19,3538513,0.36876036102412973,1000,622,1622,-
chr19,3538515,0.3939804772234273,1452,921,2373,-
chr19,3538516,0.36675696539263347,1379,893,2272,-
chr19,3542224,2.344768898910122,696,590,1286,-
chr19,3542227,3.6903302804435016,1295,984,2279,-
chr19,3542229,3.6618901731827345,1672,1294,2966,-
chr19,3542231,2.8279480806407067,767,638,1405,-
chr19,3544255,1.6843398876404494,614,444,1058,-
chr19,3544378,1.4101025228776882,1969,1278,3247,-
chr19,3544423,1.7273608448768492,3830,3214,7044,-
chr19,3544425,1.7273608448768492,3830,3214,7044,-
chr19,3544496,1.5415204678362573,1317,1234,2551,-
chr19,3544530,2.4090270430248153,3975,3211,7186,-
chr19,3544531,2.425237594339064,2920,2313,5233,-
chr19,3544543,2.474372873738655,5265,3822,9087,-
chr19,3544544,2.904376363063001,3612,2534,6146,-
chr19,3544545,1.5148609779482263,789,595,1384,-
chr19,3544551,7.2353894915355,5800,3824,9624,-
chr19,3544552,7.2353894915355,5800,3824,9624,-
chr19,3544557,2.0700389105058368,873,513,1386,-
chr19,3544593,1.9042796865581677,717,394,1111,-
chr19,3544612,1.895934959349593,635,368,1003,-
chr19,3544722,2.0731226569063503,2154,1457,3611,-
chr19,3546127,1.44527027693057,2808,2298,5106,-
chr19,3546138,0.6039733362467068,1721,1321,3042,-
chr19,3546149,1.6358632546956349,3581,2130,5711,-
chr19,3546150,1.6346181147075522,2331,1173,3504,-
chr19,3546164,1.6483414165349908,2758,1858,4616,-
chr19,3546305,2.418861512319456,948,534,1482,-
chr19,3546328,2.0242461601684902,1036,720,1756,-
chr19,3546422,1.798948401400516,1788,1398,3186,-
chr19,3547301,0.8590708016294665,3141,2427,5568,-
chr19,3547901,1.4587039390088943,1147,786,1933,-
chr19,3548127,1.527117513672135,1300,734,2034,-
chr19,3548171,0.6163336265761802,1176,653,1829,-
chr19,3548229,1.4139596407038268,1584,1203,2787,-
chr19,3548241,1.4792156504668206,1599,1233,2832,-
chr19,3551006,1.931477411477412,1670,1364,3034,-
chr19,3551008,0.6521547933157431,1482,1136,2618,-
chr19,3551047,0.7083889571207348,1583,1227,2810,-
chr19,3551098,1.6795436022819883,1609,1226,2835,-
chr19,3551101,1.6536244797551631,4599,3027,7626,-
chr19,3551102,1.696622124285486,3027,1862,4889,-
chr19,3551155,0.6879564606741573,1243,889,2132,-
chr19,3557184,1.7365818118925485,1512,1008,2520,-
chr19,3557187,2.4661651708669803,1507,974,2481,-
chr19,3557267,1.9656896551724137,876,724,1600,-
chr19,3557289,0.5278706921563434,1346,1061,2407,-
chr19,3557311,0.6113087500855169,850,621,1471,-
chr19,3557315,1.4573789032793119,1616,1060,2676,-
chr19,3557343,5.291981056178752,713,417,1130,-
chr19,3557363,2.248412138320395,707,326,1033,-
chr19,3557364,2.248412138320395,707,326,1033,-
chr19,3557493,5.725382434452832,891,771,1662,-
chr19,3557494,5.692653098004942,1681,1352,3033,-
chr19,3557504,0.8307628174929977,608,523,1131,-
chr19,3557529,1.335529894992342,770,436,1206,-
chr19,3558074,0.53113224858283,784,572,1356,-
chr19,3781663,2.8792813026389665,640,410,1050,-
chr19,3976275,0.5766561335407244,27919,37490,65409,-
chr19,3976276,0.5766561335407244,27919,37490,65409,-
chr19,3976281,0.5043643707314616,11470,16578,28048,-
chr19,3976287,11.354595085067729,66449,106288,172737,-
chr19,3976288,11.354595085067729,66449,106288,172737,-
chr19,3976292,13.784955888799944,94984,51595,146579,-
chr19,3976293,12.616142536977186,125493,57942,183435,-
chr19,3976294,12.616142536977188,125493,57942,183435,-
chr19,3976295,16.87146428598004,93198,32833,126031,-
chr19,3976299,4.2221485812740704,61667,12435,74102,-
chr19,3976300,4.637680108878382,71601,13794,85395,-
chr19,3976301,5.670722587392534,25712,5736,31448,-
chr19,3976302,6.378182901487118,43410,8306,51716,-
chr19,3976397,1.4354530805203478,37053,38096,75149,-
chr19,3976399,1.394360844432553,66258,83687,149945,-
chr19,3976400,0.7170713036731786,15590,28234,43824,-
chr19,3976402,1.3688737222117495,60165,87679,147844,-
chr19,3976403,1.3463406375514209,86973,138027,225000,-
chr19,3976405,1.6622289801749526,52260,99478,151738,-
chr19,3976406,1.877480965723433,50334,92529,142863,-
chr19,3976407,1.6576004640669977,75736,126999,202735,-
chr19,3976408,1.9095098475965704,48694,86061,134755,-
chr19,3976410,1.9170191775781509,47401,67642,115043,-
chr19,3976412,2.0292334232028675,22444,35442,57886,-
chr19,3976465,1.4627042243556254,8829,9215,18044,-
chr19,3976487,1.220145222013387,61214,54842,116056,-
chr19,3976488,1.360339610763594,36922,37598,74520,-
chr19,3976489,1.2351375914135874,51583,48990,100573,-
chr19,3976502,1.5393076972811,20373,15357,35730,-
chr19,3976559,1.2067250422536968,7402,6060,13462,-
chr19,3976570,1.3338572978750485,12708,10170,22878,-
chr19,3976571,1.3338572978750485,12708,10170,22878,-
chr19,3976593,1.3478632547213103,24823,16182,41005,-
chr19,3976594,1.3478632547213103,24823,16182,41005,-
chr19,3976597,1.4904424903674722,14207,9715,23922,-
chr19,3976675,1.5332380377394226,6094,4692,10786,-
chr19,3977253,1.3534382289546034,22574,15980,38554,-
chr19,3977254,1.320066315482053,13852,10477,24329,-
chr19,3977307,1.2939128768523251,7769,5767,13536,-
chr19,3977316,1.2434081038054634,6527,5382,11909,-
chr19,3977345,1.031060234312703,814,547,1361,-
chr19,3977346,1.036774544615457,1081,753,1834,-
chr19,3977432,1.2630039277443672,14229,10334,24563,-
chr19,3977441,1.288804655481273,12991,9098,22089,-
chr19,3977444,1.585711431425717,7277,4549,11826,-
chr19,3977454,1.6991985183766003,4881,3795,8676,-
chr19,3977513,1.6419772434521254,4420,3399,7819,-
chr19,3977591,1.3725106804866785,8506,6927,15433,-
chr19,3977901,1.7673736117012837,17333,13830,31163,-
chr19,3977904,1.3727268156775247,72783,48077,120860,-
chr19,3977905,1.4670925802536519,80309,54791,135100,-
chr19,3977907,1.6325772815756887,29612,21426,51038,-
chr19,3977934,1.2285600483254586,32199,20832,53031,-
chr19,3977940,1.3598775714889275,20704,10590,31294,-
chr19,3977941,1.3843534846771406,31620,17893,49513,-
chr19,3977971,1.309950950522406,23083,15065,38148,-
chr19,3977973,1.4012029447041778,13529,9975,23504,-
chr19,3977974,0.873474688971007,7605,5065,12670,-
chr19,3978031,0.7550477539422759,6308,4725,11033,-
chr19,3978073,0.7922488356620093,4762,4007,8769,-
chr19,3978075,1.2336348323838735,7936,4479,12415,-
chr19,3978103,1.2807025775991632,6165,4945,11110,-
chr19,3979369,0.7932442736636593,10282,8060,18342,-
chr19,3979837,1.7074559698473697,83305,66831,150136,-
chr19,3979838,1.5711872440953667,110144,87750,197894,-
chr19,3979839,1.7074559698473697,83305,66831,150136,-
chr19,3979855,0.749724162350611,19130,14987,34117,-
chr19,3979873,1.260623135080667,24259,14270,38529,-
chr19,3979875,1.2549838081311588,71774,46145,117919,-
chr19,3979876,1.0895122990636839,72009,49984,121993,-
chr19,3979877,0.7448790880020109,21606,17902,39508,-
chr19,3979894,1.403756805255874,19611,14657,34268,-
chr19,3979918,1.4213748938615092,8701,5042,13743,-
chr19,3979921,1.4519878552011976,15024,10700,25724,-
chr19,3979933,1.2327586206896552,6148,4320,10468,-
chr19,3979980,1.2450264774605255,17594,11435,29029,-
chr19,3980055,1.2331145878012593,11229,8698,19927,-
chr19,3980064,0.6812988027868477,2136,1487,3623,-
chr19,3980556,1.2745294332340646,45890,33213,79103,-
chr19,3980557,1.3013057226474176,56620,39177,95797,-
chr19,3980559,1.2025181088401686,47080,33151,80231,-
chr19,3980625,1.5107361153469752,9408,6800,16208,-
chr19,3980701,1.4464332838575595,49982,35653,85635,-
chr19,3980702,1.4190583236703287,43012,28601,71613,-
chr19,3980703,1.4384401769611694,25154,18566,43720,-
chr19,3980704,1.084708491873949,22851,14751,37602,-
chr19,3980705,1.2983232969775063,15984,11923,27907,-
chr19,3980892,1.5353847663918336,6256,4810,11066,-
chr19,3981966,1.509530456988291,39854,29810,69664,-
chr19,3982027,1.188983452769168,8010,6873,14883,-
chr19,3982261,0.8367882132020418,11036,7951,18987,-
chr19,3982279,1.384272533941408,6363,5284,11647,-
chr19,3982282,1.3527509495387953,11871,9699,21570,-
chr19,3982283,1.1475263398803355,19388,15468,34856,-
chr19,3982306,1.394651530508646,10968,9067,20035,-
chr19,3982354,1.2191245414803344,11323,9526,20849,-
chr19,3982811,1.3513427491737222,14342,10631,24973,-
chr19,3982812,1.1794106778788864,22092,16551,38643,-
chr19,3982847,1.1788177184166866,22344,16120,38464,-
chr19,3982941,1.201711145664432,6953,5902,12855,-
chr19,3982944,1.3035136571080204,16029,13599,29628,-
chr19,3982946,1.2101513842736051,9601,8230,17831,-
chr19,3982950,1.3525916729011138,5493,4382,9875,-
chr19,3982965,1.35520838403011,6458,3804,10262,-
chr19,3982977,1.2912817245407242,5699,3284,8983,-
chr19,3982997,0.8076301561266024,3560,2654,6214,-
chr19,3983003,0.689191477061168,12035,8863,20898,-
chr19,3983006,1.331303896518684,2584,2019,4603,-
chr19,3983280,1.2001600398940024,7919,6548,14467,-
chr19,3984178,0.7903296164832145,4586,4131,8717,-
chr19,3984179,0.8359679683202446,7261,5565,12826,-
chr19,3984180,1.2106672442703337,5788,4425,10213,-
chr19,3984182,1.2213914681067328,6753,5172,11925,-
chr19,3984257,1.3066054408809948,13070,8371,21441,-
chr19,3984346,1.5908376093722598,4707,4302,9009,-
chr19,3985399,1.2449841120590694,28975,22110,51085,-
chr19,3985400,1.2402944721727631,21953,16531,38484,-
chr19,3985401,1.2036006450124173,15328,10528,25856,-
chr19,3985410,1.3184337235152193,2338,2085,4423,-
chr19,3985413,1.3541461199607487,7408,5791,13199,-
chr19,3985425,1.0624960705015936,5752,4393,10145,-
chr19,3985426,1.0198106977767996,2336,1946,4282,-
chr19,3985434,1.5016591613487689,2264,1640,3904,-
chr19,3985437,0.9237558112755827,3941,2571,6512,-
chr19,3985438,0.8835088229682089,5079,3352,8431,-
chr19,3985439,0.9525011024116048,5426,3628,9054,-
chr19,3985440,0.8521908039683471,2993,1893,4886,-
chr19,3985441,1.089552602706327,783,630,1413,-
chr19,3985446,1.783737694752345,1045,664,1709,-
chr19,3985447,1.783737694752345,1045,664,1709,-
chr19,3985449,1.7553347684302707,587,501,1088,-
chr19,4097292,0.38224324922563596,878,796,1674,-
chr19,4102398,1.2559957401478519,839,624,1463,-
chr19,4117607,1.2882474225889864,690,520,1210,-
chr19,4361396,0.22452606801372696,482,737,1219,-
chr19,4446557,1.735725938009788,797,612,1409,-
chr19,4446558,1.3848027655122426,1349,863,2212,-
chr19,4446559,1.6559857629268206,1007,646,1653,-
chr19,4446560,1.811145510835913,1104,645,1749,-
chr19,4446562,1.8424605155936142,898,593,1491,-
chr19,4447611,2.859217761178545,688,566,1254,-
chr19,4447613,3.0758795141599706,786,548,1334,-
chr19,4657644,0.551802041029077,2403,3049,5452,-
chr19,4657658,0.5062604062604064,1321,1715,3036,-
chr19,4657710,11.347430417876637,9870,12853,22723,-
chr19,4657711,11.347430417876637,9870,12853,22723,-
chr19,4657712,11.347430417876637,9870,12853,22723,-
chr19,4657722,26.389660806269283,6480,2856,9336,-
chr19,4657723,26.389660806269283,6480,2856,9336,-
chr19,4657728,2.9340066520645736,1954,586,2540,-
chr19,4657730,3.0400493358530682,4341,1469,5810,-
chr19,4657731,3.0417203458047815,3367,1178,4545,-
chr19,4657732,6.498495365331146,1709,456,2165,-
chr19,4657792,2.050086065431696,5008,4456,9464,-
chr19,4657794,2.42983789260385,1990,1973,3963,-
chr19,4657798,1.8825700838142518,3542,2877,6419,-
chr19,4657799,2.21028822294331,1913,1689,3602,-
chr19,4657809,0.6191283895334373,943,866,1809,-
chr19,4657901,1.7178490103345596,1065,864,1929,-
chr19,4657923,1.278572325721846,1998,1561,3559,-
chr19,4657980,1.5638247201714697,1141,645,1786,-
chr19,4658013,1.6183949088605407,1101,846,1947,-
chr19,4660000,3.538563829787234,886,751,1637,-
chr19,4660682,1.8100715014889115,2339,1730,4069,-
chr19,4660729,0.5405619834710744,1021,824,1845,-
chr19,4664890,1.7595238095238095,738,559,1297,-
chr19,4664905,6.024896265560166,725,481,1206,-
chr19,4668652,0.9173242983929,2216,1515,3731,-
chr19,4668654,0.9173242983929,2216,1515,3731,-
chr19,4668655,1.623931623931624,607,503,1110,-
chr19,4668656,0.5953479430988081,814,577,1391,-
chr19,4670194,2.0142857142857142,845,707,1552,-
chr19,4670195,2.0142857142857142,845,707,1552,-
chr19,4670228,1.588897101092223,690,368,1058,-
chr19,4670229,3.2203883495145638,748,514,1262,-
chr19,4670230,3.2203883495145638,748,514,1262,-
chr19,4838561,2.4296899482537673,1550,1103,2653,-
chr19,4838562,2.429689948253767,1550,1103,2653,-
chr19,4839009,2.159288537549407,606,505,1111,-
chr19,4839060,0.523696682464455,594,421,1015,-
chr19,4839072,1.637024913620658,642,422,1064,-
chr19,4839120,1.717171717171717,679,431,1110,-
chr19,4839121,2.5016100178890874,607,429,1036,-
chr19,4839208,0.44089576300126965,670,500,1170,-
chr19,4839467,0.8557704562628299,681,491,1172,-
chr19,5205613,2.375279481585344,660,433,1093,-
chr19,5244396,2.2823335994624414,1844,1627,3471,-
chr19,5244397,2.4993641822677497,1635,1489,3124,-
chr19,5244398,2.719282600079271,2110,1855,3965,-
chr19,5244400,3.098569662722938,996,808,1804,-
chr19,5600146,4.758169934640524,1091,917,2008,-
chr19,5600163,1.805639589169001,1050,764,1814,-
chr19,5600165,1.4807692307692308,839,599,1438,-
chr19,5600178,2.8881205532016954,1066,721,1787,-
chr19,5678565,0.44434543337458177,708,530,1238,-
chr19,5679389,0.5021440113705028,919,709,1628,-
chr19,5691925,3.335445774749679,602,538,1140,-
chr19,5693348,2.3812578474168995,998,717,1715,-
chr19,5693603,2.486042904908534,1051,721,1772,-
chr19,5694785,1.8056648312049257,1397,1064,2461,-
chr19,5694787,2.565694444444444,636,449,1085,-
chr19,5696113,1.2947206379560057,670,541,1211,-
chr19,5696316,2.4819427402325234,778,691,1469,-
chr19,5696721,1.80571488682233,2000,1771,3771,-
chr19,5696723,1.941025953454368,1769,1697,3466,-
chr19,5696724,2.003247348435249,1158,1090,2248,-
chr19,5696735,2.086837606837607,653,350,1003,-
chr19,5699092,2.2836879432624118,758,422,1180,-
chr19,5699127,2.347722772277228,911,605,1516,-
chr19,5699129,2.347722772277228,911,605,1516,-
chr19,5699157,2.3168298224644124,712,544,1256,-
chr19,5705995,3.4349734078351317,3389,1900,5289,-
chr19,5707716,1.4420990037537487,776,485,1261,-
chr19,5707737,3.7443524820776783,711,415,1126,-
chr19,5711802,1.3781753339764389,2142,1266,3408,-
chr19,5711803,2.252907452907453,2644,2441,5085,-
chr19,5711804,1.7934782742348807,7247,5529,12776,-
chr19,5711806,1.6615359435404944,11948,7968,19916,-
chr19,5711807,1.629792958550125,8800,5640,14440,-
chr19,5711813,1.781616982836495,1931,1475,3406,-
chr19,5711815,1.781616982836495,1931,1475,3406,-
chr19,5711818,1.8410256410256407,1076,584,1660,-
chr19,5711826,2.0164776898605106,1029,532,1561,-
chr19,5711830,2.3586655425749727,611,436,1047,-
chr19,5711844,1.953168044077135,708,362,1070,-
chr19,5711959,1.5924456652486911,1092,974,2066,-
chr19,5711960,2.0694852126305943,2303,1760,4063,-
chr19,5711962,2.0067693784069394,1753,1254,3007,-
chr19,5713165,1.163163948138854,1170,796,1966,-
chr19,5713166,1.163163948138854,1170,796,1966,-
chr19,5720050,36.23045267489712,619,404,1023,-
chr19,5720051,18.10142794517213,2164,1418,3582,-
chr19,5720052,18.10142794517213,2164,1418,3582,-
chr19,5720053,11.25158368617889,1216,785,2001,-
chr19,5894766,2.089064914992272,982,646,1628,-
chr19,5894828,1.7381835928026708,1422,1186,2608,-
chr19,5894829,1.214680744092509,1207,1052,2259,-
chr19,5894831,0.9008259368836292,789,675,1464,-
chr19,5896985,0.4188293313929986,796,588,1384,-
chr19,5896992,2.359322033898305,695,589,1284,-
chr19,5903670,1.7873027861698556,1216,661,1877,-
chr19,5903688,2.7857142857142856,611,475,1086,-
chr19,5903696,2.088779956427015,589,458,1047,-
chr19,5903731,1.6289615678258789,1557,1006,2563,-
chr19,5903791,1.3279626256681647,1082,606,1688,-
chr19,5903793,1.0522417323863884,804,388,1192,-
chr19,5903800,0.7616106663442717,1461,1138,2599,-
chr19,5903801,0.9192749652950983,948,709,1657,-
chr19,5924896,2.2258248774409584,671,475,1146,-
chr19,6210473,0.5973244147157191,939,597,1536,-
chr19,6210497,1.9757639620653318,749,437,1186,-
chr19,6210522,2.127659574468085,679,469,1148,-
chr19,6393079,2.040118554104839,1238,973,2211,-
chr19,6393081,2.040118554104839,1238,973,2211,-
chr19,6393091,0.5207094498931706,777,562,1339,-
chr19,6393111,0.4519848028298179,574,448,1022,-
chr19,6393117,2.406277703157092,775,551,1326,-
chr19,6393160,2.484956575682382,762,402,1164,-
chr19,6413710,3.622630409834373,980,715,1695,-
chr19,6413724,2.556620117614149,748,470,1218,-
chr19,6413839,0.25412479356518075,620,484,1104,-
chr19,6413920,0.23961467214062368,469,687,1156,-
chr19,6413924,0.30000736524085236,423,686,1109,-
chr19,6413948,0.283470172279378,707,1281,1988,-
chr19,6413950,0.265321375186846,354,668,1022,-
chr19,6413956,6.285529462473251,1022,1797,2819,-
chr19,6413957,6.426223037817076,935,1561,2496,-
chr19,6413965,10.256625859018769,1564,1888,3452,-
chr19,6413966,11.04597634404003,1914,2006,3920,-
chr19,6413967,11.809229898056625,1719,1685,3404,-
chr19,6413968,14.477721357883006,1087,763,1850,-
chr19,6416572,1.767182783418285,681,459,1140,-
chr19,6416577,1.7328138555888637,892,573,1465,-
chr19,6417066,1.460627464275848,597,424,1021,-
chr19,6417791,0.9388657838176705,742,482,1224,-
chr19,6418548,1.608303222275309,945,733,1678,-
chr19,6418567,0.7035954895212528,654,516,1170,-
chr19,6420131,0.4324324324324324,695,434,1129,-
chr19,6420132,1.2189901053853778,915,608,1523,-
chr19,6422392,0.5019304201266169,826,561,1387,-
chr19,6422407,1.1892903613819816,750,470,1220,-
chr19,6678403,1.6407421431276032,941,694,1635,-
chr19,6678415,1.8367210981315645,1150,1093,2243,-
chr19,6678417,1.7540348638390304,1919,1626,3545,-
chr19,6678418,2.102568053415511,610,589,1199,-
chr19,6678426,1.642232160217772,617,416,1033,-
chr19,6679476,2.463157894736842,701,474,1175,-
chr19,6679478,1.5902207438724345,1116,810,1926,-
chr19,6681961,1.8056838218889215,1272,994,2266,-
chr19,6682012,0.6325717103640995,732,528,1260,-
chr19,6684650,1.680851063829787,710,516,1226,-
chr19,6684807,2.2407901160389048,1325,858,2183,-
chr19,6684809,2.382820167599028,1661,1134,2795,-
chr19,6685057,1.1726754002010382,780,600,1380,-
chr19,6685092,2.1663803988098955,802,537,1339,-
chr19,6685125,2.1965587634280177,691,483,1174,-
chr19,6693012,0.996292372881356,626,471,1097,-
chr19,6693014,0.996292372881356,626,471,1097,-
chr19,6697418,2.2412542797572295,607,490,1097,-
chr19,6697459,1.1324032343854475,635,548,1183,-
chr19,6697708,1.5260632854976486,1072,788,1860,-
chr19,6702587,0.637843298904654,723,414,1137,-
chr19,6710835,0.9417083037108914,613,514,1127,-
chr19,6713506,0.43794168927903554,842,627,1469,-
chr19,6714244,0.3093373747579355,667,641,1308,-
chr19,6714245,0.3093373747579355,667,641,1308,-
chr19,6714398,2.172557172557173,626,480,1106,-
chr19,6714399,2.172557172557173,626,480,1106,-
chr19,6714413,1.9903409472191387,764,599,1363,-
chr19,6718298,2.8441393399080024,981,727,1708,-
chr19,6719408,4.1559409058913745,664,402,1066,-
chr19,6720561,2.299215237289323,900,497,1397,-
chr19,7689295,2.9590069284064664,614,432,1046,-
chr19,7689296,2.3912638250279605,894,618,1512,-
chr19,8002943,2.4502609262883235,600,437,1037,-
chr19,8002944,2.4502609262883235,600,437,1037,-
chr19,8367260,2.2243824488980626,695,652,1347,-
chr19,8367262,2.2243824488980626,695,652,1347,-
chr19,8367370,1.2836553949522609,1323,1080,2403,-
chr19,8367393,0.5371682351697156,634,385,1019,-
chr19,8367797,2.8330674152652664,697,401,1098,-
chr19,8368875,2.021044211515775,1022,747,1769,-
chr19,8376347,0.6708937198067634,1110,827,1937,-
chr19,8376361,1.631016042780749,975,747,1722,-
chr19,8376365,1.716852010265184,891,667,1558,-
chr19,8376427,0.6204457364341085,673,479,1152,-
chr19,8376428,1.039475689681451,1239,728,1967,-
chr19,8376429,1.039475689681451,1239,728,1967,-
chr19,8381469,2.162218191241254,595,453,1048,-
chr19,8381476,0.5088300220750552,921,603,1524,-
chr19,8381479,0.48750000000000004,623,479,1102,-
chr19,8386222,2.534464006051899,1965,891,2856,-
chr19,8386243,2.067119217579779,2092,989,3081,-
chr19,8386244,2.086482487799411,2307,904,3211,-
chr19,8386255,2.1485382400072033,1245,565,1810,-
chr19,8386258,0.9124273602233574,2225,864,3089,-
chr19,10225772,1.431363954944506,609,591,1200,-
chr19,10227502,1.1149340628507294,725,619,1344,-
chr19,10227534,2.030181521209395,830,577,1407,-
chr19,10227633,2.162143349189995,1264,866,2130,-
chr19,10227634,3.4541015625,785,511,1296,-
chr19,10227782,4.172661870503597,599,416,1015,-
chr19,10229572,2.4322033898305087,778,589,1367,-
chr19,10229604,3.129965457685665,658,385,1043,-
chr19,10230548,0.5380444646098004,640,579,1219,-
chr19,10230549,0.7160157421289355,1120,1026,2146,-
chr19,10230551,0.8864161634235443,552,525,1077,-
chr19,10244181,0.9471491228070176,616,455,1071,-
chr19,10244183,0.9471491228070176,616,455,1071,-
chr19,10251577,5.21565374058823,692,532,1224,-
chr19,10265665,1.0873165618448637,901,529,1430,-
chr19,10265666,1.401887717581682,1207,703,1910,-
chr19,10265695,0.7011680368762423,882,501,1383,-
chr19,10277324,1.5494001353365792,1365,665,2030,-
chr19,10277326,1.7743753286059725,2561,1441,4002,-
chr19,10279010,1.7322976878612717,684,345,1029,-
chr19,10287978,2.0365359209147647,1015,812,1827,-
chr19,10287979,2.0672333374451797,1484,1098,2582,-
chr19,10501886,1.1967352253746784,670,505,1175,-
chr19,10502051,0.9451992409867171,592,424,1016,-
chr19,10502053,0.9451992409867171,592,424,1016,-
chr19,10502161,2.4670629020091983,818,622,1440,-
chr19,10502375,0.8191452991452991,598,449,1047,-
chr19,10502376,0.986747115464395,1142,824,1966,-
chr19,10503831,0.5361670096166865,679,419,1098,-
chr19,10505988,1.9680000000000002,655,439,1094,-
chr19,10506159,1.6056042031523643,2673,1712,4385,-
chr19,10506160,1.669184831222865,4831,3393,8224,-
chr19,10506163,3.406503479177209,3151,2326,5477,-
chr19,10506211,0.6001762632197415,680,459,1139,-
chr19,10506623,1.8657636006117544,1153,994,2147,-
chr19,10506647,1.7741197988111568,969,728,1697,-
chr19,10506658,0.4942989214175655,801,589,1390,-
chr19,10506662,1.6353285469621663,1564,1211,2775,-
chr19,10506670,1.927705330587966,765,563,1328,-
chr19,10506682,1.8387813806701696,1160,844,2004,-
chr19,10602717,2.140535128760391,746,500,1246,-
chr19,10602719,0.8870054808984131,760,539,1299,-
chr19,10683615,2.515970994979394,557,524,1081,-
chr19,10683660,21.987457858583774,1576,1065,2641,-
chr19,10683661,23.54236246545939,1398,898,2296,-
chr19,10685617,1.4082822542135378,685,421,1106,-
chr19,10943388,2.5803608447138413,588,439,1027,-
chr19,10945730,2.293622236128494,709,560,1269,-
chr19,10945754,2.255639097744361,749,559,1308,-
chr19,10945755,2.255639097744361,749,559,1308,-
chr19,10946792,24.31030524122962,1291,959,2250,-
chr19,10946793,24.31030524122962,1291,959,2250,-
chr19,11453614,1.2026300904977374,728,543,1271,-
chr19,11453615,1.2026300904977374,728,543,1271,-
chr19,11456009,1.7069764177428415,736,547,1283,-
chr19,11456247,1.157575472235903,930,611,1541,-
chr19,11456866,1.3693647874109374,773,556,1329,-
chr19,11456943,1.0936305854360309,596,486,1082,-
chr19,12772132,2.599031244354387,1054,796,1850,-
chr19,12778962,2.1814573187358635,694,577,1271,-
chr19,12779025,2.112211221122112,639,403,1042,-
chr19,12779131,0.5197278911564626,572,440,1012,-
chr19,12779135,1.748502522068096,764,487,1251,-
chr19,12779203,1.868071507040847,644,526,1170,-
chr19,12779943,0.9467222758383154,2861,1798,4659,-
chr19,12779944,1.2126872130774702,3733,2388,6121,-
chr19,12779947,1.9980435314257767,1289,782,2071,-
chr19,12779961,1.6959776678086538,977,638,1615,-
chr19,12779972,2.1087572977481237,902,544,1446,-
chr19,12779973,1.832273449920509,921,591,1512,-
chr19,12779986,3.7590579710144936,746,413,1159,-
chr19,12779991,1.9499201915403035,673,357,1030,-
chr19,12779993,2.834473324213406,739,429,1168,-
chr19,12780180,0.5514596207116983,646,360,1006,-
chr19,12780224,0.5569645679232473,758,549,1307,-
chr19,12786884,2.145098729768125,651,483,1134,-
chr19,12790352,2.723908918406072,791,526,1317,-
chr19,12790354,2.723908918406072,791,526,1317,-
chr19,12790669,1.3096338261400229,648,420,1068,-
chr19,12790727,2.5007631257631258,564,467,1031,-
chr19,12790729,2.5007631257631258,564,467,1031,-
chr19,12792463,3.5831729556773055,877,632,1509,-
chr19,12841668,1.8238598653645584,1398,795,2193,-
chr19,12841678,2.034712950600801,634,534,1168,-
chr19,12841679,0.5466522936878668,814,758,1572,-
chr19,12841729,2.400612843058886,973,555,1528,-
chr19,12841753,1.0925514461623398,1314,860,2174,-
chr19,12841780,1.8746749026418648,1798,1434,3232,-
chr19,12841781,1.9682524271844657,1066,1029,2095,-
chr19,12842179,1.5626575259602784,774,762,1536,-
chr19,12842213,2.1189592494026668,1216,1023,2239,-
chr19,12845135,1.891144148052894,977,728,1705,-
chr19,12845299,1.5766022380467954,1106,982,2088,-
chr19,12845301,0.8949056655850616,3858,2497,6355,-
chr19,12845302,1.4244150051231177,1717,1476,3193,-
chr19,12845303,1.1013425627112103,3707,2407,6114,-
chr19,12845304,1.2795131667089774,6245,4668,10913,-
chr19,12845305,1.5969839908519152,2179,1759,3938,-
chr19,12845306,1.5969839908519152,2179,1759,3938,-
chr19,12845317,0.4996509790954847,799,632,1431,-
chr19,12845327,1.807418181818182,653,549,1202,-
chr19,12845370,3.9474323625575902,890,534,1424,-
chr19,12907693,0.5795398923152227,591,453,1044,-
chr19,12907769,1.6736808403001078,2239,1516,3755,-
chr19,12907778,0.5737437965260546,1056,623,1679,-
chr19,12907802,0.4955654101995565,744,549,1293,-
chr19,12907944,1.779040750730864,3080,2451,5531,-
chr19,12907945,1.779040750730864,3080,2451,5531,-
chr19,12910695,1.1956033412457365,2837,2294,5131,-
chr19,12911017,1.3918541505042668,1630,1288,2918,-
chr19,12911065,1.4501679731243,2071,1409,3480,-
chr19,12911071,1.591584244317196,1368,1129,2497,-
chr19,12911072,1.5499462943071964,3625,2400,6025,-
chr19,12911074,1.523973509636667,6271,4557,10828,-
chr19,12911108,2.116539992761491,1461,920,2381,-
chr19,12911864,1.4825137252603404,1920,1550,3470,-
chr19,12911865,1.4713997833001822,3620,2638,6258,-
chr19,12911999,0.5400428200800506,2875,2319,5194,-
chr19,12912564,2.835897435897436,1105,869,1974,-
chr19,12912586,1.9707570907504892,1831,1315,3146,-
chr19,12912596,1.8021959169668895,954,602,1556,-
chr19,12912606,1.9762687969924813,646,455,1101,-
chr19,12912613,1.747841726618705,677,416,1093,-
chr19,12912617,0.8460406240800707,957,687,1644,-
chr19,12912618,0.8460406240800707,957,687,1644,-
chr19,12986403,1.6883903355613532,1355,1620,2975,-
chr19,12986404,1.6883903355613532,1355,1620,2975,-
chr19,12986413,0.8859740100787894,1345,1641,2986,-
chr19,12986449,0.5142857142857143,575,1119,1694,-
chr19,12986450,0.5142857142857143,575,1119,1694,-
chr19,12986499,25.992781363988236,996,1223,2219,-
chr19,12986500,26.849035513733696,885,1126,2011,-
chr19,12986643,2.622613333333333,1068,749,1817,-
chr19,12986645,2.622613333333333,1068,749,1817,-
chr19,12989360,0.6368190020262028,1122,745,1867,-
chr19,12989361,0.7469628043885471,820,504,1324,-
chr19,12989601,2.1815877399696704,625,469,1094,-
chr19,12991680,1.99102068498681,679,455,1134,-
chr19,13033625,4.296199117591798,672,452,1124,-
chr19,13035507,2.3105224429727738,627,452,1079,-
chr19,13035508,2.4974765454981194,853,614,1467,-
chr19,13039581,0.3802729528535979,612,619,1231,-
chr19,13039582,0.3802729528535979,612,619,1231,-
chr19,13041070,2.9786234732952677,530,501,1031,-
chr19,13065106,1.0456106349865886,2061,1528,3589,-
chr19,13065112,0.4559701492537313,1221,803,2024,-
chr19,13065139,1.5254237288135593,1052,766,1818,-
chr19,13065174,1.7463137996219282,744,574,1318,-
chr19,13065180,1.9529702970297032,788,605,1393,-
chr19,13065183,2.093990876199465,1347,1303,2650,-
chr19,13065184,1.9292353760567957,3459,2933,6392,-
chr19,13065186,2.046018902445509,2495,2221,4716,-
chr19,13065187,1.862972620599739,1298,1179,2477,-
chr19,13065311,1.525015015015015,1180,739,1919,-
chr19,13065324,0.5752873563218391,1182,695,1877,-
chr19,13067696,1.6402627675354948,1045,714,1759,-
chr19,13067725,1.8282781456953647,1452,1207,2659,-
chr19,13067727,1.7797379856459157,2037,1782,3819,-
chr19,13067731,1.7843451057752966,1466,1083,2549,-
chr19,13067751,1.8825227716330517,984,847,1831,-
chr19,13067752,1.8825227716330517,984,847,1831,-
chr19,13067809,3.041108294371536,1183,855,2038,-
chr19,13067852,4.017687464699823,917,607,1524,-
chr19,13067854,2.5493905201771434,835,647,1482,-
chr19,13067855,2.8492289545852887,725,410,1135,-
chr19,13067887,6.130678140005202,904,423,1327,-
chr19,14217590,2.257900062019645,1985,1617,3602,-
chr19,14217591,2.4491994348952204,1205,1095,2300,-
chr19,14217602,1.2680891148062057,1008,638,1646,-
chr19,14217606,2.0286657715242566,2484,1628,4112,-
chr19,14217607,2.083542188805347,1375,911,2286,-
chr19,14217608,2.083542188805347,1375,911,2286,-
chr19,14217614,1.3602534486057587,793,461,1254,-
chr19,14217620,2.9810490693739427,1148,590,1738,-
chr19,14217621,3.0883829531684825,1810,949,2759,-
chr19,14217622,3.198995194408038,1514,762,2276,-
chr19,14217623,3.7432300798753166,1477,707,2184,-
chr19,14217625,3.918801563178463,721,328,1049,-
chr19,14237037,2.275412929308095,598,440,1038,-
chr19,14237039,4.467644546266455,675,457,1132,-
chr19,14520629,2.126658534138791,673,548,1221,-
chr19,14522351,3.224091260634184,666,430,1096,-
chr19,14522353,3.224091260634184,666,430,1096,-
chr19,14530134,1.5928712466807382,658,772,1430,-
chr19,14530135,2.123136013435281,722,654,1376,-
chr19,14588622,10.086496112445229,760,564,1324,-
chr19,14588623,10.440217050119367,602,410,1012,-
chr19,14591516,1.9545562411010915,645,391,1036,-
chr19,14591517,1.342079606007871,1119,669,1788,-
chr19,14591571,2.7050119829113264,589,456,1045,-
chr19,14591573,3.716330846143043,805,570,1375,-
chr19,14591580,2.5046195870490884,724,460,1184,-
chr19,14602497,4.849816010239415,994,870,1864,-
chr19,14602498,5.236429704146422,1122,997,2119,-
chr19,14625717,2.6341123327098184,706,516,1222,-
chr19,14625724,4.59611472054221,1152,861,2013,-
chr19,14626431,0.9334649265019304,627,376,1003,-
chr19,14626641,28.27303762935905,1127,1471,2598,-
chr19,14626643,22.379026534853786,2433,2678,5111,-
chr19,14626644,23.575305433749453,1415,1220,2635,-
chr19,14626647,34.970953641216184,2282,1023,3305,-
chr19,14626648,34.97095364121619,2282,1023,3305,-
chr19,14626857,0.44252612448886863,973,567,1540,-
chr19,14626858,0.4452790269954666,1216,776,1992,-
chr19,14627485,2.664447242381693,1161,823,1984,-
chr19,14627594,1.0247660979636763,587,473,1060,-
chr19,14627596,1.0247660979636763,587,473,1060,-
chr19,14627810,3.531662343163204,685,492,1177,-
chr19,14629143,0.8528152260111023,565,484,1049,-
chr19,14629144,0.8528152260111023,565,484,1049,-
chr19,14629154,1.3044051204819278,532,497,1029,-
chr19,14629155,2.733872037655483,1159,1042,2201,-
chr19,14629156,2.733872037655483,1159,1042,2201,-
chr19,14677023,2.5013127112808733,685,584,1269,-
chr19,14677669,10.442622950819672,685,426,1111,-
chr19,14677733,2.627141866165489,712,542,1254,-
chr19,15472577,0.7283176282755118,636,398,1034,-
chr19,16764921,2.5776631394240535,729,497,1226,-
chr19,17343100,1.0544571626777663,759,464,1223,-
chr19,17343101,1.0544571626777663,759,464,1223,-
chr19,17351512,1.2666666666666666,645,407,1052,-
chr19,17351513,1.2666666666666666,645,407,1052,-
chr19,17355793,1.189855742100135,832,600,1432,-
chr19,17355797,1.8603198519695987,1107,773,1880,-
chr19,17355800,0.462921125285047,610,469,1079,-
chr19,17513790,0.4490395347471069,545,586,1131,-
chr19,17513793,4.749140302867412,1431,1800,3231,-
chr19,17513796,10.224306125251877,2662,2797,5459,-
chr19,17513797,3.401811867733655,930,894,1824,-
chr19,17513812,8.557999419279907,1240,860,2100,-
chr19,17513813,5.178842154787616,6630,4996,11626,-
chr19,17513814,5.178842154787616,6630,4996,11626,-
chr19,17513815,4.433909312520788,5390,4136,9526,-
chr19,17513828,2.1976164092532304,1094,670,1764,-
chr19,17513912,0.5797979797979798,573,560,1133,-
chr19,17513952,1.9830914407545548,1993,1652,3645,-
chr19,17513963,3.943974132863022,918,809,1727,-
chr19,17513964,4.506229968828199,2779,2085,4864,-
chr19,17513965,6.090534979423867,739,512,1251,-
chr19,17513989,3.197725284339457,730,380,1110,-
chr19,17514026,14.763860622373949,1196,852,2048,-
chr19,17514078,0.4045179319981369,1736,1129,2865,-
chr19,17514094,0.6751032282282282,1672,1183,2855,-
chr19,17514126,1.0636636044555898,2186,1846,4032,-
chr19,17514496,1.6451118326118326,985,692,1677,-
chr19,17514497,0.6437864106975761,1375,817,2192,-
chr19,17514512,1.6146355036171396,828,598,1426,-
chr19,17514546,1.741328340559716,1292,707,1999,-
chr19,17515239,1.2916710839117327,3055,2017,5072,-
chr19,17516109,1.4626340482573723,1217,745,1962,-
chr19,17516118,1.155357772839563,1818,1406,3224,-
chr19,17516151,1.5014767999491854,926,850,1776,-
chr19,17516168,1.779819189268008,717,507,1224,-
chr19,17516169,1.5235013623978202,851,733,1584,-
chr19,17516171,3.5781818181818177,655,449,1104,-
chr19,17516172,2.2671286203674867,786,675,1461,-
chr19,17516177,1.5529411764705885,951,577,1528,-
chr19,17516262,2.0740114903683677,721,537,1258,-
chr19,17516335,1.9451757782251822,784,586,1370,-
chr19,17516364,1.6129812162916124,1061,848,1909,-
chr19,17516374,1.3675336691682944,738,547,1285,-
chr19,17516385,1.0846222522659579,1276,897,2173,-
chr19,17516435,1.4714906116812092,915,526,1441,-
chr19,17516436,1.4909421663003108,842,473,1315,-
chr19,18417845,0.7600109897657805,2212,1687,3899,-
chr19,18417956,1.7733234191333511,2037,2038,4075,-
chr19,18418139,1.3438970309880482,2484,1680,4164,-
chr19,18418187,1.6134680134680135,1197,956,2153,-
chr19,18418194,1.419296905794245,3408,2536,5944,-
chr19,18418195,1.419296905794245,3408,2536,5944,-
chr19,18418229,1.7859157840351334,4909,2764,7673,-
chr19,18418230,1.8462661851910014,6679,3913,10592,-
chr19,18418238,2.68092497022628,1588,915,2503,-
chr19,18418307,1.4209821428571427,1060,959,2019,-
chr19,18418309,0.5964175143741708,898,645,1543,-
chr19,18418337,1.7216293839411927,2013,1292,3305,-
chr19,18418360,1.6930365864358203,1653,1102,2755,-
chr19,18418361,1.2713188294853768,2818,1804,4622,-
chr19,18420519,1.8241789354473388,1136,882,2018,-
chr19,18420520,1.8241789354473388,1136,882,2018,-
chr19,18420522,1.649616368286445,859,505,1364,-
chr19,18420594,0.6652924628964981,945,792,1737,-
chr19,18423483,1.5779616576429327,2316,1505,3821,-
chr19,18423497,1.190430917414428,4227,3758,7985,-
chr19,18423499,0.9865180155241958,3036,2641,5677,-
chr19,18426845,1.5412709317820572,6220,4488,10708,-
chr19,18426846,1.434427111350188,2984,2144,5128,-
chr19,18426863,0.553765365795441,1119,1028,2147,-
chr19,18426870,0.3257380622151773,958,720,1678,-
chr19,18433831,1.975378787878788,1191,639,1830,-
chr19,18433832,1.582262638413591,1591,1337,2928,-
chr19,18433862,2.116564078946976,1466,886,2352,-
chr19,18433885,1.5662100456621004,1371,1021,2392,-
chr19,18433886,1.5558382759587257,1894,1291,3185,-
chr19,18433887,1.5662100456621004,1371,1021,2392,-
chr19,18433916,0.5618271502360708,657,378,1035,-
chr19,18642801,3.220132572837984,632,498,1130,-
chr19,18642803,3.220132572837984,632,498,1130,-
chr19,18642921,1.8672489126912353,809,504,1313,-
chr19,18643573,1.7575757575757576,719,494,1213,-
chr19,18643597,0.6630078163523816,1527,962,2489,-
chr19,18649070,2.0859675230883705,804,536,1340,-
chr19,18649232,2.2652329749103943,631,371,1002,-
chr19,18652506,3.834644730567478,918,465,1383,-
chr19,18652640,2.1887219116123617,903,838,1741,-
chr19,18652646,5.888865874702536,1785,1332,3117,-
chr19,18652647,4.560416698927722,1873,1339,3212,-
chr19,18652649,3.0756319588624543,1471,955,2426,-
chr19,18652800,1.2540764878586963,952,1286,2238,-
chr19,18652802,1.5193550253527532,1797,2258,4055,-
chr19,18652803,1.9174757281553398,789,823,1612,-
chr19,18652804,1.9174757281553398,789,823,1612,-
chr19,18654308,6.791811846689894,677,573,1250,-
chr19,18654309,9.197797717947237,2066,2066,4132,-
chr19,18654310,9.197797717947237,2066,2066,4132,-
chr19,18654311,9.610578811248784,1836,1852,3688,-
chr19,18654328,10.357954184508671,1138,596,1734,-
chr19,18654329,8.125324058216302,1107,494,1601,-
chr19,18654330,7.501075268817203,871,309,1180,-
chr19,19010752,2.1850502637603264,1545,984,2529,-
chr19,19010753,2.1850502637603264,1545,984,2529,-
chr19,19014207,1.6255924170616116,685,421,1106,-
chr19,19015590,1.908225108225108,695,314,1009,-
chr19,19015647,1.5778882575757578,644,395,1039,-
chr19,19015649,0.8502362522473162,1044,828,1872,-
chr19,19015650,0.28762221718577685,1162,929,2091,-
chr19,19017864,0.4094757118187454,707,523,1230,-
chr19,19030077,1.9626919733410604,820,492,1312,-
chr19,19030080,1.7547348484848482,762,447,1209,-
chr19,19030095,1.987878787878788,655,362,1017,-
chr19,19030156,2.326434663121798,1167,715,1882,-
chr19,19030168,1.0457680835197614,862,446,1308,-
chr19,19030170,1.0457680835197614,862,446,1308,-
chr19,19030177,2.72839585704466,1019,604,1623,-
chr19,19030179,2.072481050696232,615,425,1040,-
chr19,19136338,0.7645493847688726,604,484,1088,-
chr19,19136339,0.7645493847688726,604,484,1088,-
chr19,19136340,0.7645493847688726,604,484,1088,-
chr19,19767809,1.301485168323523,630,478,1108,-
chr19,19767810,0.6970082364341086,676,515,1191,-
chr19,29698292,1.677750743444174,641,410,1051,-
chr19,29698464,2.450590832359434,1347,905,2252,-
chr19,29698531,1.5963473494764395,1164,763,1927,-
chr19,29698647,1.9587020648967552,829,564,1393,-
chr19,29698734,1.9457574140428453,2489,2017,4506,-
chr19,29698737,1.3190364950129971,2374,1877,4251,-
chr19,29698744,1.77580132285628,2237,1740,3977,-
chr19,29698765,1.5683076923076926,1698,1169,2867,-
chr19,29698771,1.6275151995742114,3309,1979,5288,-
chr19,29698777,1.8512155891457442,4383,2816,7199,-
chr19,29698778,1.8170658245931424,4133,2387,6520,-
chr19,29698799,1.618030759026106,2357,1367,3724,-
chr19,29698805,0.8829951959344108,1667,848,2515,-
chr19,29698807,0.8829951959344108,1667,848,2515,-
chr19,29698813,2.6465922444183314,1286,665,1951,-
chr19,29698815,2.6465922444183314,1286,665,1951,-
chr19,29698816,1.4601827119345296,1311,794,2105,-
chr19,29698988,0.8615830404216777,2934,2374,5308,-
chr19,29699048,1.4885271981888268,917,553,1470,-
chr19,29699053,1.6491433021806852,604,427,1031,-
chr19,29703813,1.5964755226950573,809,588,1397,-
chr19,33878023,1.531770934171254,601,446,1047,-
chr19,33980919,0.3551883765755881,720,608,1328,-
chr19,35990885,0.37282460721630273,1150,615,1765,-
chr19,35996865,0.5997425997425998,698,517,1215,-
chr19,35996866,2.275036694140228,649,520,1169,-
chr19,35996886,0.4864864864864865,593,428,1021,-
chr19,36001103,2.1001265738458463,1454,882,2336,-
chr19,36001104,2.1001265738458463,1454,882,2336,-
chr19,36001105,2.1001265738458463,1454,882,2336,-
chr19,36605082,0.6113161131611317,496,541,1037,-
chr19,36605300,2.4211834240042984,766,708,1474,-
chr19,36605301,2.5976549044814496,1094,935,2029,-
chr19,39306186,4.090236686390533,868,571,1439,-
chr19,39306588,2.0153800059922102,1008,588,1596,-
chr19,39306590,1.656264333315673,1790,1245,3035,-
chr19,39306591,1.257967867998263,782,657,1439,-
chr19,39321743,0.3685897435897435,574,519,1093,-
chr19,39321782,0.470084619213539,786,489,1275,-
chr19,39321981,2.329545947980845,3289,2944,6233,-
chr19,39321982,2.329545947980845,3289,2944,6233,-
chr19,39321991,2.9823586744639368,826,683,1509,-
chr19,39322011,1.679608535215787,721,541,1262,-
chr19,39322043,1.7652649769585256,680,495,1175,-
chr19,39322063,1.2872462993912803,1075,836,1911,-
chr19,39322389,1.32709171227006,591,522,1113,-
chr19,39322390,1.5620676938861997,815,670,1485,-
chr19,39322391,1.0127637010945727,763,676,1439,-
chr19,39327165,15.934767025422111,3789,3321,7110,-
chr19,39327166,19.55669291338583,1460,1396,2856,-
chr19,39327184,1.064297894082875,1194,921,2115,-
chr19,39327190,3.147851545681564,961,552,1513,-
chr19,39327205,1.8497536945812807,750,419,1169,-
chr19,39328043,2.1816362271703778,871,570,1441,-
chr19,39328247,2.01092084006462,758,618,1376,-
chr19,39329076,2.530667701863354,860,643,1503,-
chr19,39329079,2.29939393939394,812,549,1361,-
chr19,39329082,1.7888584271856711,2619,1487,4106,-
chr19,39329083,1.902167343061912,2097,1251,3348,-
chr19,39329085,1.8079070992059645,1358,792,2150,-
chr19,39329103,1.0115405017514376,1182,700,1882,-
chr19,39329114,1.763046940878853,1820,820,2640,-
chr19,39329115,1.763046940878853,1820,820,2640,-
chr19,39329116,1.6815230390150329,2353,1046,3399,-
chr19,39329118,1.6020850480109738,1122,485,1607,-
chr19,39329542,1.7386363636363638,611,543,1154,-
chr19,39329545,1.6949196813373382,926,493,1419,-
chr19,39329651,0.4345583494519665,673,516,1189,-
chr19,39330808,1.8502383571690502,741,504,1245,-
chr19,39330838,1.8007706579135148,700,538,1238,-
chr19,39330840,0.8835016835016835,655,494,1149,-
chr19,39330847,1.070782417824665,637,425,1062,-
chr19,39334701,1.5101871797933368,6311,4197,10508,-
chr19,39334702,1.529119425380224,3644,2713,6357,-
chr19,39334705,0.965009525966464,4483,2728,7211,-
chr19,39334712,1.6485895140814584,1408,918,2326,-
chr19,39334728,2.032272494887525,1616,977,2593,-
chr19,39336306,2.0689655172413794,1034,758,1792,-
chr19,39336313,1.907020872865275,1004,743,1747,-
chr19,39336355,1.089778282757571,2026,1496,3522,-
chr19,39336544,1.6483341304001276,879,696,1575,-
chr19,39336710,0.5883152173913043,865,551,1416,-
chr19,39338015,0.5174512987012987,424,615,1039,-
chr19,39338034,0.3114599686028257,495,909,1404,-
chr19,39338035,0.38716672258965695,835,1265,2100,-
chr19,39338052,0.289964192868004,562,1101,1663,-
chr19,39338053,0.289964192868004,562,1101,1663,-
chr19,39338061,0.18844480611518902,564,1306,1870,-
chr19,39338062,0.19425496729371025,577,1202,1779,-
chr19,39338065,0.34660748454304985,614,1316,1930,-
chr19,39338066,0.3772469252601702,329,905,1234,-
chr19,39338072,4.603902404142285,1174,1712,2886,-
chr19,39338073,4.603902404142285,1174,1712,2886,-
chr19,39340578,1.2179358313497808,585,532,1117,-
chr19,39880157,2.939695606142537,887,688,1575,-
chr19,39880159,2.443014705882353,1328,959,2287,-
chr19,39880160,2.4395966409986216,1504,1073,2577,-
chr19,39880161,3.8792556855938587,1872,1354,3226,-
chr19,39923928,1.4473725967433342,8205,5313,13518,-
chr19,39923961,1.3243223696988193,34445,23589,58034,-
chr19,39923962,1.3243223696988193,34445,23589,58034,-
chr19,39923964,0.7834761701632605,13468,10121,23589,-
chr19,39923965,1.1067314686575451,44867,31219,76086,-
chr19,39923966,1.2519829922909278,31399,21098,52497,-
chr19,39924012,1.4429873341978248,15989,12543,28532,-
chr19,39924309,1.203863308513727,7364,5536,12900,-
chr19,39924338,1.329290606458806,11661,9131,20792,-
chr19,39924353,1.266457468416372,10942,8878,19820,-
chr19,39924389,1.359357757953901,8762,7051,15813,-
chr19,39926253,1.3396879649838533,16472,11574,28046,-
chr19,39926274,1.2632515554767274,21608,17130,38738,-
chr19,39926275,1.2052743319123729,26573,20641,47214,-
chr19,39926277,1.2621076270074756,20349,16041,36390,-
chr19,39926348,0.46282102339281334,1118,796,1914,-
chr19,39926489,1.369901547116737,5356,4265,9621,-
chr19,39926551,0.96376171650445,8716,5763,14479,-
chr19,39926552,1.040372071340382,5100,3596,8696,-
chr19,39926555,1.3105332579611833,2079,1463,3542,-
chr19,39926557,1.348308675824522,5297,3774,9071,-
chr19,39926560,0.7042927320012415,3870,3770,7640,-
chr19,39926561,0.7042927320012415,3870,3770,7640,-
chr19,39926564,0.761943872446395,3184,2930,6114,-
chr19,39926579,0.5663492661233199,2070,2372,4442,-
chr19,39926580,0.5663492661233199,2070,2372,4442,-
chr19,39926585,1.4699916193926779,3554,2009,5563,-
chr19,39926587,1.283178936642486,5812,3796,9608,-
chr19,39926588,1.0191589517432214,1703,800,2503,-
chr19,40029875,13.938271502828728,1261,1329,2590,-
chr19,40029876,13.308028783014915,1411,1386,2797,-
chr19,40029877,13.889222785864565,1004,903,1907,-
chr19,40325191,3.047846889952153,636,436,1072,-
chr19,40325351,1.9667282809611832,683,540,1223,-
chr19,40325379,0.5417753695899391,622,452,1074,-
chr19,40325382,2.608472400513479,761,491,1252,-
chr19,40325399,0.5254029879387914,1257,955,2212,-
chr19,40325400,1.9297945205479448,587,437,1024,-
chr19,40327208,2.052030456852792,692,590,1282,-
chr19,40327219,3.3410138248847927,599,433,1032,-
chr19,40327246,2.191494779730074,661,461,1122,-
chr19,40328370,1.987616727444171,1309,1050,2359,-
chr19,40328379,0.5670449768810425,638,548,1186,-
chr19,40329688,0.563927507447865,648,423,1071,-
chr19,40329831,0.5132041927478795,865,550,1415,-
chr19,40330925,0.5183887915936952,702,570,1272,-
chr19,40331058,0.3041749502982107,543,502,1045,-
chr19,40331086,2.1005706068980183,2323,2949,5272,-
chr19,40331087,2.687590962475227,1413,1896,3309,-
chr19,40331100,0.41643197777026775,1108,1613,2721,-
chr19,40331102,0.41643197777026775,1108,1613,2721,-
chr19,40331105,0.7190979211571691,1391,2306,3697,-
chr19,40331106,1.1910084507443701,3181,4836,8017,-
chr19,40331107,0.8213998206325082,2206,3608,5814,-
chr19,40331108,1.1324270578395088,3515,4986,8501,-
chr19,40331109,1.2363939661555206,1580,2606,4186,-
chr19,40331111,1.2721741821949784,1373,1817,3190,-
chr19,40331144,0.32550626400606064,796,1198,1994,-
chr19,40331145,1.4040464902620557,1163,1775,2938,-
chr19,40331147,5.125785913216515,1605,2206,3811,-
chr19,40331149,9.490289322829002,1216,1786,3002,-
chr19,40331150,6.864916389983215,1172,1335,2507,-
chr19,40331263,5.255579785894575,1016,748,1764,-
chr19,40331338,8.236279186697013,1406,930,2336,-
chr19,40331339,8.52087576860703,1587,1012,2599,-
chr19,40331340,8.605898467435095,1245,763,2008,-
chr19,40331350,4.413270388994619,752,414,1166,-
chr19,40331351,4.7835480499942,1123,534,1657,-
chr19,40331352,5.018879370926324,993,461,1454,-
chr19,40331421,2.747663551401869,832,534,1366,-
chr19,40331422,2.747663551401869,832,534,1366,-
chr19,40331426,1.7926708723219358,625,468,1093,-
chr19,40336955,2.3179881243450926,705,408,1113,-
chr19,40336956,2.662764559635895,991,631,1622,-
chr19,40953805,2.457922178972203,1511,1327,2838,-
chr19,40953807,2.9116584564860424,571,608,1179,-
chr19,40953884,1.005306603773585,549,529,1078,-
chr19,40953886,1.4320112418320747,775,692,1467,-
chr19,46112751,6.51250760542321,1402,1852,3254,-
chr19,46112757,5.17523247868402,2754,3140,5894,-
chr19,46112758,5.17523247868402,2754,3140,5894,-
chr19,46112795,21.638008953082387,4146,2114,6260,-
chr19,46112796,24.1105273893653,5527,2273,7800,-
chr19,46112797,24.38542029990955,6558,2389,8947,-
chr19,46112798,43.91959378860863,6200,1511,7711,-
chr19,46112799,21.267430897556928,5156,622,5778,-
chr19,46112800,14.780518044647287,4674,510,5184,-
chr19,46112801,17.306650562478637,4566,465,5031,-
chr19,46112802,29.87049944846615,2572,251,2823,-
chr19,46112908,2.8868655927292592,931,665,1596,-
chr19,46116874,0.4061398389286626,809,772,1581,-
chr19,46116905,2.344771241830065,559,543,1102,-
chr19,46116907,6.630447021718941,1214,1137,2351,-
chr19,46116910,14.653647442984026,1607,1201,2808,-
chr19,46116911,13.729001203369435,1096,830,1926,-
chr19,46116912,15.026214094454243,2164,1609,3773,-
chr19,46116913,11.922599337748343,822,603,1425,-
chr19,46119133,2.0137871471207314,734,554,1288,-
chr19,46122400,3.102535248993294,647,502,1149,-
chr19,46124889,5.442206280185494,792,916,1708,-
chr19,46124890,5.270827027917364,902,911,1813,-
chr19,46127981,13.374560560273231,752,552,1304,-
chr19,46127999,2.231245428274163,779,444,1223,-
chr19,46137710,0.34133280825273027,604,508,1112,-
chr19,46190875,1.821450335161487,1371,1093,2464,-
chr19,46190896,1.3822747395575612,2554,1530,4084,-
chr19,46190917,1.413821138211382,1738,1434,3172,-
chr19,46190977,1.674832363360324,1680,1215,2895,-
chr19,46191753,1.733169308237635,4653,3136,7789,-
chr19,46191757,1.4122631089408209,1494,1127,2621,-
chr19,46191761,2.389253279515641,1352,990,2342,-
chr19,46195172,1.5888067297329664,1494,1192,2686,-
chr19,46195179,1.49478390461997,1002,670,1672,-
chr19,46195180,1.642127143599515,1263,1003,2266,-
chr19,46195191,0.8978732257254113,1034,837,1871,-
chr19,46195199,1.069743390860319,661,572,1233,-
chr19,46195201,1.4920674407501142,974,775,1749,-
chr19,47236354,3.5205724508050085,737,558,1295,-
chr19,47236359,2.8421052631578947,701,512,1213,-
chr19,47236363,0.2790896646132785,698,486,1184,-
chr19,47236369,1.7325929064926293,1220,701,1921,-
chr19,47278239,1.7543859649122808,649,626,1275,-
chr19,47278242,2.2635563380281694,896,709,1605,-
chr19,47278245,0.9778726708074534,915,895,1810,-
chr19,47278246,0.8574315333668661,1697,1505,3202,-
chr19,47278266,1.8628296428174027,1134,835,1969,-
chr19,47278267,1.8628296428174027,1134,835,1969,-
chr19,47278428,1.775381850853549,683,476,1159,-
chr19,47278431,1.4669302659956864,741,427,1168,-
chr19,47278432,2.546463245492372,611,411,1022,-
chr19,47278451,1.9387253820456554,1013,629,1642,-
chr19,47278529,1.5945409429280397,755,619,1374,-
chr19,47278559,2.31859756097561,844,655,1499,-
chr19,47278699,1.8562116937445279,635,540,1175,-
chr19,47278778,0.5029201817001947,774,602,1376,-
chr19,47278827,1.2462810423624557,1043,774,1817,-
chr19,47280255,1.7781291172595524,722,494,1216,-
chr19,47280258,0.596652719665272,712,477,1189,-
chr19,47280297,1.8292908720607293,759,490,1249,-
chr19,47280519,1.4612914786130091,1423,1220,2643,-
chr19,47280522,1.7554421768707482,793,419,1212,-
chr19,47280524,2.284026845637584,708,595,1303,-
chr19,47280563,2.2549407114624507,651,505,1156,-
chr19,47280638,2.698398169336384,736,436,1172,-
chr19,47282015,1.9951373788183198,1007,881,1888,-
chr19,47282075,1.8800813008130082,874,614,1488,-
chr19,47282101,2.668273741594664,2272,1691,3963,-
chr19,47282117,2.12216404886562,767,572,1339,-
chr19,47285657,1.4624593158228254,2656,1665,4321,-
chr19,47285662,1.5044726930320151,1161,707,1868,-
chr19,47285671,0.5287532344088293,1053,652,1705,-
chr19,47285677,0.5120560020741509,789,550,1339,-
chr19,47285699,1.9844404548174746,828,556,1384,-
chr19,47285705,3.364615384615385,647,519,1166,-
chr19,47285723,1.7394796016704144,721,565,1286,-
chr19,47285778,2.924654630709056,6386,5017,11403,-
chr19,47285779,2.924654630709056,6386,5017,11403,-
chr19,47285780,2.78411009032588,3995,3011,7006,-
chr19,47290678,1.7215927913602331,811,558,1369,-
chr19,47290693,1.8420753665474165,1313,892,2205,-
chr19,47290703,0.46862491808039025,1130,731,1861,-
chr19,47290704,1.736676292990286,629,585,1214,-
chr19,47290706,1.736676292990286,629,585,1214,-
chr19,47290959,1.6921992221787685,781,706,1487,-
chr19,47290960,2.2879841112214496,575,476,1051,-
chr19,47290991,7.891110137310164,1931,1389,3320,-
chr19,47290992,7.901269755798034,1940,1317,3257,-
chr19,47290993,8.323928262168314,1700,1097,2797,-
chr19,47291339,1.532022717343818,796,653,1449,-
chr19,47291367,1.886590584878745,1057,700,1757,-
chr19,47291405,1.7926853508248854,621,558,1179,-
chr19,47291410,1.5289772727272728,896,559,1455,-
chr19,47291412,0.66456685102056,811,660,1471,-
chr19,47291413,1.7018878557340096,603,506,1109,-
chr19,47291439,1.2219619220477032,1413,949,2362,-
chr19,47291478,2.025052503204819,1221,800,2021,-
chr19,47291517,2.116993363173329,1015,681,1696,-
chr19,47291519,2.116993363173329,1015,681,1696,-
chr19,47291530,1.2208924441835765,879,598,1477,-
chr19,47291812,3.781669463087249,948,297,1245,-
chr19,47291814,3.688282962666983,1180,423,1603,-
chr19,47291840,5.540289056630999,768,312,1080,-
chr19,47291847,10.178289760348582,776,304,1080,-
chr19,47333885,0.7589204882464958,852,621,1473,-
chr19,47333888,0.7267878605769231,674,511,1185,-
chr19,47333891,2.2323474806121415,722,537,1259,-
chr19,47341646,3.265898251192369,746,443,1189,-
chr19,47341647,3.265898251192369,746,443,1189,-
chr19,47341657,1.0244042492104506,891,485,1376,-
chr19,47341659,1.7722222222222224,835,455,1290,-
chr19,47342821,1.6968137254901965,988,839,1827,-
chr19,47354027,7.443143274214403,1931,1280,3211,-
chr19,47354028,7.146691202166137,3211,2388,5599,-
chr19,47354029,7.146691202166137,3211,2388,5599,-
chr19,47354030,8.472384665367121,662,512,1174,-
chr19,47354089,2.469275957229652,817,565,1382,-
chr19,47995341,3.2419041201386216,609,398,1007,-
chr19,48626257,5.882384269904044,740,570,1310,-
chr19,48885924,12.834815815674459,2572,2243,4815,-
chr19,48885925,12.92455553067873,3126,2603,5729,-
chr19,48885926,12.92455553067873,3126,2603,5729,-
chr19,48886453,2.104622871046229,864,821,1685,-
chr19,48886454,2.104622871046229,864,821,1685,-
chr19,48886530,1.5613474089973278,937,616,1553,-
chr19,48886532,2.654887218045113,962,629,1591,-
chr19,48886568,1.696236559139785,630,495,1125,-
chr19,48887635,2.526219746446408,906,547,1453,-
chr19,48887637,2.526219746446408,906,547,1453,-
chr19,48892919,0.30939925265881,597,496,1093,-
chr19,48892930,4.794457274826789,691,432,1123,-
chr19,48892958,2.012179487179487,1386,779,2165,-
chr19,48892960,2.012179487179487,1386,779,2165,-
chr19,48893702,0.5598921832884097,576,529,1105,-
chr19,48893778,2.088311811172604,900,728,1628,-
chr19,48893779,0.444635357006491,821,581,1402,-
chr19,48893780,1.153677623384587,2081,1667,3748,-
chr19,49118637,1.0761586569246067,8528,6634,15162,-
chr19,49118638,0.7948445383081074,6390,4734,11124,-
chr19,49118677,1.294928173556142,2523,2273,4796,-
chr19,49118678,1.3318485675239886,5422,4314,9736,-
chr19,49119137,1.5760176912870412,3650,2124,5774,-
chr19,49119392,1.3990568818155025,3837,2261,6098,-
chr19,49119400,1.4896991174078835,5431,3918,9349,-
chr19,49119401,1.4896991174078835,5431,3918,9349,-
chr19,49120050,1.3261011244297418,3302,2818,6120,-
chr19,49120051,0.7927674278296799,3211,2635,5846,-
chr19,49120073,1.4995570321151717,7385,5804,13189,-
chr19,49120074,1.556663635521329,11100,8738,19838,-
chr19,49120678,1.3588298871546605,19322,14398,33720,-
chr19,49120680,1.012122598055544,6388,5263,11651,-
chr19,49121049,0.801293751008803,5866,4238,10104,-
chr19,49121066,1.324544829423526,9784,6452,16236,-
chr19,49121069,1.3161955911026026,9034,5916,14950,-
chr19,49121072,1.2754357821210662,8854,5088,13942,-
chr19,49121074,1.318599236186092,15845,10709,26554,-
chr19,49121075,1.2887184056777194,3500,2488,5988,-
chr19,49121082,1.3123265953230283,2966,2522,5488,-
chr19,49121115,1.3971217338824198,2478,2011,4489,-
chr19,49121117,1.6976911976911977,2352,1979,4331,-
chr19,49122404,1.4771296207138596,3597,2338,5935,-
chr19,49122408,1.711084472930988,1248,996,2244,-
chr19,49122412,1.6764117151285294,1674,1016,2690,-
chr19,49122416,1.5507914245642154,1031,712,1743,-
chr19,49122422,1.609404221212931,1254,984,2238,-
chr19,49122424,1.609404221212931,1254,984,2238,-
chr19,49122426,0.5490163711889628,1344,970,2314,-
chr19,49122429,1.4414545832968981,3009,1848,4857,-
chr19,49122430,1.538879835572194,2673,1424,4097,-
chr19,49122432,1.38330022728901,3094,1756,4850,-
chr19,49122433,1.3238463780069865,1364,861,2225,-
chr19,49122434,1.0707569373485952,927,540,1467,-
chr19,49950302,0.4767635309077505,1285,772,2057,-
chr19,49951106,0.2815622553313848,533,522,1055,-
chr19,51301710,3.1603960396039605,797,403,1200,-
chr19,51301711,3.1603960396039605,797,403,1200,-
chr19,51301712,3.1603960396039605,797,403,1200,-
chr19,51848469,0.3365420214735283,605,437,1042,-
chr19,51850184,1.7635648754914808,840,762,1602,-
chr19,51850187,1.7210285714285711,813,699,1512,-
chr19,51850190,2.4794142980189493,777,644,1421,-
chr19,51850256,2.6654985639358375,2404,1704,4108,-
chr19,51850275,2.694877505567929,846,448,1294,-
chr19,51856410,2.9942455242966752,668,390,1058,-
chr19,51856416,1.7227979274611398,664,385,1049,-
chr19,51856422,2.0683512540247517,1323,976,2299,-
chr19,51856424,2.0166215693853884,845,596,1441,-
chr19,51856478,1.4111884899054663,829,628,1457,-
chr19,51857456,1.7757376020087883,729,471,1200,-
chr19,51857557,0.3649261603375527,813,631,1444,-
chr19,51869598,0.6064003286152895,1555,1215,2770,-
chr19,51869599,0.6038098375054897,646,593,1239,-
chr19,55876993,14.123819129445437,815,1155,1970,-
chr19,55877002,6.3096434657628935,1608,1669,3277,-
chr19,55877003,6.3096434657628935,1608,1669,3277,-
chr19,55877009,10.52360410527575,1316,839,2155,-
chr19,55877010,10.523604105275748,1316,839,2155,-
chr19,55912947,1.3636349175636497,1142,919,2061,-
chr19,55912949,1.0431468422537213,1188,972,2160,-
chr19,55913018,1.6430124650405986,908,586,1494,-
chr19,55918997,1.916436638531479,756,586,1342,-
chr19,55919006,2.4034988950990948,638,571,1209,-
chr19,55919150,0.48036724335775877,1731,711,2442,-
chr19,55919154,1.0103092783505154,979,391,1370,-
chr19,55919155,1.0103092783505154,979,391,1370,-
chr19,59063034,1.942640418868926,989,846,1835,-
chr19,59063097,0.5847322456107179,908,705,1613,-
chr19,59063548,1.9057750759878422,879,751,1630,-
chr19,59063666,1.6796536796536798,775,659,1434,-
chr19,59063708,1.6941258783685063,1707,1272,2979,-
chr19,59063729,1.7256127886323267,758,562,1320,-
chr19,59063745,0.5202822580645161,758,619,1377,-
chr19,59063750,1.630273390529879,1429,928,2357,-
chr19,59065424,0.1395348837209302,683,515,1198,-
chr19,59065454,1.3543706569174823,2117,1375,3492,-
chr19,59065456,1.1880173841059605,1601,905,2506,-
chr19,59065469,1.5004214515984773,908,808,1716,-
chr19,59067233,0.41841442953020125,664,595,1259,-
chr19,59067235,0.41841442953020125,664,595,1259,-
chr19,59067292,0.5058249527033755,634,912,1546,-
chr19,59067294,0.5058249527033755,634,912,1546,-
chr19,59067295,0.1543306629513526,408,1187,1595,-
chr19,59067297,0.1543306629513526,408,1187,1595,-
chr19,59067352,11.075627337318368,2051,2843,4894,-
chr19,59067353,12.327077649319845,2405,2937,5342,-
chr19,59067354,12.327077649319845,2405,2937,5342,-
chr19,59067355,17.618951071631624,1102,706,1808,-
chr19,59067368,34.14906410004744,952,182,1134,-
chr19,59067710,0.45770975056689334,733,419,1152,-
chr19,59067721,2.746031746031746,691,395,1086,-
chr19,59068457,2.7707830286305626,594,445,1039,-
chr19,59068523,1.4404126370547068,796,517,1313,-
chr20,472907,2.135877992851984,626,491,1117,-
chr20,627378,2.21123595505618,614,444,1058,-
chr20,627616,0.7834476090014064,774,631,1405,-
chr20,627618,0.7834476090014064,774,631,1405,-
chr20,627831,5.248193626826845,721,469,1190,-
chr20,627944,2.2262996941896023,883,653,1536,-
chr20,627945,2.2262996941896023,883,653,1536,-
chr20,628856,2.1432472351476517,689,507,1196,-
chr20,629144,2.2601018090352825,1233,813,2046,-
chr20,629149,1.9881944444444444,1226,719,1945,-
chr20,629150,2.593275972093449,1780,1075,2855,-
chr20,1350308,1.3888812511761142,765,530,1295,-
chr20,1350367,6.7655472482692245,804,509,1313,-
chr20,1350477,3.262037037037037,541,479,1020,-
chr20,1350479,3.262037037037037,541,479,1020,-
chr20,1356150,2.066729944735985,610,498,1108,-
chr20,1356187,2.4178741344692534,696,431,1127,-
chr20,2442392,1.4014153203179158,2476,1858,4334,-
chr20,2442505,0.693621867881549,1014,877,1891,-
chr20,2442553,1.613807245386193,786,664,1450,-
chr20,2442577,1.9878107846302877,984,651,1635,-
chr20,2442583,2.3205266539721205,2137,1600,3737,-
chr20,2443680,0.9745465250342077,2994,1967,4961,-
chr20,2443761,3.3676684187191546,1020,715,1735,-
chr20,2443762,1.5900114578418818,760,400,1160,-
chr20,2443858,0.6225660472494398,2008,1256,3264,-
chr20,2443861,1.6442437055544876,589,472,1061,-
chr20,2443869,1.2670095597821542,1759,1101,2860,-
chr20,2444443,2.2538213315217392,982,511,1493,-
chr20,2444474,1.5356684263090312,1132,651,1783,-
chr20,2448277,1.6881220968812207,1695,1506,3201,-
chr20,2448375,2.1213640320196063,2563,2123,4686,-
chr20,2448388,1.548733900895001,1923,1017,2940,-
chr20,2451347,1.3594646730597075,4671,3290,7961,-
chr20,2451356,1.118872911651347,2313,1946,4259,-
chr20,2451397,2.9047706039281787,6401,4353,10754,-
chr20,2451398,2.9681531181416063,5648,3859,9507,-
chr20,2451411,1.568892589633768,3768,2219,5987,-
chr20,2451412,1.4831143139748482,1311,1010,2321,-
chr20,2451413,1.4898269645319369,1855,862,2717,-
chr20,2451432,1.452875911188072,1199,653,1852,-
chr20,2451433,1.970323001465635,739,350,1089,-
chr20,2451434,1.090506399305125,931,484,1415,-
chr20,2640994,4.063028091260798,688,498,1186,-
chr20,2644162,1.4490901340051674,584,432,1016,-
chr20,3128634,2.931500644253778,607,430,1037,-
chr20,3128636,0.2885707441385014,757,485,1242,-
chr20,5080876,1.4235857870906627,615,472,1087,-
chr20,5081009,1.8690206824489608,1473,1497,2970,-
chr20,5081011,1.3966192468619243,1158,1194,2352,-
chr20,5081012,1.1470588235294117,758,758,1516,-
chr20,5081090,0.3814088598402324,605,404,1009,-
chr20,5095751,1.5147058823529411,1132,835,1967,-
chr20,5095953,1.4219919401266552,1728,1157,2885,-
chr20,5095995,1.507744235761538,5297,3396,8693,-
chr20,5098169,1.8436795135824264,1174,926,2100,-
chr20,5098289,1.338304503467094,2250,1857,4107,-
chr20,5099454,1.745364561550258,1021,796,1817,-
chr20,5099498,1.8275467568643056,992,717,1709,-
chr20,5100340,1.3287539314184567,2108,1485,3593,-
chr20,5100356,1.546440411305276,833,480,1313,-
chr20,5100506,2.7907621247113163,1006,432,1438,-
chr20,5100601,0.937486168347417,5625,2227,7852,-
chr20,5100603,0.9499137176946709,11974,4679,16653,-
chr20,5921725,2.922642213694571,988,743,1731,-
chr20,5921727,2.506475243908564,1492,1020,2512,-
chr20,5921742,13.566629729533503,774,450,1224,-
chr20,13695724,3.023400200010051,932,621,1553,-
chr20,13695727,2.5277838982171916,1607,1038,2645,-
chr20,13695728,2.616498693542366,1347,892,2239,-
chr20,13695730,2.0784991248506177,1296,822,2118,-
chr20,13695733,3.6229103878668676,1549,908,2457,-
chr20,13695734,3.1136027930710357,1178,676,1854,-
chr20,13695735,2.8948895901195537,1714,1000,2714,-
chr20,13698156,1.711360451269773,1178,857,2035,-
chr20,13699558,1.0047579085757605,1252,823,2075,-
chr20,17599259,1.3914229550286836,1507,1186,2693,-
chr20,17599262,1.549413164316015,4393,3410,7803,-
chr20,17599265,1.4688345340469753,2599,1984,4583,-
chr20,17599271,1.801480755430312,3811,3006,6817,-
chr20,17599272,1.801480755430312,3811,3006,6817,-
chr20,17599273,1.85275885395841,4977,3841,8818,-
chr20,17599275,1.7733161871982597,4716,3441,8157,-
chr20,17599277,1.7321109737673397,2292,1617,3909,-
chr20,17599288,0.9821083809699119,1175,799,1974,-
chr20,17599292,1.7811904915047256,963,639,1602,-
chr20,17599293,0.43958048335613326,722,458,1180,-
chr20,17600300,1.9084012504065628,1084,591,1675,-
chr20,17600302,2.3188054882970137,662,412,1074,-
chr20,17600986,1.6242300866478756,840,617,1457,-
chr20,17601001,1.1214143965361718,1007,722,1729,-
chr20,17601002,0.8948659690743899,1561,1113,2674,-
chr20,17923010,2.021212121212121,666,494,1160,-
chr20,17936028,2.8197498407483046,698,469,1167,-
chr20,21146846,1.6763208365324556,569,457,1026,-
chr20,21146856,0.8401907095162606,1626,1027,2653,-
chr20,21146857,0.8401907095162606,1626,1027,2653,-
chr20,23614423,0.5419585129310345,618,463,1081,-
chr20,23614575,2.519131657035764,1612,1010,2622,-
chr20,23614576,2.2660034898293833,2344,1577,3921,-
chr20,23614610,1.4102147039687702,866,637,1503,-
chr20,23615946,1.3547143547651026,1342,994,2336,-
chr20,23615984,1.4655779810081047,2471,1900,4371,-
chr20,23615985,1.7757833575430586,1955,1463,3418,-
chr20,23615987,1.8581525241675618,1290,949,2239,-
chr20,23615990,3.268353174603175,598,431,1029,-
chr20,23618260,2.450319724545007,737,427,1164,-
chr20,23618261,0.5019752771759909,605,412,1017,-
chr20,23618299,1.8772963604852686,676,576,1252,-
chr20,23618552,1.676806121819798,854,721,1575,-
chr20,24943672,1.4526280921608026,677,486,1163,-
chr20,24943712,0.4915132596065132,717,631,1348,-
chr20,31960453,1.179065436407989,3390,2289,5679,-
chr20,31960455,1.4235370283788682,2311,1636,3947,-
chr20,31960462,0.6114942528735633,797,521,1318,-
chr20,31960499,1.986849334498016,611,395,1006,-
chr20,32263749,17.28985180885054,1533,1227,2760,-
chr20,32263750,23.36929382824666,1071,871,1942,-
chr20,32263794,12.935633632408317,2174,1419,3593,-
chr20,32263795,12.935633632408317,2174,1419,3593,-
chr20,32263912,13.598082813474548,2020,1242,3262,-
chr20,32263913,14.083365905891172,1870,1034,2904,-
chr20,32263914,14.82437072625927,1774,1013,2787,-
chr20,32264081,1.8505537893549375,1621,1591,3212,-
chr20,32264083,1.717738454898576,2387,2316,4703,-
chr20,32264085,1.744319989094379,1550,1491,3041,-
chr20,32264092,0.6191171697500811,544,473,1017,-
chr20,32264117,1.8331025729779622,774,641,1415,-
chr20,32264118,1.8331025729779622,774,641,1415,-
chr20,32264120,1.1381434760479436,830,621,1451,-
chr20,32264121,1.410910557628315,635,421,1056,-
chr20,32264263,2.592500309536191,763,519,1282,-
chr20,32264264,3.233148638882197,681,505,1186,-
chr20,32265277,0.3304794520547945,578,437,1015,-
chr20,32265278,0.3304794520547945,578,437,1015,-
chr20,32265279,0.3304794520547945,578,437,1015,-
chr20,32677336,1.508400758072746,1504,1075,2579,-
chr20,32677439,0.7220233230110399,2239,1748,3987,-
chr20,32677440,2.6285948850631904,2545,1545,4090,-
chr20,32681533,2.002364315114387,2112,1684,3796,-
chr20,32684501,0.6991343007874262,1594,1193,2787,-
chr20,32684508,1.7911557041991824,1204,758,1962,-
chr20,32684522,1.595641373080397,1086,647,1733,-
chr20,32684535,1.7414442013129101,828,456,1284,-
chr20,32686341,1.8523115977884383,2968,2161,5129,-
chr20,32686366,1.9773261065943997,1651,983,2634,-
chr20,32686403,1.8413078766329132,1161,760,1921,-
chr20,32686412,1.4793402606431347,1922,1093,3015,-
chr20,32686413,1.3333333333333333,1105,631,1736,-
chr20,32686415,1.3333333333333333,1105,631,1736,-
chr20,32693310,1.805811138014528,1016,707,1723,-
chr20,32693313,0.8794559256286785,1782,1245,3027,-
chr20,32693314,0.8794559256286785,1782,1245,3027,-
chr20,32693321,0.4815857956555416,1476,1121,2597,-
chr20,32693338,4.4351015801354405,812,442,1254,-
chr20,32693339,3.9844574652360922,1260,721,1981,-
chr20,32693342,1.7625661144297,1372,912,2284,-
chr20,32693343,1.1547910636086989,840,498,1338,-
chr20,32699903,2.5639695300537113,649,365,1014,-
chr20,32700019,0.660212631024307,1101,618,1719,-
chr20,32868198,1.6366559485530547,1526,932,2458,-
chr20,32868479,0.5652387723030542,1428,1126,2554,-
chr20,32868503,1.4360664619830237,1115,790,1905,-
chr20,32868568,1.5245726495726497,1426,935,2361,-
chr20,32868649,2.0648301429306084,2035,1464,3499,-
chr20,32868775,1.5041831792162044,975,756,1731,-
chr20,32868852,1.4758015111292628,1605,829,2434,-
chr20,32868894,0.7090114942528735,2202,1739,3941,-
chr20,32868895,0.6166181565135687,6249,4382,10631,-
chr20,32868933,2.5346862704493685,1529,877,2406,-
chr20,32873306,1.403459452290718,2331,1579,3910,-
chr20,32873325,1.8510004257130688,1086,782,1868,-
chr20,32873338,1.6750225494518225,2411,1615,4026,-
chr20,32873342,1.796314791627129,2124,1305,3429,-
chr20,32878241,1.7814781021897812,3904,2739,6643,-
chr20,32878243,1.7814781021897812,3904,2739,6643,-
chr20,32878395,1.3671028466483013,1580,967,2547,-
chr20,32878574,2.0799779371207943,1256,734,1990,-
chr20,32878586,2.155414934091101,2088,1395,3483,-
chr20,32879297,1.547588561673069,961,780,1741,-
chr20,32880184,1.8515742128935533,740,666,1406,-
chr20,32880187,0.6556928034371644,841,664,1505,-
chr20,32880189,1.6241094328868622,694,604,1298,-
chr20,32880268,0.575499533146592,810,594,1404,-
chr20,32883226,2.327315084449621,665,504,1169,-
chr20,32883227,0.3084458750262402,550,460,1010,-
chr20,32883229,1.9568244515479265,930,556,1486,-
chr20,32883253,0.5949375678610207,796,613,1409,-
chr20,32883336,2.3293032786885246,841,487,1328,-
chr20,32883351,2.159877800407332,908,490,1398,-
chr20,32891053,1.5579569931729402,1122,636,1758,-
chr20,32891057,1.5852017937219733,908,668,1576,-
chr20,32891099,2.014480408858603,945,586,1531,-
chr20,32891108,1.3036760857367982,1106,950,2056,-
chr20,32891139,2.5287572097548683,563,608,1171,-
chr20,32891148,2.016096230754449,859,563,1422,-
chr20,32891149,2.016096230754449,859,563,1422,-
chr20,33516283,12.97883363885259,2167,1650,3817,-
chr20,33516284,12.978833638852592,2167,1650,3817,-
chr20,33516285,13.972928614519038,1614,1219,2833,-
chr20,33517353,1.8301531601150285,11027,8179,19206,-
chr20,33517354,1.8301531601150285,11027,8179,19206,-
chr20,33517355,1.533264656410246,14894,10929,25823,-
chr20,33517371,1.3866893028522214,8537,5105,13642,-
chr20,33517372,1.0566317873303168,6709,3739,10448,-
chr20,33517374,1.0314294255946421,6637,3811,10448,-
chr20,33517383,1.4547842845914487,1986,1118,3104,-
chr20,33517384,1.53509521368495,3089,1745,4834,-
chr20,33517385,1.4354055716338507,4911,3084,7995,-
chr20,33517389,1.532127307678505,2774,1669,4443,-
chr20,33517390,1.457407077806248,3002,1804,4806,-
chr20,33517392,1.7386290325574663,2158,1400,3558,-
chr20,33519157,0.5565934065934066,1012,493,1505,-
chr20,33519159,2.0457671957671955,702,377,1079,-
chr20,33519160,0.6438503098681073,852,433,1285,-
chr20,33519170,1.7817639845108149,1740,1224,2964,-
chr20,33519171,2.175324675324675,1339,951,2290,-
chr20,33519175,2.722554144884242,633,411,1044,-
chr20,33523423,2.468290542023261,911,650,1561,-
chr20,33523433,2.1124814879068716,1730,1127,2857,-
chr20,33524811,1.8381330377937066,1519,1137,2656,-
chr20,33529608,1.507785967862878,1018,834,1852,-
chr20,33529609,0.9984406925475856,598,546,1144,-
chr20,33530349,0.4330714785719841,695,597,1292,-
chr20,33530351,0.43669730973885457,1096,859,1955,-
chr20,33530396,2.2850090462651846,3134,2649,5783,-
chr20,33530401,1.9160574916166304,2979,2350,5329,-
chr20,33530410,1.646881588879923,2608,1873,4481,-
chr20,33530413,0.6839245044760638,1010,726,1736,-
chr20,33530749,2.0063626723223758,1375,735,2110,-
chr20,33530753,2.0356235843228774,1261,856,2117,-
chr20,33530758,1.6317108360543702,1263,1012,2275,-
chr20,33530773,1.6340244550770866,903,626,1529,-
chr20,33530797,1.5352044837551448,898,600,1498,-
chr20,33530801,2.148216216216216,640,369,1009,-
chr20,33543558,1.8161471438949277,614,456,1070,-
chr20,33543559,1.8161471438949277,614,456,1070,-
chr20,33590670,1.600601899823212,729,473,1202,-
chr20,33591036,3.0823789969606232,683,613,1296,-
chr20,33594323,1.7137908600969851,747,525,1272,-
chr20,33609059,1.8860312059473323,700,497,1197,-
chr20,33632513,2.7594339622641506,584,423,1007,-
chr20,33657123,1.8059360730593603,564,437,1001,-
chr20,33866899,1.6939391811222697,803,490,1293,-
chr20,33867422,0.5686192175799566,624,432,1056,-
chr20,33867423,1.699467217570947,520,540,1060,-
chr20,33867425,1.558302656452094,894,528,1422,-
chr20,33867521,2.067304015296367,900,522,1422,-
chr20,33867910,0.6996774193548387,1445,991,2436,-
chr20,33867912,1.5325706645303463,1730,1345,3075,-
chr20,33868577,1.668370317655431,920,532,1452,-
chr20,33872018,2.1973938223938223,784,517,1301,-
chr20,33872197,0.4468798751950078,673,640,1313,-
chr20,33872267,2.0263287401574805,609,507,1116,-
chr20,33872564,0.5862968109203648,1250,1001,2251,-
chr20,33969814,1.802251565575237,609,426,1035,-
chr20,34214100,2.756602031394275,648,360,1008,-
chr20,34214101,2.756602031394275,648,360,1008,-
chr20,34214516,1.1040941881952135,1154,681,1835,-
chr20,34214517,4.979913549061506,764,559,1323,-
chr20,34214720,2.5118563957715647,769,579,1348,-
chr20,34218390,1.3939511805936784,1301,1131,2432,-
chr20,34218391,0.8101546577149022,900,877,1777,-
chr20,34218392,0.8101546577149022,900,877,1777,-
chr20,34218886,4.159663865546218,593,475,1068,-
chr20,34218887,2.7930385365530146,971,691,1662,-
chr20,34219084,2.901857050313107,1053,841,1894,-
chr20,34219085,2.901857050313107,1053,841,1894,-
chr20,34219458,1.2670098693738125,945,716,1661,-
chr20,34220811,2.87084932421158,554,460,1014,-
chr20,34220812,2.87084932421158,554,460,1014,-
chr20,34252705,4.6963218588860745,1356,1434,2790,-
chr20,34252706,4.587971698113208,793,847,1640,-
chr20,34252708,3.69970443188032,715,742,1457,-
chr20,34252711,5.163646411512829,1976,1611,3587,-
chr20,34252712,5.163646411512831,1976,1611,3587,-
chr20,34252721,2.622859891466858,1083,708,1791,-
chr20,34252722,2.6677172408669776,1787,1039,2826,-
chr20,34252723,2.7647447668013223,648,388,1036,-
chr20,34252724,3.075307472355443,864,491,1355,-
chr20,34260715,2.6037735849056607,643,476,1119,-
chr20,34260716,2.6037735849056607,643,476,1119,-
chr20,34268781,1.8396490419432283,617,480,1097,-
chr20,34269878,1.9465511645904583,986,976,1962,-
chr20,34269879,1.8646423285010645,1536,1323,2859,-
chr20,34269886,2.1692340156151086,770,676,1446,-
chr20,34269887,2.5113997113997115,1144,989,2133,-
chr20,34269889,2.8180983976847607,1108,913,2021,-
chr20,34269891,3.3368781542898343,725,583,1308,-
chr20,34292110,2.0767076175281036,731,576,1307,-
chr20,34292221,2.8755186721991697,769,481,1250,-
chr20,34292222,2.8755186721991697,769,481,1250,-
chr20,34292392,2.382960413080895,638,497,1135,-
chr20,34292447,0.4737025253529528,732,427,1159,-
chr20,34295106,2.4055284191829487,698,562,1260,-
chr20,34295118,0.47409200968523,622,412,1034,-
chr20,34302228,1.9229946524064168,743,560,1303,-
chr20,34302237,1.899159663865546,677,424,1101,-
chr20,34309697,1.6588477366255143,1528,971,2499,-
chr20,34309698,1.6588477366255143,1528,971,2499,-
chr20,34309765,0.6249968797583685,962,678,1640,-
chr20,34312965,1.602786401150905,1322,842,2164,-
chr20,34317436,2.271053883524634,1304,985,2289,-
chr20,34317437,0.5002392344497607,737,626,1363,-
chr20,34319935,1.6567830827102725,10425,8176,18601,-
chr20,34319938,1.628215300174826,9480,5441,14921,-
chr20,34319939,1.8161726081541272,14278,9757,24035,-
chr20,34319947,1.8318588738717465,8237,6792,15029,-
chr20,34319948,1.5869253177838398,15029,11473,26502,-
chr20,34319960,1.6264786670722946,3099,2290,5389,-
chr20,34319962,1.5668178501854066,2814,1460,4274,-
chr20,34319964,1.4302458711394797,5475,3863,9338,-
chr20,34319965,1.5035495531968883,12705,8275,20980,-
chr20,34319968,1.2473209808843604,10735,6498,17233,-
chr20,34319969,1.313825308280223,15297,9416,24713,-
chr20,34319971,1.6467427165263695,5770,3841,9611,-
chr20,34326932,1.6905138339920946,610,505,1115,-
chr20,34328797,0.7139478957915831,757,498,1255,-
chr20,34328798,0.4310077519379845,555,472,1027,-
chr20,34330060,0.7787756221292932,567,502,1069,-
chr20,34330062,0.7787756221292932,567,502,1069,-
chr20,34541810,0.8451343500363108,664,485,1149,-
chr20,34541812,0.8451343500363108,664,485,1149,-
chr20,34541822,1.574274032688232,899,583,1482,-
chr20,34541823,1.366778505618576,801,568,1369,-
chr20,34633668,1.5320380854348945,1322,937,2259,-
chr20,34633699,2.174610591900312,606,427,1033,-
chr20,34633904,2.7056220718375847,692,451,1143,-
chr20,34633936,2.791208791208791,634,384,1018,-
chr20,34634343,1.598956824108954,889,594,1483,-
chr20,34634461,4.941421143847488,593,576,1169,-
chr20,34634463,8.096509098476634,1772,1440,3212,-
chr20,34634468,5.088307637941754,1871,1120,2991,-
chr20,34634469,5.885445372255866,1745,964,2709,-
chr20,34634475,5.356686257915973,705,373,1078,-
chr20,34634743,1.8251346105546564,1142,1131,2273,-
chr20,34634745,1.595688048975246,544,577,1121,-
chr20,34634752,4.599598331773211,1610,1360,2970,-
chr20,34634753,2.0839523233719124,935,826,1761,-
chr20,34634754,3.0687094522736102,1607,1159,2766,-
chr20,34634755,2.4529132244571406,1500,1058,2558,-
chr20,34634761,9.166015850524362,1175,531,1706,-
chr20,34635147,2.381425593689343,1439,776,2215,-
chr20,34635149,2.5476773648648647,1402,739,2141,-
chr20,34635150,2.75939393939394,941,494,1435,-
chr20,34635185,1.6014182849446208,864,418,1282,-
chr20,34635235,0.1694552929085303,1373,694,2067,-
chr20,34635236,0.19684839349871155,4390,2636,7026,-
chr20,34635237,0.19684839349871155,4390,2636,7026,-
chr20,34635371,20.278070411734635,1737,1213,2950,-
chr20,34635372,23.121816534883394,2069,1484,3553,-
chr20,34635373,20.403097043406177,1306,989,2295,-
chr20,34635377,9.890266442546235,1073,405,1478,-
chr20,34635378,10.107282734168866,829,308,1137,-
chr20,34635602,0.4885204081632652,765,559,1324,-
chr20,34635621,2.8924103419516265,577,435,1012,-
chr20,34635622,2.8924103419516265,577,435,1012,-
chr20,34635753,3.505462296829203,597,416,1013,-
chr20,34635856,0.40474103825019736,1783,1268,3051,-
chr20,34635857,0.45250717900791154,1168,797,1965,-
chr20,34636000,1.538768015521064,944,655,1599,-
chr20,34636001,1.8165413533834585,603,454,1057,-
chr20,34636337,0.3896940418679548,483,597,1080,-
chr20,34636340,27.505912071428398,4074,3945,8019,-
chr20,34636341,27.505912071428398,4074,3945,8019,-
chr20,34636523,1.6999554367201426,1030,679,1709,-
chr20,34636581,1.720168527457266,653,404,1057,-
chr20,34636936,2.773989898989899,844,494,1338,-
chr20,34636961,6.004796163069545,625,416,1041,-
chr20,34637308,2.483720930232558,711,300,1011,-
chr20,34637477,0.6143356643356642,752,659,1411,-
chr20,34637496,0.3697483122099211,683,678,1361,-
chr20,34637517,7.58352305778934,2126,2137,4263,-
chr20,34637518,10.602989642184555,756,943,1699,-
chr20,34637519,8.867269769679325,2129,2165,4294,-
chr20,34637522,8.85362255937484,2975,1819,4794,-
chr20,34637523,10.818713488069237,3944,2180,6124,-
chr20,34637524,10.818713488069237,3944,2180,6124,-
chr20,34637525,17.615100532252104,2935,1470,4405,-
chr20,34637535,3.9203882224044433,747,255,1002,-
chr20,34638065,2.304069602458741,1434,830,2264,-
chr20,34638067,2.7246051770862536,787,368,1155,-
chr20,34638509,7.1916269248661395,708,638,1346,-
chr20,35381210,1.316563323654116,640,470,1110,-
chr20,35381236,1.411320644888444,750,543,1293,-
chr20,35383218,2.069687045123726,974,915,1889,-
chr20,35383224,1.5090719762708655,853,736,1589,-
chr20,35383230,2.589550628472784,1476,1001,2477,-
chr20,35383232,2.589550628472784,1476,1001,2477,-
chr20,35383237,1.6762420532140336,1355,1095,2450,-
chr20,35383238,1.6574731767601263,2180,1747,3927,-
chr20,35399451,2.698850574712644,586,434,1020,-
chr20,35399452,2.698850574712644,586,434,1020,-
chr20,36757086,2.0587250611971935,817,544,1361,-
chr20,36757567,2.470387164283223,757,585,1342,-
chr20,36757815,2.57803738317757,612,427,1039,-
chr20,36757816,2.57803738317757,612,427,1039,-
chr20,36758341,2.805876701479463,748,503,1251,-
chr20,36758342,2.460426576152241,810,542,1352,-
chr20,36758494,6.568329539709443,1169,781,1950,-
chr20,36758496,6.568329539709444,1169,781,1950,-
chr20,36760803,2.823186906184218,613,431,1044,-
chr20,36767881,1.2610288361675208,548,485,1033,-
chr20,36767915,3.3774834437086096,759,603,1362,-
chr20,36767916,3.3774834437086096,759,603,1362,-
chr20,36767996,0.8946352133880059,878,572,1450,-
chr20,36767998,1.0628385698808234,653,425,1078,-
chr20,36776452,3.463750869706309,583,532,1115,-
chr20,42825707,0.8686434395848776,867,709,1576,-
chr20,42825709,0.8686434395848776,867,709,1576,-
chr20,42825838,2.6310597767636303,569,454,1023,-
chr20,42826231,6.210635216221808,937,536,1473,-
chr20,42826233,6.210635216221808,937,536,1473,-
chr20,42826374,1.0066787341614132,671,432,1103,-
chr20,42826375,1.0066787341614132,671,432,1103,-
chr20,43126385,13.140135949118747,880,850,1730,-
chr20,43126386,12.966023754414568,708,572,1280,-
chr20,43127959,1.5630770120619155,5620,3841,9461,-
chr20,43127960,1.5630770120619155,5620,3841,9461,-
chr20,43127965,1.8269454659037667,3756,3706,7462,-
chr20,43127966,1.4733215388492167,7846,6985,14831,-
chr20,43127968,1.8880304672317614,6896,6365,13261,-
chr20,43127969,1.7726107302729486,6590,5829,12419,-
chr20,43127970,1.2722307777274384,14376,11577,25953,-
chr20,43127971,1.5939699261861875,10313,8281,18594,-
chr20,43127972,1.3747539641632915,11444,9005,20449,-
chr20,43127973,1.4572149151503118,7870,6166,14036,-
chr20,43127978,1.860896600140407,1236,844,2080,-
chr20,43127979,0.618648757904463,2596,1941,4537,-
chr20,43127980,1.7573381793007965,1720,962,2682,-
chr20,43127981,0.618648757904463,2596,1941,4537,-
chr20,43127982,1.7573381793007965,1720,962,2682,-
chr20,43128008,2.351145038167939,703,392,1095,-
chr20,43128050,2.274218955106327,769,585,1354,-
chr20,43128068,2.060606060606061,645,428,1073,-
chr20,43128076,2.5908523041607836,976,683,1659,-
chr20,43128086,1.7644323047394066,770,520,1290,-
chr20,43128659,1.7626606198034769,635,377,1012,-
chr20,43129022,0.40692057550557503,564,480,1044,-
chr20,43132566,2.7040993071593533,645,432,1077,-
chr20,43132567,2.7040993071593533,645,432,1077,-
chr20,43132604,0.9192913385826772,933,634,1567,-
chr20,43132605,0.9192913385826772,933,634,1567,-
chr20,43135474,1.2776056594040643,638,454,1092,-
chr20,43139994,1.2314002011614154,608,506,1114,-
chr20,43141532,2.470398565767126,846,668,1514,-
chr20,43881773,2.152949091724602,799,636,1435,-
chr20,43882222,0.6460558648011635,990,781,1771,-
chr20,43883102,0.6138836772983114,817,532,1349,-
chr20,43883148,0.498157894736842,630,399,1029,-
chr20,43883199,1.058756595586953,534,474,1008,-
chr20,43955305,5.743042671614099,301,769,1070,-
chr20,43955307,14.261752478676575,2355,2805,5160,-
chr20,43955308,16.587506252116068,2198,2420,4618,-
chr20,43955309,16.587506252116068,2198,2420,4618,-
chr20,43955818,6.5458578466806285,648,812,1460,-
chr20,43955823,7.966552479171381,1035,1107,2142,-
chr20,43955824,8.325983108992322,874,937,1811,-
chr20,43955837,4.036131398335968,760,641,1401,-
chr20,43955840,8.117754969139481,741,554,1295,-
chr20,44473041,2.2606028274206453,564,488,1052,-
chr20,44473043,2.2606028274206453,564,488,1052,-
chr20,45315810,2.1785015962203547,776,486,1262,-
chr20,45867526,4.065763052208836,622,497,1119,-
chr20,47730038,2.0178968649018096,663,471,1134,-
chr20,47734320,2.7254728631033474,771,563,1334,-
chr20,47734460,3.650446428571429,628,447,1075,-
chr20,47734598,2.2773894366368137,736,502,1238,-
chr20,47741039,5.671437751504258,1659,1372,3031,-
chr20,47741040,5.671437751504258,1659,1372,3031,-
chr20,48697865,0.8899742953074843,948,713,1661,-
chr20,48697886,1.0783882783882783,703,461,1164,-
chr20,48698017,1.918214598208706,949,748,1697,-
chr20,48698310,2.945675825189009,1871,1478,3349,-
chr20,48698353,1.7042445129693449,873,595,1468,-
chr20,48698356,1.6551724137931032,1103,666,1769,-
chr20,48698364,1.9542787630090397,3514,1976,5490,-
chr20,48698365,1.9000982930540007,4816,2915,7731,-
chr20,48698892,2.030708340582165,687,397,1084,-
chr20,48699199,2.48738950612278,851,648,1499,-
chr20,48699295,1.7436641221374043,1268,916,2184,-
chr20,48699297,1.7436641221374043,1268,916,2184,-
chr20,48699395,2.189473684210526,597,436,1033,-
chr20,48699420,2.018489447060875,788,636,1424,-
chr20,48700679,2.982749808331204,752,558,1310,-
chr20,48700755,1.7994426292523549,748,472,1220,-
chr20,48700759,1.7810871183916606,551,473,1024,-
chr20,48700761,1.1981055250187165,1126,689,1815,-
chr20,48713322,2.186410579933642,1533,1018,2551,-
chr20,48713323,1.5785251859943212,2390,1678,4068,-
chr20,48713350,1.0918372379778052,941,810,1751,-
chr20,48713351,1.0918372379778052,941,810,1751,-
chr20,48713352,1.9671207150667998,1484,976,2460,-
chr20,48713354,1.486672909604491,1355,822,2177,-
chr20,48744707,1.5306393845284576,781,516,1297,-
chr20,49551543,1.7875736961451247,757,440,1197,-
chr20,49551620,1.86608442503639,640,457,1097,-
chr20,49571747,2.631833206203916,940,620,1560,-
chr20,49571808,0.5196163905841326,595,443,1038,-
chr20,49574986,1.723291770573566,616,400,1016,-
chr20,49575068,0.951352694429355,1442,651,2093,-
chr20,54944686,2.2115589488636367,858,511,1369,-
chr20,54944687,2.2115589488636367,858,511,1369,-
chr20,54944880,0.40582306830907056,905,569,1474,-
chr20,54944882,0.40582306830907056,905,569,1474,-
chr20,54945702,2.396101949025488,1309,1149,2458,-
chr20,54948498,1.344854058838036,3846,2917,6763,-
chr20,54948505,1.784025651849757,5440,3904,9344,-
chr20,54948507,1.9720961060480529,2203,1419,3622,-
chr20,54948511,2.6735307609969925,1115,852,1967,-
chr20,54956501,2.896389324960753,614,440,1054,-
chr20,54956561,2.4864758403361344,652,543,1195,-
chr20,54958071,3.1237701692247146,634,461,1095,-
chr20,54958153,1.78380706287683,653,515,1168,-
chr20,54958205,1.6154297291533375,738,520,1258,-
chr20,54961514,1.0703060642544833,912,733,1645,-
chr20,54961515,1.0703060642544833,912,733,1645,-
chr20,54963234,1.9110000000000005,636,499,1135,-
chr20,54963240,0.7129186602870813,595,474,1069,-
chr20,57570281,0.4374269005847953,475,683,1158,-
chr20,57570287,0.510236220472441,431,634,1065,-
chr20,57570294,9.899611505879596,3141,2789,5930,-
chr20,57570295,9.899611505879596,3141,2789,5930,-
chr20,57570296,7.157894736842105,902,816,1718,-
chr20,57570298,69.43942273169917,4346,616,4962,-
chr20,57570299,76.55792884730384,4526,565,5091,-
chr20,57570300,65.88425238707181,4919,592,5511,-
chr20,57570301,26.00709219858156,1929,140,2069,-
chr20,57570302,20.25974025974026,1949,139,2088,-
chr20,57570303,15.829051110239227,2251,173,2424,-
chr20,57570304,16.831977407611582,2047,188,2235,-
chr20,57570305,15.771428571428572,1034,104,1138,-
chr20,57570306,12.663949467264219,2195,255,2450,-
chr20,57570415,1.8480615288023856,811,553,1364,-
chr20,57570431,4.199352750809061,810,514,1324,-
chr20,57570468,2.621705426356589,800,644,1444,-
chr20,57570469,2.621705426356589,800,644,1444,-
chr20,57570540,1.830802328524424,628,438,1066,-
chr20,57570566,3.1366456786610484,992,687,1679,-
chr20,57570809,1.5996794871794873,712,779,1491,-
chr20,57571702,2.168370607028754,616,625,1241,-
chr20,57571714,0.5225712502600374,941,758,1699,-
chr20,57571734,5.781311946388754,4606,3310,7916,-
chr20,57571735,5.781311946388754,4606,3310,7916,-
chr20,57572671,1.7473633748801534,809,595,1404,-
chr20,57572682,1.4179269806860586,2013,1541,3554,-
chr20,57572683,1.826245820079928,1453,1004,2457,-
chr20,57572696,4.902026046582245,2016,1571,3587,-
chr20,57572771,0.5860008818342152,1398,1007,2405,-
chr20,57572772,0.5860008818342152,1398,1007,2405,-
chr20,57576540,1.4315647021116478,936,629,1565,-
chr20,57581513,2.5654370300751883,752,447,1199,-
chr20,57581514,2.5654370300751883,752,447,1199,-
chr20,57603895,1.0671142580454775,34594,26853,61447,-
chr20,57605359,0.9359261580434521,33303,25728,59031,-
chr20,57605370,0.9906702333954353,27266,21288,48554,-
chr20,57605376,0.7775164433360567,14249,11550,25799,-
chr20,57605460,0.8110849113351458,4085,3196,7281,-
chr20,57605473,1.437714075971207,12975,8021,20996,-
chr20,57605475,1.4295496011541071,10075,5891,15966,-
chr20,57607347,1.821792454736478,4077,2389,6466,-
chr20,57607356,0.6089057669041538,1240,864,2104,-
chr20,57607368,0.6365856684133355,2570,1728,4298,-
chr20,57607387,1.1454344624447717,914,489,1403,-
chr20,57607389,0.5155556156829847,1106,889,1995,-
chr20,57607390,0.5649642580311773,840,682,1522,-
chr20,57607397,1.611594737481643,667,438,1105,-
chr20,57608487,2.4252252252252253,672,517,1189,-
chr20,57608990,2.990191708402279,1684,1895,3579,-
chr20,57608995,11.867863227731702,1663,1700,3363,-
chr20,57608998,13.021146579984952,3976,3192,7168,-
chr20,57608999,12.17229766459029,5380,4166,9546,-
chr20,57609000,12.17229766459029,5380,4166,9546,-
chr20,57609001,15.009151106257635,2131,1603,3734,-
chr20,57609016,3.900624752218075,881,437,1318,-
chr20,57609018,1.9285714285714284,989,549,1538,-
chr20,57609019,1.9285714285714284,989,549,1538,-
chr20,57609587,2.329216896991081,678,536,1214,-
chr20,57609658,1.777168201118258,1432,880,2312,-
chr20,57609660,1.777168201118258,1432,880,2312,-
chr20,57609707,2.2146089204912736,570,441,1011,-
chr20,57609845,0.6551724137931034,797,629,1426,-
chr20,57609934,1.8759842148859398,1045,774,1819,-
chr20,57610042,1.6228359828293788,1250,985,2235,-
chr20,57610070,0.6796123348017621,1606,1134,2740,-
chr20,57611537,1.4167337681396357,2797,2136,4933,-
chr20,57612300,0.7265406162464986,2074,1478,3552,-
chr20,57613635,1.5760688321216567,1389,956,2345,-
chr20,57613673,2.0372537313432835,897,669,1566,-
chr20,57617774,0.5182839631731301,2192,1711,3903,-
chr20,57617816,1.073301135310489,3631,2191,5822,-
chr20,57617823,1.3001692695652045,4424,3508,7932,-
chr20,57617824,1.4634898941786474,5134,4106,9240,-
chr20,57617825,0.6381028543307086,1885,1269,3154,-
chr20,57617826,1.1232998738695503,6216,4567,10783,-
chr20,57617828,0.4680382208066367,2021,1611,3632,-
chr20,57617829,0.5498636583409843,4332,3328,7660,-
chr20,57617830,1.68562780503079,1189,870,2059,-
chr20,57617831,0.5780646761636961,4683,3387,8070,-
chr20,57617846,1.9245378814588319,1292,957,2249,-
chr20,57617849,4.7724700614436655,5923,4561,10484,-
chr20,57617850,4.63357497858731,6994,4989,11983,-
chr20,57617851,4.63357497858731,6994,4989,11983,-
chr20,57617852,12.76743081345428,3245,1747,4992,-
chr20,57617870,3.2801920768307324,827,244,1071,-
chr20,57617872,3.0825299282886167,2887,816,3703,-
chr20,57617873,3.545647219444965,2021,515,2536,-
chr20,57617874,3.618075049364773,2572,631,3203,-
chr20,60711999,1.3341679886807014,1767,1404,3171,-
chr20,60713299,2.0470973571267224,1249,931,2180,-
chr20,60714212,1.4223104953875447,1732,1467,3199,-
chr20,60714249,1.4699999999999998,1042,893,1935,-
chr20,60714865,0.6412249339344008,1249,918,2167,-
chr20,60714868,2.000062059763552,1150,870,2020,-
chr20,60714870,1.514312514150791,866,718,1584,-
chr20,60715927,1.979879275653924,2951,1845,4796,-
chr20,60715956,1.5066621355649006,1636,1196,2832,-
chr20,60718279,0.6314625850340135,1579,1049,2628,-
chr20,60718280,1.8203856749311291,825,604,1429,-
chr20,60718282,1.476190476190476,1115,845,1960,-
chr20,60718301,2.356369426751592,1207,784,1991,-
chr20,60718306,1.8236135388526933,603,405,1008,-
chr20,60718358,1.8897185862344905,1031,830,1861,-
chr20,60718383,2.016983016983017,672,363,1035,-
chr20,60718426,2.3793103448275863,827,463,1290,-
chr20,60718428,2.3793103448275863,827,463,1290,-
chr20,60885105,1.9485222557982844,592,446,1038,-
chr20,60885486,0.5296667092688357,636,413,1049,-
chr20,60886250,1.5820933636248125,574,473,1047,-
chr20,60887349,3.7153109424160915,878,604,1482,-
chr20,60887828,1.222272208788366,832,584,1416,-
chr20,60888264,2.6155313763945784,868,520,1388,-
chr20,60888813,1.3707295218966515,861,661,1522,-
chr20,60889718,1.2018126202516064,678,443,1121,-
chr20,60891023,1.5261204481792716,588,594,1182,-
chr20,60892413,5.45280338273584,621,395,1016,-
chr20,61488958,1.7268170426065164,688,398,1086,-
chr20,61490778,1.253683385284282,1058,786,1844,-
chr20,61490854,1.3589712227466948,1085,743,1828,-
chr20,61490855,1.3230726083686384,1163,869,2032,-
chr20,62120291,1.6444906444906444,677,443,1120,-
chr20,62120296,1.873074101247249,850,422,1272,-
chr20,62120402,0.5264494286923402,621,555,1176,-
chr20,62120500,2.26844262295082,819,487,1306,-
chr20,62121844,1.9093913245945633,1028,675,1703,-
chr20,62121875,1.773410652920962,717,387,1104,-
chr20,62121923,2.807441503644035,562,473,1035,-
chr20,62121979,1.9760802469135803,590,485,1075,-
chr20,62121981,1.2612612612612613,655,491,1146,-
chr20,62121982,1.6938019328758047,2654,2066,4720,-
chr20,62121983,1.8324957240538313,1999,1575,3574,-
chr20,62126180,1.1579580466804542,1482,816,2298,-
chr20,62126182,1.1579580466804542,1482,816,2298,-
chr20,62126230,1.092240446049198,1672,1133,2805,-
chr20,62126284,1.6501759324419425,4832,4409,9241,-
chr20,62126285,1.432116530761894,4900,2878,7778,-
chr20,62126286,1.542505762348758,11912,9174,21086,-
chr20,62126288,1.4060610892421148,6623,5733,12356,-
chr20,62126289,1.489482513872758,6168,5207,11375,-
chr20,62126291,1.4062853803307087,5938,4416,10354,-
chr20,62126294,0.6863709309851861,4479,3037,7516,-
chr20,62126317,1.570811744386874,1283,771,2054,-
chr20,62126318,0.6494047619047619,1090,895,1985,-
chr20,62126323,1.853664532260092,1506,1209,2715,-
chr20,62126335,2.3256779410359143,2488,1666,4154,-
chr20,62126401,4.301638787374154,896,547,1443,-
chr20,62126414,2.6331598395678357,1002,607,1609,-
chr20,62127227,2.643354013912389,702,590,1292,-
chr20,62127233,1.9558592667836363,1411,1104,2515,-
chr20,62127234,1.615298937992709,1814,1445,3259,-
chr20,62127281,2.2004147812971344,1060,611,1671,-
chr20,62127296,1.8526899309342058,702,523,1225,-
chr20,62127368,1.6522461456671982,1080,683,1763,-
chr20,62129031,1.929873772791024,687,557,1244,-
chr20,62129057,1.6734234234234235,742,480,1222,-
chr20,62704720,2.441499140054108,750,508,1258,-
chr21,15745761,1.9999775258221995,971,675,1646,-
chr21,18966439,2.1339204545454544,962,703,1665,-
chr21,18966440,2.1339204545454544,962,703,1665,-
chr21,18966598,1.615866388308977,644,478,1122,-
chr21,18981452,0.4054580896686159,623,512,1135,-
chr21,18981454,0.4054580896686159,623,512,1135,-
chr21,18981456,0.5369526177648846,844,634,1478,-
chr21,18981458,0.5369526177648846,844,634,1478,-
chr21,26965125,2.048423274838369,689,582,1271,-
chr21,26965126,1.4635902470954016,1039,678,1717,-
chr21,26965130,2.306247835468167,1850,1216,3066,-
chr21,26965143,0.6445084455514907,689,442,1131,-
chr21,26978916,1.1013634443449998,723,431,1154,-
chr21,27096975,1.7254847336750614,836,640,1476,-
chr21,27101948,2.0758764777823075,1100,891,1991,-
chr21,27101997,1.889042498719918,1867,1394,3261,-
chr21,27102102,0.5884359572127141,3514,3646,7160,-
chr21,27102103,0.586263333099839,4490,4531,9021,-
chr21,27102104,0.586263333099839,4490,4531,9021,-
chr21,27102107,0.45821525413362146,774,1000,1774,-
chr21,27107183,22.50185132163275,2191,2449,4640,-
chr21,27107187,10.71648813153651,4091,3597,7688,-
chr21,27107189,7.385848680778058,6622,4967,11589,-
chr21,27107190,7.847085142260093,5076,3306,8382,-
chr21,27107191,4.506338316464094,2862,1388,4250,-
chr21,27107192,2.2207506290187307,2762,1167,3929,-
chr21,27107193,2.3284984580491774,2512,1104,3616,-
chr21,27107194,2.710120068610635,1579,635,2214,-
chr21,27252982,1.916666666666666,689,467,1156,-
chr21,27253071,1.645977011494253,715,494,1209,-
chr21,27253227,1.4980401672390624,2588,1447,4035,-
chr21,27253228,1.4980401672390624,2588,1447,4035,-
chr21,27253242,87.17926258729447,11861,4160,16021,-
chr21,27253243,86.67131890548966,14186,4337,18523,-
chr21,27253244,86.67131890548967,14186,4337,18523,-
chr21,27253245,97.96150859124671,8087,1426,9513,-
chr21,27253247,13.698060365650935,6481,548,7029,-
chr21,27253248,10.935159607120932,4596,361,4957,-
chr21,27253249,10.209035818946175,10106,895,11001,-
chr21,27253250,9.387983980064165,6817,599,7416,-
chr21,27253252,20.64406779661017,1217,117,1334,-
chr21,27253486,0.7461360810090601,2639,1731,4370,-
chr21,27253498,0.7659881056267279,2516,1693,4209,-
chr21,27253564,1.583160800552105,1828,1448,3276,-
chr21,27253894,1.3777165058277978,2113,1514,3627,-
chr21,27253931,1.9405597162002368,1085,884,1969,-
chr21,27253957,1.956854499579478,1316,869,2185,-
chr21,27254041,1.5535078169559635,1795,1249,3044,-
chr21,27264071,1.6810972798702322,1612,1392,3004,-
chr21,27264152,1.496605700179533,1720,1113,2833,-
chr21,27269889,1.936473165388828,1223,912,2135,-
chr21,27269948,1.9313304721030038,1199,931,2130,-
chr21,27277349,1.504306808214863,7066,4651,11717,-
chr21,27277351,1.4497146480659482,4898,2904,7802,-
chr21,27277358,1.7746870653685676,1913,1437,3350,-
chr21,27277362,1.4225820763087844,1748,1287,3035,-
chr21,27277365,1.5271013354281224,1673,1177,2850,-
chr21,27284061,1.625475599669148,1155,805,1960,-
chr21,27284107,1.329518653957024,2663,1941,4604,-
chr21,27327953,1.5870035543192706,892,718,1610,-
chr21,27347413,1.4375391849529782,1078,637,1715,-
chr21,27347416,1.7727009832272989,612,545,1157,-
chr21,27347450,0.5899321266968326,744,441,1185,-
chr21,27348283,1.4079742928417402,1664,1058,2722,-
chr21,27354695,1.784487054417626,17121,13316,30437,-
chr21,27354696,1.8329359888312984,16621,13271,29892,-
chr21,27354697,1.8329359888312984,16621,13271,29892,-
chr21,27354698,1.7687742918956788,12189,9514,21703,-
chr21,27354705,1.5132598324330182,3454,2188,5642,-
chr21,27354711,1.4703136901922258,5872,3878,9750,-
chr21,27354713,0.8378465212900804,2898,2505,5403,-
chr21,27354720,0.65142828927426,4905,3678,8583,-
chr21,27354726,0.7379481085363437,2013,1979,3992,-
chr21,27354750,1.654743951216314,2968,2113,5081,-
chr21,27354751,1.8404904812242506,5751,4467,10218,-
chr21,27354753,1.9032520776648716,2882,2000,4882,-
chr21,27354754,1.544187898089172,1292,1255,2547,-
chr21,27354772,1.636198636032291,2142,1542,3684,-
chr21,27372358,1.7411446771547148,1319,796,2115,-
chr21,27372363,0.6988649706457924,991,729,1720,-
chr21,27372439,1.754227680814427,1991,1339,3330,-
chr21,27372448,1.0718627154229436,1778,1214,2992,-
chr21,27372454,1.7175000000000002,686,527,1213,-
chr21,27372484,1.6449810606060604,598,439,1037,-
chr21,27394168,1.8508550974413365,606,396,1002,-
chr21,27394306,2.486804451510334,710,628,1338,-
chr21,27423369,1.965713558150533,1612,1308,2920,-
chr21,27423404,1.5430218676295029,1655,1125,2780,-
chr21,27423487,2.037296763804478,1059,620,1679,-
chr21,27425612,1.7545945945945944,1081,924,2005,-
chr21,27462297,1.9212328767123286,692,510,1202,-
chr21,27484377,1.6080808080808078,795,644,1439,-
chr21,27484398,1.574966027479994,1097,715,1812,-
chr21,27484448,1.0493857377061608,1915,1638,3553,-
chr21,27484450,1.0493857377061608,1915,1638,3553,-
chr21,27484454,1.4721611605941787,1277,1092,2369,-
chr21,27484456,1.3918918276686263,1537,1163,2700,-
chr21,27543084,1.0309896431063366,1351,1011,2362,-
chr21,28210322,0.8913565426170469,593,475,1068,-
chr21,28210323,0.8913565426170469,593,475,1068,-
chr21,30428795,2.0019500019500023,1251,776,2027,-
chr21,30428804,1.6050042771599655,1184,667,1851,-
chr21,30432904,1.4971418800078171,1976,1427,3403,-
chr21,30432936,1.840329383410324,1665,1148,2813,-
chr21,30434476,1.34355117586603,3753,2362,6115,-
chr21,30434496,1.4544951700601574,3324,2160,5484,-
chr21,30434557,1.3904935064935064,1845,1499,3344,-
chr21,30434563,0.7599531615925059,2595,1707,4302,-
chr21,30434657,1.640511680454827,1901,1192,3093,-
chr21,30434716,1.4761463524579903,1841,1093,2934,-
chr21,30434866,1.7490380313199105,1611,1191,2802,-
chr21,30437294,2.2765323992994744,1856,1141,2997,-
chr21,30437304,1.7668343653250775,1190,815,2005,-
chr21,30439364,1.3812367950593207,1568,1171,2739,-
chr21,30439376,1.4519080293728182,1722,1169,2891,-
chr21,30442656,2.0883509108341323,1116,744,1860,-
chr21,30445854,1.558100956985565,2028,1480,3508,-
chr21,30445895,0.4585352346670359,551,465,1016,-
chr21,30445928,1.2792784452754968,1693,1129,2822,-
chr21,30445929,0.9551656920077972,1259,809,2068,-
chr21,30445933,1.9328650684582889,1084,665,1749,-
chr21,30445934,2.109558041986801,1440,922,2362,-
chr21,30445950,1.563807430904861,1170,797,1967,-
chr21,30445951,2.129956999522217,742,545,1287,-
chr21,33974627,1.5920273769885316,2458,1801,4259,-
chr21,33974644,1.4339950874613043,3928,2570,6498,-
chr21,33974645,1.4339950874613043,3928,2570,6498,-
chr21,33974646,0.4816592592592592,1015,624,1639,-
chr21,33974655,1.3192627061494537,3346,2226,5572,-
chr21,33974657,1.4123317837044287,1177,669,1846,-
chr21,33974669,1.6200317965023847,1018,526,1544,-
chr21,33975480,1.403894615771683,2664,1825,4489,-
chr21,33975481,1.0138243379546308,1348,856,2204,-
chr21,33975492,1.3022730517998855,1917,1173,3090,-
chr21,33975499,0.5542064238577586,1313,852,2165,-
chr21,33975502,0.4468325791855204,631,415,1046,-
chr21,33975582,1.8723472836248167,707,428,1135,-
chr21,33975586,0.7680065750149432,540,477,1017,-
chr21,33975587,0.7680065750149432,540,477,1017,-
chr21,33982213,2.0786493230706578,715,555,1270,-
chr21,33982234,2.440246024161337,642,473,1115,-
chr21,34876787,3.9252547066470305,624,444,1068,-
chr21,34878312,3.02710608424337,816,640,1456,-
chr21,34878313,3.02710608424337,816,640,1456,-
chr21,34882126,4.091684065794164,763,582,1345,-
chr21,34883687,2.1741106862226833,806,541,1347,-
chr21,34889869,2.8573440020274794,755,464,1219,-
chr21,34889899,2.1067020648254915,971,621,1592,-
chr21,34889901,2.101744186046512,722,429,1151,-
chr21,34892806,2.4043164451833183,683,552,1235,-
chr21,34897248,3.405328115593017,904,603,1507,-
chr21,34897250,3.405328115593017,904,603,1507,-
chr21,34911482,1.6961074886386092,591,481,1072,-
chr21,34911624,1.3934051570980472,998,728,1726,-
chr21,34911626,0.9960753532182103,704,489,1193,-
chr21,34954523,1.8872861421948297,778,466,1244,-
chr21,35275839,2.448201740589284,952,866,1818,-
chr21,35276252,1.4055549930815698,2191,1410,3601,-
chr21,35276296,0.6161900926298832,1529,1336,2865,-
chr21,35276320,1.4384791853178158,1772,1116,2888,-
chr21,35281437,1.5981129568106314,1178,874,2052,-
chr21,35284634,1.378376304481277,1561,1085,2646,-
chr21,35286791,1.6149479659413437,568,452,1020,-
chr21,40550515,2.6133333333333333,587,449,1036,-
chr21,40550517,2.6133333333333333,587,449,1036,-
chr21,40552225,1.2639501544850937,877,566,1443,-
chr21,40552344,4.439018636470866,606,470,1076,-
chr21,40552345,4.439018636470866,606,470,1076,-
chr21,40714818,1.5260223782360687,658,417,1075,-
chr21,40717114,2.460972222222222,610,449,1059,-
chr21,40717122,0.5815170008718396,666,464,1130,-
chr21,40717123,1.5664939550949912,906,578,1484,-
chr21,40717145,1.587687372771575,756,558,1314,-
chr21,40720833,0.5583140877598152,966,432,1398,-
chr21,40720868,0.3325,1070,815,1885,-
chr21,40720869,0.7215208431944381,1313,985,2298,-
chr21,40720870,0.3325,1070,815,1885,-
chr21,40720900,7.884126514387179,824,524,1348,-
chr21,40720901,7.610204081632654,677,419,1096,-
chr21,40720902,7.610204081632654,677,419,1096,-
chr21,43256713,2.6673002378635635,582,452,1034,-
chr21,44513228,0.2462790052694832,443,745,1188,-
chr21,44513229,0.2462790052694832,443,745,1188,-
chr21,44513243,6.829266831295944,961,1140,2101,-
chr21,44513259,22.935235378031383,811,700,1511,-
chr21,44513260,11.327148220765292,2560,1995,4555,-
chr21,44513261,11.327148220765292,2560,1995,4555,-
chr21,44513262,13.370597798474533,2011,1418,3429,-
chr21,44513265,22.124962638271548,940,530,1470,-
chr21,44513268,6.80150179874334,890,256,1146,-
chr21,44513270,9.73,833,239,1072,-
chr21,44513271,23.83074486387382,1021,243,1264,-
chr21,44513272,15.51124998999111,1440,319,1759,-
chr21,44513274,11.924270095265596,1629,312,1941,-
chr21,44513275,10.265972007929127,1532,272,1804,-
chr21,44513277,9.574615835401197,1223,196,1419,-
chr21,44513280,10.851489461166834,1110,153,1263,-
chr21,44514616,1.4840737707574603,4279,3942,8221,-
chr21,44514618,1.9093237704918036,3726,3903,7629,-
chr21,44514620,1.9318485807095394,2419,2478,4897,-
chr21,44514647,1.993878071592552,699,618,1317,-
chr21,44514812,0.5396793028677855,3451,1690,5141,-
chr21,44514814,1.3515294762621237,4796,3016,7812,-
chr21,44514824,0.9931795502114219,5616,2967,8583,-
chr21,44514840,0.3675910399441692,1995,912,2907,-
chr21,44514842,0.689704235557605,2453,1614,4067,-
chr21,44514843,0.6058059587471352,1707,832,2539,-
chr21,44514845,0.623757841941767,2173,1522,3695,-
chr21,44514861,0.608710529817691,1600,1282,2882,-
chr21,44514866,1.833290322580645,1331,774,2105,-
chr21,44514876,1.7311764231562905,1674,1045,2719,-
chr21,44514884,1.0854760679053284,2122,1423,3545,-
chr21,44515549,1.698785359469769,1736,1153,2889,-
chr21,44515634,1.9881314380770265,1216,803,2019,-
chr21,44524444,0.5958446484762274,600,626,1226,-
chr21,44524488,0.5308627542670096,477,657,1134,-
chr21,44524494,0.1366080156402737,558,1022,1580,-
chr21,44524498,0.45163080927953453,604,705,1309,-
chr21,44527578,0.3192938460769111,1519,4093,5612,-
chr21,44527589,0.27886123457434703,1029,2766,3795,-
chr21,44527596,1.433372012599355,1645,5220,6865,-
chr21,44527597,1.098307136834367,507,2010,2517,-
chr21,44527598,1.171754488301251,536,1250,1786,-
chr21,44527603,2.983559168925023,459,1106,1565,-
chr21,44527605,5.484486061714266,2423,4880,7303,-
chr21,44527606,6.169753667572579,2335,4385,6720,-
chr21,44527607,6.473384698168592,1923,3638,5561,-
chr21,44834578,1.48625050999592,1300,1074,2374,-
chr21,44834583,0.6929714658808167,1154,928,2082,-
chr21,44834629,1.6676614631160087,1146,725,1871,-
chr21,44834761,1.7461687248921292,651,516,1167,-
chr21,44834767,1.5874049945711186,730,613,1343,-
chr21,44834812,1.64700145137881,2085,1324,3409,-
chr21,44834813,1.64700145137881,2085,1324,3409,-
chr21,44834935,0.5560783455520297,967,702,1669,-
chr21,44834993,0.38868498458501,806,670,1476,-
chr21,44835381,1.841555262262972,694,502,1196,-
chr21,44835553,1.4615083711469252,957,615,1572,-
chr21,44835628,0.5557387444514902,625,414,1039,-
chr21,44835633,0.8019629094412332,700,518,1218,-
chr21,44835635,1.1788529412594835,1199,849,2048,-
chr21,44835850,1.962076271186441,685,471,1156,-
chr21,44835859,0.527050268286489,1078,741,1819,-
chr21,44836154,3.108830237862496,657,557,1214,-
chr21,44836158,0.5469759375677433,663,658,1321,-
chr21,44836189,1.8354037267080745,590,459,1049,-
chr21,44836204,0.6000899685110213,666,467,1133,-
chr21,44836295,0.5059534387773236,948,992,1940,-
chr21,44836297,0.5059534387773236,948,992,1940,-
chr21,44836317,0.48937990856961555,642,908,1550,-
chr21,44836327,2.4684564887508538,1192,1643,2835,-
chr21,44836333,1.8480358362499258,561,591,1152,-
chr21,44836357,11.080998275939939,1825,1473,3298,-
chr21,44836358,8.186404502078862,2137,1738,3875,-
chr21,44836359,5.151312450984915,970,408,1378,-
chr21,44836360,5.475427433381478,946,827,1773,-
chr21,44836361,4.490274863396291,1487,806,2293,-
chr21,44836363,4.548282896973818,862,172,1034,-
chr21,44836364,16.707600401532396,2175,704,2879,-
chr21,44836365,16.501878354721228,2384,727,3111,-
chr21,44836366,19.64882670163965,1877,522,2399,-
chr21,44836371,12.91498630479215,1673,191,1864,-
chr21,44836372,13.964054503685789,2112,215,2327,-
chr21,44836373,13.805212111686012,1977,157,2134,-
chr21,44836374,14.238457268175248,1536,109,1645,-
chr21,44836469,0.7101591454109439,1302,833,2135,-
chr21,44836580,2.025934579439252,597,427,1024,-
chr21,44836585,1.8535156124627454,960,765,1725,-
chr21,44836707,4.429586109987832,811,542,1353,-
chr21,44839817,1.2415571332167303,741,524,1265,-
chr21,44839866,2.162921894757319,600,446,1046,-
chr21,44839867,2.162921894757319,600,446,1046,-
chr21,44840199,3.8395844088837285,565,504,1069,-
chr21,44841538,2.502262443438914,552,475,1027,-
chr21,44845301,1.5339478076164468,1092,675,1767,-
chr21,44845910,0.7430030906593407,910,671,1581,-
chr21,44846053,0.6378364495607962,708,458,1166,-
chr21,45193955,2.9369324911172523,762,595,1357,-
chr21,45193985,0.5707306240284256,1027,631,1658,-
chr21,45194129,0.7799205899035734,1099,983,2082,-
chr21,45194162,1.1785749955937046,1751,1233,2984,-
chr21,45194185,1.7538595346814525,871,656,1527,-
chr21,45194553,0.5003706449221645,674,567,1241,-
chr21,45194605,1.5659089560211288,775,580,1355,-
chr21,45194609,0.49210239651416127,694,509,1203,-
chr21,45194636,2.211835657745948,651,378,1029,-
chr21,45196172,0.7934163052692476,1316,711,2027,-
chr21,45196173,0.8292171213979154,856,447,1303,-
chr21,46189191,2.547514619883041,696,379,1075,-
chr21,46189193,2.547514619883041,696,379,1075,-
chr21,46225996,2.016558249556476,681,444,1125,-
chr21,46226434,2.455357142857143,626,398,1024,-
chr21,46226435,2.455357142857143,626,398,1024,-
chr21,46226574,1.8330852318163644,769,543,1312,-
chr21,46226704,1.6407272727272726,563,549,1112,-
chr21,46229011,2.1917770419426046,1013,603,1616,-
chr21,46229012,2.1917770419426046,1013,603,1616,-
chr21,46233982,2.187040250250495,2840,2406,5246,-
chr21,46233993,1.1462663746603028,7144,4997,12141,-
chr21,46234002,1.001661609610894,6646,4446,11092,-
chr21,46234004,0.9025990029910804,10170,6627,16797,-
chr21,46234009,1.5421972922195073,4853,3156,8009,-
chr21,46234011,1.5421972922195073,4853,3156,8009,-
chr21,46237868,1.7906850240096035,1564,832,2396,-
chr21,46237870,1.3462356763532315,4576,2851,7427,-
chr21,46237871,1.7320247493065928,1475,762,2237,-
chr21,46237872,0.8865740837422992,3248,2354,5602,-
chr21,46237873,0.6824256859985324,2025,1451,3476,-
chr21,46237921,1.9903664921465969,703,381,1084,-
chr21,46237922,1.9903664921465969,703,381,1084,-
chr21,46270036,2.0074554941877096,852,716,1568,-
chr21,46270153,3.299613628380752,670,437,1107,-
chr21,46270212,0.9634738186462324,942,608,1550,-
chr21,46270213,0.9634738186462324,942,608,1550,-
chr21,46270231,2.107769561682965,758,558,1316,-
chr21,46270838,2.19570905285191,1048,734,1782,-
chr21,46270839,2.19570905285191,1048,734,1782,-
chr21,46275142,0.7447619047619047,643,489,1132,-
chr21,46275143,0.7447619047619047,643,489,1132,-
chr21,46275154,1.4124623674253887,722,549,1271,-
chr22,17618597,2.583199135048932,698,479,1177,-
chr22,17618884,9.066708776585722,1550,1093,2643,-
chr22,17618885,9.489863877252832,1733,1170,2903,-
chr22,17618886,10.299603023746693,1234,805,2039,-
chr22,17629426,1.5085143851342644,626,465,1091,-
chr22,18075042,1.9859989229940764,921,618,1539,-
chr22,18075068,1.6614778325123154,815,524,1339,-
chr22,18075075,2.0600895987534087,640,603,1243,-
chr22,18075147,2.0117231286212878,1155,815,1970,-
chr22,18075156,3.818397242567858,708,421,1129,-
chr22,18075466,0.5576378503929491,761,592,1353,-
chr22,18077332,2.952624198717949,718,623,1341,-
chr22,18080992,1.6746327130264451,1441,1020,2461,-
chr22,18083902,1.6857988165680473,846,714,1560,-
chr22,18083903,0.6510416666666666,794,635,1429,-
chr22,18083905,0.4618916437098255,1005,604,1609,-
chr22,18096075,2.9053345900094247,1351,1060,2411,-
chr22,18111443,1.7468060394889666,895,587,1482,-
chr22,18111448,0.5559135935075785,821,512,1333,-
chr22,18111470,1.568027993922372,1031,586,1617,-
chr22,18111483,3.001261034047919,713,365,1078,-
chr22,18111503,5.63063063063063,749,443,1192,-
chr22,18111514,0.7176428679302913,2295,1115,3410,-
chr22,18111533,0.45720648842400985,851,483,1334,-
chr22,19163548,4.684938524590164,589,487,1076,-
chr22,19163549,4.684938524590164,589,487,1076,-
chr22,19163575,2.1910325988310886,739,444,1183,-
chr22,19163751,2.0199456764381933,1591,1059,2650,-
chr22,19163752,2.1700219780219783,747,454,1201,-
chr22,19164107,1.8564492993490012,672,476,1148,-
chr22,19164154,2.113058113058113,735,480,1215,-
chr22,19164423,2.7229656379141414,728,471,1199,-
chr22,19442284,0.4259820480648587,1225,796,2021,-
chr22,19442285,1.0360401571476032,1741,1261,3002,-
chr22,19442319,2.029186691535851,1023,688,1711,-
chr22,19443205,1.6435315199874327,1052,790,1842,-
chr22,19444411,3.4335079279072183,709,604,1313,-
chr22,19445657,1.7043988648090815,754,407,1161,-
chr22,19452791,0.5481415136587551,611,405,1016,-
chr22,19452792,3.092771084337349,603,414,1017,-
chr22,19452794,1.7984962413171508,1081,848,1929,-
chr22,20103596,1.2627307092664453,767,638,1405,-
chr22,20103600,1.2101262191623638,766,497,1263,-
chr22,20103601,1.2101262191623638,766,497,1263,-
chr22,20103602,2.152183311716385,523,513,1036,-
chr22,20103603,2.216767881241565,772,740,1512,-
chr22,20103605,2.597873900293255,745,681,1426,-
chr22,21982537,2.325657329438048,693,505,1198,-
chr22,21982538,2.325657329438048,693,505,1198,-
chr22,21982791,5.492508946495593,598,407,1005,-
chr22,22115081,2.2137522768845077,649,475,1124,-
chr22,22142561,1.3985036967244862,962,784,1746,-
chr22,22142562,1.6924140637614238,991,796,1787,-
chr22,22161978,3.633323765786452,872,535,1407,-
chr22,22890259,2.16015625,710,511,1221,-
chr22,22890454,1.8114942528735631,590,434,1024,-
chr22,22892173,3.531947261663286,596,492,1088,-
chr22,22892174,3.531947261663286,596,492,1088,-
chr22,22892247,2.725663716814159,699,564,1263,-
chr22,22892249,2.725663716814159,699,564,1263,-
chr22,22892320,0.6187664041994752,614,507,1121,-
chr22,22892350,0.5557387739413168,934,764,1698,-
chr22,22892430,1.491925147398103,969,580,1549,-
chr22,22892459,3.174881648565859,876,683,1559,-
chr22,22892469,2.641772814517536,756,520,1276,-
chr22,22892490,0.3740348606038189,808,502,1310,-
chr22,22892510,3.5504047093451065,578,452,1030,-
chr22,22892659,2.3492833225734695,1566,1185,2751,-
chr22,22892665,1.2437573827391843,2667,1908,4575,-
chr22,22892666,1.1062136408496137,3441,2340,5781,-
chr22,22892684,2.3824212271973466,652,401,1053,-
chr22,22893254,2.347826086956522,620,436,1056,-
chr22,22893256,2.2162454246807326,894,631,1525,-
chr22,24108115,2.029934406326268,2150,1539,3689,-
chr22,24108125,0.5688521677327647,673,468,1141,-
chr22,24108149,2.7156707558369604,914,531,1445,-
chr22,24108323,1.738440860215054,668,557,1225,-
chr22,24108409,1.375219814057367,1267,843,2110,-
chr22,24108410,0.9521069892288225,953,680,1633,-
chr22,24313644,2.319859402460457,659,568,1227,-
chr22,24313768,2.5787250384024576,789,650,1439,-
chr22,24313798,1.8488888888888888,1439,899,2338,-
chr22,24313806,1.8327044025157238,1053,794,1847,-
chr22,24313809,1.4766880046401103,1667,1223,2890,-
chr22,24315973,2.0101250744490766,874,510,1384,-
chr22,24315981,2.7240065323897658,833,500,1333,-
chr22,24315982,2.7240065323897658,833,500,1333,-
chr22,24315992,1.150092631271061,740,489,1229,-
chr22,24315995,2.417085594433532,1170,612,1782,-
chr22,24315996,2.417085594433532,1170,612,1782,-
chr22,24315997,2.3855725297765735,1409,740,2149,-
chr22,24937907,27.532569080176774,1242,878,2120,-
chr22,24937908,27.532569080176774,1242,878,2120,-
chr22,28062584,2.637142857142857,701,674,1375,-
chr22,28062586,2.5721685891748,837,773,1610,-
chr22,28256186,2.3574977994106554,810,536,1346,-
chr22,29090089,3.035230352303523,699,491,1190,-
chr22,29090091,3.035230352303523,699,491,1190,-
chr22,29095888,6.881257632677287,2220,1934,4154,-
chr22,29095889,6.9203330801,1922,1683,3605,-
chr22,29107931,0.5667109069280608,1229,839,2068,-
chr22,29120994,2.6880685623049625,683,544,1227,-
chr22,29190898,1.5697025500892712,2917,2148,5065,-
chr22,29190899,1.2586151210880065,4403,3316,7719,-
chr22,29190907,1.3229126953869614,3469,2439,5908,-
chr22,29191022,0.7789789494393075,3770,2759,6529,-
chr22,29191157,1.6700602079912426,1906,1574,3480,-
chr22,29191203,1.6322120168465928,3220,2227,5447,-
chr22,29191206,2.239842579019025,2626,2051,4677,-
chr22,29191225,1.8226287038569773,1158,862,2020,-
chr22,29191260,2.2118593308804657,1099,898,1997,-
chr22,29191343,1.3314046366647183,1501,1179,2680,-
chr22,29191421,1.4994024380527449,2213,1629,3842,-
chr22,29191534,1.387093860822037,12794,7519,20313,-
chr22,29191535,1.4821216949274627,7417,4450,11867,-
chr22,29191563,1.8917040631888997,7098,4228,11326,-
chr22,29191566,1.8466394187102635,3625,2201,5826,-
chr22,29191585,1.4850250595208303,2532,1536,4068,-
chr22,29191602,0.7537251655629138,1820,1207,3027,-
chr22,29191605,1.6258014514197134,1774,995,2769,-
chr22,29191612,1.446482997669276,2016,1153,3169,-
chr22,29191622,1.7418609131188596,1506,894,2400,-
chr22,29192043,0.6427175612298073,896,807,1703,-
chr22,29192080,0.5666284841542573,1112,872,1984,-
chr22,29192083,2.01050385688495,1049,676,1725,-
chr22,29192174,1.9789612097304403,979,818,1797,-
chr22,29195139,1.4571217636024807,22406,16727,39133,-
chr22,29195140,1.388582376531095,22160,14791,36951,-
chr22,29195142,1.048504834331606,435,584,1019,-
chr22,29195950,3.414576378694761,711,595,1306,-
chr22,29196297,1.4119168847087666,10416,6085,16501,-
chr22,29196298,1.4440917722750362,34948,22912,57860,-
chr22,29196300,1.3822770764720997,40571,26662,67233,-
chr22,29196301,1.4351726218005263,22380,14369,36749,-
chr22,29196303,1.349704599060515,12280,8247,20527,-
chr22,29196310,1.3217731790636469,6519,3857,10376,-
chr22,29196319,1.57082071843548,2429,1209,3638,-
chr22,29196320,0.6602269286092816,2364,1553,3917,-
chr22,29196322,1.7384175015334287,2297,1459,3756,-
chr22,29196329,1.8833178985874484,3970,2175,6145,-
chr22,29196332,1.3373360231949878,3860,2293,6153,-
chr22,29196334,1.271236240490408,9814,5317,15131,-
chr22,29196335,1.2191478816673218,4337,1928,6265,-
chr22,29196336,1.2191478816673218,4337,1928,6265,-
chr22,29196349,2.3137332385685587,2173,1158,3331,-
chr22,29196366,3.400346620450607,980,576,1556,-
chr22,29196375,2.7214285714285715,761,335,1096,-
chr22,29196382,0.4827118644067796,711,294,1005,-
chr22,29196391,2.0186543434808653,1314,656,1970,-
chr22,29196397,3.0375434027777777,1155,565,1720,-
chr22,29196464,1.6471405384383386,810,518,1328,-
chr22,29727443,2.053672712076928,779,584,1363,-
chr22,29907208,1.7937839392527912,883,475,1358,-
chr22,29907214,0.39825022855657005,1084,626,1710,-
chr22,29907216,0.337089715536105,710,456,1166,-
chr22,29939479,1.697443181818182,716,439,1155,-
chr22,29940454,2.087869172565292,657,481,1138,-
chr22,29950904,1.3439207856254434,651,527,1178,-
chr22,29950928,8.192503486469041,2128,1434,3562,-
chr22,29950929,10.7218074240316,2385,1603,3988,-
chr22,29951114,1.8540836191712244,799,468,1267,-
chr22,29951328,26.566469090272566,4240,3345,7585,-
chr22,29951329,26.566469090272566,4240,3345,7585,-
chr22,29951412,1.90322889719268,763,496,1259,-
chr22,29951531,4.776400651865465,2314,1527,3841,-
chr22,29951532,5.590047481516836,2234,1480,3714,-
chr22,29951662,0.5935746766668635,873,573,1446,-
chr22,29951800,2.218599033816425,667,413,1080,-
chr22,29954863,1.7549579831932771,680,424,1104,-
chr22,29956726,1.4172918388309177,1254,921,2175,-
chr22,29956802,1.6746587822084498,5012,3059,8071,-
chr22,29956803,1.8645810781554448,2649,1638,4287,-
chr22,29957180,1.914393939393939,930,559,1489,-
chr22,29957519,1.717557346828729,1608,1077,2685,-
chr22,29957526,1.9465272591486185,723,514,1237,-
chr22,29957799,2.180529755761954,1218,854,2072,-
chr22,29957800,2.2967638669154895,1934,1442,3376,-
chr22,29957802,2.481454877889513,716,588,1304,-
chr22,29976997,5.333359253979603,723,607,1330,-
chr22,30200796,0.3920899132166737,847,638,1485,-
chr22,30200798,1.906743598996021,1244,1094,2338,-
chr22,30200799,2.405080545229244,1492,1344,2836,-
chr22,30200801,2.2684654300168634,1415,1185,2600,-
chr22,30200802,2.1023580767072945,1330,999,2329,-
chr22,30202217,1.1195991910277625,640,517,1157,-
chr22,30202218,1.1195991910277625,640,517,1157,-
chr22,30202265,2.983124639247733,740,515,1255,-
chr22,30735192,2.153343447310071,1317,778,2095,-
chr22,30735195,1.7315926691414698,4886,3510,8396,-
chr22,30735196,1.8958055714195063,3103,2447,5550,-
chr22,30735212,0.6693449149475208,1320,920,2240,-
chr22,30735222,1.7439350772684106,1009,701,1710,-
chr22,30735227,1.2363411027758588,2302,1582,3884,-
chr22,30736192,2.017193882397644,684,362,1046,-
chr22,30736288,2.9791057291057292,675,414,1089,-
chr22,30737832,1.2839167173153188,603,398,1001,-
chr22,30738315,7.447937235026234,667,440,1107,-
chr22,30748973,2.1084035221433353,692,517,1209,-
chr22,30972651,27.91411042944785,699,325,1024,-
chr22,30972652,17.98436769662442,1398,713,2111,-
chr22,30972653,17.984367696624417,1398,713,2111,-
chr22,30974860,0.606009166525208,839,547,1386,-
chr22,30975199,5.309066847925974,1213,1019,2232,-
chr22,30975749,1.876011995211489,1632,1208,2840,-
chr22,30975778,2.3189161021365297,711,403,1114,-
chr22,30975873,1.593551797040169,647,493,1140,-
chr22,30976630,2.157587649992593,569,481,1050,-
chr22,30984090,2.970606826801517,722,451,1173,-
chr22,30984139,0.3840810027512274,971,666,1637,-
chr22,30987803,0.3550999981163663,674,409,1083,-
chr22,31345741,1.9573330532630917,985,637,1622,-
chr22,31501658,0.9578441585137832,1030,790,1820,-
chr22,31501920,2.877648042623524,672,503,1175,-
chr22,32015346,1.5650884999233674,5426,3814,9240,-
chr22,32015347,1.5202550175443277,4026,2860,6886,-
chr22,32015364,1.6587552742616034,1274,947,2221,-
chr22,32015366,1.6587552742616034,1274,947,2221,-
chr22,32015388,1.7708284753895354,1766,1220,2986,-
chr22,32015389,1.0072365445499776,1047,803,1850,-
chr22,32015390,3.014354066985646,719,417,1136,-
chr22,32783661,0.48850323483126423,744,531,1275,-
chr22,32783667,1.9621920135938828,744,534,1278,-
chr22,32783709,2.027941176470588,590,509,1099,-
chr22,32784021,1.9684460773719472,758,660,1418,-
chr22,32789923,3.2278005464480874,726,487,1213,-
chr22,32789969,1.7871465295629818,631,388,1019,-
chr22,32791021,1.2890980747886318,985,759,1744,-
chr22,32791179,2.1429169282276628,930,530,1460,-
chr22,32792074,0.3859432708118385,2828,1817,4645,-
chr22,32793937,2.4751714677640604,693,485,1178,-
chr22,32795608,1.9597541726005614,1002,618,1620,-
chr22,32797837,0.5867850098619329,734,506,1240,-
chr22,32802741,0.7544935055343741,1008,726,1734,-
chr22,32804171,1.127155351936693,872,685,1557,-
chr22,32804172,1.127155351936693,872,685,1557,-
chr22,32808141,2.580486303477993,785,721,1506,-
chr22,32808142,2.580486303477993,785,721,1506,-
chr22,32808212,0.9472049689440992,548,482,1030,-
chr22,32808214,0.9472049689440992,548,482,1030,-
chr22,36002897,8.001977017743473,957,691,1648,-
chr22,36002898,8.001977017743473,957,691,1648,-
chr22,36136553,1.8354187084056441,486,592,1078,-
chr22,36136564,28.424635701275047,617,481,1098,-
chr22,36136789,2.740580132049326,690,420,1110,-
chr22,36138673,0.5977247295785154,640,382,1022,-
chr22,36234417,1.6916420845624387,758,564,1322,-
chr22,36234427,3.1521880415725145,1139,818,1957,-
chr22,36234428,2.5248042641058754,951,553,1504,-
chr22,36236458,7.080269614906424,607,479,1086,-
chr22,36677774,0.624439461883408,556,445,1001,-
chr22,36677781,1.6956521739130437,635,423,1058,-
chr22,36678020,1.408749713148142,665,447,1112,-
chr22,36678354,1.9457775105377415,689,538,1227,-
chr22,36680220,0.3916150255293611,732,432,1164,-
chr22,36681238,1.2567921571015597,638,542,1180,-
chr22,36681308,0.6368492605155106,1363,706,2069,-
chr22,36681309,1.2684742474468504,1399,979,2378,-
chr22,36681312,2.1349494888006926,1885,1134,3019,-
chr22,36681315,2.9938398357289526,728,486,1214,-
chr22,36681319,0.5793820355841217,1040,762,1802,-
chr22,36681320,0.5394804477360161,1671,1157,2828,-
chr22,36681326,1.1674508126603935,823,667,1490,-
chr22,36681328,1.2029408101749788,1892,1273,3165,-
chr22,36681973,4.900269541778975,908,370,1278,-
chr22,36681975,4.900269541778975,908,370,1278,-
chr22,36682780,0.42040505226480845,890,573,1463,-
chr22,36682782,0.42040505226480845,890,573,1463,-
chr22,36682881,2.412954464016661,709,456,1165,-
chr22,36682885,1.3991024055002812,1518,915,2433,-
chr22,36682887,2.273717567835215,819,458,1277,-
chr22,36684795,1.5635418304626818,666,509,1175,-
chr22,36684866,3.4188844539155556,666,455,1121,-
chr22,36685162,2.6072519083969463,827,523,1350,-
chr22,36685163,2.6072519083969463,827,523,1350,-
chr22,36691654,0.9597226807527235,683,465,1148,-
chr22,36691655,0.9597226807527235,683,465,1148,-
chr22,36693018,2.7267317388372385,1174,700,1874,-
chr22,36693019,2.8035043804755944,799,469,1268,-
chr22,36695024,2.6346345498944213,986,694,1680,-
chr22,36695066,2.021718067168607,900,613,1513,-
chr22,36696281,3.674374962040578,610,482,1092,-
chr22,36696996,2.4920454545454542,730,483,1213,-
chr22,36696998,2.4920454545454542,730,483,1213,-
chr22,36697058,1.3374358974358975,814,584,1398,-
chr22,36697059,1.5077850993442494,1184,775,1959,-
chr22,36697060,1.9147630522160466,1052,771,1823,-
chr22,36697652,4.701512021364377,874,649,1523,-
chr22,36700151,1.2787369574298664,2780,1635,4415,-
chr22,36700152,0.4950267846707533,2092,1058,3150,-
chr22,36700154,2.00772328479406,2427,1492,3919,-
chr22,36700155,2.00772328479406,2427,1492,3919,-
chr22,36700171,0.668329240843053,900,542,1442,-
chr22,36708151,0.43317759576227527,585,425,1010,-
chr22,36710360,0.47384615901549365,705,562,1267,-
chr22,36714342,4.787673204836823,747,447,1194,-
chr22,36716400,1.664499045987306,637,420,1057,-
chr22,36716870,2.202127659574468,689,422,1111,-
chr22,36745290,2.3538858049167324,765,387,1152,-
chr22,36745292,2.3723002266736786,986,546,1532,-
chr22,36863496,1.0031446540880502,637,527,1164,-
chr22,36863497,1.0031446540880502,637,527,1164,-
chr22,36863911,2.1859645870028737,785,468,1253,-
chr22,36863912,1.8983147705050218,1360,929,2289,-
chr22,36876623,3.6153069367449677,681,385,1066,-
chr22,36876699,1.806172839506173,664,404,1068,-
chr22,36876730,0.9940068493150686,601,583,1184,-
chr22,36876732,0.9940068493150686,601,583,1184,-
chr22,36907013,2.3142875263048146,2760,2121,4881,-
chr22,36907626,1.6834706580331862,2339,1847,4186,-
chr22,36907645,1.481027825855412,926,811,1737,-
chr22,36907669,1.5560478511298184,877,731,1608,-
chr22,36907689,1.664314516129032,888,650,1538,-
chr22,36908564,1.4279552350531441,2372,1730,4102,-
chr22,36908567,1.7962940387663051,841,630,1471,-
chr22,36908573,2.69712796710497,2053,1338,3391,-
chr22,36908623,2.054439324116743,1285,774,2059,-
chr22,36912550,2.1836324257425743,940,807,1747,-
chr22,36912555,2.142857142857143,954,763,1717,-
chr22,36912772,1.456515286435144,1401,1122,2523,-
chr22,36912779,1.7245516926555435,2862,2129,4991,-
chr22,36914883,2.3717315051020407,1265,783,2048,-
chr22,36915565,0.7187385405207187,1259,908,2167,-
chr22,36916625,2.298711814501288,843,714,1557,-
chr22,36919974,1.8278948420079533,2442,2024,4466,-
chr22,36920670,2.210646592283909,1494,1037,2531,-
chr22,36920673,2.2727143547332824,1453,950,2403,-
chr22,36922084,0.876495477642058,10538,6375,16913,-
chr22,36922086,1.0221858792191432,15217,9151,24368,-
chr22,36922087,1.5353360685790265,14148,9425,23573,-
chr22,36922088,1.5263995192535338,16403,10694,27097,-
chr22,36922089,1.7245281817487204,8850,6319,15169,-
chr22,36922090,1.5751846913272103,12874,8174,21048,-
chr22,36922091,1.5287032705862007,8737,5451,14188,-
chr22,36922097,1.399599378628076,1406,905,2311,-
chr22,36922157,3.39500792393027,901,630,1531,-
chr22,36922160,0.6571428571428573,769,538,1307,-
chr22,36925160,0.5630400445972312,807,457,1264,-
chr22,37577920,0.9503111935567211,800,574,1374,-
chr22,38686800,2.037869062901155,634,409,1043,-
chr22,38686929,2.0300982800982803,660,406,1066,-
chr22,38686987,2.3951612903225805,615,433,1048,-
chr22,38687128,0.72073732718894,815,650,1465,-
chr22,38687171,1.0442216981132075,692,423,1115,-
chr22,38687172,1.4833585614965958,860,541,1401,-
chr22,38687383,13.297501178689297,1281,706,1987,-
chr22,38687384,14.824912630619062,3072,1966,5038,-
chr22,38687385,14.824912630619062,3072,1966,5038,-
chr22,38687521,1.8389777524252788,1232,842,2074,-
chr22,38687547,2.041379310344828,607,579,1186,-
chr22,38687618,1.2281335522714834,862,608,1470,-
chr22,38687619,1.2281335522714834,862,608,1470,-
chr22,38687857,1.9531685930649667,890,771,1661,-
chr22,38687866,1.630565371024735,838,565,1403,-
chr22,38690141,1.7946745562130175,673,506,1179,-
chr22,38690229,1.4364131340630035,833,438,1271,-
chr22,38690239,2.2500969869390923,724,406,1130,-
chr22,38690252,0.27473226488383384,3681,2140,5821,-
chr22,38690253,0.27473226488383384,3681,2140,5821,-
chr22,38690377,3.4921607919261257,696,615,1311,-
chr22,38694918,2.2485207100591715,1119,727,1846,-
chr22,38695941,2.1136548869782534,1834,1266,3100,-
chr22,38695964,1.9302955109406719,795,571,1366,-
chr22,38696746,1.913638680550499,729,442,1171,-
chr22,38696781,1.6453586497890296,1417,710,2127,-
chr22,38696782,1.6453586497890296,1417,710,2127,-
chr22,38696856,1.6670004380749732,682,550,1232,-
chr22,38696875,1.6904388714733545,718,527,1245,-
chr22,38698869,2.348774509803922,1035,679,1714,-
chr22,38698905,1.4194202082746972,1181,968,2149,-
chr22,38698906,0.5624575878973058,1772,1222,2994,-
chr22,38698923,1.7147950089126558,961,611,1572,-
chr22,38699010,1.7563218390804598,763,434,1197,-
chr22,38699169,0.6157998998628557,831,646,1477,-
chr22,38699246,2.257289879931389,657,582,1239,-
chr22,38710091,1.5903665068085553,630,538,1168,-
chr22,38710097,1.8177511842433307,633,381,1014,-
chr22,38710099,1.1672272705943343,1084,886,1970,-
chr22,38710165,1.6571314293236394,5950,4505,10455,-
chr22,38710167,1.5501633224451703,8645,6428,15073,-
chr22,38710169,1.3096827868408436,12878,9267,22145,-
chr22,38710170,1.1753106736693044,13306,9033,22339,-
chr22,38710171,1.0755359498960642,16559,11439,27998,-
chr22,38710172,1.2716309533884345,9467,6696,16163,-
chr22,38710174,1.6952235772357724,2382,1639,4021,-
chr22,38713173,0.6711145996860285,1006,636,1642,-
chr22,38713174,1.660794044665013,2230,1239,3469,-
chr22,38713176,1.2145677578572986,3280,1796,5076,-
chr22,38713177,1.3092029264536005,2799,1483,4282,-
chr22,38713179,1.2743847967818005,1713,889,2602,-
chr22,38879691,1.7836284416427182,739,468,1207,-
chr22,38879901,1.954515272244356,840,501,1341,-
chr22,38879914,2.44549367437743,1412,920,2332,-
chr22,38879924,2.1759615384615385,656,467,1123,-
chr22,38880149,0.5550780690445496,774,536,1310,-
chr22,38880437,0.6642445425558009,1237,905,2142,-
chr22,38880588,1.5976470588235294,678,577,1255,-
chr22,38880713,0.5826330532212886,675,441,1116,-
chr22,38880997,1.9563492063492067,594,489,1083,-
chr22,38881048,2.006456820016142,677,412,1089,-
chr22,38881491,0.5069854028567948,939,1126,2065,-
chr22,38881507,0.5182195843105656,1086,1591,2677,-
chr22,38881508,0.5234087945952353,367,766,1133,-
chr22,38881511,0.5173187571921749,665,868,1533,-
chr22,38881520,0.4873792706897905,1545,1988,3533,-
chr22,38881521,0.4446016499940218,1664,2280,3944,-
chr22,38881523,0.30346829613558113,2016,3246,5262,-
chr22,38881524,0.30308877360867714,2093,3620,5713,-
chr22,38881526,2.9933208524390533,3304,5681,8985,-
chr22,38881527,4.498031812489714,3227,4980,8207,-
chr22,38881528,4.498031812489714,3227,4980,8207,-
chr22,38881531,20.915370344116358,2563,2120,4683,-
chr22,38881532,19.816715542521997,1430,836,2266,-
chr22,38881533,25.018570298861498,3951,2296,6247,-
chr22,38881534,41.43704571972824,2844,1295,4139,-
chr22,38881535,58.947692307692314,1235,199,1434,-
chr22,38881537,11.888201333274491,2844,265,3109,-
chr22,38881538,9.642880221371843,2269,237,2506,-
chr22,38881539,8.974660497048557,2346,195,2541,-
chr22,38881540,8.2734375,1058,95,1153,-
chr22,38881541,12.663060025680258,1430,137,1567,-
chr22,38881543,11.74105065056772,1331,142,1473,-
chr22,38881665,1.6715663256988957,1123,587,1710,-
chr22,38881690,0.38217244409395545,642,370,1012,-
chr22,38881818,1.914375169557431,1038,790,1828,-
chr22,38881819,2.332020324168644,961,751,1712,-
chr22,38881944,1.5311125078566938,579,429,1008,-
chr22,38882142,0.4745939882211967,1094,642,1736,-
chr22,38882143,0.4745939882211967,1094,642,1736,-
chr22,38882171,0.36901266682198963,753,544,1297,-
chr22,38882181,1.1992251649976322,847,611,1458,-
chr22,38882263,1.1977151815672469,1354,1009,2363,-
chr22,38882301,2.1598111476940334,814,680,1494,-
chr22,38882311,0.5397367576243981,1135,874,2009,-
chr22,38882313,0.8613841562204138,1997,1638,3635,-
chr22,38882314,0.5137537884254582,1046,844,1890,-
chr22,38882440,23.816035587585716,1664,1271,2935,-
chr22,38882441,17.851427498121712,940,483,1423,-
chr22,38882442,13.970893970893972,575,480,1055,-
chr22,38882443,4.945689997351175,1641,891,2532,-
chr22,38883984,0.5558953968496712,726,502,1228,-
chr22,38883988,1.936643653639762,1101,735,1836,-
chr22,38884026,2.6911480890076236,1289,877,2166,-
chr22,38884741,1.6368728898230187,572,470,1042,-
chr22,38885135,0.2794158564837265,1091,679,1770,-
chr22,38890115,1.7224155069582507,716,502,1218,-
chr22,38890133,2.868998750669284,642,430,1072,-
chr22,38890918,3.085690856908569,993,812,1805,-
chr22,38890919,3.2433893038650967,1718,1298,3016,-
chr22,38891038,1.6611650485436893,707,514,1221,-
chr22,38891866,1.0783920278986134,1603,1149,2752,-
chr22,38891903,1.2591818217623723,12305,6735,19040,-
chr22,38891904,1.3993284234870735,16783,9907,26690,-
chr22,38891920,1.292991247045079,3727,2475,6202,-
chr22,38891936,0.7107023411371237,2600,1793,4393,-
chr22,38891940,1.548514914783142,4951,3341,8292,-
chr22,38894101,1.4432887863483377,2697,1623,4320,-
chr22,38894137,1.5619884981198848,1201,821,2022,-
chr22,38894138,0.5999836461016396,1173,788,1961,-
chr22,38897248,3.1657209939346513,808,537,1345,-
chr22,38897249,3.1657209939346513,808,537,1345,-
chr22,38897250,3.1657209939346513,808,537,1345,-
chr22,38897263,3.4264786245531536,707,561,1268,-
chr22,39083060,1.7062362798068584,552,469,1021,-
chr22,39096276,0.26133958558949083,580,1232,1812,-
chr22,39096282,4.75222816399287,386,747,1133,-
chr22,39096283,7.712398720312637,1061,2133,3194,-
chr22,39096284,7.712398720312637,1061,2133,3194,-
chr22,39131150,2.704376773630212,582,1017,1599,-
chr22,39131151,7.453733892252756,472,1355,1827,-
chr22,39131152,9.64908444883127,3021,4886,7907,-
chr22,39131153,11.47877313360175,2716,4358,7074,-
chr22,39131154,12.263590782958858,2553,3824,6377,-
chr22,39131160,10.55781193455133,1351,668,2019,-
chr22,39131161,10.219890831506977,1217,594,1811,-
chr22,39131162,9.932285583560175,1445,663,2108,-
chr22,39131630,4.950975079080579,573,435,1008,-
chr22,39134217,1.3562689582495353,565,472,1037,-
chr22,39709244,1.340232846123624,8982,5569,14551,-
chr22,39709245,1.1950413644214786,10380,8110,18490,-
chr22,39709640,1.2830103139521705,12734,6884,19618,-
chr22,39709664,1.2268235649091046,11855,6317,18172,-
chr22,39710213,1.1331533963112912,1099,854,1953,-
chr22,39710727,1.1438743000586682,74463,57488,131951,-
chr22,39710781,1.194380176330033,34005,21741,55746,-
chr22,39710791,1.1117512073625757,27874,19243,47117,-
chr22,39710827,1.4777891306749145,12301,6583,18884,-
chr22,39711516,1.3464590371051306,21385,14138,35523,-
chr22,39711534,1.360749241416784,16285,11380,27665,-
chr22,39711535,1.2583767833063197,34511,23678,58189,-
chr22,39712751,1.5172368574425923,10309,7459,17768,-
chr22,39712754,1.773115596527196,9740,6812,16552,-
chr22,39712784,1.2270335905188894,9997,6393,16390,-
chr22,39713494,1.1344999282346857,26106,19332,45438,-
chr22,39713549,1.000937354960093,28635,22064,50699,-
chr22,39713593,0.8881027392634713,16396,10005,26401,-
chr22,39713625,1.2087296289540206,16559,13269,29828,-
chr22,39713628,0.8820431258456516,11363,8367,19730,-
chr22,39714454,1.3715987309193194,31580,20917,52497,-
chr22,39714455,1.3715987309193194,31580,20917,52497,-
chr22,39714473,1.2853997074974477,11943,6679,18622,-
chr22,39714475,1.3628017046917706,23560,14732,38292,-
chr22,39714477,1.525355958349402,8171,5185,13356,-
chr22,39714489,1.3342227358474532,4025,2028,6053,-
chr22,39714496,1.5873213951456917,3179,1550,4729,-
chr22,39714500,0.7288302724023171,2408,1341,3749,-
chr22,39714512,1.5335974755265205,2236,962,3198,-
chr22,39714513,1.0419870967741935,3442,2749,6191,-
chr22,39714514,1.2167350929183611,7134,5185,12319,-
chr22,39714515,1.8921689813131681,1963,808,2771,-
chr22,39714518,1.3908810546048256,1803,718,2521,-
chr22,39715625,1.5751329815057047,6453,5272,11725,-
chr22,39715627,1.4284236330163274,8907,7099,16006,-
chr22,39715628,1.0139269590454691,1844,1259,3103,-
chr22,39925374,3.4415408439798685,772,368,1140,-
chr22,39928444,0.7814732347233132,678,576,1254,-
chr22,39928458,0.5811390307149182,748,692,1440,-
chr22,41221732,1.998086734693877,963,671,1634,-
chr22,41221734,1.998086734693877,963,671,1634,-
chr22,41222337,2.4178306092124813,1355,672,2027,-
chr22,41222338,2.4178306092124813,1355,672,2027,-
chr22,41222339,2.5265017667844525,857,565,1422,-
chr22,41222344,2.1066875524092112,1259,836,2095,-
chr22,41222587,3.609486761199649,845,612,1457,-
chr22,41222612,2.1281512605042017,1012,611,1623,-
chr22,41222661,1.5030800821355237,1219,973,2192,-
chr22,41223173,3.8235066795624815,1322,958,2280,-
chr22,41223185,1.9290209790209796,612,389,1001,-
chr22,41223193,0.3975672215108835,620,425,1045,-
chr22,41223207,2.000462388637131,1040,582,1622,-
chr22,41226952,1.760401187573678,4216,2524,6740,-
chr22,41226954,1.7266464878405174,1630,870,2500,-
chr22,41231866,1.7207977434387567,1766,1013,2779,-
chr22,41252465,1.6160780280875406,1340,1072,2412,-
chr22,41252467,1.6160780280875406,1340,1072,2412,-
chr22,41252505,0.9994457133417054,1399,910,2309,-
chr22,41252506,1.5394944679345275,1486,843,2329,-
chr22,41641809,7.352875259849338,1312,917,2229,-
chr22,41641810,5.012373664889688,1103,783,1886,-
chr22,41641893,1.4370057133332,554,487,1041,-
chr22,41642016,5.603969913581564,956,486,1442,-
chr22,41642018,7.298045969023879,1448,854,2302,-
chr22,41642098,1.1279508546216939,751,528,1279,-
chr22,41650334,0.29997233621911823,665,703,1368,-
chr22,41650387,4.92148728731486,838,1145,1983,-
chr22,41650390,5.279685390804331,592,568,1160,-
chr22,41650456,11.612014768837732,936,627,1563,-
chr22,41650471,5.452349328763211,774,393,1167,-
chr22,41652211,2.205833967893596,696,525,1221,-
chr22,41657552,1.955755707625336,590,464,1054,-
chr22,41670610,2.622779408344488,629,462,1091,-
chr22,41855872,0.4019550342130987,513,494,1007,-
chr22,41855879,0.6115011202389843,533,514,1047,-
chr22,41855886,0.5493507369559174,1191,1231,2422,-
chr22,41855887,0.5299833780846439,828,868,1696,-
chr22,41855896,6.265082587023114,862,943,1805,-
chr22,41855898,5.91648472246267,1565,1853,3418,-
chr22,41855903,12.291055021594268,2529,1711,4240,-
chr22,41855904,12.749644534991173,2682,1760,4442,-
chr22,41855905,13.138020443855236,3321,1946,5267,-
chr22,41855907,11.285886988453642,1316,475,1791,-
chr22,41856180,2.756742556917688,953,570,1523,-
chr22,41856209,0.5826604334891627,913,542,1455,-
chr22,41856216,2.000907441016334,818,493,1311,-
chr22,41856224,0.5879681647940075,660,444,1104,-
chr22,41856225,0.5992359630419332,709,535,1244,-
chr22,41856351,1.784678857527878,1374,955,2329,-
chr22,41856424,0.5006366220083598,1101,852,1953,-
chr22,41856475,0.5402504472271914,754,519,1273,-
chr22,41863512,2.3125,554,509,1063,-
chr22,41864133,0.4546114742193173,625,458,1083,-
chr22,41864671,1.9141571423352222,700,412,1112,-
chr22,41928100,1.9193666282915776,1858,1478,3336,-
chr22,41928101,2.0312431328836205,2777,2034,4811,-
chr22,41928105,1.7971246006389776,849,625,1474,-
chr22,41928109,1.8759920634920637,792,545,1337,-
chr22,41928112,2.0271520866072987,748,497,1245,-
chr22,41928132,0.5593940371182479,1301,843,2144,-
chr22,41982151,1.6698895027624308,650,361,1011,-
chr22,41982154,1.6572504708097928,799,589,1388,-
chr22,41982192,2.237410469427359,1360,873,2233,-
chr22,41982193,1.8431771894093687,1447,981,2428,-
chr22,41982195,1.7828462817771442,937,620,1557,-
chr22,41999373,1.2246647537869968,728,549,1277,-
chr22,42000104,2.720438315005509,662,471,1133,-
chr22,42070238,3.093717773794786,703,511,1214,-
chr22,42070248,1.3495581286788412,685,464,1149,-
chr22,42070250,2.0662707468834216,919,604,1523,-
chr22,42070251,3.0943106225943477,1556,1005,2561,-
chr22,42070606,2.718309235838639,721,547,1268,-
chr22,42071003,1.4786427644771294,2944,2220,5164,-
chr22,42071019,1.5180776014109347,938,755,1693,-
chr22,42071028,2.0478855721393034,889,669,1558,-
chr22,42071193,1.3972579263067697,1577,1166,2743,-
chr22,42076341,1.7095593220338985,1575,1374,2949,-
chr22,42076353,1.493894138720404,3963,2948,6911,-
chr22,42076367,1.7160736196319017,998,814,1812,-
chr22,42078372,0.9074102564102563,822,749,1571,-
chr22,42078373,0.9074102564102563,822,749,1571,-
chr22,42078405,3.100872473205807,711,489,1200,-
chr22,42084810,2.076932463528011,1692,1222,2914,-
chr22,42084811,1.954248366013072,1156,800,1956,-
chr22,42084828,0.762571795691706,1125,779,1904,-
chr22,42084829,0.844430352990911,704,512,1216,-
chr22,42084850,1.5871972158578596,822,496,1318,-
chr22,42084852,2.3110810928580765,746,432,1178,-
chr22,42084854,2.8301033591731266,673,343,1016,-
chr22,42482250,1.735164051355207,953,700,1653,-
chr22,42482313,2.0,1294,924,2218,-
chr22,42483116,0.7667218927924371,4420,2342,6762,-
chr22,42483124,0.8080804989095918,3105,1771,4876,-
chr22,42483134,0.7684756683069903,4364,2722,7086,-
chr22,42483135,1.225928211493311,3756,2346,6102,-
chr22,42483148,1.2954792724666928,2559,1622,4181,-
chr22,42483150,0.7906632181092501,2663,1756,4419,-
chr22,42486675,2.026279956427015,646,407,1053,-
chr22,42486697,1.976470588235294,631,394,1025,-
chr22,43024261,1.2893288127801403,2520,1539,4059,-
chr22,43024262,1.0395197665145453,3910,3019,6929,-
chr22,43026892,1.4971150147454804,1111,708,1819,-
chr22,43026897,2.5192012288786483,655,464,1119,-
chr22,43026927,2.019322141273361,764,450,1214,-
chr22,43026937,2.3925382653061225,914,559,1473,-
chr22,43026938,1.5489826318099087,2864,1956,4820,-
chr22,43026940,1.612534865497303,3075,2025,5100,-
chr22,43026954,2.332780908186941,611,430,1041,-
chr22,43026981,0.8626660546598832,903,604,1507,-
chr22,43192811,3.2361372401955992,645,469,1114,-
chr22,43192814,2.055659779439726,782,590,1372,-
chr22,43193019,1.941162471223528,660,476,1136,-
chr22,43195135,2.4589986095666467,1716,1088,2804,-
chr22,43195136,2.4589986095666467,1716,1088,2804,-
chr22,43219687,2.6020336390230057,777,564,1341,-
chr22,43266911,1.7451677748569665,890,668,1558,-
chr22,43266939,0.4464925755248335,871,650,1521,-
chr22,43266976,2.2204979698719707,1902,1293,3195,-
chr22,43266977,2.2390808013219483,2186,1499,3685,-
chr22,43569808,2.7135646393141624,642,435,1077,-
chr22,43570558,1.0896498241346226,640,444,1084,-
chr22,43572362,3.6210072271323015,595,414,1009,-
chr22,43575966,1.8519636896372673,639,459,1098,-
chr22,43616509,1.2840685096949067,2348,1709,4057,-
chr22,43616526,1.5985790408525753,1319,1125,2444,-
chr22,43616527,1.4435688221152336,2013,1612,3625,-
chr22,44891008,2.3962626889418015,690,402,1092,-
chr22,47081150,0.5862640880194143,797,520,1317,-
chr22,50962146,1.539849871755653,660,466,1126,-
chr22,50962147,2.382818523950071,727,672,1399,-
chr22,50962148,2.3600011593950567,1667,1329,2996,-
chr22,50962149,3.2423367035788795,907,803,1710,-
chr22,50962150,3.4176,711,599,1310,-
chrX,322255,2.364238410596027,797,603,1400,-
chrX,322266,0.9417637373404686,872,696,1568,-
chrX,1505090,0.5795862068965517,954,724,1678,-
chrX,1505220,0.594147320285972,7869,7845,15714,-
chrX,1505233,0.7398995558562288,5175,4792,9967,-
chrX,1505244,10.813461900143178,16542,15764,32306,-
chrX,1505245,10.813461900143178,16542,15764,32306,-
chrX,1505252,6.974707059358254,16257,12287,28544,-
chrX,1505253,6.974707059358254,16257,12287,28544,-
chrX,1505343,1.3050478539505863,2829,2143,4972,-
chrX,1505435,0.6748338870431894,3249,2407,5656,-
chrX,1505437,1.2811875786454072,3385,2195,5580,-
chrX,1505438,1.2843782274413802,2219,2010,4229,-
chrX,1505447,1.2814434300563575,5016,3657,8673,-
chrX,1505495,1.2379115474376532,1688,1491,3179,-
chrX,1505501,1.3529250956806995,1413,1297,2710,-
chrX,1505508,1.4369393924376828,1317,1186,2503,-
chrX,1505522,1.4695544789588677,1903,1275,3178,-
chrX,1505606,0.6657337639696143,4379,3178,7557,-
chrX,1505612,1.439036638277358,2310,1523,3833,-
chrX,1505616,1.688983430362741,1587,1231,2818,-
chrX,1505642,1.4967081656213923,1498,1186,2684,-
chrX,1506225,0.5158486238532111,1322,1089,2411,-
chrX,1506227,1.3766233766233764,2066,1143,3209,-
chrX,1506266,1.5664845173041897,2039,1646,3685,-
chrX,1506293,1.5988395824829438,2030,1558,3588,-
chrX,1506294,1.27182160606104,2723,1702,4425,-
chrX,1508159,1.529075347944329,2940,1785,4725,-
chrX,1508171,1.2704443990981618,2950,1801,4751,-
chrX,1508235,1.3579435073796084,4735,3198,7933,-
chrX,1508243,1.2877098857426723,1905,1524,3429,-
chrX,1508319,1.342397942783671,2197,1829,4026,-
chrX,1508339,1.4871122915527526,7202,5232,12434,-
chrX,1508351,1.9731090287627595,1864,1482,3346,-
chrX,1508355,1.9788788014493344,2825,1594,4419,-
chrX,1508477,0.764456559417641,6930,4881,11811,-
chrX,1508478,0.764456559417641,6930,4881,11811,-
chrX,1508481,0.6512113461638841,3118,2272,5390,-
chrX,1508489,1.4767240457607185,2605,1989,4594,-
chrX,1508544,0.561832490163013,1998,1778,3776,-
chrX,1508559,1.3252105510666496,2817,1694,4511,-
chrX,1508607,1.4402573351487034,2166,1702,3868,-
chrX,1510807,1.8109651710973422,6887,4693,11580,-
chrX,1510808,2.011735941320293,4113,3271,7384,-
chrX,1510835,0.992183412451482,4219,3181,7400,-
chrX,1510837,1.3089204492713262,2867,1511,4378,-
chrX,1510873,0.7441335978835979,1906,1439,3345,-
chrX,1510960,1.3742632739239138,3654,1981,5635,-
chrX,1510961,1.4705090408268098,5412,3263,8675,-
chrX,1510963,1.6489119673063555,1758,1282,3040,-
chrX,1510980,1.7394799054373522,565,469,1034,-
chrX,1510998,2.75,967,415,1382,-
chrX,1510999,2.181057474732329,1176,824,2000,-
chrX,1511001,2.2584362139917697,783,539,1322,-
chrX,1511003,0.6872972424979725,595,410,1005,-
chrX,1511004,0.7979485363786787,1674,902,2576,-
chrX,13397467,0.6046099932568156,1778,1295,3073,-
chrX,13397468,0.8664544176632901,1742,1223,2965,-
chrX,15403222,1.6464251893939394,1986,1187,3173,-
chrX,15408328,2.3361877645736255,2082,1233,3315,-
chrX,15415574,2.178001952489424,581,438,1019,-
chrX,15415577,0.6578276980083373,740,507,1247,-
chrX,15415631,1.750346565847511,816,528,1344,-
chrX,15474037,0.5437666793747618,838,609,1447,-
chrX,15474126,1.5929632999696697,1143,1098,2241,-
chrX,15474127,1.7214132104454685,1647,1549,3196,-
chrX,15474129,1.637416366443644,1070,985,2055,-
chrX,15474142,1.3558232992039798,1342,1009,2351,-
chrX,15474144,1.8094565153388686,877,665,1542,-
chrX,15497933,2.431858407079646,686,451,1137,-
chrX,15497940,0.48056484102683233,1358,929,2287,-
chrX,15509362,2.020764750569765,664,358,1022,-
chrX,15509418,2.0089063552740627,930,615,1545,-
chrX,16863159,1.4592424506894743,1671,1347,3018,-
chrX,16863954,1.4407935214593346,1332,846,2178,-
chrX,16863963,0.614217224847377,1483,1100,2583,-
chrX,16867421,1.4743018867924529,1446,999,2445,-
chrX,16870920,0.5777186711166077,1262,880,2142,-
chrX,16870981,1.777472126510027,3834,2832,6666,-
chrX,16870982,1.6204245553643144,2148,1469,3617,-
chrX,16871897,1.4176341768631813,1482,991,2473,-
chrX,16876843,2.6180272108843536,1073,839,1912,-
chrX,16881121,1.9972240294946864,1000,794,1794,-
chrX,16881160,0.6861466881407061,1341,1002,2343,-
chrX,16887336,2.230916640051102,1015,807,1822,-
chrX,16888164,0.5852885412963621,858,581,1439,-
chrX,16888170,2.1201427879891446,1289,947,2236,-
chrX,16888190,0.5296989831873553,618,461,1079,-
chrX,16888347,2.0142857142857142,610,636,1246,-
chrX,16888348,1.3827884128540187,1006,1080,2086,-
chrX,16888394,0.5585337583309186,513,492,1005,-
chrX,16888408,0.5299136477004556,1247,1549,2796,-
chrX,16888422,0.4801497315218488,1530,1781,3311,-
chrX,16888423,1.9964516460857344,2719,3421,6140,-
chrX,16888425,4.252376091815734,3909,4059,7968,-
chrX,16888426,10.54964700466327,3237,2936,6173,-
chrX,16888427,10.77953040664739,2334,1855,4189,-
chrX,16888428,4.808659425680703,1133,610,1743,-
chrX,16888431,16.256602128442722,894,526,1420,-
chrX,16888433,6.680673326748223,1172,863,2035,-
chrX,16888434,4.553751952489163,908,677,1585,-
chrX,20145420,0.9440534584488521,663,520,1183,-
chrX,20145421,0.9440534584488521,663,520,1183,-
chrX,20145422,2.1668494877861435,787,536,1323,-
chrX,20145431,3.79428939351539,682,433,1115,-
chrX,20145728,1.7144261006289307,670,423,1093,-
chrX,20145794,0.5595799424019364,706,555,1261,-
chrX,20204480,1.4818589903688955,807,671,1478,-
chrX,23722010,3.651112155388471,678,462,1140,-
chrX,23748656,0.4293096070838121,717,499,1216,-
chrX,23748942,3.1514869556590477,766,496,1262,-
chrX,23876780,2.3708866383323213,912,613,1525,-
chrX,31138830,1.5909024536484164,604,463,1067,-
chrX,31139719,1.9947374153840833,1196,812,2008,-
chrX,31139777,3.7166388657214346,712,435,1147,-
chrX,31152262,2.175287356321839,756,611,1367,-
chrX,31152264,2.3927201862810286,1934,1433,3367,-
chrX,31152265,2.564814814814815,830,566,1396,-
chrX,31152266,2.458195236956299,1057,790,1847,-
chrX,31152268,2.680034656143284,1015,763,1778,-
chrX,31222134,2.3960019990005,921,689,1610,-
chrX,31222135,2.124364543128703,1482,1076,2558,-
chrX,31279117,2.650116426415707,734,537,1271,-
chrX,31279119,1.930511175171913,1106,720,1826,-
chrX,37699023,2.572211478962154,850,622,1472,-
chrX,37699889,2.0449722177023255,881,664,1545,-
chrX,37701152,2.6713660297334747,615,459,1074,-
chrX,38020297,2.1194384544294325,859,732,1591,-
chrX,38020298,2.178835978835979,1130,944,2074,-
chrX,38020299,2.305701498345982,1393,1141,2534,-
chrX,38020300,2.4994298745724057,1095,876,1971,-
chrX,38020301,3.083039215686275,1065,815,1880,-
chrX,39646212,1.7162037037037037,673,479,1152,-
chrX,39646213,1.7162037037037037,673,479,1152,-
chrX,39646214,1.430487594724948,878,637,1515,-
chrX,39646294,0.5084762352204212,1038,773,1811,-
chrX,39646297,1.476244343891403,869,883,1752,-
chrX,39646308,1.7507520357575788,3592,2445,6037,-
chrX,39646309,1.6399524375743164,2585,1681,4266,-
chrX,39646310,2.0176470588235293,1007,764,1771,-
chrX,39646320,1.289334741288279,1220,946,2166,-
chrX,39646321,1.289334741288279,1220,946,2166,-
chrX,39646322,1.6980571783097975,2996,1982,4978,-
chrX,39646323,2.0897058823529413,1420,815,2235,-
chrX,39646337,1.0298986486486486,870,443,1313,-
chrX,39646339,0.9773627120676085,1273,930,2203,-
chrX,47001797,1.6686131386861316,1015,821,1836,-
chrX,47001798,0.7228443062035598,1417,1285,2702,-
chrX,47003888,0.6284862231182795,1150,991,2141,-
chrX,47003901,1.4111276455026456,1312,839,2151,-
chrX,47003944,2.051726211957176,655,488,1143,-
chrX,47004086,0.3626006191950464,731,424,1155,-
chrX,47004090,1.1634143103677153,625,377,1002,-
chrX,47495305,5.8336750794125205,398,646,1044,-
chrX,47495306,7.762237762237762,449,584,1033,-
chrX,47495307,7.762237762237762,449,584,1033,-
chrX,47516668,1.345666165645354,1217,960,2177,-
chrX,47517218,1.8157055925818602,722,492,1214,-
chrX,47517235,2.3645484949832776,908,584,1492,-
chrX,47518268,2.1942257217847767,626,380,1006,-
chrX,47518282,1.524525465138132,1039,625,1664,-
chrX,47518283,2.076374693908305,2140,1474,3614,-
chrX,47518285,2.6979522184300344,743,585,1328,-
chrX,48750804,2.632124446339257,746,615,1361,-
chrX,48751474,1.3678175403225807,834,495,1329,-
chrX,48751475,1.3678175403225807,834,495,1329,-
chrX,48754122,2.2175730302271126,1637,1236,2873,-
chrX,48754123,2.449421965317919,1016,691,1707,-
chrX,48779623,3.0568961397508647,636,476,1112,-
chrX,48779624,3.0568961397508647,636,476,1112,-
chrX,48779995,4.1563644496754995,859,668,1527,-
chrX,48780004,2.068649885583524,677,398,1075,-
chrX,48780005,2.283375856633868,788,505,1293,-
chrX,48780483,4.749216300940439,706,405,1111,-
chrX,48780484,4.749216300940439,706,405,1111,-
chrX,48791750,1.804064606379362,1733,1764,3497,-
chrX,48791751,1.7899626600284495,1201,1405,2606,-
chrX,48791753,2.2569170263810823,1303,1290,2593,-
chrX,48929645,2.080696782239118,2978,2104,5082,-
chrX,48929651,1.9738515053376513,747,396,1143,-
chrX,48929657,1.80238964487222,861,654,1515,-
chrX,48929666,1.601964701964702,658,454,1112,-
chrX,48930098,2.732842189347729,770,424,1194,-
chrX,48932520,2.433409975712334,751,691,1442,-
chrX,48935751,4.255263487142773,723,523,1246,-
chrX,48970404,9.354858124396198,981,851,1832,-
chrX,48970405,10.217291753828086,894,813,1707,-
chrX,48970417,9.430085601954547,780,644,1424,-
chrX,48980083,0.8292282570745659,1483,1281,2764,-
chrX,48980084,1.0361052001224298,956,848,1804,-
chrX,53228021,0.8039867109634551,659,515,1174,-
chrX,53228022,1.3470207222925978,868,661,1529,-
chrX,53228023,0.8039867109634551,659,515,1174,-
chrX,53401712,3.534478808705613,531,484,1015,-
chrX,53401713,3.534478808705613,531,484,1015,-
chrX,53406390,0.47713502116803275,633,451,1084,-
chrX,53406510,2.5332280563232,769,446,1215,-
chrX,53406512,2.5332280563232,769,446,1215,-
chrX,53409254,1.0433333333333332,625,383,1008,-
chrX,53409255,1.4830732639626247,850,535,1385,-
chrX,53409580,1.6010558069381595,1350,727,2077,-
chrX,53410043,0.463095238095238,777,461,1238,-
chrX,53410052,0.3592162554426705,659,423,1082,-
chrX,53410139,3.489270671212233,590,440,1030,-
chrX,53410144,3.3588447486765256,761,608,1369,-
chrX,53421718,2.4118889984504857,1222,915,2137,-
chrX,53421755,2.62910284463895,800,456,1256,-
chrX,53421765,1.6859792071830322,1882,1055,2937,-
chrX,53421766,1.671104133511119,1316,693,2009,-
chrX,53421768,0.5681870669745959,756,432,1188,-
chrX,53423193,2.207289156457013,632,474,1106,-
chrX,53423479,3.0296766573158127,759,520,1279,-
chrX,53426525,2.07597645799893,775,533,1308,-
chrX,53426537,2.1281990333571037,789,600,1389,-
chrX,53430515,2.3055656212040563,685,478,1163,-
chrX,53430518,1.8789168867064132,728,485,1213,-
chrX,53430535,2.893612046389824,608,448,1056,-
chrX,53438782,1.9315463917525777,2341,1454,3795,-
chrX,53438783,1.9315463917525777,2341,1454,3795,-
chrX,53438784,1.9315463917525777,2341,1454,3795,-
chrX,53438827,0.4022031510183169,627,421,1048,-
chrX,53438845,0.3154589371980676,652,413,1065,-
chrX,53438846,0.3154589371980676,652,413,1065,-
chrX,53440008,2.4061617458279847,1583,1229,2812,-
chrX,53440011,1.8801888992537317,2980,2143,5123,-
chrX,53440012,1.6493838382117596,3538,2570,6108,-
chrX,53440023,2.3806555040969006,1214,801,2015,-
chrX,53440027,2.742069128787879,1129,703,1832,-
chrX,53440038,1.484035633484163,1362,1039,2401,-
chrX,53440041,3.033333333333333,874,499,1373,-
chrX,53440044,2.1015328019619863,835,465,1300,-
chrX,53440082,6.117712075158884,819,516,1335,-
chrX,53440192,2.5165596919127085,753,409,1162,-
chrX,53440206,2.696024464831804,695,326,1021,-
chrX,53449516,0.3291995069815248,1442,995,2437,-
chrX,53449517,0.3729885057471264,648,434,1082,-
chrX,53458333,1.1965728800760775,543,465,1008,-
chrX,53458334,0.9840745862515056,1102,772,1874,-
chrX,53458336,0.9840745862515056,1102,772,1874,-
chrX,53458972,1.74392523364486,621,427,1048,-
chrX,53460684,0.5382580091533181,578,436,1014,-
chrX,53460702,1.934610034677908,1020,670,1690,-
chrX,53566033,4.001556178026767,988,458,1446,-
chrX,64738012,4.534231844017596,985,906,1891,-
chrX,64738041,2.243229762638266,596,486,1082,-
chrX,64738045,5.2202010322836125,1124,857,1981,-
chrX,64749649,7.078245780058134,1092,950,2042,-
chrX,64753524,2.4244617414263634,556,459,1015,-
chrX,70279191,2.4819172882455964,659,535,1194,-
chrX,70279687,0.9341557019639349,765,632,1397,-
chrX,70279689,1.0366939552767573,769,565,1334,-
chrX,70280619,19.32333695750316,1283,513,1796,-
chrX,70280620,21.517910072894967,1524,526,2050,-
chrX,70280621,21.517910072894967,1524,526,2050,-
chrX,71492520,1.4023114760568507,31974,24248,56222,-
chrX,71493822,0.8618085505315642,4000,3059,7059,-
chrX,71493823,0.9908514952602344,1168,1037,2205,-
chrX,71494954,1.2431803556260022,34767,20393,55160,-
chrX,71495467,1.266094314488197,18947,12249,31196,-
chrX,71495497,1.2121318052714165,13039,10944,23983,-
chrX,71495546,1.2621537512980678,42725,30864,73589,-
chrX,71495548,1.4105961296681675,17875,13178,31053,-
chrX,71496024,0.8670808690965841,9853,7607,17460,-
chrX,71496060,1.205385934484208,39708,26902,66610,-
chrX,71496070,1.2682098323957571,47885,29252,77137,-
chrX,71496071,1.268209832395757,47885,29252,77137,-
chrX,71497065,0.9260068613865119,20204,10223,30427,-
chrX,71497067,0.9644518962776677,22670,10248,32918,-
chrX,71497068,1.061918181489018,18546,9323,27869,-
chrX,71497090,1.7679157549234137,833,456,1289,-
chrX,71497094,2.813511611541168,1998,666,2664,-
chrX,71497096,0.7593982420554428,3208,1391,4599,-
chrX,71497097,0.7787151556605789,6514,2758,9272,-
chrX,71497098,0.7593982420554428,3208,1391,4599,-
chrX,74293749,2.96336439888164,567,448,1015,-
chrX,76938321,1.9543147208121827,879,787,1666,-
chrX,76938323,1.9543147208121827,879,787,1666,-
chrX,76938324,2.599810067027055,720,538,1258,-
chrX,76938327,1.0196705188099335,714,580,1294,-
chrX,76938329,1.0196705188099335,714,580,1294,-
chrX,76938369,3.455852156057495,560,486,1046,-
chrX,76938370,3.455852156057495,560,486,1046,-
chrX,77084364,1.5664939672067384,655,406,1061,-
chrX,77084554,1.540144631176956,633,463,1096,-
chrX,77131033,1.1723261723261724,724,480,1204,-
chrX,77131034,1.1723261723261724,724,480,1204,-
chrX,79826561,2.0095045252380306,1100,697,1797,-
chrX,80370648,2.5860766961651915,706,564,1270,-
chrX,80370657,1.6052399435426958,586,435,1021,-
chrX,80370669,2.330372108811691,1571,1007,2578,-
chrX,80371729,3.1953840031834457,729,358,1087,-
chrX,80377075,4.191222570532916,763,463,1226,-
chrX,80377077,4.024412129470459,641,442,1083,-
chrX,86983521,0.8916658638928779,596,458,1054,-
chrX,99884805,0.39989458805491,1283,622,1905,-
chrX,99884957,0.5877905877905878,621,406,1027,-
chrX,99885763,0.9477781824804224,770,645,1415,-
chrX,99885765,0.9477781824804224,770,645,1415,-
chrX,99888959,2.863739837398374,713,614,1327,-
chrX,99888966,2.60121107266436,678,475,1153,-
chrX,100656659,1.725265616758345,847,576,1423,-
chrX,100656662,1.7310756972111552,789,501,1290,-
chrX,100656668,0.3957067114961851,679,406,1085,-
chrX,100662730,2.5864043242441697,769,525,1294,-
chrX,102508324,2.831818181818182,622,494,1116,-
chrX,102508325,2.831818181818182,622,494,1116,-
chrX,102508686,2.358734023128424,2152,1642,3794,-
chrX,102508688,2.358734023128424,2152,1642,3794,-
chrX,102508719,2.3712890625000003,1348,799,2147,-
chrX,102508721,2.184873949579832,2003,1168,3171,-
chrX,102508722,2.26658692185008,1321,759,2080,-
chrX,102508726,0.564580265095729,696,484,1180,-
chrX,102508847,1.9871269267281668,977,656,1633,-
chrX,102930603,1.4463469096105752,1950,1554,3504,-
chrX,102930627,1.2924639719284832,1752,1368,3120,-
chrX,102930660,1.3790153709066608,1271,1004,2275,-
chrX,102931255,1.6977781528409024,3610,2282,5892,-
chrX,102931574,1.2453907838523222,3406,2365,5771,-
chrX,102931603,1.409268054087316,1257,1038,2295,-
chrX,102931613,1.5342685830679632,1527,1290,2817,-
chrX,102931656,1.8621896810672325,1774,1371,3145,-
chrX,102931657,1.8621896810672325,1774,1371,3145,-
chrX,102933556,1.3667274312435604,1436,1022,2458,-
chrX,102940132,1.949540749290088,4772,3243,8015,-
chrX,102940137,1.7315978835978836,3718,2267,5985,-
chrX,102940138,1.7315978835978836,3718,2267,5985,-
chrX,102941572,1.614381631730509,6587,3599,10186,-
chrX,102941599,1.6408880666049952,3619,1879,5498,-
chrX,102941601,1.692029113229654,8203,4192,12395,-
chrX,102941603,1.75681845304252,9247,4461,13708,-
chrX,102941612,1.7132545311268716,1468,704,2172,-
chrX,102941623,1.6028842947840058,4551,2020,6571,-
chrX,102941626,0.9085112835750491,5645,2260,7905,-
chrX,102941627,0.9116536902093615,4592,1823,6415,-
chrX,102942971,0.4794016810712977,1072,645,1717,-
chrX,102942978,0.5869133732743546,671,613,1284,-
chrX,107327853,1.8540775802866616,1100,794,1894,-
chrX,107327858,2.876513317191284,647,412,1059,-
chrX,107330960,2.6808991753125837,694,536,1230,-
chrX,107330961,2.6808991753125837,694,536,1230,-
chrX,107331032,1.6572890025575449,647,475,1122,-
chrX,107331230,1.7665406427221173,622,528,1150,-
chrX,107331231,1.7409534226597392,763,476,1239,-
chrX,107331992,0.6087885738115096,686,435,1121,-
chrX,107332073,3.096774193548387,623,402,1025,-
chrX,108885348,2.073740034564236,704,540,1244,-
chrX,108885362,0.5557307683502865,618,482,1100,-
chrX,108885900,0.14520393306165147,1744,1081,2825,-
chrX,108885937,1.024566846384529,1195,782,1977,-
chrX,108886149,1.8834449760765553,756,474,1230,-
chrX,108902637,2.11712131086491,757,466,1223,-
chrX,108902674,2.2993559848989564,667,473,1140,-
chrX,108904863,2.338072669826224,887,632,1519,-
chrX,108904867,0.3695575221238938,782,564,1346,-
chrX,108906509,1.9740777666999,1187,884,2071,-
chrX,108906570,1.8425735797399043,672,486,1158,-
chrX,108906573,2.3780920819031834,854,496,1350,-
chrX,108906585,1.8787395293179094,784,435,1219,-
chrX,108906591,1.9677958421129884,1385,953,2338,-
chrX,108906592,0.3297220913801225,699,385,1084,-
chrX,108912375,1.959425882925384,855,710,1565,-
chrX,108912379,0.5193889541715628,779,554,1333,-
chrX,108912380,1.9280898876404493,714,444,1158,-
chrX,108912401,1.8624213836477985,720,423,1143,-
chrX,108921509,2.275489631336405,686,433,1119,-
chrX,108924594,1.7639492753623187,748,459,1207,-
chrX,108926106,1.9803037902242402,1206,847,2053,-
chrX,109441586,2.487894582268735,1210,542,1752,-
chrX,118673690,1.9077008042525285,1347,1072,2419,-
chrX,118673692,1.5406224125192771,2750,2050,4800,-
chrX,118673693,1.6436276442241184,1725,1263,2988,-
chrX,118673703,2.330780084660351,745,450,1195,-
chrX,118673725,2.0090782122905027,958,536,1494,-
chrX,118673727,1.3306749588439728,1398,769,2167,-
chrX,118673728,1.0326078028747432,897,486,1383,-
chrX,118786984,1.3757302672288394,1754,1216,2970,-
chrX,118786985,2.0188280140933252,1566,1270,2836,-
chrX,118786986,1.3698963875750718,2306,1811,4117,-
chrX,118786998,1.3327444593489617,815,534,1349,-
chrX,118797454,2.268272803004994,1074,762,1836,-
chrX,118797456,2.334285714285714,816,545,1361,-
chrX,118797534,2.327944572748268,671,432,1103,-
chrX,118797535,2.327944572748268,671,432,1103,-
chrX,118920520,1.6508651211061445,5552,4065,9617,-
chrX,118920521,1.6847516286644952,3677,3069,6746,-
chrX,118920524,1.0644012596598764,6633,5703,12336,-
chrX,118920542,1.8361837538574768,3181,2193,5374,-
chrX,118920553,1.529447453954496,5535,3549,9084,-
chrX,118920554,1.529447453954496,5535,3549,9084,-
chrX,118920556,1.353019500943594,3308,2509,5817,-
chrX,118920571,1.365954443521122,2329,1641,3970,-
chrX,118920574,1.4247542770572368,3246,1745,4991,-
chrX,118920576,1.3992335321590812,5196,3055,8251,-
chrX,118920580,0.6240462175713974,1144,694,1838,-
chrX,118920584,0.5063920901820014,1869,1184,3053,-
chrX,118920586,0.5063920901820014,1869,1184,3053,-
chrX,118920592,1.8498483929654337,1673,1454,3127,-
chrX,118920593,1.2160491850085435,3770,2896,6666,-
chrX,118920594,0.6560350218886803,2097,1442,3539,-
chrX,118920604,1.9396734680235959,1318,980,2298,-
chrX,118920605,1.5911486000709143,1789,1310,3099,-
chrX,118920606,1.9722034276932878,1760,1135,2895,-
chrX,118920607,2.885310927237055,1108,616,1724,-
chrX,118920611,1.2687831540474426,916,526,1442,-
chrX,118920615,0.4066227889757302,658,441,1099,-
chrX,118920617,0.8145126172233765,1684,988,2672,-
chrX,118925556,0.6532645436755027,951,802,1753,-
chrX,118925559,0.48148148148148134,1221,986,2207,-
chrX,118925570,0.2759113352242882,937,834,1771,-
chrX,118925591,1.051398101183509,1327,879,2206,-
chrX,118925592,1.0260582014221733,1815,1209,3024,-
chrX,118925594,0.9242112482853224,769,485,1254,-
chrX,118968378,3.3986928104575167,584,458,1042,-
chrX,118968380,3.3986928104575167,584,458,1042,-
chrX,118968945,3.4086088583905174,682,457,1139,-
chrX,118968947,3.4086088583905174,682,457,1139,-
chrX,118971785,2.5090803709428133,998,646,1644,-
chrX,118971834,1.525324205487839,928,677,1605,-
chrX,118972375,2.704440789473684,782,379,1161,-
chrX,118972376,2.704440789473684,782,379,1161,-
chrX,118972381,2.416489361702128,648,375,1023,-
chrX,118972441,1.1010436432637571,843,526,1369,-
chrX,118972443,1.1010436432637571,843,526,1369,-
chrX,119005202,1.6763814944005877,973,837,1810,-
chrX,119005203,1.6763814944005877,973,837,1810,-
chrX,119005206,1.5339146983714325,694,514,1208,-
chrX,119059140,2.184367554840974,562,456,1018,-
chrX,119070274,1.7639160320907938,4055,2381,6436,-
chrX,119070337,1.7728986053524312,817,378,1195,-
chrX,119070351,1.6094369547977796,1106,581,1687,-
chrX,119070362,1.7742955326460483,921,484,1405,-
chrX,119664068,2.2495228179767484,1851,1355,3206,-
chrX,119664070,2.074702077662835,2841,2044,4885,-
chrX,119664073,2.007439446366782,848,577,1425,-
chrX,119664076,1.5909735654416506,795,516,1311,-
chrX,119664084,0.5320978570771636,1196,785,1981,-
chrX,119664085,0.5320978570771636,1196,785,1981,-
chrX,119668437,3.5313644528493193,668,510,1178,-
chrX,119760085,1.1061342241117522,704,533,1237,-
chrX,119760086,1.1061342241117522,704,533,1237,-
chrX,119760863,2.2353720816368727,857,627,1484,-
chrX,122757034,2.056288320479754,574,458,1032,-
chrX,123460021,0.6181951937224129,2520,2038,4558,-
chrX,123460025,1.1343357566706052,7691,6775,14466,-
chrX,123460026,1.5845569298423203,4227,4518,8745,-
chrX,123460027,1.1084900599745475,10620,9224,19844,-
chrX,123460028,1.1577987689274072,7109,6241,13350,-
chrX,123460031,0.6881578947368421,4183,3695,7878,-
chrX,123460032,0.6881578947368421,4183,3695,7878,-
chrX,123460033,0.6921951792470469,5611,5019,10630,-
chrX,123460036,0.6392948923867653,548,565,1113,-
chrX,123460037,1.0236451431351252,1839,1597,3436,-
chrX,123460041,1.986038394415358,568,572,1140,-
chrX,123460056,1.059755505538638,648,497,1145,-
chrX,123460057,1.059755505538638,648,497,1145,-
chrX,128650319,1.6125297611260825,2769,2065,4834,-
chrX,128650320,1.9024937450166344,4022,2948,6970,-
chrX,128650322,2.262630198433817,2601,1878,4479,-
chrX,128650325,1.9212405631503773,1176,753,1929,-
chrX,128650336,1.7511579912864021,1031,622,1653,-
chrX,128650340,1.6351035581518851,932,537,1469,-
chrX,128650343,1.7313958333333332,2026,1199,3225,-
chrX,128650344,1.7313958333333332,2026,1199,3225,-
chrX,128650346,1.6790123456790125,849,404,1253,-
chrX,128650393,0.3997568662386153,751,378,1129,-
chrX,129263986,4.3950233281493,784,642,1426,-
chrX,129263987,3.6250896057347672,1166,929,2095,-
chrX,129263989,2.665409523809524,1146,874,2020,-
chrX,129263990,1.9649577443414163,1329,937,2266,-
chrX,129265747,0.8293838862559242,629,421,1050,-
chrX,129265748,0.8293838862559242,629,421,1050,-
chrX,129270116,1.9649267228961478,650,396,1046,-
chrX,129270649,1.282713948394796,576,448,1024,-
chrX,129273831,0.5255853213965747,1405,1033,2438,-
chrX,129273836,0.5611623876506389,818,576,1394,-
chrX,129274525,1.7629716981132075,584,423,1007,-
chrX,133700252,2.1490559186637617,622,611,1233,-
chrX,133700280,2.349934863212747,699,586,1285,-
chrX,133700281,2.349934863212747,699,586,1285,-
chrX,133905171,8.3738347101335,838,578,1416,-
chrX,134021961,1.2144822665889465,687,482,1169,-
chrX,134021995,3.7970873786407764,695,500,1195,-
chrX,134022318,0.8783295334482568,1169,733,1902,-
chrX,134022319,0.8783295334482568,1169,733,1902,-
chrX,134022365,2.6329942730748273,670,414,1084,-
chrX,134022683,0.643611513770967,739,438,1177,-
chrX,134022685,0.44553520330131874,2038,1258,3296,-
chrX,134023152,2.1834380471727264,730,510,1240,-
chrX,134023163,2.9827044025157234,812,476,1288,-
chrX,134023165,2.9827044025157234,812,476,1288,-
chrX,134030966,2.570117438437651,718,495,1213,-
chrX,134033492,1.076724181487707,714,524,1238,-
chrX,134185356,1.7798785784545625,795,512,1307,-
chrX,135328463,1.273229779452266,682,589,1271,-
chrX,135328466,2.154043645699615,838,778,1616,-
chrX,135328467,2.154043645699615,838,778,1616,-
chrX,135328473,1.9490282713272293,1098,692,1790,-
chrX,135328475,1.412609635845392,1957,1107,3064,-
chrX,135328476,1.1166225749559082,1012,503,1515,-
chrX,135328477,1.1166225749559082,1012,503,1515,-
chrX,135952089,3.2771930130242004,604,437,1041,-
chrX,135955712,2.377108134920635,660,503,1163,-
chrX,135955816,1.7097713097713103,770,554,1324,-
chrX,135956007,1.6902223025483465,667,502,1169,-
chrX,135956035,2.434520884520885,1042,739,1781,-
chrX,135956036,2.7490942028985508,606,459,1065,-
chrX,135956295,0.6073689673066944,615,469,1084,-
chrX,135956300,1.798886827458256,605,538,1143,-
chrX,135956543,3.2340011841244456,844,561,1405,-
chrX,135957427,2.495533980582524,713,514,1227,-
chrX,135957531,2.453198127925117,924,640,1564,-
chrX,135957635,1.7251320422535212,803,567,1370,-
chrX,135957640,2.160697887970616,723,483,1206,-
chrX,135957718,1.869542886492039,727,530,1257,-
chrX,135958665,3.016877637130801,571,473,1044,-
chrX,135958734,0.3172268907563025,905,713,1618,-
chrX,135958736,1.1249190885224314,2040,1352,3392,-
chrX,135958737,1.861585365853658,1135,639,1774,-
chrX,135961431,0.8368642632870618,1431,894,2325,-
chrX,135961540,1.3724151864485474,2517,1839,4356,-
chrX,135961541,1.1508558284283876,1848,1136,2984,-
chrX,135961542,0.9702148638100325,1727,1445,3172,-
chrX,135961543,1.1381163084702908,1661,1016,2677,-
chrX,135961544,1.185430463576159,1073,905,1978,-
chrX,135961545,0.8655462184873951,1029,628,1657,-
chrX,135961557,3.30319503362014,650,456,1106,-
chrX,138871533,2.912221883572082,734,385,1119,-
chrX,138871534,3.0598550758784753,1190,698,1888,-
chrX,138871553,3.0250605554425,623,385,1008,-
chrX,152966109,2.42765789579078,748,482,1230,-
chrX,152966112,2.6696515003386936,638,378,1016,-
chrX,152966115,2.661521388216304,850,412,1262,-
chrX,152966117,2.661521388216304,850,412,1262,-
chrX,152969493,1.1632130889306267,1160,843,2003,-
chrX,152981065,0.9832136746174329,1779,1284,3063,-
chrX,152986416,1.6865625,770,639,1409,-
chrX,152988661,2.15702479338843,719,483,1202,-
chrX,152989814,5.696391589628535,798,678,1476,-
chrX,152989836,1.0136361718166766,899,651,1550,-
chrX,153059790,0.38393506212155964,600,417,1017,-
chrX,153195596,4.206244232299126,885,615,1500,-
chrX,153195598,3.359333168938696,766,652,1418,-
chrX,153197539,1.525885558583106,769,733,1502,-
chrX,153197545,1.8796587337224966,1091,785,1876,-
chrX,153197842,2.637105751391465,617,384,1001,-
chrX,153197843,2.637105751391465,617,384,1001,-
chrX,153276130,2.3597466784512746,681,554,1235,-
chrX,153276224,2.903748430829075,708,516,1224,-
chrX,153276466,1.8239949743777935,856,579,1435,-
chrX,153279660,2.346046881207787,1180,838,2018,-
chrX,153279661,2.346046881207787,1180,838,2018,-
chrX,153279684,0.435761047463175,851,610,1461,-
chrX,153279686,1.139309429136445,1839,1207,3046,-
chrX,153279688,1.114356232003291,773,571,1344,-
chrX,153279694,1.6066746385675779,1132,690,1822,-
chrX,153279695,1.686188811188811,642,428,1070,-
chrX,153283554,0.4317414313403972,599,436,1035,-
chrX,153284166,2.1745125617054133,949,710,1659,-
chrX,153284167,2.231239077972872,1367,984,2351,-
chrX,153284169,2.194414820081368,1291,872,2163,-
chrX,153284170,1.8971359662345493,827,534,1361,-
chrX,153284179,0.5210211841390548,871,525,1396,-
chrX,153284180,0.5264118577544598,1122,683,1805,-
chrX,153284227,3.015307787832816,681,450,1131,-
chrX,153576962,19.439785311903112,4034,3861,7895,-
chrX,153576963,18.958034139054416,5356,4235,9591,-
chrX,153576964,18.958034139054412,5356,4235,9591,-
chrX,153576965,24.98889658557517,4003,2805,6808,-
chrX,153576969,15.91503267973856,973,152,1125,-
chrX,153576970,15.91503267973856,973,152,1125,-
chrX,153577036,0.37223099613411303,762,570,1332,-
chrX,153577286,2.488962472406181,549,452,1001,-
chrX,153577287,2.488962472406181,549,452,1001,-
chrX,153577342,2.136018543349844,1030,746,1776,-
chrX,153577395,0.5412715779236567,684,456,1140,-
chrX,153577398,2.3860364683301345,662,520,1182,-
chrX,153577736,0.4862852664576802,583,463,1046,-
chrX,153577738,0.4858988355167394,762,457,1219,-
chrX,153577867,1.2525156794624226,959,612,1571,-
chrX,153577870,2.00032934949025,915,631,1546,-
chrX,153578069,1.311003565290174,673,518,1191,-
chrX,153578151,2.765641903005498,865,716,1581,-
chrX,153578427,2.550277329935926,1074,719,1793,-
chrX,153579287,1.6066856401909972,1554,1074,2628,-
chrX,153579289,1.4241461204149553,951,849,1800,-
chrX,153579993,2.508662046908316,752,468,1220,-
chrX,153580048,1.5840642188196818,665,433,1098,-
chrX,153580054,1.9107065919862127,656,421,1077,-
chrX,153580730,1.9411764705882355,692,356,1048,-
chrX,153580736,1.5028522810347467,1055,605,1660,-
chrX,153580793,1.0390133421085348,2468,1503,3971,-
chrX,153580799,1.6071663721149225,2606,1968,4574,-
chrX,153580801,1.8403178760640515,2408,1925,4333,-
chrX,153580802,2.004974378569833,2313,1645,3958,-
chrX,153580812,1.9242636746143058,685,464,1149,-
chrX,153580813,1.6763537792346974,830,546,1376,-
chrX,153580942,0.6050508320589423,1196,763,1959,-
chrX,153580997,1.7521951219512195,897,655,1552,-
chrX,153580999,1.8875934602587983,1492,1016,2508,-
chrX,153581162,0.4193718379023125,1074,1022,2096,-
chrX,153581163,0.4691201494778285,739,696,1435,-
chrX,153581524,1.2597315132130402,619,514,1133,-
chrX,153581676,1.4996693287622505,1574,1275,2849,-
chrX,153581677,1.474110650371017,2524,1579,4103,-
chrX,153581678,1.474110650371017,2524,1579,4103,-
chrX,153581689,3.7689009252990298,834,632,1466,-
chrX,153581692,2.7736026795059656,802,561,1363,-
chrX,153581695,1.8597403323410615,1900,1036,2936,-
chrX,153581696,1.799760884248698,3333,1974,5307,-
chrX,153581698,1.725488568939048,1433,938,2371,-
chrX,153581745,0.4921052631578947,714,379,1093,-
chrX,153582303,2.6940076099873056,897,678,1575,-
chrX,153582398,1.854619454619454,711,454,1165,-
chrX,153582553,1.41221295217959,681,575,1256,-
chrX,153582607,1.817862165963432,1319,631,1950,-
chrX,153582608,1.817862165963432,1319,631,1950,-
chrX,153582765,2.0203175613222344,1333,807,2140,-
chrX,153582766,2.0796703296703294,756,475,1231,-
chrX,153583199,1.5097251888981067,777,519,1296,-
chrX,153585819,2.280327520483046,902,609,1511,-
chrX,153585863,2.0021639540689002,803,532,1335,-
chrX,153585923,1.847971744805354,956,556,1512,-
chrX,153585933,3.704738543079109,659,490,1149,-
chrX,153586621,1.3105059155296632,4476,3016,7492,-
chrX,153586622,1.7036527772379213,3102,1978,5080,-
chrX,153586632,1.9258480761370935,1063,518,1581,-
chrX,153586640,1.688029797071667,1010,457,1467,-
chrX,153586697,2.056974459724951,1395,1017,2412,-
chrX,153586698,2.056974459724951,1395,1017,2412,-
chrX,153586700,1.872853489221776,698,390,1088,-
chrX,153587515,1.6336684551595653,732,572,1304,-
chrX,153587870,0.9918224102092349,1015,704,1719,-
chrX,153587902,3.5860046119923004,813,511,1324,-
chrX,153587903,3.5860046119923004,813,511,1324,-
chrX,153588371,0.8457712720299448,2107,1375,3482,-
chrX,153588373,1.0607929849868087,1241,892,2133,-
chrX,153588386,2.651696129957,924,597,1521,-
chrX,153588387,1.9408018130090388,1330,941,2271,-
chrX,153588479,1.3091442297094331,727,502,1229,-
chrX,153588501,1.1588508026956208,822,601,1423,-
chrX,153588616,0.943188086045229,759,517,1276,-
chrX,153588617,1.3610044899941378,978,695,1673,-
chrX,153589800,2.424526762685619,834,589,1423,-
chrX,153589802,2.321534409160876,791,647,1438,-
chrX,153589862,1.2946903568557204,573,530,1103,-
chrX,153590370,0.3581242532855435,653,557,1210,-
chrX,153590372,0.3581242532855435,653,557,1210,-
chrX,153590808,2.2203309658848496,938,655,1593,-
chrX,153592481,0.3818542926212617,586,466,1052,-
chrX,153593232,1.4725847776709786,912,525,1437,-
chrX,153593290,2.684326710816777,759,452,1211,-
chrX,153593291,2.684326710816777,759,452,1211,-
chrX,153593569,2.4970997811349234,777,550,1327,-
chrX,153593788,2.9464656793895556,770,512,1282,-
chrX,153594411,2.756380510440835,593,430,1023,-
chrX,153594412,2.756380510440835,593,430,1023,-
chrX,153594804,0.3466855243378571,705,549,1254,-
chrX,153596424,2.386704036715866,903,653,1556,-
chrX,153596429,2.064686860414292,677,514,1191,-
chrX,153630754,0.9540314981827972,566,645,1211,-
chrX,153630755,0.9540314981827972,566,645,1211,-
chrX,153630765,6.470374089881999,620,1137,1757,-
chrX,153630767,14.226225087334692,2616,2891,5507,-
chrX,153630768,30.196099924474574,2301,2315,4616,-
chrX,153630769,14.80829747607732,1097,676,1773,-
chrX,153630771,14.355253424619418,2635,1198,3833,-
chrX,153630772,14.188158935380208,2584,1143,3727,-
chrX,153630773,16.518049776977975,1397,735,2132,-
chrX,153630776,16.04896633407341,3222,787,4009,-
chrX,153630777,16.429542629252595,3474,793,4267,-
chrX,153630778,19.425126475046063,3724,774,4498,-
chrX,153630779,17.83944931467569,1696,304,2000,-
chrX,153630780,20.90436936395835,1797,235,2032,-
chrX,153630782,9.666030534351144,1012,130,1142,-
chrX,153630783,8.996525878104826,1274,130,1404,-
chrX,153706188,2.319101551843654,576,438,1014,-
chrX,153712666,1.9127512856474984,921,743,1664,-
chrX,153712668,1.9127512856474984,921,743,1664,-
chrX,153712684,0.8271874684863357,768,418,1186,-
chrX,153712685,0.7376902513968601,1234,680,1914,-
chrX,153712688,1.4869005662470463,791,524,1315,-
chrX,153734712,4.258459043149366,576,453,1029,-
chrX,153734949,10.823006729466325,877,782,1659,-
chrX,153734950,10.823006729466325,877,782,1659,-
chrX,153734951,10.823006729466325,877,782,1659,-
chrX,153735229,3.2041538721823235,709,508,1217,-
chrX,153735580,1.9476490233443575,699,497,1196,-
chrX,153735810,1.462253829321663,692,456,1148,-
chrX,153735811,0.8746341582284952,637,405,1042,-
chrX,153736836,2.0518187561105634,847,477,1324,-
chrX,153736837,2.2094091392444333,995,630,1625,-
chrX,153759826,0.35513644810263373,856,831,1687,-
chrX,153759838,4.530838218204932,673,781,1454,-
chrX,153759840,8.106558477722729,1281,1264,2545,-
chrX,153759847,4.045729466002042,812,431,1243,-
chrX,153759849,3.241631657406153,735,313,1048,-
chrX,153759850,4.014491061088333,1048,387,1435,-
chrX,153759852,4.533820325835655,1032,342,1374,-
chrX,153760645,1.69641143734408,679,385,1064,-
chrX,153760860,1.4739267610661853,607,527,1134,-
chrX,153761199,2.003317325566519,650,441,1091,-
chrX,153761872,1.0810241543600059,870,594,1464,-
chrX,153762274,2.010832769126608,719,421,1140,-
chrX,153762307,1.8754427390791029,705,362,1067,-
chrX,153762663,2.6435967302452315,692,366,1058,-
chrX,153762696,1.954887218045113,688,370,1058,-
chrX,153775059,0.8635265735329672,579,555,1134,-
chrX,154774809,3.8783505154639175,626,484,1110,-
chrX,154774810,3.361694972254918,832,625,1457,-
chrX,154774811,3.361694972254918,832,625,1457,-
chrX,154774812,2.589748773518788,812,562,1374,-
