chromosome,position,rsr,t_read,c_read,total_reads,strand
chr2,271868,1.9081496629874022,1406,1035,2441,+
chr2,271890,0.6598360655737705,1034,719,1753,+
chr2,272123,1.8855101295219405,1446,968,2414,+
chr2,275146,0.719532126892858,1623,1180,2803,+
chr2,277307,2.307017543859649,788,398,1186,+
chr2,277360,2.0219460227272728,580,439,1019,+
chr2,277366,1.9896774193548383,770,619,1389,+
chr2,277396,0.48971618465960115,726,585,1311,+
chr2,277762,1.9525358559293207,1300,1009,2309,+
chr2,277777,2.131904761904762,813,599,1412,+
chr2,277786,1.4567335745127787,1018,778,1796,+
chr2,277792,0.6727825486732849,1866,1262,3128,+
chr2,277796,1.6336031588146558,2613,2036,4649,+
chr2,277804,1.5558284899660049,1125,828,1953,+
chr2,277807,2.078867341343038,1667,1542,3209,+
chr2,277812,2.043663925506912,5240,4085,9325,+
chr2,277919,1.9640601071975496,1000,652,1652,+
chr2,278103,0.5916666666666667,851,479,1330,+
chr2,3622883,0.8147787433822794,825,375,1200,+
chr2,3622884,1.0752812866956893,1156,666,1822,+
chr2,3622903,1.8562325766626842,2064,1133,3197,+
chr2,3622904,0.5754147542096423,1964,1371,3335,+
chr2,3622905,1.7739512549697682,3253,1797,5050,+
chr2,3622906,1.5297622594291842,2333,1290,3623,+
chr2,3622911,1.309708684882219,5869,4001,9870,+
chr2,3622912,1.3267013835415231,5022,3390,8412,+
chr2,3622915,0.7274260076922644,2814,2031,4845,+
chr2,3622919,1.3031674208144797,1427,1104,2531,+
chr2,3622921,0.6390429608713192,1490,1071,2561,+
chr2,3622922,1.1973158413231395,1906,1485,3391,+
chr2,3622934,1.5103065612428908,2221,1779,4000,+
chr2,3623191,0.7998350855493712,2812,2232,5044,+
chr2,3623200,1.4544541178152104,3116,1998,5114,+
chr2,3623205,1.3620207301412586,3393,2207,5600,+
chr2,3623269,1.5198625868075666,10325,7540,17865,+
chr2,3623458,0.8593732103771217,19481,11624,31105,+
chr2,3623460,0.8920336519652234,40282,25463,65745,+
chr2,3623462,1.094283383115474,28156,17756,45912,+
chr2,3624209,1.3869074473001428,11184,7523,18707,+
chr2,3625324,1.2513141755738568,4924,3950,8874,+
chr2,3625325,0.736934580426971,4290,2431,6721,+
chr2,3625337,2.0091499814824885,7149,3841,10990,+
chr2,3625338,0.6691146966095124,7086,5814,12900,+
chr2,3625341,1.3111341783216783,6057,3717,9774,+
chr2,3627697,0.7960863578347651,883,691,1574,+
chr2,3627698,0.7095459337608436,698,546,1244,+
chr2,3627754,1.3479385669396966,42924,27161,70085,+
chr2,3627755,1.2980747510984039,53681,36393,90074,+
chr2,9570999,2.5690511961169533,854,508,1362,+
chr2,9571000,1.87684745274031,1601,959,2560,+
chr2,9571002,1.5053034012054154,2684,1741,4425,+
chr2,9571003,1.3512043613388145,2246,1469,3715,+
chr2,9572639,2.0265939182045205,1363,950,2313,+
chr2,9583711,0.456394913986537,1016,572,1588,+
chr2,9583712,0.456394913986537,1016,572,1588,+
chr2,9583773,1.7966046511627909,2032,1499,3531,+
chr2,9583774,1.7966046511627909,2032,1499,3531,+
chr2,9621521,3.08168924908193,716,556,1272,+
chr2,10192704,1.8873649864874005,761,455,1216,+
chr2,10192716,3.5794443593606586,1023,662,1685,+
chr2,10263887,2.8566685113447705,711,555,1266,+
chr2,10263892,1.63915765509391,719,501,1220,+
chr2,10263921,1.6623376623376624,895,615,1510,+
chr2,10264855,0.4611964122833687,808,571,1379,+
chr2,10264926,2.248068924539513,657,395,1052,+
chr2,10264958,1.7057350363135486,972,725,1697,+
chr2,10267287,1.7726083082748636,1818,1475,3293,+
chr2,10267288,1.400458066155833,2802,2134,4936,+
chr2,10269221,2.0353256021409454,712,589,1301,+
chr2,10269488,1.6922269287860685,1086,836,1922,+
chr2,10269560,1.5176524530032094,992,726,1718,+
chr2,10269563,0.4088147095959596,796,575,1371,+
chr2,10269566,0.9335354102179244,2774,2077,4851,+
chr2,10269828,0.5307829375613659,1779,1284,3063,+
chr2,10269829,1.1635922052554895,2691,1856,4547,+
chr2,10271140,2.806892033742953,624,459,1083,+
chr2,10560030,2.2485799945445755,1054,772,1826,+
chr2,10560031,2.2145054945054943,686,524,1210,+
chr2,10560226,1.2655981649264423,654,411,1065,+
chr2,10563117,1.2576053528385005,742,477,1219,+
chr2,10563136,4.1256422058440725,641,517,1158,+
chr2,10567353,8.83988311591507,1685,1166,2851,+
chr2,10567354,8.83988311591507,1685,1166,2851,+
chr2,10567362,4.204993405607923,995,941,1936,+
chr2,10567363,3.166418691972011,755,701,1456,+
chr2,10567395,0.4519478844169245,636,683,1319,+
chr2,10567396,0.4519478844169245,636,683,1319,+
chr2,10567445,0.4331344331344331,616,461,1077,+
chr2,11965048,2.204600219058051,628,414,1042,+
chr2,15732050,4.117107637375644,1130,1216,2346,+
chr2,15732051,4.2411338757297345,2243,2405,4648,+
chr2,15732052,2.4163609959291312,2997,3196,6193,+
chr2,15732053,3.7813941698352345,642,788,1430,+
chr2,15732054,1.2022902856408864,1387,1502,2889,+
chr2,15732064,2.3922948848078898,654,669,1323,+
chr2,15735275,1.9383026731624275,868,775,1643,+
chr2,15735623,0.6152010906612134,759,488,1247,+
chr2,15735641,1.5524715833994187,838,678,1516,+
chr2,15735654,1.9452717391304348,872,735,1607,+
chr2,15743324,3.20656871218669,794,533,1327,+
chr2,15743971,0.532845668387837,742,580,1322,+
chr2,15743998,1.716849544355589,997,565,1562,+
chr2,15744561,2.513720882007327,1101,628,1729,+
chr2,15746095,2.088472715531159,692,488,1180,+
chr2,15747344,1.9595509328050191,912,672,1584,+
chr2,15757425,1.847091932457786,894,614,1508,+
chr2,15757436,0.9694258016405668,2599,1787,4386,+
chr2,15757437,0.9694258016405668,2599,1787,4386,+
chr2,15758339,1.5988966941130778,2613,1753,4366,+
chr2,15760374,2.228687296129772,789,596,1385,+
chr2,15760477,2.011583011583012,1041,776,1817,+
chr2,15763580,2.0093255368484724,926,762,1688,+
chr2,15769767,1.8413159506518504,1481,1038,2519,+
chr2,15769783,1.806830047896618,3962,2737,6699,+
chr2,15769784,1.806830047896618,3962,2737,6699,+
chr2,15770129,1.5999432140829073,1126,586,1712,+
chr2,15770217,1.9219600725952806,705,579,1284,+
chr2,15770907,0.6008253094910594,1013,726,1739,+
chr2,15770924,0.46817765567765574,817,623,1440,+
chr2,15770961,2.239402173913043,803,639,1442,+
chr2,15770993,1.654673553304583,984,766,1750,+
chr2,15771060,2.2161527165932453,1077,680,1757,+
chr2,20646837,1.0772358381802405,1724,1433,3157,+
chr2,20646838,1.0608784295159277,4173,3379,7552,+
chr2,20647290,1.7005961084242491,863,522,1385,+
chr2,20647301,1.9564079274458075,793,726,1519,+
chr2,20647503,1.4318971738680835,1618,1214,2832,+
chr2,20647506,1.502636945459646,1914,1409,3323,+
chr2,20647574,1.546742209631728,1039,705,1744,+
chr2,20647677,2.1137869223031385,877,653,1530,+
chr2,20647793,3.5315789473684207,670,360,1030,+
chr2,20647910,1.0725453408380237,734,491,1225,+
chr2,20647911,0.8370534298370983,992,705,1697,+
chr2,20648132,0.7727709190672154,592,485,1077,+
chr2,20648134,0.7727709190672154,592,485,1077,+
chr2,20648155,1.8646780303030304,678,329,1007,+
chr2,20648161,0.6182962503324173,836,388,1224,+
chr2,20648211,2.4860113624182656,891,490,1381,+
chr2,20648276,8.088150219965323,1350,297,1647,+
chr2,20648277,13.000000000000002,1182,285,1467,+
chr2,20648279,9.260301632427144,4252,734,4986,+
chr2,20648280,13.903769184661494,4870,786,5656,+
chr2,20648281,4.994181954863427,4634,701,5335,+
chr2,20648282,5.898029452127239,3745,571,4316,+
chr2,20648285,10.690625875189859,4528,806,5334,+
chr2,20648286,10.277529942376221,7997,1526,9523,+
chr2,20648287,9.733633136468015,11277,2407,13684,+
chr2,20648288,9.325422142581893,10268,2344,12612,+
chr2,20648289,9.24712892116697,8102,1958,10060,+
chr2,20648290,8.611796982167354,2043,728,2771,+
chr2,20648292,5.673305953224817,1385,539,1924,+
chr2,20648297,35.721001690832026,7228,3811,11039,+
chr2,20648298,30.921841620570035,8820,4860,13680,+
chr2,20648299,30.92184162057003,8820,4860,13680,+
chr2,20648300,24.556214333142837,4770,2709,7479,+
chr2,20648303,0.6070811744386874,702,578,1280,+
chr2,20648325,0.6035406698564594,741,759,1500,+
chr2,20648327,1.7873768263676522,793,653,1446,+
chr2,20648349,0.2853535353535353,564,479,1043,+
chr2,20648547,1.8034850684941155,1127,775,1902,+
chr2,20648561,2.235278552872125,1238,1093,2331,+
chr2,20648562,2.5219417933784913,5981,4334,10315,+
chr2,20648563,2.6056356828599965,4743,3241,7984,+
chr2,20648567,1.5068681318681318,1096,818,1914,+
chr2,20648575,2.0182476102016333,1468,956,2424,+
chr2,20648665,1.4012515311285083,2458,1706,4164,+
chr2,20648786,0.6856883001795666,2672,1877,4549,+
chr2,26257321,2.3550832825622736,703,522,1225,+
chr2,26257517,2.941871206356394,791,681,1472,+
chr2,26257578,0.5103066867772751,869,701,1570,+
chr2,26257581,0.550517614958671,979,732,1711,+
chr2,26257582,1.6744694132334583,579,533,1112,+
chr2,26257590,0.4349730605808402,661,616,1277,+
chr2,26332707,0.5892778023925564,664,487,1151,+
chr2,26350032,1.8998890737659455,883,600,1483,+
chr2,26357947,2.073921265257005,753,553,1306,+
chr2,26358040,2.0795604395604395,746,649,1395,+
chr2,26358094,1.2012943611295543,1388,995,2383,+
chr2,26358328,3.3009136721502315,776,524,1300,+
chr2,26359872,0.6997493734335839,1046,692,1738,+
chr2,26501490,1.566790715765006,986,690,1676,+
chr2,26501596,0.5262449981505767,625,430,1055,+
chr2,26501612,1.761643323996265,736,524,1260,+
chr2,26502129,2.7288,757,499,1256,+
chr2,26502131,2.7288,757,499,1256,+
chr2,26507797,0.4889486834518546,794,604,1398,+
chr2,26508411,1.9409282700421941,643,552,1195,+
chr2,26513061,2.1238476802189177,1244,923,2167,+
chr2,26513062,3.320024645717807,708,540,1248,+
chr2,26513178,1.838472834067548,625,453,1078,+
chr2,27009159,2.1170183166369356,783,508,1291,+
chr2,27015007,1.9549032878566592,1119,837,1956,+
chr2,27015008,1.891135996223536,1728,1300,3028,+
chr2,27015011,2.1157232704402515,637,529,1166,+
chr2,27016841,1.389753827214642,584,429,1013,+
chr2,27256975,2.3255994993236833,634,472,1106,+
chr2,27258582,5.847982776246469,587,418,1005,+
chr2,27259633,4.954315230108108,624,538,1162,+
chr2,27263796,0.684104407553089,595,480,1075,+
chr2,27435232,0.8186177312960875,1468,866,2334,+
chr2,27435233,0.8251113157053447,2344,1669,4013,+
chr2,27435234,0.8251113157053447,2344,1669,4013,+
chr2,27435311,0.6299059986432793,779,606,1385,+
chr2,27435332,2.1411764705882352,678,484,1162,+
chr2,27436054,0.6222044728434505,778,625,1403,+
chr2,27438378,1.5668137767869328,882,708,1590,+
chr2,27438513,1.4825337038131128,2313,1641,3954,+
chr2,27438518,1.6726109026704925,1485,984,2469,+
chr2,27438531,1.60377358490566,1019,847,1866,+
chr2,27439413,0.7587655660744944,3823,2713,6536,+
chr2,27439473,1.7984976525821597,1883,1064,2947,+
chr2,27439861,1.7303693142300738,1198,1026,2224,+
chr2,27439940,0.6215005599104142,739,751,1490,+
chr2,27439941,0.6263666947014297,2978,2377,5355,+
chr2,27439943,0.6263666947014297,2978,2377,5355,+
chr2,27439945,1.7547546941247731,782,634,1416,+
chr2,27439948,1.766233766233766,1183,776,1959,+
chr2,27448007,3.1685840707964603,1022,677,1699,+
chr2,27448008,2.359480046365292,1600,1097,2697,+
chr2,27448009,1.7634051962410173,1099,602,1701,+
chr2,27448010,2.1433505897049945,2794,1834,4628,+
chr2,27448012,2.0695001096688004,1804,1373,3177,+
chr2,27448013,2.0008496176720474,1883,1497,3380,+
chr2,27448015,1.8366795366795365,1277,1035,2312,+
chr2,27448017,1.7283372365339578,737,426,1163,+
chr2,27449754,2.0685397704788286,725,664,1389,+
chr2,27449755,1.7430896814689134,1074,881,1955,+
chr2,27597590,1.2428273569071673,788,548,1336,+
chr2,27599235,2.4690807460708837,685,437,1122,+
chr2,27599236,2.7243884686529247,709,497,1206,+
chr2,27599630,1.1511601697180274,1127,855,1982,+
chr2,27599631,0.3382820784729586,637,551,1188,+
chr2,27599817,2.9699588110866193,595,466,1061,+
chr2,27656247,1.8036058541726152,808,575,1383,+
chr2,27656255,2.8511656468225928,1441,1060,2501,+
chr2,27656256,3.1891178996442147,1060,740,1800,+
chr2,27656561,0.6259040105193951,615,506,1121,+
chr2,27660210,2.871217712177122,752,541,1293,+
chr2,27660211,2.871217712177122,752,541,1293,+
chr2,27664037,2.874418604651163,617,429,1046,+
chr2,27664039,2.874418604651163,617,429,1046,+
chr2,27873586,2.6865444776688387,715,459,1174,+
chr2,27917653,3.869771715580635,613,405,1018,+
chr2,27994602,1.388196817861037,1282,752,2034,+
chr2,27994603,1.3531444831616208,832,453,1285,+
chr2,27997302,3.61307509894151,779,633,1412,+
chr2,27997303,0.4399914043193295,584,453,1037,+
chr2,27997345,1.181989979783774,814,733,1547,+
chr2,27997346,1.4924643074175714,1558,1310,2868,+
chr2,28002442,2.7100628930817607,694,529,1223,+
chr2,28210924,4.043444270363513,672,508,1180,+
chr2,28248275,0.6451134509862079,724,612,1336,+
chr2,28460092,1.247251266422187,595,433,1028,+
chr2,28460094,4.137056994025846,788,580,1368,+
chr2,29124890,2.166183574879226,589,574,1163,+
chr2,29124892,2.166183574879226,589,574,1163,+
chr2,29135534,3.9868537885809174,681,570,1251,+
chr2,29145843,2.8712387878593497,634,460,1094,+
chr2,29152494,1.0176470588235291,864,524,1388,+
chr2,29152496,1.0176470588235291,864,524,1388,+
chr2,29169341,2.591253153910849,1026,696,1722,+
chr2,29169342,2.4358388303698533,1355,971,2326,+
chr2,29169997,3.018147684605757,688,469,1157,+
chr2,29169999,3.3072895216802967,1040,738,1778,+
chr2,29170001,2.8832684824902723,701,513,1214,+
chr2,29170892,0.30525970658765544,3421,2323,5744,+
chr2,29170893,0.30525970658765544,3421,2323,5744,+
chr2,29170898,2.6224107528925984,934,584,1518,+
chr2,30369913,6.822152676073357,677,377,1054,+
chr2,30379547,3.1792240300375467,976,469,1445,+
chr2,30379548,3.1792240300375467,976,469,1445,+
chr2,30379602,2.302207130730051,677,340,1017,+
chr2,30379637,1.145490264296693,1555,1017,2572,+
chr2,32515666,2.170684578579316,760,571,1331,+
chr2,32515691,1.808625,688,399,1087,+
chr2,32530622,1.1160687368103708,1233,748,1981,+
chr2,32530623,1.1160687368103708,1233,748,1981,+
chr2,32530797,2.2693865740740744,758,575,1333,+
chr2,32531067,1.73992673992674,645,441,1086,+
chr2,33141313,0.8182588100736096,847,539,1386,+
chr2,33141322,0.779583009870245,826,709,1535,+
chr2,33141326,0.7865100846552878,2795,2070,4865,+
chr2,33141467,0.8694893747505478,7431,5208,12639,+
chr2,36623801,0.4386309485478781,716,585,1301,+
chr2,36623802,0.4386309485478781,716,585,1301,+
chr2,36704171,2.240814922460212,606,414,1020,+
chr2,36726456,1.0508274231678485,888,563,1451,+
chr2,36726457,1.0508274231678485,888,563,1451,+
chr2,36749371,3.887674199031591,713,589,1302,+
chr2,36771524,1.300777679536831,619,472,1091,+
chr2,36775706,2.445182724252492,689,429,1118,+
chr2,36775741,2.0901085398320705,728,513,1241,+
chr2,36775755,1.802926829268293,615,409,1024,+
chr2,36775771,1.3362220963466982,3128,2103,5231,+
chr2,36775772,1.6294112830590357,2387,1592,3979,+
chr2,36775773,1.6294112830590357,2387,1592,3979,+
chr2,36775794,1.2872605801476478,4593,3484,8077,+
chr2,36775796,1.0633024164022455,2884,2409,5293,+
chr2,36775797,1.5488875978264582,1332,1008,2340,+
chr2,36775801,0.6615878107457899,1099,773,1872,+
chr2,36775803,1.8635720321081537,1648,1314,2962,+
chr2,36775813,1.2222222222222223,2111,1727,3838,+
chr2,36775822,1.5800574783912142,5224,4550,9774,+
chr2,36775823,1.5800574783912142,5224,4550,9774,+
chr2,36776156,55.9587482419128,2226,144,2370,+
chr2,36776157,62.23480371464753,2215,154,2369,+
chr2,36776158,50.78396757086206,2821,210,3031,+
chr2,36776159,46.58567415730337,1617,177,1794,+
chr2,36776160,67.16663689278634,2473,322,2795,+
chr2,36776161,58.39006702074611,2283,503,2786,+
chr2,36776162,21.76986067079898,1722,489,2211,+
chr2,36776164,12.964796945936708,1368,556,1924,+
chr2,36776170,10.952174305460392,2287,2182,4469,+
chr2,36776171,9.106241900851789,2113,2419,4532,+
chr2,36776172,3.7280906593406593,526,1119,1645,+
chr2,36776173,3.4262827644519604,400,976,1376,+
chr2,36776174,0.2888443721046701,768,814,1582,+
chr2,36776176,0.3681587712281913,1132,1130,2262,+
chr2,36776221,0.5357545680126325,474,571,1045,+
chr2,36776416,0.5213581599123768,594,414,1008,+
chr2,36776682,3.6167371208467136,1592,1175,2767,+
chr2,36777074,0.586889785108048,649,448,1097,+
chr2,36777494,2.224510551741673,672,436,1108,+
chr2,36777917,1.6123839009287926,839,645,1484,+
chr2,36777919,3.2522060332444083,565,442,1007,+
chr2,37324630,4.060975609756097,554,450,1004,+
chr2,37324631,4.060975609756097,554,450,1004,+
chr2,37324632,4.060975609756097,554,450,1004,+
chr2,37428200,3.166216216216217,780,591,1371,+
chr2,37428201,3.166216216216217,780,591,1371,+
chr2,37475367,2.2143796469576653,1268,1162,2430,+
chr2,37475368,2.2143796469576653,1268,1162,2430,+
chr2,37475373,1.5575179509163004,1467,1504,2971,+
chr2,37475375,1.5575179509163004,1467,1504,2971,+
chr2,37475377,2.3984851672627814,899,678,1577,+
chr2,39008836,2.8526403204483213,643,443,1086,+
chr2,46525024,1.0282257646583264,648,426,1074,+
chr2,46574101,4.142654723876588,784,513,1297,+
chr2,46602847,2.233552519036356,582,457,1039,+
chr2,46602919,1.1369036903690368,742,403,1145,+
chr2,46602921,1.3290229308623291,1012,625,1637,+
chr2,46603763,1.8817847512044643,909,591,1500,+
chr2,46605840,2.382608695652174,821,584,1405,+
chr2,46605841,2.382608695652174,821,584,1405,+
chr2,46609161,1.4861648545450248,560,457,1017,+
chr2,46611975,0.596624266144814,812,583,1395,+
chr2,46612371,1.0184971098265896,880,518,1398,+
chr2,46612372,1.0184971098265896,880,518,1398,+
chr2,46612627,0.5452302631578948,713,447,1160,+
chr2,46612740,4.309738002160618,643,519,1162,+
chr2,46612895,43.55884933871156,971,150,1121,+
chr2,46612897,17.603636363636365,751,274,1025,+
chr2,46612898,52.57647868724394,2288,1364,3652,+
chr2,46612899,52.57647868724394,2288,1364,3652,+
chr2,46612900,55.296921687366776,2104,1330,3434,+
chr2,46612921,0.9370796135502018,612,628,1240,+
chr2,46612922,0.9242258570840636,1005,970,1975,+
chr2,46613146,2.3841895165657614,591,461,1052,+
chr2,46613225,1.773206235669082,897,729,1626,+
chr2,46613430,2.122448979591837,662,440,1102,+
chr2,46808650,4.005270762200464,659,344,1003,+
chr2,46809504,3.4863704528919075,786,584,1370,+
chr2,46809770,2.3816610982814903,2113,1212,3325,+
chr2,46809771,2.591496232508073,1604,928,2532,+
chr2,46809790,2.277355317787466,1961,1638,3599,+
chr2,46809791,2.1160830377693456,2675,2035,4710,+
chr2,46809792,0.5988663435471946,809,517,1326,+
chr2,46809793,1.1758068816057654,1798,960,2758,+
chr2,46809794,1.7111501277236147,6604,5436,12040,+
chr2,46809795,1.6113747072077997,8402,6396,14798,+
chr2,46809796,1.7111501277236147,6604,5436,12040,+
chr2,46850997,2.2567811934900543,831,473,1304,+
chr2,46850998,2.2567811934900543,831,473,1304,+
chr2,46851430,1.7515616252704005,617,420,1037,+
chr2,47635554,2.840248145887284,614,480,1094,+
chr2,48010283,0.9952606635071091,739,421,1160,+
chr2,48010284,1.9312448858840032,1153,618,1771,+
chr2,48023111,1.813358302122347,580,444,1024,+
chr2,48023133,0.5013281815986477,691,403,1094,+
chr2,48023147,2.3461012311901506,734,515,1249,+
chr2,48026554,0.3238636932787771,608,457,1065,+
chr2,48026862,0.4898081534772183,816,555,1371,+
chr2,48026863,0.4898081534772183,816,555,1371,+
chr2,48027187,1.2909142313940505,775,509,1284,+
chr2,48033686,1.85,554,449,1003,+
chr2,54014506,0.8954836903738255,659,626,1285,+
chr2,54021550,2.238766228733245,841,558,1399,+
chr2,54023084,1.4423836780536263,1483,972,2455,+
chr2,54028608,2.5712220973181306,592,478,1070,+
chr2,54028615,0.5374864179645056,635,501,1136,+
chr2,54028704,0.4948735475051265,723,538,1261,+
chr2,54040183,1.9534883720930236,629,429,1058,+
chr2,54045115,2.1076688463478503,979,637,1616,+
chr2,54045406,1.6462715105162524,737,522,1259,+
chr2,54045822,1.0518234165067175,821,520,1341,+
chr2,54045823,1.0518234165067175,821,520,1341,+
chr2,54532076,4.017025185462714,692,446,1138,+
chr2,54855238,2.3820449145235036,1027,667,1694,+
chr2,54858428,1.067807623595715,828,494,1322,+
chr2,54858453,0.4630944888968803,908,680,1588,+
chr2,54858455,0.4630944888968803,908,680,1588,+
chr2,54858475,1.9218644067796613,781,471,1252,+
chr2,54871630,0.8449766666275205,1181,715,1896,+
chr2,54871632,1.4828159045238052,2008,1305,3313,+
chr2,54871633,1.887207542777325,1045,780,1825,+
chr2,54871709,1.5968393907397167,6415,3921,10336,+
chr2,54871711,1.5968393907397167,6415,3921,10336,+
chr2,54895915,5.951336628837296,1077,859,1936,+
chr2,54896455,2.878571428571429,779,419,1198,+
chr2,55459817,0.6463414634146342,835,417,1252,+
chr2,55459819,0.7767512605033169,1435,835,2270,+
chr2,55459822,0.9105169913147436,4891,2709,7600,+
chr2,55459823,0.9949622394918841,9970,5769,15739,+
chr2,55459825,0.5587570245895559,6303,3116,9419,+
chr2,55459827,1.3283635006915715,3724,2836,6560,+
chr2,55459828,1.3283635006915715,3724,2836,6560,+
chr2,55459829,1.2045553346651885,3998,2026,6024,+
chr2,55459834,1.1064688976977133,10606,6770,17376,+
chr2,55459900,1.3642629879759682,684,603,1287,+
chr2,55459957,0.757631036311396,10263,5694,15957,+
chr2,55459958,0.8577109905715384,7354,5996,13350,+
chr2,55459973,1.1855490186044702,12417,9556,21973,+
chr2,55460497,1.2023494860499266,551,453,1004,+
chr2,55460500,1.3956854035272444,24129,18702,42831,+
chr2,55461252,0.98591394251092,648,603,1251,+
chr2,55461253,0.8672458309119117,1508,1037,2545,+
chr2,55462613,1.3530394283769405,42405,28434,70839,+
chr2,55756074,1.1762649115590291,816,441,1257,+
chr2,55756075,1.1762649115590291,816,441,1257,+
chr2,55756123,3.4084848484848487,702,494,1196,+
chr2,55761037,1.550726050092584,815,661,1476,+
chr2,55761068,2.242494082471658,972,697,1669,+
chr2,55761071,2.2496836243988865,612,438,1050,+
chr2,55761074,1.2795389252876266,1837,1384,3221,+
chr2,55761077,2.0390907841918127,2616,2316,4932,+
chr2,61405902,1.9777268143054738,845,556,1401,+
chr2,61405927,2.255414763518491,784,616,1400,+
chr2,63182750,1.014911463187325,791,463,1254,+
chr2,63182752,1.4984124344805823,1171,691,1862,+
chr2,63816101,0.6988790037272835,1470,642,2112,+
chr2,63816104,1.9785239087290911,1252,584,1836,+
chr2,63816109,2.471266067276586,882,444,1326,+
chr2,63816110,2.1799400074990625,1236,634,1870,+
chr2,63816111,2.1799400074990625,1236,634,1870,+
chr2,63816112,1.9870472450006782,1908,928,2836,+
chr2,63816114,3.268449370685685,931,567,1498,+
chr2,63816115,1.9451002227171494,1202,594,1796,+
chr2,63816123,1.7429951690821257,879,449,1328,+
chr2,63816137,1.5807555909068938,2497,1506,4003,+
chr2,63816138,1.5807555909068938,2497,1506,4003,+
chr2,63816152,1.4876149660008275,2481,1761,4242,+
chr2,63816153,1.4876149660008275,2481,1761,4242,+
chr2,63821661,1.3778913703786524,3656,2654,6310,+
chr2,63821669,1.9634551495016608,1181,902,2083,+
chr2,63822589,1.9669421487603305,1119,879,1998,+
chr2,63824658,0.9830005664531274,1809,1438,3247,+
chr2,63824660,0.9830005664531274,1809,1438,3247,+
chr2,63824684,1.3417516439531114,2222,1498,3720,+
chr2,63826327,1.5332003988035892,1397,1179,2576,+
chr2,63831839,1.4694052203679933,1716,1082,2798,+
chr2,63831931,1.3823301572546285,1603,1323,2926,+
chr2,63832450,0.6175580221997982,1223,990,2213,+
chr2,63832489,1.1818284420607201,3447,2713,6160,+
chr2,63833076,0.6879816451852353,1415,1014,2429,+
chr2,63833094,1.622777777777778,888,629,1517,+
chr2,63834163,1.5270843362446416,3027,1964,4991,+
chr2,64085042,2.0543607750566095,783,655,1438,+
chr2,64112774,2.2559094125973105,612,470,1082,+
chr2,64112791,1.7691346808993866,576,517,1093,+
chr2,64114616,2.2116152450090745,676,434,1110,+
chr2,64118287,3.1953321364452427,808,556,1364,+
chr2,64118600,1.8000606591629036,1186,801,1987,+
chr2,65454979,1.431964122981518,660,604,1264,+
chr2,65473731,0.6102564102564102,692,494,1186,+
chr2,65473820,1.3958915765163489,637,432,1069,+
chr2,65482680,1.6556552962298023,794,556,1350,+
chr2,65482797,1.902757619738752,873,529,1402,+
chr2,65482822,1.4756161055189168,894,669,1563,+
chr2,65488490,1.8430622009569382,641,474,1115,+
chr2,65492216,1.6715981735159815,703,437,1140,+
chr2,65495737,2.1551985936675098,1051,805,1856,+
chr2,65495812,2.759047045569728,1230,863,2093,+
chr2,65495821,0.616742239274503,841,609,1450,+
chr2,65496284,9.671104950014108,1776,486,2262,+
chr2,65496285,8.143675914450059,986,248,1234,+
chr2,65496290,5.929523809523809,848,209,1057,+
chr2,65496291,10.002090253810138,1778,508,2286,+
chr2,65496294,60.21702932778038,2642,2321,4963,+
chr2,65496295,60.217029327780374,2642,2321,4963,+
chr2,65496316,2.6269941800375696,1204,1535,2739,+
chr2,65496446,19.924908424908427,1418,116,1534,+
chr2,65496447,37.608081990119544,2852,409,3261,+
chr2,65496448,36.75402807824422,5911,1276,7187,+
chr2,65496449,34.03104892003137,5917,1368,7285,+
chr2,65496450,22.878206683092174,6380,1762,8142,+
chr2,65496451,28.046842325386866,2394,796,3190,+
chr2,65496452,17.891549946625425,5502,3433,8935,+
chr2,65496453,18.477091016702218,4906,3937,8843,+
chr2,65496454,18.229788946658154,4429,3813,8242,+
chr2,65496464,11.869093541085752,1703,2538,4241,+
chr2,65496467,3.8405795750162985,1314,1976,3290,+
chr2,65496478,0.1463657484234981,440,654,1094,+
chr2,65496490,0.3636698939603504,492,722,1214,+
chr2,65496497,0.38860814221532464,1488,2294,3782,+
chr2,65496589,0.4627926421404683,737,519,1256,+
chr2,65496647,1.5679503729202524,1197,1161,2358,+
chr2,65496656,2.108540925266904,1105,842,1947,+
chr2,65496666,1.6905405405405407,1250,1035,2285,+
chr2,65496990,1.675389675389675,807,517,1324,+
chr2,65497105,1.6013585226066651,942,672,1614,+
chr2,65497223,2.749510763209393,561,510,1071,+
chr2,65497360,0.373245744998507,624,393,1017,+
chr2,65497403,1.889466707453859,544,466,1010,+
chr2,65498143,2.584650112866817,686,442,1128,+
chr2,65498186,1.6703252032520326,586,491,1077,+
chr2,67630825,1.1686529129820329,633,455,1088,+
chr2,68402013,4.335340079934182,551,467,1018,+
chr2,69240728,2.6104238230904895,690,350,1040,+
chr2,69240736,6.134111455041702,1964,1781,3745,+
chr2,69240737,6.134111455041702,1964,1781,3745,+
chr2,69240738,6.077022672429377,1503,1359,2862,+
chr2,69240758,1.444504359623027,629,679,1308,+
chr2,69267201,0.5265827922077922,864,703,1567,+
chr2,69267203,0.4812270842715773,1196,1003,2199,+
chr2,69267212,1.4815274830663967,780,578,1358,+
chr2,69473801,1.2573045056983834,608,421,1029,+
chr2,69474259,3.0047425255080586,693,524,1217,+
chr2,69475259,0.5055224791340943,892,703,1595,+
chr2,69476100,0.4214748100197016,598,417,1015,+
chr2,69476399,2.822808819087889,751,453,1204,+
chr2,70122242,1.422352295591732,719,496,1215,+
chr2,70122259,1.3307949454453445,847,609,1456,+
chr2,70123571,1.4675680744268496,594,482,1076,+
chr2,70132150,2.4193917414756783,595,447,1042,+
chr2,70314855,2.4993774313487878,694,493,1187,+
chr2,70314889,1.507748091632824,1685,1180,2865,+
chr2,70314891,0.4626451459120781,936,752,1688,+
chr2,70314892,0.8117236680020373,2798,1948,4746,+
chr2,70314894,0.770610944526154,2862,1961,4823,+
chr2,70314902,1.704438149197356,1082,705,1787,+
chr2,70314965,0.5640579710144928,555,459,1014,+
chr2,70315016,2.1630564578032985,1755,1123,2878,+
chr2,70315017,1.8606829268292684,893,614,1507,+
chr2,70315079,1.5986800933037493,1123,836,1959,+
chr2,70315166,0.5721985607284477,1923,1237,3160,+
chr2,70315167,1.0091862159507237,3496,2009,5505,+
chr2,70315175,1.7805255023183928,1055,646,1701,+
chr2,70315193,1.5576954304393524,4973,2826,7799,+
chr2,70315279,1.982488641806835,1299,834,2133,+
chr2,70315357,2.1373163374525643,1233,1194,2427,+
chr2,70315358,1.9191968132602795,1995,1674,3669,+
chr2,70315371,1.8517455762792925,967,614,1581,+
chr2,70315409,1.72275641025641,2724,1416,4140,+
chr2,70315427,1.4083073360616907,16133,8992,25125,+
chr2,70315428,1.345559498777404,23065,12889,35954,+
chr2,70315429,1.3904252114799347,15837,8215,24052,+
chr2,70315430,1.570375153067994,19136,11289,30425,+
chr2,70315538,1.3251332551501234,1172,884,2056,+
chr2,70315543,1.1748137368634524,1073,775,1848,+
chr2,70315552,2.2053097345132744,622,451,1073,+
chr2,70315579,0.7495041261601,1154,841,1995,+
chr2,70315706,1.3320951174897988,1463,926,2389,+
chr2,70315893,1.2434480171519793,2372,1566,3938,+
chr2,70315899,1.4823067536739347,1523,926,2449,+
chr2,70315963,1.460868198887597,4347,2879,7226,+
chr2,70315965,1.4219141048838062,4511,3141,7652,+
chr2,70315990,2.017065444630123,3130,2450,5580,+
chr2,71297632,5.493478224580575,1044,682,1726,+
chr2,71297633,5.8592017646761825,1295,890,2185,+
chr2,71297634,5.859201764676183,1295,890,2185,+
chr2,71368383,2.2409933558411597,578,432,1010,+
chr2,71591111,0.7930186604489563,787,471,1258,+
chr2,71653948,0.3858687126805641,638,381,1019,+
chr2,71654020,0.5501427604273983,889,640,1529,+
chr2,71658544,3.283422063543942,982,541,1523,+
chr2,71658546,2.441489361702128,713,375,1088,+
chr2,71660333,1.785385348535835,929,783,1712,+
chr2,71660338,1.8934882515782574,1519,1315,2834,+
chr2,73118596,0.9716755782021667,665,488,1153,+
chr2,73461417,0.8143204824842478,751,419,1170,+
chr2,73461441,1.5392011921667093,994,572,1566,+
chr2,73461457,0.817907949790795,1085,716,1801,+
chr2,73461458,0.817907949790795,1085,716,1801,+
chr2,73461465,1.5797273266152934,779,481,1260,+
chr2,73461468,1.8181818181818183,647,461,1108,+
chr2,73461490,1.7100551263286212,1135,861,1996,+
chr2,73461491,0.6874953945914082,932,661,1593,+
chr2,73461501,3.051186017478152,610,533,1143,+
chr2,73461502,0.6035042180402336,1208,870,2078,+
chr2,73466780,1.458989898989899,1255,899,2154,+
chr2,73470171,1.685754985754986,1648,1169,2817,+
chr2,73470177,1.821123882503193,1717,1304,3021,+
chr2,73470178,0.6489841306352767,5667,3363,9030,+
chr2,73470186,1.5745729199620373,6032,3160,9192,+
chr2,73470187,1.4977014237236288,7996,4706,12702,+
chr2,73470219,1.364485254161585,7780,4767,12547,+
chr2,73471689,1.6643835616438356,1196,1021,2217,+
chr2,73471730,0.5911254359590994,3284,2605,5889,+
chr2,73474947,1.4603174603174602,1103,863,1966,+
chr2,73474961,1.4801026957637995,1152,892,2044,+
chr2,73474962,1.33729038022753,1821,1606,3427,+
chr2,73474989,2.0457899208514063,1499,1176,2675,+
chr2,73476163,1.642877252252252,2121,1535,3656,+
chr2,73476233,1.6778310832099779,3505,2385,5890,+
chr2,73476235,1.4290031284308908,8331,5670,14001,+
chr2,73476236,1.7640652894669728,3681,2613,6294,+
chr2,73476239,1.706659237706102,2164,1670,3834,+
chr2,73476291,0.7274953437366969,4396,2893,7289,+
chr2,73478401,2.009894867037724,909,685,1594,+
chr2,73478402,1.5882267742602938,1300,1073,2373,+
chr2,73478427,1.557241062287135,1095,902,1997,+
chr2,73479784,2.043833580980684,916,672,1588,+
chr2,73479794,1.6549141965678629,883,640,1523,+
chr2,73479815,1.753026372676178,992,770,1762,+
chr2,73479984,1.8514555468135327,953,464,1417,+
chr2,73479987,2.937559762860967,990,497,1487,+
chr2,73480005,0.4869970069837047,522,484,1006,+
chr2,74185329,1.6035978939157565,888,640,1528,+
chr2,74185960,3.113686291739894,858,568,1426,+
chr2,74185961,3.113686291739894,858,568,1426,+
chr2,74185986,1.1632181113564848,998,723,1721,+
chr2,74425767,1.3624883100413645,794,453,1247,+
chr2,74425779,1.7238805970149256,692,401,1093,+
chr2,74425784,1.5156250000000002,872,503,1375,+
chr2,74425785,0.6857239731335572,1088,783,1871,+
chr2,74432872,1.606972445514336,732,540,1272,+
chr2,74432899,2.114624505928854,1069,551,1620,+
chr2,74432935,2.115790881133841,1031,830,1861,+
chr2,74432944,1.590870340230954,1578,934,2512,+
chr2,74432959,1.4843958201837435,1113,872,1985,+
chr2,74432969,1.459136432350718,1382,1175,2557,+
chr2,74435833,1.6638385020479813,2067,1708,3775,+
chr2,74437085,2.0579815216580606,8726,6780,15506,+
chr2,74438348,0.6288721640488657,1773,1527,3300,+
chr2,74438889,1.5979507569964828,1934,1508,3442,+
chr2,74441214,0.6923875762510605,6645,4685,11330,+
chr2,74441300,1.4560138812209165,2563,2044,4607,+
chr2,74441412,1.3791679404998771,2547,1648,4195,+
chr2,74441557,1.409961685823755,2131,1598,3729,+
chr2,74441582,1.3173016864459717,2070,1600,3670,+
chr2,74441819,1.5511576727522538,3347,2296,5643,+
chr2,74441885,1.373183600644983,3467,2571,6038,+
chr2,74442230,1.6906614785992218,1579,1284,2863,+
chr2,74760016,3.3409346394732617,742,478,1220,+
chr2,74760017,3.0620760722006737,779,468,1247,+
chr2,74760031,2.368587327550088,602,451,1053,+
chr2,74760069,1.6936427007719783,1098,1051,2149,+
chr2,74760070,1.8695622743682305,1690,1661,3351,+
chr2,74760072,2.195615141257937,1153,1158,2311,+
chr2,75081426,0.8196838876313477,623,421,1044,+
chr2,75113720,6.3066962661877515,1154,1019,2173,+
chr2,75113721,6.3066962661877515,1154,1019,2173,+
chr2,75117968,2.2675423487538677,977,368,1345,+
chr2,75117969,3.3598326359832638,802,238,1040,+
chr2,75117971,6.172932330827067,820,265,1085,+
chr2,75118020,1.7264244804245779,1189,687,1876,+
chr2,75118023,1.7869842231410566,2087,1365,3452,+
chr2,75118025,1.552667355484257,2063,1553,3616,+
chr2,75118026,1.7131542940931994,2209,1740,3949,+
chr2,75118028,1.9172375993422852,2331,1926,4257,+
chr2,75118030,2.5408029238764205,1588,1346,2934,+
chr2,75118562,13.214466745124168,618,452,1070,+
chr2,75118563,17.450038097434707,728,609,1337,+
chr2,75118573,1.917280681200752,781,939,1720,+
chr2,75118983,2.9844758416186985,589,440,1029,+
chr2,75118984,2.9844758416186985,589,440,1029,+
chr2,75119501,2.730215550545906,608,454,1062,+
chr2,75186493,0.8781087338946183,1700,1320,3020,+
chr2,75874305,4.291538147865455,631,420,1051,+
chr2,75879327,0.5903225806451613,731,526,1257,+
chr2,75879344,1.8255969357527664,2649,1860,4509,+
chr2,75879345,1.8255969357527664,2649,1860,4509,+
chr2,75879380,1.6185732164840398,2958,1687,4645,+
chr2,75879650,0.6298462453278967,2430,1634,4064,+
chr2,75879654,1.3322517482517482,2351,1299,3650,+
chr2,75879673,1.8735622346980687,2353,1743,4096,+
chr2,75879677,1.2589527443958703,12535,9224,21759,+
chr2,75879678,1.2016437141778595,17074,11464,28538,+
chr2,75879679,1.2016437141778595,17074,11464,28538,+
chr2,75879690,1.2958514312161775,5765,3510,9275,+
chr2,75879725,2.1814919530230537,742,483,1225,+
chr2,75882272,1.9866972249013648,1145,771,1916,+
chr2,75882359,0.4572082379862699,665,436,1101,+
chr2,75882385,1.7127613616727149,966,642,1608,+
chr2,75882794,2.64171974522293,552,470,1022,+
chr2,85132778,0.799568231987786,1677,788,2465,+
chr2,85132779,1.1338507145889918,1596,1858,3454,+
chr2,85132780,1.2316576101862238,5979,3025,9004,+
chr2,85132781,1.6465171706325816,7055,3665,10720,+
chr2,85132782,1.4078203232037716,6614,4027,10641,+
chr2,85132783,1.3668002732091953,5054,3198,8252,+
chr2,85132785,1.1129678654732702,2353,1963,4316,+
chr2,85132791,1.3541734308119222,5279,3298,8577,+
chr2,85132792,1.3703033528472592,2825,1878,4703,+
chr2,85132794,1.745099852071006,2749,1663,4412,+
chr2,85132795,1.3519506565255233,1623,1914,3537,+
chr2,85132809,1.2337855030603122,3306,3143,6449,+
chr2,85132812,1.2832870077170269,9969,6315,16284,+
chr2,85132813,1.2832870077170269,9969,6315,16284,+
chr2,85132819,0.7775056227395708,8211,7869,16080,+
chr2,85132829,1.2365666326983342,4395,4320,8715,+
chr2,85133129,1.3143481182795698,7822,5114,12936,+
chr2,85133135,1.2277660094508718,5966,5490,11456,+
chr2,85133136,1.155606777350284,6958,6092,13050,+
chr2,85133139,1.1530672466190144,16954,13053,30007,+
chr2,85133166,1.2725237113784413,17481,15319,32800,+
chr2,85133534,0.7884803084168245,13161,9844,23005,+
chr2,85133556,1.142985928843167,14417,10492,24909,+
chr2,85133557,0.8579973324702685,17710,12051,29761,+
chr2,85133581,1.3135396786324576,56270,38877,95147,+
chr2,85133706,1.4793727104246468,6259,4263,10522,+
chr2,85133708,0.7360537700254826,2292,1632,3924,+
chr2,85133731,1.8392782458027128,2911,2390,5301,+
chr2,85273261,0.931851315212822,703,445,1148,+
chr2,85280447,0.3088611190002839,724,502,1226,+
chr2,85280449,0.3088611190002839,724,502,1226,+
chr2,85766319,0.9841151621273327,629,531,1160,+
chr2,85768238,1.719416498993964,632,496,1128,+
chr2,85768831,1.6874502097827822,1245,990,2235,+
chr2,85769043,0.3321937321937322,741,629,1370,+
chr2,85769059,2.087752573014672,2485,1883,4368,+
chr2,85769752,2.11676415406688,684,532,1216,+
chr2,85769777,1.6411443314615268,1601,1197,2798,+
chr2,85770063,1.2404236975438097,5735,4601,10336,+
chr2,85770065,1.121062332211606,7218,5741,12959,+
chr2,85770066,0.5902564731868941,2885,2247,5132,+
chr2,85770070,1.5515188149146337,5258,4556,9814,+
chr2,85770072,1.895332054252594,3567,3288,6855,+
chr2,85770111,2.282072368421053,776,447,1223,+
chr2,85770136,0.6702099851877669,1281,997,2278,+
chr2,85770161,2.1507874015748034,606,507,1113,+
chr2,85770258,0.6848207499878721,1209,922,2131,+
chr2,85770274,2.0700136612021858,550,548,1098,+
chr2,85770497,11.631853785900782,674,382,1056,+
chr2,85770499,26.015452366355625,4115,3152,7267,+
chr2,85770500,28.554109050797575,4053,3211,7264,+
chr2,85770509,0.3494443814891262,700,740,1440,+
chr2,85770524,0.7080679405520169,1391,1255,2646,+
chr2,85770650,1.3940052443246844,1551,1210,2761,+
chr2,85770746,1.3222996951067127,1188,987,2175,+
chr2,85770754,2.024830699774266,597,442,1039,+
chr2,85770881,1.5287657212588817,1386,1080,2466,+
chr2,85770960,4.179404187146534,1556,1146,2702,+
chr2,85771147,0.996719184326359,923,662,1585,+
chr2,85771418,2.956109596156343,784,452,1236,+
chr2,85771419,2.956109596156343,784,452,1236,+
chr2,85771462,7.481510934393639,671,502,1173,+
chr2,85771525,1.687576875768758,1035,812,1847,+
chr2,85771681,3.435045317220544,757,661,1418,+
chr2,85771740,2.5957883890804165,1722,1381,3103,+
chr2,85771828,1.5645609852999605,1073,838,1911,+
chr2,85771903,1.677359059391016,842,534,1376,+
chr2,85771907,1.0568972549965272,2536,1880,4416,+
chr2,85771911,1.5730889235569423,937,640,1577,+
chr2,85772018,2.836897590361446,965,663,1628,+
chr2,85772101,1.7512335892182935,1413,1034,2447,+
chr2,85772137,1.7301024575362045,2296,1690,3986,+
chr2,85772139,1.659671149880468,1934,1480,3414,+
chr2,85772141,0.5874652455977758,921,663,1584,+
chr2,85772142,1.4849354716264946,1180,957,2137,+
chr2,85806241,0.9485866244050319,1109,740,1849,+
chr2,85806242,1.102960102960103,856,554,1410,+
chr2,85809023,0.4800469729775551,820,505,1325,+
chr2,85822893,2.993963782696177,959,496,1455,+
chr2,85822894,2.993963782696177,959,496,1455,+
chr2,85822895,1.355085224222953,793,532,1325,+
chr2,85823962,2.911974977658624,930,745,1675,+
chr2,85823963,2.911974977658624,930,745,1675,+
chr2,85824287,1.7140918782709829,716,468,1184,+
chr2,85858063,2.087272727272727,573,439,1012,+
chr2,85872119,3.125674069010645,933,699,1632,+
chr2,85872120,2.5580867638650657,1330,1002,2332,+
chr2,85872122,3.097870182555781,595,492,1087,+
chr2,85875061,1.423526114173596,585,416,1001,+
chr2,85875066,1.550608828006088,651,583,1234,+
chr2,85875070,1.1582814718305372,1904,1593,3497,+
chr2,85875072,1.316231751078603,3650,2899,6549,+
chr2,85875076,0.9685049610647188,2382,1692,4074,+
chr2,85875077,1.1338097797600646,3345,2578,5923,+
chr2,85875078,1.622527539672841,1548,1168,2716,+
chr2,85875094,1.6442425401683247,1282,1306,2588,+
chr2,85876191,0.990419708029197,667,547,1214,+
chr2,85876192,1.3669930204450282,929,707,1636,+
chr2,85876246,3.57494824820019,578,527,1105,+
chr2,86354337,1.546994156580883,772,533,1305,+
chr2,86361420,1.9275013409597779,655,422,1077,+
chr2,86433412,0.28384558593655806,714,479,1193,+
chr2,86437677,2.0422177581483947,727,574,1301,+
chr2,86437732,1.5934702474986833,800,632,1432,+
chr2,86712936,0.3975588856383134,1475,930,2405,+
chr2,86712938,0.4657088122605364,1000,608,1608,+
chr2,86712963,1.8063886424134872,782,489,1271,+
chr2,86998680,1.8581836685792297,631,396,1027,+
chr2,87820852,3.477760428172245,702,415,1117,+
chr2,89049732,7.146560690354035,1199,2456,3655,+
chr2,89049733,7.146560690354035,1199,2456,3655,+
chr2,89049734,6.345344095687503,1331,2740,4071,+
chr2,89049736,0.7557880461106267,563,1146,1709,+
chr2,89049737,0.2624821583091236,1111,2164,3275,+
chr2,89049738,0.2955146853376724,619,1192,1811,+
chr2,89049739,0.2631298741750909,782,1271,2053,+
chr2,89050007,2.167624967624968,1707,857,2564,+
chr2,89050009,2.167624967624968,1707,857,2564,+
chr2,89050015,1.643586311608487,1586,749,2335,+
chr2,97009019,1.7053603466531106,1437,869,2306,+
chr2,97009021,2.076093128904032,913,586,1499,+
chr2,97009870,0.6754918981481481,804,575,1379,+
chr2,97009871,1.4855219084077844,1473,870,2343,+
chr2,97009892,1.0223446663199722,1394,760,2154,+
chr2,97009903,2.234168865435356,1128,757,1885,+
chr2,97009913,2.2186147186147185,1229,923,2152,+
chr2,97039338,8.74982911825017,752,265,1017,+
chr2,97039339,7.677668372268052,1016,414,1430,+
chr2,97039344,26.28193865018018,1431,1511,2942,+
chr2,97039345,26.486632321278964,1619,1899,3518,+
chr2,97039346,26.486632321278964,1619,1899,3518,+
chr2,97039355,0.24718949909360147,390,809,1199,+
chr2,98262524,0.9431800325583442,1325,878,2203,+
chr2,98262615,1.6889848812095032,1057,462,1519,+
chr2,98262636,2.70381670600426,1235,598,1833,+
chr2,98262637,2.398610964958434,785,558,1343,+
chr2,98263533,1.5392922412360857,1634,925,2559,+
chr2,98263548,2.328997770900513,1823,1126,2949,+
chr2,98263592,0.7106413994169096,1715,1231,2946,+
chr2,98263813,1.699949734669019,3232,2178,5410,+
chr2,98263853,1.4418231225296445,2593,1583,4176,+
chr2,98264536,1.3709204612077388,1724,902,2626,+
chr2,99226316,0.7473816506074571,891,681,1572,+
chr2,99226318,0.5347732181425486,618,462,1080,+
chr2,99226485,2.578646173969915,750,555,1305,+
chr2,99226486,2.578646173969915,750,555,1305,+
chr2,99227315,0.9606261859582542,749,619,1368,+
chr2,99227316,0.9606261859582542,749,619,1368,+
chr2,99802692,2.327678571428572,552,489,1041,+
chr2,99802695,2.158223889931207,594,532,1126,+
chr2,99804706,1.023028344525878,1153,847,2000,+
chr2,99811296,2.014367816091954,700,463,1163,+
chr2,99813356,1.2568245406034624,918,536,1454,+
chr2,99813634,4.987879251335799,736,384,1120,+
chr2,99813653,5.935309766411945,1883,1243,3126,+
chr2,99813654,5.935309766411945,1883,1243,3126,+
chr2,99813657,17.729652762384944,710,542,1252,+
chr2,99813668,7.277177206564219,1924,1726,3650,+
chr2,99813669,7.416263208823483,2210,2062,4272,+
chr2,99813670,5.714845763527325,1217,1121,2338,+
chr2,99977886,1.4415470113410616,756,468,1224,+
chr2,99984962,2.574149659863945,687,391,1078,+
chr2,99985024,2.3441048034934497,670,457,1127,+
chr2,99985040,1.1457976471958242,2773,2140,4913,+
chr2,99985044,1.762222222222222,1377,1059,2436,+
chr2,99985859,1.4552872062663185,1819,1531,3350,+
chr2,99992920,7.527230752168101,1274,1277,2551,+
chr2,99992921,7.527230752168101,1274,1277,2551,+
chr2,99993011,3.535546139359698,652,353,1005,+
chr2,99993013,3.535546139359698,652,353,1005,+
chr2,100013324,3.1112519294824925,571,548,1119,+
chr2,100016142,2.470253766406421,710,580,1290,+
chr2,101618735,0.8547844896885368,761,493,1254,+
chr2,101618747,1.1267979681486,5512,3502,9014,+
chr2,101618749,1.0649402591826327,7694,4710,12404,+
chr2,101618750,1.0553987867157415,6706,4254,10960,+
chr2,101618753,1.1983607963483043,9074,6854,15928,+
chr2,101618754,1.3224178458250022,10305,9493,19798,+
chr2,101618756,1.4099377496665984,4565,4651,9216,+
chr2,101618757,0.7732603586605863,3636,3192,6828,+
chr2,101618760,1.106728350344599,11014,7434,18448,+
chr2,101618767,1.117733474658237,14162,9604,23766,+
chr2,101619175,1.1304498303488648,10513,7773,18286,+
chr2,101619190,1.1378697657364245,14258,8985,23243,+
chr2,101619191,1.1199901477832512,20803,17999,38802,+
chr2,101619193,1.187880010936997,92140,71387,163527,+
chr2,101619194,1.1989230765300518,82415,62989,145404,+
chr2,101620716,1.2921918959995624,64358,41715,106073,+
chr2,101620717,1.3383628803688137,53273,32713,85986,+
chr2,101620736,1.163603621201225,14360,10593,24953,+
chr2,101620738,0.8923606696026722,44499,30038,74537,+
chr2,101622418,0.9441317885381976,1755,1198,2953,+
chr2,101622419,0.9466526309487581,1423,907,2330,+
chr2,101886676,6.886724338273364,592,418,1010,+
chr2,101886677,6.584988231913429,718,505,1223,+
chr2,105654628,2.99798207513574,1208,801,2009,+
chr2,105654629,2.877039848197344,721,526,1247,+
chr2,105654659,1.9674808921721176,1069,725,1794,+
chr2,105654662,2.1943231441048034,1004,457,1461,+
chr2,105654663,1.527152000857469,1109,879,1988,+
chr2,105654664,2.10289598108747,1546,719,2265,+
chr2,105654666,2.0313117588932808,1060,505,1565,+
chr2,105654669,1.9420288704515452,1080,601,1681,+
chr2,105654675,1.8995124890446973,1260,651,1911,+
chr2,105654676,1.8995124890446973,1260,651,1911,+
chr2,105665629,1.7826589595375721,770,518,1288,+
chr2,105665639,1.878409090909091,626,439,1065,+
chr2,105665640,2.1372669213662543,1998,1348,3346,+
chr2,105665642,2.1372669213662543,1998,1348,3346,+
chr2,105665654,1.6320800458412308,1213,925,2138,+
chr2,105665656,0.703142210853391,5173,4306,9479,+
chr2,105665657,0.8758449678106944,5759,4817,10576,+
chr2,105696492,3.5662822664819003,737,585,1322,+
chr2,105713776,1.9494702526487369,597,408,1005,+
chr2,105716130,2.568693009118541,625,469,1094,+
chr2,105716166,1.5101426563941176,1986,1215,3201,+
chr2,105716167,1.196111913831604,1255,661,1916,+
chr2,105716178,1.6763351749539597,992,723,1715,+
chr2,105716192,2.0296674679487183,2683,2079,4762,+
chr2,105716193,1.9721336394853184,4121,3256,7377,+
chr2,105716195,1.5731173538836647,5612,4272,9884,+
chr2,105716196,1.3698807274543066,3603,2870,6473,+
chr2,105959331,2.0947521072723476,597,460,1057,+
chr2,109113546,1.4802568405664314,634,516,1150,+
chr2,113286428,2.5842918735388203,658,395,1053,+
chr2,113286444,1.2464281379268787,870,711,1581,+
chr2,113333498,3.616071428571429,809,447,1256,+
chr2,113333499,3.616071428571429,809,447,1256,+
chr2,113420645,2.8203894551044804,617,384,1001,+
chr2,114647769,2.368236697909735,1154,816,1970,+
chr2,114647771,2.1034825870646765,905,602,1507,+
chr2,114670771,0.4993248456790123,667,647,1314,+
chr2,114670772,0.4993248456790123,667,647,1314,+
chr2,114670774,0.5670489252578805,655,468,1123,+
chr2,114674578,2.063963963963964,710,554,1264,+
chr2,114691935,2.5584445844810157,1352,878,2230,+
chr2,114691953,1.846153846153846,878,585,1463,+
chr2,114697600,1.4621420996818664,1148,819,1967,+
chr2,114697629,1.7795986973421576,604,500,1104,+
chr2,114697672,1.7891496729511351,749,564,1313,+
chr2,114709316,3.711417816813049,985,796,1781,+
chr2,114709323,1.8395089285714288,1205,767,1972,+
chr2,114714979,1.6282102728731946,1081,711,1792,+
chr2,114715067,13.382870580741079,11388,10707,22095,+
chr2,114715068,13.382870580741079,11388,10707,22095,+
chr2,114715081,0.6517081245114718,1491,1672,3163,+
chr2,114715121,1.611280212517893,9923,10345,20268,+
chr2,114715135,0.5791972747423274,14342,13325,27667,+
chr2,114715140,0.9190572075647714,12277,11073,23350,+
chr2,114715143,1.5609079029725368,5225,4792,10017,+
chr2,114715546,2.3014141414141416,711,549,1260,+
chr2,114715597,1.9419744318181815,738,639,1377,+
chr2,118572276,0.5443708592132941,680,393,1073,+
chr2,118572279,0.9606525514845752,910,427,1337,+
chr2,118572280,1.3259699921925387,1312,661,1973,+
chr2,118572281,1.3259699921925387,1312,661,1973,+
chr2,118572282,1.3207002752600747,2128,1555,3683,+
chr2,118572283,0.9605863758920616,1378,1187,2565,+
chr2,118572298,0.52593808915648,2631,2348,4979,+
chr2,118572299,0.7283357388799697,3327,2726,6053,+
chr2,118572300,0.52593808915648,2631,2348,4979,+
chr2,118572305,1.090253568485458,2001,1371,3372,+
chr2,118572312,1.8989604821421349,1066,602,1668,+
chr2,118572329,1.4203875206674088,3335,2256,5591,+
chr2,118572331,1.1996727193542158,5179,3284,8463,+
chr2,118572335,1.4811081661475365,1962,1396,3358,+
chr2,118572339,1.036821745707417,5756,4149,9905,+
chr2,118579285,1.1692229299824237,628,399,1027,+
chr2,118579468,2.0234375,665,383,1048,+
chr2,118579471,1.7043269230769231,708,415,1123,+
chr2,118579521,1.7115901736475092,1137,592,1729,+
chr2,118579780,2.4652442866143534,799,544,1343,+
chr2,118582213,0.4567467748647523,1032,711,1743,+
chr2,118582215,1.4443881498597215,1374,959,2333,+
chr2,118588321,2.528024495621123,1001,725,1726,+
chr2,120124552,0.7586523415327304,809,428,1237,+
chr2,120124605,2.918122270742358,890,686,1576,+
chr2,120124606,2.918122270742358,890,686,1576,+
chr2,120124612,1.6312056737588654,1379,845,2224,+
chr2,120125851,2.694425483503982,763,585,1348,+
chr2,120736322,1.4150452352781804,624,489,1113,+
chr2,122514829,1.3719867643433068,811,555,1366,+
chr2,122514871,1.7593984962406013,584,419,1003,+
chr2,122516347,1.3985476967554689,1934,1212,3146,+
chr2,122519025,1.6915706381557296,2815,1809,4624,+
chr2,122519043,1.8692111598923664,1675,1227,2902,+
chr2,122519050,0.6933113059685686,2517,1463,3980,+
chr2,122519052,0.4792829049666148,1047,753,1800,+
chr2,122519055,1.6940711810729767,7143,5571,12714,+
chr2,122519056,1.2651364462080097,12673,9552,22225,+
chr2,122519057,1.6940711810729767,7143,5571,12714,+
chr2,122520587,2.8866787691450457,731,687,1418,+
chr2,122520641,1.2004405757250742,867,659,1526,+
chr2,122523379,2.231404958677686,809,604,1413,+
chr2,122523380,2.231404958677686,809,604,1413,+
chr2,122524457,1.58262072535267,817,598,1415,+
chr2,122524500,5.601873536299765,623,426,1049,+
chr2,122524572,2.0846131556070704,653,405,1058,+
chr2,127453607,1.2850996544952644,639,404,1043,+
chr2,127453677,1.3770307314720698,645,492,1137,+
chr2,127453682,1.8121677242325505,578,475,1053,+
chr2,127453733,2.009134345137718,840,592,1432,+
chr2,127453758,1.391781785859783,1192,805,1997,+
chr2,127453763,2.744950783813343,2402,1898,4300,+
chr2,127453764,2.744950783813343,2402,1898,4300,+
chr2,127453765,2.744950783813343,2402,1898,4300,+
chr2,127453768,1.9666294777234852,2293,1736,4029,+
chr2,127454081,34.33446690856092,1105,1090,2195,+
chr2,127454082,34.33446690856092,1105,1090,2195,+
chr2,127454083,28.769194651541994,1294,1468,2762,+
chr2,127454088,0.1896367521367521,496,1455,1951,+
chr2,127454089,0.24718004950636382,831,2053,2884,+
chr2,127454090,0.25469508999516327,1213,2535,3748,+
chr2,127454091,0.3025092936802974,464,806,1270,+
chr2,127454095,0.27063128025482497,435,1021,1456,+
chr2,127454103,0.35553337241138133,435,634,1069,+
chr2,127454104,0.14603596066285243,410,784,1194,+
chr2,130939922,1.6088368023577087,1074,487,1561,+
chr2,130939923,1.6088368023577087,1074,487,1561,+
chr2,130940297,1.7224868798178223,887,515,1402,+
chr2,130948043,2.1559060737373286,1116,886,2002,+
chr2,130948045,0.6315172817809022,734,568,1302,+
chr2,130948046,2.092664827323756,1221,913,2134,+
chr2,130948047,2.092664827323756,1221,913,2134,+
chr2,130948170,1.7898470660493313,1812,1350,3162,+
chr2,130948171,1.7579982238438288,3829,2711,6540,+
chr2,130948172,1.7579982238438288,3829,2711,6540,+
chr2,130948180,1.1732240566596397,1904,1140,3044,+
chr2,130948181,1.1732240566596397,1904,1140,3044,+
chr2,130948190,2.0615373270789306,1573,1126,2699,+
chr2,130948200,0.4155428571428571,605,624,1229,+
chr2,130948213,1.823323442136498,626,673,1299,+
chr2,130948224,1.9163498098859322,545,525,1070,+
chr2,130948225,0.6677428033360236,1240,943,2183,+
chr2,131052019,0.5394857949315826,627,378,1005,+
chr2,131103672,1.5016764338720177,529,486,1015,+
chr2,131904394,1.0151594014313596,742,529,1271,+
chr2,131904395,1.0151594014313596,742,529,1271,+
chr2,131906997,0.3949025192306164,718,509,1227,+
chr2,135920186,1.0682238442822385,685,410,1095,+
chr2,135920188,1.0682238442822385,685,410,1095,+
chr2,136505840,2.1716609210642623,663,418,1081,+
chr2,136505842,2.1716609210642623,663,418,1081,+
chr2,136527374,1.98905558288244,646,427,1073,+
chr2,136530067,2.529964011891723,850,580,1430,+
chr2,136530068,2.529964011891723,850,580,1430,+
chr2,136533834,1.8756371049949032,639,435,1074,+
chr2,136536540,1.1225372835003364,1178,821,1999,+
chr2,136540411,1.6643985699457964,901,597,1498,+
chr2,136541211,1.2132034242247318,1130,749,1879,+
chr2,136541311,0.6131538560619263,1848,1005,2853,+
chr2,136541312,0.6507080610021787,918,679,1597,+
chr2,136541315,0.5194805194805195,1405,702,2107,+
chr2,136541366,3.1542120607641557,2854,1329,4183,+
chr2,136541409,2.158102512666204,2298,996,3294,+
chr2,136541415,0.9788594215864489,7703,3807,11510,+
chr2,136541438,1.5736042889660955,8436,3927,12363,+
chr2,136541440,1.5736042889660955,8436,3927,12363,+
chr2,136541444,1.4161061483704929,9822,5308,15130,+
chr2,136541454,1.3746421556852382,5931,3076,9007,+
chr2,136541505,2.107264086897488,775,490,1265,+
chr2,136542247,1.1348052940053186,1124,791,1915,+
chr2,136542459,1.187093738232459,1037,669,1706,+
chr2,136542464,1.9060758884175495,1101,630,1731,+
chr2,138722049,0.7679020057223982,1065,716,1781,+
chr2,138722143,2.3652482269503547,695,422,1117,+
chr2,138758572,2.4326375711574952,640,526,1166,+
chr2,138758574,2.4326375711574952,640,526,1166,+
chr2,138771523,1.1134964737925261,4599,3101,7700,+
chr2,138771524,1.0086597824748242,5748,3932,9680,+
chr2,138771525,1.221082753627156,5069,3452,8521,+
chr2,138771568,1.999878971255673,917,660,1577,+
chr2,143635203,2.0873750343187463,1318,676,1994,+
chr2,143635204,2.738643481747784,1477,758,2235,+
chr2,143635205,3.996382428940568,626,386,1012,+
chr2,143635232,0.8283640140628005,6840,3308,10148,+
chr2,143635233,0.786457345619635,2271,1081,3352,+
chr2,143635241,1.836732589982193,7739,4160,11899,+
chr2,143635242,1.836732589982193,7739,4160,11899,+
chr2,143635243,1.7061207704791532,6140,3393,9533,+
chr2,143635244,1.6647444820043749,2092,1221,3313,+
chr2,143635250,2.765441313677925,1139,698,1837,+
chr2,143642923,1.653286939232012,1662,1237,2899,+
chr2,143642989,1.5415332747555988,4964,3881,8845,+
chr2,143642991,1.7164098292378176,4337,3429,7766,+
chr2,143642992,1.5525847849700285,2945,2344,5289,+
chr2,143642996,0.7464069740045551,2375,1818,4193,+
chr2,143643084,1.2719565314013956,3633,2415,6048,+
chr2,143676268,1.8102231237322517,1808,1449,3257,+
chr2,143676294,1.2227017968551208,7807,5441,13248,+
chr2,143712393,1.3625477359519913,4540,3007,7547,+
chr2,143723375,17.12942031497953,667,358,1025,+
chr2,143723376,17.12942031497953,667,358,1025,+
chr2,143725970,2.428660910318927,655,394,1049,+
chr2,143725971,2.456733427673281,666,375,1041,+
chr2,143726010,7.999623636436823,726,314,1040,+
chr2,143726047,1.5377994254766585,692,429,1121,+
chr2,143742675,1.2993065543868672,1649,1282,2931,+
chr2,143742725,1.3698417966589225,2415,1571,3986,+
chr2,143743520,1.551383556057898,5725,3766,9491,+
chr2,143743521,1.551383556057898,5725,3766,9491,+
chr2,143743538,1.41503756721148,3381,2276,5657,+
chr2,143746596,0.2058609126694853,705,360,1065,+
chr2,143746598,0.2058609126694853,705,360,1065,+
chr2,143746611,1.0188203912270302,1249,722,1971,+
chr2,143746613,1.2993243243243244,1922,1119,3041,+
chr2,143746614,1.0745472186287193,1328,772,2100,+
chr2,143746631,2.1023937469467517,741,444,1185,+
chr2,143746633,1.6947852760736195,1104,651,1755,+
chr2,143746657,3.1364491844416564,1110,796,1906,+
chr2,143746661,2.986393872203185,1161,901,2062,+
chr2,143798000,1.3148500230733733,2967,2166,5133,+
chr2,143798201,1.598259064968006,1108,912,2020,+
chr2,143798208,1.4907238045466424,1140,978,2118,+
chr2,143799632,1.1182447429096125,8331,5911,14242,+
chr2,152318779,2.760674157303371,755,533,1288,+
chr2,152318781,2.604254649893597,1071,788,1859,+
chr2,152320647,1.6347638757489749,691,366,1057,+
chr2,152320663,1.883242383142847,1509,915,2424,+
chr2,152320664,0.9992966490196866,1124,632,1756,+
chr2,152320741,1.8201320880816445,1043,691,1734,+
chr2,153616794,2.4680625663679567,1462,1090,2552,+
chr2,153617018,3.277383530810719,649,520,1169,+
chr2,157440041,3.5210084033613445,837,517,1354,+
chr2,157440042,3.5210084033613445,837,517,1354,+
chr2,160599615,2.057167133391724,621,412,1033,+
chr2,160604940,0.8267619466884278,985,808,1793,+
chr2,160623866,2.4066721956889787,739,489,1228,+
chr2,162172962,0.5132396207911082,627,436,1063,+
chr2,162172970,2.375606796116505,674,514,1188,+
chr2,162172979,0.6127095999690199,878,526,1404,+
chr2,162224296,1.7523809523809524,735,629,1364,+
chr2,162224298,0.5746054519368723,800,611,1411,+
chr2,162224301,1.549056603773585,820,635,1455,+
chr2,162227710,2.4788359788359786,936,566,1502,+
chr2,162242027,2.5848208864602307,733,548,1281,+
chr2,162242076,2.683596318211703,1688,1013,2701,+
chr2,162247684,3.3306856187290967,770,597,1367,+
chr2,162268067,2.109790388548057,970,651,1621,+
chr2,169629087,1.9426313981449677,974,709,1683,+
chr2,169629088,1.6950507383635038,1158,819,1977,+
chr2,169629091,1.786314525810324,1053,832,1885,+
chr2,169629092,1.9735814922398711,2237,1764,4001,+
chr2,169629093,1.4670341268311782,1717,935,2652,+
chr2,169629094,1.6332033258562433,2616,1735,4351,+
chr2,170440917,5.7202878365549115,846,1305,2151,+
chr2,170440919,4.207812386347769,877,1491,2368,+
chr2,170440956,0.3233115468409586,476,764,1240,+
chr2,170440958,0.3233115468409586,476,764,1240,+
chr2,170463640,1.1431075151400507,782,604,1386,+
chr2,170493055,2.8537616176776983,568,458,1026,+
chr2,170493232,2.537796976241901,751,462,1213,+
chr2,170493237,1.7475728155339807,809,514,1323,+
chr2,170493499,2.2989716333413632,754,432,1186,+
chr2,170493541,2.4669738863287254,583,433,1016,+
chr2,170493731,4.073805515249801,683,477,1160,+
chr2,170607777,0.26222467656144743,574,442,1016,+
chr2,170655384,1.1464791957419807,2377,1863,4240,+
chr2,170655482,0.9990945351182837,1428,1147,2575,+
chr2,170655483,0.9990945351182837,1428,1147,2575,+
chr2,170657514,2.27480757229041,971,835,1806,+
chr2,170662025,1.7607735647936653,745,596,1341,+
chr2,170663320,1.775534111499726,1698,1248,2946,+
chr2,170663557,1.412868410128684,2031,1319,3350,+
chr2,170665375,1.4480075137528512,1519,1284,2803,+
chr2,170667383,2.0849112426035505,782,649,1431,+
chr2,170667720,1.9148281909764169,2881,2141,5022,+
chr2,170667721,1.9653402379443659,2985,2054,5039,+
chr2,171806231,0.6062307044625316,719,508,1227,+
chr2,171806724,0.5510424155283968,875,641,1516,+
chr2,171807848,2.0850559132497457,585,453,1038,+
chr2,171818205,1.726973684210526,599,511,1110,+
chr2,171822343,2.7915037295336265,672,505,1177,+
chr2,171822947,6.82378272669221,833,639,1472,+
chr2,171822998,0.3929352146263911,718,543,1261,+
chr2,171823191,1.6247723132969036,668,426,1094,+
chr2,171823335,1.6915264995239607,614,410,1024,+
chr2,172411416,3.9639852613547597,628,533,1161,+
chr2,172544100,2.2577412344363466,872,707,1579,+
chr2,172584467,2.5166487647690654,780,440,1220,+
chr2,172584469,2.5166487647690654,780,440,1220,+
chr2,172585335,1.3264750490085198,633,461,1094,+
chr2,172604448,1.919289222595381,857,541,1398,+
chr2,172782074,0.5462348809988294,559,465,1024,+
chr2,172803247,1.62134944612286,1011,661,1672,+
chr2,172821900,1.976315789473684,750,550,1300,+
chr2,172822979,1.8266863033873344,815,678,1493,+
chr2,172848226,1.5915934755332497,1120,796,1916,+
chr2,172944885,2.489006048101458,893,400,1293,+
chr2,173955757,5.925558978977232,724,543,1267,+
chr2,174085897,0.6679325643300799,696,574,1270,+
chr2,174085898,0.6679325643300799,696,574,1270,+
chr2,174085899,0.6679325643300799,696,574,1270,+
chr2,174088177,2.9087510103607057,675,448,1123,+
chr2,174089244,1.0305250305250304,632,377,1009,+
chr2,174089246,1.0305250305250304,632,377,1009,+
chr2,174090651,2.673286707998166,741,446,1187,+
chr2,174090929,13.643667372843382,1022,619,1641,+
chr2,174090930,19.52053024246766,1645,1025,2670,+
chr2,174231964,0.24313725490196067,743,475,1218,+
chr2,174232007,1.1229245626059898,743,547,1290,+
chr2,174232712,1.6090712742980562,595,462,1057,+
chr2,174232788,0.5802285146547442,583,426,1009,+
chr2,174233018,3.859090909090909,565,439,1004,+
chr2,174233503,0.9492550205139278,627,420,1047,+
chr2,174233504,0.9492550205139278,627,420,1047,+
chr2,174233538,3.157250249246196,701,558,1259,+
chr2,175585045,1.5465212737489966,1426,739,2165,+
chr2,175585046,1.5465212737489966,1426,739,2165,+
chr2,177202276,0.5996810207336523,1033,626,1659,+
chr2,177202280,0.4100243810952738,1165,687,1852,+
chr2,177202281,1.9933048908992779,1914,1065,2979,+
chr2,177202283,1.4422381278716834,3307,1841,5148,+
chr2,177202285,1.6534235562106394,850,438,1288,+
chr2,177202289,1.9472849083215795,1174,708,1882,+
chr2,177202299,1.7132818671948036,4059,2409,6468,+
chr2,177202300,1.6912167606768735,2914,1824,4738,+
chr2,177202303,1.5549815925843784,3644,1943,5587,+
chr2,177202306,0.6698476219793751,1359,729,2088,+
chr2,177202314,1.829255439764064,9015,5694,14709,+
chr2,177202315,2.318153530233791,6468,4785,11253,+
chr2,177202317,2.136657158308411,6217,4365,10582,+
chr2,178080618,1.5810280009615543,1709,1129,2838,+
chr2,178080865,3.5945765725716825,621,408,1029,+
chr2,178081444,3.3915454833685676,1213,589,1802,+
chr2,178081464,6.334611824448633,2037,1141,3178,+
chr2,178081609,13.09538960087127,1174,566,1740,+
chr2,178081611,14.696720849378114,2333,1323,3656,+
chr2,178081612,11.824605225560786,1984,1181,3165,+
chr2,178081621,3.058852396824324,858,596,1454,+
chr2,178084005,5.486203369745467,2151,1547,3698,+
chr2,178084027,1.7946555525595405,1386,1054,2440,+
chr2,178084034,0.5937029873200086,649,516,1165,+
chr2,178084140,1.8384150905733816,920,690,1610,+
chr2,178084332,2.310682127025742,681,491,1172,+
chr2,178084711,3.915202258608781,663,411,1074,+
chr2,178346845,1.3570951678204979,681,484,1165,+
chr2,178346898,2.080233508602328,1053,846,1899,+
chr2,178346900,2.0500000000000003,782,579,1361,+
chr2,178402807,2.180996832996164,651,510,1161,+
chr2,181922458,2.8055350138277513,1120,827,1947,+
chr2,181922459,2.2398822663723323,760,603,1363,+
chr2,181927783,3.720819506362404,619,419,1038,+
chr2,181927962,2.733962264150944,643,529,1172,+
chr2,182756962,2.4810137516170436,1288,921,2209,+
chr2,182757358,1.891385767790262,605,444,1049,+
chr2,182757359,1.891385767790262,605,444,1049,+
chr2,182763618,2.5132457719570915,1136,896,2032,+
chr2,182766504,1.9583992792854743,878,623,1501,+
chr2,182780225,0.47737699731055205,709,515,1224,+
chr2,182780751,1.4463273505624945,596,468,1064,+
chr2,182781032,2.159667661109969,770,582,1352,+
chr2,182792887,2.4063553558354682,924,692,1616,+
chr2,182792921,1.652713857842063,706,506,1212,+
chr2,182794352,1.7732997481108312,735,396,1131,+
chr2,182794546,1.7196969696969695,680,431,1111,+
chr2,182794565,2.8184900945921827,657,430,1087,+
chr2,182794654,2.9090461522801103,861,680,1541,+
chr2,182795078,1.830699774266365,810,442,1252,+
chr2,183593355,2.4325590113797095,695,478,1173,+
chr2,183593686,1.6602857142857144,744,699,1443,+
chr2,183593701,0.625,850,739,1589,+
chr2,183593702,1.649122807017544,516,626,1142,+
chr2,183608371,2.1031549098491866,808,567,1375,+
chr2,183623888,1.5539769382574928,703,511,1214,+
chr2,183623897,2.3780225956463186,952,711,1663,+
chr2,183642546,1.480665501056529,605,404,1009,+
chr2,183995217,4.114083659324835,983,689,1672,+
chr2,183995218,4.567815118267348,684,442,1126,+
chr2,187351145,1.7192509610640487,815,616,1431,+
chr2,187365012,1.715697578652611,650,466,1116,+
chr2,187367292,0.45940594059405926,695,504,1199,+
chr2,187368794,0.554500781773509,661,483,1144,+
chr2,187368829,1.7523470968918058,768,476,1244,+
chr2,187368832,1.639917171336261,1749,1391,3140,+
chr2,187368839,1.821356553620532,1281,1090,2371,+
chr2,187368840,1.821356553620532,1281,1090,2371,+
chr2,187370487,0.49234259784458306,743,491,1234,+
chr2,187373435,2.384683098591549,601,425,1026,+
chr2,187373453,3.449339207048458,637,453,1090,+
chr2,187373591,1.1936350144878942,2152,1541,3693,+
chr2,187373592,0.9982110912343469,1529,1104,2633,+
chr2,187373603,1.604204753199269,701,546,1247,+
chr2,187373692,2.215232586165341,706,460,1166,+
chr2,187373740,1.6436101245842494,787,656,1443,+
chr2,187511590,2.2029196610891777,1340,686,2026,+
chr2,187511594,2.1532972972972977,865,369,1234,+
chr2,187529264,3.3348193724812893,642,478,1120,+
chr2,187542551,1.1085257857266886,607,442,1049,+
chr2,187542552,1.1085257857266886,607,442,1049,+
chr2,187545325,2.035034013605442,578,440,1018,+
chr2,190306269,3.637514516469594,612,412,1024,+
chr2,190328599,2.0617644562045934,1123,848,1971,+
chr2,190329844,3.300419498490174,732,599,1331,+
chr2,190331211,2.8233297338018017,653,430,1083,+
chr2,191550250,1.7712643678160922,803,434,1237,+
chr2,191785888,2.1034719984820573,773,675,1448,+
chr2,192141654,0.7020408163265307,773,524,1297,+
chr2,192141655,0.7020408163265307,773,524,1297,+
chr2,192141656,0.7020408163265307,773,524,1297,+
chr2,192160871,3.915978825206414,723,498,1221,+
chr2,192160911,3.413171379768457,561,478,1039,+
chr2,192214916,1.899497487437186,647,397,1044,+
chr2,192255035,1.2210826786596576,1214,658,1872,+
chr2,192255037,0.6581596439370615,1570,839,2409,+
chr2,192255055,2.854415177775996,1323,701,2024,+
chr2,192256853,0.3787081843046497,959,678,1637,+
chr2,192256864,0.5887686993991761,4283,2835,7118,+
chr2,192256865,0.5887686993991761,4283,2835,7118,+
chr2,192256866,0.5887686993991761,4283,2835,7118,+
chr2,192256882,1.644640234948605,1151,680,1831,+
chr2,192256894,1.8328338328338327,895,636,1531,+
chr2,192256897,2.675250357653791,934,698,1632,+
chr2,192257906,2.178011152120733,788,653,1441,+
chr2,192272894,2.8269302499067512,688,382,1070,+
chr2,192275810,1.6835664335664335,641,483,1124,+
chr2,192278828,1.8409313725490195,776,509,1285,+
chr2,192279312,0.3776707163803938,600,461,1061,+
chr2,192279389,1.4225245653817078,940,566,1506,+
chr2,192279390,1.4225245653817078,940,566,1506,+
chr2,192280895,1.2228558120426227,1033,736,1769,+
chr2,192288669,1.851365546218488,563,447,1010,+
chr2,192289047,1.306803554436596,1141,802,1943,+
chr2,192289165,1.4435332779413474,750,557,1307,+
chr2,192289288,1.5536403498968043,783,680,1463,+
chr2,192289493,2.3430962343096238,639,477,1116,+
chr2,192543392,2.413479052823315,799,487,1286,+
chr2,192543393,2.413479052823315,799,487,1286,+
chr2,192543394,2.413479052823315,799,487,1286,+
chr2,192543397,1.475418811273893,1558,931,2489,+
chr2,192543399,1.242033898305085,686,449,1135,+
chr2,192543726,0.644369619550125,976,553,1529,+
chr2,192543760,2.2677871148459383,1471,951,2422,+
chr2,192543761,2.1166526158328085,2322,1441,3763,+
chr2,192543767,1.258693863744651,1406,870,2276,+
chr2,196544846,2.242647058823529,914,611,1525,+
chr2,196544848,2.242647058823529,914,611,1525,+
chr2,196545607,2.3372701181522726,676,531,1207,+
chr2,196578174,1.9946988392285894,681,520,1201,+
chr2,196578226,1.5549698795180722,884,663,1547,+
chr2,196583013,2.2795876846259815,967,643,1610,+
chr2,196600565,3.4841173143588424,621,475,1096,+
chr2,196600584,0.6637931034482759,531,550,1081,+
chr2,196601002,1.6201285279416735,957,648,1605,+
chr2,196602026,3.993139313136201,785,590,1375,+
chr2,196602205,0.2918953826283501,677,488,1165,+
chr2,198365069,0.8433165195460278,534,545,1079,+
chr2,198365070,0.8433165195460278,534,545,1079,+
chr2,198365071,0.8433165195460278,534,545,1079,+
chr2,198365072,1.0365853658536586,594,491,1085,+
chr2,198365073,1.0252449009168723,1444,1326,2770,+
chr2,198365074,1.0179425837320573,850,835,1685,+
chr2,198365076,0.45483993902439024,867,655,1522,+
chr2,198365078,0.45483993902439024,867,655,1522,+
chr2,198365081,0.43735842721617557,1437,1032,2469,+
chr2,198365083,1.1430156646296805,1330,1047,2377,+
chr2,198365102,0.64510418748091,4040,2677,6717,+
chr2,198365104,0.6532013901785145,5469,3716,9185,+
chr2,198365109,1.593137716210875,3077,1585,4662,+
chr2,198365110,1.593137716210875,3077,1585,4662,+
chr2,198365119,1.8194714167524213,2999,2351,5350,+
chr2,198365124,2.222394601093744,1909,1120,3029,+
chr2,198365127,1.3489430894308942,1463,1229,2692,+
chr2,198365132,0.913846386021385,6839,4283,11122,+
chr2,198365134,1.0720561385426777,6225,3763,9988,+
chr2,198365137,1.3908643059213734,2781,1607,4388,+
chr2,198365156,1.2371628408020523,3190,1980,5170,+
chr2,198365831,1.3944167742728897,1596,1250,2846,+
chr2,198365839,1.316259678379988,2974,2043,5017,+
chr2,198365955,1.426183297791504,2077,1510,3587,+
chr2,198367998,1.5969809750353496,2767,2052,4819,+
chr2,198404852,1.1549990959112826,728,530,1258,+
chr2,198413125,1.780558995868793,860,564,1424,+
chr2,200828545,3.0258906550235465,788,556,1344,+
chr2,201436167,3.030702040284205,860,528,1388,+
chr2,201436169,3.030702040284205,860,528,1388,+
chr2,201436232,1.678200692041523,775,475,1250,+
chr2,201436235,1.8696099884154973,580,456,1036,+
chr2,201437070,5.365117496813602,712,387,1099,+
chr2,201437102,0.3429487179487179,855,431,1286,+
chr2,201437104,0.3429487179487179,855,431,1286,+
chr2,201437142,2.1893017558187013,1116,789,1905,+
chr2,201437143,2.1893017558187013,1116,789,1905,+
chr2,201437154,1.639326864766525,982,581,1563,+
chr2,201437164,2.0603988603988608,903,674,1577,+
chr2,201437167,1.6637630662020906,954,737,1691,+
chr2,201676414,4.027325315760501,618,425,1043,+
chr2,201676632,0.8057467243254597,4788,2165,6953,+
chr2,201676638,1.9733287932557257,2666,1176,3842,+
chr2,201676644,1.7980770868057183,9873,5226,15099,+
chr2,201676645,1.609063722619619,18782,9924,28706,+
chr2,201676646,1.5725155068134329,7290,3903,11193,+
chr2,201676647,1.5972865753504577,20514,11169,31683,+
chr2,201676648,1.550405255633169,12734,7249,19983,+
chr2,201676650,1.7009220166033383,3843,2376,6219,+
chr2,201676661,0.7639221846763923,3256,1625,4881,+
chr2,201676671,2.360199614555015,2227,1598,3825,+
chr2,201676678,1.282664987133079,19058,12495,31553,+
chr2,201676679,1.2245902666656583,9121,5913,15034,+
chr2,201680459,0.775289078097334,6722,4494,11216,+
chr2,201683068,1.826092393417263,9127,6538,15665,+
chr2,201683069,1.8081794782807392,12076,8085,20161,+
chr2,201683072,1.4836117831460145,5328,3702,9030,+
chr2,201683073,1.4836117831460145,5328,3702,9030,+
chr2,201683081,1.3788544747842666,3916,2152,6068,+
chr2,201685929,2.0988805970149254,674,334,1008,+
chr2,201685934,1.6676195426195428,712,443,1155,+
chr2,201685937,1.1066736574039395,1605,1026,2631,+
chr2,201685939,1.2895327902440399,4844,3469,8313,+
chr2,201685940,1.9117835385375315,2199,1162,3361,+
chr2,201685941,1.829533904457674,1889,1454,3343,+
chr2,201685942,1.9117835385375315,2199,1162,3361,+
chr2,201685945,1.5038254107613196,1198,937,2135,+
chr2,201685953,1.6753299869864287,1732,977,2709,+
chr2,201685990,1.6376819661277136,3881,2386,6267,+
chr2,201687527,2.8548795542319185,853,480,1333,+
chr2,201687531,1.6916064050429058,732,435,1167,+
chr2,201687538,1.2212369513974632,1019,452,1471,+
chr2,201687540,1.2212369513974632,1019,452,1471,+
chr2,201687553,0.3317783168501585,888,465,1353,+
chr2,201687575,1.4534534534534531,1693,944,2637,+
chr2,201687582,1.4571900144419228,2017,1178,3195,+
chr2,201687602,1.5996501690781597,11216,7032,18248,+
chr2,201687603,1.5815926233774302,9670,5596,15266,+
chr2,201687605,1.413750651072494,10219,6033,16252,+
chr2,201687606,1.4071491018915914,7034,4193,11227,+
chr2,201687618,1.2512026813880126,7465,5071,12536,+
chr2,201687871,0.7446187709554402,618,438,1056,+
chr2,201687888,1.7524271844660195,1804,1029,2833,+
chr2,201687890,1.7524271844660195,1804,1029,2833,+
chr2,201687910,1.6851654215581644,1578,936,2514,+
chr2,201687914,1.597190517998244,1515,1004,2519,+
chr2,201687940,1.5936238902340596,3589,2300,5889,+
chr2,201687947,1.403919923803532,2947,2061,5008,+
chr2,201688229,1.2535799855653524,1841,1181,3022,+
chr2,201688235,1.134253249640462,2036,1384,3420,+
chr2,201688249,0.469917608737306,980,613,1593,+
chr2,201688253,1.7932692307692306,1118,703,1821,+
chr2,201688257,1.5060386473429952,1246,809,2055,+
chr2,201688259,1.591960028345284,2704,1913,4617,+
chr2,201688260,1.3928200399763806,3445,1966,5411,+
chr2,201688261,1.3928200399763806,3445,1966,5411,+
chr2,201688271,1.6149116064565718,2100,1300,3400,+
chr2,201688289,1.7646986634523583,5950,4109,10059,+
chr2,201688301,0.8717257499941269,8730,6080,14810,+
chr2,201757985,0.2530334377096846,786,525,1311,+
chr2,201757986,0.38529905900963113,2285,1515,3800,+
chr2,201757987,0.49948671825409646,1146,783,1929,+
chr2,201758038,0.4207920792079208,611,403,1014,+
chr2,201760019,1.855336737174812,586,456,1042,+
chr2,201768262,0.5640527493229718,736,446,1182,+
chr2,201936750,1.9984450318768463,917,544,1461,+
chr2,201936752,1.8003401300542379,1304,874,2178,+
chr2,201936769,1.3366653851082917,893,577,1470,+
chr2,201943612,0.6924176913452007,3316,2846,6162,+
chr2,201943613,0.6924176913452007,3316,2846,6162,+
chr2,201943637,1.2756054274818898,4581,3776,8357,+
chr2,201943718,1.653657616892911,1073,883,1956,+
chr2,201950312,1.5500588928150767,1127,848,1975,+
chr2,201950324,2.897427101200686,1235,794,2029,+
chr2,203130493,0.7374367402073737,1124,561,1685,+
chr2,203130605,2.184442661573681,1165,623,1788,+
chr2,203130606,2.184442661573681,1165,623,1788,+
chr2,203139840,2.5866441251056638,611,545,1156,+
chr2,203139844,2.025,656,583,1239,+
chr2,203149074,1.7849462365591398,663,495,1158,+
chr2,203149075,2.350569860700717,902,617,1519,+
chr2,203149081,1.9081770177680668,1329,992,2321,+
chr2,203149134,1.8535319341006546,763,632,1395,+
chr2,203149167,2.045466457023061,1164,1059,2223,+
chr2,203149169,2.453397416564531,1794,1750,3544,+
chr2,203149170,2.282048192771084,1221,1244,2465,+
chr2,203157504,1.7888198757763976,607,482,1089,+
chr2,203157512,2.107617051013277,623,476,1099,+
chr2,203157515,0.3854496913065242,692,460,1152,+
chr2,203157546,1.7396507601987057,796,510,1306,+
chr2,203157592,2.2884615384615388,713,623,1336,+
chr2,203160407,1.6491445062873635,799,538,1337,+
chr2,203160476,1.329213628002508,1070,790,1860,+
chr2,203160482,1.864925935224705,618,568,1186,+
chr2,207024616,1.3985786802030458,1007,590,1597,+
chr2,207024618,0.8452876104421915,7551,4212,11763,+
chr2,207024619,0.8430113234461678,7157,3998,11155,+
chr2,207024620,0.8107161487443176,1977,1135,3112,+
chr2,207024626,1.805129927375005,1074,580,1654,+
chr2,207024629,1.7885639986523671,3144,1824,4968,+
chr2,207024648,1.1493498819075925,16081,9619,25700,+
chr2,207024649,1.0526150162313308,18761,12478,31239,+
chr2,207024650,0.9615691076043066,15479,10400,25879,+
chr2,207024719,1.41736063623442,19191,12236,31427,+
chr2,207024720,1.408883779791087,15648,9543,25191,+
chr2,207025340,0.8037110747555841,4026,3371,7397,+
chr2,207025398,1.2776965200494612,3930,3144,7074,+
chr2,207025421,1.5455837545282491,6931,5217,12148,+
chr2,207025423,1.4807502020077516,10612,8112,18724,+
chr2,207025424,1.3900879434585873,13588,9387,22975,+
chr2,207026082,1.2650778774006557,15777,9714,25491,+
chr2,207026083,1.2650778774006557,15777,9714,25491,+
chr2,207027273,1.421327273492404,4824,3470,8294,+
chr2,208589561,3.7034476591229857,666,545,1211,+
chr2,210884452,1.6026410752094264,610,455,1065,+
chr2,211421325,2.8010786363705,855,544,1399,+
chr2,211421341,2.279326567507601,2196,1131,3327,+
chr2,211421342,2.0339921545389092,4581,2487,7068,+
chr2,211421343,2.0608612886401527,6312,3695,10007,+
chr2,211421344,1.4299591100779323,6113,3470,9583,+
chr2,211421345,1.4165432217340028,2957,1804,4761,+
chr2,211421346,1.083707341840595,5237,3215,8452,+
chr2,211421347,0.82937181663837,1953,1115,3068,+
chr2,211442228,1.5467991169977924,1143,905,2048,+
chr2,211452864,1.5809404790919894,3116,1980,5096,+
chr2,211454930,1.6126675866869724,4185,2901,7086,+
chr2,211456577,3.2521792322985164,685,502,1187,+
chr2,211456585,1.6870917119813147,1650,1033,2683,+
chr2,211457667,1.7223359422034918,1787,1207,2994,+
chr2,211459262,1.0500794287559954,1949,1466,3415,+
chr2,211460224,1.4920192024704384,2400,1748,4148,+
chr2,211460230,2.741058655221745,957,698,1655,+
chr2,211464246,2.1496755994358248,976,708,1684,+
chr2,211465285,1.822517723845605,1592,1005,2597,+
chr2,211465293,1.4514653611427808,1773,1146,2919,+
chr2,211471461,1.963739837398374,928,737,1665,+
chr2,211473109,1.6611775254034666,1792,1194,2986,+
chr2,211473110,1.48950780048341,985,887,1872,+
chr2,211473225,0.6932709357736885,2902,2126,5028,+
chr2,211473259,2.264251968503937,1026,761,1787,+
chr2,211476877,0.6795868175110673,3453,2246,5699,+
chr2,211476906,1.28982695057631,11542,6863,18405,+
chr2,211476907,1.6275009763230317,7096,4275,11371,+
chr2,211476908,1.6275009763230317,7096,4275,11371,+
chr2,211476911,1.8488176767024165,2554,1634,4188,+
chr2,211476965,1.3805705705705704,1482,1109,2591,+
chr2,211477003,1.321048628914013,10805,7575,18380,+
chr2,211502439,1.4818798400566888,1194,858,2052,+
chr2,211502537,1.593166438077439,2429,1542,3971,+
chr2,211502539,1.9216054013503376,1089,859,1948,+
chr2,211507223,1.9893617021276602,713,563,1276,+
chr2,211507242,1.5631720430107527,1162,929,2091,+
chr2,211507261,1.9277048774449124,686,576,1262,+
chr2,211507286,0.708426382470648,1334,993,2327,+
chr2,211507378,0.760745392577632,1460,931,2391,+
chr2,211512598,1.5053131260343176,3121,1805,4926,+
chr2,211512621,1.8813688902710828,2166,1307,3473,+
chr2,211512704,1.753116834639791,1020,892,1912,+
chr2,211512719,0.5628375861426709,966,825,1791,+
chr2,211512771,0.4368939730020914,1102,1017,2119,+
chr2,211513208,1.7180852345274518,1980,1338,3318,+
chr2,211518795,1.4820009563059267,2033,1186,3219,+
chr2,211518796,1.1105413732394367,1601,1279,2880,+
chr2,211518797,1.3288584494962925,3021,2372,5393,+
chr2,211521350,0.583519981138748,659,498,1157,+
chr2,211527901,1.483506343713956,1743,1155,2898,+
chr2,211540526,0.6291793313069908,872,678,1550,+
chr2,211540559,1.4010278220804535,1205,890,2095,+
chr2,211541739,1.6865599458335352,810,666,1476,+
chr2,211542646,1.7464156504675568,3119,2187,5306,+
chr2,211542733,1.355255806528853,2263,1473,3736,+
chr2,211542967,2.357243037467441,904,712,1616,+
chr2,211543229,2.5199142156862746,704,575,1279,+
chr2,211543409,0.4299468791500663,924,752,1676,+
chr2,211543410,1.9308600770218227,1418,1024,2442,+
chr2,211543728,1.8711426188490412,640,544,1184,+
chr2,215712171,3.177919209169209,629,444,1073,+
chr2,216177237,1.2979507626668334,920,680,1600,+
chr2,216177238,0.5100334448160535,609,467,1076,+
chr2,216177255,0.3634146341463414,893,573,1466,+
chr2,216177256,0.3634146341463414,893,573,1466,+
chr2,216177264,1.791536488250189,856,615,1471,+
chr2,216182926,2.2736500203004466,1231,820,2051,+
chr2,216182927,2.2736500203004466,1231,820,2051,+
chr2,216184412,0.5444015444015444,610,480,1090,+
chr2,216191670,2.9580818594374985,746,560,1306,+
chr2,216198137,0.5163934426229508,566,487,1053,+
chr2,216199696,2.255891082720351,1170,888,2058,+
chr2,216211610,0.5523962393946342,802,622,1424,+
chr2,216211615,0.585511575802838,979,714,1693,+
chr2,216211619,0.5370542769709096,2775,1893,4668,+
chr2,216974112,0.5978248421863875,653,516,1169,+
chr2,216974124,0.6886356509452147,742,561,1303,+
chr2,216974175,1.6960659898477155,890,590,1480,+
chr2,216977777,0.4688319636300052,714,601,1315,+
chr2,216981469,1.557181430189008,1276,800,2076,+
chr2,216981479,1.8036170212765963,1383,939,2322,+
chr2,216981484,1.8065913945682026,758,564,1322,+
chr2,216981494,1.1350478521210816,2562,1931,4493,+
chr2,216981561,1.5664437826599988,1051,961,2012,+
chr2,216981562,3.4407948929159797,710,606,1316,+
chr2,216982478,1.5261971830985916,755,709,1464,+
chr2,216995659,1.4834205121735933,3290,2095,5385,+
chr2,217001889,1.7684464686125572,2726,2010,4736,+
chr2,217001890,2.7153731735059936,1577,1038,2615,+
chr2,217002831,0.4649904046017946,3121,1929,5050,+
chr2,217002865,1.9022256790714367,2238,1369,3607,+
chr2,217002872,1.7466832515479984,3943,2454,6397,+
chr2,217002873,0.6903513788283135,3342,2439,5781,+
chr2,217002874,1.7466832515479984,3943,2454,6397,+
chr2,217002880,0.759297847915486,4282,3044,7326,+
chr2,217005914,2.0091185496222037,6644,5281,11925,+
chr2,217005916,2.068159176099924,10141,8235,18376,+
chr2,217005917,2.131256199311512,6891,5712,12603,+
chr2,217005926,1.4054981630357157,10614,8724,19338,+
chr2,217012875,2.0136877428470505,690,595,1285,+
chr2,217012944,0.6227824463118581,956,692,1648,+
chr2,217012959,0.5386671895839028,2396,1767,4163,+
chr2,217024813,0.6500513596799482,1001,697,1698,+
chr2,217026721,1.758097165991903,578,493,1071,+
chr2,217026750,1.7618927125506074,1265,987,2252,+
chr2,217069093,2.511492063492063,681,524,1205,+
chr2,217069947,1.651257302514605,590,507,1097,+
chr2,217070542,5.3944873669377476,648,492,1140,+
chr2,217363565,1.081628076808533,6275,5166,11441,+
chr2,217363566,1.0106542614558385,8205,6257,14462,+
chr2,217363570,1.0105946639174508,5014,4358,9372,+
chr2,217363571,1.4744316714583148,8078,5697,13775,+
chr2,217363572,1.209826390385243,8855,7113,15968,+
chr2,217363573,1.5606975221819868,9141,5841,14982,+
chr2,217363578,0.7046979466017655,6212,5546,11758,+
chr2,217363580,0.9737128544682749,6996,5896,12892,+
chr2,217363595,1.4488120299559542,3547,3038,6585,+
chr2,217364004,0.951082207212516,15455,12144,27599,+
chr2,217364005,0.9645604881798964,16238,11998,28236,+
chr2,217364008,1.448727078511661,7439,4383,11822,+
chr2,217364022,0.9795761267464648,17167,9920,27087,+
chr2,217364023,0.800373079647857,12429,9408,21837,+
chr2,217364024,0.8701798583687008,36184,24577,60761,+
chr2,217364041,1.4058139140029409,16156,12787,28943,+
chr2,217364059,1.3586757395768063,24490,16907,41397,+
chr2,217364071,1.2686508344277234,11951,9857,21808,+
chr2,217364077,1.1777326149339145,33809,23979,57788,+
chr2,217364750,1.352976135139052,34367,24632,58999,+
chr2,217366085,1.3492053493647853,23298,16430,39728,+
chr2,219090644,1.9533342519080499,1373,1049,2422,+
chr2,219090668,1.8636565836298933,930,842,1772,+
chr2,219090669,1.8636565836298933,930,842,1772,+
chr2,219103414,1.932985858826022,1195,907,2102,+
chr2,219103470,0.4732186732186732,641,439,1080,+
chr2,219104126,1.8057004470938895,717,487,1204,+
chr2,219110247,3.0467165946519237,777,464,1241,+
chr2,219114137,5.219683366076002,814,604,1418,+
chr2,219114621,1.0108303249097472,719,553,1272,+
chr2,219114622,1.0108303249097472,719,553,1272,+
chr2,219118709,2.245360824742268,725,581,1306,+
chr2,219118710,1.4977540168712886,1300,1004,2304,+
chr2,219118877,3.2880294083553574,601,439,1040,+
chr2,219460573,2.1827705545755456,2030,1707,3737,+
chr2,219460574,2.182770554575545,2030,1707,3737,+
chr2,220097064,2.380597014925373,782,602,1384,+
chr2,220097065,2.380597014925373,782,602,1384,+
chr2,220097066,2.41073971434205,988,813,1801,+
chr2,223781151,1.9381793413257675,1036,744,1780,+
chr2,223781185,1.6226990671133816,903,623,1526,+
chr2,223782767,3.416216216216216,631,480,1111,+
chr2,223782768,3.416216216216216,631,480,1111,+
chr2,223786009,2.410905791123577,834,550,1384,+
chr2,223786011,2.410905791123577,834,550,1384,+
chr2,223786084,3.3184887406686876,770,528,1298,+
chr2,223786101,0.9962310165170157,816,581,1397,+
chr2,223786102,0.9962310165170157,816,581,1397,+
chr2,223787471,0.23956834532374102,665,416,1081,+
chr2,223797888,2.283524904214559,595,463,1058,+
chr2,228193393,2.116950407105848,623,385,1008,+
chr2,228193395,2.039860777967952,1656,1184,2840,+
chr2,228193396,1.9284632216798523,683,456,1139,+
chr2,228193436,0.5137331838565022,610,445,1055,+
chr2,228193448,1.8734545454545453,735,624,1359,+
chr2,228195452,1.611111111111111,668,445,1113,+
chr2,228195456,2.0366598778004072,699,490,1189,+
chr2,228195463,1.990668740279938,831,642,1473,+
chr2,228197174,1.5275838208467007,933,756,1689,+
chr2,228197198,1.508568754752296,991,833,1824,+
chr2,228217265,1.77638940693771,634,382,1016,+
chr2,228221702,1.9736278211453053,2000,1588,3588,+
chr2,228388553,1.417677234578643,615,421,1036,+
chr2,228418504,2.9126876294874258,947,747,1694,+
chr2,228419410,1.0214424951267056,785,647,1432,+
chr2,228419412,0.8335224668282147,1464,1097,2561,+
chr2,228419500,2.0462962962962963,805,557,1362,+
chr2,231740341,0.9885087704571874,610,499,1109,+
chr2,231927347,0.3916666666666667,751,359,1110,+
chr2,231927348,0.3380707494048383,1401,693,2094,+
chr2,231927365,1.9503468858929174,1694,928,2622,+
chr2,231931629,3.351709811441355,838,297,1135,+
chr2,231931634,2.6057379473528544,880,321,1201,+
chr2,231931643,2.2575881261595545,1048,384,1432,+
chr2,231931655,2.475609756097561,1217,491,1708,+
chr2,231947673,2.1421776922575386,627,391,1018,+
chr2,232573263,1.3448121429751296,1254,863,2117,+
chr2,232573344,0.4964200477326969,584,418,1002,+
chr2,232573360,2.1742313323572477,1121,682,1803,+
chr2,232573362,2.015356807068024,2208,1173,3381,+
chr2,232573366,1.8611602753195675,1182,564,1746,+
chr2,232573377,0.5764637378046606,1077,816,1893,+
chr2,232573378,1.522841207491482,1492,780,2272,+
chr2,232573447,1.7544339006772651,4529,2986,7515,+
chr2,232576607,1.7845158197507194,1488,1042,2530,+
chr2,232576675,4.42374739039666,1486,957,2443,+
chr2,232576678,5.500024567632638,5871,3908,9779,+
chr2,232577158,2.8577290119372103,6468,4876,11344,+
chr2,232577168,1.7002970972996223,7112,5777,12889,+
chr2,232577592,1.0876666666666668,1505,1199,2704,+
chr2,232577593,1.0876666666666668,1505,1199,2704,+
chr2,232577634,0.6786096256684492,1160,945,2105,+
chr2,232577759,1.883466553427391,1574,966,2540,+
chr2,232577760,0.47727272727272735,626,483,1109,+
chr2,232577762,1.995224643529728,1744,1238,2982,+
chr2,232577763,1.901754774536751,2298,1546,3844,+
chr2,232577797,1.6014094601051123,1307,727,2034,+
chr2,232578020,5.61345029239766,661,341,1002,+
chr2,232578055,1.386129525849153,1502,912,2414,+
chr2,232578080,1.941434468524252,601,455,1056,+
chr2,232578089,1.883587786259542,1469,916,2385,+
chr2,232578095,1.6050545995531185,2284,1915,4199,+
chr2,232578099,1.628811188811189,1940,1264,3204,+
chr2,232578103,2.126896551724138,1027,811,1838,+
chr2,232578104,0.7402874986540325,3021,2007,5028,+
chr2,233247064,2.660633484162896,685,363,1048,+
chr2,233247066,2.8653470490618784,835,456,1291,+
chr2,233247085,0.4962727131542164,1161,821,1982,+
chr2,233247087,0.4962727131542164,1161,821,1982,+
chr2,233247100,3.4418604651162794,813,472,1285,+
chr2,233320833,0.7952468297681069,865,800,1665,+
chr2,233320862,0.9311732389300066,8952,5723,14675,+
chr2,233320863,0.9782909586374491,7626,4936,12562,+
chr2,233320866,2.030194879884321,4981,2253,7234,+
chr2,233320867,2.030194879884321,4981,2253,7234,+
chr2,233320871,1.8567612086984209,5707,2791,8498,+
chr2,233320872,1.7224981992511004,7379,4296,11675,+
chr2,233320878,1.2620292887029287,6984,3584,10568,+
chr2,233320879,1.1391768698175024,8671,5192,13863,+
chr2,233320907,1.0888559253581314,7517,4699,12216,+
chr2,233320967,1.254398318815754,3689,2728,6417,+
chr2,233320977,1.5419566514217538,1192,641,1833,+
chr2,233320995,1.8115956321325337,1962,1286,3248,+
chr2,233321020,2.1937603323301262,1326,760,2086,+
chr2,233321038,1.897470950102529,693,538,1231,+
chr2,233321057,1.6697613961518774,1983,1518,3501,+
chr2,233321067,1.3063147973609803,4157,3182,7339,+
chr2,233321117,1.315123459363589,14419,10011,24430,+
chr2,233321118,1.3447577701379807,8376,6550,14926,+
chr2,233321136,1.349318525996971,6398,3870,10268,+
chr2,233321147,1.1616343787398327,14513,9941,24454,+
chr2,233321318,1.475575662074925,4465,3295,7760,+
chr2,233321319,1.3633502646254396,3575,2994,6569,+
chr2,233321326,0.8255594228145887,6283,4708,10991,+
chr2,233321402,1.5574608990515637,5702,4164,9866,+
chr2,233321607,0.4758187954976865,1273,772,2045,+
chr2,233321612,1.5025169670767555,6325,4738,11063,+
chr2,233321680,1.53496513104761,6010,4534,10544,+
chr2,233321716,1.3117484561506125,14228,10938,25166,+
chr2,233321717,1.224512262246957,8882,5228,14110,+
chr2,233321728,1.2705826020497426,6467,4973,11440,+
chr2,233321994,1.5681375127935027,11128,9181,20309,+
chr2,233322024,1.3977260446856026,6652,5400,12052,+
chr2,233322295,1.2027462483766111,5500,4331,9831,+
chr2,233322301,1.2262251934216737,9178,5525,14703,+
chr2,233322329,1.274248470527766,5757,4411,10168,+
chr2,233322386,1.5609550182192553,19115,15357,34472,+
chr2,233322387,1.5609550182192553,19115,15357,34472,+
chr2,233322388,1.5609550182192553,19115,15357,34472,+
chr2,233322556,0.6958230875561825,11353,8593,19946,+
chr2,233322558,2.067706258968587,43270,34041,77311,+
chr2,233322559,1.6641881293807854,86022,68189,154211,+
chr2,233322560,1.6637583557742022,119338,96471,215809,+
chr2,233322561,1.7954549272379345,89101,69163,158264,+
chr2,233322562,1.5231423854404427,104543,80259,184802,+
chr2,233322565,0.6365386037820849,57504,41093,98597,+
chr2,233322566,0.9012722401308939,75947,59132,135079,+
chr2,233322567,0.6523038010900967,72776,49849,122625,+
chr2,233322572,1.4182190080546602,60164,47587,107751,+
chr2,233322805,1.8478937593191669,4606,3141,7747,+
chr2,233322808,1.2754155097882711,6301,3408,9709,+
chr2,233322965,1.7069688069949576,5040,3823,8863,+
chr2,233323115,1.1630732362045932,14910,10607,25517,+
chr2,233323433,1.3880810287123482,4712,4054,8766,+
chr2,233323440,1.3702042352061259,13983,10756,24739,+
chr2,233323578,1.3520401122870065,5142,4260,9402,+
chr2,233323689,1.2070920348695109,3950,3201,7151,+
chr2,233323789,1.3656829722217423,6393,3850,10243,+
chr2,233323846,1.421326643525853,5114,4000,9114,+
chr2,233323870,1.3578216519113249,7049,5619,12668,+
chr2,233323871,1.237517739552891,11602,7043,18645,+
chr2,233323872,1.3152415165266085,21332,15070,36402,+
chr2,233323905,1.4646277766356124,14860,10909,25769,+
chr2,233323926,1.2331162390901877,3692,3183,6875,+
chr2,233323975,0.8038007970921331,6849,5032,11881,+
chr2,233323977,1.1537389805055758,8921,5136,14057,+
chr2,233323978,1.2683231363171963,9720,8204,17924,+
chr2,233324073,1.599638314869535,14647,9894,24541,+
chr2,233324080,1.470978473053777,4835,3372,8207,+
chr2,233324083,1.6638784868230734,8038,4757,12795,+
chr2,233324097,1.462234360489815,5980,4738,10718,+
chr2,233324213,1.4448321585595645,5024,4024,9048,+
chr2,233324424,1.2227457158764314,14568,9627,24195,+
chr2,233324511,1.0427587079608946,19303,15268,34571,+
chr2,233324564,1.2556409059377711,15917,10798,26715,+
chr2,233324638,1.2448101315735596,8549,4932,13481,+
chr2,233324651,1.1336674774580187,25914,18525,44439,+
chr2,233324660,1.599112495316598,6264,5337,11601,+
chr2,233324841,1.6986056850330054,2694,2283,4977,+
chr2,233324960,4.703703703703703,1142,80,1222,+
chr2,233324962,6.6125603864734295,1710,114,1824,+
chr2,233324963,10.026408450704226,1138,70,1208,+
chr2,233324965,16.099110988975678,4752,241,4993,+
chr2,233324966,15.436470140407422,3716,198,3914,+
chr2,233324967,10.766382522874665,9354,516,9870,+
chr2,233324968,14.080717091629767,8335,642,8977,+
chr2,233324969,13.503982487473646,7126,788,7914,+
chr2,233324970,11.469910644272813,9032,1125,10157,+
chr2,233324971,9.089875805912476,9302,1479,10781,+
chr2,233324973,5.7719372314405115,5362,1027,6389,+
chr2,233324974,2.7526315789473683,1568,227,1795,+
chr2,233324978,3.3096948098411585,5221,1348,6569,+
chr2,233324979,4.3219863498040345,11234,4028,15262,+
chr2,233324980,4.108480138074417,12106,4312,16418,+
chr2,233324981,4.27980385179062,10467,3970,14437,+
chr2,233324982,3.481781327960084,2568,771,3339,+
chr2,233324991,2.44532279314888,927,362,1289,+
chr2,233324992,3.720045857450437,3325,1702,5027,+
chr2,233324993,3.767323342757779,5636,3384,9020,+
chr2,233324994,3.581970493008083,5937,3323,9260,+
chr2,233324999,0.6705721901927966,745,565,1310,+
chr2,233325001,2.367075452088963,1167,565,1732,+
chr2,233325007,3.3863569822161175,8771,6367,15138,+
chr2,233325008,3.3863569822161175,8771,6367,15138,+
chr2,233325013,1.6570541259982254,1327,783,2110,+
chr2,233325018,4.994481197508607,15370,15034,30404,+
chr2,233325019,4.994481197508607,15370,15034,30404,+
chr2,233325020,4.994481197508607,15370,15034,30404,+
chr2,233325026,0.6520667966157909,4879,4902,9781,+
chr2,233325089,0.7158028261583963,6892,5369,12261,+
chr2,233325090,0.6806909467796071,10032,7583,17615,+
chr2,233325147,7.5055159604715,18275,7620,25895,+
chr2,233325148,6.850700916117651,12262,4613,16875,+
chr2,233325149,7.268909672602178,13301,5982,19283,+
chr2,233325152,8.176180294583636,7899,4020,11919,+
chr2,233325155,11.845498866317344,8003,4903,12906,+
chr2,233325159,5.502777886767748,8247,5615,13862,+
chr2,233325165,1.6753658304793824,13122,9773,22895,+
chr2,233325166,1.5814950899412767,8691,6234,14925,+
chr2,233325175,4.567029489418556,5229,5926,11155,+
chr2,233325176,3.6860758120918145,21502,21878,43380,+
chr2,233325177,3.6860758120918145,21502,21878,43380,+
chr2,233325178,3.0846199172830904,4636,5865,10501,+
chr2,233325181,1.6698772149106684,1669,2344,4013,+
chr2,233325185,0.6938612162592422,1762,2457,4219,+
chr2,233325214,0.6933989378432216,5696,5405,11101,+
chr2,233325237,0.9788769311756387,9851,9142,18993,+
chr2,233385068,1.7905479185634177,671,566,1237,+
chr2,233385107,0.9065465217930085,1125,952,2077,+
chr2,233385109,0.4970737417089348,818,698,1516,+
chr2,233385110,1.7374999999999998,833,479,1312,+
chr2,233385138,2.1145228215767635,587,481,1068,+
chr2,233385143,4.096014492753623,3625,2552,6177,+
chr2,233385144,4.46163146003733,9215,7643,16858,+
chr2,233385145,4.02928456288813,10340,8575,18915,+
chr2,233385146,2.601856984478936,3754,2859,6613,+
chr2,233385147,2.382743476036159,2140,1803,3943,+
chr2,233385171,0.5654716501398424,1667,1310,2977,+
chr2,233385183,0.9602879158085053,2251,2201,4452,+
chr2,233385184,0.9602879158085053,2251,2201,4452,+
chr2,233385185,0.7521635739903323,2030,1451,3481,+
chr2,233385187,0.7176014594689648,4115,3812,7927,+
chr2,233385219,0.7503745996135841,3114,2528,5642,+
chr2,233385237,1.2922875117922565,3671,2962,6633,+
chr2,233385248,1.490427110817942,2030,1515,3545,+
chr2,233385372,1.5452955082742317,1420,1174,2594,+
chr2,233385402,1.3494907773402736,3999,2798,6797,+
chr2,233386069,1.4458739674220906,4173,4158,8331,+
chr2,233386071,1.4458739674220906,4173,4158,8331,+
chr2,233386088,0.7663586207929093,2988,2207,5195,+
chr2,233386119,1.2979589835287453,4939,3482,8421,+
chr2,233386706,1.5419888029858704,1686,846,2532,+
chr2,233386780,2.4726158175057784,1329,641,1970,+
chr2,233386818,4.608615452219521,2561,1610,4171,+
chr2,233386828,2.03397341211226,764,676,1440,+
chr2,233386857,1.4962563939315343,2481,1730,4211,+
chr2,233386862,1.385814185814186,1529,1154,2683,+
chr2,233386863,1.724069675376089,870,841,1711,+
chr2,233387296,1.3879437869822484,1945,1182,3127,+
chr2,233387321,1.3717180489216965,1101,986,2087,+
chr2,233387413,1.5940733408602314,2453,1557,4010,+
chr2,233387562,1.6210982437303474,1690,883,2573,+
chr2,233387782,1.5284001115552663,801,693,1494,+
chr2,233387792,0.6407067492152075,1366,975,2341,+
chr2,233387895,1.7572480324955573,1305,1009,2314,+
chr2,233387898,1.627652488343325,1865,1016,2881,+
chr2,233388149,1.549890533971576,907,690,1597,+
chr2,233388183,1.7799043062200957,2231,1272,3503,+
chr2,233388236,2.115501582584139,10025,6632,16657,+
chr2,233388237,2.1524609158185917,11154,6889,18043,+
chr2,233388239,2.108996845305423,4248,2252,6500,+
chr2,233388568,1.8444192313147072,764,640,1404,+
chr2,233388570,1.452309737454304,1149,884,2033,+
chr2,233388574,1.4017319829737265,954,756,1710,+
chr2,233388789,2.069317023445464,579,435,1014,+
chr2,233388821,1.7353206865401989,1242,593,1835,+
chr2,233389068,1.7564263222157959,1852,987,2839,+
chr2,233389472,1.0373903940272293,2458,1859,4317,+
chr2,233389474,1.3908841405422052,1764,976,2740,+
chr2,233389477,1.3861906549711591,1933,1058,2991,+
chr2,233389507,1.5640205695518774,2128,1267,3395,+
chr2,233389540,1.5562835738307124,3665,2728,6393,+
chr2,233389543,0.7838983050847458,2589,2005,4594,+
chr2,233389939,0.6734037577632718,5794,4469,10263,+
chr2,233390068,2.25974025974026,695,538,1233,+
chr2,233390113,1.73560443490701,1644,931,2575,+
chr2,233390244,1.4900199600798405,1492,667,2159,+
chr2,233390248,1.5037159717196458,1714,780,2494,+
chr2,233390251,1.9486059761358037,2634,1317,3951,+
chr2,233390284,0.6155770642410117,4192,2254,6446,+
chr2,233390285,0.6126789778456397,6395,3369,9764,+
chr2,233390287,0.580490270008846,6645,3118,9763,+
chr2,233390293,0.6711271230056614,1303,637,1940,+
chr2,233390329,9.063704491998191,22037,5139,27176,+
chr2,233390330,9.397097834218412,29514,7991,37505,+
chr2,233390331,9.397097834218412,29514,7991,37505,+
chr2,233390332,10.51060960513496,22256,6559,28815,+
chr2,233390336,11.314384274191765,4889,2695,7584,+
chr2,233390337,12.26304666204246,9741,4665,14406,+
chr2,233390341,22.562388617714007,20378,20414,40792,+
chr2,233390342,17.492883609554372,27615,29434,57049,+
chr2,233390343,16.69577287611102,24369,24987,49356,+
chr2,233390344,15.740432840106983,20490,23899,44389,+
chr2,233390367,0.5273919326926617,2574,3291,5865,+
chr2,233415443,1.02795,622,399,1021,+
chr2,233415444,1.02795,622,399,1021,+
chr2,233431667,18.813994291751722,730,482,1212,+
chr2,234343029,1.151337629369264,736,568,1304,+
chr2,234343030,1.4143761644925779,1355,1111,2466,+
chr2,234343035,2.3736391912908243,659,642,1301,+
chr2,234343040,2.543238146551724,716,767,1483,+
chr2,234357918,1.6149379783584057,632,420,1052,+
chr2,234357932,2.138755980861244,893,417,1310,+
chr2,234357934,1.6913967869437716,1414,681,2095,+
chr2,234357935,1.1470538624322038,2905,1760,4665,+
chr2,234357936,0.893271565904881,2483,1670,4153,+
chr2,234357949,1.6139720878330988,4397,3054,7451,+
chr2,234357950,1.4141281862344839,5572,3843,9415,+
chr2,234357951,1.798188962924996,5433,3901,9334,+
chr2,234357952,0.6172688509874327,1666,1113,2779,+
chr2,234357953,1.9899013867387585,4486,3432,7918,+
chr2,234357954,1.8678586408707014,4029,2904,6933,+
chr2,234357961,1.8010204081632657,1058,587,1645,+
chr2,237033157,0.26821223469227995,541,479,1020,+
chr2,237033158,0.2532629304091607,555,477,1032,+
chr2,237034111,3.3416194348639956,663,407,1070,+
chr2,237034121,3.866220735785953,611,413,1024,+
chr2,237034122,2.91358301191626,1078,728,1806,+
chr2,237034144,1.6807432432432432,1392,1035,2427,+
chr2,237034145,1.6807432432432432,1392,1035,2427,+
chr2,237995786,3.2557852990980938,651,417,1068,+
chr2,237998543,2.542190140784635,683,528,1211,+
chr2,238006321,0.9503676470588235,704,543,1247,+
chr2,238006323,0.683165443731123,2060,1637,3697,+
chr2,238006324,0.5925132598939208,784,569,1353,+
chr2,238671954,1.6709558823529411,706,475,1181,+
chr2,239756684,0.4319843111227697,681,657,1338,+
chr2,239756691,2.1207271708048054,846,692,1538,+
chr2,239757240,0.5802354686196348,568,468,1036,+
chr2,242089896,1.5558949060699119,885,417,1302,+
chr2,242089938,1.4887828150633202,1703,779,2482,+
chr2,242089939,1.852759331348752,898,396,1294,+
chr2,242089950,3.2635841471976947,922,386,1308,+
chr2,242265408,2.7639671075106143,758,564,1322,+
chr2,242274553,1.0397883382517554,785,633,1418,+
chr2,242274555,1.0397883382517554,785,633,1418,+
chr2,242276852,2.283362218370884,764,576,1340,+
chr2,242276899,1.7473524962178513,923,660,1583,+
chr2,242276902,1.7567132979578708,949,690,1639,+
chr2,242282423,0.4477958236658932,578,430,1008,+
chr2,242282440,2.2260545934290774,2997,2404,5401,+
chr2,242282441,2.4152221428726004,1716,1265,2981,+
chr2,242282442,1.1963666068117225,3167,2779,5946,+
chr2,242282483,2.5996767241379306,578,463,1041,+
chr2,242282484,1.6276529338327088,1042,711,1753,+
chr2,242285598,0.9819866384433159,1070,829,1899,+
chr2,242285624,0.5293370721125866,666,460,1126,+
chr2,242289567,5.253257097071455,2816,1740,4556,+
chr2,242289568,4.999180327868853,962,609,1571,+
chr2,242289569,4.344921390753866,3280,1997,5277,+
chr2,242289571,3.6999161863130787,1892,1249,3141,+
chr2,242289577,26.143806963938715,1440,1336,2776,+
chr2,242289606,0.5460188933873145,577,493,1070,+
chr2,242291421,1.7320194146197971,735,522,1257,+
chr2,242291467,1.8771070450943668,908,630,1538,+
chr2,242291623,1.7149359886201991,1232,854,2086,+
chr2,242291688,1.8910931174089067,691,519,1210,+
chr2,242291692,1.7236883942766297,1250,1019,2269,+
chr2,242292355,2.071393687527952,1069,704,1773,+
chr2,242292561,2.0381330685203576,732,529,1261,+
chr2,242292595,1.9174664107485604,739,520,1259,+
chr2,242292847,2.175088760042574,1091,803,1894,+
chr2,242292897,1.2676378931503745,2114,1314,3428,+
chr2,242292898,0.8700436500979476,1641,1105,2746,+
chr2,242292932,1.9505404893034424,1374,942,2316,+
chr2,242292937,1.878558283389564,1773,1300,3073,+
chr2,242293023,2.8239795918367347,696,475,1171,+
chr2,242293248,1.9963870715750418,704,538,1242,+
chr2,242293258,1.777047834232309,1577,1102,2679,+
chr2,242293308,2.0487264673311185,999,644,1643,+
chr2,242592987,2.145570953205153,606,458,1064,+
chr2,669484,3.7666320591254743,628,511,1139,-
chr2,669832,2.4625977372524064,622,464,1086,-
chr2,675589,0.5555828220858896,848,488,1336,-
chr2,675590,0.5555828220858896,848,488,1336,-
chr2,675618,4.590231362467866,863,388,1251,-
chr2,1635779,1.765898076075782,1001,618,1619,-
chr2,1635787,2.097524604831494,540,478,1018,-
chr2,1636357,0.43408203125,634,511,1145,-
chr2,1636424,3.1133530193158396,921,722,1643,-
chr2,1636501,4.2267289104028505,798,627,1425,-
chr2,1636735,1.5413915465121502,745,542,1287,-
chr2,1636914,2.1399095417170027,866,666,1532,-
chr2,1636935,0.823130350508803,636,452,1088,-
chr2,1636936,0.823130350508803,636,452,1088,-
chr2,1636940,0.8900453267449404,716,497,1213,-
chr2,1636944,0.757413162250649,619,444,1063,-
chr2,1637039,2.3390049372041744,1348,1077,2425,-
chr2,1637040,1.9709618874773136,723,721,1444,-
chr2,1637164,2.0552301255230123,613,477,1090,-
chr2,1637230,1.68609022556391,850,702,1552,-
chr2,1637277,2.902597402597402,893,703,1596,-
chr2,1637307,2.722205925491347,639,486,1125,-
chr2,1637506,1.673997084732873,561,508,1069,-
chr2,1637599,1.7071840423874085,625,557,1182,-
chr2,1637683,1.4533957655195622,2236,1708,3944,-
chr2,1637686,0.7191195613585263,1687,1254,2941,-
chr2,1637720,1.509076401356473,1512,1113,2625,-
chr2,1637749,3.2070707070707067,634,485,1119,-
chr2,1637795,1.1496078513475099,1475,1133,2608,-
chr2,1637835,1.569265889703232,705,573,1278,-
chr2,1637879,2.2735527510579554,1076,939,2015,-
chr2,1637886,1.6167180011007536,1601,1107,2708,-
chr2,1637988,1.805536697593724,747,490,1237,-
chr2,1638000,1.4645098039215687,1066,611,1677,-
chr2,1638005,0.46146953405017926,926,557,1483,-
chr2,1638007,1.8274950429610044,947,533,1480,-
chr2,1638012,0.5716252831697242,756,478,1234,-
chr2,1638036,1.8057553956834531,752,416,1168,-
chr2,1638069,3.162016806722689,817,424,1241,-
chr2,1639188,1.9828259172521467,634,426,1060,-
chr2,1642677,1.4891908896438906,1258,882,2140,-
chr2,1642724,2.896975781151964,678,612,1290,-
chr2,1642725,1.6906055900621118,1004,735,1739,-
chr2,1643100,1.7973025106937741,1573,1131,2704,-
chr2,1643145,0.5547445255474452,911,684,1595,-
chr2,1643160,1.758706467661692,1009,669,1678,-
chr2,1643171,1.7084002027536491,1381,996,2377,-
chr2,1643172,2.223437879893022,589,456,1045,-
chr2,1643175,1.55811482930127,786,530,1316,-
chr2,1647145,1.7115902964959568,634,423,1057,-
chr2,1647213,2.0817698015061894,818,730,1548,-
chr2,1647237,2.9679283572223243,934,827,1761,-
chr2,1647294,1.100313320539881,1376,1026,2402,-
chr2,1647300,1.465069819636338,1320,945,2265,-
chr2,1647336,1.6318336968699791,2192,1434,3626,-
chr2,1647342,3.9484777517564402,842,548,1390,-
chr2,1652014,1.3646248108187684,3969,3496,7465,-
chr2,1652016,1.479727353418968,2387,2058,4445,-
chr2,1652020,1.5551967753120666,1258,823,2081,-
chr2,1652024,1.488386376326075,1158,994,2152,-
chr2,1652031,0.5675985153597094,1624,1637,3261,-
chr2,1652032,0.9144366351729301,2511,2185,4696,-
chr2,1652033,2.1834061135371177,559,457,1016,-
chr2,1652050,2.118542848611526,644,393,1037,-
chr2,1652078,0.5240550073179149,1220,1324,2544,-
chr2,1652079,0.548960057394253,1255,1543,2798,-
chr2,1652117,0.1623520710059171,438,1143,1581,-
chr2,1652171,4.864751410205956,2189,3464,5653,-
chr2,1652172,7.243279832888805,7162,11408,18570,-
chr2,1652173,7.313215694436809,7808,11591,19399,-
chr2,1652174,8.434759522881757,7043,10378,17421,-
chr2,1652175,14.552616184595388,2007,1447,3454,-
chr2,1652280,1.6004787415935255,738,565,1303,-
chr2,1652308,2.1545053378066807,1749,1570,3319,-
chr2,1652309,0.5656934306569343,619,547,1166,-
chr2,1652310,2.175066312997348,1079,1043,2122,-
chr2,1652340,1.711888111888112,815,494,1309,-
chr2,1652405,1.127245508982036,752,667,1419,-
chr2,1652407,1.5284800208574787,1805,1270,3075,-
chr2,1652507,1.5546744411860933,1220,1024,2244,-
chr2,1652592,2.479252951209525,529,487,1016,-
chr2,1652661,1.0863350485991994,799,423,1222,-
chr2,1652663,1.0863350485991994,799,423,1222,-
chr2,1653195,1.7342142040401474,545,462,1007,-
chr2,1653233,3.803644914756026,646,377,1023,-
chr2,1653306,1.2642563350374658,1070,622,1692,-
chr2,1653363,1.7509424556812163,1123,822,1945,-
chr2,1653365,1.7509424556812163,1123,822,1945,-
chr2,1657467,1.514481185860889,1373,876,2249,-
chr2,1657496,1.8412698412698414,735,551,1286,-
chr2,1658241,1.8817097415506963,630,502,1132,-
chr2,1658263,0.639363432987594,1005,595,1600,-
chr2,1664784,1.9433844360041859,1405,984,2389,-
chr2,1664788,1.597225470519191,1329,916,2245,-
chr2,1667447,2.132668144863267,795,491,1286,-
chr2,1667474,1.63508172211987,1154,744,1898,-
chr2,1667480,1.7920385187563166,930,724,1654,-
chr2,1668807,0.3653381642512077,604,551,1155,-
chr2,1670024,3.0345963756177925,920,606,1526,-
chr2,1670030,0.6230000000000001,622,474,1096,-
chr2,1670050,0.5015748031496063,636,507,1143,-
chr2,1670067,2.9344565821144237,586,490,1076,-
chr2,1670077,2.1665248592534003,2009,1304,3313,-
chr2,1670078,2.2677871148459383,1103,764,1867,-
chr2,1670083,1.5951107715813595,782,475,1257,-
chr2,1670107,2.015163576390693,1028,652,1680,-
chr2,1677429,2.002450980392157,773,431,1204,-
chr2,1677488,1.7645220109403494,1128,697,1825,-
chr2,1677581,2.420351302241066,591,507,1098,-
chr2,1677582,2.1205712716286733,1102,661,1763,-
chr2,1677583,0.5888564002599089,724,647,1371,-
chr2,1680758,1.7107883817427385,531,481,1012,-
chr2,1680776,1.7883027522935782,677,435,1112,-
chr2,1684025,1.5353795493680065,2390,1622,4012,-
chr2,1684026,1.5457410946304853,2428,1688,4116,-
chr2,1684029,1.180973241520585,1049,779,1828,-
chr2,1687453,2.0289717256244453,864,716,1580,-
chr2,1687497,0.6455992509363296,1378,1067,2445,-
chr2,1687886,1.5936323938070662,1700,1144,2844,-
chr2,1691464,1.5590664848825084,1079,673,1752,-
chr2,1696863,1.8634139510362784,4812,3915,8727,-
chr2,1696864,1.8634139510362784,4812,3915,8727,-
chr2,1696880,0.7309337854814764,3119,2120,5239,-
chr2,1696883,1.1054253206012992,4397,3106,7503,-
chr2,1696889,1.172068174267821,3137,2052,5189,-
chr2,1696895,1.5915492957746478,1355,851,2206,-
chr2,1696896,1.4894201306584958,1144,705,1849,-
chr2,1748029,2.1908998842592595,976,575,1551,-
chr2,1748033,1.851672478367558,924,533,1457,-
chr2,1748047,1.817698259187621,715,375,1090,-
chr2,1748057,2.4993080993081,807,584,1391,-
chr2,1748079,1.4986043990835132,1227,807,2034,-
chr2,1748081,1.5919102105366056,1084,674,1758,-
chr2,1748094,2.835062578665863,693,410,1103,-
chr2,3502282,9.446106941356495,1679,1565,3244,-
chr2,3502283,7.09497124621434,1139,1033,2172,-
chr2,3502284,6.578649082842473,994,1033,2027,-
chr2,3502304,7.172118467393318,718,536,1254,-
chr2,3502305,6.299404642446195,907,658,1565,-
chr2,3502403,2.765180421344446,4486,2767,7253,-
chr2,3502404,2.6856350277402905,3169,2051,5220,-
chr2,3502413,1.9331578031531558,3343,2021,5364,-
chr2,3502430,1.5710230937943492,2375,1347,3722,-
chr2,3502431,1.5710230937943492,2375,1347,3722,-
chr2,3502438,1.553698525673615,1062,561,1623,-
chr2,3502442,1.870639534883721,857,429,1286,-
chr2,3502448,1.7114127702362998,850,441,1291,-
chr2,3502717,2.397164420117093,860,743,1603,-
chr2,3502718,2.0311524269088843,608,541,1149,-
chr2,3517744,1.8983874353981063,2346,1660,4006,-
chr2,3523143,2.176314027725618,1531,1345,2876,-
chr2,3523145,1.9762170865489213,2453,2016,4469,-
chr2,3523146,2.106426939090691,2038,1570,3608,-
chr2,3523148,1.9450516297232368,1846,1272,3118,-
chr2,3523149,1.8403456758973065,1166,763,1929,-
chr2,3523183,3.0259097306897735,770,346,1116,-
chr2,3593302,1.708757582115279,696,558,1254,-
chr2,3595581,4.791306143646107,794,533,1327,-
chr2,9548331,2.151010701545779,1004,724,1728,-
chr2,9548332,2.151010701545779,1004,724,1728,-
chr2,9552514,1.696774193548387,788,619,1407,-
chr2,9552532,2.296992481203008,610,455,1065,-
chr2,9554348,1.077973340144513,933,870,1803,-
chr2,9563584,3.53073967609247,566,513,1079,-
chr2,9667917,1.7787718293730321,856,498,1354,-
chr2,9667931,3.4631578947368418,657,379,1036,-
chr2,9667962,1.2026674670816475,828,484,1312,-
chr2,9724322,1.0141467727674625,1035,608,1643,-
chr2,9724323,1.0141467727674625,1035,608,1643,-
chr2,9724614,3.026185770750988,874,505,1379,-
chr2,9724640,0.4262763650699783,864,533,1397,-
chr2,9724662,0.3707361775786579,661,426,1087,-
chr2,9724789,2.143812902545895,1843,1266,3109,-
chr2,9724812,1.5472097328749008,649,397,1046,-
chr2,9725014,1.5685103708359525,1084,739,1823,-
chr2,9725416,1.6345244868484397,1890,1251,3141,-
chr2,9728328,2.075027428474977,1068,696,1764,-
chr2,9731581,1.7179958630199956,1149,915,2064,-
chr2,9770347,0.6949026338705403,1448,1002,2450,-
chr2,9770361,2.34666980465992,766,606,1372,-
chr2,9770373,2.050052766470677,1045,736,1781,-
chr2,9770381,0.6196120689655172,597,463,1060,-
chr2,9770399,2.644315495379325,768,516,1284,-
chr2,9770576,0.8417022843547156,852,557,1409,-
chr2,9770578,0.6874125874125875,982,623,1605,-
chr2,9770580,0.9842845326716296,629,402,1031,-
chr2,9771098,1.4699340302887127,1480,989,2469,-
chr2,9771099,1.498469517898138,757,618,1375,-
chr2,9771107,3.9221757000703175,748,388,1136,-
chr2,10581975,2.2428438970324933,1294,979,2273,-
chr2,10583409,3.1732713025693533,959,695,1654,-
chr2,10583412,2.5791050650385166,721,496,1217,-
chr2,10585162,2.3347665218622238,828,577,1405,-
chr2,10585348,0.8888934482617864,667,520,1187,-
chr2,10729728,0.6018193830360319,1145,936,2081,-
chr2,10729783,1.538825042411642,947,691,1638,-
chr2,10729795,2.079855491826254,900,590,1490,-
chr2,10797972,1.7580744048460581,591,410,1001,-
chr2,10923680,1.9550161812297733,862,514,1376,-
chr2,10923738,0.6160114492668964,916,645,1561,-
chr2,10923973,2.036885686632971,610,546,1156,-
chr2,10924332,0.7684051497635312,3014,2199,5213,-
chr2,10924435,1.676165561057647,1559,972,2531,-
chr2,10927497,4.959875351321461,7269,5592,12861,-
chr2,10927498,4.321349963316214,3161,2396,5557,-
chr2,10927499,4.321349963316214,3161,2396,5557,-
chr2,10929903,1.616383820919969,1732,1417,3149,-
chr2,10931924,1.2907384054925035,2913,1890,4803,-
chr2,10932047,1.3792809622128273,1912,1452,3364,-
chr2,10933224,1.3676817662733156,1890,1419,3309,-
chr2,10933225,1.446214219759926,1610,1367,2977,-
chr2,10933235,1.4009863575225774,1735,1200,2935,-
chr2,10937303,1.3134493743940163,2666,1610,4276,-
chr2,10942746,0.3763258146737194,1193,1176,2369,-
chr2,10942759,0.6068049490538574,724,686,1410,-
chr2,10952808,0.5124555160142349,773,842,1615,-
chr2,10952840,0.3979591836734694,473,552,1025,-
chr2,10952843,0.9042357643920367,1209,1460,2669,-
chr2,10952845,2.2582317221605206,3548,3420,6968,-
chr2,10952846,2.5760143749997955,3882,3919,7801,-
chr2,10952847,2.711874978493795,2809,3108,5917,-
chr2,10952887,1.81456468456948,779,394,1173,-
chr2,10952894,4.580245957688062,1032,562,1594,-
chr2,11341208,1.5013063448151862,1505,1037,2542,-
chr2,11341225,1.9278783548047014,1197,783,1980,-
chr2,11341239,2.219677991607777,642,365,1007,-
chr2,11341240,2.465515158835609,755,486,1241,-
chr2,11341242,2.4203944203944205,1109,692,1801,-
chr2,11341243,2.4278421259981235,993,580,1573,-
chr2,11341250,3.5534655074306163,859,500,1359,-
chr2,17864988,2.411650485436893,620,514,1134,-
chr2,17864989,2.4267354624262545,1010,752,1762,-
chr2,17864992,2.970679507758159,781,533,1314,-
chr2,17864993,2.3119967740856464,1102,721,1823,-
chr2,17864994,3.316583313487338,1018,662,1680,-
chr2,17876514,2.185482463793404,1001,520,1521,-
chr2,17876515,2.185482463793404,1001,520,1521,-
chr2,17876561,2.3125247162755906,707,406,1113,-
chr2,17884479,2.4594628124227285,866,497,1363,-
chr2,17898104,2.597353497164461,915,528,1443,-
chr2,17898105,2.597353497164461,915,528,1443,-
chr2,17902215,2.4724528301886792,839,529,1368,-
chr2,17902222,2.6152320070538964,1482,843,2325,-
chr2,17902224,2.5008156606851557,2189,1225,3414,-
chr2,17902225,2.390625,1427,783,2210,-
chr2,17902226,0.37831549557933913,812,613,1425,-
chr2,20232546,0.5084276891405044,1128,1071,2199,-
chr2,20232661,0.4789054865279911,2047,2754,4801,-
chr2,20232681,28.10310573773128,12242,14625,26867,-
chr2,20232682,28.10310573773128,12242,14625,26867,-
chr2,20232683,27.434117995110928,6508,8418,14926,-
chr2,20232687,2.453416149068323,1579,781,2360,-
chr2,20232688,3.6214221274501766,3651,1506,5157,-
chr2,20232689,4.1220963850260075,7784,3749,11533,-
chr2,20232690,3.8374940494421956,9277,4428,13705,-
chr2,20232996,1.61304542642847,2478,1830,4308,-
chr2,20232999,1.7873483286173324,846,718,1564,-
chr2,20234105,2.016025641025641,813,623,1436,-
chr2,20237085,1.5136344752796125,2523,1849,4372,-
chr2,20240660,1.6510639230381523,1276,1112,2388,-
chr2,20240758,2.6869908015768726,851,760,1611,-
chr2,20240767,0.5405778432094223,704,626,1330,-
chr2,20240769,2.213709677419355,853,495,1348,-
chr2,20251192,1.7875375356822354,944,811,1755,-
chr2,20251371,2.689655172413793,643,666,1309,-
chr2,20251372,2.689655172413793,643,666,1309,-
chr2,20251390,3.515200868621064,1109,613,1722,-
chr2,20251391,4.7154054205012,2547,1874,4421,-
chr2,20251392,4.235487315774082,2740,2030,4770,-
chr2,24290604,1.5732572035586243,1518,1328,2846,-
chr2,24291275,1.6667036790287957,918,710,1628,-
chr2,24297043,1.4504344282035606,1326,946,2272,-
chr2,24299101,1.7297297297297298,1215,702,1917,-
chr2,24299140,0.6105798962941821,754,538,1292,-
chr2,24299191,1.819773146469519,1002,766,1768,-
chr2,24299196,1.1878804818515687,654,449,1103,-
chr2,25016066,1.6864391648051673,797,571,1368,-
chr2,25042867,7.660147111659107,584,495,1079,-
chr2,25047334,1.0493364662371953,725,519,1244,-
chr2,25469094,1.8248756662583643,908,687,1595,-
chr2,25469095,0.5118610515862646,1294,847,2141,-
chr2,25469096,0.49398734103331426,1659,1077,2736,-
chr2,25964777,2.0639646561659624,613,547,1160,-
chr2,25964778,0.5556764344621863,811,694,1505,-
chr2,25964851,32.243336738534005,1066,777,1843,-
chr2,25964852,32.243336738534005,1066,777,1843,-
chr2,26413790,9.84627267956794,1273,943,2216,-
chr2,26414135,1.9053811659192823,606,445,1051,-
chr2,26414227,1.6972864533840144,642,450,1092,-
chr2,26414449,1.9243738907513317,672,460,1132,-
chr2,26415245,0.5300840336134454,746,594,1340,-
chr2,26415269,0.6143657170684197,663,554,1217,-
chr2,26416489,3.423275035447972,805,601,1406,-
chr2,26417467,1.860705596107056,664,410,1074,-
chr2,26418036,1.568152454780362,970,601,1571,-
chr2,26418051,1.7617728531855952,635,531,1166,-
chr2,26418067,1.6344086021505375,611,526,1137,-
chr2,26418099,2.229260476264111,1204,1026,2230,-
chr2,26420590,1.6679785330948123,755,644,1399,-
chr2,26420637,1.03185915009394,1284,1120,2404,-
chr2,26424186,1.9838056680161944,699,519,1218,-
chr2,26426980,0.3195652173913044,685,482,1167,-
chr2,26435446,1.952434668170709,669,590,1259,-
chr2,26437366,1.3380318332406569,3731,2607,6338,-
chr2,26437367,1.6500168248199747,1612,1142,2754,-
chr2,26437390,1.928705440900563,770,532,1302,-
chr2,26438033,1.677411417322835,801,507,1308,-
chr2,26438037,2.242652084757348,578,461,1039,-
chr2,26453094,1.6561066813498484,1055,852,1907,-
chr2,26453098,1.6066445182724254,623,429,1052,-
chr2,26455114,1.0329732063386197,1473,1144,2617,-
chr2,26455117,1.8548006605331449,628,470,1098,-
chr2,26459824,1.7222831076905452,11187,8003,19190,-
chr2,26459825,1.9421000087445714,5988,4731,10719,-
chr2,26459826,1.9421000087445714,5988,4731,10719,-
chr2,26459838,1.8487976834949007,1779,1221,3000,-
chr2,26459843,1.574972181008902,1520,1010,2530,-
chr2,26459850,1.7563790021127903,3029,1757,4786,-
chr2,26459852,1.7563790021127903,3029,1757,4786,-
chr2,26461822,0.549970924309566,2948,2244,5192,-
chr2,26461823,0.5600215082672402,2082,1633,3715,-
chr2,26461838,1.184423932513274,1533,1109,2642,-
chr2,26461860,1.8743078626799563,676,429,1105,-
chr2,27293576,2.530919758642531,1459,908,2367,-
chr2,27294219,1.706161137440758,809,632,1441,-
chr2,27294223,1.8330745341614907,786,615,1401,-
chr2,27294229,2.1774546002561976,780,576,1356,-
chr2,27294301,1.6516233063929366,1134,758,1892,-
chr2,27294328,1.5356183164244583,717,520,1237,-
chr2,27294329,1.528188005650443,1049,598,1647,-
chr2,27294517,2.1236203090507724,739,603,1342,-
chr2,27294519,2.1236203090507724,739,603,1342,-
chr2,27532476,1.5383165249256143,977,818,1795,-
chr2,27532511,1.11703690282843,890,693,1583,-
chr2,27532581,0.5658365004154111,990,710,1700,-
chr2,27532621,3.054992266712494,612,528,1140,-
chr2,27532622,2.863962558995142,1032,837,1869,-
chr2,27551367,0.3661898900507234,770,545,1315,-
chr2,27551430,3.4382843526941924,644,492,1136,-
chr2,27551777,1.328246450988426,604,454,1058,-
chr2,27564895,0.3996607010239873,821,561,1382,-
chr2,27565821,2.1638988632676743,911,698,1609,-
chr2,27565829,1.4400133156453865,582,488,1070,-
chr2,27565839,0.4342750803586533,603,513,1116,-
chr2,27565840,0.4342750803586533,603,513,1116,-
chr2,27590626,1.0312435340368302,622,536,1158,-
chr2,27590627,1.0312435340368302,622,536,1158,-
chr2,27592388,0.49777777777777776,495,557,1052,-
chr2,27604490,2.716276552563929,955,777,1732,-
chr2,27604491,2.716276552563929,955,777,1732,-
chr2,27604507,1.9567575839777862,1057,837,1894,-
chr2,27605031,1.9036995724112291,639,488,1127,-
chr2,27605373,2.247143624144471,1678,1223,2901,-
chr2,27605454,2.3372944356837126,882,771,1653,-
chr2,27605455,2.3372944356837126,882,771,1653,-
chr2,27605456,1.1931057088196064,978,659,1637,-
chr2,27606300,2.4969071773109177,1591,1063,2654,-
chr2,27606301,2.1191884685885687,1182,705,1887,-
chr2,27606863,2.002814985529135,726,528,1254,-
chr2,27607649,2.4524213615425103,846,556,1402,-
chr2,27607758,1.2049110228914492,1001,721,1722,-
chr2,27607759,0.5600936833459204,876,685,1561,-
chr2,27608638,2.0323206205559146,654,454,1108,-
chr2,27609138,1.4176908695252397,3189,2890,6079,-
chr2,27609139,1.4176908695252397,3189,2890,6079,-
chr2,27609142,1.6417149644766416,2581,2020,4601,-
chr2,27609969,1.3525959367945826,1069,885,1954,-
chr2,27609982,0.5759928603302098,921,746,1667,-
chr2,27609990,0.652144690211414,820,667,1487,-
chr2,27632193,2.2214815088970035,782,566,1348,-
chr2,27876587,2.9450887104767567,690,530,1220,-
chr2,27876589,2.699063191484406,689,612,1301,-
chr2,27880378,0.8666458015871977,791,630,1421,-
chr2,27880380,1.5214896214896214,732,629,1361,-
chr2,27880381,2.0089590302651605,741,541,1282,-
chr2,27886214,2.1177088962706003,630,489,1119,-
chr2,29092783,1.87107131551576,1654,818,2472,-
chr2,29092784,2.0976947087112623,2369,1298,3667,-
chr2,32145873,0.3159856370164992,631,448,1079,-
chr2,32145874,0.3159856370164992,631,448,1079,-
chr2,32249135,1.8369140625,797,511,1308,-
chr2,32254685,0.5028678631448618,4121,2436,6557,-
chr2,32254686,0.4937553237086107,3084,1833,4917,-
chr2,32254695,0.7504470552041071,1238,793,2031,-
chr2,32254711,1.2223489146963287,1475,884,2359,-
chr2,32254716,2.176299081342263,1338,865,2203,-
chr2,32264373,1.7769689616823376,675,470,1145,-
chr2,32264389,2.1002724088727462,770,592,1362,-
chr2,32264390,2.0729158791367848,1319,934,2253,-
chr2,32264825,3.053247927181588,644,522,1166,-
chr2,32264826,2.9536607527335783,738,553,1291,-
chr2,33809229,2.2293219334058003,749,533,1282,-
chr2,33817166,6.837200072741937,606,396,1002,-
chr2,36779971,0.9390579327378994,962,689,1651,-
chr2,36780168,1.4673093824232564,666,479,1145,-
chr2,36808550,2.0232945091514143,735,600,1335,-
chr2,37374854,1.925217391304348,860,459,1319,-
chr2,37374856,1.7069983318228772,1826,929,2755,-
chr2,37374857,2.538252427184466,816,411,1227,-
chr2,37374865,3.0693039526348618,803,384,1187,-
chr2,37374877,0.36694680874671526,785,459,1244,-
chr2,37444173,3.048441309648206,772,556,1328,-
chr2,37450418,3.0444443630067837,695,539,1234,-
chr2,37455252,3.941897663502878,645,445,1090,-
chr2,37505113,1.960744891232696,1918,1516,3434,-
chr2,37505115,1.960744891232696,1918,1516,3434,-
chr2,37505121,2.8035714285714284,1412,1175,2587,-
chr2,37505122,2.8035714285714284,1412,1175,2587,-
chr2,37505125,2.244048086744716,1259,978,2237,-
chr2,37505127,2.244048086744716,1259,978,2237,-
chr2,38295509,2.5198921191529093,999,789,1788,-
chr2,38295759,2.427212762885165,915,630,1545,-
chr2,38296041,0.9036777583187392,558,570,1128,-
chr2,38296042,0.9036777583187392,558,570,1128,-
chr2,38296048,1.242780172413793,606,463,1069,-
chr2,38296050,5.069182011305856,1749,1391,3140,-
chr2,38296055,6.8271271526502035,1139,750,1889,-
chr2,38296056,7.452088452088452,673,406,1079,-
chr2,38296207,2.44263490520175,772,483,1255,-
chr2,38296306,1.7059468948869871,597,433,1030,-
chr2,38296450,0.5009666122732043,1125,827,1952,-
chr2,38297237,0.46493993993994,562,443,1005,-
chr2,38297372,2.200708762886598,620,387,1007,-
chr2,38522767,0.5078991341333738,1485,907,2392,-
chr2,38522796,1.5636247129812573,1330,920,2250,-
chr2,38522803,1.549079504724666,1041,681,1722,-
chr2,38522809,0.9486302785365687,3344,2517,5861,-
chr2,38522810,0.6322426575466933,3124,2399,5523,-
chr2,38522811,0.6407840808500129,2509,1990,4499,-
chr2,38522823,2.1636925279787915,1067,644,1711,-
chr2,38523134,4.788235294117647,1035,594,1629,-
chr2,38523135,4.788235294117647,1035,594,1629,-
chr2,38523136,4.788235294117647,1035,594,1629,-
chr2,38526403,2.3082644628099174,881,659,1540,-
chr2,38526405,2.3082644628099174,881,659,1540,-
chr2,38526454,1.412563059255303,752,475,1227,-
chr2,38570541,1.840275387263339,971,829,1800,-
chr2,38570544,2.6009569377990434,905,759,1664,-
chr2,38570638,1.6155538679928922,809,556,1365,-
chr2,38795354,2.786982195354729,1150,629,1779,-
chr2,38795414,2.1974584571846756,1064,662,1726,-
chr2,38971557,0.5679580322769223,1184,653,1837,-
chr2,38971558,0.5045871585412748,971,548,1519,-
chr2,38972164,2.0001454016721194,723,654,1377,-
chr2,38972265,1.5290846163026617,1362,854,2216,-
chr2,38972266,0.724537037037037,1564,1214,2778,-
chr2,38972286,1.1201221192087303,1767,1340,3107,-
chr2,38973293,1.7066411849020542,911,643,1554,-
chr2,38973855,1.7735849056603776,657,529,1186,-
chr2,38973872,2.432778394376619,1341,900,2241,-
chr2,38975208,0.6419196606124885,1075,793,1868,-
chr2,38975222,0.7191964285714285,1073,783,1856,-
chr2,38975766,0.6824811824811825,1128,813,1941,-
chr2,38976724,1.7192982456140349,580,497,1077,-
chr2,38976750,0.5775577557755776,804,605,1409,-
chr2,38976819,1.8414166478682608,906,681,1587,-
chr2,38977323,1.6948983957994295,1377,953,2330,-
chr2,38978423,2.4002427184466018,681,514,1195,-
chr2,38978424,2.4002427184466018,681,514,1195,-
chr2,38978425,0.3922716627634661,669,426,1095,-
chr2,38978462,3.2528378826108013,1040,621,1661,-
chr2,38978477,2.4051185944990388,1159,616,1775,-
chr2,39262369,1.5773780961044124,889,768,1657,-
chr2,39262373,1.1161440185830431,991,655,1646,-
chr2,39262374,1.1161440185830431,991,655,1646,-
chr2,42577784,2.674008810572688,606,453,1059,-
chr2,42577786,1.873986815086999,577,486,1063,-
chr2,42577803,1.6374145182232398,2334,1680,4014,-
chr2,42577804,1.673160173160173,1545,1007,2552,-
chr2,42577984,0.3555871212121212,750,527,1277,-
chr2,42578159,2.1626840123245463,928,634,1562,-
chr2,42578274,1.6110730854057342,661,486,1147,-
chr2,42578324,2.6319607843137254,865,599,1464,-
chr2,42578365,1.7145490858810877,743,565,1308,-
chr2,42578398,2.17898771661255,1427,1064,2491,-
chr2,42578404,1.64893849062091,676,528,1204,-
chr2,42580478,2.091397207970409,625,492,1117,-
chr2,44121749,0.4403625083632382,723,400,1123,-
chr2,44123835,0.37417117500809904,1298,856,2154,-
chr2,44126428,2.133659331703341,713,408,1121,-
chr2,44126431,1.9671811716839867,988,640,1628,-
chr2,44145256,1.0349938564578502,1304,903,2207,-
chr2,44145536,1.722905915045653,619,457,1076,-
chr2,44161342,1.6428048601961645,723,505,1228,-
chr2,44170950,2.2990563284366186,843,540,1383,-
chr2,44175266,1.938953488372093,579,429,1008,-
chr2,44175577,3.682403433476394,571,465,1036,-
chr2,44175645,0.35221135850860913,1289,939,2228,-
chr2,44201320,1.6740678676162546,776,538,1314,-
chr2,44202239,2.031702786377709,630,474,1104,-
chr2,44203286,3.3987380419295747,1011,577,1588,-
chr2,44203288,3.0130139373411975,1369,856,2225,-
chr2,44204324,4.130244755244755,899,571,1470,-
chr2,44204326,4.130244755244755,899,571,1470,-
chr2,44548381,4.467592677572318,626,459,1085,-
chr2,45236108,1.1881767121825277,1709,981,2690,-
chr2,45236109,1.4072299651567943,1076,727,1803,-
chr2,45236110,1.4633033337558623,961,482,1443,-
chr2,45236111,1.166795069337442,698,471,1169,-
chr2,45236116,0.8471663231821492,832,512,1344,-
chr2,47129763,1.887671232876712,635,437,1072,-
chr2,47129786,1.0086206896551724,584,521,1105,-
chr2,47129787,1.0086206896551724,584,521,1105,-
chr2,47130390,1.3682803915753856,668,413,1081,-
chr2,47132058,2.33228693008589,610,397,1007,-
chr2,47132572,2.152881169010201,678,402,1080,-
chr2,47132595,2.841726618705036,710,416,1126,-
chr2,47136182,3.215594270724488,575,489,1064,-
chr2,47142912,8.11786655493804,698,796,1494,-
chr2,47142913,8.11786655493804,698,796,1494,-
chr2,47387678,1.4618299064203055,3524,2914,6438,-
chr2,47389476,1.3443961258590973,2245,1490,3735,-
chr2,47397880,1.1071731381762622,5004,4062,9066,-
chr2,47403602,1.3867630981414516,1454,1080,2534,-
chr2,47403636,1.6099706744868036,1367,1177,2544,-
chr2,47403638,0.6523699776033955,2012,1408,3420,-
chr2,47403649,1.479400264132377,1969,1678,3647,-
chr2,47403650,1.479400264132377,1969,1678,3647,-
chr2,47403653,0.9076355815688808,2836,2522,5358,-
chr2,47403654,0.921889719761362,2375,2176,4551,-
chr2,55199649,1.762853172765169,1037,761,1798,-
chr2,55199713,2.47953216374269,847,607,1454,-
chr2,55199888,1.810305958132045,802,689,1491,-
chr2,55199894,1.4637179487179486,698,584,1282,-
chr2,55199928,1.9384027187765507,701,427,1128,-
chr2,55199933,0.459070053619164,2138,1447,3585,-
chr2,55200000,1.7236722115656735,2810,3244,6054,-
chr2,55200003,1.6263611053650697,5212,5725,10937,-
chr2,55200004,1.448622223982845,11146,10739,21885,-
chr2,55200006,1.4039645869758977,12320,11803,24123,-
chr2,55200007,1.5722109633037176,7109,7250,14359,-
chr2,55200008,1.1290393679664197,12908,11532,24440,-
chr2,55200009,0.4978022945165375,5799,4282,10081,-
chr2,55200020,0.6545366448508592,4053,3195,7248,-
chr2,55200025,0.6648778573973276,3595,3182,6777,-
chr2,55200026,0.6648778573973276,3595,3182,6777,-
chr2,55200037,1.558490513926756,4085,3398,7483,-
chr2,55200216,8.619989411195846,7905,6018,13923,-
chr2,55200217,9.106433840737758,4681,3571,8252,-
chr2,55200258,1.8802499770241705,997,701,1698,-
chr2,55200291,1.9724556489262368,1013,713,1726,-
chr2,55209757,1.5012645914396885,1402,1027,2429,-
chr2,55209772,1.9288698140200289,910,698,1608,-
chr2,55214809,0.3528996210904887,784,676,1460,-
chr2,55214810,0.3528996210904887,784,676,1460,-
chr2,55276895,4.055085454513481,614,435,1049,-
chr2,55276906,1.376820750562385,742,529,1271,-
chr2,55277595,3.764546381907318,544,488,1032,-
chr2,55277621,16.289901526322787,932,598,1530,-
chr2,55277624,7.972621846528961,1053,504,1557,-
chr2,55277625,7.975003651411879,720,307,1027,-
chr2,55471258,2.9673612391665127,595,492,1087,-
chr2,55471259,2.9673612391665127,595,492,1087,-
chr2,55776693,0.356368742438504,444,689,1133,-
chr2,55776741,22.134176738960434,418,680,1098,-
chr2,55863523,2.711613623673925,882,596,1478,-
chr2,55863524,2.711613623673925,882,596,1478,-
chr2,55873425,1.9414802065404475,845,497,1342,-
chr2,55883461,2.310501976088874,645,455,1100,-
chr2,55889113,2.1750180271412,903,641,1544,-
chr2,55894146,2.025345622119816,585,433,1018,-
chr2,55899136,2.658329275310992,2265,1843,4108,-
chr2,55899147,1.3648186173853527,1993,1460,3453,-
chr2,55899156,1.512575339936431,1791,1242,3033,-
chr2,55899160,2.023781823159048,1665,1123,2788,-
chr2,55899180,1.5844298245614032,1444,835,2279,-
chr2,55900048,2.2101550079491257,1533,1087,2620,-
chr2,55900064,1.4925685538386038,2089,1252,3341,-
chr2,55900066,1.7143897996357014,1628,914,2542,-
chr2,55900068,1.7143897996357014,1628,914,2542,-
chr2,55912121,1.7271816485870242,1110,705,1815,-
chr2,56093925,1.5569358178053831,1279,919,2198,-
chr2,56094112,1.503051255808957,4023,2949,6972,-
chr2,56094121,1.6128420995641697,992,696,1688,-
chr2,56094275,1.6752533717739702,2302,1917,4219,-
chr2,56097875,1.6917062247672146,2686,2052,4738,-
chr2,56098235,2.466577540106952,944,747,1691,-
chr2,56102192,1.5876379825577849,1156,862,2018,-
chr2,56104898,1.6250668449197858,1056,879,1935,-
chr2,56104937,1.6007674341007678,1009,665,1674,-
chr2,56104961,1.8998527245949925,859,678,1537,-
chr2,56104995,2.659513590844063,714,465,1179,-
chr2,56144816,1.744328809169824,982,718,1700,-
chr2,56144820,2.9484665661136256,950,662,1612,-
chr2,56144825,0.5817283950617285,867,629,1496,-
chr2,56144864,1.8605961468556889,705,523,1228,-
chr2,56145043,1.7521319985168704,726,557,1283,-
chr2,56145185,1.5369560211835136,1067,807,1874,-
chr2,61705213,1.5875112410071943,806,555,1361,-
chr2,61705223,1.717566016073479,747,468,1215,-
chr2,61705250,1.630760690038548,1435,943,2378,-
chr2,61705568,0.46796094714397923,694,468,1162,-
chr2,61705672,3.575833668139815,580,468,1048,-
chr2,61705855,2.1384673266894874,1870,1426,3296,-
chr2,61705857,2.3040516735173227,852,654,1506,-
chr2,61705888,1.0101347175874429,742,557,1299,-
chr2,61705890,1.4247307420224942,1336,898,2234,-
chr2,61706012,0.9274317795333323,2311,1731,4042,-
chr2,61709543,1.8242983467896965,948,577,1525,-
chr2,61713087,2.584673604541154,682,452,1134,-
chr2,61719181,1.4736685888738126,992,803,1795,-
chr2,61719187,2.043434343434344,832,629,1461,-
chr2,61719220,2.0,635,423,1058,-
chr2,61719610,0.4793365050790794,980,706,1686,-
chr2,61719785,2.1325189998188643,1275,936,2211,-
chr2,61724119,2.573523206751055,786,473,1259,-
chr2,61726883,2.072,776,539,1315,-
chr2,61765379,2.627743626951069,644,419,1063,-
chr2,62095644,0.7050808572547703,2290,1553,3843,-
chr2,62095728,1.3294797687861273,2046,1383,3429,-
chr2,62099668,2.091472471190781,1967,1561,3528,-
chr2,62100160,1.4581667333066777,2333,1463,3796,-
chr2,62100161,1.376443954257851,1871,1497,3368,-
chr2,62104106,1.3812580231065468,2151,1348,3499,-
chr2,62104139,0.646441577441203,3343,2526,5869,-
chr2,62104536,1.5817772317772318,2165,1979,4144,-
chr2,62104537,1.5817772317772318,2165,1979,4144,-
chr2,62106088,1.5632658295340651,3108,2448,5556,-
chr2,62106090,1.5632658295340651,3108,2448,5556,-
chr2,62106100,1.6660699367466285,1395,1028,2423,-
chr2,62112158,1.4785714285714286,1241,1079,2320,-
chr2,62112189,1.6198589607435325,2249,1920,4169,-
chr2,62115547,0.6663931623931624,885,779,1664,-
chr2,62115568,1.8721358275110807,711,492,1203,-
chr2,62115574,1.7861271676300576,926,518,1444,-
chr2,62115580,1.7590076804068244,3078,1909,4987,-
chr2,62115582,1.796218487394958,1799,951,2750,-
chr2,62115649,1.7841324860388983,1089,576,1665,-
chr2,62115696,1.779004600585529,817,796,1613,-
chr2,62115715,1.5032487309644669,870,590,1460,-
chr2,62115723,2.7555555555555555,639,599,1238,-
chr2,62115731,0.4297312430011198,920,563,1483,-
chr2,62115745,0.5804668879031503,1599,1302,2901,-
chr2,62115748,1.107829850688051,1260,1071,2331,-
chr2,62115749,1.2618550008167864,1482,1269,2751,-
chr2,62115752,1.903225245145446,726,552,1278,-
chr2,62115754,1.6095216296635386,585,513,1098,-
chr2,64147719,1.9156804733727808,979,675,1654,-
chr2,64147722,1.6462532104291674,1570,1189,2759,-
chr2,64147725,2.4209702660406887,1819,1419,3238,-
chr2,64147726,2.292518513189219,3172,2330,5502,-
chr2,64147727,2.4995984193786747,2393,1830,4223,-
chr2,64147728,2.6252293430328,1772,1321,3093,-
chr2,64147729,1.5924579736483415,1401,867,2268,-
chr2,64147730,1.744809688581315,2016,1223,3239,-
chr2,64147732,1.771359447004608,1302,774,2076,-
chr2,64859544,1.761872133944346,738,422,1160,-
chr2,65314554,2.0402149392595925,725,520,1245,-
chr2,65315183,1.466421793694521,1238,1088,2326,-
chr2,65315492,1.7030308734939756,977,663,1640,-
chr2,65315496,1.9807824296499656,1183,751,1934,-
chr2,65315608,1.7738052917576557,943,678,1621,-
chr2,65315688,1.9051732411939721,793,452,1245,-
chr2,65315727,0.6012197982641332,698,608,1306,-
chr2,65318188,1.3754042504042503,2070,1331,3401,-
chr2,65318190,1.4012234535064148,4475,2683,7158,-
chr2,65331915,1.6237963407161542,2427,1628,4055,-
chr2,65357195,1.820022083179978,644,428,1072,-
chr2,65357201,1.8920451053155452,1272,762,2034,-
chr2,65357233,3.107530898234518,940,432,1372,-
chr2,69552621,1.924580103359173,700,515,1215,-
chr2,69552634,1.5774058577405856,753,477,1230,-
chr2,69552748,2.3231138568954295,794,510,1304,-
chr2,69554151,0.6886690907672588,1225,747,1972,-
chr2,69554153,0.5948706571939874,1559,959,2518,-
chr2,69554155,0.3345923487832514,688,430,1118,-
chr2,69555475,1.5708770565693702,661,437,1098,-
chr2,69555521,0.3932571350750466,822,555,1377,-
chr2,69575358,1.5987948586576377,1816,1693,3509,-
chr2,69575360,1.654037531136233,2694,2455,5149,-
chr2,69575362,1.663556723609286,2607,2282,4889,-
chr2,69575363,1.7348640272382032,1727,1477,3204,-
chr2,69575368,1.578525565272059,1418,1105,2523,-
chr2,69601148,2.916500994035785,651,502,1153,-
chr2,69601184,1.0483126553051356,782,543,1325,-
chr2,70437999,1.0719298287171237,1716,1433,3149,-
chr2,70515253,0.5225115664243226,1646,1274,2920,-
chr2,70515266,2.049403183023873,882,579,1461,-
chr2,70515277,2.131887201735358,755,460,1215,-
chr2,70515281,2.809906410278995,1779,1211,2990,-
chr2,70520777,1.3831911532385466,1112,632,1744,-
chr2,70520788,1.8341595313204144,1099,633,1732,-
chr2,70520802,1.4533696392103472,853,677,1530,-
chr2,70520808,1.829698343010905,782,613,1395,-
chr2,70520811,0.5474020458088326,1713,1119,2832,-
chr2,70520818,0.668112798264642,549,460,1009,-
chr2,70520832,2.004026217228464,1258,711,1969,-
chr2,70520833,2.004026217228464,1258,711,1969,-
chr2,70520848,1.2584737813954556,599,417,1016,-
chr2,70523312,2.935813274981765,574,456,1030,-
chr2,70523313,2.126618086695407,852,665,1517,-
chr2,70523601,6.881883858989728,622,525,1147,-
chr2,70523880,4.0501355013550135,853,491,1344,-
chr2,70523882,4.0501355013550135,853,491,1344,-
chr2,71337229,4.92063492063492,619,559,1178,-
chr2,71337234,2.377695526231091,590,477,1067,-
chr2,71337239,2.2401581622504074,2138,1439,3577,-
chr2,71337241,2.2401581622504074,2138,1439,3577,-
chr2,73957786,1.7757464960390008,845,546,1391,-
chr2,73957831,2.154775604142693,748,473,1221,-
chr2,73961690,3.774617067833698,551,456,1007,-
chr2,73961692,3.774617067833698,551,456,1007,-
chr2,74362674,1.1630928970855423,895,742,1637,-
chr2,74372355,2.348283007696862,834,562,1396,-
chr2,74372357,2.348283007696862,834,562,1396,-
chr2,74372360,0.4934390504010757,625,552,1177,-
chr2,74372361,1.104629697998966,747,466,1213,-
chr2,74372362,0.8036374836798376,1372,1018,2390,-
chr2,74382149,1.7829808870040593,704,479,1183,-
chr2,74383706,0.5575296108291034,658,393,1051,-
chr2,74399734,1.834846667808806,629,448,1077,-
chr2,74399807,1.7839213753196952,890,666,1556,-
chr2,74593025,0.6281735330521104,756,542,1298,-
chr2,74593104,1.733367162825051,9052,5654,14706,-
chr2,74593105,2.0776567674683752,4328,2824,7152,-
chr2,74593106,2.0776567674683752,4328,2824,7152,-
chr2,74593112,1.7570774797786295,1245,695,1940,-
chr2,74593133,1.8376160778405504,3059,1555,4614,-
chr2,74593135,1.8974878890193776,2088,1047,3135,-
chr2,74593141,0.5789189189189189,2379,1499,3878,-
chr2,74593142,0.5789189189189189,2379,1499,3878,-
chr2,74593374,1.6526537046768262,739,345,1084,-
chr2,74593395,2.115091463414634,739,491,1230,-
chr2,74593398,0.5399385560675882,961,433,1394,-
chr2,74593399,0.5399385560675882,961,433,1394,-
chr2,74593432,2.665384368094138,770,448,1218,-
chr2,74594909,2.3271582321045146,643,422,1065,-
chr2,74597330,1.610397745067335,856,617,1473,-
chr2,74597331,1.5674814873795684,1157,660,1817,-
chr2,74597349,1.803845569235446,1009,773,1782,-
chr2,74597350,2.243511680650676,2334,1132,3466,-
chr2,74597351,2.243511680650676,2334,1132,3466,-
chr2,74597352,2.243511680650676,2334,1132,3466,-
chr2,74597410,1.169570267131243,1006,573,1579,-
chr2,74597411,1.169570267131243,1006,573,1579,-
chr2,74597790,3.6733193277310923,641,423,1064,-
chr2,74598217,1.7505759595938684,1039,788,1827,-
chr2,74598220,2.566669355489231,676,538,1214,-
chr2,74598222,2.514510656857085,1023,778,1801,-
chr2,74604828,3.4586233565351896,687,430,1117,-
chr2,74604829,3.4586233565351896,687,430,1117,-
chr2,74688303,0.2656005367926638,474,788,1262,-
chr2,74688304,1.2384470442310056,1082,1043,2125,-
chr2,74688305,0.2393014396675407,690,1188,1878,-
chr2,74688307,0.4309241531603253,1425,1797,3222,-
chr2,74688382,19.032891537623698,3462,4039,7501,-
chr2,74688383,19.856861611416942,3844,4114,7958,-
chr2,74688384,20.624733904355345,4126,4153,8279,-
chr2,74688385,44.83578104138852,1543,748,2291,-
chr2,74688386,53.584229390681,1149,247,1396,-
chr2,74688387,12.530131695150896,2845,467,3312,-
chr2,74688388,9.803774286494507,3428,547,3975,-
chr2,74688389,7.270943971728679,1629,214,1843,-
chr2,74688390,8.123791315708115,3335,523,3858,-
chr2,74688392,7.729324457029686,1334,230,1564,-
chr2,74688534,2.1517168215151417,908,650,1558,-
chr2,74688680,2.031724924012158,929,657,1586,-
chr2,74688681,1.5984436195363936,1247,905,2152,-
chr2,74688686,1.580777637941313,644,486,1130,-
chr2,74688861,1.7170447299749567,902,675,1577,-
chr2,74689414,1.673203602870695,718,626,1344,-
chr2,74689563,1.9609872408339217,864,595,1459,-
chr2,74689622,0.36781034762362014,2661,2006,4667,-
chr2,74689623,0.3312660310512489,1919,1464,3383,-
chr2,74689630,1.2840481019994203,708,475,1183,-
chr2,74689631,1.2840481019994203,708,475,1183,-
chr2,74689683,1.4659630919468665,672,510,1182,-
chr2,74689713,2.9007149349952006,863,554,1417,-
chr2,74689962,0.4185526280900368,1398,955,2353,-
chr2,74690409,1.9318885448916407,575,455,1030,-
chr2,74699273,3.3352220816396416,689,625,1314,-
chr2,74699274,3.650506712631758,1131,954,2085,-
chr2,74699713,1.9600990649652352,1415,1144,2559,-
chr2,74699715,2.1405807365439093,779,705,1484,-
chr2,74733900,3.6444780069561116,752,510,1262,-
chr2,74733992,1.810822510822511,800,769,1569,-
chr2,74734004,0.6137787056367432,545,478,1023,-
chr2,74734170,1.8006001362314967,1208,853,2061,-
chr2,74734172,1.4428807947019866,829,603,1432,-
chr2,74734178,2.3554531455628434,639,446,1085,-
chr2,74734210,1.828674756799087,826,593,1419,-
chr2,74754141,2.172316179160387,882,620,1502,-
chr2,74754152,2.036823771948532,753,520,1273,-
chr2,74754153,2.036823771948532,753,520,1273,-
chr2,74754643,2.287037037037037,759,647,1406,-
chr2,74754644,2.287037037037037,759,647,1406,-
chr2,74754709,2.1559399421930387,681,551,1232,-
chr2,74755421,3.040284971071295,911,609,1520,-
chr2,74755606,2.246999816553805,759,481,1240,-
chr2,74756009,3.4201248313371906,640,517,1157,-
chr2,74756292,3.113957602794105,743,531,1274,-
chr2,84650785,1.7173051519154556,999,756,1755,-
chr2,84650850,1.1391259019451836,1037,888,1925,-
chr2,84650851,1.1391259019451836,1037,888,1925,-
chr2,84652605,0.5681818181818182,924,591,1515,-
chr2,84652617,0.6072397543909753,809,595,1404,-
chr2,84658766,1.6533924790805523,983,762,1745,-
chr2,84658772,2.2236235750666995,763,650,1413,-
chr2,84668185,1.5799725506756759,906,591,1497,-
chr2,84668214,1.778653687962709,836,520,1356,-
chr2,84668401,0.5499999999999999,725,509,1234,-
chr2,84670421,1.8866532713110016,1343,772,2115,-
chr2,84670422,1.8866532713110016,1343,772,2115,-
chr2,84676862,1.8611754677185137,936,638,1574,-
chr2,85547559,5.945319469290401,645,430,1075,-
chr2,85569375,0.36872523195087936,1135,1236,2371,-
chr2,85569376,0.4077080706179067,738,731,1469,-
chr2,85569392,0.4170516090994183,1243,1705,2948,-
chr2,85569393,0.4473610232623515,877,1115,1992,-
chr2,85569394,0.4473610232623515,877,1115,1992,-
chr2,85569419,0.5458089668615985,327,1106,1433,-
chr2,85569420,3.5385658968788976,528,1435,1963,-
chr2,85569421,0.5458089668615985,327,1106,1433,-
chr2,85569429,0.22444599292594603,573,1373,1946,-
chr2,85569439,10.434023960525796,608,1189,1797,-
chr2,85569563,4.087019606872548,760,424,1184,-
chr2,85569564,7.2867485019820775,916,522,1438,-
chr2,85777087,2.2093218559731262,618,432,1050,-
chr2,85777089,2.2093218559731262,618,432,1050,-
chr2,85835484,6.743991838055293,573,738,1311,-
chr2,85835488,8.231599452183522,1082,707,1789,-
chr2,85835489,7.813229571984436,752,513,1265,-
chr2,85835490,9.062521779669215,890,553,1443,-
chr2,86371417,2.2315749380694934,759,574,1333,-
chr2,86371613,2.23757492981258,796,572,1368,-
chr2,86371615,2.23757492981258,796,572,1368,-
chr2,86371854,3.485838779956427,499,509,1008,-
chr2,86371855,3.485838779956427,499,509,1008,-
chr2,86374884,2.6857200267097245,1133,746,1879,-
chr2,86397924,0.2598173515981735,568,437,1005,-
chr2,86398352,2.0336339525059057,1203,807,2010,-
chr2,86406676,2.690943826211956,660,460,1120,-
chr2,86408437,0.354215815201205,583,505,1088,-
chr2,86408446,1.545586435733166,685,644,1329,-
chr2,86832486,2.982848620432513,639,446,1085,-
chr2,86832495,1.533516921765111,1207,886,2093,-
chr2,86832504,1.0336596674542167,932,658,1590,-
chr2,86832508,1.6552197802197803,722,441,1163,-
chr2,86832509,1.6552197802197803,722,441,1163,-
chr2,95753035,1.1718857467077688,686,492,1178,-
chr2,95753124,0.6120879120879121,556,454,1010,-
chr2,95753213,1.8423427977603672,1173,825,1998,-
chr2,95753215,1.68454481298518,681,435,1116,-
chr2,95753220,2.463235891089424,1568,940,2508,-
chr2,95753221,2.836977036804026,974,577,1551,-
chr2,95753304,1.6869388009110537,1040,685,1725,-
chr2,95753305,2.439252336448598,683,427,1110,-
chr2,95767426,1.6559477756286267,760,516,1276,-
chr2,95770433,2.0332222222222223,630,499,1129,-
chr2,95774111,2.114402512587866,2208,1542,3750,-
chr2,95774136,1.5060506050605063,3366,2120,5486,-
chr2,95774138,1.5060506050605063,3366,2120,5486,-
chr2,95774150,2.435317984525382,1258,756,2014,-
chr2,95775664,2.28619123931624,1291,831,2122,-
chr2,95775674,1.4848154209856337,1064,610,1674,-
chr2,95775696,1.64318425411673,991,621,1612,-
chr2,95775700,0.6543836560757035,907,590,1497,-
chr2,95775718,0.54,647,479,1126,-
chr2,95780880,2.792464114832536,643,417,1060,-
chr2,95783686,1.8549150094279432,1029,710,1739,-
chr2,96850714,1.2472119158295458,628,477,1105,-
chr2,96850717,0.3480787253983129,618,484,1102,-
chr2,96850718,0.3480787253983129,618,484,1102,-
chr2,96850735,2.5827154356816617,784,571,1355,-
chr2,96852255,2.6242026023256293,1370,980,2350,-
chr2,96861110,2.725445775913066,704,473,1177,-
chr2,96861137,1.0422463768115942,756,459,1215,-
chr2,96861138,1.0422463768115942,756,459,1215,-
chr2,96861257,1.4207928169562836,923,665,1588,-
chr2,96940623,4.67595818815331,609,409,1018,-
chr2,96940624,4.67595818815331,609,409,1018,-
chr2,96940800,2.8145359019264444,973,570,1543,-
chr2,96940801,1.7206700118709959,1574,1186,2760,-
chr2,96940802,0.3337882794506526,601,616,1217,-
chr2,96942834,0.19709050815611234,598,471,1069,-
chr2,96944442,2.917433328115068,710,484,1194,-
chr2,96944716,2.5688695231178893,757,485,1242,-
chr2,96944717,2.5688695231178893,757,485,1242,-
chr2,96952152,1.0392001529614698,695,514,1209,-
chr2,96953290,1.861842105263158,565,455,1020,-
chr2,96954807,1.2396251673360106,678,477,1155,-
chr2,96957172,3.607159657272272,672,520,1192,-
chr2,96958812,1.1502372471685476,1019,874,1893,-
chr2,96959057,2.297061803444782,871,704,1575,-
chr2,96959059,2.297061803444782,871,704,1575,-
chr2,96961373,1.250185524167615,721,492,1213,-
chr2,96961375,1.250185524167615,721,492,1213,-
chr2,96962688,1.279341821973571,1404,859,2263,-
chr2,96962694,1.8061402416241128,1260,776,2036,-
chr2,96962695,1.4309408250529985,1866,1126,2992,-
chr2,96962750,0.3783622235505081,632,477,1109,-
chr2,96962751,0.3783622235505081,632,477,1109,-
chr2,96962778,2.4601047250966213,876,616,1492,-
chr2,96962779,2.4601047250966213,876,616,1492,-
chr2,96962793,1.4287965893006762,643,422,1065,-
chr2,96967404,1.1521197007481296,615,400,1015,-
chr2,96967405,1.1521197007481296,615,400,1015,-
chr2,96970570,3.39480198019802,632,403,1035,-
chr2,98273140,2.720317903023278,694,437,1131,-
chr2,98273275,9.32933778278476,1189,1206,2395,-
chr2,98273276,9.329337782784762,1189,1206,2395,-
chr2,99787020,1.6418653880606866,4272,3073,7345,-
chr2,99787021,1.6418653880606866,4272,3073,7345,-
chr2,99787024,2.0328647730222533,2018,1396,3414,-
chr2,99787027,2.1918830473743767,1885,1210,3095,-
chr2,99787030,1.5017617387434166,1722,883,2605,-
chr2,99797368,2.620718422709355,642,426,1068,-
chr2,99944081,0.9078438708068338,559,485,1044,-
chr2,99944083,0.9078438708068338,559,485,1044,-
chr2,101654113,2.5358627858627862,696,480,1176,-
chr2,101654114,2.5358627858627862,696,480,1176,-
chr2,101893218,1.3773220410763298,693,420,1113,-
chr2,105977477,1.3713628975715468,2844,2163,5007,-
chr2,105977553,1.4111846779923776,3610,2259,5869,-
chr2,105977554,1.3797924405425726,4723,3785,8508,-
chr2,105977572,1.3630060983997434,4328,3389,7717,-
chr2,105977706,0.7502039111760184,4563,3404,7967,-
chr2,105977740,0.6285152409046214,1597,1304,2901,-
chr2,105977872,1.5888792017824276,1945,1146,3091,-
chr2,105977878,0.7575860893283327,2221,1675,3896,-
chr2,105979826,1.5635354469767049,1327,1011,2338,-
chr2,105979906,0.6490595458532307,1619,992,2611,-
chr2,105984123,1.440846824408468,1962,1660,3622,-
chr2,105984141,1.573104571154312,5044,3698,8742,-
chr2,105984186,1.6735954587194255,1252,1088,2340,-
chr2,105984187,1.1642023998648678,5921,4291,10212,-
chr2,105990033,1.9208017541350877,1941,1553,3494,-
chr2,105990132,0.6976239004505471,2000,1579,3579,-
chr2,105990144,2.866006944444444,1398,959,2357,-
chr2,105990160,3.0784386617100363,1013,806,1819,-
chr2,106002861,1.5495283018867922,1605,1271,2876,-
chr2,106002987,1.2887149185810545,4095,2869,6964,-
chr2,106002989,1.3407887409889685,5959,4166,10125,-
chr2,106002990,1.2928594082371296,3861,2694,6555,-
chr2,106015448,1.9768395342096292,1151,850,2001,-
chr2,106015449,1.8552970082381848,903,628,1531,-
chr2,106761746,2.0935368042213356,953,846,1799,-
chr2,106761747,2.0287769784172665,563,555,1118,-
chr2,106780132,2.2644553335846216,1305,1136,2441,-
chr2,106780133,2.736640746018077,1692,1392,3084,-
chr2,106780134,2.2644553335846216,1305,1136,2441,-
chr2,110301205,1.0758176743042993,1230,823,2053,-
chr2,110303664,4.324564431287475,803,503,1306,-
chr2,111398650,2.248784549153999,1841,1358,3199,-
chr2,111398655,2.0274233390910275,1957,1571,3528,-
chr2,111398656,2.0274233390910275,1957,1571,3528,-
chr2,111398657,2.0274233390910275,1957,1571,3528,-
chr2,111399020,1.793179723502304,607,433,1040,-
chr2,111406953,2.937568761554368,691,474,1165,-
chr2,111414676,2.532695374800638,793,527,1320,-
chr2,111414677,2.532695374800638,793,527,1320,-
chr2,111416201,0.4725626740947075,1130,717,1847,-
chr2,111416203,1.2503363073734255,2049,1319,3368,-
chr2,111416205,1.0728396087884078,1018,680,1698,-
chr2,111416230,3.2740136054421773,751,524,1275,-
chr2,111416232,1.8822604952620625,1446,996,2442,-
chr2,111419166,2.4054373522458627,1479,845,2324,-
chr2,111419167,2.457267690548807,2249,1408,3657,-
chr2,111419178,2.802395209580838,701,500,1201,-
chr2,111419185,2.46275463666768,674,428,1102,-
chr2,111419203,1.0169635644742996,919,546,1465,-
chr2,111419204,1.0169635644742996,919,546,1465,-
chr2,111427035,2.356811145510836,782,611,1393,-
chr2,111427036,2.3996431951564374,1336,980,2316,-
chr2,111435559,1.7545732335802025,692,456,1148,-
chr2,112187042,1.7581006647673316,1267,1052,2319,-
chr2,112187043,1.7581006647673316,1267,1052,2319,-
chr2,112187134,1.7219663027702403,757,688,1445,-
chr2,112187157,3.4753694581280787,829,579,1408,-
chr2,112252475,2.040085287846482,551,468,1019,-
chr2,112252496,1.7899491812535286,633,384,1017,-
chr2,112252503,1.7369490273878108,1540,1099,2639,-
chr2,113513935,1.9684984791932088,671,598,1269,-
chr2,120979901,1.593820938297405,786,614,1400,-
chr2,120979917,2.7382721536685843,1303,789,2092,-
chr2,120979918,2.4729050799329126,998,564,1562,-
chr2,122135191,1.4656126482213436,617,384,1001,-
chr2,122488524,2.3702298123550496,802,526,1328,-
chr2,122488528,2.064733062371011,1655,1157,2812,-
chr2,122488536,0.5042372881355932,696,471,1167,-
chr2,122489710,1.6926807760141094,697,503,1200,-
chr2,122494373,2.1257961927295512,698,557,1255,-
chr2,122494383,2.852839690701692,1004,729,1733,-
chr2,122494386,0.42868360099032127,1365,1034,2399,-
chr2,122494387,0.3136562482294697,1028,818,1846,-
chr2,127805986,1.2155097649603144,2406,1858,4264,-
chr2,127805987,0.885401597176721,1586,1158,2744,-
chr2,127805989,1.3725006102852106,5623,5354,10977,-
chr2,127805990,1.375131055433612,5171,5041,10212,-
chr2,127805991,1.421708383838646,4813,4759,9572,-
chr2,127805994,2.814758092586146,878,844,1722,-
chr2,127806023,0.45326648207737785,672,580,1252,-
chr2,127806069,2.07092555331992,536,496,1032,-
chr2,127806071,2.07092555331992,536,496,1032,-
chr2,127828173,1.892340621096034,6694,3382,10076,-
chr2,127828174,1.8550111989124165,17836,10863,28699,-
chr2,127828175,1.9165577055991607,19622,12292,31914,-
chr2,127828176,1.919661803713528,6432,3131,9563,-
chr2,127828177,2.3133067580978683,3629,2982,6611,-
chr2,127828198,0.5435149266318098,1288,538,1826,-
chr2,127828204,1.319491143540504,2718,1696,4414,-
chr2,127828205,1.319491143540504,2718,1696,4414,-
chr2,127828351,2.948083758254628,2319,1409,3728,-
chr2,127828353,2.560813492063492,1865,1007,2872,-
chr2,127828354,2.18639060213883,1981,1065,3046,-
chr2,127828368,2.104879135568676,1325,763,2088,-
chr2,127828369,2.104879135568676,1325,763,2088,-
chr2,127828375,3.226937269372694,1059,541,1600,-
chr2,127828377,3.226937269372694,1059,541,1600,-
chr2,127834219,0.4751861805239142,732,422,1154,-
chr2,127864483,4.153042822181193,670,489,1159,-
chr2,128047016,1.607016427585131,614,450,1064,-
chr2,128244157,1.9259546920214912,715,449,1164,-
chr2,128252451,2.0529634300126105,591,487,1078,-
chr2,128255783,2.3667043725460837,801,552,1353,-
chr2,128260419,0.6789233994361582,1760,882,2642,-
chr2,128260423,2.3170345161236505,1633,1130,2763,-
chr2,128260430,1.4767170374213632,1468,906,2374,-
chr2,128262304,3.7248379702095433,620,545,1165,-
chr2,128262430,1.170036166835792,802,556,1358,-
chr2,128262432,1.8229480250559988,1188,830,2018,-
chr2,128262451,1.2336959963484277,1096,756,1852,-
chr2,128262452,0.9513297230174884,787,546,1333,-
chr2,128262510,2.4931377143267395,1135,1009,2144,-
chr2,128262554,3.0683417085427136,851,596,1447,-
chr2,128262555,3.0683417085427136,851,596,1447,-
chr2,128262556,3.0683417085427136,851,596,1447,-
chr2,128263038,2.082707215265355,658,558,1216,-
chr2,128263039,0.4678179824561403,741,569,1310,-
chr2,128263040,2.045857307249712,960,789,1749,-
chr2,128263041,1.0731338294229607,1363,1058,2421,-
chr2,128480174,2.938738611209415,722,469,1191,-
chr2,128480191,1.1988052536521607,611,418,1029,-
chr2,128481938,0.16185515960299915,550,623,1173,-
chr2,128481973,2.8358501152269655,358,669,1027,-
chr2,128604922,1.7971349055332317,2046,1418,3464,-
chr2,128604926,1.7305522964051965,1676,1198,2874,-
chr2,128604927,1.0936401406200065,1710,1042,2752,-
chr2,128604928,1.7305522964051965,1676,1198,2874,-
chr2,128604929,1.0936401406200065,1710,1042,2752,-
chr2,128604932,0.47331509410518446,964,679,1643,-
chr2,128604934,1.6639793614962914,644,442,1086,-
chr2,128604944,2.0182120312719776,887,614,1501,-
chr2,128622107,3.0919540229885056,806,521,1327,-
chr2,128622108,3.0919540229885056,806,521,1327,-
chr2,128622146,0.258538749128699,679,366,1045,-
chr2,128622147,1.5440492507410541,1829,963,2792,-
chr2,128622148,2.679334916864608,845,420,1265,-
chr2,128622149,1.8647697741627842,1480,779,2259,-
chr2,128699605,4.10711267185469,683,535,1218,-
chr2,131806062,1.3610437362358967,663,497,1160,-
chr2,131809273,7.920770951004163,958,834,1792,-
chr2,131809276,7.039727182790585,908,646,1554,-
chr2,131809429,18.62671806438984,845,686,1531,-
chr2,132241641,3.0378863443828057,582,450,1032,-
chr2,132241659,1.5127422196124487,1170,654,1824,-
chr2,132241660,1.5127422196124487,1170,654,1824,-
chr2,132241661,1.5127422196124487,1170,654,1824,-
chr2,132249833,2.4500885922077678,649,518,1167,-
chr2,136598319,2.560934489402697,685,518,1203,-
chr2,136603906,1.5892652944539736,600,423,1023,-
chr2,136603910,0.546875,727,511,1238,-
chr2,136603919,0.5434322033898306,626,471,1097,-
chr2,136605657,0.6084819997863475,711,505,1216,-
chr2,136605713,1.5955768523523175,17252,12929,30181,-
chr2,136605715,1.5832479880476735,27752,20167,47919,-
chr2,136605716,1.716294789542837,8088,6652,14740,-
chr2,136605717,0.6652999698522761,1838,1069,2907,-
chr2,136605718,1.26016114028034,3567,2186,5753,-
chr2,136605719,1.5237039540385264,3635,2689,6324,-
chr2,136605738,0.8104924212675725,4127,2617,6744,-
chr2,136605739,1.293836015437268,2681,1771,4452,-
chr2,136605749,1.8122238955823289,4246,2655,6901,-
chr2,136605751,1.8122238955823289,4246,2655,6901,-
chr2,136609044,0.5640249668999433,851,621,1472,-
chr2,136609057,1.714549085881088,719,565,1284,-
chr2,136614327,0.6466201098379551,866,601,1467,-
chr2,136614414,0.4766167460857726,736,564,1300,-
chr2,136614427,1.991701244813278,1007,722,1729,-
chr2,136615472,1.7869674185463658,712,607,1319,-
chr2,136615549,1.7868187385180647,752,567,1319,-
chr2,136616876,3.2616906474820135,818,555,1373,-
chr2,136616921,0.4037383177570093,701,534,1235,-
chr2,136620192,1.716380825404521,832,568,1400,-
chr2,136620264,1.8707090464547675,796,408,1204,-
chr2,136620307,0.48295031906980374,770,622,1392,-
chr2,136622687,1.9385026737967914,824,560,1384,-
chr2,136623751,1.829268292682927,593,450,1043,-
chr2,136623794,1.1707118741123903,1401,1058,2459,-
chr2,136623829,2.132849414503869,1073,858,1931,-
chr2,136623830,2.132849414503869,1073,858,1931,-
chr2,136626357,0.5671172376873662,564,466,1030,-
chr2,136626407,1.885957217086173,821,510,1331,-
chr2,136627877,1.4927207337374753,2184,1611,3795,-
chr2,136630311,0.5483743061062649,921,678,1599,-
chr2,136630387,1.612650322237725,591,518,1109,-
chr2,136630388,0.5683391003460208,656,475,1131,-
chr2,136633834,2.2115460182053073,924,703,1627,-
chr2,136633992,0.7127098252707902,1215,935,2150,-
chr2,136664658,0.6304235043551867,887,690,1577,-
chr2,136664748,0.9582672167565852,1097,821,1918,-
chr2,136664750,0.9582672167565852,1097,821,1918,-
chr2,136670064,2.097170240740364,2725,2066,4791,-
chr2,136673797,1.5176221351993324,1181,841,2022,-
chr2,136673911,1.7504568914459764,2776,2229,5005,-
chr2,136673926,2.3433545048223947,2263,1634,3897,-
chr2,136678030,1.3828866255695524,1748,1147,2895,-
chr2,136680391,2.181990577304164,6963,6625,13588,-
chr2,136680392,1.9339592123116522,13774,12265,26039,-
chr2,136680394,2.174298974857793,6705,6150,12855,-
chr2,136680406,1.3287060864261069,2706,1942,4648,-
chr2,136680407,1.7931476144732628,2687,2081,4768,-
chr2,136680412,1.7192808790271614,2401,1798,4199,-
chr2,136680439,1.3534437218791553,3714,2523,6237,-
chr2,136680441,1.255397666347728,8641,6162,14803,-
chr2,136680443,1.0158650801586506,3152,1970,5122,-
chr2,136680461,0.5335094962840627,1345,864,2209,-
chr2,136680464,0.6854994051328536,1240,928,2168,-
chr2,136680465,1.814361144543231,1394,1197,2591,-
chr2,136681998,1.4923087334604663,2811,2399,5210,-
chr2,136682001,1.5635327635327634,1371,1052,2423,-
chr2,136682012,1.864108713029576,1165,833,1998,-
chr2,136682024,1.6417089130518618,2420,1842,4262,-
chr2,136690355,0.5018001800180018,1114,706,1820,-
chr2,136690405,2.027329192546584,815,629,1444,-
chr2,136691535,0.8026297495382049,4040,2387,6427,-
chr2,136691539,1.2325155620651775,4135,2730,6865,-
chr2,136691540,1.3858376103671366,3375,2023,5398,-
chr2,136700963,1.5751333620220689,2394,1558,3952,-
chr2,136700993,2.385430247718383,1967,1533,3500,-
chr2,136700996,0.7490644545050114,1788,1441,3229,-
chr2,136701001,0.4825507352604334,1595,1314,2909,-
chr2,136701009,0.6793956674831597,1290,1135,2425,-
chr2,136701042,0.3710057181298352,1102,990,2092,-
chr2,136718978,1.867869625402442,1675,1401,3076,-
chr2,136740993,2.1592039800995027,783,535,1318,-
chr2,136742992,2.825050505050505,873,494,1367,-
chr2,136742993,2.825050505050505,873,494,1367,-
chr2,136743051,0.5811293706860633,613,731,1344,-
chr2,136743066,5.341664006436423,457,570,1027,-
chr2,136743083,0.3409613087032442,529,557,1086,-
chr2,136743084,0.406108585047548,974,1123,2097,-
chr2,136743108,4.218007202881152,575,475,1050,-
chr2,136743109,6.143084922954443,2166,1762,3928,-
chr2,136743110,6.143084922954443,2166,1762,3928,-
chr2,136743111,8.332488780316577,1616,1147,2763,-
chr2,136743113,10.491024893940855,1630,549,2179,-
chr2,136743114,21.787540575997323,1237,370,1607,-
chr2,136743117,12.401544387157315,940,212,1152,-
chr2,136872134,2.000748502994012,593,500,1093,-
chr2,136872157,1.8679245283018868,725,529,1254,-
chr2,136872340,2.524586620555496,729,486,1215,-
chr2,136872342,2.524586620555496,729,486,1215,-
chr2,136872451,1.712293388429752,662,439,1101,-
chr2,136872606,0.5085987548450462,751,562,1313,-
chr2,136873040,2.926779197080292,657,547,1204,-
chr2,136873042,2.926779197080292,657,547,1204,-
chr2,136873297,1.7544541626174277,676,440,1116,-
chr2,136873363,1.7795454545454543,608,461,1069,-
chr2,136873453,2.531991508122691,1081,782,1863,-
chr2,136875718,0.9531318900539758,1470,592,2062,-
chr2,148695880,0.846974597910444,606,537,1143,-
chr2,148716415,1.1213682064501607,577,451,1028,-
chr2,150426577,3.208505747126437,820,579,1399,-
chr2,150432966,1.5922004722370326,1071,690,1761,-
chr2,150433031,2.0989932885906044,833,595,1428,-
chr2,150436004,0.6072790294627383,875,576,1451,-
chr2,150436044,0.5132610006027728,654,473,1127,-
chr2,150436047,2.407351321585903,602,453,1055,-
chr2,150438644,2.215944246132925,1416,794,2210,-
chr2,150438646,2.215944246132925,1416,794,2210,-
chr2,150438779,2.185760294455947,612,482,1094,-
chr2,150443612,1.7892339048075772,573,438,1011,-
chr2,151325365,0.5165346410159688,631,481,1112,-
chr2,151325578,1.9260893546607831,775,517,1292,-
chr2,151325816,0.6453252032520326,634,491,1125,-
chr2,151326147,0.9208488013585225,1043,750,1793,-
chr2,151326148,1.0244739853860376,861,613,1474,-
chr2,151326686,1.6050254093732357,757,505,1262,-
chr2,151326736,0.5541474654377879,628,433,1061,-
chr2,151326749,0.37838689154582156,1323,1105,2428,-
chr2,151328166,0.5201484623541888,653,367,1020,-
chr2,151328244,0.9789290833965022,1315,978,2293,-
chr2,151328245,0.4573170731707316,974,737,1711,-
chr2,151343864,1.516566942899874,681,481,1162,-
chr2,152132161,2.4629629629629632,1272,1071,2343,-
chr2,152132279,1.7673743214502453,2329,1611,3940,-
chr2,152132301,1.7637981194923475,995,640,1635,-
chr2,152668951,7.61460956944828,632,369,1001,-
chr2,153512234,0.6137109517442567,593,432,1025,-
chr2,153514533,2.353339725151806,3591,2979,6570,-
chr2,153515466,1.1327110633263278,5630,4200,9830,-
chr2,153515467,1.3093667873258295,4400,2813,7213,-
chr2,153515502,1.3480626545754328,2043,1212,3255,-
chr2,153515624,2.2051033683125842,4182,2373,6555,-
chr2,153515631,1.535781051372168,1140,621,1761,-
chr2,153515661,2.565730565730566,1575,818,2393,-
chr2,153515668,1.8026418026418023,579,428,1007,-
chr2,153515691,0.39564007421150266,852,489,1341,-
chr2,153515697,0.5889285714285715,678,489,1167,-
chr2,153515818,1.5969414013675465,723,468,1191,-
chr2,153519192,1.8412742769316752,598,420,1018,-
chr2,153520187,1.5300296256396446,987,631,1618,-
chr2,153520192,1.5759329239489843,784,583,1367,-
chr2,153520201,2.358631578947368,678,474,1152,-
chr2,153520437,0.5120687191925255,844,662,1506,-
chr2,153529100,2.176949356913183,618,621,1239,-
chr2,153533037,2.030403452515257,689,491,1180,-
chr2,153549569,2.2723415110652714,620,517,1137,-
chr2,161130168,0.23424464918571702,642,1297,1939,-
chr2,161130207,0.17141432966434433,694,1810,2504,-
chr2,161130208,0.1953488372093023,503,1375,1878,-
chr2,161130209,0.1953488372093023,503,1375,1878,-
chr2,161130210,0.18237715809105284,391,1206,1597,-
chr2,161130214,8.395364980445386,452,1143,1595,-
chr2,168811927,2.49787003854216,696,642,1338,-
chr2,169732650,1.7754249216841238,1289,797,2086,-
chr2,169732653,3.328301886792453,944,529,1473,-
chr2,170676087,2.1847507331378297,744,495,1239,-
chr2,170678502,0.6256809338521402,669,513,1182,-
chr2,170681006,1.9246987951807228,638,497,1135,-
chr2,170681102,1.9161064890146107,1163,851,2014,-
chr2,170681303,2.7834326381992716,596,411,1007,-
chr2,171906577,3.301190476190476,648,615,1263,-
chr2,171906579,2.8620823223550915,992,875,1867,-
chr2,172373784,1.4503023856114927,1024,783,1807,-
chr2,172373786,2.376368040062781,1086,856,1942,-
chr2,172373787,2.893220338983051,568,471,1039,-
chr2,174783490,2.540948592176629,826,609,1435,-
chr2,174783491,2.362256884267283,901,576,1477,-
chr2,174939918,0.5084325396825397,901,615,1516,-
chr2,174939935,1.704047352985488,945,683,1628,-
chr2,174939945,1.87966379087229,657,466,1123,-
chr2,174940182,2.8272327409285527,1510,988,2498,-
chr2,174946705,1.826633302507752,818,592,1410,-
chr2,174946712,1.7227805695142375,747,596,1343,-
chr2,175006564,0.648907773601351,1488,843,2331,-
chr2,175006565,1.8749552024847689,1230,760,1990,-
chr2,175006600,1.8980269989615783,987,641,1628,-
chr2,175006655,3.236026033690658,804,652,1456,-
chr2,175087764,1.5341726618705034,852,555,1407,-
chr2,175087831,2.53345521023766,844,546,1390,-
chr2,175111485,3.579326033467283,732,541,1273,-
chr2,175215446,1.706093413797927,2115,1100,3215,-
chr2,175215447,1.6502679066329986,2413,1248,3661,-
chr2,175215449,1.7447311827956993,2317,1199,3516,-
chr2,175215450,1.7998898760721014,2288,1209,3497,-
chr2,175216358,3.1618923073083156,1418,727,2145,-
chr2,175216361,1.67503454847959,1000,472,1472,-
chr2,175252417,3.8520114378700243,701,388,1089,-
chr2,175260345,3.85904534052697,636,426,1062,-
chr2,176043934,1.3127906899373871,3491,2193,5684,-
chr2,176043952,1.4379749548988672,7385,5378,12763,-
chr2,176044873,0.5763935031376892,1836,1547,3383,-
chr2,176044878,0.6623711340206185,1798,1259,3057,-
chr2,176044890,0.6559195521459672,1538,1112,2650,-
chr2,176044896,1.5527582201360737,1309,980,2289,-
chr2,176046123,1.5988741339491916,1165,865,2030,-
chr2,176046155,0.6170842705235076,2418,1640,4058,-
chr2,176046156,2.181729834791059,897,685,1582,-
chr2,176046429,1.5983057525610718,1158,647,1805,-
chr2,176046436,0.8627832543848419,1943,1094,3037,-
chr2,176046437,0.7052109615873153,3668,2597,6265,-
chr2,178095365,0.49565785268657336,1371,910,2281,-
chr2,178095572,2.339861751152074,676,433,1109,-
chr2,178095849,1.970169677066229,625,405,1030,-
chr2,178095919,0.5976824457593688,712,506,1218,-
chr2,178095995,2.1763435395756576,570,462,1032,-
chr2,178096118,1.9752596146432448,618,432,1050,-
chr2,178096259,1.4768342949737514,768,475,1243,-
chr2,178096418,1.4733107703123258,707,565,1272,-
chr2,179296363,3.048241105400174,611,454,1065,-
chr2,179312256,2.9631937682570597,633,394,1027,-
chr2,179312257,2.9631937682570597,633,394,1027,-
chr2,179312298,1.592513985749079,794,546,1340,-
chr2,179315072,1.13375,906,459,1365,-
chr2,179315073,1.13375,906,459,1365,-
chr2,179343248,3.3650403517263556,2508,2110,4618,-
chr2,179343249,3.3808032207216105,1554,1337,2891,-
chr2,180851519,2.134060402684564,1105,893,1998,-
chr2,180851520,2.134060402684564,1105,893,1998,-
chr2,180851525,1.512084834064721,753,528,1281,-
chr2,180853352,5.1564138261424715,797,442,1239,-
chr2,181737492,0.6630352460329602,6711,5862,12573,-
chr2,181737493,0.6630352460329602,6711,5862,12573,-
chr2,181737494,0.5002018105287436,2081,2213,4294,-
chr2,181737499,0.5680936995153473,540,618,1158,-
chr2,181737502,1.4476225264773734,3295,2540,5835,-
chr2,181737504,1.4767122710120792,4797,3648,8445,-
chr2,181737505,1.58640024467326,3077,2307,5384,-
chr2,181737509,0.9238254971705248,2610,1951,4561,-
chr2,181737515,1.748124936530734,1927,1241,3168,-
chr2,181737516,1.748124936530734,1927,1241,3168,-
chr2,181737521,1.783609022556391,817,474,1291,-
chr2,181737529,0.5432937181663837,639,371,1010,-
chr2,181737530,0.8004495367578531,470,628,1098,-
chr2,181737531,0.8004495367578531,470,628,1098,-
chr2,181737532,0.8004495367578531,470,628,1098,-
chr2,183066440,2.8344720728793305,980,694,1674,-
chr2,183066478,1.5964292867407706,2528,1614,4142,-
chr2,183066479,1.5936157151626766,1769,1085,2854,-
chr2,183070773,1.828872942169692,746,514,1260,-
chr2,183088616,0.550682261208577,677,485,1162,-
chr2,183099188,2.1593069369002142,1700,1190,2890,-
chr2,183099216,1.791081750619323,722,518,1240,-
chr2,183129105,1.751556310130164,618,464,1082,-
chr2,183291376,0.3617947747065506,636,416,1052,-
chr2,183291505,0.5897496052670778,2493,2003,4496,-
chr2,183291506,0.7931668880973178,2925,2333,5258,-
chr2,183291515,0.615603207051982,2033,1840,3873,-
chr2,183291517,0.6389250108365844,1607,1537,3144,-
chr2,183291531,0.6883278790712171,630,371,1001,-
chr2,183291536,2.2753658478380885,1080,623,1703,-
chr2,183291538,2.564402984094765,1734,1407,3141,-
chr2,183291539,1.682299736451394,1167,1206,2373,-
chr2,183291713,0.3651821871995859,682,528,1210,-
chr2,183790024,0.5561904761904762,875,559,1434,-
chr2,183792856,0.5935997347040292,715,488,1203,-
chr2,183818017,1.2144231317089016,837,642,1479,-
chr2,183822232,1.7754104086622426,662,408,1070,-
chr2,183826991,1.939844542075025,819,537,1356,-
chr2,183829433,2.3898678414096914,650,453,1103,-
chr2,183829439,1.7620923913043478,1178,735,1913,-
chr2,183829441,1.8143457692834493,1704,1042,2746,-
chr2,183829442,1.679878048780488,1101,655,1756,-
chr2,183832050,1.6479400749063668,799,533,1332,-
chr2,183841623,2.196185923685046,1313,1272,2585,-
chr2,183841624,2.196185923685046,1313,1272,2585,-
chr2,183847553,1.7952540310313352,1123,691,1814,-
chr2,183847585,1.191005823082366,1104,806,1910,-
chr2,183847588,2.3475840570028947,810,498,1308,-
chr2,183847589,0.5762790697674419,766,558,1324,-
chr2,183847633,2.893360160965795,718,425,1143,-
chr2,183860537,1.8452256944444443,732,479,1211,-
chr2,183888551,0.5154185022026432,701,453,1154,-
chr2,183888564,3.3149720439014287,666,438,1104,-
chr2,188329072,2.181580120347671,954,640,1594,-
chr2,188329117,0.6150975015234613,849,546,1395,-
chr2,188329465,1.8055555555555558,714,431,1145,-
chr2,188329537,2.3068324717060222,634,420,1054,-
chr2,188329632,0.6154384830855419,913,713,1626,-
chr2,188329866,2.374923965816683,977,754,1731,-
chr2,188330289,1.4759937032664308,576,483,1059,-
chr2,188330815,2.0772676387032685,878,525,1403,-
chr2,188332505,1.468673050615595,2195,1461,3656,-
chr2,188332551,1.5143444182330112,1989,1545,3534,-
chr2,188343515,2.312793589389334,836,516,1352,-
chr2,188361726,1.8618574813122377,10719,11192,21911,-
chr2,188361734,1.4586657809645955,10332,9950,20282,-
chr2,188361739,1.9665099319008126,13721,14200,27921,-
chr2,188361760,3.2330438378825472,4247,4463,8710,-
chr2,188368438,1.5062431463418984,33609,18750,52359,-
chr2,188378356,0.38985814948152253,904,470,1374,-
chr2,188378363,1.663228120114043,2438,1434,3872,-
chr2,188378364,1.0445528455284554,1605,901,2506,-
chr2,188394112,1.3028415918053995,1709,1016,2725,-
chr2,188418994,0.6582433668801464,9706,5464,15170,-
chr2,188418996,0.6582433668801464,9706,5464,15170,-
chr2,188419147,2.501407261469181,1658,1308,2966,-
chr2,188419157,1.480708388106776,3079,2079,5158,-
chr2,188419161,1.2893491718253305,1618,1074,2692,-
chr2,188419164,1.2810807035747422,1365,886,2251,-
chr2,188419171,2.2082273112807465,761,523,1284,-
chr2,188419174,0.8381280041199357,1685,1087,2772,-
chr2,188419175,0.8353448552216524,2516,1616,4132,-
chr2,188419176,0.8381280041199357,1685,1087,2772,-
chr2,188419205,0.9067185218009962,634,384,1018,-
chr2,189897510,2.270653907496013,618,417,1035,-
chr2,189897558,1.7296296296296296,1400,1079,2479,-
chr2,189897731,1.869375907111756,827,476,1303,-
chr2,189898164,0.9772123584509996,931,621,1552,-
chr2,189898166,0.9772123584509996,931,621,1552,-
chr2,189898171,2.8713408234821878,1164,737,1901,-
chr2,189898172,3.336225596529284,768,460,1228,-
chr2,189898642,0.7097057356608477,2155,1603,3758,-
chr2,189898689,2.443397047082527,2352,1838,4190,-
chr2,189898720,1.848294930875576,812,650,1462,-
chr2,189898870,1.711436711436711,840,545,1385,-
chr2,189898902,1.5732779383429671,900,691,1591,-
chr2,189901416,2.131304347826087,816,649,1465,-
chr2,189901417,1.8267494356659142,746,442,1188,-
chr2,189901496,0.5109050541987724,651,402,1053,-
chr2,189904056,2.650322695084811,1116,910,2026,-
chr2,189906386,2.2483345669874164,728,578,1306,-
chr2,189906387,2.323214902541327,930,717,1647,-
chr2,189907482,1.7058357538949036,645,540,1185,-
chr2,189907975,0.8632327333683267,1248,952,2200,-
chr2,189909940,1.9958117090048253,684,522,1206,-
chr2,189917718,0.7394152948535742,942,755,1697,-
chr2,189918188,1.208570775767585,1515,1174,2689,-
chr2,189918190,1.025734674383323,1216,961,2177,-
chr2,189918671,2.0626869391824525,612,471,1083,-
chr2,189921741,0.6031468531468532,620,428,1048,-
chr2,189925470,0.5812133072407044,659,510,1169,-
chr2,189928750,0.9722701873612889,1090,871,1961,-
chr2,189932787,1.519137025582088,1263,942,2205,-
chr2,189945759,1.963515901060071,716,565,1281,-
chr2,189948711,1.1419580350635439,1139,909,2048,-
chr2,189948724,0.5010784801725569,754,573,1327,-
chr2,189948748,1.127294981640147,920,816,1736,-
chr2,189948749,1.127294981640147,920,816,1736,-
chr2,189968994,1.8999176954732506,795,674,1469,-
chr2,189968995,1.8999176954732506,795,674,1469,-
chr2,189975054,1.4409150348547144,946,773,1719,-
chr2,189975161,2.639705882352941,717,463,1180,-
chr2,189975162,3.116226838854576,739,547,1286,-
chr2,190636542,1.8589081190110852,1334,1061,2395,-
chr2,190640367,0.4587448559670782,685,485,1170,-
chr2,190640413,1.9901315789473681,604,436,1040,-
chr2,190640429,2.0040949054558594,639,436,1075,-
chr2,190647257,3.1074647493365326,1037,666,1703,-
chr2,190647299,1.7054489641124475,575,470,1045,-
chr2,191161607,2.2255973937617752,636,488,1124,-
chr2,191839568,1.4405422288653795,670,454,1124,-
chr2,191841732,3.2884662240874034,617,521,1138,-
chr2,191847121,0.7536382270346734,581,467,1048,-
chr2,191850379,2.3201995280525205,796,440,1236,-
chr2,191862993,1.8613249558587608,3593,3892,7485,-
chr2,191862994,1.793818119305484,2460,2769,5229,-
chr2,191862997,1.8130891462429306,1121,1184,2305,-
chr2,191862999,1.599276974416018,1916,1797,3713,-
chr2,191863000,1.700751206683719,2937,2815,5752,-
chr2,191863005,1.5179695919714424,2212,2239,4451,-
chr2,191864392,2.0951911490853323,616,536,1152,-
chr2,191864411,2.5456192034915444,894,746,1640,-
chr2,191878285,2.7478777589134125,746,371,1117,-
chr2,191878286,2.7478777589134125,746,371,1117,-
chr2,191878287,2.7478777589134125,746,371,1117,-
chr2,197631428,2.0396544336892175,684,495,1179,-
chr2,197657759,3.0854709834358376,795,1811,2606,-
chr2,197657760,3.0664524725719478,653,1401,2054,-
chr2,197657761,3.504159747890984,896,1960,2856,-
chr2,198257123,1.6867096774193546,687,464,1151,-
chr2,198257719,2.696449704142012,650,519,1169,-
chr2,198257781,2.319015444015444,929,591,1520,-
chr2,198257814,3.0677793608792996,941,577,1518,-
chr2,198260873,2.544568245125348,1217,717,1934,-
chr2,198260951,1.8898131646649305,1615,1181,2796,-
chr2,198262726,1.6292925702097405,673,484,1157,-
chr2,198262751,2.325764742983286,589,452,1041,-
chr2,198262766,2.354068456650953,740,573,1313,-
chr2,198262832,1.8439226519337013,1067,723,1790,-
chr2,198266177,1.7390396659707725,1427,957,2384,-
chr2,198266480,1.373654798935664,1769,1353,3122,-
chr2,198266576,1.480911983032874,1273,942,2215,-
chr2,198266761,0.5980106100795756,1001,779,1780,-
chr2,198266786,2.6798226063335076,983,800,1783,-
chr2,198266835,1.7392495784148398,891,592,1483,-
chr2,198268329,2.0078163165608207,1369,889,2258,-
chr2,198268330,1.8614641558983769,2219,1413,3632,-
chr2,198270034,0.4602028108877424,1337,1094,2431,-
chr2,198270076,2.045261669024045,722,504,1226,-
chr2,198270135,1.9282061401345103,5862,4436,10298,-
chr2,198270136,1.5409994049120432,11629,8119,19748,-
chr2,198270149,0.7448177451617424,2219,1538,3757,-
chr2,198270166,1.6179434615570525,3306,2057,5363,-
chr2,198270173,0.7070374275171323,2145,1354,3499,-
chr2,198272775,1.866129369897425,848,561,1409,-
chr2,198272788,1.7484037701429007,741,505,1246,-
chr2,198272837,2.133636934673367,646,397,1043,-
chr2,198274500,0.5632754342431762,680,433,1113,-
chr2,198281482,1.847382920110193,1436,1088,2524,-
chr2,198281484,1.847382920110193,1436,1088,2524,-
chr2,198281486,0.5627462216173627,826,606,1432,-
chr2,198281488,1.8077591198610303,668,470,1138,-
chr2,198281493,1.848407518280414,836,496,1332,-
chr2,198281525,1.3248658079370712,1309,888,2197,-
chr2,198281542,0.5834274102506208,815,617,1432,-
chr2,198281543,1.5758423623649291,1794,1110,2904,-
chr2,198281545,2.35671834625323,985,644,1629,-
chr2,198285190,2.065810487090764,886,577,1463,-
chr2,198285234,1.796268057784912,1040,711,1751,-
chr2,198285263,2.1571803353484658,1181,796,1977,-
chr2,198285264,1.7171242774566473,969,864,1833,-
chr2,198285758,2.05686630369026,883,740,1623,-
chr2,198285765,0.6497653806047965,996,684,1680,-
chr2,198285832,1.0795537758705933,1547,1052,2599,-
chr2,198285844,2.4355785837651123,640,385,1025,-
chr2,198288651,2.1244200034370166,882,528,1410,-
chr2,198288695,1.9564087759815245,752,432,1184,-
chr2,198299727,1.6523809523809525,693,419,1112,-
chr2,198299747,0.4855700712589074,628,420,1048,-
chr2,198351514,1.436342022220571,4640,3519,8159,-
chr2,198351547,1.6518727345952475,1708,954,2662,-
chr2,198351677,0.7667748634100119,3587,2569,6156,-
chr2,198351688,1.811627609168908,2020,1506,3526,-
chr2,198351692,1.478008377760853,1799,1312,3111,-
chr2,198351742,0.6311357853342586,1794,1440,3234,-
chr2,198351744,0.6311357853342586,1794,1440,3234,-
chr2,198351745,0.6158875449493298,627,436,1063,-
chr2,198351770,0.5343299475396521,2381,2524,4905,-
chr2,198351771,0.534329947539652,2381,2524,4905,-
chr2,198351772,0.46840915751223455,1779,1896,3675,-
chr2,198351774,0.3122763864042934,930,687,1617,-
chr2,198351775,0.2493066705590425,853,662,1515,-
chr2,198351776,1.261352303490616,2061,2176,4237,-
chr2,198351777,1.0497084412455067,1275,1180,2455,-
chr2,198351778,2.1713874180986967,1984,2253,4237,-
chr2,198351779,7.455303933253874,694,838,1532,-
chr2,198351781,3.6466840452437017,719,645,1364,-
chr2,198353867,0.8122972463221426,3588,2650,6238,-
chr2,198354964,0.7859947682975514,2691,1928,4619,-
chr2,198358131,1.5184861472362918,4943,3200,8143,-
chr2,198358159,1.2529707145047533,5229,3260,8489,-
chr2,198360061,0.8238503376126985,6937,4849,11786,-
chr2,198360068,2.047044223826715,1909,1107,3016,-
chr2,198362066,1.278869634764063,2948,2324,5272,-
chr2,198362105,1.6007941009642654,2465,1844,4309,-
chr2,198363480,0.6546020761245674,2101,1699,3800,-
chr2,198364540,1.9154670044915356,923,456,1379,-
chr2,198364543,2.514934289127837,841,371,1212,-
chr2,198364556,2.172297520661157,1368,549,1917,-
chr2,198364558,2.1813833632095028,2846,1443,4289,-
chr2,198364559,2.266941624315052,1806,876,2682,-
chr2,198364563,0.6179622389471799,1038,502,1540,-
chr2,201718104,0.6207913138830466,1113,882,1995,-
chr2,201721624,0.5580693815987933,961,675,1636,-
chr2,201722719,2.29496855345912,978,582,1560,-
chr2,201722720,2.29496855345912,978,582,1560,-
chr2,201722788,1.7963286713286717,684,467,1151,-
chr2,201726057,1.7529893014474511,618,453,1071,-
chr2,201726436,2.353072853072853,745,467,1212,-
chr2,201726438,2.353072853072853,745,467,1212,-
chr2,201726573,2.323681410548716,1222,773,1995,-
chr2,201729328,2.2171945701357467,769,560,1329,-
chr2,201729334,2.772229823586474,2144,1285,3429,-
chr2,201729336,2.7393480073974694,1936,1198,3134,-
chr2,201729338,2.836613331051596,1250,753,2003,-
chr2,201729344,2.409572825527535,866,334,1200,-
chr2,201729345,2.7151421813003984,2143,933,3076,-
chr2,201729346,2.7151421813003984,2143,933,3076,-
chr2,201729347,2.938978494623656,840,309,1149,-
chr2,201729374,3.449759170662797,761,274,1035,-
chr2,201729380,0.8239763682578605,1109,397,1506,-
chr2,201735998,0.47663139841413993,1166,884,2050,-
chr2,201736219,0.4836924868957484,603,403,1006,-
chr2,201752376,2.2723973956029657,818,592,1410,-
chr2,201752377,2.3008750682919326,1021,668,1689,-
chr2,201822802,1.6220992264603893,694,651,1345,-
chr2,201822807,2.1929749103942653,955,836,1791,-
chr2,201822808,2.1929749103942653,955,836,1791,-
chr2,201824118,2.240538594968725,694,570,1264,-
chr2,203071587,2.4036138249816155,714,500,1214,-
chr2,203071752,0.5589959819576127,3279,2271,5550,-
chr2,203071847,1.8316498316498315,679,593,1272,-
chr2,203072021,1.6894347482582774,1237,713,1950,-
chr2,203072027,1.799771602588504,1181,638,1819,-
chr2,203079121,1.8474041451953416,1564,898,2462,-
chr2,203079123,1.8474041451953416,1564,898,2462,-
chr2,203079130,1.7121919678137798,661,448,1109,-
chr2,203103260,1.48753593520217,608,413,1021,-
chr2,203745395,1.6967100078802209,688,422,1110,-
chr2,203745499,1.758896151053014,691,458,1149,-
chr2,203747464,1.8416644672700966,2083,1548,3631,-
chr2,203749173,1.1433441790983694,621,453,1074,-
chr2,203764346,2.4870585220822563,794,585,1379,-
chr2,203776167,2.686239620403321,646,561,1207,-
chr2,203776365,2.3640486502396767,605,476,1081,-
chr2,206988733,2.37534473248759,637,517,1154,-
chr2,206991282,0.3773691654879774,666,504,1170,-
chr2,206992541,0.4515462395748764,965,796,1761,-
chr2,206992598,2.2992706454395737,2567,1865,4432,-
chr2,206992600,1.9942703784436269,4152,2963,7115,-
chr2,206992621,1.94719633009614,1049,660,1709,-
chr2,206994820,1.805341551104263,924,589,1513,-
chr2,206997725,1.768085847418096,1376,1122,2498,-
chr2,206997728,0.5650558457935506,1090,792,1882,-
chr2,207006765,1.670333495910127,2331,1687,4018,-
chr2,207007476,2.0969533481434466,880,547,1427,-
chr2,207007548,0.4930662557781202,639,471,1110,-
chr2,207011628,0.3856907305183167,537,480,1017,-
chr2,207012479,0.5536963262150963,1056,877,1933,-
chr2,207014562,1.72241610738255,801,595,1396,-
chr2,207018359,2.263135228251508,1050,515,1565,-
chr2,207018363,0.6930937063534504,4215,2397,6612,-
chr2,207018364,0.6326932914587164,7098,4098,11196,-
chr2,207018365,0.6326932914587164,7098,4098,11196,-
chr2,207024146,0.8930247718383311,720,471,1191,-
chr2,207024147,0.8240561109919585,1113,683,1796,-
chr2,207024148,0.6230195013609936,1196,702,1898,-
chr2,209101013,2.4609983308290753,609,491,1100,-
chr2,209106789,2.083297318210908,799,588,1387,-
chr2,209106833,2.03300395256917,761,505,1266,-
chr2,209113221,1.7844378468782214,1158,804,1962,-
chr2,209113240,2.1056518401663498,875,605,1480,-
chr2,209119673,3.3684458618539583,1000,608,1608,-
chr2,211298445,1.4848531211750309,1293,816,2109,-
chr2,211298516,2.8826469067723592,1639,828,2467,-
chr2,211298517,2.8826469067723592,1639,828,2467,-
chr2,211298520,3.281772575250836,784,367,1151,-
chr2,211298526,3.898668639053255,752,337,1089,-
chr2,211298529,2.848678601875533,1466,620,2086,-
chr2,211298530,2.848678601875533,1466,620,2086,-
chr2,211306127,2.4797476653714323,654,463,1117,-
chr2,219134710,2.087315775179143,1345,1066,2411,-
chr2,219134713,2.5271002876904514,704,516,1220,-
chr2,220405099,1.5370322846611548,685,555,1240,-
chr2,220432930,4.321044546850999,775,371,1146,-
chr2,220432931,3.805182732496359,1064,598,1662,-
chr2,223488439,2.811380400421496,643,510,1153,-
chr2,223488440,2.6633068520936245,1174,841,2015,-
chr2,223489063,2.2923762772991383,1016,712,1728,-
chr2,223489065,2.2923762772991383,1016,712,1728,-
chr2,223504406,1.5424237635329634,6245,4577,10822,-
chr2,223504407,1.5755334429350176,4100,3174,7274,-
chr2,223505593,1.5280929487179489,1342,974,2316,-
chr2,223505608,1.5119457981694997,1059,715,1774,-
chr2,223507575,1.6075757575757577,1060,659,1719,-
chr2,223507622,3.132512140795743,1214,748,1962,-
chr2,224840075,1.9109940750493741,1061,734,1795,-
chr2,224840092,2.4516695957820738,619,568,1187,-
chr2,224840112,1.8486328125,630,511,1141,-
chr2,224840389,2.0250019906043475,747,660,1407,-
chr2,224842303,2.2061323618700666,1117,731,1848,-
chr2,224842326,1.5945945945945945,1061,665,1726,-
chr2,224845109,2.078054480980013,972,751,1723,-
chr2,224849493,1.4925275212779412,3225,2166,5391,-
chr2,224849543,1.6909811232812864,906,612,1518,-
chr2,224849549,1.8783325070264385,1635,1018,2653,-
chr2,224849553,3.228778615100242,810,540,1350,-
chr2,224856567,1.9516557892192408,733,590,1323,-
chr2,224856597,1.6101694915254237,683,530,1213,-
chr2,224856713,1.911233388704319,897,687,1584,-
chr2,224856714,1.5254083484573504,901,637,1538,-
chr2,224862847,0.6029862174578866,899,652,1551,-
chr2,224862968,1.7420721489772046,1101,810,1911,-
chr2,224863014,1.7045454545454546,674,557,1231,-
chr2,224866373,1.5979532163742691,1092,645,1737,-
chr2,224866394,1.6892932843922863,777,666,1443,-
chr2,224866397,1.079226852126327,1282,821,2103,-
chr2,224866471,3.52667731629393,668,625,1293,-
chr2,224866527,0.218344328580549,683,507,1190,-
chr2,224866552,1.8353422325562083,959,702,1661,-
chr2,224866615,2.5542039962202066,588,432,1020,-
chr2,232319799,1.3336201052016363,2640,1710,4350,-
chr2,232319879,1.4080259222333005,1882,1415,3297,-
chr2,232319907,0.6870091840809264,1146,1365,2511,-
chr2,232319921,0.4704837845081747,905,1147,2052,-
chr2,232319940,3.560072650505149,2702,2766,5468,-
chr2,232319943,4.78861404611478,1804,1686,3490,-
chr2,232319946,3.224408466188513,2462,2018,4480,-
chr2,232319969,2.1220651217047406,1228,796,2024,-
chr2,232319970,2.1689608636977056,573,493,1066,-
chr2,232319975,6.6124733253434265,952,799,1751,-
chr2,232320142,2.4891197502318194,2425,1770,4195,-
chr2,232320144,2.6032258064516127,806,619,1425,-
chr2,232320160,4.694691140372927,1002,699,1701,-
chr2,232320172,2.8746295750856286,913,599,1512,-
chr2,232320190,7.32322142282557,1578,983,2561,-
chr2,232322425,0.7970238373383467,4945,3538,8483,-
chr2,232325238,1.369551022100378,9587,7641,17228,-
chr2,232325239,1.4276578614901587,34956,31593,66549,-
chr2,232325240,1.5960201153813156,13432,13482,26914,-
chr2,232325241,1.5106191857128661,22485,20548,43033,-
chr2,232325244,1.9579698343804397,8006,7354,15360,-
chr2,232325245,1.9579698343804397,8006,7354,15360,-
chr2,232325252,1.346045684113866,6700,5444,12144,-
chr2,232325253,1.346045684113866,6700,5444,12144,-
chr2,232325264,1.5553738424864767,5406,4194,9600,-
chr2,232325265,1.5553738424864767,5406,4194,9600,-
chr2,232325266,0.7909401139070832,2874,2045,4919,-
chr2,232325381,3.6573324606430244,9554,7405,16959,-
chr2,232325384,1.411331292188325,5411,3780,9191,-
chr2,232325437,2.0829767139196806,3491,2190,5681,-
chr2,232325518,1.605660954134954,8906,6205,15111,-
chr2,232325534,1.3419039126470202,8451,5995,14446,-
chr2,232325535,1.4061170418503908,4444,3335,7779,-
chr2,232325567,1.616438859494415,1516,1133,2649,-
chr2,232326284,1.788897113249445,1006,771,1777,-
chr2,232326358,0.508174139051332,1503,949,2452,-
chr2,232326359,2.0868813486060085,851,660,1511,-
chr2,232326366,2.702905865962999,1804,1422,3226,-
chr2,232326434,2.4954407294832825,820,657,1477,-
chr2,232326442,2.628834355828221,856,651,1507,-
chr2,232326604,1.54796142195606,1932,1118,3050,-
chr2,232326655,1.7698545549231857,970,926,1896,-
chr2,232326659,1.65625,953,863,1816,-
chr2,232328018,0.6851340487259254,1152,853,2005,-
chr2,232329056,1.7217847769028871,655,507,1162,-
chr2,232329175,1.9471306471306473,861,454,1315,-
chr2,232329176,1.9471306471306473,861,454,1315,-
chr2,233344621,2.937692489931296,991,803,1794,-
chr2,233344658,1.7588448231803027,3412,2493,5905,-
chr2,233344659,1.9590738722887582,5238,3927,9165,-
chr2,233344660,1.815225364907305,6159,4636,10795,-
chr2,233344678,2.2103277060575968,717,529,1246,-
chr2,233344679,1.9898201394447776,1840,1311,3151,-
chr2,233344680,2.279865295994328,676,402,1078,-
chr2,233344893,2.3888008452192286,713,630,1343,-
chr2,233344941,1.7894021739130432,877,735,1612,-
chr2,233345150,1.388254347084896,914,837,1751,-
chr2,233345441,1.496031746031746,1913,1154,3067,-
chr2,233345443,1.419495658960101,1662,1223,2885,-
chr2,233345465,0.664818400516341,1332,987,2319,-
chr2,233345467,1.5590251124026755,2992,1657,4649,-
chr2,233345468,1.6566835999696716,4369,2397,6766,-
chr2,233345470,1.8093506493506493,2837,1539,4376,-
chr2,233345481,1.1521796881015574,4854,3018,7872,-
chr2,233345482,1.0825665886665918,4119,2413,6532,-
chr2,233345490,1.5746799431009957,674,474,1148,-
chr2,233346225,2.193612774451098,1098,834,1932,-
chr2,233346243,1.8590823970037447,1044,800,1844,-
chr2,233346270,0.6258250330013201,744,640,1384,-
chr2,233346333,1.6916012468378914,1428,1143,2571,-
chr2,233346533,1.6003984063745025,926,752,1678,-
chr2,233347270,2.036702868281816,1260,1025,2285,-
chr2,233347271,0.6794940796555438,1009,928,1937,-
chr2,233347636,1.4273954116059375,1510,1234,2744,-
chr2,233347825,0.6135456702035712,1755,1221,2976,-
chr2,233347844,1.7097345132743362,1126,903,2029,-
chr2,233347884,1.8760994109577989,948,728,1676,-
chr2,233348127,0.7232561557268634,1202,840,2042,-
chr2,233348151,2.103767906584808,1027,638,1665,-
chr2,233348717,1.8275405958624618,2100,1456,3556,-
chr2,233348721,1.660968660968661,1165,740,1905,-
chr2,233348773,1.8203156781384755,1542,963,2505,-
chr2,233348774,0.692847725774555,1000,819,1819,-
chr2,233348775,1.8203156781384755,1542,963,2505,-
chr2,233348799,2.1145374449339207,767,453,1220,-
chr2,233348872,1.617605982713137,4223,3018,7241,-
chr2,233348874,1.617605982713137,4223,3018,7241,-
chr2,233348887,1.9157438613384685,864,669,1533,-
chr2,233348921,1.7149813883804026,1747,1062,2809,-
chr2,233349223,1.5198539176626826,973,752,1725,-
chr2,233349274,0.6324659231722429,967,806,1773,-
chr2,233349285,1.900606060606061,959,824,1783,-
chr2,233349523,1.1414295037264093,1954,1683,3637,-
chr2,233349721,1.341103666480551,1557,1193,2750,-
chr2,233349723,1.376466856961624,1239,1050,2289,-
chr2,233349733,1.4311798199573749,1405,997,2402,-
chr2,233349750,1.7085141011004001,2192,1872,4064,-
chr2,233349910,1.5503534747232224,1181,1070,2251,-
chr2,233349976,1.6463046757164406,825,662,1487,-
chr2,233350599,0.5767524401064773,779,643,1422,-
chr2,233350648,2.032882414151925,813,619,1432,-
chr2,233350650,2.1294995709672775,1288,1060,2348,-
chr2,233350665,0.4063592287743827,635,542,1177,-
chr2,233350666,0.44377898671162774,1139,845,1984,-
chr2,233350698,3.3299913728321586,612,494,1106,-
chr2,233350788,1.896484829673314,751,525,1276,-
chr2,233350789,1.896484829673314,751,525,1276,-
chr2,233350999,2.542372881355932,767,471,1238,-
chr2,233351008,1.981380337636544,693,423,1116,-
chr2,233351748,0.8028578251870719,876,570,1446,-
chr2,233351750,0.8028578251870719,876,570,1446,-
chr2,233351782,1.587608195021683,718,546,1264,-
chr2,234749309,1.4802631578947367,1040,693,1733,-
chr2,234749311,1.1020075497597803,1834,867,2701,-
chr2,234749313,1.1020075497597803,1834,867,2701,-
chr2,234749322,1.685650336390959,1508,805,2313,-
chr2,234749340,0.4682454059098796,775,505,1280,-
chr2,234750358,2.1889000872211604,1031,864,1895,-
chr2,240900486,3.852864583333334,806,431,1237,-
chr2,240900505,1.202255370947966,1035,578,1613,-
chr2,240929551,1.4743463645246515,1022,708,1730,-
chr2,240961593,2.6467344779413473,916,752,1668,-
chr2,240961605,2.461729234683943,1419,980,2399,-
chr2,240961606,2.079154887665526,821,610,1431,-
chr2,240961691,2.9193881950941707,908,678,1586,-
chr2,241073378,0.4337599446558285,791,587,1378,-
chr2,241073380,0.674358081148407,1682,1262,2944,-
chr2,242035814,2.0028892247029333,3013,2084,5097,-
chr2,242035815,2.175479080911837,2666,1885,4551,-
chr2,242035831,3.8033803501945527,1008,513,1521,-
chr2,242035832,3.8033803501945527,1008,513,1521,-
chr2,242035839,2.185824592074592,810,527,1337,-
chr2,242035840,2.2926749590358035,995,674,1669,-
chr2,242168799,2.2865153787091135,1073,729,1802,-
chr2,242168920,1.2937121195139514,1175,891,2066,-
chr2,242168921,0.9735413056036973,765,576,1341,-
chr2,242168922,2.4493554327808478,664,361,1025,-
chr2,242168943,0.3605279698302954,716,429,1145,-
chr2,242169334,2.101187664664006,966,799,1765,-
chr2,242169336,2.958436069038393,680,500,1180,-
chr2,242170179,1.94377990430622,624,439,1063,-
chr2,242170299,1.7081052631578948,600,499,1099,-
chr2,242170324,0.917514534883721,1110,945,2055,-
chr2,242170325,0.917514534883721,1110,945,2055,-
chr2,242173300,1.835559392615916,1003,678,1681,-
chr2,242176063,1.6605263157894734,630,474,1104,-
chr2,242176119,0.6014950166112957,638,429,1067,-
chr2,242176123,3.8532067783541555,897,668,1565,-
chr2,242178090,0.6210892546500736,1008,704,1712,-
chr2,242178150,1.8654669291092567,1011,680,1691,-
chr2,242178175,1.9810268956598158,1565,1100,2665,-
chr2,242179091,1.8119072032812096,1153,663,1816,-
chr2,242179093,1.8119072032812096,1153,663,1816,-
chr2,242179322,1.026596549636804,1205,895,2100,-
chr2,242179324,1.026596549636804,1205,895,2100,-
chr2,242179328,1.2101861495382276,955,737,1692,-
chr2,242179459,2.4105272939579767,833,704,1537,-
chr2,242179460,1.558758314855876,702,450,1152,-
chr2,242179498,0.562798092209857,707,441,1148,-
chr2,242186522,1.0055748080759372,3714,2564,6278,-
chr2,242187434,3.0444827586206893,980,724,1704,-
chr2,242189270,2.092596313887874,889,560,1449,-
chr2,242189388,0.4793198529411764,595,511,1106,-
chr2,242192880,1.3302182704214438,5778,4311,10089,-
chr2,242192881,1.5145706984936909,5861,4202,10063,-
chr2,242192884,1.372943469785575,1983,1349,3332,-
chr2,242192886,1.355984555984556,1755,1109,2864,-
chr2,242192894,0.7006323656223052,1624,1064,2688,-
chr2,242192896,0.5965012905075996,1455,950,2405,-
chr2,242194487,1.7941640378548895,909,633,1542,-
chr2,242194508,0.9988996478873239,1690,1135,2825,-
chr2,242194509,0.9988996478873239,1690,1135,2825,-
chr2,242194909,1.668942389727666,1619,1131,2750,-
chr2,242194976,1.671161825726141,1073,722,1795,-
chr2,242194978,0.6042168674698796,884,663,1547,-
chr2,242194991,2.032535885167464,884,626,1510,-
chr2,242194994,1.6810787671232876,832,583,1415,-
chr2,242195617,1.8795727861407787,744,516,1260,-
chr2,242195653,1.9899037883558428,1044,761,1805,-
chr2,242195780,2.2774371551195585,873,931,1804,-
chr2,242195782,0.5074263573592965,680,490,1170,-
chr2,242195783,1.4652384291725105,1570,1549,3119,-
chr2,242195784,1.4652384291725105,1570,1549,3119,-
chr2,242195787,1.6559278350515465,770,581,1351,-
chr2,242195790,1.6303472706779025,674,600,1274,-
chr2,242195791,2.121304347826088,696,499,1195,-
chr2,242196054,1.933143750959417,2790,2065,4855,-
chr2,242196055,1.933143750959417,2790,2065,4855,-
chr2,242196067,0.4002339469309856,590,438,1028,-
chr2,242196167,0.5809561894605882,1045,725,1770,-
chr2,242202196,1.4940833653012986,7672,5140,12812,-
chr2,242202210,2.508872368908257,2317,1493,3810,-
chr2,242202256,1.5641029270225897,1872,1038,2910,-
chr2,242202294,1.6626633986928103,1298,764,2062,-
chr2,242202313,1.6068754774637126,808,560,1368,-
chr2,242202333,2.6110395185932838,1234,850,2084,-
chr2,242203870,0.9140682184160446,1114,758,1872,-
chr2,242203872,0.9140682184160446,1114,758,1872,-
chr2,242203882,2.6081117742810638,662,387,1049,-
chr2,242207904,1.383664000504927,2219,1445,3664,-
chr2,242207906,1.383664000504927,2219,1445,3664,-
chr2,242439630,2.549385545166866,711,557,1268,-
chr2,242615244,0.4870741920999522,716,504,1220,-
chr2,242615324,0.2949760765550239,684,417,1101,-
