chromosome,position,rsr,t_read,c_read,total_reads,strand
chr1,629926,0.4941720832874297,1868,1251,3119,+
chr1,629927,1.4473036473483998,692,653,1345,+
chr1,629928,0.4941720832874297,1868,1251,3119,+
chr1,629929,0.5409842435501168,1236,886,2122,+
chr1,629932,0.6482142857142856,890,839,1729,+
chr1,629933,1.7085578964559855,853,627,1480,+
chr1,631310,1.9358302297886594,2594,1395,3989,+
chr1,631311,1.913921360255048,1800,940,2740,+
chr1,631314,1.7040560597581451,2000,1125,3125,+
chr1,631315,1.7453204764605785,3076,1762,4838,+
chr1,631317,1.6760147123864217,4063,2448,6511,+
chr1,631318,1.642521119783481,2975,2054,5029,+
chr1,631326,1.3321814637604108,1239,1025,2264,+
chr1,631329,1.4451297989992724,3129,2264,5393,+
chr1,631343,1.305053337955431,3218,2490,5708,+
chr1,631361,1.5531724600933643,6802,5641,12443,+
chr1,631362,2.0092556165234496,4218,3714,7932,+
chr1,631484,0.33950795587732296,1316,1133,2449,+
chr1,631485,0.40137325535668733,1900,1469,3369,+
chr1,631497,1.9586276741275093,1546,1131,2677,+
chr1,631500,1.5009325611072937,1111,667,1778,+
chr1,631503,1.6875353148792736,6263,5003,11266,+
chr1,631504,1.6875353148792736,6263,5003,11266,+
chr1,631505,1.6875353148792736,6263,5003,11266,+
chr1,633917,1.0194792434291329,846,589,1435,+
chr1,633918,1.0194792434291329,846,589,1435,+
chr1,633921,1.0072626036434065,1512,805,2317,+
chr1,633923,1.0072626036434065,1512,805,2317,+
chr1,633925,2.0341311673723323,1595,651,2246,+
chr1,633926,1.0550389273356402,1773,1087,2860,+
chr1,633927,2.0341311673723323,1595,651,2246,+
chr1,633928,1.0550389273356402,1773,1087,2860,+
chr1,633930,2.0564111148309343,944,411,1355,+
chr1,633937,1.38285580633844,1136,502,1638,+
chr1,633938,1.5810562992847972,1202,797,1999,+
chr1,633955,1.574416264090177,1818,827,2645,+
chr1,633963,1.6012891344383058,2208,1085,3293,+
chr1,633965,1.5064061756067813,2902,1746,4648,+
chr1,633967,1.6431577474656192,4827,3133,7960,+
chr1,633970,1.404054192855794,3560,2202,5762,+
chr1,633973,1.300333140208575,3191,1725,4916,+
chr1,633977,1.4366478797638214,4253,2759,7012,+
chr1,633980,1.2649597531331422,4543,2986,7529,+
chr1,633985,1.456755889671211,9775,6133,15908,+
chr1,633990,0.7922427035330261,4125,3143,7268,+
chr1,633991,1.4298024444479192,20234,15336,35570,+
chr1,633992,1.3844616936666911,26282,19042,45324,+
chr1,633993,1.4298024444479192,20234,15336,35570,+
chr1,1311036,0.6481603893622183,5711,2503,8214,+
chr1,1311037,0.7650865994078904,3491,1518,5009,+
chr1,1311038,0.6413045038993801,3933,1785,5718,+
chr1,1311046,2.534637919371133,1725,758,2483,+
chr1,2395847,1.084503952066749,999,734,1733,+
chr1,2399433,2.2264445601249347,657,451,1108,+
chr1,2403598,2.7213749674270082,766,554,1320,+
chr1,6633336,2.5064649724986445,1598,1020,2618,+
chr1,6633337,2.972614107883817,596,481,1077,+
chr1,6633338,0.9475890985324948,677,370,1047,+
chr1,6785546,3.0057371597053937,657,666,1323,+
chr1,6785547,3.0057371597053937,657,666,1323,+
chr1,6785548,1.8033198984604986,602,692,1294,+
chr1,7961710,0.5370236496953423,649,420,1069,+
chr1,7961714,1.9055349412492268,724,461,1185,+
chr1,7962765,1.4127207376152522,1129,728,1857,+
chr1,7962766,0.6049409237379163,1055,734,1789,+
chr1,7962767,1.1189795016534516,1508,1269,2777,+
chr1,7962773,1.4771290322580646,1578,999,2577,+
chr1,7962774,1.4207662201986495,1570,1086,2656,+
chr1,7962776,0.6963953525453637,1723,1056,2779,+
chr1,7962780,1.421512598972581,1896,1190,3086,+
chr1,7962781,1.384777031432859,3077,2356,5433,+
chr1,7962783,1.3352789898572874,5295,3949,9244,+
chr1,7965351,1.5068219633943427,1980,1201,3181,+
chr1,7965354,1.626522823895921,2755,2264,5019,+
chr1,7965361,1.4130325454414832,1638,1346,2984,+
chr1,7965408,1.3385479509049305,2297,1517,3814,+
chr1,7965409,1.6489530456852792,1847,1575,3422,+
chr1,7969390,1.3575409379346697,3248,2540,5788,+
chr1,7970891,1.197818340233201,2598,2108,4706,+
chr1,7970892,1.2788769045832549,4913,3703,8616,+
chr1,7970893,1.691357663943325,6362,4924,11286,+
chr1,7977693,1.6455957170884183,2061,1768,3829,+
chr1,7984986,1.487846982460986,1485,1113,2598,+
chr1,10399091,2.290837400968608,1132,660,1792,+
chr1,10399672,1.246975682061185,1044,704,1748,+
chr1,10400403,1.7691888100989637,945,625,1570,+
chr1,10400503,1.4955908289241622,1006,755,1761,+
chr1,10403081,3.9181286549707597,669,493,1162,+
chr1,10404269,1.6166541635408853,861,515,1376,+
chr1,10408075,1.1649679294889892,2001,1519,3520,+
chr1,10408077,0.5500776397515528,1307,1103,2410,+
chr1,10411422,2.2722344308335956,1340,992,2332,+
chr1,10411431,7.595078588306868,2203,2130,4333,+
chr1,10411447,0.5652603010115963,473,578,1051,+
chr1,10411493,0.6728138253645997,1177,1069,2246,+
chr1,10411500,0.36575549760133935,709,608,1317,+
chr1,10411502,2.9093535572408813,635,638,1273,+
chr1,10411509,0.27988888888888885,686,674,1360,+
chr1,10411511,1.113167605320448,1922,1409,3331,+
chr1,10411528,1.9064386317907447,757,567,1324,+
chr1,10413107,1.2787343270563094,2668,2139,4807,+
chr1,10413199,1.8488745980707395,749,621,1370,+
chr1,10413215,2.4454477050413845,749,442,1191,+
chr1,10416986,1.924015500628404,992,681,1673,+
chr1,10417045,0.6714169809336359,1624,1177,2801,+
chr1,10417063,1.6117375630857966,1432,949,2381,+
chr1,10417087,2.437551440329218,1633,1079,2712,+
chr1,10417088,1.4075180613430476,2013,1448,3461,+
chr1,10417458,0.5514858841010402,1141,672,1813,+
chr1,10417460,2.0848938826466914,667,533,1200,+
chr1,10418827,1.3875055169722863,1003,799,1802,+
chr1,10418834,1.988175344308383,1373,991,2364,+
chr1,10418838,0.4864771151178918,975,720,1695,+
chr1,10418839,0.49826613005290216,1269,1012,2281,+
chr1,10418840,0.49826613005290216,1269,1012,2281,+
chr1,10418845,1.113703560987825,1611,1208,2819,+
chr1,10418852,0.6167195372270945,1321,931,2252,+
chr1,10418860,1.7168947055324209,1177,819,1996,+
chr1,10419457,2.1511182652931713,1107,735,1842,+
chr1,10419464,1.9125735177237317,751,465,1216,+
chr1,10419472,1.6765306122448982,582,489,1071,+
chr1,10419475,0.5302903225806451,966,619,1585,+
chr1,10419504,0.6880317957904164,722,615,1337,+
chr1,10419684,1.9932453245324533,1240,908,2148,+
chr1,10419685,2.0292782121140327,1885,1406,3291,+
chr1,10419687,2.0092417955488497,1271,963,2234,+
chr1,10419827,0.6370808678500987,1291,1013,2304,+
chr1,10419835,0.6750480355131517,2981,2235,5216,+
chr1,10419836,0.6750480355131517,2981,2235,5216,+
chr1,10419974,1.7277117743649184,576,492,1068,+
chr1,10419990,0.616183615345954,612,507,1119,+
chr1,10420037,1.6078431372549018,819,509,1328,+
chr1,10420056,1.7984916021131465,1332,1045,2377,+
chr1,10420069,1.1421054641637183,1345,1024,2369,+
chr1,10440368,2.625,629,374,1003,+
chr1,10440369,2.625,629,374,1003,+
chr1,10442271,1.7684966165241929,2030,1570,3600,+
chr1,10630654,2.0308179723502304,640,433,1073,+
chr1,10630655,1.7106876977731618,908,628,1536,+
chr1,10630658,1.3177227448810185,885,555,1440,+
chr1,10630660,1.5264144397268724,1285,871,2156,+
chr1,10630663,1.2439695787793723,2564,1891,4455,+
chr1,10630664,1.2654523565854099,3204,2336,5540,+
chr1,11016906,1.8391260286344722,1224,830,2054,+
chr1,11018736,0.563872255489022,564,500,1064,+
chr1,11020476,2.3116674569497815,979,717,1696,+
chr1,11022307,3.9442403013976253,2241,1355,3596,+
chr1,11022308,4.339796786358581,1616,1038,2654,+
chr1,11022338,8.266055221579256,2345,2014,4359,+
chr1,11022339,8.266055221579256,2345,2014,4359,+
chr1,11022607,2.217136352446695,647,355,1002,+
chr1,11022673,11.430680619765841,1112,811,1923,+
chr1,11022677,2.725074492167511,2082,1552,3634,+
chr1,11022690,4.962400078043698,2755,2445,5200,+
chr1,11022691,4.928824401247508,3204,2772,5976,+
chr1,11023486,2.116117850953206,956,576,1532,+
chr1,11023487,2.242758129025968,1346,841,2187,+
chr1,11745806,0.8950615138156677,611,447,1058,+
chr1,11747448,2.1051794001528035,1274,967,2241,+
chr1,11747450,2.1527777777777777,584,467,1051,+
chr1,11948052,1.9640403511400248,820,620,1440,+
chr1,11949803,1.8435189174703777,986,675,1661,+
chr1,11949811,2.1110256564618393,1681,1354,3035,+
chr1,11949829,3.0695827759360927,843,656,1499,+
chr1,11952699,5.008971704623879,572,482,1054,+
chr1,11952700,5.008971704623879,572,482,1054,+
chr1,11957845,2.939339809939716,712,522,1234,+
chr1,11957850,3.0431915475517584,622,500,1122,+
chr1,11958620,2.428952739833569,909,578,1487,+
chr1,11958621,2.428952739833569,909,578,1487,+
chr1,11965550,1.50238962547182,640,507,1147,+
chr1,11966256,1.8707486632014934,622,379,1001,+
chr1,11967017,1.823378231708529,1287,775,2062,+
chr1,11967036,6.515228426395938,905,590,1495,+
chr1,11967038,6.515228426395938,905,590,1495,+
chr1,11967049,2.254460093896713,685,354,1039,+
chr1,11967054,1.7658079625292742,753,426,1179,+
chr1,11970669,0.5062391607800008,747,502,1249,+
chr1,11970670,0.6179458239277653,875,442,1317,+
chr1,11970682,2.1284197631686403,833,631,1464,+
chr1,11970721,1.9797468354430376,611,394,1005,+
chr1,11974657,15.585548349188878,2150,1423,3573,+
chr1,11974658,14.923035206040916,2307,1563,3870,+
chr1,11974659,16.207591085940177,1852,1227,3079,+
chr1,11974779,2.487281503756792,643,401,1044,+
chr1,11975093,2.117246802483023,900,624,1524,+
chr1,11975330,1.622877042188138,891,636,1527,+
chr1,11989211,1.3232345248474282,933,495,1428,+
chr1,11989212,2.046608563849943,981,405,1386,+
chr1,11989213,2.2012262710029367,1618,751,2369,+
chr1,11992650,4.415825472036243,684,591,1275,+
chr1,11998773,2.6340451165791903,662,450,1112,+
chr1,11998778,3.02885760368629,910,568,1478,+
chr1,11998812,0.14500782849572444,601,436,1037,+
chr1,11998829,1.9099752384134414,2623,1786,4409,+
chr1,11998831,1.9099752384134414,2623,1786,4409,+
chr1,12012246,4.819833976467746,658,634,1292,+
chr1,12012247,4.639045376196069,751,775,1526,+
chr1,15409928,1.85246776957342,1197,737,1934,+
chr1,15409929,1.85246776957342,1197,737,1934,+
chr1,15410087,2.7599259487679624,2208,1595,3803,+
chr1,15410088,2.6889481392466856,917,858,1775,+
chr1,15410089,2.8915296571378595,1356,1125,2481,+
chr1,15410164,1.8076443705857919,686,497,1183,+
chr1,15410165,0.37745956430460315,2197,1419,3616,+
chr1,15410166,0.3640306196699363,1136,730,1866,+
chr1,15410182,0.6109422492401215,803,419,1222,+
chr1,15410185,0.593065693430657,1899,911,2810,+
chr1,15410187,0.6250890313390314,3008,1403,4411,+
chr1,15410188,0.671358211590836,4835,2598,7433,+
chr1,15410205,1.4838406292749657,2313,1375,3688,+
chr1,15410208,1.6620305980528511,1672,718,2390,+
chr1,15410209,1.5134221292067598,7231,4154,11385,+
chr1,15410210,1.5117958759790795,3476,1795,5271,+
chr1,15410248,1.7313861268939394,1426,1055,2481,+
chr1,15425902,2.1142151566599785,760,681,1441,+
chr1,15425908,1.8166947533984947,1393,1034,2427,+
chr1,15425911,1.5912706911850198,1464,1126,2590,+
chr1,15425914,1.3999178172255096,1606,935,2541,+
chr1,15425959,1.5421080329008923,4656,2980,7636,+
chr1,15425961,1.442581660763479,3159,1814,4973,+
chr1,15425962,1.006119801228856,3573,2753,6326,+
chr1,15425964,1.006119801228856,3573,2753,6326,+
chr1,15427156,1.9087621239519972,1365,868,2233,+
chr1,15427162,0.7005128295970877,1437,888,2325,+
chr1,15427189,1.4458007303077725,2027,1277,3304,+
chr1,15427192,1.7043625937336324,5119,3124,8243,+
chr1,15427227,1.3519971709103928,6920,4342,11262,+
chr1,15427228,1.3748315237731878,6624,3956,10580,+
chr1,15427236,1.5336239574603967,4270,2521,6791,+
chr1,15427240,2.134637212957304,1527,880,2407,+
chr1,15427260,0.7296163069544364,2433,1535,3968,+
chr1,15427263,1.034817528416783,7106,4623,11729,+
chr1,15427266,1.3615950927173601,8143,5380,13523,+
chr1,15427269,1.3782243014546105,2343,1533,3876,+
chr1,15427270,1.5896406330920412,8295,5551,13846,+
chr1,15428796,1.5033968880122723,839,701,1540,+
chr1,15428797,1.6651658999706374,962,600,1562,+
chr1,15428992,1.8334410434052288,982,675,1657,+
chr1,15429185,1.0580975994590331,568,466,1034,+
chr1,15429187,1.5476796277874594,1491,1111,2602,+
chr1,15429188,2.7089947089947093,575,485,1060,+
chr1,15429190,1.1659252572120151,1435,987,2422,+
chr1,15429192,1.9619783306581056,953,622,1575,+
chr1,15429230,1.2858218231004224,2694,1942,4636,+
chr1,15429231,0.977115916406002,2292,1633,3925,+
chr1,15429294,1.503761203585147,873,567,1440,+
chr1,15429342,11.20452872820093,1841,1282,3123,+
chr1,15429464,2.1977331875568584,1027,589,1616,+
chr1,15429510,1.879639175257732,662,581,1243,+
chr1,15429523,0.6616915422885572,797,602,1399,+
chr1,15429566,7.5377620951908915,2082,1811,3893,+
chr1,15429567,6.315586768679452,3528,3090,6618,+
chr1,15429570,1.1287842569541429,7684,7849,15533,+
chr1,15429571,0.9409360767333554,6981,7272,14253,+
chr1,15429572,0.9756626953089708,9471,9352,18823,+
chr1,15429573,0.6269916502346721,5242,4802,10044,+
chr1,15429804,1.701184668989547,717,573,1290,+
chr1,15429807,1.1053755140818804,1351,872,2223,+
chr1,15429852,1.5687182903705217,1843,1234,3077,+
chr1,15429853,1.5687182903705217,1843,1234,3077,+
chr1,15429860,1.901433691756272,1060,827,1887,+
chr1,15429863,1.9387964674471143,943,540,1483,+
chr1,15429987,1.417449913430621,1697,1243,2940,+
chr1,15430093,1.4339253646896752,1596,1377,2973,+
chr1,15571306,2.8155041814218458,630,407,1037,+
chr1,15828241,0.8179979777553085,808,601,1409,+
chr1,15828242,0.8179979777553085,808,601,1409,+
chr1,15828246,0.9441804905935018,1644,1463,3107,+
chr1,15828248,1.096903248676981,1082,1081,2163,+
chr1,15828250,1.5568057421611228,1165,912,2077,+
chr1,15828257,1.4872730675650383,690,547,1237,+
chr1,15828270,0.4515129711795979,1652,1613,3265,+
chr1,15828271,0.6735821957842477,3236,2841,6077,+
chr1,15828272,1.0558814822884366,3313,2412,5725,+
chr1,15828376,1.3900202186646007,668,482,1150,+
chr1,16395395,16.269258519258518,1281,204,1485,+
chr1,16395397,17.524029077719888,1388,199,1587,+
chr1,16395398,17.166666666666668,990,165,1155,+
chr1,16395402,14.355029083890225,971,215,1186,+
chr1,16395403,7.862068965517242,881,146,1027,+
chr1,16395413,37.25362294363296,2659,2158,4817,+
chr1,16395414,23.234722154375437,3553,3375,6928,+
chr1,16395415,18.535511166542353,4275,4332,8607,+
chr1,16395416,17.20560184817594,3393,3906,7299,+
chr1,16395417,12.30071533534789,2150,2544,4694,+
chr1,16396053,2.9919790934195163,825,664,1489,+
chr1,16396055,2.5977229601518026,739,679,1418,+
chr1,16396056,1.8174659997163014,1065,1016,2081,+
chr1,16396058,2.0953406370159864,1089,1057,2146,+
chr1,16396059,2.1098706176961604,553,598,1151,+
chr1,16396270,2.1075290133942666,572,460,1032,+
chr1,16396305,3.5832062075922892,548,481,1029,+
chr1,16397386,87.99846743295019,856,260,1116,+
chr1,16397387,92.86007135899014,1321,588,1909,+
chr1,16397388,82.74082956214598,1474,724,2198,+
chr1,16397436,8.117246069138739,1490,1980,3470,+
chr1,16397437,8.978823814455426,1979,2474,4453,+
chr1,16397438,8.978823814455426,1979,2474,4453,+
chr1,16727280,1.1764764764764766,965,809,1774,+
chr1,16727340,0.8917034823997873,3081,2266,5347,+
chr1,19257481,11.744100578805773,1333,1162,2495,+
chr1,19257482,10.303203146410302,1229,1050,2279,+
chr1,19257850,0.32275404725759904,676,658,1334,+
chr1,19258770,1.8395169582894,648,466,1114,+
chr1,19258814,3.372856939095707,768,462,1230,+
chr1,19259336,28.885104493592664,1182,618,1800,+
chr1,19597040,4.137653422649322,4895,5721,10616,+
chr1,19597041,4.137653422649322,4895,5721,10616,+
chr1,19597042,4.137653422649322,4895,5721,10616,+
chr1,19597045,0.44411728622254937,723,1044,1767,+
chr1,19597051,0.40379990379990377,802,1088,1890,+
chr1,19608103,1.4247122372282253,891,798,1689,+
chr1,19608104,1.377520557564317,774,689,1463,+
chr1,19608390,2.0018817755386213,595,559,1154,+
chr1,19608568,0.6749216996036475,1570,992,2562,+
chr1,19608570,0.6749216996036475,1570,992,2562,+
chr1,19608578,0.6671361502347418,2302,1419,3721,+
chr1,19608579,0.6671361502347418,2302,1419,3721,+
chr1,19622117,0.5518877438017201,1164,1013,2177,+
chr1,19623477,0.6545209176788125,969,831,1800,+
chr1,19626410,1.5294927888510776,877,560,1437,+
chr1,19655093,2.4412861736334412,1025,621,1646,+
chr1,19655094,2.4412861736334412,1025,621,1646,+
chr1,19655099,1.5071669627701165,1003,730,1733,+
chr1,19655115,2.324615255235052,1083,1080,2163,+
chr1,19655116,2.3143332781666492,1685,1740,3425,+
chr1,19655118,2.1541852960583685,1901,1805,3706,+
chr1,19657216,0.5233065624135654,1184,648,1832,+
chr1,19657217,0.6078842972056644,1126,547,1673,+
chr1,19657234,0.4072174390914087,740,308,1048,+
chr1,20649028,2.772099748124537,661,372,1033,+
chr1,20651080,1.521805641745223,571,486,1057,+
chr1,22078429,1.9754743352134607,1015,529,1544,+
chr1,22078431,1.9271317829457366,790,386,1176,+
chr1,22086485,0.4931581828133552,847,503,1350,+
chr1,22086487,0.6408644959476753,938,540,1478,+
chr1,22086488,0.9015047879616964,658,373,1031,+
chr1,22086500,2.5509496602603017,596,438,1034,+
chr1,22086677,0.2799242424242424,738,439,1177,+
chr1,22092187,0.4030436357687321,928,630,1558,+
chr1,22092361,2.048690165757678,1034,703,1737,+
chr1,22092607,101.22843991191733,1269,80,1349,+
chr1,22092608,86.38659945873596,1508,99,1607,+
chr1,22092609,158.63636363636363,1046,65,1111,+
chr1,22092610,10.461658841940533,954,70,1024,+
chr1,22092611,25.912203834312418,1739,191,1930,+
chr1,22092612,29.645768025078368,1224,318,1542,+
chr1,22092613,11.746360595771051,2889,1793,4682,+
chr1,22092614,9.881755963003407,2717,2235,4952,+
chr1,22092615,7.2526983887858645,2987,2964,5951,+
chr1,22092617,2.637125699059205,990,1468,2458,+
chr1,22092622,0.19780155081100267,523,744,1267,+
chr1,22092635,8.393344252099181,2126,3322,5448,+
chr1,22092636,9.083203738803793,1934,2927,4861,+
chr1,22092647,3.742952903564686,613,1607,2220,+
chr1,22092648,4.3916233357503005,1284,2307,3591,+
chr1,22092655,0.4288682231895529,1019,1443,2462,+
chr1,22092657,0.37334638255740155,1295,2114,3409,+
chr1,23030611,3.2952657488824,663,405,1068,+
chr1,23050508,2.116503456221198,638,433,1071,+
chr1,23053777,1.6841491841491845,577,428,1005,+
chr1,23053785,1.7264683341461715,707,462,1169,+
chr1,23068557,1.7094792684629345,789,550,1339,+
chr1,23069065,2.3803063457330422,776,456,1232,+
chr1,23072149,1.735408560311284,668,513,1181,+
chr1,23079652,3.840502184054068,646,409,1055,+
chr1,23083221,2.0058009114957915,1021,703,1724,+
chr1,23083274,1.2844085884469225,809,585,1394,+
chr1,23083523,1.828978622327791,594,420,1014,+
chr1,23691803,1.1357396839332747,996,669,1665,+
chr1,23691805,0.8746164594771992,5331,2409,7740,+
chr1,23691806,0.860935317270008,4846,1736,6582,+
chr1,23691807,0.90514963992328,6252,2264,8516,+
chr1,23691808,1.4527522829641704,7993,3346,11339,+
chr1,23691809,1.2999722799590523,6113,2387,8500,+
chr1,23691810,1.8498265658461448,5531,2462,7993,+
chr1,23691814,1.6587641770359625,6740,3380,10120,+
chr1,23691815,1.6587641770359625,6740,3380,10120,+
chr1,23691816,1.451371693792759,10755,5765,16520,+
chr1,23691817,1.0695704144192004,3350,2310,5660,+
chr1,23691818,1.433654509517039,6244,3600,9844,+
chr1,23692609,1.2842244638480373,7737,5006,12743,+
chr1,23692610,1.320769475081611,15308,10335,25643,+
chr1,23692612,1.4228853845174998,16474,11237,27711,+
chr1,23692613,1.4962347997709646,10442,6845,17287,+
chr1,23692616,1.2982123081790855,3729,2149,5878,+
chr1,23692619,1.1652358487945012,4765,3584,8349,+
chr1,23692621,1.1826256564141036,3623,3099,6722,+
chr1,23692624,1.2059172691276934,4240,3606,7846,+
chr1,23692627,1.2666678867406418,14548,9826,24374,+
chr1,23692628,0.780692883895131,5321,4449,9770,+
chr1,23692642,1.485650039959599,9056,5566,14622,+
chr1,23692675,1.157311592609019,11656,7604,19260,+
chr1,23692691,0.8601159953182705,9622,7472,17094,+
chr1,23692731,1.2394485106141648,21701,14192,35893,+
chr1,23692738,1.5252481301395597,22141,14850,36991,+
chr1,23693807,1.2427048923834734,38661,26826,65487,+
chr1,23693808,1.2427048923834734,38661,26826,65487,+
chr1,23693889,1.2100267295001648,23499,18876,42375,+
chr1,23693896,1.2205554519944726,11366,9348,20714,+
chr1,23694739,1.1423167526885194,12613,10635,23248,+
chr1,23694746,1.33426943276435,17636,11837,29473,+
chr1,23694771,1.252801216017167,11736,9238,20974,+
chr1,23696345,1.6935688543728749,6672,4377,11049,+
chr1,23760606,2.9511735480555084,637,448,1085,+
chr1,23760608,2.9511735480555084,637,448,1085,+
chr1,23795142,0.7582389429267553,660,420,1080,+
chr1,23962046,3.0457059300402647,743,477,1220,+
chr1,24672201,2.6395199501399857,672,382,1054,+
chr1,24839938,1.8978812801038945,1328,1037,2365,+
chr1,24840780,1.9251778557183177,1106,702,1808,+
chr1,24840794,0.5769956002514143,647,515,1162,+
chr1,24840798,1.990430622009569,639,417,1056,+
chr1,24841124,2.0778816199376946,666,427,1093,+
chr1,24841366,1.7793139428720492,1076,696,1772,+
chr1,24841568,1.7962906658558833,843,505,1348,+
chr1,24841595,2.0762929649855444,833,565,1398,+
chr1,24841673,0.4821247892074199,952,592,1544,+
chr1,24841982,2.1027088036117383,620,442,1062,+
chr1,24842138,0.9478227889373949,1614,1219,2833,+
chr1,24842461,2.014438635797859,951,617,1568,+
chr1,24842474,1.4355492196878752,1082,713,1795,+
chr1,24842926,1.122591151026518,1415,978,2393,+
chr1,24842991,9.413220898165612,5030,3847,8877,+
chr1,24842992,8.008257842563715,5563,4369,9932,+
chr1,24842994,4.832876107589948,1056,1022,2078,+
chr1,24843181,2.3460451977401133,754,589,1343,+
chr1,24843221,1.6859035004730367,890,603,1493,+
chr1,24843292,4.041033925686591,757,618,1375,+
chr1,24843319,1.916841579210395,891,666,1557,+
chr1,24843415,2.124811463046757,965,611,1576,+
chr1,24843976,1.711549295774648,587,425,1012,+
chr1,24844044,1.9351083591331268,600,474,1074,+
chr1,25352928,0.38698022312373226,554,492,1046,+
chr1,25352929,0.38698022312373226,554,492,1046,+
chr1,25360713,0.3855897753354658,767,527,1294,+
chr1,25360877,0.6764069264069263,999,703,1702,+
chr1,26475259,0.6060468631897203,843,539,1382,+
chr1,26863148,0.7798261923483665,2509,1318,3827,+
chr1,26863150,0.7955568804694345,2150,1088,3238,+
chr1,26863224,0.44121405859379303,690,462,1152,+
chr1,26863228,2.25169755171605,875,551,1426,+
chr1,26863285,0.851037851037851,696,524,1220,+
chr1,26863287,1.4234789418871452,1838,1383,3221,+
chr1,26863288,0.9838441793749056,723,536,1259,+
chr1,26863573,3.2236923629108523,746,479,1225,+
chr1,26863800,0.49056603773584906,731,365,1096,+
chr1,26863826,1.519416153804259,753,426,1179,+
chr1,26864381,1.4179549570278402,721,544,1265,+
chr1,26941464,1.368979230194569,1054,746,1800,+
chr1,26941544,1.5804697694649847,675,417,1092,+
chr1,26941551,0.5736813485589994,843,612,1455,+
chr1,26941559,9.327927927927927,834,554,1388,+
chr1,26941766,1.9757991304167941,696,488,1184,+
chr1,26941780,2.2556174174739025,645,384,1029,+
chr1,26942957,2.508521930092112,584,430,1014,+
chr1,26942963,5.96772251990151,612,494,1106,+
chr1,26945438,6.2502628454378195,582,484,1066,+
chr1,26946175,1.7769786610401346,1128,755,1883,+
chr1,27206975,1.0360604193329226,647,433,1080,+
chr1,27207014,0.8541389651605307,1250,964,2214,+
chr1,27207016,1.5051231470758406,2142,1666,3808,+
chr1,27207017,1.1728546840422915,1589,1273,2862,+
chr1,27207018,1.9591994692613885,1221,951,2172,+
chr1,27207019,1.6085209236077933,2653,2183,4836,+
chr1,27207020,1.4430986545652105,1277,1078,2355,+
chr1,27207030,1.397458711370418,2192,1770,3962,+
chr1,27207031,0.5859329587289285,1007,793,1800,+
chr1,27207032,1.0741926874833199,1609,1248,2857,+
chr1,27207033,2.53776397515528,658,643,1301,+
chr1,27207035,1.4455018398680368,1957,1561,3518,+
chr1,27207036,1.4455018398680368,1957,1561,3518,+
chr1,27207037,1.4439041283904,2202,1937,4139,+
chr1,27207265,2.3193725837870542,1212,780,1992,+
chr1,27207269,1.7983254269534785,1178,906,2084,+
chr1,27207272,2.0237806357680177,694,633,1327,+
chr1,27207273,1.6672004880652789,642,422,1064,+
chr1,27207276,1.3870696893366916,825,793,1618,+
chr1,27207327,1.4438037611738908,1984,1231,3215,+
chr1,27207329,0.5989503528985944,1575,1506,3081,+
chr1,27325449,2.1517822093498995,1428,1405,2833,+
chr1,27325450,2.485652797704448,494,696,1190,+
chr1,27838757,2.146384604499788,1318,763,2081,+
chr1,27838759,2.146384604499788,1318,763,2081,+
chr1,27838764,1.5897711015736768,761,465,1226,+
chr1,27838765,1.6181752873563215,900,575,1475,+
chr1,27850503,17.792117063855006,1333,1361,2694,+
chr1,27850504,17.442381936761507,1520,1710,3230,+
chr1,27850505,17.442381936761507,1520,1710,3230,+
chr1,27850509,0.36566980796663157,465,639,1104,+
chr1,27850582,0.4187357104654342,458,552,1010,+
chr1,28236130,2.1601284729899692,700,351,1051,+
chr1,28236134,3.6870917955083438,884,518,1402,+
chr1,28236153,1.4266207106824633,819,629,1448,+
chr1,28236170,1.5548851813088715,573,438,1011,+
chr1,28236176,1.9762769100886448,866,514,1380,+
chr1,28236181,4.726822157434402,522,489,1011,+
chr1,28236363,1.8204653622422,1052,805,1857,+
chr1,28236364,1.8204653622422,1052,805,1857,+
chr1,28236388,2.0915398230088496,952,564,1516,+
chr1,28236414,1.5290466581055464,1162,710,1872,+
chr1,28236422,1.4425180101539141,1306,1016,2322,+
chr1,28237846,1.3253359548918606,1874,1557,3431,+
chr1,28237848,1.8375781948168008,1409,1118,2527,+
chr1,28237865,1.3401486988847584,2225,1613,3838,+
chr1,28237868,1.3959502806736168,2320,1633,3953,+
chr1,28237869,0.6800551152782923,5256,4177,9433,+
chr1,28237900,1.7091563833505912,2233,2076,4309,+
chr1,28237907,1.6156018729230444,2123,2082,4205,+
chr1,28272437,4.2953846153846165,697,324,1021,+
chr1,28272438,4.367168489793818,1029,560,1589,+
chr1,28506043,1.6871885069817396,597,653,1250,+
chr1,28506044,2.615102850896514,571,455,1026,+
chr1,28506050,1.2879641612771062,865,629,1494,+
chr1,28506055,1.421957786849648,1818,1190,3008,+
chr1,28506056,1.421957786849648,1818,1190,3008,+
chr1,28507529,1.5429040625617727,693,636,1329,+
chr1,28507530,0.7076918391277202,627,412,1039,+
chr1,28507531,1.0505904888928206,970,846,1816,+
chr1,28507532,0.9800202951017498,802,707,1509,+
chr1,28507533,0.6564744467970274,1374,867,2241,+
chr1,28508128,2.6762471395881007,885,574,1459,+
chr1,28508130,2.6762471395881007,885,574,1459,+
chr1,28508721,0.8619908479644767,1503,992,2495,+
chr1,28508722,0.8619908479644767,1503,992,2495,+
chr1,28508723,0.8619908479644767,1503,992,2495,+
chr1,28509019,0.3182161234991424,772,582,1354,+
chr1,28509076,2.113256556574402,1168,956,2124,+
chr1,28509082,1.655013192612137,964,757,1721,+
chr1,28509083,2.348314491413391,933,731,1664,+
chr1,28509105,0.6749317881353548,1296,973,2269,+
chr1,28509113,1.4233646652599272,1589,1202,2791,+
chr1,28509310,2.2857142857142865,611,458,1069,+
chr1,28509344,0.6886024412099486,1778,1446,3224,+
chr1,28509345,0.9806451612903225,607,439,1046,+
chr1,28509346,0.5663860790832567,941,843,1784,+
chr1,28509411,1.7318122555410689,717,589,1306,+
chr1,28509494,1.707598421559634,2189,1609,3798,+
chr1,28509502,0.7398288770053476,1133,849,1982,+
chr1,28509506,0.4146861486823604,6304,3956,10260,+
chr1,28509507,0.4392367386999362,8022,4829,12851,+
chr1,28509508,0.5162202600857101,3070,1615,4685,+
chr1,28509509,0.588646027835747,2500,1261,3761,+
chr1,28535900,2.3973676427092574,753,482,1235,+
chr1,28535902,2.3973676427092574,753,482,1235,+
chr1,28537920,0.376149402410262,566,462,1028,+
chr1,28538078,1.4665094263604432,665,447,1112,+
chr1,28538224,7.337579168920783,3947,2890,6837,+
chr1,28538225,7.337579168920783,3947,2890,6837,+
chr1,28538226,7.337579168920782,3947,2890,6837,+
chr1,28538387,2.0303518613846605,611,497,1108,+
chr1,28538759,7.878603111270306,1381,217,1598,+
chr1,28538761,9.28134758067746,989,118,1107,+
chr1,28538764,10.774391238011262,1391,249,1640,+
chr1,28538765,10.774391238011262,1391,249,1640,+
chr1,28538768,5.967693234895118,1211,268,1479,+
chr1,28538770,6.973995271867612,1179,281,1460,+
chr1,28538771,8.215481789008553,2026,638,2664,+
chr1,28538772,8.065343355243694,1956,675,2631,+
chr1,28538813,8.708758563651786,3894,1220,5114,+
chr1,28538814,9.536562661971937,4449,1502,5951,+
chr1,28538815,8.899315029722189,5138,1722,6860,+
chr1,28538816,11.239130800140208,1882,883,2765,+
chr1,28538817,5.393632677087764,1595,530,2125,+
chr1,28538822,9.525316455696204,902,236,1138,+
chr1,28538823,8.61116020072179,1761,658,2419,+
chr1,28538826,20.29582687811901,2624,1817,4441,+
chr1,28538827,20.295826878119012,2624,1817,4441,+
chr1,28538842,10.789165931435988,2406,2819,5225,+
chr1,28538843,10.789165931435987,2406,2819,5225,+
chr1,28648664,1.7821311066689287,968,607,1575,+
chr1,28769628,4.812425328554362,1367,836,2203,+
chr1,28769629,4.812425328554362,1367,836,2203,+
chr1,28769630,3.6984627973775943,2759,1708,4467,+
chr1,28769632,4.543408360128617,941,621,1562,+
chr1,28769684,1.7120390455531451,615,460,1075,+
chr1,28769697,2.4520509193776516,984,706,1690,+
chr1,28769699,2.4520509193776516,984,706,1690,+
chr1,28769716,5.547169811320754,587,529,1116,+
chr1,31297031,0.8419320949617601,1048,619,1667,+
chr1,31348946,1.6881139278514137,1388,1226,2614,+
chr1,31348947,1.6881139278514137,1388,1226,2614,+
chr1,32030312,2.5606349206349206,653,449,1102,+
chr1,32030313,2.5606349206349206,653,449,1102,+
chr1,32031588,1.9375162043038632,1973,1861,3834,+
chr1,32031589,2.356861263510628,3041,2993,6034,+
chr1,32031591,2.0029466053160263,4345,4358,8703,+
chr1,32031593,2.3095635709329536,3356,3696,7052,+
chr1,32031595,2.131145656539702,3488,3996,7484,+
chr1,32031596,1.606323823080891,5042,5429,10471,+
chr1,32031602,1.316750065439801,4251,4672,8923,+
chr1,32042622,0.5602968460111317,603,461,1064,+
chr1,32042976,2.6133540372670807,560,505,1065,+
chr1,32042978,2.6133540372670807,560,505,1065,+
chr1,32043247,1.8567195767195763,848,566,1414,+
chr1,32043291,2.1507773540627757,610,486,1096,+
chr1,32043292,2.1507773540627757,610,486,1096,+
chr1,32043418,12.094335103963548,2190,1162,3352,+
chr1,32043420,8.463319456531114,1614,846,2460,+
chr1,32043423,12.184872732193945,3950,3395,7345,+
chr1,32043424,12.184872732193945,3950,3395,7345,+
chr1,32043440,0.5146045996802361,796,691,1487,+
chr1,32043716,2.881763527054108,718,498,1216,+
chr1,32154623,4.671690491245183,505,617,1122,+
chr1,32190094,1.4616174781475944,821,540,1361,+
chr1,32190096,2.3151601579640197,669,423,1092,+
chr1,32190097,1.6266946712618184,697,448,1145,+
chr1,32193241,1.4797326223842489,884,657,1541,+
chr1,32197654,1.9233443005175084,554,468,1022,+
chr1,32222544,3.387958532695375,585,417,1002,+
chr1,32222545,3.387958532695375,585,417,1002,+
chr1,32222578,1.526760018364103,1090,841,1931,+
chr1,32222586,2.2624964565813097,583,556,1139,+
chr1,32222609,2.0104416068103217,816,715,1531,+
chr1,32224417,1.986363636363636,645,439,1084,+
chr1,32226183,2.1922484599589325,656,486,1142,+
chr1,32226190,1.547818791946309,778,595,1373,+
chr1,32226193,2.5153970826580228,775,616,1391,+
chr1,32226196,1.3826690550828482,854,692,1546,+
chr1,32226516,1.5860566448801745,1175,713,1888,+
chr1,32228595,1.6716348824291798,1388,981,2369,+
chr1,32228794,1.6340636411058946,1252,1064,2316,+
chr1,32228805,1.5466730702060774,1416,817,2233,+
chr1,32228806,2.235317990832697,1356,1231,2587,+
chr1,32229148,1.8768614899670963,2766,1771,4537,+
chr1,32229153,1.118853360721947,7559,5987,13546,+
chr1,32229155,1.0594965335361086,6684,5266,11950,+
chr1,32229185,1.6063182745374156,8037,6459,14496,+
chr1,32229186,1.6864962425517502,10886,8858,19744,+
chr1,32229187,1.6864962425517502,10886,8858,19744,+
chr1,32229188,1.7139840902439671,8301,6833,15134,+
chr1,32229192,2.263514747756944,2987,2658,5645,+
chr1,32231140,2.106946470654248,750,468,1218,+
chr1,32231167,0.4924814611370502,754,661,1415,+
chr1,32231194,1.5922535211267606,832,709,1541,+
chr1,32231253,1.4570484739179752,2291,1655,3946,+
chr1,32231396,0.3357120695004654,1081,585,1666,+
chr1,32231398,0.4874588815789474,2370,1215,3585,+
chr1,32231399,0.5408114026947775,1859,928,2787,+
chr1,32231400,0.5538269505314162,2288,1294,3582,+
chr1,32231502,1.0054489973844811,1976,1479,3455,+
chr1,32231504,1.0054489973844811,1976,1479,3455,+
chr1,32231518,0.5302864725626414,646,556,1202,+
chr1,32324501,1.9382826032899405,1205,916,2121,+
chr1,32324502,2.943885390634504,888,619,1507,+
chr1,32329099,3.2001201923076934,638,383,1021,+
chr1,32329101,3.2001201923076934,638,383,1021,+
chr1,32331491,2.772854836208381,875,675,1550,+
chr1,32332158,56.49940006434588,1942,1577,3519,+
chr1,32332159,56.49940006434588,1942,1577,3519,+
chr1,32333041,3.393119610994265,606,396,1002,+
chr1,32333251,3.0091745693955136,577,454,1031,+
chr1,32333297,2.0605322338830585,732,463,1195,+
chr1,32333299,1.5033475235006675,1106,750,1856,+
chr1,32333530,2.0434753925319957,884,582,1466,+
chr1,32333531,2.40942064819847,1143,802,1945,+
chr1,32668290,6.525879917184263,787,482,1269,+
chr1,32668291,3.902308375777123,1760,1194,2954,+
chr1,32668316,3.3103316326530616,632,489,1121,+
chr1,32668746,2.7022544700699656,631,453,1084,+
chr1,32668748,2.770764079654222,973,620,1593,+
chr1,32669060,2.513044016915133,910,727,1637,+
chr1,32679651,1.3741895001045807,875,682,1557,+
chr1,32679653,1.3741895001045807,875,682,1557,+
chr1,32679885,1.9681748774411318,789,540,1329,+
chr1,32680561,2.0243076204094277,599,530,1129,+
chr1,32686062,3.1160572337042924,489,628,1117,+
chr1,32686063,3.1160572337042924,489,628,1117,+
chr1,32774719,5.548975649529063,618,491,1109,+
chr1,35351236,1.024363159022012,15786,8662,24448,+
chr1,35351237,0.9754758854115909,22094,12175,34269,+
chr1,35351238,0.9431228092856296,3705,2528,6233,+
chr1,35351239,0.9824308893614401,8577,4915,13492,+
chr1,35351240,0.9445979598727144,8483,5420,13903,+
chr1,35351356,0.9494063711055842,1988,1663,3651,+
chr1,35351357,0.9808661926308984,1123,1019,2142,+
chr1,35351358,1.1561568929860844,743,606,1349,+
chr1,35351359,0.9225613336634354,1598,1377,2975,+
chr1,35351362,0.7273327464788731,660,567,1227,+
chr1,35359084,5.982870842725315,610,406,1016,+
chr1,35420039,3.4438775510204085,599,447,1046,+
chr1,35420041,3.4438775510204085,599,447,1046,+
chr1,36092064,0.9750346740638002,591,411,1002,+
chr1,36092065,0.9750346740638002,591,411,1002,+
chr1,36178957,2.8597443336962507,636,473,1109,+
chr1,36178977,1.8708440185606832,2086,1358,3444,+
chr1,36178978,1.756795016987542,1240,882,2122,+
chr1,36178984,2.0028687328822334,1442,1115,2557,+
chr1,36292687,3.1408059293511887,727,502,1229,+
chr1,36296624,2.2830882352941178,647,407,1054,+
chr1,36296625,2.182633317602643,924,488,1412,+
chr1,36296627,2.182633317602643,924,488,1412,+
chr1,36296639,1.6410256410256407,831,506,1337,+
chr1,36296723,2.448869752421959,1299,928,2227,+
chr1,36300928,1.534970085505601,993,757,1750,+
chr1,36300936,2.0028446265005404,676,566,1242,+
chr1,36304294,39.51892511462048,1134,74,1208,+
chr1,36304296,29.083462547419128,2167,146,2313,+
chr1,36304297,21.8133113584664,1811,124,1935,+
chr1,36304300,13.023006386114295,1455,121,1576,+
chr1,36304301,11.836808012258576,1501,126,1627,+
chr1,36304302,11.836808012258576,1501,126,1627,+
chr1,36304311,19.492910119654077,988,1284,2272,+
chr1,36304341,0.25160638423174514,354,685,1039,+
chr1,36304628,2.3103738224412145,557,457,1014,+
chr1,37809149,0.5976926295657449,969,684,1653,+
chr1,37809227,0.23913536128207777,550,476,1026,+
chr1,38018507,0.5730978260869566,702,399,1101,+
chr1,38019262,4.199511599511601,592,454,1046,+
chr1,38019264,4.199511599511601,592,454,1046,+
chr1,38023554,1.661052062691407,682,426,1108,+
chr1,38023568,2.0324504070634104,708,458,1166,+
chr1,38023705,2.1739130434782608,699,459,1158,+
chr1,39026324,0.8021677273110008,1448,487,1935,+
chr1,39026326,0.7875280059746079,1025,308,1333,+
chr1,39026337,1.4060993477305812,1371,560,1931,+
chr1,39026345,1.3060030643798828,4969,3457,8426,+
chr1,39026348,1.3225552050473186,1286,950,2236,+
chr1,39026349,0.7505992873339812,2464,2099,4563,+
chr1,39026358,0.7842312611662623,9964,7813,17777,+
chr1,39026359,0.891556361855039,12452,9080,21532,+
chr1,39026360,0.7842312611662623,9964,7813,17777,+
chr1,39026370,0.7620870193849163,16767,10555,27322,+
chr1,39026371,0.7237626421910207,15406,10596,26002,+
chr1,39026372,0.9827737162649808,3468,2148,5616,+
chr1,39026373,0.7202560455192034,16877,11399,28276,+
chr1,39026374,0.9873916801345686,35110,20223,55333,+
chr1,39026375,1.2591193920209427,15690,7374,23064,+
chr1,39026376,0.9487911392876721,37467,21425,58892,+
chr1,39026377,0.7631044202734315,20005,13130,33135,+
chr1,39028724,1.0335722104470892,19967,12614,32581,+
chr1,39028778,1.6066814107787222,1925,1561,3486,+
chr1,39028805,1.3439723119919313,6431,4636,11067,+
chr1,39034406,0.6345733539750479,1466,1111,2577,+
chr1,39034432,1.8519792370020256,2221,1480,3701,+
chr1,39034524,1.6606438896189224,1010,760,1770,+
chr1,39447518,2.75103734439834,662,481,1143,+
chr1,39447519,2.170774661192426,865,619,1484,+
chr1,39460695,2.7375487900078066,796,609,1405,+
chr1,39460696,1.4547817047817049,1243,961,2204,+
chr1,39460698,1.2032992930086408,850,669,1519,+
chr1,39463621,1.4002179083955903,844,550,1394,+
chr1,39740188,0.4921564295183384,809,583,1392,+
chr1,39740189,0.4921564295183384,809,583,1392,+
chr1,39740192,1.391336119967054,709,554,1263,+
chr1,39741384,1.7723924922784509,745,548,1293,+
chr1,39743272,0.344908082871316,787,595,1382,+
chr1,39745389,1.9452289376639893,1712,1288,3000,+
chr1,39745390,1.3922835266565057,1502,1020,2522,+
chr1,39748929,0.941608984541248,1193,795,1988,+
chr1,39752912,2.242742857142857,668,524,1192,+
chr1,39752913,2.358403770181968,1043,830,1873,+
chr1,39753317,2.871352899383991,721,522,1243,+
chr1,39753396,1.8168372738218526,755,602,1357,+
chr1,40040752,1.994056706937613,727,484,1211,+
chr1,40040759,0.7151473387876981,1570,929,2499,+
chr1,40040760,1.623749384943415,659,468,1127,+
chr1,40040767,1.846724962877413,1065,637,1702,+
chr1,40059335,2.219503151649981,1167,695,1862,+
chr1,40059337,2.219503151649981,1167,695,1862,+
chr1,40059372,1.6328802588996765,741,514,1255,+
chr1,40059373,1.0276829162123067,1718,1032,2750,+
chr1,40059412,2.070847661153867,1083,590,1673,+
chr1,40059417,1.7825713368770228,2340,1464,3804,+
chr1,40059444,1.7554479418886202,1507,825,2332,+
chr1,40060079,1.6642865881463191,3963,2192,6155,+
chr1,40060081,1.4006863351304237,7635,4638,12273,+
chr1,40060091,1.4947615921263586,9941,6915,16856,+
chr1,40060092,1.5774947789835854,6983,4978,11961,+
chr1,40060093,1.545476134928541,15925,10641,26566,+
chr1,40060095,1.6464138790330676,13962,9467,23429,+
chr1,40060097,2.0176675318546486,5104,3911,9015,+
chr1,40060102,1.9426686450552857,3798,2338,6136,+
chr1,40061736,0.8402554522547572,920,676,1596,+
chr1,40061737,0.8402554522547572,920,676,1596,+
chr1,40061758,2.200443637830208,681,521,1202,+
chr1,40061787,1.9050564403896704,1055,668,1723,+
chr1,40061791,1.343181596329678,1031,841,1872,+
chr1,40061796,1.8266200181971066,3170,2699,5869,+
chr1,40061798,1.908595194085028,3087,2704,5791,+
chr1,40061799,1.7781020454158676,3234,2957,6191,+
chr1,40061801,2.1364939353190664,3511,2962,6473,+
chr1,40064340,1.7326923076923078,900,649,1549,+
chr1,40064501,0.6119733924611974,781,560,1341,+
chr1,40066214,1.6213308388154462,624,392,1016,+
chr1,40066216,2.593642437740433,853,448,1301,+
chr1,40066225,2.53023589658647,779,492,1271,+
chr1,40066228,2.8057046864005617,970,627,1597,+
chr1,40066245,1.6218199608610566,662,437,1099,+
chr1,40066250,0.3217028746982664,732,464,1196,+
chr1,40069693,1.4303858520900323,860,621,1481,+
chr1,40069695,1.60588527159533,1082,764,1846,+
chr1,40070158,0.5027685137515326,797,531,1328,+
chr1,40070165,2.6884429065743944,606,424,1030,+
chr1,40070222,2.082092555331992,596,496,1092,+
chr1,40070437,1.7492849148115903,540,472,1012,+
chr1,40070441,2.5248091603053435,566,523,1089,+
chr1,40070866,1.98986131064549,1128,715,1843,+
chr1,40070887,2.3746350009733312,786,466,1252,+
chr1,40070899,1.7629702483403,955,580,1535,+
chr1,40071494,2.3918367346938774,585,454,1039,+
chr1,40071605,0.41860465116279066,557,464,1021,+
chr1,40071675,0.3392360305499265,930,504,1434,+
chr1,40071731,1.7444866920152091,1146,525,1671,+
chr1,40071750,2.023656803917511,792,536,1328,+
chr1,40071787,1.5339616762735633,1256,785,2041,+
chr1,40071812,1.4047975806837851,2598,1418,4016,+
chr1,40071834,0.6954027539457741,10348,6056,16404,+
chr1,40071846,1.6033191661606963,3028,2195,5223,+
chr1,40071943,1.7645089285714286,917,575,1492,+
chr1,40072025,1.545961369622476,818,669,1487,+
chr1,40072027,2.4319363719791993,635,466,1101,+
chr1,40072061,1.4978881904951944,1125,770,1895,+
chr1,40072388,0.6356102003642987,996,731,1727,+
chr1,40072450,1.6285385221555433,1413,1052,2465,+
chr1,40072457,0.5292078203220133,1078,777,1855,+
chr1,40258359,2.3242085756461646,690,541,1231,+
chr1,40281347,1.47001212537082,923,579,1502,+
chr1,40292688,3.0042657076561183,674,494,1168,+
chr1,40984928,0.957664025130292,705,482,1187,+
chr1,40984929,0.957664025130292,705,482,1187,+
chr1,40995961,4.087927735504827,604,441,1045,+
chr1,40995980,4.434962916108511,669,497,1166,+
chr1,41001033,1.5351410197949167,994,749,1743,+
chr1,41012065,3.213019494017478,625,431,1056,+
chr1,41012327,3.533785317469939,818,580,1398,+
chr1,42457320,1.8524084778420042,1264,691,1955,+
chr1,42457321,1.8524084778420042,1264,691,1955,+
chr1,42457329,2.9542424788326427,712,426,1138,+
chr1,42459608,1.8683435967018054,1516,870,2386,+
chr1,42459609,1.8683435967018054,1516,870,2386,+
chr1,42459611,1.8715763846622036,1024,741,1765,+
chr1,42459622,2.0567307692307693,712,389,1101,+
chr1,42459640,2.156295782249981,1189,785,1974,+
chr1,42459645,1.7490494296577948,2644,1840,4484,+
chr1,42459646,1.676525867689849,3792,2523,6315,+
chr1,42459670,0.5856044723969251,1675,953,2628,+
chr1,42459671,1.7241516966067865,1850,1502,3352,+
chr1,42459675,1.8683168316831686,1886,1110,2996,+
chr1,42658459,0.45225190045013713,1251,670,1921,+
chr1,42658483,3.263888888888889,704,395,1099,+
chr1,42666016,0.807667389129745,936,545,1481,+
chr1,42666017,0.8624331660242115,769,473,1242,+
chr1,42682498,1.4441404534940692,1464,1116,2580,+
chr1,42696226,1.910635619886721,758,453,1211,+
chr1,42696262,2.337274896940768,694,418,1112,+
chr1,42696682,1.2808042581429948,2917,2171,5088,+
chr1,42696687,1.6161774982529702,1594,1059,2653,+
chr1,42696692,0.5716312056737589,1053,798,1851,+
chr1,42696699,1.3901112446457735,2173,1491,3664,+
chr1,42696717,1.0261116640213315,6391,4925,11316,+
chr1,42696733,1.2850120736991828,3963,3358,7321,+
chr1,42700786,2.0582258637136204,1211,757,1968,+
chr1,42700843,1.8446348343955696,1176,562,1738,+
chr1,42700855,1.5847929936305731,1326,627,1953,+
chr1,42700867,1.6810506566604129,895,558,1453,+
chr1,42700895,2.18743447656133,748,606,1354,+
chr1,42700963,1.6598033373063172,1050,838,1888,+
chr1,42701995,1.4565804887861324,2782,1302,4084,+
chr1,42701996,1.2883932673432734,2409,1040,3449,+
chr1,42701997,1.1193556208218574,2930,1412,4342,+
chr1,42702000,1.9440470801267544,975,469,1444,+
chr1,42702001,0.4549878345498783,747,547,1294,+
chr1,42702002,1.9081439393939397,584,431,1015,+
chr1,42702007,0.6667714061272584,1060,759,1819,+
chr1,42702008,1.5612315270935957,772,579,1351,+
chr1,42702014,1.4311693127043517,1732,898,2630,+
chr1,42702017,2.3263593004769474,870,628,1498,+
chr1,42702021,1.3157243857479524,4698,2520,7218,+
chr1,42702022,1.3157243857479524,4698,2520,7218,+
chr1,42702026,1.5213701483872069,2071,1445,3516,+
chr1,42702031,1.444138700738916,3262,1791,5053,+
chr1,42702034,1.5492577597840758,1639,1234,2873,+
chr1,43359542,1.8148539816348028,647,375,1022,+
chr1,43359543,2.2060934105631276,1051,633,1684,+
chr1,43360056,1.6212100135211345,1172,751,1923,+
chr1,43360195,2.2268028196547878,598,412,1010,+
chr1,43360222,1.1035525321239608,583,440,1023,+
chr1,43360223,2.076550103502335,954,737,1691,+
chr1,43360319,1.213330768490911,840,561,1401,+
chr1,43360320,1.4798244167814831,1199,819,2018,+
chr1,43360576,1.5297729437272682,707,499,1206,+
chr1,43360839,0.9617224880382776,669,417,1086,+
chr1,43360840,0.9617224880382776,669,417,1086,+
chr1,43360926,2.7471436395894266,593,464,1057,+
chr1,43622345,7.865486725663716,807,564,1371,+
chr1,43622346,19.053656465041076,1467,1087,2554,+
chr1,43622347,7.865486725663716,807,564,1371,+
chr1,43622358,2.000150713847692,995,830,1825,+
chr1,43622359,2.000150713847692,995,830,1825,+
chr1,43622722,14.049956378381392,1445,1101,2546,+
chr1,43622723,14.73160246723226,2566,2261,4827,+
chr1,43622724,14.670151615889688,2420,2170,4590,+
chr1,43623423,14.362037747735922,727,476,1203,+
chr1,43623424,12.373601597104564,977,805,1782,+
chr1,43973083,3.083569016845268,870,648,1518,+
chr1,43975807,1.279291589918729,652,493,1145,+
chr1,44651042,6.576457457889305,997,97,1094,+
chr1,44651043,6.578589758672874,1201,121,1322,+
chr1,44651048,8.765368283459921,1847,270,2117,+
chr1,44651049,7.782404750895536,2268,356,2624,+
chr1,44651050,8.880591791526346,1587,246,1833,+
chr1,44651051,9.774589360355785,1443,279,1722,+
chr1,44651052,9.433925491756815,1034,211,1245,+
chr1,44651055,3.6659532173421443,2234,801,3035,+
chr1,44651056,3.6981566352139312,2811,1077,3888,+
chr1,44651057,3.698156635213931,2811,1077,3888,+
chr1,44651058,3.6295144188754693,1653,714,2367,+
chr1,44651067,62.31126156280631,1786,1142,2928,+
chr1,44651068,62.31126156280632,1786,1142,2928,+
chr1,44740979,4.1431658058456025,639,446,1085,+
chr1,44753141,1.3549741602067182,838,429,1267,+
chr1,44753142,1.692173040112809,1100,629,1729,+
chr1,44753145,4.980237154150197,881,482,1363,+
chr1,44753147,2.5078090138331097,1404,836,2240,+
chr1,44753149,2.27958510136728,966,605,1571,+
chr1,44753152,1.836278475622738,749,426,1175,+
chr1,44753157,1.7828542988839369,3460,2425,5885,+
chr1,44753159,1.636486573418951,3939,2739,6678,+
chr1,44753739,0.4052936311000828,734,557,1291,+
chr1,44753740,0.4052936311000828,734,557,1291,+
chr1,44767340,8.29796310330267,1036,722,1758,+
chr1,44775560,1.1547519889183557,748,408,1156,+
chr1,44775562,1.4118134038157737,790,623,1413,+
chr1,44775564,1.4118134038157737,790,623,1413,+
chr1,44775572,0.6536767168460011,3459,1402,4861,+
chr1,44775573,0.6335520643844281,5180,2501,7681,+
chr1,44775577,1.3950260806565802,14403,7856,22259,+
chr1,44775578,1.4001345768828901,13398,7211,20609,+
chr1,44776033,1.6778840939606356,13556,7217,20773,+
chr1,44776035,1.8427415130909097,16981,8576,25557,+
chr1,44776037,1.6282795636217968,18738,10046,28784,+
chr1,44776039,1.4623430464584748,16830,9867,26697,+
chr1,44776043,1.345425350869073,4129,3003,7132,+
chr1,44776044,1.4158317211920672,17605,11058,28663,+
chr1,44776045,1.4308369612165588,30440,19898,50338,+
chr1,44776047,1.3981729555316387,28853,18538,47391,+
chr1,44776048,1.3660638922296273,25261,16865,42126,+
chr1,44776053,1.8236501309353652,17134,15642,32776,+
chr1,44776054,1.8236501309353652,17134,15642,32776,+
chr1,44776080,1.2014932355785952,18354,12256,30610,+
chr1,44776672,1.1230469919185873,8337,4289,12626,+
chr1,44776674,1.1230469919185873,8337,4289,12626,+
chr1,44776690,1.602108870699722,24198,16395,40593,+
chr1,44776693,1.2674322229759754,17872,11066,28938,+
chr1,44776712,1.5247048142269646,28632,20496,49128,+
chr1,44776716,1.4088979183977854,12306,7528,19834,+
chr1,44776722,1.2318085309793008,49143,34294,83437,+
chr1,44776723,1.2318085309793008,49143,34294,83437,+
chr1,44777623,0.9019341959268004,13382,10332,23714,+
chr1,44777626,1.5110796423045656,11843,8473,20316,+
chr1,44777660,0.9354020422475784,61091,46738,107829,+
chr1,44777748,1.3737313270310836,18898,10238,29136,+
chr1,44778024,1.7770342800798014,27730,19923,47653,+
chr1,44778026,1.7770342800798014,27730,19923,47653,+
chr1,44778627,1.4058366330889964,8296,5745,14041,+
chr1,44778638,1.193360578355757,23464,17755,41219,+
chr1,44778654,1.040325591483102,42178,31016,73194,+
chr1,45012934,3.2308621866502802,790,582,1372,+
chr1,45013135,2.60976546918206,1472,781,2253,+
chr1,45013136,2.60976546918206,1472,781,2253,+
chr1,45013137,1.9644444444444444,1104,524,1628,+
chr1,45013635,8.090452261306533,699,397,1096,+
chr1,45013636,8.090452261306533,699,397,1096,+
chr1,45013921,0.8843594710688116,699,382,1081,+
chr1,45013922,0.8843594710688116,699,382,1081,+
chr1,45013983,3.416596656226533,845,600,1445,+
chr1,45014757,2.243649906196032,938,688,1626,+
chr1,45014758,2.3140572390572394,742,494,1236,+
chr1,45014825,1.7376303487943396,1560,821,2381,+
chr1,45014955,1.8569892387606588,929,484,1413,+
chr1,45014960,2.110268688480979,834,536,1370,+
chr1,45014961,2.0865175629250508,1279,838,2117,+
chr1,45014963,2.1130966553421433,2162,1225,3387,+
chr1,45014964,2.190513626834381,1285,635,1920,+
chr1,45014973,0.5343718311672373,1739,810,2549,+
chr1,45014974,3.051346801346801,579,431,1010,+
chr1,45015414,0.33112864955919524,629,462,1091,+
chr1,45015499,3.2662975531344887,507,508,1015,+
chr1,45015501,3.2662975531344887,507,508,1015,+
chr1,45327305,4.204353172628366,702,401,1103,+
chr1,45327941,2.179390094036974,681,464,1145,+
chr1,45328123,1.6543587932146144,640,562,1202,+
chr1,45328383,0.988663967611336,887,759,1646,+
chr1,45328384,0.988663967611336,887,759,1646,+
chr1,45551069,0.3039307880383675,605,408,1013,+
chr1,45551070,0.3039307880383675,605,408,1013,+
chr1,45551076,2.332613390928726,539,462,1001,+
chr1,45551077,2.332613390928726,539,462,1001,+
chr1,45566579,1.6820627802690584,604,445,1049,+
chr1,45566611,0.37491479209270623,659,488,1147,+
chr1,45567989,2.5636998254799304,790,572,1362,+
chr1,45567991,2.5636998254799304,790,572,1362,+
chr1,45568594,1.685219630848476,603,481,1084,+
chr1,45569170,1.629680054458816,797,564,1361,+
chr1,45569198,2.021280211908013,1177,874,2051,+
chr1,45584056,2.311934897963829,601,461,1062,+
chr1,45591225,2.112941176470588,897,524,1421,+
chr1,45602319,1.6215924426450743,750,493,1243,+
chr1,45606503,1.9961500815660684,926,612,1538,+
chr1,45606543,2.1045533642691407,630,430,1060,+
chr1,45613195,1.7063090418353577,594,455,1049,+
chr1,45613197,0.7198193503560882,1294,854,2148,+
chr1,45614120,2.143446180555556,580,511,1091,+
chr1,45615132,2.201460393553029,1726,1234,2960,+
chr1,45615354,1.9549644231654895,2049,1333,3382,+
chr1,45615355,2.000535495716034,1136,687,1823,+
chr1,45615358,2.124819624819625,664,440,1104,+
chr1,45615360,1.7993619283941864,845,545,1390,+
chr1,45615361,4.0114458845312235,661,456,1117,+
chr1,45616631,1.9066489361702132,1176,939,2115,+
chr1,45616633,1.9066489361702132,1176,939,2115,+
chr1,45618109,10.711174311128156,1804,1264,3068,+
chr1,45618111,3.2974177967676006,999,768,1767,+
chr1,45618113,2.758218576731547,965,753,1718,+
chr1,46303668,0.8458028806789892,1222,805,2027,+
chr1,46303669,0.977989823617281,1624,1338,2962,+
chr1,46303670,1.0685397077149654,647,678,1325,+
chr1,46303689,2.178903721682848,694,411,1105,+
chr1,46303690,0.7677800960084353,4154,3066,7220,+
chr1,46303692,0.7677800960084353,4154,3066,7220,+
chr1,46303696,1.1904461419405135,9165,6288,15453,+
chr1,46303698,1.039086859688196,3905,2879,6784,+
chr1,46303702,1.4457622852471952,8730,6120,14850,+
chr1,46303708,1.390477792732167,2203,1485,3688,+
chr1,46303743,0.7387502712085051,3016,2094,5110,+
chr1,46310156,1.1835345985737291,842,508,1350,+
chr1,46310160,0.9450351617440226,907,710,1617,+
chr1,46310161,0.8123985448538753,1517,1015,2532,+
chr1,46310166,1.8555395683453242,805,416,1221,+
chr1,46310172,1.0741771793000152,3699,2216,5915,+
chr1,46310173,1.2053811488476784,2979,1628,4607,+
chr1,46310174,1.2053811488476784,2979,1628,4607,+
chr1,46310188,0.681338028169014,1169,922,2091,+
chr1,46310194,1.2524661428074526,3169,2048,5217,+
chr1,46310195,0.7648482623569479,3688,2788,6476,+
chr1,46310196,0.7648482623569479,3688,2788,6476,+
chr1,46310198,1.6628237559042782,2475,1440,3915,+
chr1,46310201,1.4130527756393807,1651,1298,2949,+
chr1,46310205,1.741262946876044,2321,1844,4165,+
chr1,46310267,1.556020849898401,2121,1616,3737,+
chr1,47368468,2.409829280104462,765,462,1227,+
chr1,47368470,2.4397861779305083,742,484,1226,+
chr1,47368497,4.147438016528927,696,549,1245,+
chr1,47368499,4.147438016528927,696,549,1245,+
chr1,47372954,1.7312084612728842,1309,870,2179,+
chr1,47372978,1.8300224887556218,836,666,1502,+
chr1,47372979,2.296426479203281,895,568,1463,+
chr1,47375213,0.44824596505268777,610,440,1050,+
chr1,47377073,1.583488805970149,969,669,1638,+
chr1,47377582,1.7734979973297733,856,534,1390,+
chr1,47377917,2.455798106006337,847,618,1465,+
chr1,47378406,0.5056326451675289,746,480,1226,+
chr1,50973905,3.200345165480799,622,539,1161,+
chr1,51772118,1.0931100626157508,728,519,1247,+
chr1,51772119,1.1799312474838968,646,506,1152,+
chr1,51786549,1.9715639810426537,623,421,1044,+
chr1,51787740,1.8078488372093025,690,429,1119,+
chr1,51787745,2.2233124018838306,1029,545,1574,+
chr1,51787844,3.0456769676769238,753,578,1331,+
chr1,51787962,3.028037916092061,542,459,1001,+
chr1,52056335,1.4656501798476578,616,424,1040,+
chr1,52064878,0.43965364802595197,743,495,1238,+
chr1,52086737,1.9595566333213696,832,536,1368,+
chr1,52086797,2.2304147465437785,703,495,1198,+
chr1,52087049,1.495089477381253,619,421,1040,+
chr1,52088211,2.849390919158361,663,515,1178,+
chr1,52088212,2.849390919158361,663,515,1178,+
chr1,52414776,2.1083333333333334,758,479,1237,+
chr1,52415338,1.9950184745315391,1140,841,1981,+
chr1,52415340,1.9950184745315391,1140,841,1981,+
chr1,52415347,1.7965287584543521,2645,1831,4476,+
chr1,52415348,1.7694134815210512,2801,1837,4638,+
chr1,52417700,1.3293524336727411,935,455,1390,+
chr1,53014946,0.9710371558406843,678,644,1322,+
chr1,53014947,0.7000323426812881,2040,1597,3637,+
chr1,53027985,1.8509545753785388,780,489,1269,+
chr1,53028011,2.310696710696711,1631,1286,2917,+
chr1,53028013,2.310696710696711,1631,1286,2917,+
chr1,53050623,2.2872074894658536,732,544,1276,+
chr1,53051051,1.7126404094980803,729,540,1269,+
chr1,53967953,5.711016524299084,613,477,1090,+
chr1,53968045,2.721752849858497,682,619,1301,+
chr1,54200183,1.3422672549980934,783,632,1415,+
chr1,54200186,0.46296875475662613,1995,1068,3063,+
chr1,54200193,0.6736180072823569,2034,1006,3040,+
chr1,54200195,1.421931735657226,2224,2039,4263,+
chr1,54200196,1.2480174841467304,8493,6093,14586,+
chr1,54200198,1.2647241209576061,14091,9373,23464,+
chr1,54200199,1.304352293462241,7124,5239,12363,+
chr1,54200235,1.9454903363929172,646,411,1057,+
chr1,54200537,0.9646085920527016,887,750,1637,+
chr1,54200538,0.9646085920527016,887,750,1637,+
chr1,54200555,2.466531440162272,607,434,1041,+
chr1,54205053,1.7625144175317187,825,577,1402,+
chr1,54205146,1.661998132586368,889,594,1483,+
chr1,54205314,1.0732130996956306,2298,1772,4070,+
chr1,54205315,1.0732130996956306,2298,1772,4070,+
chr1,54205335,1.8958635703918725,949,635,1584,+
chr1,54205371,1.631700023004371,864,620,1484,+
chr1,54209992,2.1633433488118,719,522,1241,+
chr1,54212605,1.9466478712731752,1185,971,2156,+
chr1,54216141,2.875718426777733,757,628,1385,+
chr1,54216149,1.8176562688184996,685,360,1045,+
chr1,54216222,1.6528925619834711,719,483,1202,+
chr1,54216260,0.5100267379679144,762,560,1322,+
chr1,54216303,3.0074786324786325,562,467,1029,+
chr1,54218227,1.604424202992843,821,582,1403,+
chr1,55043963,2.1041706244718092,669,532,1201,+
chr1,55043972,0.4575174696314975,885,672,1557,+
chr1,55046630,0.9777370047351025,1170,806,1976,+
chr1,55052305,1.903143585386576,959,641,1600,+
chr1,55052307,1.9210119518526687,1403,981,2384,+
chr1,55052337,0.5717005076142132,635,393,1028,+
chr1,55052374,2.651623931623932,553,449,1002,+
chr1,55057351,1.0397247419455742,830,555,1385,+
chr1,55057352,1.0397247419455742,830,555,1385,+
chr1,55057380,1.1894669235709698,925,518,1443,+
chr1,55057381,1.1894669235709698,925,518,1443,+
chr1,55057415,1.7886626307099618,649,394,1043,+
chr1,55058047,2.2353184308918177,728,522,1250,+
chr1,55058580,1.2231641166567637,732,468,1200,+
chr1,55061414,1.1537114845938377,658,475,1133,+
chr1,55061415,1.1537114845938377,658,475,1133,+
chr1,55061527,2.5318938544655354,674,545,1219,+
chr1,55063537,2.571725788206178,570,451,1021,+
chr1,55063628,11.748829401214083,3777,2861,6638,+
chr1,55063629,11.748829401214083,3777,2861,6638,+
chr1,55063630,11.748829401214083,3777,2861,6638,+
chr1,55063638,0.7980845170844527,1449,1149,2598,+
chr1,55063639,1.0367372353673725,998,802,1800,+
chr1,55063759,2.8208239644035986,681,564,1245,+
chr1,55063873,2.603890362511052,588,521,1109,+
chr1,55063909,2.6992199071788288,780,532,1312,+
chr1,55064000,8.897515527950311,1145,321,1466,+
chr1,55064002,8.69135802469136,1119,314,1433,+
chr1,55064004,9.801227232386049,3569,1264,4833,+
chr1,55064005,9.398271120593243,3562,1292,4854,+
chr1,55064006,6.922235292318797,2123,770,2893,+
chr1,55064007,6.655023547880691,1093,363,1456,+
chr1,55064010,3.130813953488372,717,300,1017,+
chr1,55064012,3.1671826625387003,1115,509,1624,+
chr1,55064013,3.400429939101545,2863,1754,4617,+
chr1,55064014,2.982346676895186,4045,2335,6380,+
chr1,55064015,3.4276718147947003,2337,1402,3739,+
chr1,55064016,1.6611742424242426,1252,659,1911,+
chr1,55064017,1.0995565410199557,854,450,1304,+
chr1,55064029,12.08891707937003,3153,3184,6337,+
chr1,55064030,10.21961401098062,5428,5574,11002,+
chr1,55064031,10.21961401098062,5428,5574,11002,+
chr1,55064032,13.401917338343953,4377,4699,9076,+
chr1,55064070,0.4674515235457064,674,721,1395,+
chr1,55064101,0.42795698924731196,795,743,1538,+
chr1,55064377,2.2553122465531223,631,410,1041,+
chr1,55064421,3.104291497975708,660,474,1134,+
chr1,55064428,1.7384390404659298,1388,1082,2470,+
chr1,55064458,0.5768172888015717,733,508,1241,+
chr1,55064461,1.7937508757180889,691,548,1239,+
chr1,55064515,2.8767197821837636,1331,1048,2379,+
chr1,55064549,1.748554628246404,1032,714,1746,+
chr1,55064652,2.025847889089058,1271,750,2021,+
chr1,55064653,2.025847889089058,1271,750,2021,+
chr1,55064683,0.678958980593453,886,672,1558,+
chr1,55064684,1.6322778345250255,815,533,1348,+
chr1,55064694,2.548828125,584,511,1095,+
chr1,55064703,1.6297791335061125,934,738,1672,+
chr1,55064727,2.784371995454943,723,672,1395,+
chr1,56645385,2.402299535035484,681,359,1040,+
chr1,62439891,1.7324985988140493,604,468,1072,+
chr1,62444992,0.4855371900826446,704,560,1264,+
chr1,62864038,1.7547728991220486,941,512,1453,+
chr1,62864072,1.4929807674852622,1852,1102,2954,+
chr1,63593450,2.8843549227296403,790,442,1232,+
chr1,63593451,2.8843549227296403,790,442,1232,+
chr1,63593477,2.8092342142573785,1138,567,1705,+
chr1,63629435,1.1084905660377358,657,423,1080,+
chr1,63629437,0.9313118218839392,872,596,1468,+
chr1,63631755,2.8706896551724137,665,463,1128,+
chr1,63636237,3.2884749214814413,748,545,1293,+
chr1,63638700,1.1995475651863317,774,453,1227,+
chr1,63638701,1.1995475651863317,774,453,1227,+
chr1,63638709,1.4413796131921455,946,751,1697,+
chr1,63638710,0.9429752066115704,651,483,1134,+
chr1,63638745,1.9756550991501418,1037,705,1742,+
chr1,63638746,1.9756550991501418,1037,705,1742,+
chr1,63648534,0.3803889578041625,679,518,1197,+
chr1,63651770,2.8868661376031852,971,681,1652,+
chr1,63659673,3.9556639595309386,723,516,1239,+
chr1,63659860,2.6259842519685037,666,380,1046,+
chr1,63660118,3.0860033726812817,914,592,1506,+
chr1,65431962,0.5189408371532201,1349,879,2228,+
chr1,70221726,11.971736053597695,898,1062,1960,+
chr1,70221727,13.97156752952454,1375,1587,2962,+
chr1,70221728,14.645695612593062,1238,1487,2725,+
chr1,70221733,0.3293361458635504,778,1227,2005,+
chr1,70221734,0.8557323754879368,747,1186,1933,+
chr1,70221735,0.254627227123335,459,614,1073,+
chr1,70221736,0.8585099111414902,627,1044,1671,+
chr1,70221737,0.61165547922237,1007,1431,2438,+
chr1,70221749,0.31442303849858977,1051,1398,2449,+
chr1,70221750,0.298702969424462,1310,1750,3060,+
chr1,70235515,0.30809777955721684,711,473,1184,+
chr1,70237457,1.517472056871122,2066,1360,3426,+
chr1,70237460,1.418382000957396,2962,2088,5050,+
chr1,70237461,1.4140901493382476,4110,2938,7048,+
chr1,70237462,1.555728176305103,5292,3876,9168,+
chr1,70237463,1.5176000825403133,4383,3250,7633,+
chr1,70237464,1.497880399843463,5281,3787,9068,+
chr1,70237514,1.2741743408467552,2251,1228,3479,+
chr1,70239467,1.6275016156654525,3012,1900,4912,+
chr1,70239472,1.1623367548784953,5562,3504,9066,+
chr1,70244696,1.6500294191271154,2554,1829,4383,+
chr1,70244713,1.5002389350691983,2595,1725,4320,+
chr1,70244714,1.3658766990800788,2001,1606,3607,+
chr1,70244717,1.653133980865073,1566,1121,2687,+
chr1,70244719,0.7096407677803027,1544,961,2505,+
chr1,70244720,1.4132480083894918,1743,1300,3043,+
chr1,70244723,2.178795734559157,1831,1206,3037,+
chr1,70244741,2.2123061375208923,4742,3957,8699,+
chr1,70244742,2.0957226689950974,7351,6355,13706,+
chr1,70244744,1.5851621480543658,11248,9393,20641,+
chr1,70249991,1.2627194924103478,1606,1117,2723,+
chr1,70249993,1.2275133527022426,1524,1077,2601,+
chr1,70250674,1.5802649930264994,730,477,1207,+
chr1,70250896,0.1852215459126906,565,462,1027,+
chr1,70251033,0.6130610743193525,876,603,1479,+
chr1,70252431,36.738144329896905,648,484,1132,+
chr1,70252432,29.246413290446338,657,1058,1715,+
chr1,70417970,2.099797023577511,739,581,1320,+
chr1,70417988,1.9561864937609104,1269,943,2212,+
chr1,70424305,2.1757640582438422,699,573,1272,+
chr1,70424389,1.2586207818022757,1309,933,2242,+
chr1,70429834,0.4439746300211416,664,472,1136,+
chr1,70430323,2.6108597285067874,576,441,1017,+
chr1,70438701,2.6086015021096407,974,688,1662,+
chr1,70438759,1.6452930559513632,865,637,1502,+
chr1,74752394,1.165332281656138,757,569,1326,+
chr1,75724754,0.4989579212169328,630,423,1053,+
chr1,75728444,0.4439013326620096,651,406,1057,+
chr1,75761158,2.751764138238,786,515,1301,+
chr1,75763030,0.6124763705103969,791,505,1296,+
chr1,75763073,1.94,1163,674,1837,+
chr1,75763080,1.7132363648403992,2076,1328,3404,+
chr1,75763081,1.1820466786355477,822,556,1378,+
chr1,75763090,2.9769950218735857,1360,946,2306,+
chr1,75763129,1.584402413670706,918,532,1450,+
chr1,75763147,1.623199819981998,1373,807,2180,+
chr1,75763157,1.6557734204793029,1519,917,2436,+
chr1,75763160,1.5892412527846942,734,586,1320,+
chr1,75763163,1.7414285714285715,827,699,1526,+
chr1,75763166,0.9953122447084913,2874,1998,4872,+
chr1,75787564,0.48829807152218696,814,544,1358,+
chr1,75787569,1.532871972318339,885,628,1513,+
chr1,75789269,1.6090187590187592,768,494,1262,+
chr1,75790008,2.5764732343679717,789,467,1256,+
chr1,75791517,2.1888641425389754,566,448,1014,+
chr1,75792184,0.41663874729042893,1143,893,2036,+
chr1,75794129,0.4641051567239635,662,597,1259,+
chr1,76699928,2.934701928279723,629,551,1180,+
chr1,76699951,1.221310887526366,845,600,1445,+
chr1,76699954,2.2126929674099483,687,423,1110,+
chr1,76699955,1.8206461058048615,1296,851,2147,+
chr1,76699981,1.514461371440709,1394,1020,2414,+
chr1,76699983,1.514461371440709,1394,1020,2414,+
chr1,76699989,1.6992971793963572,1687,1357,3044,+
chr1,76699990,1.6992971793963572,1687,1357,3044,+
chr1,76700001,0.6404678701637122,3403,2522,5925,+
chr1,76700020,1.379586471312872,5238,3873,9111,+
chr1,76700062,1.7036754558001015,1537,1058,2595,+
chr1,76700063,1.7036754558001015,1537,1058,2595,+
chr1,76700075,2.1848502304147464,806,619,1425,+
chr1,76700077,1.578730008388817,2768,2123,4891,+
chr1,76700078,1.5618942267172353,1790,1511,3301,+
chr1,76700079,1.6238650253186662,2300,1991,4291,+
chr1,76700080,1.294118815277159,2561,2243,4804,+
chr1,76700081,1.5341863325458132,1456,1298,2754,+
chr1,76700084,1.4039327633274672,1582,1182,2764,+
chr1,76700089,0.7270918536531448,1195,871,2066,+
chr1,76700175,2.0122112211221115,870,605,1475,+
chr1,76700176,2.0122112211221115,870,605,1475,+
chr1,76700177,1.3376183297599697,1587,1010,2597,+
chr1,76700183,1.7629840454456054,2004,1225,3229,+
chr1,76700185,1.776085891148486,2421,1547,3968,+
chr1,76700194,1.5877695417789757,974,741,1715,+
chr1,76700200,1.5292780336001248,2416,1703,4119,+
chr1,76700205,1.5720480893087165,778,684,1462,+
chr1,76700208,1.5044257340241798,1447,1157,2604,+
chr1,76700209,1.4544765727391875,946,871,1817,+
chr1,76700212,1.2823316638842517,2710,1796,4506,+
chr1,76700217,0.8052237617455009,3159,2092,5251,+
chr1,76700370,2.0068807339449544,699,435,1134,+
chr1,76700371,2.0068807339449544,699,435,1134,+
chr1,76700404,0.9698575000555486,1415,1119,2534,+
chr1,76700409,0.7638139434491692,893,677,1570,+
chr1,76700413,2.1456095481670925,725,764,1489,+
chr1,77129077,0.9799496049173134,2020,1763,3783,+
chr1,77129078,0.6890520690902778,7816,5639,13455,+
chr1,77129080,0.5351856984342974,5686,3890,9576,+
chr1,77129082,0.6683277050215524,1390,1025,2415,+
chr1,77129127,1.6188078004494182,1791,1500,3291,+
chr1,77129138,1.4013262995599685,4980,3451,8431,+
chr1,77129146,0.7429195804195805,2832,2274,5106,+
chr1,78004975,2.30801169053534,874,664,1538,+
chr1,78013372,2.6080274762057223,1178,798,1976,+
chr1,78013373,2.8337394179447717,1787,1071,2858,+
chr1,78013374,2.0880001757644044,1550,1033,2583,+
chr1,78013376,1.7733447087402037,3241,1717,4958,+
chr1,78013377,2.8181818181818183,1425,1176,2601,+
chr1,78013378,2.184300058402503,5428,3313,8741,+
chr1,78013379,2.5238397173881046,2940,1989,4929,+
chr1,78013510,1.4303052669831087,672,490,1162,+
chr1,84490318,1.5166543756145523,666,451,1117,+
chr1,84490353,1.9193857278037267,1405,1117,2522,+
chr1,84490371,0.4322751775477026,1262,898,2160,+
chr1,84490402,1.7210065922920894,3668,2899,6567,+
chr1,84490403,1.7210065922920894,3668,2899,6567,+
chr1,84490404,1.7210065922920894,3668,2899,6567,+
chr1,84495418,2.5774002056228387,963,645,1608,+
chr1,85581456,1.1418588399720475,601,476,1077,+
chr1,85581458,1.1418588399720475,601,476,1077,+
chr1,85582105,1.845247446975648,608,468,1076,+
chr1,85582173,2.4130179740559417,730,624,1354,+
chr1,85582191,2.309315040464751,917,717,1634,+
chr1,85582199,3.0177577839997998,914,679,1593,+
chr1,85582255,0.4724734042553192,835,639,1474,+
chr1,85582420,1.8123297846001483,731,576,1307,+
chr1,85582745,1.3062544663873654,964,797,1761,+
chr1,85582829,1.9713407887230068,2686,1962,4648,+
chr1,85582830,1.8729373791770232,2106,1631,3737,+
chr1,85582833,2.21395881006865,644,367,1011,+
chr1,85582872,2.04517812675051,2348,1553,3901,+
chr1,85582873,2.6653806584362143,1204,647,1851,+
chr1,85582955,1.8970180527861211,1608,1205,2813,+
chr1,85582983,2.654385342638255,1171,885,2056,+
chr1,85583126,6.951561951561952,1164,258,1422,+
chr1,85583127,7.307650920682596,2392,481,2873,+
chr1,85583129,10.781199925740273,1363,212,1575,+
chr1,85583131,11.07034451264663,2260,417,2677,+
chr1,85583132,76.00947119179162,925,361,1286,+
chr1,85583133,28.024951238978584,6896,4019,10915,+
chr1,85583134,26.075048686533812,5960,3845,9805,+
chr1,85583135,24.507067841482314,5650,3791,9441,+
chr1,85583141,5.797022798079324,4033,6351,10384,+
chr1,85583142,5.797022798079324,4033,6351,10384,+
chr1,85583150,0.3380607737746794,769,1633,2402,+
chr1,85583151,0.3570739135116677,2703,4721,7424,+
chr1,85583452,1.5875473562839733,1263,933,2196,+
chr1,85583602,4.633003285968329,4738,3519,8257,+
chr1,85583603,4.382503602398325,6566,4828,11394,+
chr1,87046605,1.4193460742581931,1054,732,1786,+
chr1,87046613,0.40035499028470306,1016,924,1940,+
chr1,87046614,1.7467798175228761,767,498,1265,+
chr1,87046615,0.3307502641775273,625,667,1292,+
chr1,87072964,0.44641785478785956,779,518,1297,+
chr1,87072977,2.4024024024024024,639,369,1008,+
chr1,87332223,2.369559172289203,678,484,1162,+
chr1,87332235,0.4535433070866142,959,634,1593,+
chr1,87332236,1.0488771538735115,1573,992,2565,+
chr1,87339538,3.512125479289291,1151,670,1821,+
chr1,87339543,1.8247566652560305,1596,1111,2707,+
chr1,87339544,1.8247566652560305,1596,1111,2707,+
chr1,87339599,1.8600305758450824,875,405,1280,+
chr1,87345086,12.810660851652612,1322,1453,2775,+
chr1,87345087,12.810660851652614,1322,1453,2775,+
chr1,87345103,0.3027660324171952,490,527,1017,+
chr1,87345105,0.2862325515213586,1330,1631,2961,+
chr1,87345107,0.3486068684624641,537,553,1090,+
chr1,87345140,0.34743991640543365,569,695,1264,+
chr1,87345141,0.34743991640543365,569,695,1264,+
chr1,88741120,2.274849394598278,652,458,1110,+
chr1,88770403,2.520476778835263,709,502,1211,+
chr1,88833959,2.8992536115569827,602,448,1050,+
chr1,88835168,3.9448286840517066,672,465,1137,+
chr1,88835170,4.820812252290646,735,515,1250,+
chr1,91049608,1.6850372191715894,642,464,1106,+
chr1,91049609,1.3372817054341064,888,612,1500,+
chr1,91049611,1.1146079933156945,1043,644,1687,+
chr1,91049612,1.0462328352425467,863,525,1388,+
chr1,91049613,1.0462328352425467,863,525,1388,+
chr1,91049617,0.5733359095739542,1412,940,2352,+
chr1,91049619,0.5733359095739542,1412,940,2352,+
chr1,91049631,1.3631687242798354,688,485,1173,+
chr1,91049635,0.9685332814829218,1481,1331,2812,+
chr1,91049637,0.6560303366629671,2459,2119,4578,+
chr1,91049638,0.9139054156081066,11023,8457,19480,+
chr1,91049639,1.0141407138794083,5059,3515,8574,+
chr1,91049640,1.0568172406835288,7324,5754,13078,+
chr1,91049641,0.7118310140156616,2736,1721,4457,+
chr1,91049643,1.2966263484798954,1638,1329,2967,+
chr1,91507869,4.9752300070771405,569,470,1039,+
chr1,91507870,4.942899471249216,841,628,1469,+
chr1,91507871,4.9752300070771405,569,470,1039,+
chr1,91643043,0.5039233436056261,660,441,1101,+
chr1,91643290,1.6370987524934546,615,492,1107,+
chr1,91643924,1.963183791606368,546,690,1236,+
chr1,91643926,1.963183791606368,546,690,1236,+
chr1,92832036,0.9658502548839271,11382,8243,19625,+
chr1,92832037,0.9481158789108818,20201,14016,34217,+
chr1,92832038,0.9736991780912501,45846,34060,79906,+
chr1,92832039,0.9999193535863925,48302,34121,82423,+
chr1,92832040,0.8469220474916276,46085,33099,79184,+
chr1,92832041,0.9411651032930727,35862,25421,61283,+
chr1,92832072,1.190503289589081,14866,10552,25418,+
chr1,92833402,1.3239439771731225,5432,3740,9172,+
chr1,92833406,1.2097069715348523,5750,3898,9648,+
chr1,92833407,0.7636131156008354,7004,6003,13007,+
chr1,92833543,0.39668037156364483,948,696,1644,+
chr1,92834776,0.9452831548105095,908,763,1671,+
chr1,92834777,0.8590104511478688,1453,1185,2638,+
chr1,92834825,0.49688421639631897,13257,8241,21498,+
chr1,92834862,1.6181304197053978,62924,37110,100034,+
chr1,92834864,1.4312558384821839,145870,84383,230253,+
chr1,92834865,1.5620916769454098,78413,43848,122261,+
chr1,92834866,1.4083692532985563,84683,51022,135705,+
chr1,92836214,1.1680649659328526,8173,4701,12874,+
chr1,92836220,1.0040191302887105,26964,17566,44530,+
chr1,92836297,0.7615567488182595,32795,18061,50856,+
chr1,92836321,0.8232145956943926,16197,7576,23773,+
chr1,92836324,0.6968328482139938,29772,13697,43469,+
chr1,92836327,0.7591434029326289,17960,7723,25683,+
chr1,92836338,1.1223375774002076,22092,9057,31149,+
chr1,92837454,0.5000138885583671,622,464,1086,+
chr1,92840556,1.5352422907488987,1475,907,2382,+
chr1,92840557,2.056106198191782,2734,1826,4560,+
chr1,92840561,1.9150243378605567,5987,3308,9295,+
chr1,92840562,1.9150243378605567,5987,3308,9295,+
chr1,92840563,1.9150243378605567,5987,3308,9295,+
chr1,92840565,1.3143012405973997,10553,7188,17741,+
chr1,92840566,1.3143012405973997,10553,7188,17741,+
chr1,92840590,1.3900791938324448,3055,2065,5120,+
chr1,92841777,1.4372289637067521,19045,11437,30482,+
chr1,92841779,1.3727513307406451,26608,17149,43757,+
chr1,93346671,2.898618353271053,984,724,1708,+
chr1,93360705,2.1434220272359514,640,430,1070,+
chr1,93361086,7.004764317740662,1011,764,1775,+
chr1,95244509,2.8428809272488973,746,450,1196,+
chr1,95244512,3.3398811881188113,726,504,1230,+
chr1,95244514,2.433406303176348,1380,975,2355,+
chr1,95244515,2.8474520905923346,757,573,1330,+
chr1,96447620,1.920092768553374,1077,720,1797,+
chr1,96447622,1.7382422756012605,1169,802,1971,+
chr1,96447623,1.1117538648068346,884,920,1804,+
chr1,96447624,1.0649385808811072,1336,1262,2598,+
chr1,96447638,0.5455848810687521,597,464,1061,+
chr1,96447640,2.0467980295566504,553,463,1016,+
chr1,96447644,1.9198830409356724,937,683,1620,+
chr1,96447645,1.5720411663807892,662,582,1244,+
chr1,97546573,2.348572320174754,847,753,1600,+
chr1,97546574,0.4682392437494479,1059,685,1744,+
chr1,97546575,2.348572320174754,847,753,1600,+
chr1,97546576,0.890588221516986,1689,1108,2797,+
chr1,97546577,1.1977391228147043,1205,786,1991,+
chr1,97546594,1.5266362252663623,1189,729,1918,+
chr1,97546596,1.8824956300828553,3053,2438,5491,+
chr1,97546598,2.0009957107843137,1924,1631,3555,+
chr1,98738263,2.7001851726498423,762,555,1317,+
chr1,100038248,1.8702139909797522,638,612,1250,+
chr1,100038250,1.8141856160761505,997,991,1988,+
chr1,100038251,1.7007887323943662,693,709,1402,+
chr1,100038289,2.1902097902097903,695,519,1214,+
chr1,100038290,2.1902097902097903,695,519,1214,+
chr1,100068479,1.695079171947459,877,583,1460,+
chr1,100069617,3.003528289891926,598,491,1089,+
chr1,100069647,1.326718176221663,637,510,1147,+
chr1,100082867,1.420121587615515,674,440,1114,+
chr1,100274824,0.7171022973282297,758,445,1203,+
chr1,100274826,1.1292610439965456,1023,586,1609,+
chr1,100274835,1.9224518814953377,702,445,1147,+
chr1,100287151,2.859382275337576,1067,757,1824,+
chr1,100287152,2.859382275337576,1067,757,1824,+
chr1,100287159,1.2546594610239798,1320,1229,2549,+
chr1,100287167,1.988439306358381,515,518,1033,+
chr1,100287178,1.6131151710398033,884,760,1644,+
chr1,101256399,1.052625509535902,741,657,1398,+
chr1,101256400,0.7606512097309641,1544,1227,2771,+
chr1,101256402,0.8775504107542943,1223,1029,2252,+
chr1,101256404,1.074867186987604,897,771,1668,+
chr1,101256408,0.9429429429429431,1412,1035,2447,+
chr1,101256409,1.099618943930321,2019,1502,3521,+
chr1,101256410,0.8777478663762767,4998,4045,9043,+
chr1,101256411,1.1084920139648902,2429,2251,4680,+
chr1,101256417,1.8464665076956426,830,658,1488,+
chr1,101256418,2.92326431181486,599,820,1419,+
chr1,105893325,1.7000000000000004,749,499,1248,+
chr1,107505233,1.5059339987384013,757,608,1365,+
chr1,107505314,1.5453696398373222,1370,893,2263,+
chr1,107505318,1.2112344172742036,4236,2992,7228,+
chr1,107505319,0.966662026726058,2192,1346,3538,+
chr1,107505326,1.5821384077973473,1407,870,2277,+
chr1,108638888,2.4465405715731885,630,407,1037,+
chr1,108696098,0.7683856530444642,604,424,1028,+
chr1,108696613,0.9279863914443204,934,655,1589,+
chr1,108699779,1.0926989335520918,665,423,1088,+
chr1,108699780,1.7820975614205317,902,627,1529,+
chr1,108808971,2.10746431925765,640,456,1096,+
chr1,108901893,4.048986486486487,610,480,1090,+
chr1,108901895,2.7515077933922543,1586,1360,2946,+
chr1,108901896,2.25521025333668,1675,1496,3171,+
chr1,108901899,1.8329755772375282,1250,1266,2516,+
chr1,108901905,5.928897338403043,502,525,1027,+
chr1,108901909,2.0476395572078974,2526,3215,5741,+
chr1,108901910,2.0476395572078974,2526,3215,5741,+
chr1,108901911,2.408120849624933,1857,2463,4320,+
chr1,108918769,3.2847682119205297,743,452,1195,+
chr1,108918770,3.2847682119205297,743,452,1195,+
chr1,108924048,0.3451813471502591,808,543,1351,+
chr1,108929707,3.9762611275964392,669,336,1005,+
chr1,108929708,3.9762611275964392,669,336,1005,+
chr1,108929765,0.5006131625562066,667,357,1024,+
chr1,108929784,2.6304545454545454,642,439,1081,+
chr1,108929786,1.9189814814814812,828,467,1295,+
chr1,108929789,2.125154894671624,734,537,1271,+
chr1,108992320,1.3412662310921324,947,517,1464,+
chr1,108992322,1.421560484891874,1530,849,2379,+
chr1,108992324,1.0299194476409663,1789,868,2657,+
chr1,108992325,0.8449576096724563,2718,1628,4346,+
chr1,108992326,1.0210114454967638,1938,942,2880,+
chr1,108992327,0.7398063765139744,2297,1414,3711,+
chr1,108992330,0.5365894797715718,1141,882,2023,+
chr1,108992331,0.5365894797715718,1141,882,2023,+
chr1,108992339,1.6391621188850036,1671,861,2532,+
chr1,108992340,1.6391621188850036,1671,861,2532,+
chr1,108992346,1.5999258435298478,862,650,1512,+
chr1,108992356,0.6306452234949286,2043,1205,3248,+
chr1,108992358,0.656734639242894,3449,1945,5394,+
chr1,109094972,12.93365166252752,415,1162,1577,+
chr1,109214006,0.7050430896903926,596,481,1077,+
chr1,109214021,2.047058823529412,659,549,1208,+
chr1,109214062,1.9462686567164176,977,736,1713,+
chr1,109214073,1.9163036219671192,2077,1598,3675,+
chr1,109214074,1.9163036219671192,2077,1598,3675,+
chr1,109214982,2.3392188427927683,619,393,1012,+
chr1,109214983,2.3392188427927683,619,393,1012,+
chr1,109223979,0.6859099804305283,700,510,1210,+
chr1,109228351,2.7036590709903585,1072,651,1723,+
chr1,109231000,3.189276807980049,608,400,1008,+
chr1,109231009,1.8026590523033383,1200,837,2037,+
chr1,109231634,3.212922568575025,938,718,1656,+
chr1,109231647,1.947166276346604,1093,914,2007,+
chr1,109231649,1.947166276346604,1093,914,2007,+
chr1,109235258,0.6605940594059406,833,706,1539,+
chr1,109235338,1.7203412423353772,716,362,1078,+
chr1,109235342,1.7368730407523514,590,463,1053,+
chr1,109236005,1.95,662,373,1035,+
chr1,109236012,1.5459167790806267,763,418,1181,+
chr1,109236037,1.7480933323265122,1851,1393,3244,+
chr1,109236038,1.7480933323265122,1851,1393,3244,+
chr1,109236478,1.6113831956830829,1576,1239,2815,+
chr1,109236488,2.077968051683703,1173,728,1901,+
chr1,109237282,2.4100529100529102,910,701,1611,+
chr1,109237325,0.5987043785065649,940,677,1617,+
chr1,109237736,1.832778042202126,721,572,1293,+
chr1,109237742,1.7538029606942316,798,652,1450,+
chr1,109237848,1.2236400027408671,3494,2362,5856,+
chr1,109237849,0.997073556078206,2135,1532,3667,+
chr1,109237996,1.6293438454652385,1466,1014,2480,+
chr1,109238025,2.0047700587084147,885,583,1468,+
chr1,109238032,1.6858006042296072,836,661,1497,+
chr1,109238036,0.5329635546980979,883,676,1559,+
chr1,109548800,1.798073504387894,948,750,1698,+
chr1,109548801,3.4073182957393486,585,524,1109,+
chr1,109582457,1.6231884057971016,879,574,1453,+
chr1,109586306,2.0670329670329672,626,454,1080,+
chr1,109592052,2.3199320050600885,1066,815,1881,+
chr1,109592054,2.3199320050600885,1066,815,1881,+
chr1,109592097,0.5913724062613761,683,535,1218,+
chr1,109592126,1.5392910749213522,1724,1052,2776,+
chr1,109592434,1.892079207920792,636,403,1039,+
chr1,109592797,2.160231450521575,1355,958,2313,+
chr1,109592814,2.3005102040816325,667,489,1156,+
chr1,109593140,1.9253224711473185,708,490,1198,+
chr1,109593268,1.2055764484256328,911,793,1704,+
chr1,109984951,16.060192317967633,1544,449,1993,+
chr1,109984952,16.060192317967633,1544,449,1993,+
chr1,109985002,4.0689516390845,1341,474,1815,+
chr1,109985003,4.13023226509633,1777,694,2471,+
chr1,109985004,3.556732663084984,2060,895,2955,+
chr1,109985005,3.321954680012724,1947,933,2880,+
chr1,109985006,3.2412618980297125,1557,790,2347,+
chr1,109985007,3.4563492063492065,736,395,1131,+
chr1,109985015,10.870107948158733,1923,1319,3242,+
chr1,109985016,12.323867887214464,2567,1899,4466,+
chr1,109985017,8.42379950099787,2806,2132,4938,+
chr1,109985018,8.955266003629585,2169,1763,3932,+
chr1,109985019,5.084366166557946,697,656,1353,+
chr1,109985024,6.215663328972174,1873,2160,4033,+
chr1,109985025,6.215663328972174,1873,2160,4033,+
chr1,109985029,0.34233288919057825,1095,1676,2771,+
chr1,109985030,0.6602269819896294,960,1270,2230,+
chr1,109985036,0.2890658867467871,661,836,1497,+
chr1,109985045,0.9496772141595458,807,982,1789,+
chr1,109985048,1.2718013697566224,2508,3355,5863,+
chr1,109985050,1.4960159911193684,7485,10166,17651,+
chr1,109985051,1.5751629163126635,6369,8722,15091,+
chr1,109985052,1.608127858011913,4660,7039,11699,+
chr1,109985055,0.47802657805667537,5205,7623,12828,+
chr1,109985056,0.5856985372398225,5937,7879,13816,+
chr1,109985057,0.5231124102307501,9688,12729,22417,+
chr1,109985058,0.5217175640142118,5627,7951,13578,+
chr1,109985068,0.49521377769121105,2070,2329,4399,+
chr1,110009033,0.5949604743083005,668,505,1173,+
chr1,110009070,1.691531907494349,767,638,1405,+
chr1,110009099,1.4104880581516095,798,641,1439,+
chr1,110011226,1.8220154792196777,1296,785,2081,+
chr1,110011270,1.770264459795586,4367,2952,7319,+
chr1,110011272,1.5378822984244669,2949,1991,4940,+
chr1,110011302,0.6375126390293225,1260,988,2248,+
chr1,110012373,2.0726655348047545,871,588,1459,+
chr1,110012424,1.9021794871794877,801,599,1400,+
chr1,110012900,1.7159899611510296,1405,1002,2407,+
chr1,110012902,1.7159899611510296,1405,1002,2407,+
chr1,110012947,1.8129829984544048,827,646,1473,+
chr1,110014815,1.5180621798268856,1374,887,2261,+
chr1,110015425,1.5751288489493853,1643,1080,2723,+
chr1,110015431,0.6595500903249896,2780,1750,4530,+
chr1,110015438,1.499666050948102,4891,3548,8439,+
chr1,110015439,1.3982856300414903,7567,5585,13152,+
chr1,110015441,1.1315003454619392,15879,11805,27684,+
chr1,110015442,1.1602394477479998,11295,8657,19952,+
chr1,110015443,1.3039882208763818,8716,6862,15578,+
chr1,110016346,1.5657216494845356,728,581,1309,+
chr1,110016701,1.815058479532164,572,431,1003,+
chr1,110017519,2.0883065404096013,653,477,1130,+
chr1,110017525,2.407792207792208,617,494,1111,+
chr1,110017529,1.6903590157321502,775,669,1444,+
chr1,110017532,1.6431110085391183,697,618,1315,+
chr1,110017537,1.5972968134622265,829,797,1626,+
chr1,110017543,1.4154185795639849,867,926,1793,+
chr1,110017548,1.6340227093866353,2141,2102,4243,+
chr1,110017551,1.625351990642464,961,1125,2086,+
chr1,110017948,1.6870569470699437,1445,1471,2916,+
chr1,110017962,1.7139128072452798,8107,9319,17426,+
chr1,110017963,1.6432651064677224,9130,9790,18920,+
chr1,110017964,1.5724147775196915,4846,5340,10186,+
chr1,110017965,2.0715617232808614,2168,2447,4615,+
chr1,110017966,0.391417361451692,1387,2038,3425,+
chr1,110017968,1.2688748135576717,3147,3753,6900,+
chr1,110017971,0.9264747218910143,6177,8150,14327,+
chr1,110017972,0.7784086397204795,3920,5396,9316,+
chr1,110017974,1.2811553451252418,5864,7440,13304,+
chr1,110017975,1.4083109836256733,9232,11970,21202,+
chr1,110017977,1.4110817681173218,14528,19489,34017,+
chr1,110017978,1.5097575958525784,6853,9329,16182,+
chr1,110018456,1.4182579509906152,1426,1095,2521,+
chr1,110018586,2.0592861464004835,827,512,1339,+
chr1,110018631,1.6740088105726871,911,680,1591,+
chr1,110019060,1.6701616202945992,932,610,1542,+
chr1,110019566,1.6655457637600497,1050,783,1833,+
chr1,110019568,0.6336602504222272,1607,1094,2701,+
chr1,110019569,1.4751149008224482,886,688,1574,+
chr1,110020731,0.6297125622629439,1059,830,1889,+
chr1,110021687,1.959880239520958,1090,834,1924,+
chr1,110021694,0.58691858259352,1189,763,1952,+
chr1,110021816,3.1015943877551018,1130,783,1913,+
chr1,110021984,1.358850864328518,1952,1283,3235,+
chr1,110022132,1.6525357566672911,1734,1185,2919,+
chr1,110022149,1.5961409152636228,3724,2077,5801,+
chr1,110022151,1.5198390350336526,7890,4752,12642,+
chr1,110022152,1.5276286353467559,3901,2234,6135,+
chr1,110022161,1.075358650227894,7099,4698,11797,+
chr1,110022198,1.063625516259324,7792,5417,13209,+
chr1,110022385,0.4156548984501762,873,585,1458,+
chr1,110022399,0.5949861354762039,750,430,1180,+
chr1,110022402,1.8644428994129483,1206,758,1964,+
chr1,110022417,1.7043536578550267,952,616,1568,+
chr1,110022420,1.7262063449746734,1049,681,1730,+
chr1,110022428,1.965654746591201,825,675,1500,+
chr1,110022430,2.270014347202296,878,696,1574,+
chr1,110022601,0.6939087546239212,1278,810,2088,+
chr1,110022756,6.14265378181417,15139,9371,24510,+
chr1,110022757,9.247832403582137,11662,8801,20463,+
chr1,110022758,9.453956144387599,21516,17277,38793,+
chr1,110022759,11.978898747140164,15566,14261,29827,+
chr1,110022762,0.607380458550068,3825,4523,8348,+
chr1,110022765,0.5127905086949456,1971,2636,4607,+
chr1,110022779,0.9104107661444111,12684,16370,29054,+
chr1,110022780,0.7430024357392425,21782,25534,47316,+
chr1,110022781,0.5590407416669433,16999,18762,35761,+
chr1,110022782,0.44808938751548033,14514,15626,30140,+
chr1,110022791,0.6525629294471463,9910,9272,19182,+
chr1,110022800,0.4213739647483542,7936,9417,17353,+
chr1,110022801,0.4213739647483542,7936,9417,17353,+
chr1,110022815,0.6681058439524239,11349,11641,22990,+
chr1,110022817,0.6681058439524239,11349,11641,22990,+
chr1,110023398,0.6440520446096655,1187,806,1993,+
chr1,110023477,1.5433148734177211,866,631,1497,+
chr1,110023478,3.9682539682539675,549,538,1087,+
chr1,110023517,0.626953125,1283,1023,2306,+
chr1,110023597,1.605659863945578,921,749,1670,+
chr1,110023598,1.5817643712813165,1745,1357,3102,+
chr1,110023612,2.0546845124282984,596,522,1118,+
chr1,110341536,2.0951627445407377,695,467,1162,+
chr1,111147642,7.3705074185419805,685,726,1411,+
chr1,111182864,1.6387149152566503,862,578,1440,+
chr1,111449468,1.0707975595616044,1014,813,1827,+
chr1,111449483,0.7958925424618499,1022,715,1737,+
chr1,111454223,1.5475989890480202,1836,1186,3022,+
chr1,111454225,1.5475989890480202,1836,1186,3022,+
chr1,111454230,2.338839083670927,1290,998,2288,+
chr1,111454248,1.65897611193808,1554,1266,2820,+
chr1,111454254,1.628720785023882,2381,1943,4324,+
chr1,111454261,1.9444976076555023,761,626,1387,+
chr1,111454287,1.6130725190839692,965,785,1750,+
chr1,111454333,1.3251386342674305,2449,1656,4105,+
chr1,111459459,1.8937070938215104,612,459,1071,+
chr1,111459483,1.7647058823529411,539,467,1006,+
chr1,111459484,2.7524959106263696,1067,626,1693,+
chr1,111459499,1.8015618221258132,768,460,1228,+
chr1,111459505,0.3872857265914377,842,610,1452,+
chr1,111459517,1.4889872246620683,3544,2358,5902,+
chr1,111459518,1.4610091640839262,2481,1504,3985,+
chr1,111459519,1.9109124135230384,1310,977,2287,+
chr1,111459522,0.7469669117647058,1504,1087,2591,+
chr1,111459523,1.0440581358442658,2745,2175,4920,+
chr1,111459524,1.156784397879389,3579,2798,6377,+
chr1,111460916,1.5312944676744678,3898,2521,6419,+
chr1,111460920,1.6136854741896758,1221,832,2053,+
chr1,111460964,1.4403247114448614,1690,1223,2913,+
chr1,111460965,1.3474445952057892,2743,2210,4953,+
chr1,111460984,1.3150371017023137,3192,2290,5482,+
chr1,111461002,1.4492687732060314,3798,2406,6204,+
chr1,111461151,1.308002461848616,2346,1858,4204,+
chr1,111461153,1.6859944903581263,1318,824,2142,+
chr1,112619831,1.0016193489550147,3664,2241,5905,+
chr1,112619832,1.0016193489550147,3664,2241,5905,+
chr1,112649448,2.26560208570963,1263,721,1984,+
chr1,112653608,1.1424956471563714,3417,2068,5485,+
chr1,112653613,1.670010123934586,3864,2420,6284,+
chr1,112654576,2.2723543422278314,2243,1485,3728,+
chr1,112659713,1.4988837020499288,1054,757,1811,+
chr1,112670000,2.58186995728524,815,601,1416,+
chr1,112670006,0.5772922873220788,871,529,1400,+
chr1,112670030,1.8390804597701147,703,521,1224,+
chr1,112670059,1.8525974025974024,1267,839,2106,+
chr1,112670073,1.8286009292720704,1385,893,2278,+
chr1,112670401,2.0013976240391336,715,476,1191,+
chr1,112670598,1.5533980582524274,959,720,1679,+
chr1,112670745,1.83893070835746,1029,627,1656,+
chr1,112670749,1.4680212422073424,1155,709,1864,+
chr1,112670795,1.4501125281320328,1932,1332,3264,+
chr1,112670797,1.5746457445987088,2089,1722,3811,+
chr1,112670829,0.7644532853399009,2045,1376,3421,+
chr1,112671250,2.0749408529957156,1297,801,2098,+
chr1,112671256,1.918858307849133,723,544,1267,+
chr1,112671360,0.6020408163265306,1061,783,1844,+
chr1,112671363,0.4635031879364435,1592,963,2555,+
chr1,112671411,2.2351502048247616,872,675,1547,+
chr1,113450225,0.9717189314750291,576,573,1149,+
chr1,113450226,0.9717189314750291,576,573,1149,+
chr1,113955569,2.2853523498456894,2231,1573,3804,+
chr1,113955570,2.2220241941956163,1996,1425,3421,+
chr1,114537196,0.4524452991008783,756,541,1297,+
chr1,114537197,0.4524452991008783,756,541,1297,+
chr1,114537201,1.4768441939145907,887,642,1529,+
chr1,114537227,0.5622071837584591,499,564,1063,+
chr1,114537228,0.5622071837584591,499,564,1063,+
chr1,116373441,2.2036417856497375,560,446,1006,+
chr1,116384048,1.5756704980842906,845,647,1492,+
chr1,116384061,2.1445913722089744,760,658,1418,+
chr1,116387325,2.1269956458635706,976,688,1664,+
chr1,116387407,1.3676431730347887,2533,1778,4311,+
chr1,116387480,2.5849133311157924,1075,932,2007,+
chr1,116388132,0.6650783699059561,883,724,1607,+
chr1,116388710,1.5062274276842071,874,688,1562,+
chr1,116388757,1.509372422228333,2210,1728,3938,+
chr1,116388759,1.424877339497853,4016,2858,6874,+
chr1,116388903,1.4821875000000002,1053,799,1852,+
chr1,116388930,1.4201800312299067,1818,1145,2963,+
chr1,116389487,1.6626773049645391,681,563,1244,+
chr1,116390223,1.6678925035360683,736,504,1240,+
chr1,116390249,1.6794478527607364,875,651,1526,+
chr1,116390314,0.34286742219823707,952,762,1714,+
chr1,116390381,1.5071251015234677,1133,990,2123,+
chr1,116392890,2.0125313283208017,802,683,1485,+
chr1,116392937,1.8465617516250428,1269,947,2216,+
chr1,116393595,1.6011730205278594,558,472,1030,+
chr1,116393709,1.8601010101010096,634,549,1183,+
chr1,116395134,2.0530973451327434,1507,1016,2523,+
chr1,116396598,2.0010964912280698,656,455,1111,+
chr1,116396622,2.5832964438542128,1280,752,2032,+
chr1,116396639,1.699270072992701,775,547,1322,+
chr1,116397904,0.5929850024189647,720,529,1249,+
chr1,116397923,0.7262200041837252,952,613,1565,+
chr1,116397954,1.8202479338842972,880,615,1495,+
chr1,116397961,2.3421897810218977,954,684,1638,+
chr1,116397972,1.8609546285018268,1136,820,1956,+
chr1,116398652,0.6292018170019468,807,669,1476,+
chr1,116398669,1.9294765840220387,1647,1209,2856,+
chr1,116398671,1.7858284496537034,2513,1876,4389,+
chr1,116398672,1.6557911026020367,3187,2250,5437,+
chr1,116398941,0.7243658088235294,1486,1359,2845,+
chr1,116398943,2.9985706117781588,1233,1165,2398,+
chr1,116399432,1.9865793864809014,2274,1633,3907,+
chr1,116399481,1.480388621794872,1102,959,2061,+
chr1,116400863,1.6178806107829757,2025,1407,3432,+
chr1,116401141,1.332263996681619,1418,1092,2510,+
chr1,116401154,1.4129446770350291,1444,1147,2591,+
chr1,116401233,1.2116867282758346,2162,1451,3613,+
chr1,116401564,1.2713378577536798,1425,900,2325,+
chr1,116401566,0.6439137160835029,2389,1811,4200,+
chr1,116401567,0.6439137160835029,2389,1811,4200,+
chr1,116401582,1.9454990583804144,1098,884,1982,+
chr1,116403944,1.7073313782991204,709,549,1258,+
chr1,116404436,1.9540709812108563,623,478,1101,+
chr1,116404606,1.4524046429583382,1124,337,1461,+
chr1,116404617,3.994750656167979,760,253,1013,+
chr1,116404618,3.994750656167979,760,253,1013,+
chr1,116404621,5.640161220982758,1865,646,2511,+
chr1,116404623,19.40278699402787,1719,1506,3225,+
chr1,116404624,22.737526099298844,4164,4064,8228,+
chr1,116404625,22.737526099298844,4164,4064,8228,+
chr1,116404638,0.3515854374633001,478,523,1001,+
chr1,116404646,0.46884310912763344,2300,3252,5552,+
chr1,116404648,0.5701401021168501,3987,5416,9403,+
chr1,116404649,0.5420034717133538,2380,2758,5138,+
chr1,116404650,0.6076606931351404,2348,2949,5297,+
chr1,116404651,0.5417687441109167,1547,1563,3110,+
chr1,116404684,0.3571871480455058,1282,1112,2394,+
chr1,116974273,2.760527285839895,784,513,1297,+
chr1,116984712,2.08023150963575,1549,1108,2657,+
chr1,116984714,2.08023150963575,1549,1108,2657,+
chr1,116990097,2.090175585798985,1270,765,2035,+
chr1,116990098,1.899827734711456,958,539,1497,+
chr1,117934641,2.370419912885646,702,474,1176,+
chr1,117939492,0.7150344414495358,763,635,1398,+
chr1,117939494,0.7097663472852579,811,660,1471,+
chr1,117939495,0.9709288001970928,562,450,1012,+
chr1,117959501,2.525408368815667,1362,1296,2658,+
chr1,117959504,2.8872740163062747,542,650,1192,+
chr1,119711924,1.020404079155269,3749,3284,7033,+
chr1,119711925,1.020404079155269,3749,3284,7033,+
chr1,119711934,0.8596819625238136,7824,5686,13510,+
chr1,119711935,0.908444505454126,10025,7540,17565,+
chr1,119712033,1.3749300641764026,3152,2059,5211,+
chr1,119712089,1.39572192513369,1964,1440,3404,+
chr1,119712092,1.4946012235347186,2304,1346,3650,+
chr1,119721274,0.5610958904109589,1055,802,1857,+
chr1,119721294,1.9249492900608518,1167,927,2094,+
chr1,119721311,1.102654895247516,2915,2382,5297,+
chr1,119723405,1.4545573359123818,1373,1141,2514,+
chr1,119723422,1.5203403711926806,3834,2603,6437,+
chr1,119726852,1.4043565153828024,2832,2336,5168,+
chr1,119726887,1.5934576444957067,1420,1223,2643,+
chr1,119727020,0.6009943603443159,1245,1122,2367,+
chr1,119734643,1.6519754170324847,1791,1138,2929,+
chr1,119734654,1.4078119215105518,1988,1240,3228,+
chr1,119735327,1.6748120300751876,1781,1082,2863,+
chr1,119737141,1.7649402390438247,885,501,1386,+
chr1,119737144,1.826325969663036,896,516,1412,+
chr1,119737150,2.3810872472661475,817,668,1485,+
chr1,119737185,1.6589742702120784,2434,1884,4318,+
chr1,119737210,1.6942024886877831,1050,883,1933,+
chr1,119737213,1.2656714859856986,1232,1126,2358,+
chr1,119737247,1.4981084489281207,1619,1169,2788,+
chr1,119740503,1.831478423206721,1108,732,1840,+
chr1,119740506,2.1519607843137254,877,815,1692,+
chr1,119741768,2.9097528530420775,1038,620,1658,+
chr1,119741823,1.4078078078078078,1464,1109,2573,+
chr1,119741826,1.408967020986645,1476,1222,2698,+
chr1,119742888,1.8534798534798536,1011,545,1556,+
chr1,119742917,1.576368970013038,1028,766,1794,+
chr1,119742939,2.1118826149613517,1239,897,2136,+
chr1,119742942,1.6523255813953492,1420,859,2279,+
chr1,119742994,1.0595512082853855,2435,2211,4646,+
chr1,119742995,1.4587186356107238,4052,3094,7146,+
chr1,119742996,1.3087557067162325,8267,6954,15221,+
chr1,119744001,2.4083946078431366,1122,815,1937,+
chr1,119744002,1.6553329023917258,1066,909,1975,+
chr1,119744032,1.559233449477352,1789,1147,2936,+
chr1,119744037,1.63250707270855,3014,2542,5556,+
chr1,147178250,5.840204024822507,568,508,1076,+
chr1,147178352,1.7266744861902195,797,501,1298,+
chr1,147178526,1.515214866434378,592,409,1001,+
chr1,147178792,1.0695134061569018,717,688,1405,+
chr1,147178794,1.3555974447586137,1096,1060,2156,+
chr1,147178796,1.1103639051843377,750,722,1472,+
chr1,147178816,1.5002899110939312,620,596,1216,+
chr1,147178930,2.7829218106995883,540,485,1025,+
chr1,147178932,2.7829218106995883,540,485,1025,+
chr1,147178948,0.444467787114846,576,475,1051,+
chr1,147178950,0.6340689385802167,1331,1077,2408,+
chr1,147178951,0.6340689385802167,1331,1077,2408,+
chr1,147179195,0.8781248448304524,932,780,1712,+
chr1,147179196,0.3749516066589237,744,614,1358,+
chr1,147179197,1.0493927125506073,647,493,1140,+
chr1,147179198,0.3749516066589237,744,614,1358,+
chr1,147179201,2.0417004048582994,737,740,1477,+
chr1,147179203,2.0417004048582994,737,740,1477,+
chr1,147179225,1.7225427350427351,700,623,1323,+
chr1,147179233,1.9072105813678848,1086,800,1886,+
chr1,147179506,0.7406978573338888,1590,1269,2859,+
chr1,147179507,0.7800824304128526,1068,807,1875,+
chr1,147179508,0.7269936137775022,1883,1520,3403,+
chr1,148288377,0.36489970439703323,600,428,1028,+
chr1,150293860,1.4604164039750247,1717,997,2714,+
chr1,150293861,1.7342256506439697,1530,971,2501,+
chr1,150293862,1.5493485488646794,2219,1311,3530,+
chr1,150293880,1.042071197411003,1448,823,2271,+
chr1,150293881,1.2466027148312426,1927,1211,3138,+
chr1,150294380,0.6051955204699835,1040,837,1877,+
chr1,150308054,1.572944297082228,1185,782,1967,+
chr1,150308133,1.7058100216362768,1958,1403,3361,+
chr1,150308134,1.8044444444444443,811,549,1360,+
chr1,150308154,0.6463768874466805,1234,741,1975,+
chr1,150308163,1.141032456665854,3595,2634,6229,+
chr1,150308241,3.4188472127660514,5406,4568,9974,+
chr1,150308242,3.2591366017971635,6642,5343,11985,+
chr1,150352866,2.8107517077273383,607,418,1025,+
chr1,150352867,2.8107517077273383,607,418,1025,+
chr1,150492415,0.3214984048574663,567,473,1040,+
chr1,150492417,1.3721087546621014,794,707,1501,+
chr1,150506965,5.5056147413201995,585,495,1080,+
chr1,151167008,2.9455176402544825,774,591,1365,+
chr1,151168320,2.10504585892288,757,612,1369,+
chr1,151199034,2.8113188439996817,781,471,1252,+
chr1,151232572,1.6515617669502647,841,621,1462,+
chr1,151232579,3.065141918943089,660,429,1089,+
chr1,151234206,1.6207641924306677,2166,1950,4116,+
chr1,151234207,1.6937554019014691,1536,1423,2959,+
chr1,151234221,1.6261264328680058,1008,978,1986,+
chr1,151234230,1.1738925253565953,2314,2265,4579,+
chr1,151234236,2.1891625615763552,1110,1224,2334,+
chr1,151236563,1.653877782716623,910,569,1479,+
chr1,151236564,2.102582269040738,931,630,1561,+
chr1,151236566,1.8722243407350914,657,466,1123,+
chr1,151236569,1.5527210926083017,1210,851,2061,+
chr1,151236570,1.6322243292199707,1348,1167,2515,+
chr1,151236572,1.5993039006647434,1514,1406,2920,+
chr1,151236574,1.3662987283237675,3348,2394,5742,+
chr1,151236576,1.001634965600971,2993,1764,4757,+
chr1,151236578,1.1200928619261556,2755,1917,4672,+
chr1,151242143,1.9880074034416302,807,621,1428,+
chr1,151247915,1.3130953355176151,868,600,1468,+
chr1,151248280,0.5558618862960839,1221,754,1975,+
chr1,151248308,0.6346946421880855,846,470,1316,+
chr1,151248354,2.9485849755519338,795,396,1191,+
chr1,151248560,4.129232321562152,940,647,1587,+
chr1,151249084,4.441048711070109,528,487,1015,+
chr1,151249151,2.2486486486486488,779,554,1333,+
chr1,151249152,1.7025113933810898,1119,800,1919,+
chr1,151249379,8.704326828949945,1475,117,1592,+
chr1,151249380,19.54440766205472,1886,154,2040,+
chr1,151249381,47.77995215384337,2339,290,2629,+
chr1,151249382,42.906798199025,4540,475,5015,+
chr1,151249383,36.64812752358901,4855,627,5482,+
chr1,151249385,43.87105483868708,3949,1005,4954,+
chr1,151249386,39.5873511671834,4240,1038,5278,+
chr1,151249387,32.63198876253074,5198,1329,6527,+
chr1,151249389,11.494878567297016,2895,870,3765,+
chr1,151249391,11.646157068534903,4247,1675,5922,+
chr1,151249392,11.623296387621973,3289,1384,4673,+
chr1,151249395,6.432338106751028,1686,1029,2715,+
chr1,151249398,5.015543426672995,1030,1203,2233,+
chr1,151249399,12.855518567449895,3818,3355,7173,+
chr1,151249400,12.855518567449895,3818,3355,7173,+
chr1,151249410,15.832185558837098,5331,8064,13395,+
chr1,151249411,15.832185558837098,5331,8064,13395,+
chr1,151249412,15.832185558837098,5331,8064,13395,+
chr1,151262165,1.3215327587962955,865,770,1635,+
chr1,151262176,0.5421348314606742,578,533,1111,+
chr1,151263970,1.3555814734411102,683,497,1180,+
chr1,151264839,1.1883414263584957,1291,835,2126,+
chr1,151264856,0.5012102317835913,1437,1200,2637,+
chr1,151264857,0.5012102317835913,1437,1200,2637,+
chr1,151264864,0.6536032964752616,847,552,1399,+
chr1,151265167,0.6755218216318786,711,526,1237,+
chr1,151265485,2.514506769825919,1299,704,2003,+
chr1,151265486,2.422078661707975,1781,1047,2828,+
chr1,151266324,2.1594621513944223,656,501,1157,+
chr1,151266325,2.1594621513944223,656,501,1157,+
chr1,151266343,1.725173210161663,746,432,1178,+
chr1,151266346,1.6789366053169734,820,488,1308,+
chr1,151266349,1.5543237250554325,700,491,1191,+
chr1,151266377,2.0127659574468084,687,563,1250,+
chr1,151266545,0.5181388012618297,802,633,1435,+
chr1,151267177,2.4287749287749287,929,647,1576,+
chr1,151267179,2.4287749287749287,929,647,1576,+
chr1,151267180,1.5804268610098906,827,451,1278,+
chr1,151267227,0.5724974849094567,606,496,1102,+
chr1,151267250,0.48067934446800825,1985,1569,3554,+
chr1,151267251,0.5300781201639162,1337,1048,2385,+
chr1,151267267,1.6654829545454546,669,511,1180,+
chr1,151267335,1.72856221792392,765,516,1281,+
chr1,151267389,2.3950620258478206,3139,2559,5698,+
chr1,151399564,1.7289881126158022,2412,1199,3611,+
chr1,151399565,1.9076843519641093,3785,1889,5674,+
chr1,151399566,1.8282763283672565,2992,1478,4470,+
chr1,151399567,1.7515890794816789,2304,1158,3462,+
chr1,151399581,2.0329881089374755,1059,631,1690,+
chr1,151399645,1.460170759616231,2816,1622,4438,+
chr1,151399647,1.574583960631682,6264,4038,10302,+
chr1,151399648,1.606296811122014,4891,3253,8144,+
chr1,151399989,2.7423616845582166,737,518,1255,+
chr1,151400013,2.126664750407205,715,496,1211,+
chr1,151400014,1.516026711185309,1008,598,1606,+
chr1,151400017,1.4583691241373182,1118,688,1806,+
chr1,151400018,1.540841584158416,829,605,1434,+
chr1,151400036,1.4995447095246768,1073,866,1939,+
chr1,151400048,1.36181643468639,1438,891,2329,+
chr1,151400087,1.5940290411416176,1294,1041,2335,+
chr1,151400097,0.6435845213849287,1263,981,2244,+
chr1,151400113,1.4177707373271888,1252,991,2243,+
chr1,151400477,2.568764568764569,1196,1000,2196,+
chr1,151400536,1.8673157484215805,2637,1761,4398,+
chr1,151400798,1.639895577395578,1085,813,1898,+
chr1,151401300,1.4772829509671612,1641,974,2615,+
chr1,151401333,1.5260905199890717,1861,1111,2972,+
chr1,151401544,1.5296340023612747,3791,2463,6254,+
chr1,151401545,1.3345859103139475,6833,5011,11844,+
chr1,151401563,1.3998205741626797,1509,1215,2724,+
chr1,151401834,1.3511659497396424,1612,1261,2873,+
chr1,153642272,2.0573868896971885,627,528,1155,+
chr1,153642341,0.2992337164750958,567,579,1146,+
chr1,153642343,0.33749721995700205,606,573,1179,+
chr1,153645071,4.127698400456712,809,298,1107,+
chr1,153645072,4.555670036434798,1071,385,1456,+
chr1,153645092,6.390338265786568,2209,1889,4098,+
chr1,153645093,6.390338265786567,2209,1889,4098,+
chr1,153645094,6.332150566164949,2383,2086,4469,+
chr1,153645247,0.6036585365853658,626,409,1035,+
chr1,153645510,10.489082310254332,843,652,1495,+
chr1,153661313,0.6340433100626973,678,522,1200,+
chr1,153661333,2.8366311300639664,1166,937,2103,+
chr1,153661334,2.249421963742493,2170,1676,3846,+
chr1,153728734,4.600114744693059,632,580,1212,+
chr1,153728736,3.6450043363950626,705,639,1344,+
chr1,153728739,2.373128536636957,1022,1079,2101,+
chr1,153728741,1.6987421840919006,562,528,1090,+
chr1,153728744,0.4515026192445547,711,584,1295,+
chr1,153728745,0.39762359173136724,853,704,1557,+
chr1,153764707,1.011775878442545,760,584,1344,+
chr1,153764709,1.011775878442545,760,584,1344,+
chr1,153767707,3.792268278351381,638,388,1026,+
chr1,153773803,2.3071479614974093,604,439,1043,+
chr1,153969134,0.4874247228869763,817,595,1412,+
chr1,153990762,1.2705289654508773,4069,4295,8364,+
chr1,153990764,1.2700668045711958,2880,3187,6067,+
chr1,153990978,2.130925360550376,625,469,1094,+
chr1,153991161,0.4748212121647578,3331,2755,6086,+
chr1,153991162,0.4226601991574301,4647,3707,8354,+
chr1,153991163,0.563296285797078,6374,4876,11250,+
chr1,153991164,0.6296826910096309,7397,5293,12690,+
chr1,153991165,0.702884215444297,10954,7349,18303,+
chr1,153991166,0.639920610139143,12761,7779,20540,+
chr1,153991167,0.7180503434282772,15315,9337,24652,+
chr1,153991168,0.628140360350334,12474,7418,19892,+
chr1,153991169,1.4886818495514151,813,689,1502,+
chr1,153991172,0.6452455590386624,1234,550,1784,+
chr1,153995616,1.6485733603786343,621,434,1055,+
chr1,154225083,0.6314496314496315,1027,887,1914,+
chr1,154225084,0.6314496314496315,1027,887,1914,+
chr1,154225089,1.634244639206117,1033,845,1878,+
chr1,154227291,2.838994565217392,596,459,1055,+
chr1,154227292,2.838994565217392,596,459,1055,+
chr1,154227328,2.022573363431152,559,442,1001,+
chr1,154234600,1.9885892116182575,709,481,1190,+
chr1,154234676,2.2691511387163557,547,482,1029,+
chr1,154237039,2.296797671924624,752,482,1234,+
chr1,154251218,4.719490083951735,689,438,1127,+
chr1,154251292,2.304326204661879,791,577,1368,+
chr1,154253912,0.3481243027741991,615,491,1106,+
chr1,154255725,1.2942173673387747,704,540,1244,+
chr1,154259964,2.4698412382823562,610,453,1063,+
chr1,154261052,2.5583141441915696,916,517,1433,+
chr1,154261054,3.31924882629108,706,354,1060,+
chr1,154263192,1.4985122051007294,573,470,1043,+
chr1,154272640,0.6336159377086442,2172,917,3089,+
chr1,154272648,1.988907413452377,2650,1290,3940,+
chr1,154272662,2.4626784352184807,903,436,1339,+
chr1,154272677,1.8572551662174301,718,423,1141,+
chr1,154272713,2.0965571119645467,1319,884,2203,+
chr1,154272714,1.4944177180720706,783,478,1261,+
chr1,154272722,1.700041753653445,782,478,1260,+
chr1,154272750,1.9362130202904837,1603,1028,2631,+
chr1,154273457,1.6930064516129033,993,624,1617,+
chr1,154273459,0.6753482737734706,1114,761,1875,+
chr1,154273502,1.739845261121857,770,516,1286,+
chr1,154273787,2.113756613756613,1033,615,1648,+
chr1,154273848,1.53798543997159,1143,772,1915,+
chr1,154273858,1.7348927875243665,889,702,1591,+
chr1,154273903,1.6918789808917196,849,627,1476,+
chr1,154275157,2.2005988023952097,629,500,1129,+
chr1,154275165,1.6031052886948085,825,686,1511,+
chr1,154275208,1.5092707045735476,998,808,1806,+
chr1,154275239,1.976634808853119,1540,993,2533,+
chr1,154275456,0.5826086956521739,870,597,1467,+
chr1,154275465,0.5417444836411427,1067,710,1777,+
chr1,154275629,2.121328903654485,938,601,1539,+
chr1,154974691,0.9811762939936036,1426,1050,2476,+
chr1,154974692,1.048978817728151,1608,1382,2990,+
chr1,154974693,0.9565281247319423,4102,3074,7176,+
chr1,154974720,1.832004851223012,2352,1688,4040,+
chr1,154979085,1.762222222222222,792,431,1223,+
chr1,154979092,1.6273653566229984,773,686,1459,+
chr1,154979098,1.5381200375650987,1125,662,1787,+
chr1,154979102,1.6198769302217575,871,593,1464,+
chr1,154979103,2.141681079211345,1345,825,2170,+
chr1,154979118,2.567057177828292,1107,816,1923,+
chr1,154984004,0.8628841607565012,729,469,1198,+
chr1,154984006,0.8628841607565012,729,469,1198,+
chr1,154988541,2.285238091628435,974,791,1765,+
chr1,155052692,0.7070574901027884,641,513,1154,+
chr1,155053965,2.7987799925272516,687,503,1190,+
chr1,155054314,3.2152958152958147,856,494,1350,+
chr1,155054315,3.2152958152958147,856,494,1350,+
chr1,155054451,2.3920361749522847,1100,737,1837,+
chr1,155054452,2.7752808988764044,584,444,1028,+
chr1,155055961,3.0294117647058827,823,679,1502,+
chr1,155055962,2.04390726957781,1749,1360,3109,+
chr1,155055963,3.0294117647058827,823,679,1502,+
chr1,155056217,2.1219969478962284,1057,694,1751,+
chr1,155056218,2.1219969478962284,1057,694,1751,+
chr1,155056438,0.912240021912618,1450,1047,2497,+
chr1,155056997,2.7070388465294113,634,494,1128,+
chr1,155057280,0.2741828768029641,591,457,1048,+
chr1,155057282,0.2741828768029641,591,457,1048,+
chr1,155057313,1.4569921370910535,2242,1562,3804,+
chr1,155057314,1.168710416385932,1651,1085,2736,+
chr1,155057868,4.110169639470976,737,512,1249,+
chr1,155057905,2.882425699737572,823,599,1422,+
chr1,155058082,0.31326420058814425,758,496,1254,+
chr1,155058083,1.4100285173854974,841,639,1480,+
chr1,155058275,1.9273034657650043,683,337,1020,+
chr1,155060221,2.6155223299808426,690,510,1200,+
chr1,155062342,4.2655318545635525,790,487,1277,+
chr1,155062690,5.329044117647058,1114,169,1283,+
chr1,155062692,6.054542714394016,934,142,1076,+
chr1,155062698,20.843540183121572,2355,1216,3571,+
chr1,155062699,18.566614648721956,3578,2391,5969,+
chr1,155062700,18.566614648721956,3578,2391,5969,+
chr1,155062701,16.37753892909695,2807,2235,5042,+
chr1,155062709,3.507764025225361,1056,1136,2192,+
chr1,155062710,3.046698842615017,1248,1250,2498,+
chr1,155062717,2.5675550766171726,485,654,1139,+
chr1,155062721,3.6715424616149126,1178,1635,2813,+
chr1,155128030,2.5036443148688052,686,342,1028,+
chr1,155128054,2.2342401500938087,1400,819,2219,+
chr1,155128055,2.2342401500938087,1400,819,2219,+
chr1,155131343,1.8890611776483595,1155,894,2049,+
chr1,155131357,1.6474810400866742,810,567,1377,+
chr1,155131444,0.33312883435582824,542,488,1030,+
chr1,155131451,3.5747641509433965,658,423,1081,+
chr1,155131523,1.1328369161216831,1047,680,1727,+
chr1,155131537,2.0661824051654563,1279,884,2163,+
chr1,155131538,1.990787620406871,1966,1364,3330,+
chr1,155131564,1.7105618787350971,1919,1490,3409,+
chr1,155131565,1.6023819173947678,3163,2479,5642,+
chr1,155131607,1.5221734307442647,1594,1225,2819,+
chr1,155134293,2.8045343137254903,596,407,1003,+
chr1,155134294,1.1122120087192326,1442,1053,2495,+
chr1,155134298,2.2886847271391453,1318,934,2252,+
chr1,155134343,2.4848790322580645,679,495,1174,+
chr1,155134427,2.1323076923076925,692,424,1116,+
chr1,155134461,0.6311576354679802,1024,783,1807,+
chr1,155134485,2.1377536836252435,1182,871,2053,+
chr1,155134486,2.1377536836252435,1182,871,2053,+
chr1,155134552,2.5041942604856517,708,452,1160,+
chr1,155134720,0.6150743801652893,885,604,1489,+
chr1,155134761,1.7564209274673008,952,579,1531,+
chr1,155135892,3.0498448932137188,750,495,1245,+
chr1,155135908,0.33966993984021765,671,584,1255,+
chr1,155136312,1.1818739735144401,826,608,1434,+
chr1,155136319,0.6180000000000001,617,474,1091,+
chr1,155136320,1.1016792105058373,944,698,1642,+
chr1,155136934,1.896754429541315,738,548,1286,+
chr1,155137574,0.3729874776386404,694,519,1213,+
chr1,155137995,0.5649814918107602,618,480,1098,+
chr1,155138081,2.9744453248811413,857,630,1487,+
chr1,155138082,0.4063670411985019,619,533,1152,+
chr1,155138287,2.6066433566433567,638,395,1033,+
chr1,155138410,2.1893617021276595,685,469,1154,+
chr1,155138599,2.786666666666666,816,644,1460,+
chr1,155138601,2.786666666666666,816,644,1460,+
chr1,155138757,1.9864026012415017,639,397,1036,+
chr1,155138759,2.1272317233602704,1028,625,1653,+
chr1,155138760,2.198418544481227,1719,1066,2785,+
chr1,155209315,2.0169621435092138,874,764,1638,+
chr1,155209317,0.9980005515719801,578,517,1095,+
chr1,155210589,1.687088274044796,590,413,1003,+
chr1,155212138,1.2028534483896078,676,527,1203,+
chr1,155212409,1.9035733053074093,804,518,1322,+
chr1,155308858,1.230765161522574,1404,915,2319,+
chr1,155308860,1.0234009360374416,983,640,1623,+
chr1,155308866,0.8634415743933619,1299,838,2137,+
chr1,155308867,1.538670257583107,1169,832,2001,+
chr1,155308868,0.756123750893194,2801,1854,4655,+
chr1,155308869,0.6650442477876106,1502,1016,2518,+
chr1,155308872,2.2722812097812097,688,517,1205,+
chr1,155308881,1.5069018404907977,916,651,1567,+
chr1,155308913,0.6837701612903225,968,743,1711,+
chr1,155308915,1.8612686952037127,1202,830,2032,+
chr1,155308926,1.4893434262092662,2521,1773,4294,+
chr1,155308927,1.6483939210334286,4864,3359,8223,+
chr1,155308935,1.2920604914933838,1366,1057,2423,+
chr1,155308943,1.058214177424376,8119,6150,14269,+
chr1,155308944,1.5803489439853076,1720,1088,2808,+
chr1,155308945,1.092548315418062,10290,7699,17989,+
chr1,155310060,1.1349789916907271,4073,2795,6868,+
chr1,155310061,1.366609165579756,2851,1892,4743,+
chr1,155310062,0.6093210633614634,1530,1218,2748,+
chr1,155310064,1.7102652656330373,2659,1755,4414,+
chr1,155310077,0.7407354995269805,2913,2018,4931,+
chr1,155310078,0.6722354053587176,3438,2221,5659,+
chr1,155310079,1.4725615170590207,3979,2980,6959,+
chr1,155310084,1.6220001656638985,4307,3361,7668,+
chr1,155310089,0.6435679807967272,14443,9852,24295,+
chr1,155312281,1.379690813264938,2118,1276,3394,+
chr1,155312352,1.491400355479355,3470,2855,6325,+
chr1,155317968,1.5657417343757982,1914,1185,3099,+
chr1,155318007,0.7494212353993477,1867,1461,3328,+
chr1,155318193,1.7023578026251824,2029,1209,3238,+
chr1,155318223,1.40679631591029,2196,1866,4062,+
chr1,155318732,1.2606601092896177,2485,1524,4009,+
chr1,155318736,1.4907885040530584,2022,1592,3614,+
chr1,155318871,1.3474792870988217,2533,1802,4335,+
chr1,155318907,1.7610078490210423,2629,1966,4595,+
chr1,155319614,1.3442079775710465,2343,1651,3994,+
chr1,155319792,1.7549677393817045,1626,1202,2828,+
chr1,155319794,1.217508748235005,3215,2326,5541,+
chr1,155319795,1.0421972008839313,3094,2209,5303,+
chr1,155319797,0.7105028173784524,1774,1381,3155,+
chr1,155319906,1.5910373654291463,2871,1941,4812,+
chr1,155319911,1.5284962970913383,1691,1330,3021,+
chr1,155320408,1.4925153989399802,1760,1073,2833,+
chr1,155320410,0.4816574009103831,1408,1145,2553,+
chr1,155717027,2.3996681150430876,690,456,1146,+
chr1,155721580,0.6214655172413793,800,463,1263,+
chr1,155725416,1.5923190546528805,769,676,1445,+
chr1,155725446,1.6190746753246754,980,879,1859,+
chr1,155726007,2.7352472089314195,881,626,1507,+
chr1,155727614,1.8164864014775934,1832,1292,3124,+
chr1,155727654,1.4964859437751006,1354,995,2349,+
chr1,155729223,4.279835390946502,1039,728,1767,+
chr1,155729225,4.279835390946502,1039,728,1767,+
chr1,155729239,1.6069017254313582,832,601,1433,+
chr1,155729272,2.077167019027484,654,472,1126,+
chr1,155729333,2.718637992831541,665,557,1222,+
chr1,155731385,0.47081891580161467,627,509,1136,+
chr1,155736994,2.1127405801030092,1320,1053,2373,+
chr1,155736995,1.364005382241499,2613,1950,4563,+
chr1,155738173,3.1294117647058832,930,594,1524,+
chr1,155738193,1.744420895150231,953,616,1569,+
chr1,155738240,1.6845809810103376,717,592,1309,+
chr1,155738280,1.965913043478261,627,574,1201,+
chr1,155738393,1.4753623188405798,1017,689,1706,+
chr1,155751093,3.0873786407766985,794,411,1205,+
chr1,155751094,3.6564625850340136,824,461,1285,+
chr1,155751096,3.163227608578122,1150,715,1865,+
chr1,155751097,2.5386781894291834,1052,709,1761,+
chr1,155751098,3.0395017793594308,875,561,1436,+
chr1,156054838,1.8412002258151963,609,392,1001,+
chr1,156055266,2.508807588075881,643,368,1011,+
chr1,156055268,2.508807588075881,643,368,1011,+
chr1,156114710,0.8171882565071402,825,328,1153,+
chr1,156114731,2.163552402109028,1533,800,2333,+
chr1,156114733,2.163552402109028,1533,800,2333,+
chr1,156114966,2.1756521739130434,694,374,1068,+
chr1,156115009,2.1346607188191347,828,706,1534,+
chr1,156115011,2.1346607188191347,828,706,1534,+
chr1,156115024,2.5429184549356223,552,465,1017,+
chr1,156115050,1.5968545624416068,585,493,1078,+
chr1,156115074,0.5971345727443289,777,571,1348,+
chr1,156115149,0.5615487674169346,1102,621,1723,+
chr1,156115159,1.6121708240018533,613,562,1175,+
chr1,156115194,1.6720076216871649,714,501,1215,+
chr1,156115199,1.9011781255494988,635,516,1151,+
chr1,156115240,1.8639402718965896,777,640,1417,+
chr1,156130716,1.76125878045341,1809,1236,3045,+
chr1,156130754,0.568378560215295,767,636,1403,+
chr1,156134426,1.4879321027299084,1857,1312,3169,+
chr1,156134433,1.8461538461538454,1427,883,2310,+
chr1,156134469,1.7294328428349046,997,872,1869,+
chr1,156134847,1.777305074257426,998,807,1805,+
chr1,156134871,2.0781399808245444,764,595,1359,+
chr1,156134942,1.3547829046255069,1425,952,2377,+
chr1,156135994,1.7962851102385984,1219,615,1834,+
chr1,156136054,1.7670280789546846,907,653,1560,+
chr1,156136078,1.5510244758032365,948,677,1625,+
chr1,156136303,1.8477346278317157,600,514,1114,+
chr1,156136306,1.4993306559571618,1279,746,2025,+
chr1,156136307,0.4525490196078432,576,509,1085,+
chr1,156136404,1.6627140974967063,1261,758,2019,+
chr1,156136421,1.4370580808080808,1338,863,2201,+
chr1,156136964,1.6833074305036682,2751,2064,4815,+
chr1,156137171,1.8073807380738076,1003,605,1608,+
chr1,156137211,2.1230034177303483,2434,1457,3891,+
chr1,156137212,2.1230034177303483,2434,1457,3891,+
chr1,156137654,1.884656001750975,1235,819,2054,+
chr1,156137809,1.7759330253566767,1055,731,1786,+
chr1,156138702,6.5013864817916085,1034,808,1842,+
chr1,156138703,7.065202864877553,1960,1479,3439,+
chr1,156138704,7.065202864877553,1960,1479,3439,+
chr1,156139196,4.830280690463619,1115,917,2032,+
chr1,156139311,2.1068198702380303,1236,863,2099,+
chr1,156139312,1.8930629086002995,1417,1011,2428,+
chr1,156139327,1.6324468085106385,557,469,1026,+
chr1,156139330,1.291768137489869,980,790,1770,+
chr1,156139336,1.7703296703296703,715,636,1351,+
chr1,156139747,0.4323834520684913,628,380,1008,+
chr1,156139795,12.930164569938068,2166,1250,3416,+
chr1,156139798,3.594963755837769,2182,1407,3589,+
chr1,156139805,5.720560637905184,2975,2278,5253,+
chr1,156139806,5.067862833205407,3695,2739,6434,+
chr1,156139907,3.8194895056391944,1348,520,1868,+
chr1,156139913,10.849160615594215,1734,821,2555,+
chr1,156139928,5.466284987277354,660,523,1183,+
chr1,156139929,4.153373645941791,1808,1197,3005,+
chr1,156139930,3.307562073112929,2390,1540,3930,+
chr1,156139932,1.7638551288283908,630,373,1003,+
chr1,156139980,12.887072236610502,3183,1914,5097,+
chr1,156139981,11.997813103682976,3492,2091,5583,+
chr1,156139982,11.997813103682976,3492,2091,5583,+
chr1,156139983,7.2980373535929095,940,485,1425,+
chr1,156139986,7.440094197599897,1048,761,1809,+
chr1,156139987,7.6705737027749805,1586,1301,2887,+
chr1,156139993,3.8003886015552073,557,498,1055,+
chr1,156213012,3.0161445594661753,757,404,1161,+
chr1,156232354,2.1083325123955587,793,545,1338,+
chr1,156236307,0.9181395348837208,657,429,1086,+
chr1,156236309,0.9181395348837208,657,429,1086,+
chr1,156236442,8.861301639735432,600,519,1119,+
chr1,156591905,0.47599142673757566,852,492,1344,+
chr1,156591946,2.670336589401081,1102,757,1859,+
chr1,156592424,0.9996923076923075,721,649,1370,+
chr1,156592425,0.9996923076923075,721,649,1370,+
chr1,156592575,1.444219889439493,1836,1390,3226,+
chr1,156592583,1.7879194630872484,665,595,1260,+
chr1,156592595,1.847271800101989,1126,741,1867,+
chr1,156592656,1.1832434601534239,1852,1347,3199,+
chr1,156593453,1.8637653736991489,787,603,1390,+
chr1,156593893,1.3273265046304386,1638,1137,2775,+
chr1,156593951,0.4457859848484849,806,527,1333,+
chr1,156593965,1.471698113207547,987,635,1622,+
chr1,156594098,22.528372588973436,3310,2836,6146,+
chr1,156594099,22.528372588973436,3310,2836,6146,+
chr1,156768104,4.640179501652639,580,514,1094,+
chr1,156782311,2.815367400223797,628,382,1010,+
chr1,156782312,2.815367400223797,628,382,1010,+
chr1,156786824,4.023770143041019,715,536,1251,+
chr1,156794783,1.1956371671681862,584,474,1058,+
chr1,156800398,0.9930595716491375,720,537,1257,+
chr1,156800531,6.547065337763013,738,386,1124,+
chr1,159010009,0.6847484380983555,1134,740,1874,+
chr1,159018537,5.44774011299435,550,471,1021,+
chr1,159018573,1.7822586391164943,1136,801,1937,+
chr1,159018574,1.7822586391164943,1136,801,1937,+
chr1,159018576,0.5460404760881709,705,628,1333,+
chr1,159018617,1.8572560975609755,780,655,1435,+
chr1,159018618,0.41601708974388113,1355,1113,2468,+
chr1,159018621,0.6394489965562284,1523,1202,2725,+
chr1,159018623,1.4414533403775034,1224,885,2109,+
chr1,159020348,2.5306927789161495,830,535,1365,+
chr1,159053638,4.592130518234165,724,520,1244,+
chr1,159053639,4.592130518234165,724,520,1244,+
chr1,159782423,2.67260579064588,599,448,1047,+
chr1,159782424,2.67260579064588,599,448,1047,+
chr1,160317456,0.4946366318047734,1053,677,1730,+
chr1,160317458,0.4946366318047734,1053,677,1730,+
chr1,160317463,2.0500000000000003,655,575,1230,+
chr1,160317465,2.0527919916562167,1214,1037,2251,+
chr1,160317466,0.3873150532747564,766,482,1248,+
chr1,160343442,4.73361851784359,1011,806,1817,+
chr1,160349642,1.9616201526566235,793,699,1492,+
chr1,160350107,2.8981808548216184,886,595,1481,+
chr1,160350109,2.3025612158739097,605,417,1022,+
chr1,160350146,0.9599024984765389,715,546,1261,+
chr1,160350147,0.9599024984765389,715,546,1261,+
chr1,160351765,1.0541965657030512,726,537,1263,+
chr1,160352111,2.8101781170483457,752,392,1144,+
chr1,160352112,2.8101781170483457,752,392,1144,+
chr1,160355870,1.1825748817111383,658,449,1107,+
chr1,160357042,0.4455495534468468,769,577,1346,+
chr1,160357122,1.4102597760688698,1240,855,2095,+
chr1,160357123,1.145076566951567,886,575,1461,+
chr1,160358813,10.790687804317106,2338,2739,5077,+
chr1,160358814,10.790687804317106,2338,2739,5077,+
chr1,160895825,1.961863173216885,585,457,1042,+
chr1,161157261,1.0799517437422856,845,593,1438,+
chr1,161157633,4.1567955112219455,634,400,1034,+
chr1,161157673,2.6549019607843136,676,424,1100,+
chr1,161158494,1.9024122807017543,693,455,1148,+
chr1,161158544,0.5941955480417019,658,506,1164,+
chr1,161158565,1.7896103896103897,635,439,1074,+
chr1,161158574,1.7970990804519178,1090,847,1937,+
chr1,161202382,0.9974077178175921,733,528,1261,+
chr1,161202452,1.0759188606749304,1131,720,1851,+
chr1,161202458,1.262176202700491,1348,885,2233,+
chr1,161202465,1.5470540098199674,994,519,1513,+
chr1,161203508,0.5967542201655478,653,457,1110,+
chr1,161206530,2.273684210526316,719,474,1193,+
chr1,161206571,1.6702089206968844,721,476,1197,+
chr1,161206573,2.0238132055048705,817,668,1485,+
chr1,161206575,1.227527230273169,3269,2551,5820,+
chr1,161206576,1.0263296850998465,1401,991,2392,+
chr1,161206577,1.249302325581395,1342,1074,2416,+
chr1,161206578,1.0181818181818183,923,725,1648,+
chr1,161206580,2.092096808738488,887,608,1495,+
chr1,161209862,0.4111485886738861,771,654,1425,+
chr1,161209863,0.4111485886738861,771,654,1425,+
chr1,161209876,1.851069518716577,601,439,1040,+
chr1,161209903,0.5567427735912721,659,522,1181,+
chr1,161210328,0.9901075889955954,1713,1258,2971,+
chr1,161210329,0.9901075889955954,1713,1258,2971,+
chr1,161210364,1.9848286875725898,738,655,1393,+
chr1,161210647,4.219428571428572,567,499,1066,+
chr1,161212370,2.629206730769231,624,383,1007,+
chr1,161212387,1.7775590551181102,644,507,1151,+
chr1,161212406,2.088441678803125,955,580,1535,+
chr1,161212408,3.1255907491201604,817,662,1479,+
chr1,161212412,2.2562893081761013,573,476,1049,+
chr1,161213395,1.9439842209072977,895,584,1479,+
chr1,161213431,1.9554817275747511,980,601,1581,+
chr1,161213652,1.2908941495588502,1809,1141,2950,+
chr1,161213664,0.6533865804570378,1329,808,2137,+
chr1,161213703,1.5887105866436166,918,648,1566,+
chr1,161213708,1.6157629462084,2576,1479,4055,+
chr1,161213717,0.5748627357364525,1046,709,1755,+
chr1,161213870,1.681228338840977,1226,652,1878,+
chr1,161213873,1.6214156118822936,2745,1526,4271,+
chr1,161213875,1.6214156118822936,2745,1526,4271,+
chr1,161213891,0.8298561208309249,3617,1953,5570,+
chr1,161214209,2.237113463542051,1126,745,1871,+
chr1,161323645,1.533437709684634,856,525,1381,+
chr1,161323646,1.533437709684634,856,525,1381,+
chr1,161323647,1.533437709684634,856,525,1381,+
chr1,161328455,2.238295318127251,677,391,1068,+
chr1,161362818,18.19870136441898,4840,901,5741,+
chr1,161362819,17.380158760171355,5472,1064,6536,+
chr1,161362820,17.380158760171355,5472,1064,6536,+
chr1,161362821,9.990009704863029,2192,525,2717,+
chr1,161362823,9.0265340675117,3735,950,4685,+
chr1,161362824,13.489945823457633,4900,1529,6429,+
chr1,161362825,12.699982940784516,5757,1796,7553,+
chr1,161362826,14.609646029693637,4513,1513,6026,+
chr1,161362833,13.732357657942597,2994,1764,4758,+
chr1,161362834,12.565385761096215,1047,745,1792,+
chr1,161362835,13.868209477157109,4670,3566,8236,+
chr1,161362837,18.651950884341524,3146,2822,5968,+
chr1,161362841,7.007389534584505,2494,2985,5479,+
chr1,161362842,7.427096773863188,2772,3312,6084,+
chr1,161362846,0.11338263012904162,390,626,1016,+
chr1,161362952,3.6859045504994445,778,1937,2715,+
chr1,161362953,2.8348421525522185,1645,4113,5758,+
chr1,161362954,3.007970019797297,1207,3036,4243,+
chr1,161362955,2.052309273352785,737,1950,2687,+
chr1,161362957,0.196376376796436,704,1601,2305,+
chr1,161362958,0.17965736941211843,734,1422,2156,+
chr1,161362979,0.22453704397708918,1299,2670,3969,+
chr1,161362983,0.25665237595078155,657,982,1639,+
chr1,161362989,0.9571118349619978,816,920,1736,+
chr1,161362991,0.7233942627378047,1199,1587,2786,+
chr1,161362992,0.45180647896869663,994,2038,3032,+
chr1,161362995,0.49831929283337345,2013,2393,4406,+
chr1,161362996,0.4828493265915997,3131,4630,7761,+
chr1,161363028,0.5561434450323339,1117,1052,2169,+
chr1,161751897,1.5849477560462084,1014,732,1746,+
chr1,161752373,1.6820286058476697,607,402,1009,+
chr1,161959350,15.744564906760361,548,1480,2028,+
chr1,161959351,16.53451955720543,640,1615,2255,+
chr1,161959352,15.744564906760361,548,1480,2028,+
chr1,162566068,2.788182856561352,648,460,1108,+
chr1,162581299,2.243043753155777,1006,653,1659,+
chr1,162581300,2.030985915492958,720,425,1145,+
chr1,162587497,0.48412437408504133,708,448,1156,+
chr1,162587552,2.5270448100976917,726,459,1185,+
chr1,162587556,2.404857142857143,885,559,1444,+
chr1,162587557,2.404857142857143,885,559,1444,+
chr1,162599624,0.6329218106995884,768,539,1307,+
chr1,162776148,1.126776051448528,1182,721,1903,+
chr1,162776150,0.3949125022550965,795,481,1276,+
chr1,162778712,0.39068054850177764,904,715,1619,+
chr1,162778713,0.6884161614417482,1493,1158,2651,+
chr1,162778714,0.39068054850177764,904,715,1619,+
chr1,162778715,1.1555033294163728,589,443,1032,+
chr1,162780122,0.4646564814527875,881,528,1409,+
chr1,162780123,0.9320354476310097,1405,842,2247,+
chr1,162780125,1.1387272485718078,973,578,1551,+
chr1,162780132,2.7762151958470973,1145,814,1959,+
chr1,162780134,2.7762151958470973,1145,814,1959,+
chr1,162780139,1.9084287200832464,1309,1084,2393,+
chr1,162780141,1.9084287200832464,1309,1084,2393,+
chr1,162780143,0.7068755377114999,938,633,1571,+
chr1,162780908,2.632809170928212,618,434,1052,+
chr1,162781040,2.928345580325658,682,491,1173,+
chr1,162782254,0.38032429216046015,766,468,1234,+
chr1,162782271,1.9711566968101895,2097,1219,3316,+
chr1,162782276,2.4518853695324285,1015,662,1677,+
chr1,162782299,1.9686940966010733,1704,1117,2821,+
chr1,162782310,0.662377337530087,1589,981,2570,+
chr1,162782325,2.237638159345821,5827,4505,10332,+
chr1,162782327,1.885572080375394,9141,6785,15926,+
chr1,162782701,2.7839390054557254,703,481,1184,+
chr1,162784269,2.6340943501191063,629,440,1069,+
chr1,162784319,4.311835161106275,643,445,1088,+
chr1,162784930,1.7404761904761905,644,503,1147,+
chr1,162785514,1.8810438534333545,983,537,1520,+
chr1,162785518,3.158204562178071,927,603,1530,+
chr1,162785520,2.8369863013698633,1416,948,2364,+
chr1,162785521,2.556256950932424,1262,828,2090,+
chr1,162785530,2.2235332677810558,847,564,1411,+
chr1,162785532,1.436538629100728,2109,1632,3741,+
chr1,162785534,0.9599508886810104,1262,1068,2330,+
chr1,162785565,0.5044285714285714,641,399,1040,+
chr1,163326037,1.1363636363636365,545,461,1006,+
chr1,163326039,1.1363636363636365,545,461,1006,+
chr1,163328273,3.1261882941745793,607,395,1002,+
chr1,163328292,2.7474740446967343,800,583,1383,+
chr1,165631255,2.3320754716981136,720,370,1090,+
chr1,165631256,0.738161109735319,2646,2088,4734,+
chr1,165631261,1.7163079942433208,2133,1479,3612,+
chr1,165631272,1.610457516339869,1287,1034,2321,+
chr1,165631275,0.7274739030332834,1414,1077,2491,+
chr1,165649844,1.6198354374725206,3051,1829,4880,+
chr1,165649845,1.5624469611673775,6021,4210,10231,+
chr1,165654281,1.6068566762874066,3600,2723,6323,+
chr1,165654283,1.6068566762874066,3600,2723,6323,+
chr1,165655455,1.7194189851810775,1306,988,2294,+
chr1,165655462,1.7872146362494312,3996,3259,7255,+
chr1,165655463,1.7913377936555663,4265,3270,7535,+
chr1,165827905,0.3297560975609756,844,614,1458,+
chr1,165827906,0.3297560975609756,844,614,1458,+
chr1,165896212,1.888026100106556,619,446,1065,+
chr1,165896233,2.4552397520250775,1203,731,1934,+
chr1,165896234,2.504545454545455,873,505,1378,+
chr1,165896301,0.5166210670314637,580,429,1009,+
chr1,165903215,0.6441498244776933,699,480,1179,+
chr1,165903223,1.7622377622377625,737,532,1269,+
chr1,165903231,1.681245074862096,752,563,1315,+
chr1,165905958,0.5613829093281149,661,437,1098,+
chr1,165907991,3.641231593038822,543,497,1040,+
chr1,165908021,1.5759258231081006,886,580,1466,+
chr1,166853505,26.77997592244808,601,630,1231,+
chr1,166853506,18.487549730312207,1030,1152,2182,+
chr1,167787948,2.0638408924191367,666,513,1179,+
chr1,167788028,1.8954640582049112,589,454,1043,+
chr1,167789319,1.2360463366932453,631,390,1021,+
chr1,167789321,1.2360463366932453,631,390,1021,+
chr1,167789394,8.739137852550503,1102,715,1817,+
chr1,167789395,9.301680913158618,958,599,1557,+
chr1,167789991,1.3424790227946637,644,410,1054,+
chr1,168002499,1.6136746895600182,830,592,1422,+
chr1,168002519,1.7587548638132295,1016,770,1786,+
chr1,168002528,1.7546583850931678,1129,965,2094,+
chr1,168063665,1.1017639111289033,701,548,1249,+
chr1,168068357,2.7235732009925564,587,464,1051,+
chr1,168068358,2.7235732009925564,587,464,1051,+
chr1,168068395,0.35369002582117337,588,426,1014,+
chr1,168068432,3.9590075512405614,733,617,1350,+
chr1,168183903,5.503949942302201,594,422,1016,+
chr1,168183909,2.282634957174056,587,428,1015,+
chr1,168184786,2.0888392706846464,1386,930,2316,+
chr1,168184787,2.0407966714882138,1389,907,2296,+
chr1,168184842,2.256660195778778,941,780,1721,+
chr1,168191397,0.5441004900054446,822,558,1380,+
chr1,168200060,2.8181818181818183,867,538,1405,+
chr1,168200079,2.0570880147788837,2792,1947,4739,+
chr1,168200080,1.9212735624901,1865,1283,3148,+
chr1,168200087,2.3043893129771,804,523,1327,+
chr1,168200099,1.657845637358873,2047,1546,3593,+
chr1,168200126,0.3893981321342097,1184,825,2009,+
chr1,168200127,1.4239491150442478,1625,1355,2980,+
chr1,168200130,1.3919105050501923,3916,3136,7052,+
chr1,168200135,0.7019784970073155,1550,1040,2590,+
chr1,168200136,1.4198855507868386,1984,1863,3847,+
chr1,168200141,1.6147663910786385,2171,2228,4399,+
chr1,168200142,2.1457754025202447,1952,1390,3342,+
chr1,168200963,5.951458784736642,850,663,1513,+
chr1,169111387,1.9542946536139645,668,490,1158,+
chr1,169111395,2.07215422397579,797,593,1390,+
chr1,169111463,2.5679522497704315,951,725,1676,+
chr1,169111464,2.5679522497704315,951,725,1676,+
chr1,169111470,2.0726316149089548,1045,886,1931,+
chr1,169111472,2.0726316149089548,1045,886,1931,+
chr1,169127329,2.2766169154228857,623,401,1024,+
chr1,169130048,2.351384292097039,843,585,1428,+
chr1,169130059,1.28373362519704,810,633,1443,+
chr1,169131535,1.8108050697443887,672,486,1158,+
chr1,169131668,0.5182932623776489,908,618,1526,+
chr1,169132171,23.103280261829287,1455,1594,3049,+
chr1,169132172,21.08221648567499,1656,1935,3591,+
chr1,169132173,21.082216485674987,1656,1935,3591,+
chr1,169132185,0.3712526113025313,621,898,1519,+
chr1,169132186,0.3796469487958849,432,610,1042,+
chr1,169132190,0.2821833112220127,668,1380,2048,+
chr1,169132191,0.2821833112220127,668,1380,2048,+
chr1,169132211,0.450278706800446,576,689,1265,+
chr1,169132212,0.2292993630573249,431,941,1372,+
chr1,169132213,0.3876716418794534,1083,1437,2520,+
chr1,169132214,0.2292993630573249,431,941,1372,+
chr1,171527813,3.534270272407336,654,390,1044,+
chr1,171532906,2.829422739470825,761,490,1251,+
chr1,171541561,2.1462668956070234,701,566,1267,+
chr1,171541577,2.1778967495219885,677,522,1199,+
chr1,171541578,1.3702558726770941,1241,962,2203,+
chr1,171591609,2.1629256965944266,620,407,1027,+
chr1,171591611,2.1629256965944266,620,407,1027,+
chr1,171591896,0.2415803438701175,472,805,1277,+
chr1,171591897,0.26232114467408585,417,645,1062,+
chr1,171591898,0.26232114467408585,417,645,1062,+
chr1,171591923,0.1311646226680213,344,692,1036,+
chr1,171591932,0.322187306784518,476,679,1155,+
chr1,171783887,2.2752313493044074,1006,759,1765,+
chr1,171783889,2.00210101010101,651,494,1145,+
chr1,173477334,0.9875021400445128,617,530,1147,+
chr1,173477336,0.9875021400445128,617,530,1147,+
chr1,173477340,1.9390059786218974,697,570,1267,+
chr1,173477385,1.2173605038575208,1169,945,2114,+
chr1,173477411,1.4148788883384777,1887,1140,3027,+
chr1,173477433,1.5087179226083043,2908,2200,5108,+
chr1,173477445,1.3914186160279174,3727,2495,6222,+
chr1,173481325,1.890625,1451,1103,2554,+
chr1,173481354,1.3426715979526282,3172,2500,5672,+
chr1,173481357,1.4498184036793365,3810,2444,6254,+
chr1,173481374,1.2929811524690942,2419,1440,3859,+
chr1,173481386,1.6431667087435833,1881,1397,3278,+
chr1,173481407,1.3869557411193172,6129,4125,10254,+
chr1,173481423,1.2616439412361289,3430,2425,5855,+
chr1,173485478,1.4239724612736662,2223,1749,3972,+
chr1,173486258,1.3735198319685853,2438,1728,4166,+
chr1,173486275,1.3526247288503257,3536,2304,5840,+
chr1,173487772,0.6634666666666666,2487,1874,4361,+
chr1,173488123,2.1555607634588823,1769,1238,3007,+
chr1,173488254,1.8755401976065997,1503,1091,2594,+
chr1,173488292,2.2552910052910047,824,566,1390,+
chr1,173488326,1.7062399596812294,1775,1197,2972,+
chr1,173488328,0.5530487804878049,906,614,1520,+
chr1,173488417,1.3779472233932706,2373,1838,4211,+
chr1,173488423,1.3951190834308342,5349,3864,9213,+
chr1,173488472,1.5217325227963523,1177,986,2163,+
chr1,173488608,1.5416847847570856,999,616,1615,+
chr1,173830678,0.7609287691249987,823,499,1322,+
chr1,173836954,0.3661691542288557,643,401,1044,+
chr1,173836955,0.3661691542288557,643,401,1044,+
chr1,173853820,1.3575059112552093,1023,664,1687,+
chr1,173857773,2.3169077443967145,683,397,1080,+
chr1,175000120,1.7422633983143536,676,470,1146,+
chr1,175004621,0.4396355353075169,578,438,1016,+
chr1,175004626,2.120646766169154,769,535,1304,+
chr1,175004627,2.120646766169154,769,535,1304,+
chr1,175004649,1.8902986031013715,589,458,1047,+
chr1,175004650,0.6304424950009675,1116,837,1953,+
chr1,175004663,2.0002059166723867,1266,856,2122,+
chr1,175006828,3.0024154589371985,677,413,1090,+
chr1,175009939,1.3193137329190976,619,460,1079,+
chr1,175009966,1.7178612059158134,754,585,1339,+
chr1,175009979,1.7688139674894643,677,452,1129,+
chr1,175009991,2.1396844660194176,652,514,1166,+
chr1,175010196,1.554229554229554,860,538,1398,+
chr1,175010488,1.133053942136554,705,543,1248,+
chr1,175921988,2.380690737833595,1010,636,1646,+
chr1,175921989,1.8212679588656742,1819,1296,3115,+
chr1,178411700,2.1083467192654655,764,588,1352,+
chr1,179074029,2.525393278841214,638,413,1051,+
chr1,179074198,2.2263740316675324,727,439,1166,+
chr1,179074527,2.816276580875925,892,548,1440,+
chr1,179074529,3.2835257515518608,848,585,1433,+
chr1,179085726,0.6729301295908081,850,585,1435,+
chr1,179085831,3.53314816306032,797,587,1384,+
chr1,179095381,2.2275906659185702,563,490,1053,+
chr1,179095914,4.591900891328329,649,414,1063,+
chr1,179095934,45.48933901639419,1004,1003,2007,+
chr1,179095935,30.197385368165882,2198,1901,4099,+
chr1,179095936,30.197385368165882,2198,1901,4099,+
chr1,179335635,4.021390374331551,751,509,1260,+
chr1,179335636,3.2935960347235813,937,630,1567,+
chr1,179335637,4.021390374331551,751,509,1260,+
chr1,179353867,12.115107922468766,779,1052,1831,+
chr1,179353868,10.427352560475914,1169,2151,3320,+
chr1,179353870,5.314779270633396,324,1041,1365,+
chr1,179353889,0.2945503025895869,531,945,1476,+
chr1,179354036,2.8328277176356003,663,473,1136,+
chr1,179919203,0.24516412910442772,1032,558,1590,+
chr1,180197606,29.86040839983543,1069,827,1896,+
chr1,180197607,28.39951594729595,1182,956,2138,+
chr1,180197729,3.618703119096359,592,445,1037,+
chr1,180825311,1.945654858988192,708,462,1170,+
chr1,180884171,2.790337941085753,634,517,1151,+
chr1,180884638,9.560810810810812,1131,147,1278,+
chr1,180884639,10.364640883977902,1406,180,1586,+
chr1,180884640,11.74522240285894,1855,214,2069,+
chr1,180884641,13.903982243758257,1569,177,1746,+
chr1,180884648,20.680969617416785,1199,107,1306,+
chr1,180884650,27.184736592247425,1596,146,1742,+
chr1,180884651,21.8955786099865,1373,147,1520,+
chr1,180884653,53.1186046511628,1003,343,1346,+
chr1,180884654,50.11564539552304,1381,517,1898,+
chr1,180884655,51.86178228108367,1444,702,2146,+
chr1,180885778,0.42207049618559767,2135,1344,3479,+
chr1,180885779,0.6096159719041074,778,471,1249,+
chr1,180885780,0.2205530489472245,889,551,1440,+
chr1,182336009,0.7685601862235336,989,708,1697,+
chr1,182336011,1.1165724227925184,603,417,1020,+
chr1,182336015,0.9556135770234987,779,765,1544,+
chr1,182336017,0.9556135770234987,779,765,1544,+
chr1,182839427,1.9316140249203133,605,405,1010,+
chr1,182842561,3.3421009625960516,562,456,1018,+
chr1,182854053,2.7222222222222223,1223,815,2038,+
chr1,182854055,2.7222222222222223,1223,815,2038,+
chr1,182856556,3.04562288750807,865,587,1452,+
chr1,182858559,2.07814942169428,553,456,1009,+
chr1,182859054,2.226889747462388,911,607,1518,+
chr1,182859075,1.7013257575757574,690,439,1129,+
chr1,182866450,0.40897297297297297,581,499,1080,+
chr1,182874872,2.4001968181072657,541,468,1009,+
chr1,182876132,6.808457711442786,643,535,1178,+
chr1,182879254,1.0650334075723833,796,448,1244,+
chr1,182879255,1.0650334075723833,796,448,1244,+
chr1,182879358,2.780537048253584,625,380,1005,+
chr1,182881316,2.5467032967032965,617,415,1032,+
chr1,182881319,6.922222222222223,622,431,1053,+
chr1,182881343,0.3430128165438672,553,520,1073,+
chr1,182881602,0.6153683244502488,757,690,1447,+
chr1,182883249,3.1192930780559647,705,387,1092,+
chr1,182884732,0.4744289970208541,734,529,1263,+
chr1,182887381,7.304709389795822,1729,1119,2848,+
chr1,182887382,6.400448340669995,2377,1647,4024,+
chr1,182887383,6.8060019719463,1965,1369,3334,+
chr1,182887384,5.54594616572247,1759,1283,3042,+
chr1,182887391,1.967541229385307,672,459,1131,+
chr1,182887392,1.967541229385307,672,459,1131,+
chr1,182887427,4.657336922380567,1805,1882,3687,+
chr1,182887429,0.7978935207944156,1138,1452,2590,+
chr1,182887431,0.5200789993416721,789,991,1780,+
chr1,182887474,0.7879969992498125,1312,1332,2644,+
chr1,182887475,0.7879969992498125,1312,1332,2644,+
chr1,182887634,1.920481220657277,747,425,1172,+
chr1,183103456,1.5422543182511352,606,410,1016,+
chr1,183117682,0.36649358656422415,642,531,1173,+
chr1,183131352,0.9162186379928313,817,495,1312,+
chr1,183131353,1.2818474601643608,1319,795,2114,+
chr1,183132434,1.6722387127011402,891,518,1409,+
chr1,183132436,2.2080544895785557,1695,1070,2765,+
chr1,183132447,1.9773013871374527,979,609,1588,+
chr1,183132465,1.6831622634773298,4121,2800,6921,+
chr1,183132466,1.6831622634773298,4121,2800,6921,+
chr1,183132467,1.6831622634773298,4121,2800,6921,+
chr1,183137786,1.6643693297080548,747,460,1207,+
chr1,183140432,5.9523809523809526,629,440,1069,+
chr1,183140434,3.193774366471734,1416,683,2099,+
chr1,183140435,3.193774366471734,1416,683,2099,+
chr1,183140438,1.727745085764367,2122,1629,3751,+
chr1,183140439,1.727745085764367,2122,1629,3751,+
chr1,183140440,1.7414936348267298,3920,2577,6497,+
chr1,183140441,1.7173954924316337,2660,1441,4101,+
chr1,183140446,3.071895424836601,1033,560,1593,+
chr1,183140447,1.595994367078704,1019,580,1599,+
chr1,183144228,10.762497556526652,1311,1029,2340,+
chr1,183144229,10.762497556526652,1311,1029,2340,+
chr1,183546180,1.4422770632649644,931,685,1616,+
chr1,183546182,0.519995780918111,791,548,1339,+
chr1,183550815,2.6136216122431124,745,488,1233,+
chr1,183550829,0.9454676778620441,832,496,1328,+
chr1,183550830,0.9454676778620441,832,496,1328,+
chr1,184072837,2.8256099539030215,1289,877,2166,+
chr1,184072838,4.128162816281628,789,605,1394,+
chr1,184072917,0.35070153061224496,610,447,1057,+
chr1,184073881,0.35411855273287146,574,432,1006,+
chr1,184074110,2.8306188925081432,868,613,1481,+
chr1,184074111,2.8306188925081432,868,613,1481,+
chr1,186388487,1.6105059806411932,993,547,1540,+
chr1,186389587,1.2241199238188856,796,396,1192,+
chr1,186389589,1.4746431613946103,1075,590,1665,+
chr1,186420348,2.7432120727914797,781,593,1374,+
chr1,186420366,2.8216602674434,665,580,1245,+
chr1,186420367,0.32035398230088497,904,564,1468,+
chr1,186420369,0.32035398230088497,904,564,1468,+
chr1,186420372,2.1167200478062114,2383,1730,4113,+
chr1,186420375,2.5206896551724136,1189,811,2000,+
chr1,186420376,2.5206896551724136,1189,811,2000,+
chr1,186420387,2.120762890066448,1753,1320,3073,+
chr1,186420388,2.120762890066448,1753,1320,3073,+
chr1,186420395,2.1264473907493793,1950,1527,3477,+
chr1,186420924,2.1438369823088563,945,638,1583,+
chr1,186420959,3.075884418039428,669,528,1197,+
chr1,186828981,1.4933896526947013,693,454,1147,+
chr1,186828982,0.9334861533945461,1208,903,2111,+
chr1,186854286,1.9105125327347552,750,404,1154,+
chr1,186854289,3.855477855477856,826,461,1287,+
chr1,186854304,0.5347222222222222,1000,755,1755,+
chr1,186854307,0.6155057317984561,4228,2810,7038,+
chr1,186854308,0.6433226040687404,3787,2500,6287,+
chr1,186854309,0.8018579873567193,6249,3873,10122,+
chr1,186854311,1.0617568021498154,2462,1373,3835,+
chr1,186854313,1.0649102920370443,5028,3155,8183,+
chr1,186854314,1.0649102920370443,5028,3155,8183,+
chr1,186854325,1.6248400232693432,1642,954,2596,+
chr1,186911338,0.9888519924098672,757,543,1300,+
chr1,186911339,0.9888519924098672,757,543,1300,+
chr1,186932837,1.3112520798668883,933,600,1533,+
chr1,186932838,1.3944011122039723,1441,1010,2451,+
chr1,186939979,1.503702599594517,704,466,1170,+
chr1,186939983,2.204043362628959,1554,1130,2684,+
chr1,186940014,1.967948717948718,613,415,1028,+
chr1,186956267,2.3087680113022464,1071,746,1817,+
chr1,186965459,2.4737216920666576,667,412,1079,+
chr1,186965540,2.237766263672999,675,385,1060,+
chr1,186977656,2.130037783375315,614,396,1010,+
chr1,186977663,2.230639075418455,847,654,1501,+
chr1,186988601,3.308815379878904,707,564,1271,+
chr1,186988855,1.9833333333333334,730,515,1245,+
chr1,187563708,1.1428571428571428,1006,741,1747,+
chr1,187563709,1.1443233237350885,942,747,1689,+
chr1,187563710,1.1428571428571428,1006,741,1747,+
chr1,187563711,1.1443233237350885,942,747,1689,+
chr1,192716144,0.46109795713090884,4122,3158,7280,+
chr1,192716253,1.2915679097881576,7133,4028,11161,+
chr1,192716254,1.1111271383837868,6263,3888,10151,+
chr1,192716255,1.3267025683329847,9846,5545,15391,+
chr1,192716256,1.2817136536053932,9235,5187,14422,+
chr1,192716257,1.130110339370494,5284,3387,8671,+
chr1,192716258,1.16989929929798,12832,7394,20226,+
chr1,192716259,1.066783990808511,15843,9583,25426,+
chr1,192716260,0.9657706911699692,12891,7464,20355,+
chr1,192716261,0.936112170842828,4964,3385,8349,+
chr1,192716262,1.0129436837832941,8107,5309,13416,+
chr1,192716266,1.2003021476686608,11325,7881,19206,+
chr1,192716267,1.4540419095074968,4613,3457,8070,+
chr1,192716273,0.7352648007017304,4489,3026,7515,+
chr1,192716274,1.3390418848048742,11247,7227,18474,+
chr1,192716331,2.000069932922672,3397,1768,5165,+
chr1,192716333,1.5990855104059076,13596,8237,21833,+
chr1,192716334,1.5544172203662565,11984,7429,19413,+
chr1,192716337,1.8695680594659452,4498,2693,7191,+
chr1,192716339,1.6322897115397417,9554,5891,15445,+
chr1,192716340,1.445572854346225,14199,9443,23642,+
chr1,192716341,1.4366992575445834,14128,9281,23409,+
chr1,192716343,1.3450373356867291,18396,12577,30973,+
chr1,192716344,1.3126346139476595,18915,13403,32318,+
chr1,192716345,1.316794629550777,12768,8722,21490,+
chr1,192716347,1.3966299493144145,12888,9351,22239,+
chr1,192716353,1.1980933147553743,4281,3294,7575,+
chr1,192716354,1.2827784628031238,3120,2432,5552,+
chr1,192716356,0.7382288921984191,11555,8728,20283,+
chr1,192716357,0.9756883872670248,7561,5825,13386,+
chr1,192716358,0.6560159369542514,18781,13811,32592,+
chr1,192716359,0.8203444253244154,39406,28883,68289,+
chr1,192716360,0.9737930817997138,11848,8852,20700,+
chr1,192716362,0.870558530484285,7787,5196,12983,+
chr1,192716364,1.2853368969919698,5203,4009,9212,+
chr1,192716611,2.341199793764411,649,431,1080,+
chr1,192716626,2.292712799937178,1438,1007,2445,+
chr1,192809097,3.3209342560553634,1046,577,1623,+
chr1,192809099,3.3209342560553634,1046,577,1623,+
chr1,192809110,1.7747104553387276,657,381,1038,+
chr1,192809122,1.694399520814615,831,476,1307,+
chr1,192809141,2.7101272827891534,1112,694,1806,+
chr1,192809150,2.9862938596491224,837,455,1292,+
chr1,192810239,1.854363155910855,1040,835,1875,+
chr1,192810240,0.7331462486222257,783,595,1378,+
chr1,192810241,2.2678492367182725,653,540,1193,+
chr1,192811700,0.32525565540749923,655,460,1115,+
chr1,192811702,0.32525565540749923,655,460,1115,+
chr1,198319443,1.5793269230769234,729,415,1144,+
chr1,198319449,0.6849816849816851,832,587,1419,+
chr1,198319454,1.735763097949886,634,438,1072,+
chr1,198319468,2.0987910189982735,783,578,1361,+
chr1,198319474,1.5955272511848342,1538,843,2381,+
chr1,198319475,1.8211538461538463,946,727,1673,+
chr1,198319485,1.612638953219083,1796,1015,2811,+
chr1,198319492,2.1716075937529227,2110,1257,3367,+
chr1,200852620,4.1049508462551945,606,406,1012,+
chr1,201855799,3.534502515853322,782,520,1302,+
chr1,201866804,0.33980767373262305,873,609,1482,+
chr1,201866947,2.3382910310475595,642,473,1115,+
chr1,201868731,3.325041973769985,581,428,1009,+
chr1,201870793,1.5742320584675524,707,487,1194,+
chr1,201871241,1.1811584507953914,622,511,1133,+
chr1,201874882,7.380891043184787,1000,664,1664,+
chr1,201874884,8.123527558717702,1303,909,2212,+
chr1,201874885,12.579092451618942,1244,991,2235,+
chr1,201874889,4.76517634097225,761,820,1581,+
chr1,201874903,0.3799918692352886,603,705,1308,+
chr1,201955511,1.36839109553867,701,499,1200,+
chr1,201957300,1.4216558462399633,836,608,1444,+
chr1,201957343,0.3430949903374461,576,433,1009,+
chr1,201963647,2.4169611307420493,911,565,1476,+
chr1,201965481,2.0209895052473765,673,405,1078,+
chr1,201969474,1.7703703703703704,955,674,1629,+
chr1,201969483,1.5599045178502475,1200,933,2133,+
chr1,201969548,0.6514110586132039,1416,954,2370,+
chr1,201969549,0.7910974067046174,3062,2039,5101,+
chr1,201969566,1.2439056516708857,14845,9559,24404,+
chr1,201969567,1.2439056516708857,14845,9559,24404,+
chr1,201969568,1.8461292405385712,6095,4531,10626,+
chr1,201969786,1.540128731868924,1802,1197,2999,+
chr1,201988988,2.734597225401572,647,480,1127,+
chr1,201989019,0.2978715017737485,686,589,1275,+
chr1,201989021,0.2978715017737485,686,589,1275,+
chr1,201996172,1.2396321801991992,555,451,1006,+
chr1,202004392,0.9872628296601659,933,741,1674,+
chr1,202004393,0.8471760251861038,1474,1104,2578,+
chr1,202005617,0.5529920692141312,707,437,1144,+
chr1,202005618,1.6427728782526076,2377,1416,3793,+
chr1,202005620,1.9745434421693415,1337,833,2170,+
chr1,202005625,0.4032158317872603,814,384,1198,+
chr1,202005650,0.9612262257941471,2689,1364,4053,+
chr1,202005769,3.169144824980248,787,567,1354,+
chr1,202005781,1.8201846657737935,1650,1440,3090,+
chr1,202005782,1.0444726810673444,821,786,1607,+
chr1,202005855,2.8165101721439747,625,425,1050,+
chr1,202005992,1.7022508142012789,694,481,1175,+
chr1,202011136,0.2835330175536361,635,484,1119,+
chr1,202011138,0.2835330175536361,635,484,1119,+
chr1,202011157,1.717392575270389,1376,932,2308,+
chr1,202011158,1.717392575270389,1376,932,2308,+
chr1,203023195,1.3253171382156441,621,396,1017,+
chr1,203796480,2.322585191342139,999,818,1817,+
chr1,203829573,3.2090118687596703,817,567,1384,+
chr1,203833791,2.4213817691784665,716,513,1229,+
chr1,203838020,2.3837549271072453,595,427,1022,+
chr1,203847191,2.3778625954198467,711,392,1103,+
chr1,203849805,2.8554888724240914,902,614,1516,+
chr1,203849806,1.0234882558720642,639,434,1073,+
chr1,203852289,1.5954657419083647,838,632,1470,+
chr1,203852856,3.0439024390243903,623,409,1032,+
chr1,203852858,3.0439024390243903,623,409,1032,+
chr1,203853244,2.2766013071895426,621,424,1045,+
chr1,203853726,2.6144541417853318,682,621,1303,+
chr1,203853727,2.6144541417853318,682,621,1303,+
chr1,203853730,2.001246356503867,755,625,1380,+
chr1,203853858,1.6238244514106583,811,637,1448,+
chr1,203861597,0.6008790058785634,979,518,1497,+
chr1,203861598,0.5773648387642348,758,383,1141,+
chr1,203861601,2.387949260042283,752,351,1103,+
chr1,203861602,1.678752081356282,1233,625,1858,+
chr1,203861607,1.3872476935570799,2991,1850,4841,+
chr1,203861608,1.3872476935570799,2991,1850,4841,+
chr1,203861609,1.4249154086413325,2008,1359,3367,+
chr1,203861646,0.7088157676914237,1276,996,2272,+
chr1,203869889,2.301585355770354,823,571,1394,+
chr1,203869899,0.40168762650080175,1012,589,1601,+
chr1,203869901,1.642846661775495,621,469,1090,+
chr1,205351287,2.370832520959252,759,445,1204,+
chr1,205351288,1.6857859531772577,592,459,1051,+
chr1,205351289,2.2008156028368795,1170,704,1874,+
chr1,205351291,2.1030181086519115,803,496,1299,+
chr1,205351292,0.403309770398378,1471,868,2339,+
chr1,205351293,0.403309770398378,1471,868,2339,+
chr1,205526084,2.719472366772997,844,509,1353,+
chr1,205531349,0.32891007542512757,917,636,1553,+
chr1,205531350,0.8067982877101444,790,508,1298,+
chr1,205531363,2.6324625566004882,1218,869,2087,+
chr1,205531364,2.6324625566004882,1218,869,2087,+
chr1,205531373,1.5419516610623452,1331,867,2198,+
chr1,206685350,4.044530367189637,613,502,1115,+
chr1,206732578,2.0714325914182083,725,484,1209,+
chr1,206732581,1.5985584811790976,846,528,1374,+
chr1,206732585,1.9850831899024668,1037,746,1783,+
chr1,206732586,1.6394348262957872,1308,972,2280,+
chr1,206732597,2.3660511647330105,1944,1668,3612,+
chr1,206732598,2.167786588410179,3403,2695,6098,+
chr1,206732599,2.3269709791290722,3079,2408,5487,+
chr1,206732600,2.0396465866946163,2594,1767,4361,+
chr1,207321672,1.0232560969698024,2318,1675,3993,+
chr1,207321673,0.9810208454876997,3977,2766,6743,+
chr1,207321674,0.5948660714285714,1065,923,1988,+
chr1,207321675,0.6960263248943965,4764,3148,7912,+
chr1,207321676,0.6284197654594059,4821,3308,8129,+
chr1,207321678,0.5994265626466843,2689,2149,4838,+
chr1,207321679,0.615067306863997,2977,1675,4652,+
chr1,207321682,0.9366051581310996,4414,2930,7344,+
chr1,207321683,0.7878865011721957,9845,6224,16069,+
chr1,207321746,1.3667983996702944,6195,4427,10622,+
chr1,207321765,1.4957737141594387,1804,786,2590,+
chr1,207321841,1.4424818840579707,3821,2943,6764,+
chr1,207322381,1.702624198717949,2864,1663,4527,+
chr1,207322393,0.7809372011475932,4082,3136,7218,+
chr1,207322400,1.3048919592206984,4672,3727,8399,+
chr1,207322402,1.4545456827309236,4168,2655,6823,+
chr1,207322403,1.3354940265699775,10738,8414,19152,+
chr1,207322406,1.3736333435904522,10583,8380,18963,+
chr1,207322407,1.3736333435904522,10583,8380,18963,+
chr1,207322409,0.9215771603939344,19221,13948,33169,+
chr1,207322410,0.8265285337246614,14513,10784,25297,+
chr1,207324719,1.4162070465931276,13018,10003,23021,+
chr1,207325634,1.1657887177516058,10657,8185,18842,+
chr1,207325652,1.293651580743597,29251,21574,50825,+
chr1,207331106,0.8544943473504082,1795,828,2623,+
chr1,207331143,1.2323463386875588,31133,20901,52034,+
chr1,207331146,0.8006426195122914,92104,60664,152768,+
chr1,207331147,0.9261790686894464,127567,85103,212670,+
chr1,207331159,1.3989812774886663,31393,21963,53356,+
chr1,207331167,1.7976389212118893,51775,37732,89507,+
chr1,207337326,1.1559599215196004,859,792,1651,+
chr1,207337327,1.26924753390761,1526,1418,2944,+
chr1,207340470,0.3785064206458048,827,616,1443,+
chr1,207340471,0.3785064206458048,827,616,1443,+
chr1,207359544,0.7782448876119655,590,487,1077,+
chr1,207359585,1.2228315473829512,25756,18944,44700,+
chr1,207359770,1.0429629283984352,27750,21314,49064,+
chr1,207359771,0.9172211143284142,56570,42108,98678,+
chr1,207360042,1.2879536022020013,36223,25149,61372,+
chr1,207360185,1.1886868856121535,7738,4991,12729,+
chr1,207360389,1.4936046602917394,5695,3265,8960,+
chr1,207752089,2.958494938768201,688,468,1156,+
chr1,207752107,1.2957010847730013,773,523,1296,+
chr1,207752126,2.161619718309859,876,567,1443,+
chr1,207752186,1.358989310009718,1287,1028,2315,+
chr1,207752245,2.4858738501971094,1080,760,1840,+
chr1,207757035,1.4844122087287812,2777,2186,4963,+
chr1,207757045,1.634088417975886,1788,1448,3236,+
chr1,207757059,1.7662337662337662,1988,1385,3373,+
chr1,207757065,0.7065901420013804,4334,3488,7822,+
chr1,207757073,1.9877634409767566,2799,2598,5397,+
chr1,207757569,1.5650867566854327,4482,3135,7617,+
chr1,207757570,1.5147384156386254,6572,4756,11328,+
chr1,207757591,1.458453600996975,4770,3199,7969,+
chr1,207761279,1.2191146920373417,5346,3964,9310,+
chr1,207761317,0.9771567446093367,5264,4094,9358,+
chr1,207761323,1.4024500893709408,7063,4268,11331,+
chr1,207761324,1.3670168189474547,10091,6743,16834,+
chr1,207767015,4.033924611973393,1581,1229,2810,+
chr1,207767017,1.3733066528240594,2024,1341,3365,+
chr1,207767040,1.623950853236876,4039,3056,7095,+
chr1,207770330,1.5012352964029785,8134,5457,13591,+
chr1,207770331,1.5012352964029785,8134,5457,13591,+
chr1,207783298,1.7864360491579427,2006,1520,3526,+
chr1,207785617,0.79940868253445,864,613,1477,+
chr1,207785633,0.6259146684678599,2084,1691,3775,+
chr1,207790261,1.7082743172955257,2229,1651,3880,+
chr1,207790266,2.1975508880058388,796,648,1444,+
chr1,207790303,1.8357937310414565,800,644,1444,+
chr1,207790309,1.7813697318007664,864,695,1559,+
chr1,207793546,1.4661462443394966,2489,1680,4169,+
chr1,207793580,1.3566270014649566,1954,1598,3552,+
chr1,207793841,1.3328613569321537,2823,1649,4472,+
chr1,207793955,1.6536807487983811,2178,1356,3534,+
chr1,207794177,2.02255460588794,2433,1871,4304,+
chr1,207794198,1.3645231970153002,2572,2008,4580,+
chr1,207794474,2.9437799043062203,2069,1671,3740,+
chr1,207794551,1.309173317705717,3042,2336,5378,+
chr1,207794589,1.3913750868896098,3227,2476,5703,+
chr1,207794614,0.6905532153695763,8816,6504,15320,+
chr1,207794705,1.190378091693881,5152,3761,8913,+
chr1,207794875,1.3543901167338879,5860,4354,10214,+
chr1,207795223,1.4484678310648103,4481,2903,7384,+
chr1,207795352,1.4536559245149834,5262,3572,8834,+
chr1,209831032,2.3716508210890237,1175,889,2064,+
chr1,209831033,2.3716508210890237,1175,889,2064,+
chr1,212043002,1.8592921267464881,744,523,1267,+
chr1,212043003,1.4407582938388628,626,421,1047,+
chr1,212043004,1.4407582938388628,626,421,1047,+
chr1,212068644,2.0330145016970067,598,462,1060,+
chr1,212068646,2.0330145016970067,598,462,1060,+
chr1,212101007,1.467516920473221,1655,1083,2738,+
chr1,212101009,2.02995308552869,674,488,1162,+
chr1,212342245,1.227559136740169,739,467,1206,+
chr1,212342265,2.370851370851371,1146,692,1838,+
chr1,212342266,2.370851370851371,1146,692,1838,+
chr1,212433081,1.7637265534486044,821,579,1400,+
chr1,212444340,2.821898496240601,1200,930,2130,+
chr1,212444341,2.821898496240601,1200,930,2130,+
chr1,212444342,2.821898496240601,1200,930,2130,+
chr1,212445892,1.023315157538478,1835,1261,3096,+
chr1,212445894,1.023315157538478,1835,1261,3096,+
chr1,212445967,0.44030365769496205,637,643,1280,+
chr1,212445979,0.47728674203494353,773,694,1467,+
chr1,212445988,0.5584594222833562,869,726,1595,+
chr1,212446003,1.7543980580253178,4455,3134,7589,+
chr1,212446005,1.808018617804749,1963,1542,3505,+
chr1,212446006,1.741612694300518,1378,964,2342,+
chr1,212446069,1.685325516448852,1257,905,2162,+
chr1,212619363,2.4075845467130086,617,470,1087,+
chr1,212619926,58.118993505820725,980,1172,2152,+
chr1,212619927,58.11899350582072,980,1172,2152,+
chr1,212620551,1.5835923980899391,725,561,1286,+
chr1,212802737,2.7243410852713184,954,644,1598,+
chr1,212802738,2.632081635305572,1304,892,2196,+
chr1,212804323,1.9814814814814818,855,623,1478,+
chr1,212804324,2.209137055837564,1311,984,2295,+
chr1,212804326,1.915963150374586,1658,1294,2952,+
chr1,212804327,2.345,937,769,1706,+
chr1,214332180,1.2374843059200151,660,405,1065,+
chr1,214334290,0.9978174478938124,899,593,1492,+
chr1,214334294,1.1314470818002453,672,503,1175,+
chr1,214336760,0.32637641575061305,668,395,1063,+
chr1,214645149,2.5917104383930725,1091,593,1684,+
chr1,214645174,2.0696895146450265,1099,693,1792,+
chr1,214645181,2.4280107047279214,877,589,1466,+
chr1,214645191,2.7169744318181817,1092,615,1707,+
chr1,214645192,2.1342405559717776,2919,1770,4689,+
chr1,214645218,2.394782608695652,764,499,1263,+
chr1,214645219,1.5399543378995433,1348,802,2150,+
chr1,214645235,1.761689291101056,1751,1070,2821,+
chr1,214647073,3.1306220095693784,726,417,1143,+
chr1,214647074,3.1306220095693784,726,417,1143,+
chr1,214647153,1.6203522504892367,620,510,1130,+
chr1,214647159,2.4942612687813024,682,598,1280,+
chr1,214648771,0.9727433237695874,1289,787,2076,+
chr1,214648772,1.2334508662402757,1714,1113,2827,+
chr1,214657311,1.937640845755357,586,544,1130,+
chr1,214663901,0.8895750456626103,2081,1743,3824,+
chr1,214663903,0.6064775182422241,1622,1442,3064,+
chr1,215604192,1.520389441489606,911,727,1638,+
chr1,215604246,1.985743710167375,984,589,1573,+
chr1,215620216,2.5950355510411383,996,715,1711,+
chr1,215620225,1.7589422585590189,2247,1647,3894,+
chr1,215620227,1.7589422585590189,2247,1647,3894,+
chr1,215620235,1.870882241575161,1280,972,2252,+
chr1,215620248,1.9653585457485379,3757,2557,6314,+
chr1,215620250,1.9691607684529833,2336,1379,3715,+
chr1,215620279,2.440388349514563,1570,1029,2599,+
chr1,215620282,0.7860902255639098,2459,1823,4282,+
chr1,215620284,1.6293617080932552,1815,1208,3023,+
chr1,215620285,1.0696532472322262,3273,2030,5303,+
chr1,215620291,1.8001564064922415,4311,3168,7479,+
chr1,215620293,1.881399018232819,6603,4967,11570,+
chr1,215620294,2.0238361700781424,4508,3463,7971,+
chr1,215620298,0.7736279926335176,3826,2714,6540,+
chr1,215620358,0.668649193548387,736,495,1231,+
chr1,215620731,1.9946666666666668,560,449,1009,+
chr1,215620741,0.6657458563535912,722,542,1264,+
chr1,215620744,0.32620438760886344,806,578,1384,+
chr1,215620754,0.6075978959672707,1129,724,1853,+
chr1,215620786,1.558151093439364,1099,1005,2104,+
chr1,215621464,2.2257242557737342,892,559,1451,+
chr1,218285312,2.0540437414122494,659,401,1060,+
chr1,218345357,0.4366952789699571,554,465,1019,+
chr1,218345404,2.8699261992619927,548,541,1089,+
chr1,218346929,3.5617323852617973,579,441,1020,+
chr1,218346930,3.5617323852617973,579,441,1020,+
chr1,220100598,2.6984126984126986,594,440,1034,+
chr1,220100606,2.007967680395017,616,468,1084,+
chr1,220102130,2.146273062730628,785,541,1326,+
chr1,220102524,2.264784946236559,673,557,1230,+
chr1,220102704,1.9153076352853966,688,567,1255,+
chr1,220102761,2.8930909090909096,662,549,1211,+
chr1,220105933,3.736909090909091,662,549,1211,+
chr1,220107083,2.2927395035954534,705,478,1183,+
chr1,220107117,2.421969254718817,802,570,1372,+
chr1,220110808,1.5023710674010753,899,799,1698,+
chr1,220110829,1.5150554675118861,955,630,1585,+
chr1,220110918,0.5321252059308073,835,606,1441,+
chr1,220125325,2.933520269583488,844,681,1525,+
chr1,220126804,1.7871988418984588,595,508,1103,+
chr1,220134407,1.908677685950413,595,483,1078,+
chr1,220134416,0.6513904834800357,816,602,1418,+
chr1,220134422,0.5775005775005776,1249,961,2210,+
chr1,220137984,0.5775884665792923,677,435,1112,+
chr1,220137991,0.4800538629860293,712,456,1168,+
chr1,220139045,1.6830294530154282,719,557,1276,+
chr1,220143069,0.5440900562851783,753,532,1285,+
chr1,220143095,4.502840909090909,633,439,1072,+
chr1,220145520,0.5701754385964912,597,436,1033,+
chr1,220147629,1.6590436590436592,930,636,1566,+
chr1,220147747,1.8028169014084507,1087,709,1796,+
chr1,220147889,1.8592407869215848,670,400,1070,+
chr1,220253557,0.37085774739909977,566,945,1511,+
chr1,220253560,0.3079145513421958,1216,1780,2996,+
chr1,220253561,0.36691646060361854,1672,2414,4086,+
chr1,220253562,0.4259489796238775,2111,2910,5021,+
chr1,220253563,0.467702635504724,1446,2010,3456,+
chr1,220253564,0.5060151737688139,1713,2200,3913,+
chr1,220253565,0.5428061831153389,967,1275,2242,+
chr1,220253583,0.4315975633719788,645,726,1371,+
chr1,220253586,1.8890134529147984,673,445,1118,+
chr1,220253589,0.6878852536747273,828,702,1530,+
chr1,220253592,1.6678885630498534,909,615,1524,+
chr1,220253595,0.6736957776528483,6159,5511,11670,+
chr1,220253596,0.6736957776528483,6159,5511,11670,+
chr1,220253597,0.6392227131971747,3637,3504,7141,+
chr1,220253718,2.19080636877247,897,648,1545,+
chr1,220253719,0.6708237986270024,1286,827,2113,+
chr1,220253757,0.3862410071942446,858,555,1413,+
chr1,220253773,1.6146740284561483,821,553,1374,+
chr1,220253780,0.6232712520744975,844,637,1481,+
chr1,220253850,1.0324852517424783,3503,2485,5988,+
chr1,220253855,1.447221048182587,1587,1182,2769,+
chr1,220253877,0.7322418758159468,3414,1908,5322,+
chr1,220253912,1.6286790961604771,5232,3012,8244,+
chr1,220253971,0.9930584531350756,4283,1928,6211,+
chr1,220253973,0.8827443806294393,9070,4511,13581,+
chr1,220253974,1.447092057327532,6396,4041,10437,+
chr1,220253976,1.4647703692858443,14774,8406,23180,+
chr1,220254075,1.6927229782926556,699,522,1221,+
chr1,220254076,1.135135110517469,1109,828,1937,+
chr1,220254080,1.790794633255797,1459,1154,2613,+
chr1,220254085,0.5991917331696338,688,542,1230,+
chr1,220254088,0.5307132738999096,4389,3150,7539,+
chr1,220254091,1.626018379717135,1133,915,2048,+
chr1,220254094,1.5532109631635702,1696,1265,2961,+
chr1,220254360,0.6177459761831222,972,882,1854,+
chr1,220254362,0.6259760541384695,2219,1920,4139,+
chr1,220254363,0.9070256523718713,2536,2109,4645,+
chr1,220254364,0.6157743481296216,1798,1520,3318,+
chr1,220787140,0.9578061740890688,720,415,1135,+
chr1,220787142,1.3425560186776688,897,554,1451,+
chr1,220796698,0.5008001040724686,733,465,1198,+
chr1,220796749,2.9444444444444438,741,485,1226,+
chr1,220797966,1.6899701237729408,1041,709,1750,+
chr1,220805090,1.9459259259259258,851,599,1450,+
chr1,220813413,0.6009742519137091,761,478,1239,+
chr1,220813443,1.7250702247191012,866,533,1399,+
chr1,220813541,1.8875143184421537,1176,872,2048,+
chr1,220813806,0.41395623891188643,699,622,1321,+
chr1,220813861,1.5361241995892232,861,533,1394,+
chr1,220813898,0.5639946018893387,652,474,1126,+
chr1,220813926,1.6670807453416148,670,489,1159,+
chr1,220813928,1.8058958401572223,1020,709,1729,+
chr1,220814095,2.273678702250131,868,545,1413,+
chr1,220814121,1.7959475481787466,1200,824,2024,+
chr1,220814135,1.794397463002114,678,472,1150,+
chr1,220814236,1.7268773278865794,1381,1014,2395,+
chr1,223745342,3.337480934363051,578,454,1032,+
chr1,223755547,6.879498426827856,883,705,1588,+
chr1,223755548,6.3619181841194585,1126,909,2035,+
chr1,223761593,3.2404612159329136,532,476,1008,+
chr1,223761594,3.2404612159329136,532,476,1008,+
chr1,223772183,2.6652956298200507,647,388,1035,+
chr1,223772185,2.6652956298200507,647,388,1035,+
chr1,223775363,0.38977645229491836,575,502,1077,+
chr1,223775571,3.0294970986460346,894,516,1410,+
chr1,223775572,3.0294970986460346,894,516,1410,+
chr1,224192631,2.424812030075188,1124,797,1921,+
chr1,224192633,2.424812030075188,1124,797,1921,+
chr1,224193046,4.337015168482133,612,469,1081,+
chr1,224356889,11.237731288639237,697,388,1085,+
chr1,224356921,5.1264528775076235,697,436,1133,+
chr1,224356924,4.840893238728971,1718,987,2705,+
chr1,224356934,9.187086501684957,1854,1259,3113,+
chr1,224356936,8.628032084527913,1239,838,2077,+
chr1,224356937,11.067684042806793,1969,2117,4086,+
chr1,224356947,0.3938937568455641,410,663,1073,+
chr1,224356958,0.5943960541504879,471,732,1203,+
chr1,224360494,0.06553819444444445,452,575,1027,+
chr1,224360527,0.5293233082706766,703,569,1272,+
chr1,224365919,1.7633875739644973,882,519,1401,+
chr1,224371325,1.0131509479241658,1110,925,2035,+
chr1,224371327,0.8271680283008275,1622,1457,3079,+
chr1,224375809,1.7218017057569297,872,669,1541,+
chr1,224375812,2.0625300625300627,669,494,1163,+
chr1,224375900,1.8575851393188851,659,560,1219,+
chr1,224955019,5.210517421386988,708,552,1260,+
chr1,224955020,4.365040453566432,858,641,1499,+
chr1,225789404,1.818253968253968,868,494,1362,+
chr1,225789406,1.5502722601426489,1122,766,1888,+
chr1,225789416,1.6094420600858368,649,465,1114,+
chr1,225789816,1.3869294605809126,1336,963,2299,+
chr1,225790144,1.7825159914712154,626,468,1094,+
chr1,225790148,1.2649248149736212,912,668,1580,+
chr1,225790200,1.9517795637198625,1325,870,2195,+
chr1,225790202,0.7101828301265748,2045,1452,3497,+
chr1,225790320,0.6180485241531344,2537,1803,4340,+
chr1,225790321,0.6180485241531344,2537,1803,4340,+
chr1,225790365,2.532230339492909,2356,1968,4324,+
chr1,225790370,1.8688306939592272,5532,4314,9846,+
chr1,225831905,1.980183908103125,575,429,1004,+
chr1,226062720,0.8121721329543719,1555,558,2113,+
chr1,226062724,0.662125429389084,2692,1084,3776,+
chr1,228082716,0.5607357357357358,678,359,1037,+
chr1,228082720,1.3100204593351483,940,557,1497,+
chr1,228097108,0.5792930660888407,1179,922,2101,+
chr1,228097118,1.9792046144505158,1002,731,1733,+
chr1,228097127,1.0965369086939718,2571,1960,4531,+
chr1,228097139,1.661274668392106,1026,842,1868,+
chr1,228097214,1.7163099630996312,1025,812,1837,+
chr1,228097365,1.77462316458165,2358,1888,4246,+
chr1,228097367,1.388876003266991,6975,5273,12248,+
chr1,228097433,2.066428021206217,876,760,1636,+
chr1,228097593,2.2687684729064035,807,724,1531,+
chr1,228097599,1.6142440668701314,874,756,1630,+
chr1,228097674,2.5723603290547117,2115,1317,3432,+
chr1,228097698,1.6089968005800876,2161,1484,3645,+
chr1,228097884,0.5694439024390244,767,624,1391,+
chr1,228097966,0.6462355445879905,1302,995,2297,+
chr1,228098005,2.026911012831767,1660,1249,2909,+
chr1,228098008,2.0823899371069183,923,635,1558,+
chr1,228098032,2.3627564847077043,1794,1259,3053,+
chr1,228098033,2.3627564847077043,1794,1259,3053,+
chr1,228098053,1.5508939612530916,1796,1212,3008,+
chr1,228098060,1.8331573389651528,1208,946,2154,+
chr1,228098094,1.5450861195542045,1224,986,2210,+
chr1,228098142,0.6520157281026845,1341,1195,2536,+
chr1,228098144,1.4956149732620323,2127,1274,3401,+
chr1,228098204,1.488318105339382,2085,1268,3353,+
chr1,228098211,1.8101335187355405,8487,6503,14990,+
chr1,228098364,1.6953872053872054,1170,824,1994,+
chr1,228098374,1.7140856576029877,1223,901,2124,+
chr1,228098376,1.5892931085477668,2004,1224,3228,+
chr1,228098397,1.7074781445008507,1607,1402,3009,+
chr1,228098541,2.4262766096382395,1326,740,2066,+
chr1,228098562,1.6329012274865204,1293,757,2050,+
chr1,228098595,1.680206787621067,2483,1814,4297,+
chr1,228098707,0.5937427173153111,1421,1225,2646,+
chr1,228098709,0.6087876524769729,2189,1853,4042,+
chr1,228098710,0.9391502403800798,3079,2288,5367,+
chr1,228098724,1.765004512635379,1042,553,1595,+
chr1,228098767,0.6035398230088496,758,564,1322,+
chr1,228098795,2.74277660324172,833,472,1305,+
chr1,228098891,1.7995633187772928,633,457,1090,+
chr1,228098894,2.30560214693056,947,541,1488,+
chr1,228098902,2.5303030303030303,667,527,1194,+
chr1,228098922,1.581195164845847,1999,1265,3264,+
chr1,228098933,2.22075141132957,1425,933,2358,+
chr1,228098939,1.5232070153460695,1543,1029,2572,+
chr1,228099045,2.273972602739726,1493,1313,2806,+
chr1,228145511,1.1040437694726044,2639,1675,4314,+
chr1,228145512,1.0916723366570913,3847,2271,6118,+
chr1,228145517,1.6521081489884668,1027,491,1518,+
chr1,228488960,0.899793161211145,740,423,1163,+
chr1,228488986,1.452317880794702,644,452,1096,+
chr1,228488990,1.6444052419354842,869,495,1364,+
chr1,228488992,1.8617589893100093,1579,1175,2754,+
chr1,228488993,1.8617589893100093,1579,1175,2754,+
chr1,228488996,2.2316183096053344,868,715,1583,+
chr1,228488997,0.5655198487712666,830,574,1404,+
chr1,228494315,1.2368209928940594,733,520,1253,+
chr1,228494602,2.377233518176217,758,540,1298,+
chr1,228494603,2.3415177993781584,1020,773,1793,+
chr1,228494604,2.377233518176217,758,540,1298,+
chr1,228687421,0.7186711643676357,695,407,1102,+
chr1,228687431,1.7726925038245795,617,423,1040,+
chr1,228687433,0.7250871394903801,2163,1175,3338,+
chr1,228687445,1.6464270143870636,2042,1096,3138,+
chr1,229297511,2.495598591549296,734,496,1230,+
chr1,229297512,2.495598591549296,734,496,1230,+
chr1,229297540,1.9000691562932228,784,481,1265,+
chr1,229297545,2.167427238616773,736,518,1254,+
chr1,229297549,2.133159004147043,2886,1896,4782,+
chr1,229303967,2.2030236214321777,682,430,1112,+
chr1,230067243,2.905809683314804,681,356,1037,+
chr1,230178218,1.8467487289651945,1200,774,1974,+
chr1,230178221,2.216294458229942,698,402,1100,+
chr1,230178224,1.9100293814023663,717,513,1230,+
chr1,230178225,0.3801929428124457,1345,1045,2390,+
chr1,230178226,0.3801929428124457,1345,1045,2390,+
chr1,230178227,1.999781229490265,1661,1305,2966,+
chr1,230178228,1.7101807161297562,2636,2123,4759,+
chr1,230178230,1.50996783603426,2710,2191,4901,+
chr1,230203183,1.5007872102628894,2100,1582,3682,+
chr1,230203223,1.3694899774071048,1460,1171,2631,+
chr1,230236013,1.866293231061798,1346,918,2264,+
chr1,230236043,1.9114697970163852,976,695,1671,+
chr1,230236060,1.5201506342494715,1210,703,1913,+
chr1,230236067,1.691976254308694,1292,745,2037,+
chr1,230236072,1.7504051863857375,755,616,1371,+
chr1,230236076,1.639424648577967,1769,1287,3056,+
chr1,230236356,3.2140661854049037,1021,822,1843,+
chr1,230236359,1.4765393516812355,1472,880,2352,+
chr1,230236379,0.756524064171123,2020,1529,3549,+
chr1,230236396,1.6996795928192354,3218,2369,5587,+
chr1,230243382,1.5204358451225253,1210,948,2158,+
chr1,230246065,1.6947040498442367,767,641,1408,+
chr1,230246067,1.8920261850303648,1042,817,1859,+
chr1,230246110,0.7313806837039496,2240,1571,3811,+
chr1,230249187,1.6019120386208994,1893,1421,3314,+
chr1,230250464,1.579693100358423,1262,991,2253,+
chr1,230250489,1.463565062388592,1345,1121,2466,+
chr1,230255324,1.468759851207364,1247,932,2179,+
chr1,230262572,0.6084280303030303,770,575,1345,+
chr1,230262573,1.8909321496512368,1277,746,2023,+
chr1,230262592,1.9705574288625154,2704,1929,4633,+
chr1,230262598,1.5000718390804595,1098,869,1967,+
chr1,230262622,1.3014506581717884,3611,2930,6541,+
chr1,230262645,1.3161501216604812,2650,1768,4418,+
chr1,230262921,1.7913470747449511,2337,1600,3937,+
chr1,230262970,1.3754254902551435,2282,1864,4146,+
chr1,230265338,1.5896813408142714,2432,1985,4417,+
chr1,230274463,0.6745409966632137,3409,2110,5519,+
chr1,230274495,1.7019581827762724,4578,2591,7169,+
chr1,230274518,1.3214423680525376,6438,3716,10154,+
chr1,230274521,1.4167000886153616,36367,23497,59864,+
chr1,230274522,1.2694154966561488,66414,43840,110254,+
chr1,230274523,1.3944148659247564,52406,36979,89385,+
chr1,230274524,1.412873177933237,78538,54016,132554,+
chr1,230274525,1.595090488000088,50412,35441,85853,+
chr1,230274526,1.731579916004501,25772,19715,45487,+
chr1,230279377,0.6024182076813656,923,665,1588,+
chr1,230279432,1.6394515846371442,2054,1398,3452,+
chr1,230279453,2.17231548938866,1396,846,2242,+
chr1,230279484,0.952380960896507,3535,2556,6091,+
chr1,230279488,1.6326221397649967,1426,979,2405,+
chr1,230279512,1.3686405337781484,1640,1198,2838,+
chr1,230279712,1.812450748620961,574,563,1137,+
chr1,230279781,0.6101973684210525,1112,797,1909,+
chr1,230279824,2.0001127935560734,2299,1218,3517,+
chr1,230279827,4.002878474400809,2128,1045,3173,+
chr1,230279831,6.3425717408210645,6425,4295,10720,+
chr1,230279833,6.342571740821066,6425,4295,10720,+
chr1,230279836,2.1355592654424043,614,598,1212,+
chr1,230279848,3.611522004440589,2192,1446,3638,+
chr1,230279850,3.216033644669801,4524,3451,7975,+
chr1,230279856,0.4373296158612143,742,806,1548,+
chr1,230279857,2.4946017683043427,2256,1889,4145,+
chr1,230279873,0.7421526304236481,965,1037,2002,+
chr1,230279909,2.0097929281602758,1697,1637,3334,+
chr1,230280123,1.2840851495184995,2814,1972,4786,+
chr1,230280185,1.545009608455441,1254,723,1977,+
chr1,230280211,2.276985743380856,601,490,1091,+
chr1,230280271,1.6287349014621744,731,483,1214,+
chr1,230280280,5.2518349784864595,829,438,1267,+
chr1,230280304,1.6746917204932477,735,523,1258,+
chr1,230280320,1.6841249682499364,895,634,1529,+
chr1,230280348,1.0953282006509837,2725,1922,4647,+
chr1,230280389,0.6016476388168137,2649,1926,4575,+
chr1,230280540,1.58388690172032,1640,1235,2875,+
chr1,230280541,1.765817901234568,1193,863,2056,+
chr1,230280557,2.883997331877993,1159,716,1875,+
chr1,230280585,0.6117154811715482,1529,1194,2723,+
chr1,230280707,0.558044250204862,680,522,1202,+
chr1,230280711,2.601409978308026,737,460,1197,+
chr1,230280732,1.5762980276181162,2776,1822,4598,+
chr1,230280733,1.5762980276181162,2776,1822,4598,+
chr1,230280734,1.5584152551024801,3578,2452,6030,+
chr1,230280762,1.5987311657414751,671,581,1252,+
chr1,230280763,0.7218821757215765,3279,2140,5419,+
chr1,230280764,0.7218821757215765,3279,2140,5419,+
chr1,230280779,1.3380716706560813,3143,2491,5634,+
chr1,230280845,0.31932477580446633,1815,1209,3024,+
chr1,230281019,2.0566502463054186,834,629,1463,+
chr1,230281047,1.4077337687026146,1123,732,1855,+
chr1,230281048,1.759162303664921,959,763,1722,+
chr1,230281265,0.6357039187227866,802,571,1373,+
chr1,230281337,1.5917501391207571,933,598,1531,+
chr1,230281356,3.3194233687405155,874,658,1532,+
chr1,230281388,1.6375109833053756,819,641,1460,+
chr1,230281392,1.8632806732614795,630,520,1150,+
chr1,230281434,0.4793941340184114,688,518,1206,+
chr1,230281457,2.6993464052287583,648,494,1142,+
chr1,230281477,2.342244044371704,735,610,1345,+
chr1,230281542,1.8259109311740886,1352,1169,2521,+
chr1,230281716,0.3324014723976287,1411,389,1800,+
chr1,230281725,6.604413745870728,2987,478,3465,+
chr1,230281727,7.207031219868307,4451,727,5178,+
chr1,230281728,5.931996505499185,4859,797,5656,+
chr1,230281730,7.57234447007186,4444,753,5197,+
chr1,230281731,13.048868760292253,3890,643,4533,+
chr1,230281733,6.334269662921348,2254,355,2609,+
chr1,230281734,5.32469817520359,4601,897,5498,+
chr1,230281735,7.233761761851934,8751,1768,10519,+
chr1,230281736,7.100114361029043,8906,1820,10726,+
chr1,230281737,6.34114139511067,7417,1737,9154,+
chr1,230281738,16.629161184210528,2896,1215,4111,+
chr1,230281739,13.053418537949211,10799,10164,20963,+
chr1,230281740,7.645073660630592,11957,15458,27415,+
chr1,230281741,6.747138082749035,12281,16930,29211,+
chr1,230281742,6.546484704369762,9629,16247,25876,+
chr1,230281743,2.3073085144825,2895,4388,7283,+
chr1,230281752,0.5346499526963102,1232,1811,3043,+
chr1,230281754,0.2965031568722681,813,1845,2658,+
chr1,230281758,0.4657918071325113,10139,16418,26557,+
chr1,230281759,0.46174169470829274,11897,18669,30566,+
chr1,230281760,0.4986058769995663,6465,8616,15081,+
chr1,230281761,0.5169398824585364,5001,6580,11581,+
chr1,230281764,0.5070443668233497,6262,9874,16136,+
chr1,230281766,0.34920449971400125,1781,3630,5411,+
chr1,230690107,0.6959668283925868,805,541,1346,+
chr1,230690122,1.7629537021802217,600,401,1001,+
chr1,230691385,2.163929540516925,2501,1899,4400,+
chr1,230691386,2.896825396825397,1094,818,1912,+
chr1,230691389,1.6122840690978886,545,520,1065,+
chr1,230693639,0.6144799201959013,858,592,1450,+
chr1,230997181,1.9283508448455637,952,680,1632,+
chr1,231266047,2.2425436632333184,962,769,1731,+
chr1,231266048,2.629934210526316,1475,1215,2690,+
chr1,231266050,2.4553887670770793,1003,846,1849,+
chr1,231266053,2.1766992331127217,559,500,1059,+
chr1,231274037,3.337944713129275,935,761,1696,+
chr1,231277553,2.3251483765855934,998,660,1658,+
chr1,231277555,2.3251483765855934,998,660,1658,+
chr1,231564752,1.8941922418286012,2537,2073,4610,+
chr1,231564753,2.1000934035779384,2205,1797,4002,+
chr1,231564792,0.6994480632489681,1152,1182,2334,+
chr1,231564795,1.9797932330827068,765,607,1372,+
chr1,231566186,3.6861001317523057,721,505,1226,+
chr1,233672080,3.089715552018289,629,385,1014,+
chr1,234373517,1.8947599691102706,774,528,1302,+
chr1,234374260,0.9339207048458152,635,453,1088,+
chr1,234374261,0.9339207048458152,635,453,1088,+
chr1,234374317,1.7272727272727275,702,480,1182,+
chr1,234374365,1.933938294010889,665,434,1099,+
chr1,234374370,0.6465896917033687,1163,812,1975,+
chr1,234383739,2.231151998364937,1547,1013,2560,+
chr1,234383802,2.103378103378104,1063,636,1699,+
chr1,234383887,1.396910762939675,4472,2971,7443,+
chr1,234383891,1.1373113997595603,4849,3213,8062,+
chr1,234383915,1.8213654891304343,3697,2943,6640,+
chr1,235414463,1.6264719286498401,746,512,1258,+
chr1,235419531,0.6570114464634683,791,526,1317,+
chr1,235738350,1.0659956041946685,735,480,1215,+
chr1,235738355,0.9979140592407177,623,422,1045,+
chr1,235738357,0.8604923097347298,782,556,1338,+
chr1,235738670,0.6769225927620611,929,721,1650,+
chr1,235738671,0.7223074804234054,705,590,1295,+
chr1,235738672,0.7223074804234054,705,590,1295,+
chr1,235738690,1.0154142581888248,526,518,1044,+
chr1,235738692,0.8663510884689098,959,845,1804,+
chr1,236483211,1.0675427394304922,1560,1118,2678,+
chr1,236483212,0.7681294412811923,740,517,1257,+
chr1,236483213,1.2135549179884153,1018,636,1654,+
chr1,236483215,1.4084513496765987,918,674,1592,+
chr1,236483237,1.0926274039436557,2496,1680,4176,+
chr1,236483238,1.0237648349211754,3601,2508,6109,+
chr1,236483240,1.1202980280010388,3743,2468,6211,+
chr1,236483242,1.2862183939983332,2722,1829,4551,+
chr1,236483243,1.4476356071661438,743,902,1645,+
chr1,236483314,0.6147865483285455,1131,842,1973,+
chr1,236483315,1.7085983033562893,3288,2382,5670,+
chr1,236483316,1.598429014124675,5810,4359,10169,+
chr1,236483318,1.5541325501136123,6276,4569,10845,+
chr1,236483319,1.4594714517456118,4787,3458,8245,+
chr1,236483320,1.444931331881166,4015,2790,6805,+
chr1,236483338,2.2135827373311328,822,860,1682,+
chr1,236483371,0.47981927710843375,943,663,1606,+
chr1,236483391,1.467931262452371,2391,2195,4586,+
chr1,236483393,1.3248584657654316,2337,1987,4324,+
chr1,236483395,1.5117952149907985,2007,1719,3726,+
chr1,236483396,1.5117952149907985,2007,1719,3726,+
chr1,236483398,1.155202301436202,4745,3787,8532,+
chr1,236483800,2.2988779345543735,1417,1439,2856,+
chr1,236483803,0.5777218675866688,1794,1519,3313,+
chr1,236483805,0.5689322093431682,626,656,1282,+
chr1,236483806,0.6668259657506969,643,464,1107,+
chr1,236483809,1.7394354221579795,834,618,1452,+
chr1,236483819,0.8680955650452511,6346,4867,11213,+
chr1,236483820,0.7939009218794858,1463,1333,2796,+
chr1,236483821,0.98534745463172,3078,1971,5049,+
chr1,236483824,0.848469526728016,12009,9774,21783,+
chr1,236483825,0.9588741754753272,7912,6944,14856,+
chr1,236484361,1.2045955453988946,1074,863,1937,+
chr1,236484362,0.9782419121808801,1600,1281,2881,+
chr1,236484364,0.5905656797866287,979,792,1771,+
chr1,236484365,0.8703681357285521,2236,1581,3817,+
chr1,236484367,0.9340359910298723,3872,2907,6779,+
chr1,236484368,0.9630768050670088,1974,1600,3574,+
chr1,236484371,0.5885077863197319,1705,1139,2844,+
chr1,236484377,0.6988235294117647,1781,1427,3208,+
chr1,236484379,1.3787654521795705,2834,2649,5483,+
chr1,236484380,1.3787654521795705,2834,2649,5483,+
chr1,241860638,2.49415865837573,1150,731,1881,+
chr1,241860640,2.49415865837573,1150,731,1881,+
chr1,241860665,2.2342857142857144,764,629,1393,+
chr1,241860668,2.081448559687286,1326,1045,2371,+
chr1,241860680,0.5839130141149457,1047,883,1930,+
chr1,241860683,2.595503834964295,1691,994,2685,+
chr1,241860685,2.595503834964295,1691,994,2685,+
chr1,241861407,1.7124993915569136,1534,959,2493,+
chr1,241861414,1.4757543561410964,1876,1447,3323,+
chr1,241861431,1.803921897714349,3139,2353,5492,+
chr1,243304734,0.75761253309797,653,411,1064,+
chr1,243304735,0.75761253309797,653,411,1064,+
chr1,243304736,0.75761253309797,653,411,1064,+
chr1,244706066,1.7175438613645975,615,414,1029,+
chr1,244706160,1.1059420726537241,596,413,1009,+
chr1,246724568,3.981845238095238,786,279,1065,+
chr1,246724569,3.981845238095238,786,279,1065,+
chr1,246724570,2.789197807468431,680,476,1156,+
chr1,246726901,1.046527777777778,684,575,1259,+
chr1,246726903,1.046527777777778,684,575,1259,+
chr1,246726918,1.7082228116710876,643,441,1084,+
chr1,246726940,1.823858049521767,948,677,1625,+
chr1,246735988,2.0988128886376485,951,609,1560,+
chr1,246740226,1.8360354915358308,2239,1718,3957,+
chr1,246744077,2.5423728813559316,815,471,1286,+
chr1,246744091,2.8099832214765095,956,595,1551,+
chr1,246744106,2.7093195266272194,593,506,1099,+
chr1,246744111,0.40054010261949774,617,528,1145,+
chr1,246758317,2.0539281774727294,1196,795,1991,+
chr1,246760011,1.6607142857142856,557,447,1004,+
chr1,246764307,0.6347153712838287,827,576,1403,+
chr1,246766080,2.647312221316813,1057,729,1786,+
chr1,246767238,1.5518067226890755,946,699,1645,+
chr1,944627,0.785100043261951,519,483,1002,-
chr1,946190,0.6185208092203961,980,570,1550,-
chr1,946191,0.6574504739173973,957,586,1543,-
chr1,956952,5.589434283284913,1900,1739,3639,-
chr1,956953,5.330268019799649,1242,1160,2402,-
chr1,956987,3.445918865813051,1565,1094,2659,-
chr1,956989,3.445918865813051,1565,1094,2659,-
chr1,1217035,3.46136061094348,1739,1264,3003,-
chr1,1217113,2.1345291479820627,951,668,1619,-
chr1,1217139,0.4896405919661733,578,439,1017,-
chr1,1217229,0.3889028444452947,986,655,1641,-
chr1,1217257,1.0671542553191489,641,563,1204,-
chr1,1217258,1.0671542553191489,641,563,1204,-
chr1,1217259,1.0671542553191489,641,563,1204,-
chr1,1217271,2.39855459449083,1045,613,1658,-
chr1,1217273,3.207302660156503,1390,775,2165,-
chr1,1217274,3.8765306122448977,1047,489,1536,-
chr1,1217276,4.640461215932914,698,317,1015,-
chr1,1217578,1.8451480781348453,688,528,1216,-
chr1,1217638,1.2096880295929624,2169,1630,3799,-
chr1,1217660,1.9457547169811318,593,423,1016,-
chr1,1217665,2.203396422089707,738,405,1143,-
chr1,1218515,1.8160237388724036,951,673,1624,-
chr1,1218523,1.9809630459126544,1797,1177,2974,-
chr1,1218524,1.9809630459126544,1797,1177,2974,-
chr1,1218529,2.166485764381732,997,825,1822,-
chr1,1218530,2.166485764381732,997,825,1822,-
chr1,1218569,1.9799634003631417,1125,761,1886,-
chr1,1218618,1.1000812083807052,825,654,1479,-
chr1,1218620,1.3749004404517486,1480,1057,2537,-
chr1,1223311,2.4800540906017585,523,492,1015,-
chr1,1223848,2.374869109947644,647,381,1028,-
chr1,1223944,1.443673966349146,2344,1487,3831,-
chr1,1223945,1.5856350666465067,4073,2998,7071,-
chr1,1223946,0.9990414034903417,950,988,1938,-
chr1,1223947,1.8490138951142983,1601,919,2520,-
chr1,1228485,0.5961538461538461,588,455,1043,-
chr1,1228656,1.1461386900497774,746,624,1370,-
chr1,1228688,3.718390804597701,646,521,1167,-
chr1,1228690,3.718390804597701,646,521,1167,-
chr1,1257225,0.4628674568922816,1505,990,2495,-
chr1,1257226,0.517987501934232,928,659,1587,-
chr1,1313059,2.3922889248710595,899,673,1572,-
chr1,1373803,0.5455810716771051,559,478,1037,-
chr1,1373822,2.2955465587044537,809,493,1302,-
chr1,1373853,0.5015723270440252,637,476,1113,-
chr1,1373891,2.0736196319018405,675,488,1163,-
chr1,1374055,0.4852368963149462,953,770,1723,-
chr1,1374072,1.7959472521730444,1695,1345,3040,-
chr1,1374073,1.6356011183597392,674,554,1228,-
chr1,1374103,2.733663366336634,1003,605,1608,-
chr1,1374115,2.2861736334405145,1026,621,1647,-
chr1,1374126,0.351245704467354,628,484,1112,-
chr1,1374202,2.533070644525753,719,417,1136,-
chr1,1374241,0.4541104299121854,781,613,1394,-
chr1,1374295,1.8725182863113896,727,428,1155,-
chr1,1374418,2.167119565217391,956,459,1415,-
chr1,1374420,2.167119565217391,956,459,1415,-
chr1,1375127,7.746242965798685,640,422,1062,-
chr1,1402007,1.8203787184717644,1075,776,1851,-
chr1,1402109,1.7445772465692784,562,501,1063,-
chr1,1402125,1.0112682809877729,911,775,1686,-
chr1,1402126,0.7770813673080114,1404,1098,2502,-
chr1,1406927,1.287042183805648,770,543,1313,-
chr1,1407006,1.2403968786697495,662,483,1145,-
chr1,1407165,1.84302762565388,616,418,1034,-
chr1,1541733,1.3664721400004725,679,520,1199,-
chr1,1541936,1.6945043103448274,934,637,1571,-
chr1,1541992,1.8313333017122797,989,726,1715,-
chr1,1543881,1.261557896181337,7289,5627,12916,-
chr1,1543884,2.0427573340674843,4353,3189,7542,-
chr1,1543890,1.9641863323617326,5858,3957,9815,-
chr1,1543891,1.8409093343903666,5711,4163,9874,-
chr1,1543893,1.6347123242698092,5413,3483,8896,-
chr1,1543895,0.7143942848457213,2114,1376,3490,-
chr1,1543923,1.7259816207184628,1032,683,1715,-
chr1,1543926,1.9613024207296283,884,418,1302,-
chr1,1543982,0.5747008547008547,737,449,1186,-
chr1,1544937,1.5571563088512244,718,589,1307,-
chr1,1544993,2.265579878900792,736,564,1300,-
chr1,1564831,1.8419205406209265,1710,1178,2888,-
chr1,1564847,2.0208074534161495,722,419,1141,-
chr1,1751753,2.6688729340144386,1455,938,2393,-
chr1,1751775,0.37615311291556297,818,449,1267,-
chr1,1751789,1.0929915048543688,654,411,1065,-
chr1,1751791,1.245521000605336,1158,687,1845,-
chr1,1785522,1.190891641947304,818,520,1338,-
chr1,1785523,1.5824072989585798,1583,1028,2611,-
chr1,1785525,2.353734939759036,791,497,1288,-
chr1,1785737,9.121196706950004,1387,1893,3280,-
chr1,1785738,9.121196706950004,1387,1893,3280,-
chr1,1785743,19.46285890621038,1536,1176,2712,-
chr1,1785744,19.46285890621038,1536,1176,2712,-
chr1,1785745,29.462547232718386,788,408,1196,-
chr1,1785747,20.379024853672167,1233,386,1619,-
chr1,1785938,1.8954996186117465,780,626,1406,-
chr1,1785950,2.0260375709917,681,544,1225,-
chr1,1785952,1.7538126361655775,827,611,1438,-
chr1,1786024,1.846560846560846,697,449,1146,-
chr1,1786057,2.7849056603773588,737,423,1160,-
chr1,1786268,3.690659046258261,737,508,1245,-
chr1,1786270,3.690659046258261,737,508,1245,-
chr1,1786312,5.1363231273823065,666,505,1171,-
chr1,1786497,2.565217391304348,589,505,1094,-
chr1,1786912,2.579642857142857,698,559,1257,-
chr1,1786924,0.3718528831651004,640,506,1146,-
chr1,1786947,2.723305208030259,719,490,1209,-
chr1,1786982,0.6085122699386504,620,488,1108,-
chr1,1787018,1.6445454545454548,669,439,1108,-
chr1,1787355,2.761640360180506,1680,1232,2912,-
chr1,1787356,2.761640360180506,1680,1232,2912,-
chr1,1787385,0.7036141149686966,644,501,1145,-
chr1,1787386,1.6879021879021878,1219,776,1995,-
chr1,1787387,1.6879021879021878,1219,776,1995,-
chr1,1787419,1.5771972675775807,766,566,1332,-
chr1,1790481,4.240572889096204,749,609,1358,-
chr1,1804490,2.268965517241379,657,434,1091,-
chr1,1804535,1.431571377202445,1075,617,1692,-
chr1,1804536,1.1875113843506293,1410,881,2291,-
chr1,1815788,2.036880870222826,1401,830,2231,-
chr1,1815790,2.105806451612904,1103,574,1677,-
chr1,1825410,1.9926199261992616,854,812,1666,-
chr1,1825499,0.8451027020670621,1378,1328,2706,-
chr1,1825500,1.0684554257954508,817,796,1613,-
chr1,1839208,1.2995972971128251,3320,2729,6049,-
chr1,1839216,1.3857627693916919,11007,7988,18995,-
chr1,1839218,1.3105105437216171,7117,4926,12043,-
chr1,1839226,1.4102371771931201,6575,4941,11516,-
chr1,1839227,1.4757137537335228,3850,2850,6700,-
chr1,1839229,1.4264793783622234,6062,3823,9885,-
chr1,1839230,1.4748304791930629,10996,7063,18059,-
chr1,1839231,1.459695760218284,12395,7981,20376,-
chr1,1839232,1.400447122982703,7309,4437,11746,-
chr1,1839233,1.4506411181809813,3555,2422,5977,-
chr1,1839234,1.046293080869258,6279,4204,10483,-
chr1,1839236,0.7279912418894022,2879,2202,5081,-
chr1,1839237,1.4221662180691688,1408,811,2219,-
chr1,1839238,1.4221662180691688,1408,811,2219,-
chr1,1890840,1.6138372697665508,1052,598,1650,-
chr1,1890852,1.7552017654476668,654,487,1141,-
chr1,3635022,0.9910432033719704,593,437,1030,-
chr1,3635024,0.9910432033719704,593,437,1030,-
chr1,3635045,0.40823766912140325,587,440,1027,-
chr1,3835034,3.461462124843114,750,556,1306,-
chr1,6185153,1.6305849838783972,1179,834,2013,-
chr1,6185715,0.5233586024184875,687,568,1255,-
chr1,6185717,0.6299385045544891,1861,1235,3096,-
chr1,6185741,3.1010101010101008,613,485,1098,-
chr1,6185742,0.4300966671475978,541,477,1018,-
chr1,6185781,1.3892847884859656,2202,1609,3811,-
chr1,6186059,1.5736141466322275,989,718,1707,-
chr1,6186078,1.8088048090523337,1002,706,1708,-
chr1,6186200,1.7835676684214037,1486,1046,2532,-
chr1,6186340,0.6830596053996771,5956,6635,12591,-
chr1,6186367,0.5544903525050164,6206,7685,13891,-
chr1,6186368,0.6064624806069714,5627,6172,11799,-
chr1,6186370,0.5377653585203046,4937,6286,11223,-
chr1,6186371,0.3538677009265244,1492,3059,4551,-
chr1,6186372,0.4793926699296534,5109,7885,12994,-
chr1,6186375,0.5657508601497673,1671,2195,3866,-
chr1,6186376,0.5657508601497673,1671,2195,3866,-
chr1,6186380,0.42438875430314466,2100,3802,5902,-
chr1,6186383,0.3289477425604481,1870,3625,5495,-
chr1,6186387,1.2007603104196136,2252,5512,7764,-
chr1,6186389,3.9335245480506154,4833,11146,15979,-
chr1,6186390,5.688106683662832,3933,8167,12100,-
chr1,6186391,6.433240450940493,5402,9498,14900,-
chr1,6186392,8.202745055570125,4020,6295,10315,-
chr1,6186393,13.227854187465116,2072,1759,3831,-
chr1,6186395,5.338326446280992,794,241,1035,-
chr1,6186397,4.431422543309764,1826,773,2599,-
chr1,6186398,6.304621875665509,1482,555,2037,-
chr1,6186400,7.941774059108956,1941,735,2676,-
chr1,6186402,7.497165081321622,1163,371,1534,-
chr1,6186404,5.585072874771287,1109,246,1355,-
chr1,6186405,6.0237096435694975,2419,636,3055,-
chr1,6186407,5.812289462683557,1765,487,2252,-
chr1,6197751,1.3587974683212225,9504,6859,16363,-
chr1,6197754,1.2667144082335753,16890,11928,28818,-
chr1,6197755,1.164266312581424,22257,15559,37816,-
chr1,6199583,1.067864502160478,6131,3988,10119,-
chr1,6199586,1.4264217369062047,5536,3976,9512,-
chr1,6199587,1.3136000790818507,5064,2765,7829,-
chr1,6199589,1.3608652061534672,16144,9395,25539,-
chr1,6199590,1.428534122115889,16100,9877,25977,-
chr1,6199591,1.1831553352616333,19549,11719,31268,-
chr1,6199593,1.0371612946010726,12366,7238,19604,-
chr1,6199594,0.9986317430335792,6759,4148,10907,-
chr1,6199595,0.9705731706707535,5929,3109,9038,-
chr1,6224045,2.0821561073750368,1108,950,2058,-
chr1,6224647,3.841679795906664,607,407,1014,-
chr1,6233614,1.6160819493772542,721,648,1369,-
chr1,6234919,1.1214080459770115,668,463,1131,-
chr1,6234920,1.418414206087002,854,604,1458,-
chr1,6637335,0.6587938316224501,993,534,1527,-
chr1,8012536,3.571107157314054,633,440,1073,-
chr1,8012960,29.524127470599062,2004,1626,3630,-
chr1,8012961,28.824491855199625,2260,1714,3974,-
chr1,8012962,16.620658135283364,1044,546,1590,-
chr1,8012963,6.528584817244611,773,290,1063,-
chr1,8861053,1.5148081529948165,15729,11489,27218,-
chr1,8861227,1.4486676996931305,11919,7472,19391,-
chr1,8861249,1.318565775136785,32917,21395,54312,-
chr1,8861250,1.332160941002899,38513,26441,64954,-
chr1,8861379,1.1912898724434065,14161,11810,25971,-
chr1,8861399,1.221579103500292,18504,10626,29130,-
chr1,8861400,1.1129250961424593,25019,15692,40711,-
chr1,8861406,1.281947197106691,7841,4374,12215,-
chr1,8861409,1.5292369069766878,12124,7120,19244,-
chr1,8861427,1.4088461025184311,5962,3021,8983,-
chr1,8861429,1.4088461025184311,5962,3021,8983,-
chr1,8862917,0.6916174161149498,14606,9091,23697,-
chr1,8862945,0.8877714633808775,4802,3558,8360,-
chr1,8862946,0.9528771027798539,3099,2265,5364,-
chr1,8863278,1.191750452116039,41916,27768,69684,-
chr1,8863279,1.191750452116039,41916,27768,69684,-
chr1,8863997,0.8449170106722071,27281,19161,46442,-
chr1,8864040,1.5219542120603642,8470,7020,15490,-
chr1,8864083,1.0874633401121447,16139,13403,29542,-
chr1,8864092,0.8399747067243886,1340,1050,2390,-
chr1,8864093,0.8692741444051861,1216,934,2150,-
chr1,8865299,1.1872090676138725,13050,8102,21152,-
chr1,8865313,1.2295688321021834,12978,7963,20941,-
chr1,8865334,1.2385014196448445,7173,5514,12687,-
chr1,8865379,1.4562923111248227,7711,6002,13713,-
chr1,8865382,1.2347175018035883,14449,11046,25495,-
chr1,8865383,1.1406271844159934,37149,26566,63715,-
chr1,8866340,1.2536883559310459,24310,16804,41114,-
chr1,8866439,1.2555204951234156,57642,41243,98885,-
chr1,8866440,1.2862571934877285,44283,30675,74958,-
chr1,8867135,1.2129662720571812,14127,8953,23080,-
chr1,8867136,0.8594671987656552,19032,15315,34347,-
chr1,8867186,1.2843870967741935,7741,5734,13475,-
chr1,8867247,1.1312515296269787,22956,17189,40145,-
chr1,8868057,0.9815882307362807,1254,972,2226,-
chr1,8868058,0.9348859604593412,2994,2359,5353,-
chr1,8871940,1.1732967571768362,38346,28348,66694,-
chr1,8871951,1.2808843093825717,7978,5788,13766,-
chr1,8871977,1.6747949123203132,6544,4428,10972,-
chr1,8871986,0.6434309326330431,763,557,1320,-
chr1,8874873,1.156807890110665,8970,7179,16149,-
chr1,8874902,1.1183688045779587,12831,8875,21706,-
chr1,8874915,1.4334975965311496,52423,31971,84394,-
chr1,8874916,1.458088513794468,41428,24205,65633,-
chr1,8874917,1.3901679573823627,53715,32896,86611,-
chr1,8874918,0.9569750828779852,1097,861,1958,-
chr1,8878653,1.3587411080335663,21042,9137,30179,-
chr1,8878678,1.710490418791372,56077,27638,83715,-
chr1,8878685,0.5565475527795878,49965,21455,71420,-
chr1,8878686,0.5528314268298884,23649,10376,34025,-
chr1,8878688,1.115142083119426,12556,7657,20213,-
chr1,8878689,1.092376638505508,13580,9208,22788,-
chr1,8878708,1.4162782359268555,3554,2788,6342,-
chr1,8878709,1.4162782359268555,3554,2788,6342,-
chr1,9936576,3.3858643744030563,708,697,1405,-
chr1,9936577,3.3858643744030563,708,697,1405,-
chr1,9936585,2.5698964255633743,1023,841,1864,-
chr1,9936586,2.736974187380497,618,522,1140,-
chr1,9936591,5.08545328474862,672,442,1114,-
chr1,9942722,1.6442553191489362,643,422,1065,-
chr1,9942743,1.733544342582606,732,490,1222,-
chr1,10463598,0.9227564905010518,784,628,1412,-
chr1,11068059,3.1914097213137187,767,571,1338,-
chr1,11076872,2.4407291875991484,767,554,1321,-
chr1,11079757,2.163908489786626,814,671,1485,-
chr1,11079803,1.80622009569378,754,493,1247,-
chr1,11080521,1.437305015937651,944,691,1635,-
chr1,11088152,2.094814814814815,807,539,1346,-
chr1,11088165,1.6693217551178916,939,537,1476,-
chr1,11088170,2.0570853117127,1751,951,2702,-
chr1,11088171,1.2174734811468468,2193,1337,3530,-
chr1,11088176,2.7279829545454546,1001,511,1512,-
chr1,11088177,2.7917446065594214,1467,728,2195,-
chr1,11088179,2.765838042687706,1875,883,2758,-
chr1,11088180,2.409026128266033,921,420,1341,-
chr1,11088184,3.9128352490421454,816,347,1163,-
chr1,11088186,3.9128352490421454,816,347,1163,-
chr1,11090597,3.4704505193654884,721,408,1129,-
chr1,11676912,1.5473108622147085,780,675,1455,-
chr1,11676913,0.649777988520382,2412,1682,4094,-
chr1,11676914,0.649777988520382,2412,1682,4094,-
chr1,11676915,0.6315133037694014,650,527,1177,-
chr1,11676919,0.4788043478260869,1761,1359,3120,-
chr1,11676920,1.0646159826331485,1639,1048,2687,-
chr1,11676921,0.5279527771923204,3468,2665,6133,-
chr1,11676922,0.7534123623867839,2068,1681,3749,-
chr1,11680372,0.9221363851242078,820,680,1500,-
chr1,11680374,0.8301733916707178,871,725,1596,-
chr1,11680375,1.065495457559182,959,734,1693,-
chr1,11680424,1.4950308209440248,640,479,1119,-
chr1,15492514,2.656633906633907,691,406,1097,-
chr1,15492515,1.6098107144582183,1293,823,2116,-
chr1,15493004,1.031320471059885,881,613,1494,-
chr1,15493006,1.031320471059885,881,613,1494,-
chr1,15518210,2.4158613117148073,1144,819,1963,-
chr1,15518217,0.7960491535365761,1307,969,2276,-
chr1,15518219,1.0409007352941178,754,575,1329,-
chr1,15518354,2.576867107640153,664,502,1166,-
chr1,15524132,1.9571181167234064,824,512,1336,-
chr1,15807607,1.7473686293130741,2848,1943,4791,-
chr1,15807628,0.7381958960995135,1574,996,2570,-
chr1,15807629,1.4845227583551226,4553,3705,8258,-
chr1,15807630,1.6994139219918905,4846,4046,8892,-
chr1,15807631,1.6994139219918905,4846,4046,8892,-
chr1,15807632,1.490152203543844,2321,1419,3740,-
chr1,15807633,1.490152203543844,2321,1419,3740,-
chr1,15807638,1.5701438848920863,969,555,1524,-
chr1,15807644,1.974755024082378,819,445,1264,-
chr1,15807652,0.8791825035432627,1568,1259,2827,-
chr1,15807653,1.639823605757879,2046,1502,3548,-
chr1,15807655,1.0615549863670164,802,636,1438,-
chr1,15807657,0.806227056644549,1341,907,2248,-
chr1,16683683,0.38016232732945004,1367,765,2132,-
chr1,16683684,0.46527030234999656,1059,609,1668,-
chr1,16683685,0.46527030234999656,1059,609,1668,-
chr1,16685661,0.8774104683195594,636,483,1119,-
chr1,16685662,0.8774104683195594,636,483,1119,-
chr1,16685733,2.9348334907403606,760,500,1260,-
chr1,16685807,3.8789180509765524,893,733,1626,-
chr1,16685990,1.405979778135304,618,459,1077,-
chr1,17018924,1.328437633035334,2053,1403,3456,-
chr1,17018952,1.3911545880407827,1755,1145,2900,-
chr1,17018953,1.4028507126781695,1759,1332,3091,-
chr1,17022633,1.4331898124498283,1436,1157,2593,-
chr1,17022634,2.0484949832775916,1049,896,1945,-
chr1,17022654,1.726397613775026,954,762,1716,-
chr1,17022716,1.681940355817228,772,600,1372,-
chr1,17023984,2.087365194191363,1685,1308,2993,-
chr1,17028639,1.4186383012344734,5231,3750,8981,-
chr1,17033106,1.432350496090844,3389,2727,6116,-
chr1,17033144,2.3634453781512605,1259,951,2210,-
chr1,17044791,0.6267512826091944,3559,2450,6009,-
chr1,17044826,1.5105626279097337,2734,2152,4886,-
chr1,17044828,1.600761217948718,1707,1343,3050,-
chr1,17044837,1.6488984088127294,1282,816,2098,-
chr1,17044840,1.6187747566334685,2036,1436,3472,-
chr1,17044842,1.9550883898709983,743,545,1288,-
chr1,17044869,1.91996891996892,1764,935,2699,-
chr1,17044870,1.91996891996892,1764,935,2699,-
chr1,17044878,2.9856846473029046,532,481,1013,-
chr1,17044879,2.020913675379839,1304,761,2065,-
chr1,17053971,2.2656810734904043,1018,883,1901,-
chr1,17053973,2.0891502365882118,1551,1259,2810,-
chr1,17054021,1.8709829382341276,1064,597,1661,-
chr1,17054028,0.8196890434342203,1587,931,2518,-
chr1,17054029,0.6984578917254721,868,507,1375,-
chr1,17406997,2.019131566187386,693,437,1130,-
chr1,17407114,2.117091365081216,784,510,1294,-
chr1,17407745,8.619225806451613,996,774,1770,-
chr1,17407746,9.280625623307868,1984,1573,3557,-
chr1,17407970,2.3584135678562923,744,548,1292,-
chr1,17408214,1.220862202173263,778,655,1433,-
chr1,17408259,0.49259019380568564,620,990,1610,-
chr1,17408262,0.3615071283095722,709,981,1690,-
chr1,17408263,0.3615071283095722,709,981,1690,-
chr1,17408330,0.16565809379727686,364,660,1024,-
chr1,17408337,18.219564287442036,3248,4075,7323,-
chr1,17408338,19.156458719500424,4099,4265,8364,-
chr1,17408339,19.156458719500424,4099,4265,8364,-
chr1,17408340,28.770252192005515,2848,1360,4208,-
chr1,17408346,8.02533574258719,2942,532,3474,-
chr1,17408347,8.536325394952677,3543,586,4129,-
chr1,17408348,10.228209071607402,3957,690,4647,-
chr1,17408349,12.919111421150918,3794,624,4418,-
chr1,17408351,10.28280849016253,1741,263,2004,-
chr1,17409068,2.906981519507187,857,486,1343,-
chr1,17409069,2.906981519507187,857,486,1343,-
chr1,17409172,2.356413136499786,1206,983,2189,-
chr1,17409174,2.356413136499786,1206,983,2189,-
chr1,17409178,5.649882903981265,578,426,1004,-
chr1,17409192,1.1504643656962854,1048,669,1717,-
chr1,17409986,1.8384500546025666,966,553,1519,-
chr1,17413611,1.4610815879962489,778,456,1234,-
chr1,17420823,1.8668272732128066,1108,878,1986,-
chr1,17420824,1.9012777115837511,1042,853,1895,-
chr1,17422260,2.7449918130623328,583,438,1021,-
chr1,17425642,1.6782202589513056,617,386,1003,-
chr1,17429170,3.003025032232953,584,426,1010,-
chr1,19114867,0.7789558061981043,821,582,1403,-
chr1,19344420,1.182251378817942,627,420,1047,-
chr1,20651875,0.6120141265310923,1625,1106,2731,-
chr1,20652272,1.9372214770908147,994,796,1790,-
chr1,20652282,1.4957943925233643,581,534,1115,-
chr1,20652314,2.7460044681216704,550,528,1078,-
chr1,20652323,1.7942857142857143,784,489,1273,-
chr1,20652328,2.3631091122869536,3445,2473,5918,-
chr1,20652329,2.363109112286953,3445,2473,5918,-
chr1,20652330,0.6140538712949396,640,466,1106,-
chr1,20652424,0.8816175110866551,1926,1428,3354,-
chr1,20652499,1.8735414941864312,1538,1121,2659,-
chr1,20652508,2.2221867007672635,661,390,1051,-
chr1,20652703,1.7217343144236097,925,765,1690,-
chr1,20652708,1.489642184557439,903,707,1610,-
chr1,20652720,2.6039076376554173,732,562,1294,-
chr1,20652721,0.5314737679599383,1001,928,1929,-
chr1,20652722,1.644817073170732,912,703,1615,-
chr1,20652934,1.4780982906918039,1806,1686,3492,-
chr1,20652941,1.0831894174828156,1690,1530,3220,-
chr1,20652957,1.8977357924726346,790,512,1302,-
chr1,20653757,0.5605271721444842,688,438,1126,-
chr1,20654259,2.8159292035398233,887,564,1451,-
chr1,20654689,2.1199119911991198,751,605,1356,-
chr1,20655467,1.88223581973582,790,623,1413,-
chr1,20655508,1.7014557769274747,840,688,1528,-
chr1,20655725,1.104385716371014,1937,1368,3305,-
chr1,20655733,3.101785714285714,578,447,1025,-
chr1,20655739,1.7750196298207106,1439,963,2402,-
chr1,20655777,2.3725351985824195,1019,650,1669,-
chr1,20656175,1.9627056672760512,670,546,1216,-
chr1,20660938,1.4550979407333002,1072,723,1795,-
chr1,20660967,0.6236008954269268,857,582,1439,-
chr1,20660978,1.6440138808559859,757,493,1250,-
chr1,20661257,1.5599874341039288,1520,941,2461,-
chr1,20661258,1.6130728855138294,1771,1126,2897,-
chr1,20742858,3.2946363421482734,689,529,1218,-
chr1,20743344,0.4706477732793522,619,415,1034,-
chr1,20743406,3.6776670817766703,610,437,1047,-
chr1,20743407,3.6776670817766703,610,437,1047,-
chr1,20743787,0.28514607405767,595,426,1021,-
chr1,20743792,2.0776493354548773,853,609,1462,-
chr1,20749865,2.900514854528091,882,612,1494,-
chr1,20757204,2.4236194254062777,630,419,1049,-
chr1,20770972,2.3426323319027182,654,465,1119,-
chr1,20776738,0.9258095504781145,1135,857,1992,-
chr1,20776739,0.44405048076923076,820,639,1459,-
chr1,20779900,3.1544397042558607,557,449,1006,-
chr1,20780355,1.3509532906628698,623,534,1157,-
chr1,20807175,1.4208039350872383,697,604,1301,-
chr1,20807477,2.8850218853421583,562,550,1112,-
chr1,20807478,2.8850218853421583,562,550,1112,-
chr1,20817485,1.350049433197992,678,411,1089,-
chr1,20817486,0.7338292470468256,695,453,1148,-
chr1,20860490,1.2175612873003137,2471,2170,4641,-
chr1,20860493,1.706282231598687,752,710,1462,-
chr1,20860501,1.6341487089885458,909,605,1514,-
chr1,20862245,2.8164271390374336,910,703,1613,-
chr1,20862249,1.6631255562892993,1654,1200,2854,-
chr1,20862251,1.8145512130067336,3518,2451,5969,-
chr1,20862254,1.6095041322314052,778,527,1305,-
chr1,20862258,1.8102773671854626,1040,741,1781,-
chr1,20904967,1.9319558991911547,4160,3183,7343,-
chr1,20941515,0.6423992673992673,1341,1000,2341,-
chr1,20941533,2.6007604562737643,911,525,1436,-
chr1,20941534,1.6383700399591117,952,632,1584,-
chr1,20941581,2.1424302788844622,716,501,1217,-
chr1,20941593,1.9417140542850124,932,659,1591,-
chr1,20942066,2.4424326974047954,621,546,1167,-
chr1,21233618,2.0541269379218687,1014,620,1634,-
chr1,21233632,0.510164365548981,1020,584,1604,-
chr1,21233633,0.510164365548981,1020,584,1604,-
chr1,21233652,2.345073412527839,674,506,1180,-
chr1,21235907,0.4106258480049177,593,470,1063,-
chr1,21245092,1.7651933920531104,924,639,1563,-
chr1,21695128,2.636058360352015,784,507,1291,-
chr1,21695129,1.9642537296196962,1487,1047,2534,-
chr1,21729741,0.4661831231451153,1432,975,2407,-
chr1,21729743,0.4774476463218185,1066,754,1820,-
chr1,21736475,3.630209897001163,1001,694,1695,-
chr1,23310439,1.5276634659350707,1027,728,1755,-
chr1,23310587,1.7827785591498673,712,473,1185,-
chr1,23310593,2.0431372549019606,520,492,1012,-
chr1,23310611,0.5000774161583006,768,750,1518,-
chr1,23310612,1.1366919403145184,1202,1062,2264,-
chr1,23310655,4.576946465453375,787,762,1549,-
chr1,23310656,3.0126136242188335,944,800,1744,-
chr1,23310798,10.092114695340502,760,371,1131,-
chr1,23310799,18.69723546772689,1743,1047,2790,-
chr1,23310800,18.697235467726895,1743,1047,2790,-
chr1,23310831,11.024519105084288,984,379,1363,-
chr1,23310984,3.5281644234463276,2884,2158,5042,-
chr1,23310986,1.8647727272727268,1093,759,1852,-
chr1,23310987,3.3403324584426946,663,380,1043,-
chr1,23311055,2.6013289036544847,647,515,1162,-
chr1,23311060,2.1075060532687653,1087,825,1912,-
chr1,23311062,2.1075060532687653,1087,825,1912,-
chr1,23311298,1.5047827674333698,1287,1244,2531,-
chr1,23311312,1.5473881295637522,2882,2204,5086,-
chr1,23311313,1.5473881295637522,2882,2204,5086,-
chr1,23318497,0.6154590459045906,1012,807,1819,-
chr1,23318509,2.1486613876319756,990,815,1805,-
chr1,23318510,1.6389435480344572,1012,692,1704,-
chr1,23318561,0.5152263374485597,625,404,1029,-
chr1,23318590,1.345267775475712,1282,933,2215,-
chr1,23318647,1.9439694378752048,821,477,1298,-
chr1,23321605,1.5959792809887683,777,628,1405,-
chr1,23321631,2.81280276816609,738,577,1315,-
chr1,23321634,1.8226349963014712,1407,1057,2464,-
chr1,23321636,1.8226349963014712,1407,1057,2464,-
chr1,23321649,1.6449172576832152,993,657,1650,-
chr1,23321656,2.1052631578947367,799,531,1330,-
chr1,23323571,2.445192896509492,967,567,1534,-
chr1,23333616,4.455756661639015,708,441,1149,-
chr1,23333618,0.9936479128856626,656,550,1206,-
chr1,23333619,0.9936479128856626,656,550,1206,-
chr1,23337811,1.0207489683366116,1392,773,2165,-
chr1,23337813,1.0207489683366116,1392,773,2165,-
chr1,23338585,0.7603319783197833,803,575,1378,-
chr1,23338595,2.0165713618858683,639,450,1089,-
chr1,23798161,2.332847142819615,1783,1276,3059,-
chr1,23798171,1.4787554403882874,1686,1024,2710,-
chr1,23798182,0.4242724543128335,626,397,1023,-
chr1,23798669,2.9573929571828734,708,482,1190,-
chr1,23798670,2.4872348366453907,719,529,1248,-
chr1,23967609,6.342650889315713,600,464,1064,-
chr1,23967706,1.9714784633294529,1128,858,1986,-
chr1,23967707,1.4958467309753485,1014,621,1635,-
chr1,23967708,1.9714784633294529,1128,858,1986,-
chr1,23971404,1.972607363808056,734,460,1194,-
chr1,23971594,1.6777493606138103,655,390,1045,-
chr1,23971939,1.8453972000173915,5289,3625,8914,-
chr1,23971943,1.2828246703727273,2322,1776,4098,-
chr1,23971952,1.4241531664212077,1933,1357,3290,-
chr1,23971957,1.6791044776119401,1699,1138,2837,-
chr1,23971975,1.6077054528507069,1175,784,1959,-
chr1,23971982,1.6145379023883697,1013,534,1547,-
chr1,23971990,1.6914682539682542,879,575,1454,-
chr1,23971998,1.9363341336426663,1249,702,1951,-
chr1,23972002,1.546875,1528,972,2500,-
chr1,23972007,1.5467688983582908,1233,684,1917,-
chr1,23975021,1.5048390054014784,4917,2947,7864,-
chr1,23975023,1.733788855719242,5909,3790,9699,-
chr1,23975030,2.0199640287769784,3062,2084,5146,-
chr1,23975031,2.0199640287769784,3062,2084,5146,-
chr1,23975053,0.7231476220381391,2266,1685,3951,-
chr1,23978727,0.5673237984795774,628,397,1025,-
chr1,23978734,2.1442892946652345,1129,930,2059,-
chr1,25228153,2.5522353638759516,1228,1029,2257,-
chr1,25228154,2.32810650887574,731,675,1406,-
chr1,25228203,1.6353262616522015,1664,1036,2700,-
chr1,25228206,1.8994153836820429,4247,3055,7302,-
chr1,25228207,1.8735443922900232,1933,1614,3547,-
chr1,25228232,2.307556497175141,1306,943,2249,-
chr1,25228234,2.307556497175141,1306,943,2249,-
chr1,25246492,2.1555555555555554,775,607,1382,-
chr1,25246494,2.1555555555555554,775,607,1382,-
chr1,25900883,1.2997700648760486,3738,2965,6703,-
chr1,25900915,1.4813096500530218,2234,1747,3981,-
chr1,25901054,1.4008517486360248,5664,3489,9153,-
chr1,25901055,1.4008517486360248,5664,3489,9153,-
chr1,25901539,1.9402480875970847,3033,2592,5625,-
chr1,25901584,1.4737109176782857,3355,2328,5683,-
chr1,25903653,1.5410481949789259,3387,2567,5954,-
chr1,25903665,0.7491680457964891,3082,2340,5422,-
chr1,25903702,0.7520682129624928,2389,1614,4003,-
chr1,25903733,1.3603139896513794,1472,1098,2570,-
chr1,25903744,1.6793282335355666,2151,1337,3488,-
chr1,25904709,0.9226606918294692,1554,1312,2866,-
chr1,25904710,0.9226606918294692,1554,1312,2866,-
chr1,25904728,0.4363139734254681,2229,1948,4177,-
chr1,25904730,0.4285189268651231,1165,906,2071,-
chr1,25906406,0.7152821813570069,1127,759,1886,-
chr1,25906407,0.660411119191618,1390,1021,2411,-
chr1,25906408,0.7152821813570069,1127,759,1886,-
chr1,27404563,4.274945816283112,1881,1310,3191,-
chr1,27404564,4.379537553027847,1720,1172,2892,-
chr1,27404565,3.740676993689042,814,497,1311,-
chr1,27407832,2.6363843699890945,684,551,1235,-
chr1,27891671,1.7662734818698118,621,435,1056,-
chr1,27891935,30.25813484588657,1612,1216,2828,-
chr1,27892087,2.3294983416252077,724,535,1259,-
chr1,27892089,2.317818889970789,1081,789,1870,-
chr1,27892090,2.314635718891038,717,516,1233,-
chr1,27892167,1.0998327062839282,1073,730,1803,-
chr1,27897099,2.0481236678921144,848,571,1419,-
chr1,27907218,1.8429314309994973,1053,866,1919,-
chr1,28096228,0.9804713804713804,671,494,1165,-
chr1,28096229,1.4801283372711946,1012,808,1820,-
chr1,28200628,0.5165525795082372,1616,1236,2852,-
chr1,28201228,1.7314629258517034,799,498,1297,-
chr1,28201298,2.0910651793809545,1061,828,1889,-
chr1,28205328,2.4202386409213434,1452,1025,2477,-
chr1,28205329,2.9086051225354703,769,602,1371,-
chr1,28205332,0.9879855167873599,1304,867,2171,-
chr1,28205333,1.700369157061921,1965,1310,3275,-
chr1,28205334,3.1012612612612616,661,443,1104,-
chr1,28208411,2.136546184738956,664,414,1078,-
chr1,28210023,2.3297663245250058,761,481,1242,-
chr1,28229011,1.6432001697761989,4317,3654,7971,-
chr1,28229015,1.6038428703800915,7475,6046,13521,-
chr1,28229017,1.5265492648839325,14482,11187,25669,-
chr1,28229018,1.4978092772423477,8653,6829,15482,-
chr1,28229019,0.5661439103439271,1986,1285,3271,-
chr1,28229020,0.5661439103439271,1986,1285,3271,-
chr1,28229021,1.4262751585332232,1444,1394,2838,-
chr1,28229023,1.4262751585332232,1444,1394,2838,-
chr1,28232937,1.0075411146420123,3187,2137,5324,-
chr1,28232938,1.4548434535104364,2030,1699,3729,-
chr1,28232939,1.4548434535104364,2030,1699,3729,-
chr1,28232942,0.7466156724631301,1004,648,1652,-
chr1,28232943,0.9511524505545049,1453,1150,2603,-
chr1,28232944,1.4257961562478316,1095,811,1906,-
chr1,28232945,1.1496177242033596,2059,1628,3687,-
chr1,28232946,0.4737021857923498,1386,975,2361,-
chr1,28232947,1.5717988249004566,1862,1470,3332,-
chr1,28232948,0.9148279979094701,3176,2349,5525,-
chr1,28232949,0.521744060067021,1254,922,2176,-
chr1,28232999,1.6949969986995541,890,624,1514,-
chr1,28233023,1.4609518844143057,756,529,1285,-
chr1,28578817,0.7819491892086934,8845,7905,16750,-
chr1,28578818,0.7819491892086934,8845,7905,16750,-
chr1,28578819,0.9418800326986881,1696,1517,3213,-
chr1,28982643,0.564959614239674,10018,8516,18534,-
chr1,28982644,0.9965539843736344,3085,2228,5313,-
chr1,30932987,4.1599325657233415,680,451,1131,-
chr1,30932989,3.198240759889667,889,564,1453,-
chr1,31269227,2.1851034225335546,635,432,1067,-
chr1,31271467,0.8446622885372854,1342,868,2210,-
chr1,31271468,1.0236202893373816,916,508,1424,-
chr1,31281480,1.879806038588507,679,532,1211,-
chr1,31289354,0.370857812677067,765,644,1409,-
chr1,31291980,3.3616861777867433,614,475,1089,-
chr1,31906949,2.553485647334505,640,568,1208,-
chr1,31906951,2.553485647334505,640,568,1208,-
chr1,31907065,1.3257488845756158,635,419,1054,-
chr1,31908940,0.5174775652042034,781,544,1325,-
chr1,31908942,1.916396979503776,645,411,1056,-
chr1,31911760,1.708061002178649,839,509,1348,-
chr1,31911788,1.2920230195891196,772,503,1275,-
chr1,31911799,2.5752895752895757,827,443,1270,-
chr1,31911801,2.5752895752895757,827,443,1270,-
chr1,31919112,0.4012929485041403,612,429,1041,-
chr1,31919113,1.174825174825175,587,428,1015,-
chr1,31919119,4.55890917977743,714,462,1176,-
chr1,31919631,2.660026622316293,747,536,1283,-
chr1,32334087,0.8448908634344215,728,667,1395,-
chr1,32334088,0.8448908634344215,728,667,1395,-
chr1,32334100,0.4215389784946237,578,495,1073,-
chr1,32334101,0.4215389784946237,578,495,1073,-
chr1,32334392,0.9150353773584904,738,529,1267,-
chr1,32334394,0.9150353773584904,738,529,1267,-
chr1,32334606,1.122127941665245,809,614,1423,-
chr1,32334607,1.122127941665245,809,614,1423,-
chr1,32334841,3.002967359050445,791,336,1127,-
chr1,32334915,0.44696313087539175,837,282,1119,-
chr1,32335079,1.1286011060109378,629,451,1080,-
chr1,32365350,3.9508863347789522,636,556,1192,-
chr1,32365351,3.9508863347789522,636,556,1192,-
chr1,32775382,2.3337279513954017,1493,1141,2634,-
chr1,32775383,2.6499740259740254,980,769,1749,-
chr1,32775571,2.4834704079987096,615,476,1091,-
chr1,32775576,2.897658122810253,581,492,1073,-
chr1,32775578,1.8391812865497077,628,503,1131,-
chr1,32775707,1.4187349173725194,1013,800,1813,-
chr1,32775818,2.727466250689332,988,831,1819,-
chr1,32775905,6.929684210526316,632,474,1106,-
chr1,32775958,3.544896820970441,680,488,1168,-
chr1,32775961,0.17965344178673354,2726,1800,4526,-
chr1,32776009,1.8435314989460538,1504,1051,2555,-
chr1,32776010,0.48909751665657175,645,507,1152,-
chr1,32779413,1.6538255497345091,1471,961,2432,-
chr1,32779426,2.2151196172248806,642,549,1191,-
chr1,32779439,1.7768924644039406,1903,1523,3426,-
chr1,32779440,1.876009930038366,1867,1476,3343,-
chr1,32779442,1.4644744679665753,1788,1380,3168,-
chr1,32780215,3.113861386138614,665,605,1270,-
chr1,32780227,2.1186252771618626,685,573,1258,-
chr1,32780246,1.4936647173489277,612,569,1181,-
chr1,32781068,1.8091397849462367,672,464,1136,-
chr1,32781113,1.758072635742539,718,514,1232,-
chr1,32781120,1.859434312402222,1287,882,2169,-
chr1,32782469,2.226851851851852,702,647,1349,-
chr1,32782533,1.8588168885879102,1198,953,2151,-
chr1,32782536,2.4244178220487282,580,436,1016,-
chr1,32786423,1.8128440366972483,701,544,1245,-
chr1,32786440,3.2633841886269077,712,514,1226,-
chr1,32787057,1.6273539118617744,957,605,1562,-
chr1,32787067,1.544540886249429,881,795,1676,-
chr1,32791191,1.5743288250456138,905,802,1707,-
chr1,32797820,2.2237620103473765,829,491,1320,-
chr1,32806496,0.6279207335107957,578,482,1060,-
chr1,32806497,1.8123479573602375,1243,1021,2264,-
chr1,32806498,0.9628972944575782,1332,845,2177,-
chr1,32806500,0.9628972944575782,1332,845,2177,-
chr1,32810677,0.6494708994708993,981,755,1736,-
chr1,32810687,0.5515472182138849,859,566,1425,-
chr1,32810700,1.5619307057120964,833,690,1523,-
chr1,32810723,0.6229202715293491,779,682,1461,-
chr1,32810730,2.051658510059815,685,612,1297,-
chr1,32810761,0.5617391304347826,645,459,1104,-
chr1,32810941,1.7750896057347667,565,464,1029,-
chr1,32817214,0.4891720386784851,882,875,1757,-
chr1,32817215,1.0414814814814817,987,701,1688,-
chr1,32817216,0.45805800929554275,1329,1299,2628,-
chr1,32817217,1.0414814814814817,987,701,1688,-
chr1,32817236,7.693835761783142,2234,1884,4118,-
chr1,32817237,7.693835761783143,2234,1884,4118,-
chr1,32817253,9.49465264882023,1566,922,2488,-
chr1,32817254,8.923665785224802,1557,839,2396,-
chr1,33009482,2.2482993144506964,819,577,1396,-
chr1,33009724,3.948141520087712,709,581,1290,-
chr1,33010234,3.1705428558302677,3113,2282,5395,-
chr1,33010235,2.7824041550745107,5178,3433,8611,-
chr1,33010236,2.827899698752401,6575,4453,11028,-
chr1,33010239,3.8141809290953543,675,408,1083,-
chr1,33010352,1.6609063530761508,1102,733,1835,-
chr1,33010401,0.8159466614379404,3092,2145,5237,-
chr1,33010409,1.687433753385938,1591,1212,2803,-
chr1,33010410,1.687433753385938,1591,1212,2803,-
chr1,33010424,3.585500394011032,699,422,1121,-
chr1,33010430,1.127095384553514,1209,740,1949,-
chr1,33010435,1.0230176140226988,1114,730,1844,-
chr1,33010575,5.076795698189399,3211,2426,5637,-
chr1,33010602,2.6466165413533838,703,474,1177,-
chr1,33010673,0.635132382892057,890,981,1871,-
chr1,33010683,0.44861227922624053,634,724,1358,-
chr1,33010692,0.2715885367242361,476,957,1433,-
chr1,33010693,0.5294592413236481,1311,1533,2844,-
chr1,33010695,0.4263951579281262,4030,6314,10344,-
chr1,33010696,0.4427881165980984,3510,5506,9016,-
chr1,33010697,0.44183120609768256,3996,6046,10042,-
chr1,33010698,0.5187654291822681,2131,2730,4861,-
chr1,33010700,1.2354927135398486,2032,3178,5210,-
chr1,33010701,4.859815561140958,3702,6062,9764,-
chr1,33010703,10.09947921096206,5751,7746,13497,-
chr1,33010704,15.040631887662471,4257,5215,9472,-
chr1,33010705,15.040631887662471,4257,5215,9472,-
chr1,33010710,2.9919909480924405,1914,1008,2922,-
chr1,33010712,5.956823715290524,3966,1841,5807,-
chr1,33010713,7.85213830755232,1568,470,2038,-
chr1,33010714,9.2198245339604,4285,1726,6011,-
chr1,33010715,16.123679259478262,3357,1181,4538,-
chr1,33010717,7.2921239060980705,1543,312,1855,-
chr1,33010718,6.338088116385636,3435,805,4240,-
chr1,33010719,6.489281863179314,2768,650,3418,-
chr1,33010720,6.268953495144954,2611,644,3255,-
chr1,33010722,6.330760463857791,1028,206,1234,-
chr1,33013111,0.604223602484472,767,574,1341,-
chr1,33013259,1.8664637626022451,891,750,1641,-
chr1,33013361,2.978444632290786,728,545,1273,-
chr1,33013363,0.3442967749801865,752,697,1449,-
chr1,33013369,2.7968936233611443,1230,838,2068,-
chr1,33013370,2.7968936233611443,1230,838,2068,-
chr1,33013385,2.324830817282665,811,451,1262,-
chr1,33013391,1.9747899159663864,1315,679,1994,-
chr1,33013392,0.6781870261630911,1786,1324,3110,-
chr1,33013393,1.5579396678811446,2183,1172,3355,-
chr1,33021387,1.8860388983605378,1107,760,1867,-
chr1,33036840,1.2042895331741588,571,450,1021,-
chr1,33036841,1.0698056801195814,841,445,1286,-
chr1,33036842,1.0698056801195814,841,445,1286,-
chr1,33036847,0.5053651756595061,875,574,1449,-
chr1,35183779,4.883762777457915,1041,715,1756,-
chr1,35184491,0.39353153877059055,652,654,1306,-
chr1,35184494,0.9631844984841262,1065,1201,2266,-
chr1,35184496,1.2682436611008039,630,783,1413,-
chr1,35184511,0.42868965517241375,517,874,1391,-
chr1,35184512,0.42868965517241375,517,874,1391,-
chr1,35184534,0.3952403731164793,660,677,1337,-
chr1,35184535,0.4001277744372118,1085,1435,2520,-
chr1,35184540,2.5381493506493498,353,671,1024,-
chr1,35184542,3.6831933631165366,1065,1627,2692,-
chr1,35184548,2.393714643269958,683,792,1475,-
chr1,35184551,5.59685708646894,1431,1530,2961,-
chr1,35184552,5.116391636631245,1234,1273,2507,-
chr1,35184559,19.175803562329932,2477,1563,4040,-
chr1,35184560,18.82041976433219,2672,1633,4305,-
chr1,35184561,18.82041976433219,2672,1633,4305,-
chr1,35187099,0.8078697236927869,1228,780,2008,-
chr1,35187100,0.8508113905724062,1231,808,2039,-
chr1,35188002,2.0588111741230835,675,413,1088,-
chr1,35189026,1.7924221113273346,2296,1461,3757,-
chr1,35189064,1.638198292875167,2882,1588,4470,-
chr1,35189065,1.638198292875167,2882,1588,4470,-
chr1,35189067,1.4248996285317623,1549,918,2467,-
chr1,35189068,0.2844035087719298,1246,749,1995,-
chr1,35189232,1.9775396362937059,9238,6086,15324,-
chr1,35189258,1.5636336268533153,3135,2063,5198,-
chr1,35189262,1.4385692774111674,7885,4594,12479,-
chr1,35189263,1.7924864273311971,5354,3175,8529,-
chr1,35189266,1.3880840275262585,2189,1254,3443,-
chr1,35189270,1.8214512938233824,4131,2307,6438,-
chr1,35189272,0.5724044355027371,2038,1275,3313,-
chr1,35189277,1.4076405891725934,1810,952,2762,-
chr1,35189329,2.107031366136465,1118,650,1768,-
chr1,35189352,2.632231404958678,783,483,1266,-
chr1,35190514,2.1674201945471983,1129,810,1939,-
chr1,35190531,1.7761790567545956,807,555,1362,-
chr1,35190781,0.686681682890414,1942,1292,3234,-
chr1,35191445,1.7889648638100062,1283,1034,2317,-
chr1,35191490,1.6601218686526744,612,421,1033,-
chr1,35192240,2.6329790909756516,628,443,1071,-
chr1,35602482,2.7672397985839203,637,481,1118,-
chr1,35609346,1.5884592852958406,985,568,1553,-
chr1,35609394,1.756033920417482,672,510,1182,-
chr1,35636420,0.6014305816135085,891,655,1546,-
chr1,35636422,0.46538001352546426,851,817,1668,-
chr1,35641365,1.732809917355372,722,549,1271,-
chr1,35641409,1.4587087087087087,579,554,1133,-
chr1,35641415,3.108974358974359,775,467,1242,-
chr1,35641421,2.0780769986905905,1238,868,2106,-
chr1,36136681,0.05589908483799159,451,621,1072,-
chr1,36136683,0.05589908483799159,451,621,1072,-
chr1,36136708,0.17245662069790768,522,667,1189,-
chr1,36136768,3.5914997524209564,1245,2259,3504,-
chr1,36136769,3.4231343283582087,890,1339,2229,-
chr1,36136770,4.536845730027548,1084,1451,2535,-
chr1,36136771,19.789770092759834,2564,2553,5117,-
chr1,36136772,24.935728863185386,2500,2262,4762,-
chr1,36136773,29.459654782082453,2286,1949,4235,-
chr1,36136778,16.90702905299503,1160,164,1324,-
chr1,36136779,19.437494641581328,1177,149,1326,-
chr1,36137938,2.128356471859673,752,522,1274,-
chr1,36137939,2.128356471859673,752,522,1274,-
chr1,36140103,0.8732421875,788,511,1299,-
chr1,36140105,0.8732421875,788,511,1299,-
chr1,36455888,1.8348090392493719,711,657,1368,-
chr1,36455889,2.387678725650129,753,612,1365,-
chr1,36456217,2.080828157349897,738,574,1312,-
chr1,36456241,1.592156862745098,927,679,1606,-
chr1,36456320,1.7950725097654534,1727,1360,3087,-
chr1,36456332,1.9693595453847337,1114,765,1879,-
chr1,36456333,1.6403009835288542,790,581,1371,-
chr1,36461276,1.755713187504368,772,697,1469,-
chr1,36461296,1.801788908765653,1258,909,2167,-
chr1,36461306,1.871183683467257,1671,1249,2920,-
chr1,36462108,1.6043590226744553,622,548,1170,-
chr1,36462118,0.5353383458646617,711,559,1270,-
chr1,36462147,2.1531657291691606,1456,1078,2534,-
chr1,36464282,1.9544752770536569,949,634,1583,-
chr1,36464284,0.8244704620609528,1024,667,1691,-
chr1,36464286,0.8211992662233433,954,622,1576,-
chr1,36464288,1.0201704167221408,612,405,1017,-
chr1,37568307,2.2508650519031144,1300,849,2149,-
chr1,37568323,1.5774268104776583,1052,648,1700,-
chr1,37568333,2.066515107069522,908,486,1394,-
chr1,37568355,1.7150105708245245,779,472,1251,-
chr1,37568957,1.7411990688449641,735,449,1184,-
chr1,37568958,0.3926687536893664,729,475,1204,-
chr1,37582816,4.291051561200611,683,465,1148,-
chr1,37583906,2.364066852367688,827,717,1544,-
chr1,37583907,2.119255140307772,1222,1044,2266,-
chr1,37583909,2.1300332126889505,1012,863,1875,-
chr1,37587330,1.968034188034188,793,449,1242,-
chr1,37587369,0.5101214574898786,719,519,1238,-
chr1,37595808,2.9108882489748176,735,666,1401,-
chr1,37803368,1.7327955137980224,926,700,1626,-
chr1,37803371,1.423694429954211,846,638,1484,-
chr1,37803401,2.7355950457727523,1142,618,1760,-
chr1,37803403,2.521762221591865,1629,943,2572,-
chr1,37803419,2.493524730847246,760,492,1252,-
chr1,37803421,2.493524730847246,760,492,1252,-
chr1,37803423,1.8247150213658425,701,456,1157,-
chr1,37803426,2.527134146341464,613,409,1022,-
chr1,37803428,2.527134146341464,613,409,1022,-
chr1,37803681,3.5459540459540464,686,461,1147,-
chr1,37803683,3.5459540459540464,686,461,1147,-
chr1,37957330,3.8627509168649565,581,844,1425,-
chr1,37958206,1.0639729920265741,1299,974,2273,-
chr1,37960160,1.0415337056242522,632,435,1067,-
chr1,37960161,1.0415337056242522,632,435,1067,-
chr1,37976948,1.6747304582210245,856,529,1385,-
chr1,37979025,1.1816047937512653,638,486,1124,-
chr1,37980610,2.2976386133982962,696,497,1193,-
chr1,37981800,1.1672264497697262,1242,836,2078,-
chr1,37981802,0.7674384134230576,808,552,1360,-
chr1,38839116,2.338725720119192,757,543,1300,-
chr1,38866972,2.668876001104667,603,425,1028,-
chr1,38866973,2.668876001104667,603,425,1028,-
chr1,39568894,1.1925358378645576,578,577,1155,-
chr1,39568896,1.1925358378645576,578,577,1155,-
chr1,39569678,4.036634414853141,681,537,1218,-
chr1,39571269,0.3980741449435042,613,495,1108,-
chr1,39572565,2.783539702330677,671,387,1058,-
chr1,39575950,2.527472527472528,229,870,1099,-
chr1,39575951,2.527472527472528,229,870,1099,-
chr1,40073405,1.755883298218048,893,682,1575,-
chr1,40073420,1.7575718849840252,808,625,1433,-
chr1,40073509,1.5205673758865248,937,657,1594,-
chr1,40073600,1.5476917895048934,1777,1293,3070,-
chr1,40073677,2.6441025641025644,1288,824,2112,-
chr1,40073813,0.69428146632348,1315,880,2195,-
chr1,40073905,1.567471533554066,1293,853,2146,-
chr1,40073936,1.3995438788542236,970,782,1752,-
chr1,40073953,1.7714711359404098,1033,894,1927,-
chr1,40073969,1.836613349711163,1825,1538,3363,-
chr1,40073970,1.9259800351958278,2607,2128,4735,-
chr1,40074061,2.2346170872067286,630,501,1131,-
chr1,40074092,2.0595300598952457,950,799,1749,-
chr1,40074126,1.7563984908738657,688,466,1154,-
chr1,40080408,1.8387505276487968,659,514,1173,-
chr1,40080441,3.072490706319703,911,537,1448,-
chr1,40080463,1.756487025948104,639,500,1139,-
chr1,40089420,1.7897489539748954,766,477,1243,-
chr1,40089424,1.1345846525505454,1325,989,2314,-
chr1,40092080,0.20316693505099304,756,620,1376,-
chr1,40092134,3.067145593869732,780,521,1301,-
chr1,40092141,1.9239861793053288,1057,610,1667,-
chr1,40092464,1.67162471395881,973,873,1846,-
chr1,40092465,0.5753280267509904,1438,1018,2456,-
chr1,40092466,2.0586185693789707,1115,696,1811,-
chr1,40092467,0.5753280267509904,1438,1018,2456,-
chr1,40092492,1.5111428571428571,614,499,1113,-
chr1,40097125,1.1801929947460792,992,613,1605,-
chr1,40097196,2.899988749632862,807,450,1257,-
chr1,42755570,1.0699868891576074,1304,838,2142,-
chr1,42755573,0.4508357915437562,916,677,1593,-
chr1,42755575,0.42308901192828086,2209,1533,3742,-
chr1,42755576,0.38266512333330194,1717,1173,2890,-
chr1,42755579,0.4027349768875193,696,471,1167,-
chr1,42755580,0.4027349768875193,696,471,1167,-
chr1,42926331,3.0093896713615025,640,425,1065,-
chr1,42926380,1.5317410061371326,911,700,1611,-
chr1,42926381,2.3666207919875566,926,689,1615,-
chr1,42926429,5.595351798790194,702,348,1050,-
chr1,42926430,7.5745282823819275,1462,830,2292,-
chr1,42926434,2.816649466804265,711,305,1016,-
chr1,42926435,2.995818198637912,998,461,1459,-
chr1,42926482,1.5491276864728194,900,564,1464,-
chr1,42926484,0.6145266232903996,1156,442,1598,-
chr1,42926492,0.5878136200716846,655,371,1026,-
chr1,42926495,0.4211940647271878,720,316,1036,-
chr1,42926499,0.36899663330508653,1400,928,2328,-
chr1,42926500,0.4312971342383107,1805,1223,3028,-
chr1,42926501,0.4312971342383107,1805,1223,3028,-
chr1,42926502,0.46567020250723234,1316,914,2230,-
chr1,42926504,0.5192067537619932,956,585,1541,-
chr1,42926508,0.43616996658266555,808,596,1404,-
chr1,42926996,1.069298245614035,688,389,1077,-
chr1,42926998,1.069298245614035,688,389,1077,-
chr1,42929774,1.6544549608355092,750,382,1132,-
chr1,42929775,0.6161535385845662,669,409,1078,-
chr1,42930013,1.5115452556348128,564,441,1005,-
chr1,42930015,1.4086124401913875,639,474,1113,-
chr1,42930016,4.2253746253746245,621,454,1075,-
chr1,42930018,1.76702419555999,615,421,1036,-
chr1,43164655,1.921525098403309,2107,1477,3584,-
chr1,43164704,1.8525326797385624,906,611,1517,-
chr1,43164710,2.3900214592274684,1295,931,2226,-
chr1,43164711,2.3900214592274684,1295,931,2226,-
chr1,43164752,1.4239658474521635,1318,891,2209,-
chr1,43164772,1.7345454545454544,635,395,1030,-
chr1,43164792,1.7532158590308369,602,453,1055,-
chr1,43166881,1.5176108433159932,1246,910,2156,-
chr1,43166882,2.17284350218482,958,834,1792,-
chr1,43166887,3.0294759825327517,665,457,1122,-
chr1,43167174,0.6127892668598421,995,825,1820,-
chr1,43167185,2.6452456764360086,1450,1195,2645,-
chr1,43167215,2.5135467980295565,627,463,1090,-
chr1,43168952,1.085258152173913,851,735,1586,-
chr1,43168954,1.085258152173913,851,735,1586,-
chr1,43169020,2.1127413127413126,607,517,1124,-
chr1,43170822,1.963568464730291,716,481,1197,-
chr1,43171523,0.8747364594692839,1023,916,1939,-
chr1,43171524,0.8747364594692839,1023,916,1939,-
chr1,43171625,0.6265616512764802,768,525,1293,-
chr1,43171640,0.6258061160807156,572,505,1077,-
chr1,43171904,2.2286452673219395,1048,706,1754,-
chr1,43171957,2.356720288115246,816,654,1470,-
chr1,43363462,31.53518769621826,999,1141,2140,-
chr1,43363463,36.35920959727979,726,612,1338,-
chr1,43363654,0.6596768336964416,558,458,1016,-
chr1,43384949,0.46483812187473506,1512,1025,2537,-
chr1,43384950,0.46483812187473506,1512,1025,2537,-
chr1,43386092,3.0731707317073167,701,491,1192,-
chr1,43386094,3.0731707317073167,701,491,1192,-
chr1,43386603,0.437057783018868,592,423,1015,-
chr1,43386904,1.698541855024508,942,741,1683,-
chr1,43387575,1.0361963190184051,1125,814,1939,-
chr1,43387576,1.24292107267006,1613,1118,2731,-
chr1,43388368,1.13896773674471,783,598,1381,-
chr1,43388398,1.9708997454863597,709,561,1270,-
chr1,43388399,2.784357087742505,642,510,1152,-
chr1,44122503,0.7258685359404784,867,416,1283,-
chr1,44122506,0.6290607282592344,765,411,1176,-
chr1,44221630,1.1724236852620482,789,566,1355,-
chr1,44308365,2.9679572763684914,569,534,1103,-
chr1,44308366,2.9679572763684914,569,534,1103,-
chr1,44339096,2.4310969666688242,793,523,1316,-
chr1,44339099,0.2440714904547459,632,493,1125,-
chr1,44339305,2.835082200494253,628,406,1034,-
chr1,44874771,1.467672515594592,644,503,1147,-
chr1,44875648,1.916258969341161,1654,1021,2675,-
chr1,44875649,1.916258969341161,1654,1021,2675,-
chr1,44875650,1.9991184541661586,2035,1298,3333,-
chr1,44875653,2.348284682184952,601,436,1037,-
chr1,45511232,1.4153283561555874,9081,7262,16343,-
chr1,45514980,1.5362202806901482,18547,14132,32679,-
chr1,45514981,1.5362202806901482,18547,14132,32679,-
chr1,45518962,1.297085689430187,5963,4597,10560,-
chr1,45519031,1.2375233064014917,4169,3217,7386,-
chr1,45519048,1.3205387714138772,12501,8918,21419,-
chr1,45521853,1.6765258623182118,1467,1280,2747,-
chr1,45521854,0.781044539298724,1878,1542,3420,-
chr1,45521857,1.376740487918396,5460,3058,8518,-
chr1,45521858,1.376740487918396,5460,3058,8518,-
chr1,45521871,1.9525807525807528,6164,3002,9166,-
chr1,45521872,1.7536854420859098,8070,3859,11929,-
chr1,45521873,1.7084626865269084,10234,5667,15901,-
chr1,45521874,1.5976832037336697,11110,6460,17570,-
chr1,45521875,1.334622823984526,4346,2672,7018,-
chr1,45521877,1.5444347814141661,7949,4415,12364,-
chr1,45521878,1.6345467102832743,6866,3252,10118,-
chr1,45521880,2.1999516441005804,2695,1033,3728,-
chr1,45521883,0.7870241961184409,1635,756,2391,-
chr1,45522801,0.6547081416452116,1107,816,1923,-
chr1,45522820,1.5890808692685112,2184,1681,3865,-
chr1,45522851,1.0806984021134167,2608,1269,3877,-
chr1,45522852,1.0826793245404853,7329,4718,12047,-
chr1,45522853,0.9691175563045904,8356,5197,13553,-
chr1,45522854,0.9738430500164568,3804,2237,6041,-
chr1,45522855,1.2013174284319088,3962,2588,6550,-
chr1,45627929,1.451129046563193,559,466,1025,-
chr1,45627931,0.6766236705136909,597,490,1087,-
chr1,45633554,1.1675244074147957,623,510,1133,-
chr1,45633571,1.4466546702016811,883,654,1537,-
chr1,45654639,2.667445904339846,991,630,1621,-
chr1,45654640,2.913107802215622,681,402,1083,-
chr1,45655298,3.5610684447391185,591,444,1035,-
chr1,46188785,1.841696959849868,698,551,1249,-
chr1,46192402,2.461806301281427,582,439,1021,-
chr1,46194631,0.6062821194400141,594,512,1106,-
chr1,46194632,0.6062821194400141,594,512,1106,-
chr1,46194633,0.6062821194400141,594,512,1106,-
chr1,46643248,2.1787307534329647,696,367,1063,-
chr1,50441485,3.603711533944092,666,386,1052,-
chr1,50441487,3.603711533944092,666,386,1052,-
chr1,50567099,1.2907688587424297,759,590,1349,-
chr1,50655511,1.620729597453698,868,565,1433,-
chr1,50788091,1.1115292528300658,666,482,1148,-
chr1,50788168,0.9853465851172274,702,435,1137,-
chr1,50788169,0.9853465851172274,702,435,1137,-
chr1,51158119,1.4306995622803507,575,489,1064,-
chr1,51361187,2.0289633313295807,883,630,1513,-
chr1,51361188,2.0289633313295807,883,630,1513,-
chr1,51363947,2.319029850746269,1242,937,2179,-
chr1,51363949,2.319029850746269,1242,937,2179,-
chr1,51364016,0.2818215115853676,1186,723,1909,-
chr1,51364017,0.2818215115853676,1186,723,1909,-
chr1,51364018,0.2860664758969844,721,412,1133,-
chr1,51364020,0.2733718776005399,608,409,1017,-
chr1,51791594,3.6168831168831166,556,461,1017,-
chr1,51791596,1.8784159919028336,908,740,1648,-
chr1,51791597,1.8784159919028336,908,740,1648,-
chr1,51806885,1.1421389396709325,713,546,1259,-
chr1,51806886,1.1421389396709325,713,546,1259,-
chr1,51809394,2.229906897206916,651,553,1204,-
chr1,51809396,2.229906897206916,651,553,1204,-
chr1,51814066,1.1520547945205482,1246,729,1975,-
chr1,51814068,1.1520547945205482,1246,729,1975,-
chr1,51878305,2.1904640235243678,639,461,1100,-
chr1,52020386,1.4507534782207971,860,613,1473,-
chr1,52023537,3.1050076818875607,745,634,1379,-
chr1,52027335,0.5570490778368239,593,456,1049,-
chr1,52041552,1.1055442714210488,667,632,1299,-
chr1,52041554,1.420466531420278,1139,953,2092,-
chr1,52055014,2.0998355263157897,1501,911,2412,-
chr1,52055015,2.0998355263157897,1501,911,2412,-
chr1,52055034,1.8544364508393285,702,416,1118,-
chr1,52055052,2.8069240513965137,875,495,1370,-
chr1,52055064,1.9351017402900332,1105,570,1675,-
chr1,52055066,2.523711340206185,815,387,1202,-
chr1,52055105,1.3117368804067144,717,432,1149,-
chr1,52393458,2.7704581440129497,630,444,1074,-
chr1,52393569,1.7110574223095334,1301,918,2219,-
chr1,52393576,2.0386258124419685,997,717,1714,-
chr1,52393578,1.8543000832213206,1763,1239,3002,-
chr1,52393579,2.159806055808431,948,651,1599,-
chr1,52687178,1.5991189427312773,571,453,1024,-
chr1,52772228,0.7394635052294974,2877,2189,5066,-
chr1,52772229,1.5978443449048152,2282,1975,4257,-
chr1,52772230,0.796250270070881,14362,10293,24655,-
chr1,52772231,0.9393441399682004,12662,9728,22390,-
chr1,52772232,0.8867988663814207,16343,12073,28416,-
chr1,52772233,0.809767742030112,3045,2467,5512,-
chr1,52772234,1.1182484894143692,1671,1347,3018,-
chr1,52772239,1.4006628292342578,802,545,1347,-
chr1,52772243,1.4127891156462586,791,524,1315,-
chr1,52772244,1.4454939440077241,1076,709,1785,-
chr1,52772245,1.383624640784622,1587,1040,2627,-
chr1,52772335,1.180988490182803,1816,1476,3292,-
chr1,52772336,0.9708173585152642,4374,3118,7492,-
chr1,52772337,0.9741178478984927,6403,4695,11098,-
chr1,52772338,0.927368568933647,3559,2506,6065,-
chr1,52772339,1.0805860805860803,999,779,1778,-
chr1,52772503,1.2425633932687876,3425,2168,5593,-
chr1,52772506,1.5487831377661887,2850,1769,4619,-
chr1,52772578,1.2468060394889666,2792,1763,4555,-
chr1,52772579,1.3339231667054057,2425,1826,4251,-
chr1,52772581,1.3530978977725225,5489,4285,9774,-
chr1,52772583,1.1638096685341017,5188,4340,9528,-
chr1,52772586,1.5121355270064132,6122,4212,10334,-
chr1,52772587,1.5183230054934242,7272,5082,12354,-
chr1,52772589,1.5339087910742113,2504,1956,4460,-
chr1,52772604,0.5595096328854027,1445,949,2394,-
chr1,52772614,0.5597151683334206,1068,806,1874,-
chr1,52772615,0.599316758891227,1590,1221,2811,-
chr1,52772617,0.6142428999571857,1075,846,1921,-
chr1,52772622,0.4540732640787316,754,589,1343,-
chr1,52772623,0.4540732640787316,754,589,1343,-
chr1,53226982,7.993079584775085,461,577,1038,-
chr1,53227008,21.127817885058928,4703,3994,8697,-
chr1,53227009,22.36718278971982,5192,4046,9238,-
chr1,53227010,28.746839026626585,3004,1909,4913,-
chr1,53227011,42.588217492181975,1470,430,1900,-
chr1,53227013,19.759259259259256,1066,107,1173,-
chr1,53227014,19.759259259259256,1066,107,1173,-
chr1,53227015,14.866634590710799,1571,161,1732,-
chr1,53227045,0.2484280544377495,897,328,1225,-
chr1,53238402,1.1817980225216589,909,674,1583,-
chr1,53238495,0.5325564382545203,661,574,1235,-
chr1,53245637,2.5866046150796826,626,468,1094,-
chr1,53250856,0.8940466824023079,973,743,1716,-
chr1,53250857,0.8940466824023079,973,743,1716,-
chr1,53250858,0.8940466824023079,973,743,1716,-
chr1,53266528,4.5746031746031734,523,539,1062,-
chr1,53772452,1.955621342177715,746,469,1215,-
chr1,53787181,0.1706140350877193,777,359,1136,-
chr1,53787182,0.2529408857255833,889,561,1450,-
chr1,53787183,0.2415880757542173,3365,2056,5421,-
chr1,53787184,0.2293078881294024,2958,1873,4831,-
chr1,53787185,0.15926278454391846,1327,923,2250,-
chr1,53796781,3.528661231380473,716,511,1227,-
chr1,53796919,2.0245774622625103,708,533,1241,-
chr1,53806452,2.460734257233163,697,456,1153,-
chr1,53806454,2.460734257233163,697,456,1153,-
chr1,53921748,3.982600006338957,670,527,1197,-
chr1,53930066,1.3616221371046455,10859,8111,18970,-
chr1,53930070,1.9420715098463717,7753,6316,14069,-
chr1,53930071,1.9420715098463717,7753,6316,14069,-
chr1,53930075,1.941279988267996,7059,5172,12231,-
chr1,53930076,1.941279988267996,7059,5172,12231,-
chr1,53930089,1.357731762401023,3680,2312,5992,-
chr1,53930102,1.7167135856532163,2224,1389,3613,-
chr1,53930103,1.572100426886622,2715,1625,4340,-
chr1,53930111,1.8872038539432212,4597,2547,7144,-
chr1,53930113,1.8872038539432212,4597,2547,7144,-
chr1,53930132,1.5132285007699129,1379,738,2117,-
chr1,53930139,1.5796865581675708,2512,1184,3696,-
chr1,53930141,1.5796865581675708,2512,1184,3696,-
chr1,53939996,1.8465647122889817,2046,1102,3148,-
chr1,53940015,1.7971171276533535,3234,1744,4978,-
chr1,53940016,1.7971171276533535,3234,1744,4978,-
chr1,53940022,0.24900526248235144,775,370,1145,-
chr1,53940035,0.4626063829787234,668,375,1043,-
chr1,53940064,0.4442268013895695,1238,768,2006,-
chr1,53940086,1.575826919076347,605,436,1041,-
chr1,53945573,0.42664821212804416,630,510,1140,-
chr1,54040769,1.5215161649944258,852,689,1541,-
chr1,54040772,2.1794871794871797,832,636,1468,-
chr1,54041788,1.5226925746009716,1589,1309,2898,-
chr1,54043432,2.8410596026490067,857,603,1460,-
chr1,54043508,1.7398265932535917,742,686,1428,-
chr1,54047349,1.7213430047257945,894,673,1567,-
chr1,54047364,0.6037106446776612,766,579,1345,-
chr1,54047370,0.6332306507508664,714,489,1203,-
chr1,54053030,1.822881355932204,716,471,1187,-
chr1,54053192,2.2735785953177263,823,459,1282,-
chr1,54053193,1.760303006682187,1273,912,2185,-
chr1,54053200,0.6928509340133255,1219,826,2045,-
chr1,54849803,11.013784478809697,1942,1582,3524,-
chr1,54849808,10.811688311688311,1220,604,1824,-
chr1,54849809,12.549588782216,2585,1579,4164,-
chr1,54849815,2.916287483535064,1440,826,2266,-
chr1,54849943,2.2307187756639015,848,726,1574,-
chr1,54849984,1.0287698412698412,1036,719,1755,-
chr1,54849985,1.0287698412698412,1036,719,1755,-
chr1,54850098,0.5059646236116825,614,441,1055,-
chr1,54850108,1.8187438984705504,620,438,1058,-
chr1,54850367,2.5570776255707757,839,510,1349,-
chr1,54850410,1.6527093596059113,670,376,1046,-
chr1,54850628,1.8376934414148853,664,471,1135,-
chr1,54850634,0.9166087976153569,1676,1224,2900,-
chr1,54850635,0.512713205439164,1783,1327,3110,-
chr1,54850672,2.024859579779488,720,505,1225,-
chr1,54850751,1.2451112286104713,1791,1395,3186,-
chr1,54850752,1.0174701016151466,1685,1263,2948,-
chr1,54850992,1.7423459244532804,625,502,1127,-
chr1,54851295,6.9891688527397156,1263,892,2155,-
chr1,54851604,1.5478915662650603,570,497,1067,-
chr1,54851926,2.306034482758621,641,463,1104,-
chr1,54852054,3.0206671221406767,1044,713,1757,-
chr1,54852055,3.400037369207773,586,445,1031,-
chr1,54854049,0.6258310535223152,808,581,1389,-
chr1,54854051,1.2158648061990163,759,576,1335,-
chr1,54871361,1.2104708360007463,641,517,1158,-
chr1,54871438,2.2477364185110664,661,496,1157,-
chr1,54871440,2.2477364185110664,661,496,1157,-
chr1,54883679,2.0356494684988333,765,550,1315,-
chr1,54883681,1.5274800328175215,1613,1116,2729,-
chr1,54883682,1.568226330889331,1012,762,1774,-
chr1,55068405,3.813616643790842,497,559,1056,-
chr1,58631047,0.3942898789530389,540,508,1048,-
chr1,58631049,0.46679879362201093,1118,1015,2133,-
chr1,58631214,1.431697054698457,1935,1425,3360,-
chr1,58631215,1.431697054698457,1935,1425,3360,-
chr1,58631323,0.4673894338323869,678,595,1273,-
chr1,58631347,2.0785050862450243,722,475,1197,-
chr1,58631353,0.9845479085418628,2613,1804,4417,-
chr1,58631354,0.91785389426516,3599,2703,6302,-
chr1,58631355,0.9600710205322353,3071,2355,5426,-
chr1,58631356,0.9965052103715608,1668,1495,3163,-
chr1,58631362,3.1105874431913816,559,456,1015,-
chr1,61701024,1.6217448915382404,1292,904,2196,-
chr1,61709350,1.9180751983442568,673,445,1118,-
chr1,63454904,0.5883449883449884,630,454,1084,-
chr1,63523200,1.0621362444523117,891,774,1665,-
chr1,63523201,1.3416301440861407,559,488,1047,-
chr1,64836179,1.378125,832,543,1375,-
chr1,64836181,1.6072248865441265,759,533,1292,-
chr1,64837985,0.28602762740339743,680,486,1166,-
chr1,64837986,0.28602762740339743,680,486,1166,-
chr1,64837987,0.28602762740339743,680,486,1166,-
chr1,67411480,1.7145085803432143,1098,640,1738,-
chr1,67411698,0.4662984505596559,794,498,1292,-
chr1,67412105,6.159098538122395,3511,2501,6012,-
chr1,67412130,15.677003809305056,4753,2767,7520,-
chr1,67412131,24.50368271954675,2126,1058,3184,-
chr1,67412132,18.302577954504002,6879,3825,10704,-
chr1,67412213,1.9020790746372835,1089,646,1735,-
chr1,67412468,0.6303319114902692,1454,1022,2476,-
chr1,67412535,3.04728903383612,574,445,1019,-
chr1,67412544,2.093367232621663,1293,969,2262,-
chr1,67412826,3.0401855513627263,924,592,1516,-
chr1,67413069,1.2793703101528031,3425,2432,5857,-
chr1,67413196,1.4779678153172129,1073,912,1985,-
chr1,67413225,1.6320591728754998,816,685,1501,-
chr1,67413237,1.8207559714103363,2167,1518,3685,-
chr1,67413247,2.055832992222677,1167,697,1864,-
chr1,67413251,2.119956636500754,1096,623,1719,-
chr1,67413259,0.5375262054507337,640,529,1169,-
chr1,67415176,1.687985751295337,833,385,1218,-
chr1,67415190,1.9663624787775895,638,495,1133,-
chr1,67415263,0.6580494122335127,1200,716,1916,-
chr1,67415316,1.8075117370892015,890,638,1528,-
chr1,67415319,2.010720887245841,1553,1081,2634,-
chr1,67415321,2.010720887245841,1553,1081,2634,-
chr1,67420108,3.6809889944218304,762,602,1364,-
chr1,67420112,1.4502407790869072,2470,1929,4399,-
chr1,67420113,1.7705472938025677,3897,2762,6659,-
chr1,67420139,0.5919753086419752,684,404,1088,-
chr1,67420146,1.6006237776237555,863,600,1463,-
chr1,67420179,2.9615656209018457,698,430,1128,-
chr1,67420180,2.9615656209018457,698,430,1128,-
chr1,67420181,2.0888455441500513,1061,632,1693,-
chr1,67424942,3.3481461626002975,922,603,1525,-
chr1,67426214,1.3744014880986557,2467,1597,4064,-
chr1,67426256,1.5790933509810026,1864,1351,3215,-
chr1,67426259,2.213209982788296,1142,829,1971,-
chr1,67426264,1.0501378957591023,2485,1728,4213,-
chr1,67426265,1.5701815399596584,1962,1306,3268,-
chr1,67426267,1.6358463567834085,5504,3841,9345,-
chr1,67426268,1.712065899092016,1828,1186,3014,-
chr1,67426282,2.006474866937719,1297,746,2043,-
chr1,67430099,2.7032679738562093,657,356,1013,-
chr1,67430148,4.7914242125779705,2623,1700,4323,-
chr1,67430149,7.797183547486262,1648,1214,2862,-
chr1,67430185,0.287317620650954,1343,728,2071,-
chr1,67430191,1.7916947250280584,613,494,1107,-
chr1,67430230,2.0394642857142857,1214,699,1913,-
chr1,67430240,1.5692090395480227,1312,707,2019,-
chr1,67430241,1.915921115921116,765,494,1259,-
chr1,67430289,1.9943498405260291,2214,1674,3888,-
chr1,67430302,1.5195437182774318,1209,658,1867,-
chr1,67430381,1.0918358456319883,1626,1040,2666,-
chr1,67702290,3.586927277378013,732,554,1286,-
chr1,67702559,2.3975887771725235,605,404,1009,-
chr1,67704563,1.49655105719146,664,470,1134,-
chr1,68125826,0.2102425876010781,389,794,1183,-
chr1,68125827,0.2102425876010781,389,794,1183,-
chr1,68125866,0.2594994978239036,476,823,1299,-
chr1,68125870,2.9506007954126487,782,1236,2018,-
chr1,68125871,7.457534895524113,538,852,1390,-
chr1,68125880,10.316789134046132,1130,1739,2869,-
chr1,68125881,10.316789134046134,1130,1739,2869,-
chr1,68125891,13.186533666109836,600,608,1208,-
chr1,68125892,16.85270291818541,803,888,1691,-
chr1,68194115,1.8942801643251364,717,487,1204,-
chr1,68194152,2.125327704486784,920,700,1620,-
chr1,68194154,0.4740552325581395,592,429,1021,-
chr1,68194156,2.19869265399337,747,464,1211,-
chr1,68232359,3.4768195941836146,799,629,1428,-
chr1,68476219,0.4175189149799348,565,456,1021,-
chr1,68476853,2.2108629954274126,641,471,1112,-
chr1,68477965,1.1073435972629522,624,495,1119,-
chr1,68477966,1.1073435972629522,624,495,1119,-
chr1,68488966,3.1874518267303835,712,498,1210,-
chr1,68488968,3.1874518267303835,712,498,1210,-
chr1,68489031,2.9081398705823793,787,648,1435,-
chr1,71063565,1.4962237595892718,1257,826,2083,-
chr1,71063614,2.3599562602141617,841,614,1455,-
chr1,71063663,1.6807342834740093,910,656,1566,-
chr1,71063770,1.7686184438221688,1221,858,2079,-
chr1,71063802,2.216559139784946,936,557,1493,-
chr1,71063803,2.216559139784946,936,557,1493,-
chr1,71064739,2.4175705632886513,1125,782,1907,-
chr1,71064833,2.6290384615384617,650,399,1049,-
chr1,71065013,2.271051320378674,847,668,1515,-
chr1,71065015,2.271051320378674,847,668,1515,-
chr1,71066879,0.5693811074918567,873,613,1486,-
chr1,71070954,1.7935021995443563,1159,944,2103,-
chr1,71078486,2.1014492753623184,754,452,1206,-
chr1,77154587,1.1210185537824835,1091,724,1815,-
chr1,77161330,1.9781893004115223,626,404,1030,-
chr1,77169351,0.48781676413255354,692,485,1177,-
chr1,77565416,1.7811173110954337,2581,1923,4504,-
chr1,77565417,1.7978545264259551,1461,909,2370,-
chr1,77565419,2.5560822898032205,1680,1289,2969,-
chr1,77565420,2.5560822898032205,1680,1289,2969,-
chr1,77565430,2.1431670281995663,683,460,1143,-
chr1,77565435,0.5380462079357107,856,542,1398,-
chr1,77565452,1.978107407738361,941,588,1529,-
chr1,77565454,1.978107407738361,941,588,1529,-
chr1,77565468,2.392763819095477,767,397,1164,-
chr1,77565470,2.392763819095477,767,397,1164,-
chr1,77565498,2.4171035246377857,1020,591,1611,-
chr1,77565499,2.4665669728690447,752,452,1204,-
chr1,77632876,2.5512265512265517,675,428,1103,-
chr1,77632877,2.5512265512265517,675,428,1103,-
chr1,77632973,3.4667325694787823,778,509,1287,-
chr1,77633051,4.021038062283737,806,424,1230,-
chr1,77633052,4.021038062283737,806,424,1230,-
chr1,77633071,2.768195689089261,658,363,1021,-
chr1,77728637,3.114243795924763,1073,915,1988,-
chr1,77728638,3.1676275426955294,1039,950,1989,-
chr1,77728640,2.510204400859245,1068,805,1873,-
chr1,77948602,1.9886461972750111,1721,1048,2769,-
chr1,77948603,1.9108555370524565,2011,1200,3211,-
chr1,77948605,1.9775197485951321,1662,987,2649,-
chr1,77948767,0.5035227272727273,632,439,1071,-
chr1,77949223,3.6912716872464184,786,545,1331,-
chr1,77955319,2.071161048689138,473,533,1006,-
chr1,77955326,2.2323232323232323,623,593,1216,-
chr1,77955327,2.162573108333025,1053,887,1940,-
chr1,77962909,2.0126514611546686,752,487,1239,-
chr1,77963657,0.5060142928448763,723,551,1274,-
chr1,77964343,1.9150326797385624,585,424,1009,-
chr1,77964736,1.8192635179390149,3113,3275,6388,-
chr1,77964737,1.5345776480426545,5403,5259,10662,-
chr1,77964738,1.7865353037766831,4063,4190,8253,-
chr1,77964739,1.87792390937797,2963,2987,5950,-
chr1,77964743,1.803532008830022,854,754,1608,-
chr1,77964882,0.6017148981779207,801,621,1422,-
chr1,77965082,1.7127429805615548,670,462,1132,-
chr1,77965227,2.441719878463877,664,447,1111,-
chr1,77968187,1.7689655172413794,759,463,1222,-
chr1,77969984,1.0063141135950566,1300,1386,2686,-
chr1,77970009,0.3525432502571274,783,1208,1991,-
chr1,77970014,0.3768182156835587,612,783,1395,-
chr1,77978895,0.21976590359193315,1123,1940,3063,-
chr1,77978897,0.28654436247306914,835,1155,1990,-
chr1,77978909,0.22372431494363507,666,1202,1868,-
chr1,77978910,0.22372431494363507,666,1202,1868,-
chr1,77978913,0.24728978491508125,1084,3037,4121,-
chr1,77978914,0.3026567903542387,784,1645,2429,-
chr1,77978915,0.2644492292987855,1031,2786,3817,-
chr1,77978916,0.2561422988857902,1860,4249,6109,-
chr1,77978917,0.3140111809923131,472,1059,1531,-
chr1,77978918,0.2405405405405405,533,961,1494,-
chr1,77978925,2.782254454293133,451,875,1326,-
chr1,77978926,4.900875852382637,931,2492,3423,-
chr1,77978929,18.376538295436855,976,853,1829,-
chr1,77978930,16.270833333333336,780,391,1171,-
chr1,77978931,16.270833333333336,780,391,1171,-
chr1,77978932,10.69659192483977,726,305,1031,-
chr1,84498540,1.5822397686832743,812,561,1373,-
chr1,84501882,1.93878094224115,606,441,1047,-
chr1,84501883,0.4333227159314115,652,545,1197,-
chr1,84501941,1.7782391748907613,992,679,1671,-
chr1,84506061,0.9064191802010828,585,430,1015,-
chr1,84506062,0.9064191802010828,585,430,1015,-
chr1,84664473,2.6515476555317194,617,501,1118,-
chr1,85252414,1.300509795416757,664,461,1125,-
chr1,85258566,3.540051679586563,684,386,1070,-
chr1,85258567,3.540051679586563,684,386,1070,-
chr1,85258568,3.540051679586563,684,386,1070,-
chr1,86863123,1.5316673052634566,2452,1697,4149,-
chr1,86863344,1.5092198581560283,1177,929,2106,-
chr1,86863590,1.5274573812114618,1343,918,2261,-
chr1,86880691,2.270042045012896,1366,912,2278,-
chr1,86903301,1.8343495934959353,1139,737,1876,-
chr1,86903305,2.456064033408735,940,820,1760,-
chr1,86903328,2.444125634062612,1036,672,1708,-
chr1,86903390,1.7755968863386893,1966,1329,3295,-
chr1,86903393,1.8614460551867409,1113,670,1783,-
chr1,86914112,0.7032205779499762,3423,2196,5619,-
chr1,86914113,0.8331479331855893,6695,4634,11329,-
chr1,86914114,1.185172057480375,5403,4088,9491,-
chr1,86914124,1.480040211434316,814,540,1354,-
chr1,88857426,2.84263097197182,638,415,1053,-
chr1,88860188,1.234864576511721,608,439,1047,-
chr1,88860192,3.0049019607843137,612,390,1002,-
chr1,88860194,3.0049019607843137,612,390,1002,-
chr1,88864026,1.4109665071770334,1390,949,2339,-
chr1,88864034,0.6966446644664467,1191,807,1998,-
chr1,88864040,1.6951423785594641,857,596,1453,-
chr1,88864042,0.6844729344729343,960,665,1625,-
chr1,88864052,0.992092219020173,1955,1387,3342,-
chr1,88864053,0.992092219020173,1955,1387,3342,-
chr1,88949224,0.5868354766008219,680,396,1076,-
chr1,88949226,1.6592131544398436,2915,2039,4954,-
chr1,88949233,1.1655539112881326,2447,2033,4480,-
chr1,88949248,1.6425406871609405,1100,631,1731,-
chr1,88949266,1.9636611205255268,1523,1110,2633,-
chr1,88949271,1.8177722187640843,2121,1412,3533,-
chr1,88953111,2.5087944664031623,818,505,1323,-
chr1,88953113,2.5087944664031623,818,505,1323,-
chr1,88983054,0.9625798517773877,872,718,1590,-
chr1,88983055,0.9625798517773877,872,718,1590,-
chr1,88983056,0.4377865747728762,548,480,1028,-
chr1,89104359,1.554215542521994,672,495,1167,-
chr1,89104362,1.7019883319442792,1905,1134,3039,-
chr1,89104363,1.9960837595907932,1109,735,1844,-
chr1,89104364,1.7019883319442792,1905,1134,3039,-
chr1,89104365,1.9960837595907932,1109,735,1844,-
chr1,89104400,1.9742243436754177,751,418,1169,-
chr1,89104450,2.4200614530676976,871,530,1401,-
chr1,89104451,2.4200614530676976,871,530,1401,-
chr1,89104490,2.51543284301905,672,376,1048,-
chr1,89104491,1.4558097751691257,1588,967,2555,-
chr1,89104492,0.528599303669128,627,442,1069,-
chr1,89104493,2.1953203664174854,883,475,1358,-
chr1,89104504,9.246723553934341,665,345,1010,-
chr1,89104661,1.9436248816598825,1477,1211,2688,-
chr1,89104662,1.9815484116416204,946,750,1696,-
chr1,89104672,1.6175054704595184,615,456,1071,-
chr1,90939388,4.229842192973506,653,436,1089,-
chr1,93156399,2.2232638460589613,2252,2056,4308,-
chr1,93156435,1.4733639900955076,1957,1284,3241,-
chr1,93156442,1.8605990783410138,1614,991,2605,-
chr1,93156453,1.5420962277234174,2258,1567,3825,-
chr1,93156456,1.818289107299038,2154,1467,3621,-
chr1,93156459,1.7497992518383714,1999,1300,3299,-
chr1,93156464,1.814301689860835,1006,502,1508,-
chr1,93156471,0.4960463477648164,703,481,1184,-
chr1,93156482,1.9908883826879278,645,438,1083,-
chr1,93160143,2.943228200371057,660,384,1044,-
chr1,93160147,2.864456721915285,706,361,1067,-
chr1,93562133,1.1089763315608006,1953,1418,3371,-
chr1,93562134,1.338710637308963,1848,1357,3205,-
chr1,93562136,1.9593562465902892,652,422,1074,-
chr1,93875712,1.7879778504236443,1199,1152,2351,-
chr1,93875713,1.7879778504236443,1199,1152,2351,-
chr1,93875740,1.5369287991498406,1156,940,2096,-
chr1,93875742,1.5369287991498406,1156,940,2096,-
chr1,93877307,1.7692307692307692,712,619,1331,-
chr1,93877509,5.141388174807197,719,388,1107,-
chr1,93877510,5.141388174807197,719,388,1107,-
chr1,93877511,5.141388174807197,719,388,1107,-
chr1,93877783,1.6629629629629628,897,665,1562,-
chr1,93877790,2.4524919981710105,1218,971,2189,-
chr1,93877792,2.110781200452391,3461,2695,6156,-
chr1,93877793,2.4527871112259843,1173,875,2048,-
chr1,93889028,1.1614197726330515,1557,1175,2732,-
chr1,93889029,0.9220328282828285,1269,959,2228,-
chr1,93901667,1.1151029071881347,620,442,1062,-
chr1,94897590,1.6739786125582665,739,520,1259,-
chr1,94897600,2.3092105263157894,701,493,1194,-
chr1,94897742,2.4894736842105263,687,455,1142,-
chr1,94897775,5.096103896103896,653,384,1037,-
chr1,94898031,2.5451040212186706,802,611,1413,-
chr1,95064958,2.9477762803234504,672,370,1042,-
chr1,95064960,2.9477762803234504,672,370,1042,-
chr1,95064964,1.1151585010015355,1255,895,2150,-
chr1,95064966,0.42989598940351337,1041,730,1771,-
chr1,96678880,1.8779803646563813,926,620,1546,-
chr1,96678884,1.5513949025155094,1195,878,2073,-
chr1,96678893,1.0080164439876669,1225,694,1919,-
chr1,96678895,1.0080164439876669,1225,694,1919,-
chr1,96678899,1.435723716211521,960,701,1661,-
chr1,96679085,1.1123941182902926,18847,14822,33669,-
chr1,96679099,1.3098295646158078,13223,10340,23563,-
chr1,96679100,1.2622465517937682,6180,4540,10720,-
chr1,96679106,1.3657542224810717,2679,1903,4582,-
chr1,96679112,1.257248743137304,5311,3741,9052,-
chr1,96679117,1.3655612549206728,2409,1659,4068,-
chr1,96679123,1.3347621321951306,1988,1366,3354,-
chr1,96679124,1.6277846247308712,3344,2323,5667,-
chr1,96679130,2.2623076923076924,1037,649,1686,-
chr1,96679131,0.6137806905875643,2891,2333,5224,-
chr1,96679132,1.5132708258204108,1446,939,2385,-
chr1,96679133,2.4547798682074298,951,565,1516,-
chr1,96679138,1.907715092331189,1144,696,1840,-
chr1,96679144,2.347906976744186,1261,859,2120,-
chr1,96679156,1.9314285714285715,675,699,1374,-
chr1,96679162,1.7042332589116422,2355,1290,3645,-
chr1,96679172,1.3031134690383064,1935,898,2833,-
chr1,96679173,1.7590918767568902,1926,1142,3068,-
chr1,96679174,1.517887064810339,2768,1569,4337,-
chr1,96679552,1.5551849654442542,1365,1056,2421,-
chr1,96679553,0.6748713618815122,1510,1266,2776,-
chr1,96679562,0.6818702376632801,2796,2543,5339,-
chr1,96679563,0.7041299996433602,3442,3215,6657,-
chr1,96679564,0.8105907120001327,5337,4951,10288,-
chr1,96679565,0.6590804237100465,2885,2851,5736,-
chr1,96679566,0.5918504251984491,2730,2541,5271,-
chr1,96679569,1.6371886763265098,634,450,1084,-
chr1,96679571,0.5492527173913043,692,575,1267,-
chr1,96679572,0.9760382292810451,1021,1041,2062,-
chr1,96679573,0.6978375219170075,596,753,1349,-
chr1,100873081,5.054257319851525,977,675,1652,-
chr1,100990573,1.0872207935541707,603,441,1044,-
chr1,101013736,0.526984126984127,663,449,1112,-
chr1,108135101,2.4464642923884545,656,439,1095,-
chr1,108135108,3.1949536701097685,641,407,1048,-
chr1,108135200,2.2972777614545383,621,439,1060,-
chr1,108157476,2.4660606060606063,625,439,1064,-
chr1,108157477,2.4660606060606063,625,439,1064,-
chr1,108648567,2.3653152982576464,585,463,1048,-
chr1,108651111,0.997904929653803,800,578,1378,-
chr1,109062794,3.502257235991358,779,533,1312,-
chr1,109062989,0.8090909673368443,928,632,1560,-
chr1,109062990,1.0066022544283413,657,459,1116,-
chr1,109063882,1.2073359242844441,842,623,1465,-
chr1,109064631,2.4126814751799164,929,651,1580,-
chr1,109280423,5.27084992997782,679,527,1206,-
chr1,109280439,2.6653764954257566,605,405,1010,-
chr1,109280441,2.6653764954257566,605,405,1010,-
chr1,109401949,1.4775224775224776,1275,1000,2275,-
chr1,109410003,2.070700756391824,1249,940,2189,-
chr1,109411085,1.4896833866951262,1499,936,2435,-
chr1,109412103,1.4830698170190086,1868,1298,3166,-
chr1,109412138,1.6222491628695248,5659,4460,10119,-
chr1,109412140,1.6705245973538658,3427,2664,6091,-
chr1,109413116,1.581926845668153,6034,4188,10222,-
chr1,109421913,1.345280487804878,1750,1311,3061,-
chr1,109426367,1.5441486547846484,2158,1451,3609,-
chr1,109426416,2.831532846715328,1118,684,1802,-
chr1,109426433,1.5958799344885615,1931,1056,2987,-
chr1,109426437,0.46857981130199716,805,382,1187,-
chr1,109426440,2.0152043253990524,842,425,1267,-
chr1,109426443,1.7195791724017466,720,302,1022,-
chr1,109737158,1.7130731018484568,3021,2249,5270,-
chr1,109737161,1.615735910512879,2752,1989,4741,-
chr1,109737526,1.491572607177203,1033,858,1891,-
chr1,109737750,0.5815397948866099,1341,988,2329,-
chr1,109738169,1.413520547925387,2891,2067,4958,-
chr1,109738175,1.3814520739376228,1622,1210,2832,-
chr1,109738307,2.746554720965998,3813,2907,6720,-
chr1,109739438,1.9629801139444572,5192,3868,9060,-
chr1,109739441,1.8230074548062225,2267,1893,4160,-
chr1,109739482,1.450078203574299,4907,3573,8480,-
chr1,109739483,1.457656175634323,4538,3526,8064,-
chr1,109739486,1.425519339167039,1675,976,2651,-
chr1,109739853,1.5618212197159564,3738,3077,6815,-
chr1,109739854,1.2611580500413997,5794,4821,10615,-
chr1,109739855,1.2611580500413997,5794,4821,10615,-
chr1,109739879,1.1082531685853978,1403,1012,2415,-
chr1,109740255,1.7574552683896618,727,502,1229,-
chr1,109740256,2.1144160958236498,864,750,1614,-
chr1,109740268,0.5876351351351352,668,369,1037,-
chr1,110401338,1.5883892885691446,1302,1111,2413,-
chr1,110401446,1.735864724088473,1532,1018,2550,-
chr1,110401535,1.3355833913245188,1338,957,2295,-
chr1,110401537,0.7309340853013747,3637,2836,6473,-
chr1,110401538,0.9523435741384536,4941,3675,8616,-
chr1,110401575,1.866970926301555,1174,869,2043,-
chr1,110401578,1.7867807472047994,1218,771,1989,-
chr1,110401580,1.8326295045045045,1107,887,1994,-
chr1,110403950,1.461209820855566,1225,1112,2337,-
chr1,110403951,0.6263805046318192,1765,1395,3160,-
chr1,110404028,2.8254752282592426,877,785,1662,-
chr1,110406341,0.596153846153846,928,928,1856,-
chr1,110406372,0.5870899147935468,1474,1357,2831,-
chr1,110406373,0.5166279969064191,1335,1723,3058,-
chr1,110406374,0.5166279969064191,1335,1723,3058,-
chr1,110406377,0.6573953979920257,781,770,1551,-
chr1,110407606,5.058463667426129,3161,3027,6188,-
chr1,110407612,18.216007533407442,3103,2746,5849,-
chr1,110407619,10.946292401380584,6190,4120,10310,-
chr1,110407620,10.946292401380584,6190,4120,10310,-
chr1,110407693,0.9035096440644262,726,427,1153,-
chr1,111117857,1.939413601143459,2170,1476,3646,-
chr1,111117859,1.939413601143459,2170,1476,3646,-
chr1,111117873,1.6818266319647317,1734,1123,2857,-
chr1,111117874,1.6818266319647317,1734,1123,2857,-
chr1,111117875,0.6278959810874705,829,422,1251,-
chr1,111117891,2.6918536009445098,911,461,1372,-
chr1,111117893,2.6918536009445098,911,461,1372,-
chr1,111117983,3.8497061293031063,654,396,1050,-
chr1,111118880,2.1432627548958747,1231,1113,2344,-
chr1,111118881,1.2707231040564373,523,566,1089,-
chr1,111124864,3.7142613854430677,1071,744,1815,-
chr1,111126260,1.714755244755245,790,571,1361,-
chr1,111126271,0.5752495206253995,649,472,1121,-
chr1,111139515,2.144385026737968,1202,978,2180,-
chr1,111139516,2.144385026737968,1202,978,2180,-
chr1,111139559,1.8458255534809287,691,488,1179,-
chr1,111139566,1.713321578703631,733,557,1290,-
chr1,111440828,5.177666672527131,693,615,1308,-
chr1,111440838,19.106688081538955,1087,831,1918,-
chr1,111440839,20.128043564763427,1248,923,2171,-
chr1,111441366,3.4512062959437073,644,453,1097,-
chr1,111443911,0.18548303413925496,714,418,1132,-
chr1,111443913,0.24643878433306596,1130,778,1908,-
chr1,111448630,3.179864947820749,739,542,1281,-
chr1,111448632,2.2435338130456683,1808,1239,3047,-
chr1,111448633,2.788081821005457,1064,726,1790,-
chr1,111448634,2.788081821005457,1064,726,1790,-
chr1,112701345,0.7522085416515715,1198,757,1955,-
chr1,112701346,1.383587786259542,949,523,1472,-
chr1,112701475,0.5677636693443898,625,453,1078,-
chr1,112701487,1.7630062630480166,753,478,1231,-
chr1,112701573,1.7051874678993322,663,530,1193,-
chr1,112701612,2.6189483165904015,1210,898,2108,-
chr1,112702692,0.5716463414634146,624,409,1033,-
chr1,112703077,2.1075193074238925,1000,824,1824,-
chr1,112703719,1.6550580431177446,997,602,1599,-
chr1,112703773,2.353192977441405,1125,799,1924,-
chr1,112912495,2.31607849471049,1194,853,2047,-
chr1,112912496,2.31607849471049,1194,853,2047,-
chr1,112912653,1.8911216180719723,846,563,1409,-
chr1,112912690,0.9161152550529356,1561,1038,2599,-
chr1,112912691,0.9161152550529356,1561,1038,2599,-
chr1,112912774,3.1970048512971947,658,430,1088,-
chr1,112912789,1.8304178069695314,952,672,1624,-
chr1,112912808,1.269877992188162,666,437,1103,-
chr1,112913541,2.0573610659733506,1150,723,1873,-
chr1,112913680,4.667986597624124,612,468,1080,-
chr1,112914061,2.0063265306122453,677,489,1166,-
chr1,112914092,2.3264932562620424,778,518,1296,-
chr1,112914135,2.3138801261829656,814,633,1447,-
chr1,112914137,2.3138801261829656,814,633,1447,-
chr1,112914140,1.8480654318157912,814,646,1460,-
chr1,112917427,2.4131362889983583,667,405,1072,-
chr1,112917434,2.6122606789755207,963,794,1757,-
chr1,112917459,1.5884508164078055,538,464,1002,-
chr1,112917653,2.102272727272727,702,615,1317,-
chr1,112917761,2.9971988795518207,534,475,1009,-
chr1,112922018,1.2438057689857327,921,788,1709,-
chr1,112956193,0.5934373706419859,1047,567,1614,-
chr1,112956194,0.5485175593393887,1512,911,2423,-
chr1,114567858,0.4505278084134237,816,576,1392,-
chr1,114581333,1.0405144694533763,808,621,1429,-
chr1,114581334,1.0405144694533763,808,621,1429,-
chr1,114581368,3.600570169417562,984,863,1847,-
chr1,114581371,3.089390732448203,692,561,1253,-
chr1,114704704,2.6014895293781852,655,500,1155,-
chr1,114706369,2.078069756330626,658,454,1112,-
chr1,114706370,2.078069756330626,658,454,1112,-
chr1,114706764,2.8029370299232355,585,450,1035,-
chr1,114707374,2.5559447898087226,665,594,1259,-
chr1,114716113,3.1515994436717665,823,718,1541,-
chr1,114716114,7.327853831197022,1657,1505,3162,-
chr1,114716115,5.678253618121132,1450,1262,2712,-
chr1,114717063,2.677554662577755,1910,1295,3205,-
chr1,114717065,2.5464619707415954,2801,1910,4711,-
chr1,114717066,4.762418300653595,1120,764,1884,-
chr1,114717068,8.47203312376862,2017,1341,3358,-
chr1,114717240,2.649497487437185,702,596,1298,-
chr1,114717241,2.649497487437185,702,596,1298,-
chr1,114717465,0.5929799080125878,1530,1214,2744,-
chr1,114717467,1.504932376404655,1031,852,1883,-
chr1,114717478,1.5213743218806508,1025,789,1814,-
chr1,114717481,1.839595192915876,1982,1529,3511,-
chr1,114717482,1.839595192915876,1982,1529,3511,-
chr1,114717485,1.8964051968350104,946,705,1651,-
chr1,114717586,1.7571022727272725,1236,815,2051,-
chr1,114718093,1.3199281559082117,4096,3036,7132,-
chr1,114718200,1.6291836734693874,886,559,1445,-
chr1,114718204,1.9461279461279464,781,505,1286,-
chr1,114719625,1.3884072755131223,4898,3631,8529,-
chr1,114719728,1.4906832298136643,1049,804,1853,-
chr1,114720633,1.6056686065810881,2625,1841,4466,-
chr1,114720710,1.4044304220031276,9637,6691,16328,-
chr1,114720711,1.2289659938342035,6729,4686,11415,-
chr1,114720713,1.5701565336857874,3686,2506,6192,-
chr1,114723931,1.8710976017470113,5148,3981,9129,-
chr1,114723955,1.3421033457199825,2355,1658,4013,-
chr1,114725244,0.6725879917184265,1316,1034,2350,-
chr1,114725259,1.4609206660137122,1242,1020,2262,-
chr1,114726222,1.5210768532722598,1759,1492,3251,-
chr1,114730381,0.7636135967993158,2272,1433,3705,-
chr1,114730383,1.4357118947762222,1756,1538,3294,-
chr1,114732814,1.2476680464058767,1316,1008,2324,-
chr1,114732816,1.2476680464058767,1316,1008,2324,-
chr1,114733749,1.4745331069609509,1736,1481,3217,-
chr1,114734039,1.5041217146892458,2560,1606,4166,-
chr1,114734482,1.500699008252716,3331,2180,5511,-
chr1,114737530,2.6507766823340604,664,458,1122,-
chr1,114749982,1.3538771634009727,1887,1273,3160,-
chr1,114750072,0.7639947255187731,2116,1600,3716,-
chr1,114750159,1.6046178541722342,12860,12357,25217,-
chr1,114750166,2.395417460372085,11233,9781,21014,-
chr1,114750183,1.3351726343741441,8708,7310,16018,-
chr1,114750188,0.7729244545294286,13597,11229,24826,-
chr1,114750190,0.748228645175031,25549,21318,46867,-
chr1,114750191,0.7749434709447542,18521,15553,34074,-
chr1,114750192,0.7749434709447542,18521,15553,34074,-
chr1,114750193,1.511308716585814,12772,9553,22325,-
chr1,114750195,1.4258910136042642,28142,21848,49990,-
chr1,114750196,1.4062817004340151,25766,20344,46110,-
chr1,114750198,1.3066028618343892,8831,7349,16180,-
chr1,114750201,1.4562657474604188,10172,6893,17065,-
chr1,114750202,1.4822843034088087,18438,12870,31308,-
chr1,114750204,1.3149461458628908,18305,11965,30270,-
chr1,114750205,1.2723589129558242,16409,11059,27468,-
chr1,114750206,1.1178652138237148,19557,14243,33800,-
chr1,114757935,2.084739963193537,11602,9241,20843,-
chr1,114757959,1.7120762127334987,3402,2621,6023,-
chr1,114757961,1.085363708419532,5363,3698,9061,-
chr1,114757963,1.4371292137274831,10409,7594,18003,-
chr1,114757964,1.5054706828920241,10788,7514,18302,-
chr1,114757967,1.358396703493815,3911,2701,6612,-
chr1,114757972,2.261561712846348,1043,793,1836,-
chr1,114757980,0.9147150544511199,4500,2734,7234,-
chr1,114757984,0.5893580366318081,660,465,1125,-
chr1,114757986,0.5893580366318081,660,465,1125,-
chr1,114757992,0.7170311318355529,756,581,1337,-
chr1,114779243,3.869762711598007,601,442,1043,-
chr1,119967504,1.1978398367938283,700,571,1271,-
chr1,120156824,2.1599686102530744,813,558,1371,-
chr1,120156923,0.5003068530514831,666,418,1084,-
chr1,120156946,2.701576979746473,615,416,1031,-
chr1,120157129,1.996186270574067,1376,845,2221,-
chr1,120157131,1.9781741902604109,1829,1191,3020,-
chr1,120163365,3.226277372262774,662,410,1072,-
chr1,120163366,3.226277372262774,662,410,1072,-
chr1,120168911,2.231258985255012,1306,885,2191,-
chr1,120168912,2.9893572621035056,954,598,1552,-
chr1,120168913,2.9893572621035056,954,598,1552,-
chr1,121016918,1.3480904309943678,4548,3247,7795,-
chr1,121016919,1.3480904309943678,4548,3247,7795,-
chr1,121016922,0.950245027222453,1430,1060,2490,-
chr1,145926107,2.2621560107593632,753,536,1289,-
chr1,145926592,0.5778474399164054,552,527,1079,-
chr1,145926598,1.1935018435794291,913,651,1564,-
chr1,145926610,0.8153993304638929,619,491,1110,-
chr1,145926612,1.1212782729973925,901,716,1617,-
chr1,145926613,2.0770717289985225,570,462,1032,-
chr1,145926857,4.239169788207025,882,590,1472,-
chr1,145927068,1.1397459165154264,627,379,1006,-
chr1,145927069,1.1397459165154264,627,379,1006,-
chr1,145927070,1.1397459165154264,627,379,1006,-
chr1,145992604,1.5912530451890694,2011,1651,3662,-
chr1,145992653,1.8013711977607314,1613,1200,2813,-
chr1,145992711,1.874194933447832,969,684,1653,-
chr1,145992822,1.6338626705435029,973,788,1761,-
chr1,145993009,1.6503517895380853,1078,933,2011,-
chr1,145993172,1.5826933059119894,1810,1334,3144,-
chr1,145993310,1.7751284686536484,1142,972,2114,-
chr1,145993530,1.6432043965335024,1195,995,2190,-
chr1,145993606,1.5920303605313089,838,526,1364,-
chr1,145993722,2.160212828850133,608,397,1005,-
chr1,145993769,1.7986425339366516,794,560,1354,-
chr1,145993835,1.6044585987261146,915,627,1542,-
chr1,145994291,1.7994546341743447,6027,5687,11714,-
chr1,145994292,1.7994546341743447,6027,5687,11714,-
chr1,145994293,1.7994546341743447,6027,5687,11714,-
chr1,145994302,0.7391450313339302,1320,1116,2436,-
chr1,145994305,1.535270921571491,1167,1001,2168,-
chr1,145994308,1.8002959141090331,1437,1225,2662,-
chr1,145994432,1.4095454545454544,885,659,1544,-
chr1,145994557,1.7808913308913308,940,584,1524,-
chr1,145994643,2.1494848901098904,1180,909,2089,-
chr1,145994649,2.080289007678735,1939,1291,3230,-
chr1,145994679,1.6302937466210128,977,715,1692,-
chr1,145994716,1.82190576652602,963,710,1673,-
chr1,145995005,2.189682126107348,763,605,1368,-
chr1,145995194,1.058753018530544,4171,3041,7212,-
chr1,145995195,1.0875,1652,1099,2751,-
chr1,145995427,2.1772575250836117,1797,1507,3304,-
chr1,145995428,2.1772575250836117,1797,1507,3304,-
chr1,145995440,1.4472972972972975,1478,1109,2587,-
chr1,145996156,1.8456655229332508,1324,981,2305,-
chr1,145996292,1.7304421768707483,924,839,1763,-
chr1,145996314,1.3515997130559543,2116,1393,3509,-
chr1,145996576,0.7493471147545483,40589,35856,76445,-
chr1,145996577,0.76486334543509,32835,30247,63082,-
chr1,145996578,0.6761004737465456,7754,5609,13363,-
chr1,147082910,0.4950841322637449,652,537,1189,-
chr1,147082912,0.4950841322637449,652,537,1189,-
chr1,147203727,0.7599812996727443,1023,712,1735,-
chr1,147203728,1.0384759685932181,963,726,1689,-
chr1,147203729,0.7599812996727443,1023,712,1735,-
chr1,147203754,3.0071006951242985,732,575,1307,-
chr1,147204180,1.7858772340546034,886,764,1650,-
chr1,147204573,1.846704443781688,687,478,1165,-
chr1,147204574,1.113644370627611,762,536,1298,-
chr1,147204575,1.113644370627611,762,536,1298,-
chr1,148038792,0.5724030403430129,978,732,1710,-
chr1,149923499,2.014370028226841,627,432,1059,-
chr1,149923546,1.0364973352222897,667,548,1215,-
chr1,149923548,1.0364973352222897,667,548,1215,-
chr1,149926546,2.0441717791411045,587,488,1075,-
chr1,149926752,2.0967039800995018,612,401,1013,-
chr1,149926886,2.4075924468922105,1248,819,2067,-
chr1,149926887,2.4075924468922105,1248,819,2067,-
chr1,149927185,2.8275810097965337,1284,1326,2610,-
chr1,149927187,2.5990889696131005,1909,1926,3835,-
chr1,149927188,1.9325263839841353,3184,2934,6118,-
chr1,149927190,2.9840815027061445,2368,2093,4461,-
chr1,149927191,2.804637251935701,2600,2298,4898,-
chr1,149927192,2.976556588284005,2290,1892,4182,-
chr1,149927194,1.9396782209000238,2441,1934,4375,-
chr1,149927208,0.5581000310080244,1026,745,1771,-
chr1,149927265,3.0786515331699804,718,551,1269,-
chr1,149927767,5.3446088794926,631,472,1103,-
chr1,149927768,4.8736431963846965,823,616,1439,-
chr1,149927782,1.537152249609395,845,536,1381,-
chr1,150218710,20.232020615995552,2658,2210,4868,-
chr1,150218711,21.23562199250091,2185,1804,3989,-
chr1,150218973,1.9110291948662859,823,678,1501,-
chr1,150219789,2.434979268752356,645,378,1023,-
chr1,150220734,1.9792507505940187,835,559,1394,-
chr1,150226652,2.756005961251863,638,582,1220,-
chr1,150226692,6.248466033271338,1317,993,2310,-
chr1,150226698,5.0672164455940605,1037,703,1740,-
chr1,150226704,4.247882769107642,752,498,1250,-
chr1,150229109,1.7933209647495365,715,489,1204,-
chr1,150230582,1.8573380171740828,920,548,1468,-
chr1,150230594,2.2108443847574284,877,517,1394,-
chr1,150230627,2.834637717748043,801,465,1266,-
chr1,150231818,1.7104072398190049,755,458,1213,-
chr1,150231914,0.4506099177936887,970,837,1807,-
chr1,150231916,0.4506099177936887,970,837,1807,-
chr1,150235810,0.4511066107334009,566,445,1011,-
chr1,150235821,5.557464559414846,3619,3063,6682,-
chr1,150235822,5.557464559414846,3619,3063,6682,-
chr1,150235823,3.2341331269349833,731,815,1546,-
chr1,150235967,2.9718812557933023,582,479,1061,-
chr1,150265486,0.4165054179566564,573,607,1180,-
chr1,150265498,2.757529323459353,1129,1412,2541,-
chr1,150265501,20.753947126001382,3154,2471,5625,-
chr1,150265502,21.202760450054022,3312,2521,5833,-
chr1,150265503,23.777199805133677,4032,2652,6684,-
chr1,150265504,30.363157894736837,640,379,1019,-
chr1,150265505,53.56204179833162,2511,655,3166,-
chr1,150265507,22.48862681922898,2606,445,3051,-
chr1,150265508,23.344242906979822,1825,309,2134,-
chr1,150265510,11.278801843317973,978,123,1101,-
chr1,150265511,10.042592592592593,985,119,1104,-
chr1,150265512,17.058755760368662,1138,123,1261,-
chr1,150265513,14.55420688182785,2315,259,2574,-
chr1,150265514,16.107209397008226,1800,194,1994,-
chr1,150265805,5.6262070283439725,1619,1519,3138,-
chr1,150265834,4.622501111361572,1480,1077,2557,-
chr1,150265835,3.715122706609825,1373,1068,2441,-
chr1,150265837,2.9767702950622494,1883,1368,3251,-
chr1,150267183,1.6357618500397224,1502,1142,2644,-
chr1,150267987,1.6843434343434345,666,494,1160,-
chr1,150268025,1.2287807892645892,782,568,1350,-
chr1,150268067,0.3628762218191478,678,566,1244,-
chr1,150268794,1.157826718816469,741,514,1255,-
chr1,150268795,0.7724001874890668,702,474,1176,-
chr1,150574816,0.6747290154976261,1075,914,1989,-
chr1,150574817,0.5226394355210439,736,552,1288,-
chr1,150574825,0.5784131326949383,782,849,1631,-
chr1,150574858,0.5050896046686553,943,1119,2062,-
chr1,150574859,0.3394749570612108,1145,1571,2716,-
chr1,150574877,1.7766304835419406,1549,2000,3549,-
chr1,150574879,0.8369921363040631,523,871,1394,-
chr1,150574880,2.2349811826935815,1908,2510,4418,-
chr1,150574881,1.0930859363917498,687,1136,1823,-
chr1,150574883,1.9842839853297776,1186,1221,2407,-
chr1,150574887,6.165352857628162,1260,1262,2522,-
chr1,150574890,7.13344053888102,1422,1361,2783,-
chr1,150574893,5.935562909949391,1401,1159,2560,-
chr1,150574896,12.152289742218263,3827,2230,6057,-
chr1,150574897,14.62651506091404,4887,2732,7619,-
chr1,150574898,16.11337807342233,4203,2481,6684,-
chr1,150574899,19.41434986192622,3153,1730,4883,-
chr1,150574904,4.831704668838219,889,306,1195,-
chr1,150574905,4.8576391350584895,992,402,1394,-
chr1,150574906,5.680173433164088,2747,760,3507,-
chr1,150574907,6.993129968259326,4871,1354,6225,-
chr1,150574908,7.888894644739907,5156,1244,6400,-
chr1,150574909,8.281154774568558,3181,680,3861,-
chr1,150574910,10.947279274059897,2350,405,2755,-
chr1,150574914,13.53948189339482,1077,164,1241,-
chr1,150574916,13.53948189339482,1077,164,1241,-
chr1,150575113,2.042553191489361,1827,1370,3197,-
chr1,150575232,1.50565593261773,1354,848,2202,-
chr1,150575290,2.569190600522193,1199,765,1964,-
chr1,150575539,2.048695652173913,949,574,1523,-
chr1,150575609,2.0580007040205706,1878,1376,3254,-
chr1,150575700,1.4236343852013056,1257,918,2175,-
chr1,150575707,0.3652231551038445,1130,805,1935,-
chr1,150576137,1.5661489314827055,1550,1067,2617,-
chr1,150576834,2.2354556623656454,4727,3454,8181,-
chr1,150576970,0.713469387755102,1839,1499,3338,-
chr1,150577024,1.9796241630066962,1221,816,2037,-
chr1,150578423,1.5922480620155042,1184,899,2083,-
chr1,150578430,2.2288769450139374,1656,1179,2835,-
chr1,150578431,2.814308681672025,777,621,1398,-
chr1,150578449,1.5969047937294505,1505,1018,2523,-
chr1,150578466,0.9455786056237278,1431,1068,2499,-
chr1,150578467,1.019860440150295,1044,620,1664,-
chr1,150578468,0.9752699274234414,2475,1688,4163,-
chr1,150578865,2.1946647440519107,760,583,1343,-
chr1,150579067,1.7524710830704522,640,633,1273,-
chr1,150579427,2.6399825021872267,709,507,1216,-
chr1,150579429,2.258478484541985,957,694,1651,-
chr1,150622285,3.018707482993197,780,461,1241,-
chr1,150622424,2.8,678,484,1162,-
chr1,150622436,0.6009194395796847,548,570,1118,-
chr1,150622437,1.8047182175622545,611,435,1046,-
chr1,150622447,2.749013394799781,1681,1488,3169,-
chr1,150622517,0.39125972850456225,859,1469,2328,-
chr1,150622537,0.3989956057752668,453,707,1160,-
chr1,150622539,0.32430879702466725,733,1480,2213,-
chr1,150622544,0.8854166666666665,288,815,1103,-
chr1,150622545,0.8854166666666665,288,815,1103,-
chr1,150622549,0.18439696840782452,333,911,1244,-
chr1,150622553,7.377906170077042,1388,1941,3329,-
chr1,150622554,8.853223683012292,1709,1845,3554,-
chr1,150622555,8.91477567988914,939,501,1440,-
chr1,150622556,13.287171480781927,1927,731,2658,-
chr1,150622557,11.632860252078043,1900,502,2402,-
chr1,150622558,12.668043469886785,1960,488,2448,-
chr1,150622559,18.176786646363993,1714,380,2094,-
chr1,150622560,21.50497512437811,987,200,1187,-
chr1,150622562,14.986149733942705,1311,173,1484,-
chr1,150622564,26.537543192679454,1079,128,1207,-
chr1,150624259,7.652397763676392,844,555,1399,-
chr1,150624262,8.07438822352436,825,459,1284,-
chr1,150624267,13.71062052644065,1227,585,1812,-
chr1,150624268,10.783487670587563,843,429,1272,-
chr1,150625272,1.5962628557791816,6878,4384,11262,-
chr1,150625273,1.5613233743098758,9022,5572,14594,-
chr1,150625277,1.3784690731471447,3735,2458,6193,-
chr1,150625279,1.5933456075749604,2861,1900,4761,-
chr1,150625323,1.5343851619896425,1469,721,2190,-
chr1,150625324,1.6593726950230057,2231,1202,3433,-
chr1,150625325,1.6106935740301076,3700,1923,5623,-
chr1,150625326,1.6593726950230057,2231,1202,3433,-
chr1,150625654,2.8464273728932428,928,643,1571,-
chr1,150629453,1.4012430503613156,974,771,1745,-
chr1,150629489,5.246420824295011,833,460,1293,-
chr1,150629491,4.592844135332404,1138,667,1805,-
chr1,150811990,20.8883191698119,1225,852,2077,-
chr1,150811991,20.8883191698119,1225,852,2077,-
chr1,150811992,16.140124660475568,988,666,1654,-
chr1,150813199,1.1892216468397596,1332,530,1862,-
chr1,150813200,0.9506422578480876,1346,625,1971,-
chr1,150813206,0.7047146401985113,851,233,1084,-
chr1,150813207,0.7047146401985113,851,233,1084,-
chr1,150836372,0.4736926349847337,624,489,1113,-
chr1,150965552,0.6660168940870697,696,458,1154,-
chr1,150967113,1.5674676524953792,847,540,1387,-
chr1,150967134,0.5688677519663435,621,496,1117,-
chr1,150967451,0.4089306698002351,985,850,1835,-
chr1,150967453,0.4089306698002351,985,850,1835,-
chr1,150967455,2.054482758620689,661,434,1095,-
chr1,150967467,1.7755364806866951,590,465,1055,-
chr1,150967856,2.160116372567211,896,620,1516,-
chr1,150974703,3.038589266625704,483,923,1406,-
chr1,150974704,3.038589266625704,483,923,1406,-
chr1,151052767,3.0753244051966035,715,512,1227,-
chr1,151053313,3.0379084967320265,663,449,1112,-
chr1,151176544,0.6390748630553865,839,619,1458,-
chr1,151176551,2.8720337103570635,739,500,1239,-
chr1,151176640,2.755218661418679,832,633,1465,-
chr1,151176647,2.3170874535185946,1177,890,2067,-
chr1,151178018,2.0,587,440,1027,-
chr1,151184385,1.559142832089918,5146,4079,9225,-
chr1,151184387,2.040596609702962,2651,2376,5027,-
chr1,151184389,2.086346885081844,6536,4442,10978,-
chr1,151184390,2.2845341718994905,2249,1662,3911,-
chr1,151184391,2.1293190129066994,5704,3756,9460,-
chr1,151184403,2.1557788944723617,623,397,1020,-
chr1,151184417,2.103003441473794,1012,705,1717,-
chr1,151185528,1.8676356304215407,1367,1012,2379,-
chr1,151185530,1.8676356304215407,1367,1012,2379,-
chr1,151190043,1.16301841465023,828,644,1472,-
chr1,151341219,2.1454770047983986,698,473,1171,-
chr1,151341977,2.3729502870990355,705,489,1194,-
chr1,151343163,1.4522564255827854,1253,955,2208,-
chr1,151343170,1.6613408024847867,3152,2175,5327,-
chr1,151343171,1.5293884500181925,3523,2417,5940,-
chr1,151343172,1.3912754906980178,5253,3481,8734,-
chr1,151343174,1.6097490347490346,1961,1294,3255,-
chr1,151343360,2.4676661849710984,718,345,1063,-
chr1,151343364,2.3697732997481107,1343,793,2136,-
chr1,151343365,1.3922717079510547,2622,1640,4262,-
chr1,151343367,0.4101722723543889,1279,847,2126,-
chr1,151347247,0.8818556701030927,563,484,1047,-
chr1,151347248,0.9601970362301964,836,719,1555,-
chr1,151760870,1.838235294117647,664,475,1139,-
chr1,151761478,2.51490516437695,2062,1415,3477,-
chr1,151761479,1.9968666254380536,1587,1077,2664,-
chr1,151762471,2.149971500513142,811,609,1420,-
chr1,151763377,2.8479087452471483,641,525,1166,-
chr1,151763378,2.8479087452471483,641,525,1166,-
chr1,151763392,2.387139713672544,669,455,1124,-
chr1,151763399,1.3139312148668005,857,526,1383,-
chr1,151983193,1.333240602288139,3691,2508,6199,-
chr1,151983232,0.8026953773099147,3229,2496,5725,-
chr1,151983293,1.4343903772553306,1748,1356,3104,-
chr1,151983319,1.3662114314618108,1627,1317,2944,-
chr1,151986220,1.4365273311897104,1376,932,2308,-
chr1,151986233,1.6224390669283382,1768,1479,3247,-
chr1,151986244,2.2195209796506394,724,616,1340,-
chr1,151986247,2.5685913268779523,1293,854,2147,-
chr1,151993783,2.10578335358797,2229,1277,3506,-
chr1,151993811,0.5284195086175284,785,302,1087,-
chr1,151993835,1.0274379936261606,1618,1030,2648,-
chr1,151993836,0.9779854675652906,1838,1186,3024,-
chr1,151993837,0.8686519045886766,2930,1773,4703,-
chr1,151993838,0.8538530338095581,1891,1214,3105,-
chr1,152032569,1.5925934306020413,4614,3695,8309,-
chr1,152032572,1.4215292595641726,1321,1122,2443,-
chr1,152032823,0.7756226464381952,885,733,1618,-
chr1,152032824,0.9908634558746415,566,487,1053,-
chr1,152033775,1.869982205972453,3705,2482,6187,-
chr1,152033789,1.5344751758493425,3025,2183,5208,-
chr1,152033797,1.2940381331815594,1268,752,2020,-
chr1,152033798,1.8574000257168573,962,706,1668,-
chr1,152033799,1.5293063986466318,903,772,1675,-
chr1,152036923,1.587725444852728,2819,2264,5083,-
chr1,152036967,0.9144737880767403,2462,1540,4002,-
chr1,152036969,0.7813343722409205,3857,2542,6399,-
chr1,152036971,0.5643226411704825,1487,841,2328,-
chr1,152036993,1.441455680591649,632,414,1046,-
chr1,152036997,1.0719037060500476,647,692,1339,-
chr1,152036999,2.0058942469829217,1472,1347,2819,-
chr1,152037002,0.4941518491325018,666,552,1218,-
chr1,153534717,0.8431987827388698,35799,25931,61730,-
chr1,153534813,1.2778457838508601,42256,31352,73608,-
chr1,153534814,1.2546596694650545,34359,24879,59238,-
chr1,153535229,1.2896987874756873,34723,26472,61195,-
chr1,153535247,1.05485686373677,21147,16447,37594,-
chr1,153535248,1.2456705032933113,11862,9471,21333,-
chr1,153535287,1.2315014705519156,13077,9423,22500,-
chr1,153535292,1.630138972083407,12522,8252,20774,-
chr1,153535360,0.45500196726998754,763,517,1280,-
chr1,153535361,1.1162522511941115,756,534,1290,-
chr1,153535986,1.031955450780755,13720,10996,24716,-
chr1,153535990,1.0617115561881745,3096,2875,5971,-
chr1,153535991,0.9151962109219146,4903,3491,8394,-
chr1,153535992,1.102253148812576,11471,9386,20857,-
chr1,153535993,1.027073107804121,8487,6588,15075,-
chr1,153535994,1.2361040315836522,5502,3827,9329,-
chr1,153536000,1.7406417112299466,818,441,1259,-
chr1,153536011,0.6510976005940502,1298,742,2040,-
chr1,153536012,0.6510976005940502,1298,742,2040,-
chr1,153536017,0.6673366564828215,672,690,1362,-
chr1,153536019,0.5380944871717465,2328,2162,4490,-
chr1,153536020,0.44025588649407615,1349,1419,2768,-
chr1,153536022,0.34262992831541217,436,743,1179,-
chr1,153536023,0.22476727628348925,554,695,1249,-
chr1,153543690,1.7670542018368105,3025,2456,5481,-
chr1,153543691,1.7670542018368105,3025,2456,5481,-
chr1,153543914,1.3867075358219256,5890,4167,10057,-
chr1,153543921,0.8464431329473312,2164,1541,3705,-
chr1,153543923,0.8835906957600468,2309,1737,4046,-
chr1,153544742,1.3253914227365553,1946,1468,3414,-
chr1,153545788,1.103422878726294,3207,2398,5605,-
chr1,153545792,0.661076553852182,1645,1200,2845,-
chr1,153545795,2.018863636363636,657,439,1096,-
chr1,153545798,1.356558169223646,2218,1653,3871,-
chr1,153545800,1.4390728628210732,3042,2200,5242,-
chr1,153545802,1.5752470408066457,3885,2987,6872,-
chr1,153545803,1.6251034372677122,3047,2561,5608,-
chr1,153545804,1.6864490387557987,3408,2764,6172,-
chr1,153545805,1.3932520735868883,1741,1342,3083,-
chr1,153607001,3.0129570465033724,969,625,1594,-
chr1,153607013,1.8120873539867952,891,536,1427,-
chr1,153607019,1.5704304710389902,870,521,1391,-
chr1,153607029,0.5654189754608164,624,477,1101,-
chr1,153607046,0.3162035274711331,711,425,1136,-
chr1,153607048,0.9921355111917726,655,569,1224,-
chr1,153607049,1.131445333063485,1057,692,1749,-
chr1,153607050,1.3664363343225714,1097,927,2024,-
chr1,153607215,0.6641556811048336,1057,766,1823,-
chr1,153607242,1.7514285714285711,612,574,1186,-
chr1,153607299,2.0192861027311566,1118,676,1794,-
chr1,153607426,0.3564814814814815,780,638,1418,-
chr1,153607427,0.3564814814814815,780,638,1418,-
chr1,153607434,2.111124827709724,1014,723,1737,-
chr1,153607570,2.0163098878695207,687,435,1122,-
chr1,153608103,1.4224086538982648,2385,1808,4193,-
chr1,153608112,1.3050834234254316,2951,1908,4859,-
chr1,153608116,1.441780994943069,2572,1636,4208,-
chr1,153608118,0.7667619439497766,4847,3462,8309,-
chr1,153608119,1.4868049125201033,1936,1206,3142,-
chr1,153608123,1.6645859342488558,1749,1067,2816,-
chr1,153608125,1.3822681038408988,1213,940,2153,-
chr1,153608131,1.9954988747186797,1063,773,1836,-
chr1,153608150,1.6996567559845739,2390,1623,4013,-
chr1,153608152,1.5201267432407075,1443,1077,2520,-
chr1,153608154,1.875,755,419,1174,-
chr1,153612987,0.43156289604963133,632,477,1109,-
chr1,153613068,1.3814196953599764,1081,1032,2113,-
chr1,153613070,3.4848264703990264,1932,1522,3454,-
chr1,153613071,12.56461929377874,630,547,1177,-
chr1,153618849,21.90616070041104,1564,1152,2716,-
chr1,153618898,0.3750000000000001,632,421,1053,-
chr1,153618955,2.1910903863527307,5715,3859,9574,-
chr1,153618959,1.7170836707727717,2138,1617,3755,-
chr1,153618976,1.5619508696431772,3371,2287,5658,-
chr1,153618977,1.5619508696431772,3371,2287,5658,-
chr1,153618979,1.4010653956683257,2220,1296,3516,-
chr1,153619009,2.057949277338424,1160,771,1931,-
chr1,153619010,2.359119897959184,1562,1175,2737,-
chr1,153626338,1.887556992703823,2364,1510,3874,-
chr1,153626362,1.8062282533054972,1402,957,2359,-
chr1,153626363,1.8062282533054972,1402,957,2359,-
chr1,153626383,2.0245794057988307,605,492,1097,-
chr1,153626497,1.9621093998652093,835,679,1514,-
chr1,153662283,0.7496112921958713,2388,1735,4123,-
chr1,153662295,1.7089510142376858,2046,1342,3388,-
chr1,153662518,1.5699773318780958,1019,830,1849,-
chr1,153662535,1.3752515318004026,1788,1281,3069,-
chr1,153662779,1.561369000786782,971,743,1714,-
chr1,153663121,0.7262295081967213,1328,914,2242,-
chr1,153664129,0.5970106115033651,760,620,1380,-
chr1,153664463,1.7860386100386103,1090,874,1964,-
chr1,153665244,1.372428788867145,1660,1459,3119,-
chr1,153665267,1.6948924731182795,1260,991,2251,-
chr1,153665703,1.9584729255940783,1861,1509,3370,-
chr1,153665704,1.7540165678948596,3301,2728,6029,-
chr1,153667623,1.5505983545250557,1625,1336,2961,-
chr1,153667655,1.607034492742274,2678,1741,4419,-
chr1,153668070,1.6621652421652415,940,779,1719,-
chr1,153668466,1.3864597376240164,2858,2049,4907,-
chr1,153668505,0.46056045666839657,709,563,1272,-
chr1,153668527,1.7395577395577395,1061,887,1948,-
chr1,153668553,1.5259341472438033,1005,794,1799,-
chr1,153669846,0.6005864882138426,1277,793,2070,-
chr1,153669857,1.5012113055181695,1013,742,1755,-
chr1,153670189,2.533632286995516,564,445,1009,-
chr1,153959184,45.58218032223258,6859,4572,11431,-
chr1,153959185,45.58218032223258,6859,4572,11431,-
chr1,153959190,2.5700218818380747,1130,456,1586,-
chr1,153959196,6.194693094629154,2152,781,2933,-
chr1,153959197,18.344108438717097,2863,1138,4001,-
chr1,153959334,0.6645935233597572,1086,846,1932,-
chr1,153959367,1.5296678903782124,873,688,1561,-
chr1,153959374,1.9887957874492128,2059,1563,3622,-
chr1,153959378,12.078552515445722,1609,1235,2844,-
chr1,153959379,13.715090564648108,4158,2953,7111,-
chr1,153959380,13.388082912033205,4937,3451,8388,-
chr1,153959394,2.634332855956229,1671,1133,2804,-
chr1,153959395,1.5993863686171383,889,506,1395,-
chr1,153959396,2.739441340782123,1065,715,1780,-
chr1,153959428,0.3577192038730501,664,506,1170,-
chr1,153959431,0.5822553808169181,903,600,1503,-
chr1,153959594,2.0549197111757733,1305,1030,2335,-
chr1,153959595,2.0953662968000426,1994,1680,3674,-
chr1,153959625,2.0513860824723884,1625,1152,2777,-
chr1,153959729,2.7820355610055176,549,465,1014,-
chr1,153959822,0.564996829422955,692,580,1272,-
chr1,153959970,2.316146307323159,1867,1496,3363,-
chr1,153959986,0.5941572852358472,1177,750,1927,-
chr1,153959998,2.6683579335793355,1494,1083,2577,-
chr1,153959999,2.9667750770241854,3399,2394,5793,-
chr1,153960010,6.3747228381374725,689,450,1139,-
chr1,153960014,3.0415554072096125,674,427,1101,-
chr1,153960022,0.4910766316521131,3253,1991,5244,-
chr1,153960065,1.876780185758514,865,645,1510,-
chr1,153960072,1.8944383643418568,576,436,1012,-
chr1,153960098,1.8182847082494968,760,567,1327,-
chr1,153960218,0.6631611506340861,602,548,1150,-
chr1,153960222,0.6303452644916059,795,573,1368,-
chr1,153960289,2.0951871657754007,652,439,1091,-
chr1,153960529,2.098945660989457,646,410,1056,-
chr1,153960689,1.3224721031483868,1179,907,2086,-
chr1,153960731,0.5544489795918367,848,524,1372,-
chr1,153960735,1.982223222322232,1148,908,2056,-
chr1,153960737,1.982223222322232,1148,908,2056,-
chr1,153962265,1.0862747724773154,1351,1035,2386,-
chr1,153962629,2.881846635367762,634,425,1059,-
chr1,153962630,2.881846635367762,634,425,1059,-
chr1,153963510,0.46137404348993727,1279,1002,2281,-
chr1,153974599,1.2471676442216693,17865,13926,31791,-
chr1,153974612,1.5351048001080938,13947,10362,24309,-
chr1,153974621,1.7374446367080854,6106,4708,10814,-
chr1,153974648,1.6024226194222284,12552,8890,21442,-
chr1,153974722,1.5200655285038691,2020,1366,3386,-
chr1,153974731,0.6073537585104906,4113,2398,6511,-
chr1,153974760,0.5836092862452739,2929,2137,5066,-
chr1,153975841,0.7819960405263772,2764,1938,4702,-
chr1,153975844,1.092343109637718,4710,3171,7881,-
chr1,153975847,0.730604610734062,2068,1580,3648,-
chr1,153975864,1.4274832878260046,1968,1234,3202,-
chr1,153976766,2.3244591777451213,1307,1008,2315,-
chr1,153976768,2.3244591777451213,1307,1008,2315,-
chr1,153976776,1.1476355243310705,622,431,1053,-
chr1,153977010,1.9947351336966161,1610,1184,2794,-
chr1,153977181,1.8736461449897677,1909,1336,3245,-
chr1,153977281,2.070747132597277,742,490,1232,-
chr1,153977338,1.705128205128205,930,545,1475,-
chr1,153977450,1.8505687248299125,1195,794,1989,-
chr1,153977462,1.8022988505747128,685,434,1119,-
chr1,153977486,0.7663366110255133,1044,908,1952,-
chr1,153977487,0.42520985275904777,514,558,1072,-
chr1,153977541,3.568115257990117,1148,852,2000,-
chr1,153977582,0.8317300577179222,561,465,1026,-
chr1,153977584,0.8317300577179222,561,465,1026,-
chr1,153981916,2.12396265560166,629,481,1110,-
chr1,153982001,6.729987584962449,3631,2667,6298,-
chr1,153982002,6.729987584962449,3631,2667,6298,-
chr1,153982024,1.3730194323664626,1341,778,2119,-
chr1,153982025,1.1789014183017765,1302,794,2096,-
chr1,153982026,1.1278909863732969,693,420,1113,-
chr1,153982027,1.5903643700237986,1086,644,1730,-
chr1,153982127,1.8896863778127357,763,592,1355,-
chr1,153982147,3.4251968503937005,629,380,1009,-
chr1,153982149,3.4251968503937005,629,380,1009,-
chr1,154156575,0.6926823016788415,1080,917,1997,-
chr1,154156845,2.586816321468436,926,732,1658,-
chr1,154156911,0.5833333333333333,685,587,1272,-
chr1,154157135,2.1654056570829936,1052,780,1832,-
chr1,154157170,1.3007974248142478,1718,1383,3101,-
chr1,154157204,4.39067934152562,1305,907,2212,-
chr1,154157205,3.4886457356149285,2295,1674,3969,-
chr1,154157389,0.6005979980066734,769,490,1259,-
chr1,154157490,1.69683257918552,824,571,1395,-
chr1,154157602,2.0023316062176164,1047,771,1818,-
chr1,154157604,2.0023316062176164,1047,771,1818,-
chr1,154157703,0.3920051579626048,607,516,1123,-
chr1,154170688,1.425938329574996,9804,5728,15532,-
chr1,154170692,0.704727818507187,1525,1018,2543,-
chr1,154170693,0.7347102022992278,15123,8368,23491,-
chr1,154170695,0.6751134624678787,17797,10030,27827,-
chr1,154170696,0.6417852888341777,10605,5920,16525,-
chr1,154170699,1.5680120994422913,4291,2626,6917,-
chr1,154170700,0.9092797815542797,12714,7723,20437,-
chr1,154170701,0.5939188812511931,12164,7492,19656,-
chr1,154170703,0.799157218603639,16401,10360,26761,-
chr1,154170704,0.6506286506286506,7154,4661,11815,-
chr1,154170706,1.6762017538244895,3293,1837,5130,-
chr1,154170708,1.5163270991266407,13565,8123,21688,-
chr1,154170709,1.4191798145862868,4991,2761,7752,-
chr1,154170710,1.44623958973189,9436,5491,14927,-
chr1,154170711,1.3648477403961528,4933,2670,7603,-
chr1,154172046,2.1490920972786256,1150,578,1728,-
chr1,154172055,0.4753086419753086,923,485,1408,-
chr1,154172062,1.5969436485195798,1671,1046,2717,-
chr1,154172069,1.7249911629551078,1524,942,2466,-
chr1,154172074,1.7926181625066384,1412,806,2218,-
chr1,154172086,2.2203012686420025,1705,963,2668,-
chr1,154172958,1.6573084785442782,2924,1295,4219,-
chr1,154172961,1.5925522942041128,4180,2148,6328,-
chr1,154172967,1.9800683371298409,2073,877,2950,-
chr1,154172968,1.9800683371298409,2073,877,2950,-
chr1,154173141,1.5865828893424927,5336,3196,8532,-
chr1,154173150,1.5385790679908329,2013,1308,3321,-
chr1,154173161,1.3995252948364103,3288,2016,5304,-
chr1,154173162,1.3995252948364103,3288,2016,5304,-
chr1,154173174,0.7005006305652157,2443,1336,3779,-
chr1,154173185,1.82592067114922,924,558,1482,-
chr1,154176156,1.6652444444444445,985,624,1609,-
chr1,154183173,0.8193395622680149,825,600,1425,-
chr1,154183175,0.8193395622680149,825,600,1425,-
chr1,154206888,1.5184235982864107,3152,2040,5192,-
chr1,154206953,1.4055614287091729,5543,3812,9355,-
chr1,154206969,1.6738987906548533,4120,2705,6825,-
chr1,154207006,0.666842426244505,2836,1710,4546,-
chr1,154207070,1.3239549839228295,1646,1243,2889,-
chr1,154207289,1.5956280481020007,4296,3117,7413,-
chr1,154207324,0.4655135935681794,1353,1095,2448,-
chr1,154207334,1.5611850217405412,2206,1621,3827,-
chr1,154207335,1.4818112830115668,4012,2664,6676,-
chr1,154207345,1.4942789968652035,3315,1759,5074,-
chr1,154207346,1.4645948863804523,4769,2855,7624,-
chr1,154207428,1.3412024756852343,2757,1949,4706,-
chr1,154207477,1.957259158751696,1730,1473,3203,-
chr1,154207502,1.6346086956521741,1445,1249,2694,-
chr1,154207526,1.3721719457013577,2425,1631,4056,-
chr1,154207531,1.6388695315524588,2227,1434,3661,-
chr1,154207566,0.7054768743191047,1695,1316,3011,-
chr1,154207643,0.45856898029134535,1528,1166,2694,-
chr1,154212367,1.515628860884606,1401,1135,2536,-
chr1,154212576,1.6549625468164795,1413,1067,2480,-
chr1,154212584,1.8988160382051529,1387,1057,2444,-
chr1,154214525,1.5348376444689051,2323,1579,3902,-
chr1,154214533,1.530909976425799,3544,2702,6246,-
chr1,154214554,1.6152460984393753,3743,2239,5982,-
chr1,154214555,1.6152460984393753,3743,2239,5982,-
chr1,154214572,2.0888680307865592,1356,760,2116,-
chr1,154219909,1.6732397274416682,852,667,1519,-
chr1,154219931,1.6298882681564246,777,715,1492,-
chr1,154220375,1.7904003971985079,1975,1652,3627,-
chr1,154220432,2.177068214804064,1279,831,2110,-
chr1,154220441,1.7932576582968047,1626,1293,2919,-
chr1,154220442,1.7932576582968047,1626,1293,2919,-
chr1,154220457,2.3495994579815975,3619,2666,6285,-
chr1,154220458,2.5323532955777805,2626,1929,4555,-
chr1,154220459,2.5323532955777805,2626,1929,4555,-
chr1,154220460,2.6426415094339624,1936,1377,3313,-
chr1,154220463,2.9717647058823533,841,424,1265,-
chr1,154220559,0.5775261953510779,665,436,1101,-
chr1,154220577,1.1889542172179741,1036,772,1808,-
chr1,154220579,1.8077248703762128,1078,785,1863,-
chr1,154415030,1.3848886505688958,1332,718,2050,-
chr1,154415031,1.3848886505688958,1332,718,2050,-
chr1,154415032,1.3848886505688958,1332,718,2050,-
chr1,154550122,2.0551668428818335,841,708,1549,-
chr1,154551467,0.3805203805203805,603,406,1009,-
chr1,154551468,0.3805203805203805,603,406,1009,-
chr1,154554758,1.858335867792721,9592,6918,16510,-
chr1,154554759,1.9763424363644968,10971,7975,18946,-
chr1,154554761,2.351941747572816,2804,2199,5003,-
chr1,154555446,1.8727684878144122,1932,1111,3043,-
chr1,154555451,1.5715024949177598,1036,772,1808,-
chr1,154555489,5.320357833655706,814,516,1330,-
chr1,154583075,0.7660906586526421,643,483,1126,-
chr1,154583077,0.7660906586526421,643,483,1126,-
chr1,154583835,0.9921002283527742,642,490,1132,-
chr1,154583836,0.9921002283527742,642,490,1132,-
chr1,154584483,1.0842338701673713,613,425,1038,-
chr1,154584955,1.1166163513315008,945,626,1571,-
chr1,154585849,1.673575129533679,645,385,1030,-
chr1,154586190,1.2419282195636876,1316,724,2040,-
chr1,154586191,1.0975465345415625,1673,992,2665,-
chr1,154586192,1.2419282195636876,1316,724,2040,-
chr1,154588649,2.2444110275689217,771,524,1295,-
chr1,154588651,2.2444110275689217,771,524,1295,-
chr1,154601932,2.2610131340368103,614,399,1013,-
chr1,154601965,1.5511084208815311,587,485,1072,-
chr1,154944722,27.85431166427333,871,1089,1960,-
chr1,154944723,30.04061779005672,795,943,1738,-
chr1,154946286,1.6616942765172331,829,541,1370,-
chr1,154946288,1.2792559984508909,1220,835,2055,-
chr1,154962729,3.0997140007622788,615,389,1004,-
chr1,154962960,12.198915130511343,1517,1020,2537,-
chr1,154962961,12.198915130511343,1517,1020,2537,-
chr1,154962962,13.947856049717492,886,595,1481,-
chr1,154963686,2.5662733065578913,655,492,1147,-
chr1,154966453,0.38478021926993383,1005,777,1782,-
chr1,154966454,0.4077277877450092,1013,768,1781,-
chr1,154966455,0.40235351011525744,831,652,1483,-
chr1,154970133,10.973119210742666,669,356,1025,-
chr1,154970134,10.973119210742666,669,356,1025,-
chr1,155140051,0.3122664673855023,649,550,1199,-
chr1,155140052,0.3122664673855023,649,550,1199,-
chr1,155140054,3.6576783790240874,776,517,1293,-
chr1,155140211,3.548305836769769,891,815,1706,-
chr1,155140231,0.5691770798153777,947,986,1933,-
chr1,155140233,0.49107654065829703,1326,1417,2743,-
chr1,155140235,0.5255436125525079,829,911,1740,-
chr1,155140267,25.585870531298397,784,1009,1793,-
chr1,155140268,33.8984414190696,568,663,1231,-
chr1,155169453,0.47615005941266336,747,547,1294,-
chr1,155169551,0.541018387553041,629,403,1032,-
chr1,155172590,1.8715170278637772,650,475,1125,-
chr1,155172757,2.2531828703703702,598,431,1029,-
chr1,155172839,0.23867639210104966,515,802,1317,-
chr1,155172878,12.16588710360813,3156,4058,7214,-
chr1,155172879,12.16588710360813,3156,4058,7214,-
chr1,155172883,6.985068513553768,1258,745,2003,-
chr1,155172884,15.822301381529119,3718,2617,6335,-
chr1,155172885,15.822301381529119,3718,2617,6335,-
chr1,155172886,11.462207357859533,1223,597,1820,-
chr1,155247680,4.307692307692308,593,428,1021,-
chr1,155247681,4.307692307692308,593,428,1021,-
chr1,155247682,4.307692307692308,593,428,1021,-
chr1,155256127,1.8822880370543889,771,538,1309,-
chr1,155256135,3.340908575609931,696,529,1225,-
chr1,155256243,2.8423295454545454,620,395,1015,-
chr1,155256244,2.8423295454545454,620,395,1015,-
chr1,155256366,1.2183235867446394,599,455,1054,-
chr1,155256368,1.2183235867446394,599,455,1054,-
chr1,155256408,0.9728222996515681,697,573,1270,-
chr1,155256409,0.9728222996515681,697,573,1270,-
chr1,155257509,2.787079316759682,823,656,1479,-
chr1,155257511,2.787079316759682,823,656,1479,-
chr1,155257600,2.496556473829201,624,483,1107,-
chr1,155257601,2.496556473829201,624,483,1107,-
chr1,155258900,1.5836206896551723,667,463,1130,-
chr1,155258922,1.1853793298405932,706,579,1285,-
chr1,155260555,1.0015188834154352,786,695,1481,-
chr1,155260556,1.0015188834154352,786,695,1481,-
chr1,155260562,2.3272357723577235,915,573,1488,-
chr1,155260563,2.3272357723577235,915,573,1488,-
chr1,155947245,2.2280820727838293,2037,1401,3438,-
chr1,155947277,0.6009503589121423,742,470,1212,-
chr1,155947280,3.377516252360185,2064,1398,3462,-
chr1,155947295,1.5096928884807672,1171,791,1962,-
chr1,155947296,1.479507280317652,2458,1499,3957,-
chr1,155947297,1.2352624200235862,1693,979,2672,-
chr1,155947298,1.4498209829662578,1287,708,1995,-
chr1,155957875,1.9893390191897653,621,468,1089,-
chr1,155957876,1.9893390191897653,621,468,1089,-
chr1,155957877,1.9893390191897653,621,468,1089,-
chr1,156009147,0.7131710604764497,1447,1001,2448,-
chr1,156009221,1.3644655510327153,1573,1187,2760,-
chr1,156009292,1.5861739130434782,1257,919,2176,-
chr1,156009486,1.082215242942702,5889,4189,10078,-
chr1,156009487,0.970563045819654,4532,3051,7583,-
chr1,156009508,1.6655865502019351,1222,1013,2235,-
chr1,156009593,0.7105322003577818,1549,1039,2588,-
chr1,156011857,1.6881853169704453,1452,878,2330,-
chr1,156014993,1.9234913793103448,1189,869,2058,-
chr1,156015060,1.7250815512866982,1001,711,1712,-
chr1,156015064,1.8996053959805448,919,640,1559,-
chr1,156018288,1.356254145414046,3726,2736,6462,-
chr1,156018342,1.4032268832758428,1355,1044,2399,-
chr1,156020073,1.315063334474495,2153,1379,3532,-
chr1,156020088,1.4056286131757831,1195,953,2148,-
chr1,156020134,1.528457216940363,1386,889,2275,-
chr1,156020154,2.0406654343807764,689,540,1229,-
chr1,156020903,1.7757039947609692,637,508,1145,-
chr1,156020907,1.826066528622366,2440,1671,4111,-
chr1,156020909,1.826066528622366,2440,1671,4111,-
chr1,156020911,2.109256926952141,637,396,1033,-
chr1,156020921,2.1071645679548414,1347,734,2081,-
chr1,156020922,2.1071645679548414,1347,734,2081,-
chr1,156020923,2.1071645679548414,1347,734,2081,-
chr1,156292829,3.7173024234795324,1132,862,1994,-
chr1,156292835,6.941537906797606,1682,999,2681,-
chr1,156292836,6.941537906797606,1682,999,2681,-
chr1,156293094,4.495039875356293,639,508,1147,-
chr1,156294837,0.881717248741683,766,608,1374,-
chr1,156294838,1.458362284210724,661,483,1144,-
chr1,156309045,0.7901340825397606,2920,2058,4978,-
chr1,156309182,1.6970518069095513,2880,1786,4666,-
chr1,156309183,0.6193361065356375,1887,1461,3348,-
chr1,156309283,1.6227064220183487,1414,1089,2503,-
chr1,156310634,1.5174220374220375,1798,1294,3092,-
chr1,156310650,1.429915840784032,4882,3588,8470,-
chr1,156310651,1.4025090333054044,2420,1983,4403,-
chr1,156310654,2.2130143172474868,2462,2073,4535,-
chr1,156310670,1.727018385291767,1042,833,1875,-
chr1,156310672,1.443557090438161,1935,1242,3177,-
chr1,156310964,1.5027906209123512,2737,2306,5043,-
chr1,156311081,0.6487926136363636,944,639,1583,-
chr1,156311189,1.468152066558414,2277,1456,3733,-
chr1,156311192,1.6267647458087289,2106,1636,3742,-
chr1,156311193,1.5335282382930395,5469,4000,9469,-
chr1,156312172,1.4623552123552124,2019,1679,3698,-
chr1,156317428,1.33324337526214,19616,14223,33839,-
chr1,156317429,0.8591718244279144,5651,4802,10453,-
chr1,156317430,1.33324337526214,19616,14223,33839,-
chr1,156317437,1.4607330831207157,5216,3492,8708,-
chr1,156317461,1.3345019987100075,16879,11416,28295,-
chr1,156317462,1.3523462314644203,9816,5799,15615,-
chr1,156317464,1.909587903363705,3831,3148,6979,-
chr1,156317535,1.2656766714598442,39770,34160,73930,-
chr1,156317536,1.3264865304452418,105892,96806,202698,-
chr1,156317538,1.3048455662545912,95680,89676,185356,-
chr1,156317540,1.243096632574208,148706,131991,280697,-
chr1,156317541,1.2462600483590967,87208,78851,166059,-
chr1,156317542,1.241742309968883,132688,117258,249946,-
chr1,156317543,1.051190347722498,47860,37866,85726,-
chr1,156317544,1.6222822968105988,32801,34343,67144,-
chr1,156317545,1.4902595612716685,24702,25670,50372,-
chr1,156317546,1.2106305948188907,56577,51093,107670,-
chr1,156317547,1.1276150635449607,49179,43030,92209,-
chr1,156317548,0.9610864242045527,32669,25954,58623,-
chr1,156318883,1.1729576163923197,58388,47256,105644,-
chr1,156318884,1.2104681547763374,76538,61694,138232,-
chr1,156318886,1.2566929905781925,70043,55423,125466,-
chr1,156318887,1.1322199905133261,63887,49704,113591,-
chr1,156318889,0.9167268813037177,70670,55240,125910,-
chr1,156318890,0.7754998279847682,48988,38448,87436,-
chr1,156318891,0.8925690086478383,37821,30698,68519,-
chr1,156318893,1.4818991667123382,10706,8928,19634,-
chr1,156318895,1.3668575836468566,18037,14062,32099,-
chr1,156318896,1.3228284995141804,11238,8513,19751,-
chr1,156318903,1.3938499824795345,19296,14120,33416,-
chr1,156318904,1.4136781471204578,15832,11431,27263,-
chr1,156318925,1.7327694417086688,4205,2525,6730,-
chr1,156318932,0.8068345813478558,2987,2259,5246,-
chr1,156318965,1.3899109413882578,5050,3163,8213,-
chr1,156318969,1.3427815206929743,2768,2077,4845,-
chr1,156320923,1.9261002115559414,4237,4361,8598,-
chr1,156320924,1.9261002115559414,4237,4361,8598,-
chr1,156320936,1.3875739644970413,1973,1832,3805,-
chr1,156320983,1.602320675105485,1371,1105,2476,-
chr1,156320989,1.695882312504296,2466,1491,3957,-
chr1,156325028,1.371260327943198,2036,1720,3756,-
chr1,156325083,1.6206896551724137,2067,1594,3661,-
chr1,156335857,1.3984076650300057,1929,1503,3432,-
chr1,156335859,0.7334478898174907,5121,3905,9026,-
chr1,156335861,0.9320471885446495,8249,5863,14112,-
chr1,156335870,1.4102242236901978,2156,1892,4048,-
chr1,156335884,1.2759549692728491,3421,2215,5636,-
chr1,156338209,1.4924879316376902,4953,3316,8269,-
chr1,156338238,0.8301221712352748,2853,1912,4765,-
chr1,156338246,1.6132141605327723,788,633,1421,-
chr1,156338252,2.638413474599293,606,408,1014,-
chr1,156338256,0.5583179864947821,855,542,1397,-
chr1,156338262,0.8479681174075543,1722,1311,3033,-
chr1,156338263,1.0248189439962887,1734,1214,2948,-
chr1,156595152,2.1125000000000003,1312,930,2242,-
chr1,156595161,1.7142857142857144,619,433,1052,-
chr1,156595257,1.9351115670684789,502,556,1058,-
chr1,156595288,5.59971141181546,1006,1064,2070,-
chr1,156645154,2.647105373178592,1716,1303,3019,-
chr1,156645155,2.647105373178592,1716,1303,3019,-
chr1,156724194,0.940934045788092,692,586,1278,-
chr1,156727332,1.5888774336622695,864,722,1586,-
chr1,156727333,2.2010955538923462,793,680,1473,-
chr1,156737366,1.4380561342557443,2922,1456,4378,-
chr1,156737370,1.528786515565917,19550,10490,30040,-
chr1,156737371,1.4142592480135427,24557,13228,37785,-
chr1,156737373,1.4516523453331984,18653,10147,28800,-
chr1,156737375,1.7996780727772554,5762,3605,9367,-
chr1,156737378,1.0523542703308177,6282,3193,9475,-
chr1,156737399,1.3988292064144676,4659,2347,7006,-
chr1,156737495,1.5736061728757724,1920,1217,3137,-
chr1,156737685,1.2489866662016107,2531,1876,4407,-
chr1,156737687,1.6281661600810535,1606,1127,2733,-
chr1,156737702,0.4024231582371118,706,558,1264,-
chr1,156737704,2.1451175406871608,948,631,1579,-
chr1,156738053,1.6263989466754445,1097,743,1840,-
chr1,156738077,1.954248366013072,620,458,1078,-
chr1,156738091,1.8045200900694338,1279,823,2102,-
chr1,156738105,2.491283903383304,1114,701,1815,-
chr1,156738131,2.375388753322923,3220,1318,4538,-
chr1,156738132,2.2145028425543227,4136,1630,5766,-
chr1,156738133,2.2145028425543227,4136,1630,5766,-
chr1,156738351,29.90141031213918,2777,798,3575,-
chr1,156738352,18.13366336633663,1553,403,1956,-
chr1,156738354,5.968701144707398,3535,593,4128,-
chr1,156738356,5.947618657329649,2957,494,3451,-
chr1,156738364,5.777317593842314,1518,312,1830,-
chr1,156738366,7.233179723502303,980,216,1196,-
chr1,156738387,0.08656114614163772,1008,408,1416,-
chr1,156738388,0.1390889519999469,1760,666,2426,-
chr1,156738427,2.0,713,407,1120,-
chr1,156738596,0.4909492273730685,555,452,1007,-
chr1,156738604,1.6242271154862664,1245,1111,2356,-
chr1,156738606,1.8529644268774703,1171,1034,2205,-
chr1,156738607,2.1681159420289853,747,644,1391,-
chr1,156738723,0.5831860641252209,615,465,1080,-
chr1,156742292,1.4148973433205798,4200,2650,6850,-
chr1,156742293,1.4148973433205798,4200,2650,6850,-
chr1,156742294,0.7138298594609274,1501,1132,2633,-
chr1,156742321,0.6648404255319148,1292,1127,2419,-
chr1,156742322,1.7847004608294932,1029,874,1903,-
chr1,156742327,2.205311778290993,1060,865,1925,-
chr1,156742362,1.6262829077926855,3146,2627,5773,-
chr1,156742519,1.6810757473967075,1270,915,2185,-
chr1,156742701,1.382095607156913,3163,1942,5105,-
chr1,156742733,0.8766082825617775,11120,7608,18728,-
chr1,156742734,0.7419371236550099,11811,7760,19571,-
chr1,156742735,0.7419371236550099,11811,7760,19571,-
chr1,156742736,0.8633883561878876,12766,8811,21577,-
chr1,156742738,0.749111175394722,5096,3503,8599,-
chr1,156742743,0.6674877627720477,3981,3028,7009,-
chr1,156742744,0.6674877627720477,3981,3028,7009,-
chr1,156742867,0.6187050359712231,1203,972,2175,-
chr1,156742870,1.0393187258620336,2822,2035,4857,-
chr1,156742879,7.538955536806864,7371,5654,13025,-
chr1,156742880,4.081714314201414,5480,4181,9661,-
chr1,156742915,0.5847283523533077,1075,908,1983,-
chr1,156742930,0.4872818240867326,2940,3335,6275,-
chr1,156742931,0.4214117647058824,1989,2379,4368,-
chr1,156742932,0.5926753722727265,2263,2132,4395,-
chr1,156742937,0.5771547444239373,2018,2004,4022,-
chr1,156742962,0.44334872635185457,646,958,1604,-
chr1,156742967,7.891813820488301,2519,3050,5569,-
chr1,156742981,13.40543672235312,7370,6396,13766,-
chr1,156742982,13.40543672235312,7370,6396,13766,-
chr1,156742983,13.40543672235312,7370,6396,13766,-
chr1,156742987,9.21363974429956,2495,1506,4001,-
chr1,156742997,2.1400874792516063,3252,1347,4599,-
chr1,156742998,2.7863270928924497,3349,1640,4989,-
chr1,156742999,2.5150101874048705,5991,2491,8482,-
chr1,156743000,2.752535496957404,1862,782,2644,-
chr1,156743001,2.7921061792319697,4576,1741,6317,-
chr1,156743003,6.846123663092516,4857,1604,6461,-
chr1,156743004,7.428314572918317,8039,2415,10454,-
chr1,156743005,7.731550820124571,8520,2516,11036,-
chr1,156743006,9.461892058362297,8473,2201,10674,-
chr1,156743007,15.010217113665387,1931,521,2452,-
chr1,156743008,6.089832215049342,5120,700,5820,-
chr1,156743009,9.368542774441782,6553,948,7501,-
chr1,156743010,9.005497899629896,6489,900,7389,-
chr1,156743011,15.515350877192981,1414,227,1641,-
chr1,156743098,2.2372016760794318,1534,997,2531,-
chr1,156743234,1.4140225303535978,3009,2291,5300,-
chr1,156743292,1.675792369565995,1867,1504,3371,-
chr1,156743318,0.5913495155329138,887,638,1525,-
chr1,156743355,2.757336890613631,688,588,1276,-
chr1,156743729,1.6103648757016835,1189,927,2116,-
chr1,156743750,0.5499208429576186,1008,726,1734,-
chr1,156743849,1.255053964472094,2438,1975,4413,-
chr1,156743851,1.6030147058823527,1520,1274,2794,-
chr1,156743872,1.9235476885415685,680,558,1238,-
chr1,156744211,2.3004477721500405,846,716,1562,-
chr1,156744315,1.6847025912838631,994,848,1842,-
chr1,156745039,1.6159815436241611,1004,893,1897,-
chr1,156745047,1.5242429113751867,1925,1206,3131,-
chr1,156745117,0.7338208258453658,5074,2607,7681,-
chr1,156745118,0.683115090926808,7441,3857,11298,-
chr1,156745131,0.6410604534372765,1995,1160,3155,-
chr1,156745139,1.3552075565498385,1362,744,2106,-
chr1,156745340,1.2068013173824708,7231,4860,12091,-
chr1,156745342,1.0309247363239227,4501,3133,7634,-
chr1,156745345,0.7193937657210175,1026,721,1747,-
chr1,156745346,1.1954986760812003,1547,1132,2679,-
chr1,156745347,1.1954986760812003,1547,1132,2679,-
chr1,156745365,0.6680955683035996,756,546,1302,-
chr1,156751400,1.6270270270270266,1000,714,1714,-
chr1,156751403,1.6190962297536409,642,473,1115,-
chr1,156751409,1.737085906793936,824,547,1371,-
chr1,156751666,0.48546222613096673,1231,935,2166,-
chr1,156751667,0.4721413183764214,1248,888,2136,-
chr1,156751679,0.29373644002076055,766,678,1444,-
chr1,158176012,0.576988270391213,850,601,1451,-
chr1,158177307,1.826571582669144,634,406,1040,-
chr1,158177308,1.826571582669144,634,406,1040,-
chr1,158177309,1.3800725124990822,891,556,1447,-
chr1,159918160,5.095270487094328,10587,14708,25295,-
chr1,159918161,4.903811802546698,9684,12898,22582,-
chr1,159918178,5.730303960700032,3170,3256,6426,-
chr1,159918180,24.870242747944673,13184,12890,26074,-
chr1,159918181,31.021525783649025,11573,11211,22784,-
chr1,159918184,14.450916420805493,10013,5139,15152,-
chr1,159918185,15.17223667358574,8053,4403,12456,-
chr1,159918190,6.395923167168954,4457,2035,6492,-
chr1,159918194,15.171710293603477,20803,7070,27873,-
chr1,159918195,15.171710293603477,20803,7070,27873,-
chr1,159918196,15.171710293603478,20803,7070,27873,-
chr1,159918238,0.5633984867591425,1553,792,2345,-
chr1,159918281,1.8144144144144143,1006,584,1590,-
chr1,159918284,1.8111367904087825,1285,643,1928,-
chr1,159918286,1.8459064327485384,855,479,1334,-
chr1,159918288,1.7331862855865943,4234,2191,6425,-
chr1,159918289,1.7331862855865943,4234,2191,6425,-
chr1,159918298,1.8127240143369172,2736,1115,3851,-
chr1,159918299,1.8127240143369172,2736,1115,3851,-
chr1,159918300,1.8127240143369172,2736,1115,3851,-
chr1,159918305,2.4313008805449408,812,462,1274,-
chr1,159918510,2.222439721189837,1887,1542,3429,-
chr1,159918676,1.5843014177752794,2229,1778,4007,-
chr1,159918738,1.5352272727272729,1350,1007,2357,-
chr1,159918768,0.6663667961562053,1357,1004,2361,-
chr1,159918794,1.7563423473654869,1119,843,1962,-
chr1,159918809,1.5476778384159289,1277,948,2225,-
chr1,159918869,1.4847772729646456,1776,1472,3248,-
chr1,159918881,1.4830265119102206,5734,4157,9891,-
chr1,159918906,1.6211562130701356,3146,1947,5093,-
chr1,159918918,1.5423686292672572,1377,750,2127,-
chr1,159918933,1.9931567608668104,982,606,1588,-
chr1,159918940,2.6003430531732414,1136,582,1718,-
chr1,159919323,1.3121535692861428,2939,1666,4605,-
chr1,159919370,0.7348319709355132,1470,1100,2570,-
chr1,159919372,1.531059770661499,6012,3574,9586,-
chr1,159919373,1.531059770661499,6012,3574,9586,-
chr1,159919374,0.5351375598086124,1192,1063,2255,-
chr1,159919375,0.6384325285014522,1051,781,1832,-
chr1,159919762,1.5070372315252414,2472,1772,4244,-
chr1,159919809,1.634485190963562,4260,3471,7731,-
chr1,159919818,1.245414465552618,9769,8151,17920,-
chr1,159919819,1.301984069528698,11369,9485,20854,-
chr1,159919820,1.4693516465933842,6726,5770,12496,-
chr1,159919821,1.5231052572831791,4961,4215,9176,-
chr1,159919824,1.6314393939393943,1533,1247,2780,-
chr1,159920358,1.411595279005416,5799,3420,9219,-
chr1,159920360,1.384667380879502,4313,2375,6688,-
chr1,159920488,1.4170615734198384,13996,8765,22761,-
chr1,159920489,1.3917500002111207,11048,6701,17749,-
chr1,159920511,1.5109433192184072,1850,1152,3002,-
chr1,159920512,1.870631134758279,1430,990,2420,-
chr1,159920516,1.5250945517734846,2237,1086,3323,-
chr1,159925477,0.6355253063261985,2945,2212,5157,-
chr1,159925482,1.3394822110294824,1941,853,2794,-
chr1,159925500,1.7546892557697291,579,502,1081,-
chr1,159925503,1.7690783244281678,2968,1538,4506,-
chr1,159925506,0.8382183869335211,3240,1612,4852,-
chr1,159925507,0.6652235925832704,1801,684,2485,-
chr1,160093797,3.2010380031902397,709,448,1157,-
chr1,160095094,2.421974270203287,607,455,1062,-
chr1,160215778,17.520035119409098,516,773,1289,-
chr1,160215780,19.793295196993082,457,625,1082,-
chr1,160216882,5.751439269970861,1646,1412,3058,-
chr1,160216883,7.644470907058465,2989,2229,5218,-
chr1,160216884,7.644470907058465,2989,2229,5218,-
chr1,160216885,8.332290718779705,2437,1701,4138,-
chr1,160216891,6.637998477528995,825,373,1198,-
chr1,160217198,9.403830546376227,478,585,1063,-
chr1,160239752,8.472008548117532,663,423,1086,-
chr1,160277968,0.402179528085674,628,474,1102,-
chr1,160278825,0.9478243835938203,568,467,1035,-
chr1,160279038,1.1244270546174286,655,461,1116,-
chr1,160280240,1.074064170466847,625,440,1065,-
chr1,160282124,9.569717758356166,821,610,1431,-
chr1,160283069,1.7574048044978277,727,477,1204,-
chr1,160283588,1.7485699995829196,1186,918,2104,-
chr1,160283589,1.3953472209432587,950,642,1592,-
chr1,160283592,0.49648711943793916,635,426,1061,-
chr1,160283595,2.450295857988165,1009,649,1658,-
chr1,160283597,2.450295857988165,1009,649,1658,-
chr1,160289759,2.6805702716974857,692,464,1156,-
chr1,160289814,0.49370728650428464,799,523,1322,-
chr1,160289854,1.2692901850863187,1164,838,2002,-
chr1,160290618,2.405610875298421,961,711,1672,-
chr1,160291486,2.7225141078030743,822,570,1392,-
chr1,160291487,2.7225141078030743,822,570,1392,-
chr1,160291872,2.6404048818505856,939,700,1639,-
chr1,160291916,1.7421046608334412,776,596,1372,-
chr1,160292076,2.294195158412364,930,667,1597,-
chr1,160292181,1.9930251447030654,922,608,1530,-
chr1,160293400,2.2633701287081376,978,677,1655,-
chr1,160293431,1.0532874114006188,757,568,1325,-
chr1,160294559,3.0640071883503106,1281,1058,2339,-
chr1,160294560,3.252439139907171,927,781,1708,-
chr1,160294561,3.252439139907171,927,781,1708,-
chr1,160295783,0.5229885057471264,662,492,1154,-
chr1,160295803,0.5110589156390682,745,523,1268,-
chr1,160295804,1.9351832677572993,622,438,1060,-
chr1,160295812,2.270024425166344,1122,765,1887,-
chr1,160295813,2.270024425166344,1122,765,1887,-
chr1,160297429,1.7818281953818003,1156,775,1931,-
chr1,160297587,1.7285010674336834,3170,3175,6345,-
chr1,160297588,1.9261228365834735,1932,2198,4130,-
chr1,160297591,0.5900295524908528,1081,835,1916,-
chr1,160297594,1.325488625312613,2571,2379,4950,-
chr1,160297595,1.6413398692810457,1616,1631,3247,-
chr1,160297598,1.5282124087578162,2240,1944,4184,-
chr1,160297599,2.034692380253642,1437,1315,2752,-
chr1,160297605,1.5899348831182054,1846,1510,3356,-
chr1,160297606,1.598899468458883,3453,2572,6025,-
chr1,160297607,1.5899348831182054,1846,1510,3356,-
chr1,160297699,2.6477258566978192,663,534,1197,-
chr1,160297700,2.6477258566978192,663,534,1197,-
chr1,160299144,2.150761649065162,814,639,1453,-
chr1,160299225,1.101704098606523,961,714,1675,-
chr1,160305471,2.080627363319123,665,596,1261,-
chr1,160305480,3.570620381523163,1558,1143,2701,-
chr1,160305481,4.372515450240293,2345,1673,4018,-
chr1,160306403,2.321656400934229,1180,868,2048,-
chr1,160306425,1.0629381864024632,1154,884,2038,-
chr1,160306458,0.5203330324591878,1099,823,1922,-
chr1,160307195,1.6199681359532658,743,537,1280,-
chr1,160307217,2.0250839865621497,1232,704,1936,-
chr1,160307222,1.6289676425269646,880,648,1528,-
chr1,160307223,0.45514950166112955,1095,601,1696,-
chr1,160309111,1.573730333595601,1735,1100,2835,-
chr1,160310232,2.1693358708588675,1145,725,1870,-
chr1,160311893,1.7682819383259911,668,453,1121,-
chr1,160314082,1.1008522727272727,649,571,1220,-
chr1,160314083,1.1008522727272727,649,571,1220,-
chr1,160333615,1.735261561597183,1558,1135,2693,-
chr1,160335265,1.6255319148936171,763,469,1232,-
chr1,160335314,1.9251958522566925,976,659,1635,-
chr1,160340197,0.4264897215716888,595,426,1021,-
chr1,160343160,0.40801717967072293,899,761,1660,-
chr1,160343193,2.4590016478400485,1734,2033,3767,-
chr1,160343194,1.7249342427240717,2318,2496,4814,-
chr1,160343195,0.8377665947759406,1747,1604,3351,-
chr1,160343197,0.5619054676139047,1102,1008,2110,-
chr1,160343200,1.8695589837701438,632,657,1289,-
chr1,160343202,1.8695589837701438,632,657,1289,-
chr1,161100740,2.259290780141844,1085,845,1930,-
chr1,161102084,1.7569609135875028,21745,15885,37630,-
chr1,161102085,1.7422154913324819,31666,23136,54802,-
chr1,161102087,1.9706385011318843,22112,16345,38457,-
chr1,161102088,1.7209871141180855,26974,17996,44970,-
chr1,161102091,1.3892883399603186,15750,10362,26112,-
chr1,161102092,1.3929477775573238,23773,14942,38715,-
chr1,161102137,1.3654729816454885,3487,2119,5606,-
chr1,161102140,1.6526067339959218,1941,1020,2961,-
chr1,161102143,1.4092358325619667,1767,925,2692,-
chr1,161102165,2.175773132868842,4449,2726,7175,-
chr1,161102167,2.0448967061487195,5612,3357,8969,-
chr1,161102301,1.4803397845695767,2112,1201,3313,-
chr1,161102342,1.4382319751275217,6105,3814,9919,-
chr1,161102346,1.5581062552016909,2431,1686,4117,-
chr1,161102354,0.484559245650431,4056,2247,6303,-
chr1,161102357,0.8919631126910837,5770,3604,9374,-
chr1,161102361,1.0531594471356847,4039,2609,6648,-
chr1,161102374,0.5536681136559951,2717,1891,4608,-
chr1,161117961,0.9639547996531362,2778,2007,4785,-
chr1,161117964,3.77066224223547,7359,4687,12046,-
chr1,161117965,3.7706622422354705,7359,4687,12046,-
chr1,161117968,3.2455700579133886,1042,502,1544,-
chr1,161117973,3.5588318284424383,1008,442,1450,-
chr1,161117997,0.5151805688718439,867,446,1313,-
chr1,161118039,0.5767232557697832,750,469,1219,-
chr1,161118046,1.2677395023612104,1055,684,1739,-
chr1,161172085,2.8571428571428568,639,655,1294,-
chr1,161172086,2.5972573839662445,946,947,1893,-
chr1,161172088,1.8625206357098416,880,797,1677,-
chr1,165662417,12.922750947769517,3466,2446,5912,-
chr1,165662418,12.922750947769515,3466,2446,5912,-
chr1,165662419,10.650896722325292,1244,692,1936,-
chr1,165662436,2.553613204166238,691,408,1099,-
chr1,165662950,1.6496205494148177,758,483,1241,-
chr1,165663107,2.770369658805524,701,469,1170,-
chr1,165667407,2.1304604700301364,728,593,1321,-
chr1,165667448,1.5380640651234905,747,554,1301,-
chr1,165669443,2.8504141175196787,679,528,1207,-
chr1,165695390,2.8994781298629215,1059,716,1775,-
chr1,165695391,3.1143245294998487,699,437,1136,-
chr1,165727637,1.4365441370883696,9295,8341,17636,-
chr1,165727640,1.3750988142292488,2413,1869,4282,-
chr1,165727676,1.9265267657304408,2879,2611,5490,-
chr1,165727699,2.569513304736969,2470,1856,4326,-
chr1,165728110,1.8131421744324967,541,464,1005,-
chr1,165768858,0.6416429098709711,630,494,1124,-
chr1,165768866,0.38449161352236233,678,463,1141,-
chr1,166276595,0.43110285006195787,496,537,1033,-
chr1,166276596,0.7887823605168165,1090,814,1904,-
chr1,166276597,0.4889784050466157,1203,1218,2421,-
chr1,166276598,0.4906986684091991,1088,1141,2229,-
chr1,167541205,2.20947459086994,1165,859,2024,-
chr1,167541353,1.7226184086087466,4347,3725,8072,-
chr1,167541355,1.6800026824890941,6368,5398,11766,-
chr1,167541357,1.6350850629576927,10591,8130,18721,-
chr1,167541358,1.270649817588525,11756,8878,20634,-
chr1,167541359,1.270649817588525,11756,8878,20634,-
chr1,167541448,1.385893322031846,1285,994,2279,-
chr1,167541451,1.6287112724374,2459,1690,4149,-
chr1,167546115,2.5011655011655005,1014,714,1728,-
chr1,167546188,0.6907408048563746,2301,1698,3999,-
chr1,167546271,1.7375107820893256,2702,1864,4566,-
chr1,167548046,1.3942506034671929,1671,1084,2755,-
chr1,167548069,1.7162292051756007,828,540,1368,-
chr1,167548103,1.5180238870792615,1270,920,2190,-
chr1,167548113,2.0148508262947846,2460,1788,4248,-
chr1,167548114,1.9111882548636725,1809,1256,3065,-
chr1,167553427,1.6888077858880777,630,410,1040,-
chr1,167918294,0.5475555555555556,615,524,1139,-
chr1,167918312,5.770434782608695,552,459,1011,-
chr1,167920049,1.6933066933066934,677,454,1131,-
chr1,167920588,1.0229971819645731,700,620,1320,-
chr1,167920589,0.7966271931379323,1169,963,2132,-
chr1,167935764,1.0129453613051203,607,446,1053,-
chr1,167935965,8.200591545462549,644,464,1108,-
chr1,168056006,1.9427537921832174,1243,839,2082,-
chr1,168056145,1.7187499999999998,889,711,1600,-
chr1,168056167,2.391304347826087,846,643,1489,-
chr1,168056241,1.0971250971250972,705,494,1199,-
chr1,168056242,1.1610305958132046,720,597,1317,-
chr1,168056243,1.0971250971250972,705,494,1199,-
chr1,168056244,1.1610305958132046,720,597,1317,-
chr1,168056254,3.5953691402543173,591,478,1069,-
chr1,168056255,3.5953691402543173,591,478,1069,-
chr1,169132714,0.5752461322081575,817,473,1290,-
chr1,169132716,1.9863570821163157,1534,1257,2791,-
chr1,169132723,2.5457555956358475,1434,1090,2524,-
chr1,169132759,2.0490031227480183,852,542,1394,-
chr1,169132766,1.7645755597014927,817,535,1352,-
chr1,169132768,1.5416679014848098,1693,1396,3089,-
chr1,169132771,1.7938893800962763,1319,753,2072,-
chr1,169132773,1.5028388494026206,3940,2581,6521,-
chr1,169132774,1.299060222240675,2470,1445,3915,-
chr1,169132778,1.7127699886320575,1355,1130,2485,-
chr1,169132780,1.7718752923261916,1847,1368,3215,-
chr1,169132790,1.5583272193690387,589,469,1058,-
chr1,169132793,1.4669216030540664,1377,959,2336,-
chr1,169132794,1.7343749999999998,1049,799,1848,-
chr1,169132813,1.7074744076900006,843,556,1399,-
chr1,169464181,3.8150172539151344,626,443,1069,-
chr1,171670624,1.0721732157177224,2291,1478,3769,-
chr1,171670625,0.8971082360809102,3317,2386,5703,-
chr1,171670636,0.9133027456809206,2684,2069,4753,-
chr1,171670637,0.8464615384615385,1833,1624,3457,-
chr1,171670638,0.6635337027425124,2364,1613,3977,-
chr1,171670639,0.7752109206723937,4536,3515,8051,-
chr1,171670640,0.8358320839580209,2006,1448,3454,-
chr1,171670641,0.9361455521788465,2377,1762,4139,-
chr1,171684293,0.605651162586716,3836,2684,6520,-
chr1,171684296,1.3284477311912133,2616,2289,4905,-
chr1,171684298,1.5816384794911797,4990,3875,8865,-
chr1,171684299,1.73322266913533,2482,2042,4524,-
chr1,171684301,1.4739477533962926,3571,2886,6457,-
chr1,171684302,1.6205076590140173,3140,2298,5438,-
chr1,171684303,1.724679785330948,2151,1624,3775,-
chr1,171684311,0.7342650103519669,691,419,1110,-
chr1,171684377,0.5155418378794258,1146,743,1889,-
chr1,173864031,1.332501367378165,4449,3358,7807,-
chr1,173864058,1.3514717162032597,3733,2979,6712,-
chr1,173864217,1.0211065608704784,45091,30946,76037,-
chr1,173864218,1.0211065608704784,45091,30946,76037,-
chr1,173864270,1.31401320406556,4356,3662,8018,-
chr1,173864271,1.3317954523114193,4137,3137,7274,-
chr1,173864272,1.322471749301002,8493,6799,15292,-
chr1,173864301,1.3786068044377775,4310,3337,7647,-
chr1,173864302,1.3840228698483288,1802,1541,3343,-
chr1,173864303,1.3951020612555456,3275,2267,5542,-
chr1,173864444,0.9576781738152836,11794,9047,20841,-
chr1,173864445,1.0111859951040763,12242,9420,21662,-
chr1,173864903,1.182835607015935,590,571,1161,-
chr1,173864904,0.704030042674004,933,616,1549,-
chr1,173865282,1.3988830798479088,578,525,1103,-
chr1,173865427,0.9726649388450558,47056,34647,81703,-
chr1,173865428,0.9960016601064926,14597,13724,28321,-
chr1,173865429,1.003846832336412,11477,10080,21557,-
chr1,173865531,1.2528915892241723,10774,9161,19935,-
chr1,173865533,1.2415855332784043,17192,13473,30665,-
chr1,173865683,0.5977641056422569,1284,951,2235,-
chr1,173865866,1.3507141928710693,7373,6024,13397,-
chr1,173865867,1.3044049648263354,14362,11722,26084,-
chr1,173865869,1.2555041428735252,6989,5698,12687,-
chr1,173865876,1.6539100684261976,2602,2045,4647,-
chr1,173865884,1.429842660937511,2601,1773,4374,-
chr1,173865888,1.4389102772983824,4207,2792,6999,-
chr1,173865889,1.0695558192885688,3331,2817,6148,-
chr1,173865890,1.2841414569117275,10877,7953,18830,-
chr1,173865891,0.7097728526299955,2234,1627,3861,-
chr1,173865892,1.5058123964999919,3689,2396,6085,-
chr1,173866024,0.8828426188459063,80029,67238,147267,-
chr1,173866026,0.9233738946608656,110634,92594,203228,-
chr1,173866027,0.9951498180835898,41851,35141,76992,-
chr1,173866028,0.7913718606535242,14963,12879,27842,-
chr1,173866188,1.3221549199727223,2059,1541,3600,-
chr1,173866199,0.32128383854757664,990,795,1785,-
chr1,173866711,0.9735439581985956,7520,4395,11915,-
chr1,173866712,0.961081672361966,10141,6376,16517,-
chr1,173866713,0.9477831196581196,1811,1403,3214,-
chr1,173867000,2.5783506780195524,1618,1509,3127,-
chr1,173867005,2.0128636363636363,1526,1374,2900,-
chr1,173867007,0.8237018821526528,2902,2133,5035,-
chr1,173867012,1.9943057137301743,1176,972,2148,-
chr1,173867015,1.4990531246885277,1315,888,2203,-
chr1,173867037,0.34675727036552034,755,645,1400,-
chr1,173867042,1.2106932420341427,836,534,1370,-
chr1,175018549,2.813584277647899,898,657,1555,-
chr1,175018550,3.0342815463165573,639,456,1095,-
chr1,175023424,1.0156602457080728,1038,669,1707,-
chr1,180288348,0.4696819085487077,674,502,1176,-
chr1,180288404,3.203361244019139,637,463,1100,-
chr1,180314718,1.9125061531621996,610,460,1070,-
chr1,180495507,1.860265486725664,636,451,1087,-
chr1,180502203,1.7413640319317962,6486,4252,10738,-
chr1,180502204,1.873308396435849,3079,2327,5406,-
chr1,180502208,1.764155090557412,2743,1935,4678,-
chr1,180502210,2.0270244045191275,7101,4552,11653,-
chr1,180502211,1.7242460427117239,6504,4082,10586,-
chr1,180502212,1.9968142800106468,5053,3263,8316,-
chr1,180502213,2.034159951117721,4833,2990,7823,-
chr1,180502215,1.8419119342196264,3328,1924,5252,-
chr1,180502217,1.7845078946181767,3192,1826,5018,-
chr1,180502256,2.0142857142857142,657,349,1006,-
chr1,180502322,0.4900937356743278,1742,1058,2800,-
chr1,180502324,0.5189542336889227,2017,1222,3239,-
chr1,180975601,17.737916888487465,1040,1039,2079,-
chr1,180975602,17.737916888487465,1040,1039,2079,-
chr1,182383700,2.5926587914470187,796,589,1385,-
chr1,183626395,1.6727471002280163,1435,916,2351,-
chr1,183626417,1.4488700266800005,2361,1657,4018,-
chr1,183626454,1.9833439287984749,820,604,1424,-
chr1,183626631,1.629847749707211,1187,694,1881,-
chr1,183626741,1.511967997901502,1047,662,1709,-
chr1,183626748,2.1550865343420527,3468,2458,5926,-
chr1,183626749,2.254387327224724,1527,1095,2622,-
chr1,183627011,2.0673854447439357,766,582,1348,-
chr1,183627012,1.5592506034251559,968,606,1574,-
chr1,183627106,2.27027027027027,767,591,1358,-
chr1,183627435,2.1483491632745357,949,669,1618,-
chr1,183627517,1.7735334242837657,974,732,1706,-
chr1,183627545,2.005979615799877,2496,1845,4341,-
chr1,183627546,2.2243249857247736,1603,1195,2798,-
chr1,183630578,0.747886407977455,1609,1317,2926,-
chr1,183630580,1.4158324576443042,1258,860,2118,-
chr1,183630595,0.6202965561224489,1003,895,1898,-
chr1,183630598,1.0970682349522844,1580,1382,2962,-
chr1,183630605,1.690780437044745,828,774,1602,-
chr1,183630618,1.7716446124763705,780,574,1354,-
chr1,183630628,1.729787998562702,663,483,1146,-
chr1,183633098,1.5761555392516509,650,469,1119,-
chr1,183633109,1.8057223595902507,638,446,1084,-
chr1,183633118,1.9395020169303288,923,819,1742,-
chr1,183633133,2.8270753428269555,720,630,1350,-
chr1,183633148,1.2392442496913711,781,579,1360,-
chr1,183633151,1.7784148609342156,617,484,1101,-
chr1,183635595,1.0397790055248617,940,904,1844,-
chr1,183635597,1.0397790055248617,940,904,1844,-
chr1,183635649,2.425307950727883,636,469,1105,-
chr1,183635651,1.7633082706766918,532,531,1063,-
chr1,183635658,2.2879923318381272,1550,1420,2970,-
chr1,183635690,2.417484453071641,1461,842,2303,-
chr1,183635691,2.417484453071641,1461,842,2303,-
chr1,183635693,0.2598314606741573,924,622,1546,-
chr1,183635694,1.7204030226700249,682,396,1078,-
chr1,183635714,6.2755613267537935,4321,2807,7128,-
chr1,183635715,6.013546079361381,3958,2553,6511,-
chr1,183635753,1.0715679427897737,1566,941,2507,-
chr1,183635754,1.2852171023466394,2779,1640,4419,-
chr1,183635755,1.7922782874617738,787,479,1266,-
chr1,183635802,1.2442264834791377,2408,2002,4410,-
chr1,183635803,1.4602079861753996,1614,981,2595,-
chr1,183635805,2.319767441860465,944,386,1330,-
chr1,184710469,2.028938438051307,1553,1254,2807,-
chr1,184710470,1.9725801282051283,1482,1299,2781,-
chr1,184710472,1.88595871040724,969,831,1800,-
chr1,185227384,1.6166984963821716,2731,2302,5033,-
chr1,185227389,0.6998724147193125,7579,3263,10842,-
chr1,185227390,0.7082027579701446,10511,4781,15292,-
chr1,185227395,0.650792313851963,7905,4038,11943,-
chr1,185227397,0.5647228844561132,9906,5097,15003,-
chr1,185227398,0.563638756082152,8845,4798,13643,-
chr1,185227399,0.5903818897392863,18926,11936,30862,-
chr1,185227400,0.5938014002451332,20639,13915,34554,-
chr1,185227401,0.5827509801738595,20522,14430,34952,-
chr1,185227402,0.5981547324196339,18070,13416,31486,-
chr1,185227403,0.5444562967682985,15637,12330,27967,-
chr1,185227404,0.5250738880198855,13683,11490,25173,-
chr1,185227405,0.5069709772763579,10704,9272,19976,-
chr1,185227406,0.4796105374230342,7235,6467,13702,-
chr1,185227413,0.26990970470999753,552,646,1198,-
chr1,185227419,1.015619082615038,904,1146,2050,-
chr1,185227420,1.015619082615038,904,1146,2050,-
chr1,185297946,20.19700700383636,3367,2846,6213,-
chr1,185297947,22.719632277764056,3816,3383,7199,-
chr1,185298070,2.5689935064935066,632,439,1071,-
chr1,185298086,1.59865282065675,711,508,1219,-
chr1,185298109,2.0129623141984885,980,688,1668,-
chr1,185298111,2.0129623141984885,980,688,1668,-
chr1,185300102,2.714262132717068,608,465,1073,-
chr1,185300541,1.8888888888888888,679,485,1164,-
chr1,185300546,1.3552680760124391,1228,941,2169,-
chr1,185300551,2.4382591093117414,583,493,1076,-
chr1,185301483,1.096126255380201,1145,662,1807,-
chr1,185301485,1.096126255380201,1145,662,1807,-
chr1,185305632,1.3079871328659403,772,512,1284,-
chr1,185307072,1.670147690951174,1236,843,2079,-
chr1,185307077,1.7119188144305246,2340,1675,4015,-
chr1,185307085,1.9098641231826037,1750,1248,2998,-
chr1,185307087,1.9098641231826037,1750,1248,2998,-
chr1,185307121,1.8254686489980605,705,441,1146,-
chr1,185308828,1.2543166417187892,1933,1434,3367,-
chr1,185309049,0.6041905806458617,1441,1007,2448,-
chr1,186313994,10.140131573112741,1393,1165,2558,-
chr1,186313995,13.160590992107473,808,664,1472,-
chr1,186314707,3.073329329177345,621,455,1076,-
chr1,186317521,2.236722574384711,621,399,1020,-
chr1,186317598,1.318181818181818,618,618,1236,-
chr1,186327640,1.918912766344928,2006,1614,3620,-
chr1,186327641,1.918912766344928,2006,1614,3620,-
chr1,186327642,1.8311061661754495,3859,2834,6693,-
chr1,186327643,1.8590078328981727,1245,765,2010,-
chr1,186327644,1.9962765957446806,1250,959,2209,-
chr1,186327645,0.5487685132149579,1314,1110,2424,-
chr1,186327646,0.5487685132149579,1314,1110,2424,-
chr1,186327657,0.8596686731397605,1472,1157,2629,-
chr1,186327658,0.4197513812154696,1012,904,1916,-
chr1,186335364,2.1212282429895795,930,675,1605,-
chr1,186341036,1.6124846278818192,648,484,1132,-
chr1,186344069,0.5124757595345829,990,454,1444,-
chr1,186344573,3.2149071577402712,602,419,1021,-
chr1,186347449,1.8914333175130515,838,601,1439,-
chr1,186347450,2.2574163417098685,1180,921,2101,-
chr1,186350235,1.902654867256637,579,451,1030,-
chr1,186350236,1.902654867256637,579,451,1030,-
chr1,186357541,0.954728370221328,656,425,1081,-
chr1,186357542,0.7899004987916306,903,632,1535,-
chr1,186362866,2.125077399380805,623,379,1002,-
chr1,186362870,1.936410916311647,1838,1160,2998,-
chr1,186362872,2.2030186445693998,1860,1198,3058,-
chr1,186362873,2.1272287530232297,1219,772,1991,-
chr1,186374970,3.4131678828815613,818,555,1373,-
chr1,186674509,2.3631904693249433,917,708,1625,-
chr1,186674510,2.1606962153410243,627,548,1175,-
chr1,193014554,1.1401384083044983,658,458,1116,-
chr1,193014555,1.615014916807485,1024,804,1828,-
chr1,193014558,2.085665529010239,678,585,1263,-
chr1,193014560,2.3331366082277385,973,822,1795,-
chr1,193014562,1.6218872560190924,893,701,1594,-
chr1,193015993,1.5231388329979882,756,496,1252,-
chr1,193016387,1.1101045296167251,707,573,1280,-
chr1,193016388,1.6249759208791754,1192,962,2154,-
chr1,193029303,2.277777777777778,655,479,1134,-
chr1,193029448,1.9244685999129938,1279,830,2109,-
chr1,193029545,3.9540297339593113,696,425,1121,-
chr1,193029546,1.6266047527997811,793,522,1315,-
chr1,193051791,1.7780675383701616,1031,813,1844,-
chr1,193051792,2.4355027455216494,711,528,1239,-
chr1,193096717,1.5446684939607205,608,434,1042,-
chr1,197096128,2.1091943250553356,3793,3018,6811,-
chr1,197096132,1.6628168524732676,2501,1974,4475,-
chr1,197096145,2.129142792944613,1306,988,2294,-
chr1,197096147,1.5986106916339475,1473,945,2418,-
chr1,197096151,1.5170580416482056,1283,776,2059,-
chr1,197100449,1.927154653720071,1428,830,2258,-
chr1,197100451,1.9164501600663415,2367,1500,3867,-
chr1,197100453,1.8356056115392212,928,722,1650,-
chr1,197100583,4.493933854080106,844,546,1390,-
chr1,197100584,4.493933854080106,844,546,1390,-
chr1,197101441,2.7915057915057915,722,517,1239,-
chr1,197101442,2.4592976630676313,1415,952,2367,-
chr1,200406811,3.5350613083318025,829,767,1596,-
chr1,200406812,3.926621160409557,589,585,1174,-
chr1,200406815,1.597841051263105,895,683,1578,-
chr1,200603889,1.319863102397349,762,408,1170,-
chr1,200618443,2.0517205093128488,708,558,1266,-
chr1,200618444,1.8084458553452452,1246,882,2128,-
chr1,200618456,3.4944264731596433,673,402,1075,-
chr1,200644412,2.5706907533650987,595,421,1016,-
chr1,200648502,1.506785293737353,5241,3584,8825,-
chr1,200648506,1.7241707085232394,1946,1382,3328,-
chr1,200648508,2.0292857142857144,946,671,1617,-
chr1,200648544,1.5316081871345026,1068,683,1751,-
chr1,200648551,0.5019736842105262,762,379,1141,-
chr1,200648566,3.2551724137931037,1061,521,1582,-
chr1,200649146,1.177104389492388,780,512,1292,-
chr1,201134894,0.442684766214178,586,467,1053,-
chr1,201134976,2.547623258982017,767,592,1359,-
chr1,201135300,0.3247058823529411,689,424,1113,-
chr1,201135311,0.6011614401858305,646,491,1137,-
chr1,201135327,3.0039113428943938,671,412,1083,-
chr1,201135405,4.046020336503576,2785,2233,5018,-
chr1,201135406,4.118870963417137,2502,1932,4434,-
chr1,201135424,57.899043748233815,1641,1021,2662,-
chr1,201135556,0.5349119611414693,880,548,1428,-
chr1,201135661,1.0094725763068648,663,502,1165,-
chr1,201135663,1.0094725763068648,663,502,1165,-
chr1,201143855,1.9698234349919745,707,444,1151,-
chr1,201143940,1.4391259448697376,654,501,1155,-
chr1,201151781,1.7549586776859507,684,549,1233,-
chr1,201151809,0.5729719555806513,981,758,1739,-
chr1,201151810,0.3901829671540892,589,438,1027,-
chr1,201151844,1.5303156146179404,736,601,1337,-
chr1,201153929,2.157821506658716,1103,773,1876,-
chr1,201153930,2.157821506658716,1103,773,1876,-
chr1,201154467,4.868502297878956,763,745,1508,-
chr1,201154469,0.912516055373198,1250,881,2131,-
chr1,201154470,1.47148243003987,4370,3374,7744,-
chr1,201154471,1.3422738802290568,3629,2870,6499,-
chr1,201154472,1.4272364921658884,4197,3201,7398,-
chr1,201483619,0.5284953395472703,755,750,1505,-
chr1,201483622,2.108489141015743,1082,960,2042,-
chr1,201483650,7.08228824347444,4127,2834,6961,-
chr1,201483651,6.643666424801452,6009,4625,10634,-
chr1,201483661,4.019754398019948,9486,6453,15939,-
chr1,201483662,4.019754398019948,9486,6453,15939,-
chr1,201483663,3.0917766160484605,3020,1853,4873,-
chr1,201483721,1.5287298021882472,958,745,1703,-
chr1,201483769,1.515002718727826,8159,5233,13392,-
chr1,201483770,1.476142599093419,5973,3847,9820,-
chr1,201483782,0.546363206591477,1617,1138,2755,-
chr1,201483858,1.4452808159280182,2797,2136,4933,-
chr1,201484016,1.3417829594300184,1822,1257,3079,-
chr1,201484028,0.7483991690266244,2187,1642,3829,-
chr1,201484074,1.5840297993551817,1744,1388,3132,-
chr1,201484075,1.496842105263158,1421,873,2294,-
chr1,201484077,1.0696948638105301,2659,2142,4801,-
chr1,201484270,0.66958545339802,1060,938,1998,-
chr1,201484281,2.386498582557646,2148,1643,3791,-
chr1,201484282,2.4520586820397603,7548,6136,13684,-
chr1,201484283,2.2096790098314414,4104,3191,7295,-
chr1,201484291,3.1997125627256606,4284,3615,7899,-
chr1,201484292,3.047331810193467,7712,5894,13606,-
chr1,201484293,2.921180510365824,9412,6998,16410,-
chr1,201484294,3.985806168523342,8960,6495,15455,-
chr1,201484306,0.5265993265993266,735,527,1262,-
chr1,201484307,1.7019092299442082,1883,1145,3028,-
chr1,201484312,0.5173436492585428,1002,563,1565,-
chr1,201484313,1.7433409973260392,1927,1281,3208,-
chr1,201484316,2.0443349753694577,912,538,1450,-
chr1,201484429,2.3717728055077454,1377,1161,2538,-
chr1,201484532,1.4995409364895609,1365,1065,2430,-
chr1,201485296,0.6985055230669266,1449,1025,2474,-
chr1,201488876,1.9491392801251954,1165,780,1945,-
chr1,201488885,1.779105282069709,1164,758,1922,-
chr1,201488930,1.5992579250898231,2753,1936,4689,-
chr1,201488942,0.6879950928846827,1060,633,1693,-
chr1,201490262,1.4824473420260782,1477,996,2473,-
chr1,201490263,0.6610430881390783,942,822,1764,-
chr1,201490320,1.3615595491928114,1787,1406,3193,-
chr1,201490331,1.4645226326742975,1552,991,2543,-
chr1,201496251,1.6046511627906976,1235,823,2058,-
chr1,201496263,1.9272324915386616,845,667,1512,-
chr1,201496278,1.696088308730124,967,616,1583,-
chr1,201496279,0.6262042389210019,649,518,1167,-
chr1,201496281,1.06387897284373,1727,1267,2994,-
chr1,201496292,1.6045340050377832,636,396,1032,-
chr1,201496304,0.5041445913421484,674,547,1221,-
chr1,201507110,1.7363984267327095,977,711,1688,-
chr1,202134005,1.9935926773455377,1209,574,1783,-
chr1,202134006,1.9720017636684306,1788,839,2627,-
chr1,202134008,2.034188034188034,1175,545,1720,-
chr1,202134013,1.9559034572733205,936,510,1446,-
chr1,202134014,1.461174637951689,1438,752,2190,-
chr1,202331782,1.3679127984084882,942,831,1773,-
chr1,202331892,0.9896886369483742,2929,2332,5261,-
chr1,202331939,2.1078883536606194,1233,886,2119,-
chr1,202333073,1.6819987187700192,1093,891,1984,-
chr1,202333075,1.5073446327683615,1333,869,2202,-
chr1,202333272,1.4392772096932342,821,648,1469,-
chr1,202333463,1.7335031538088308,1382,915,2297,-
chr1,202335017,1.5952875952875956,1150,924,2074,-
chr1,202335028,2.0648723257418906,815,620,1435,-
chr1,202335057,0.7704554398769274,1179,846,2025,-
chr1,202335665,1.3509232954545454,826,639,1465,-
chr1,202335674,1.8544785751161592,926,595,1521,-
chr1,202335677,0.6303860901256596,614,496,1110,-
chr1,202335749,2.1597426470588235,757,543,1300,-
chr1,202335756,0.48369565217391297,711,511,1222,-
chr1,202335764,1.7298174442190668,655,492,1147,-
chr1,202335770,2.003235037949484,643,422,1065,-
chr1,202335799,0.36354679802955664,983,579,1562,-
chr1,202335801,0.36354679802955664,983,579,1562,-
chr1,202472052,4.244000441202645,627,391,1018,-
chr1,202767211,2.6824524940617582,1267,841,2108,-
chr1,202767212,2.6824524940617582,1267,841,2108,-
chr1,202767256,2.552843708016122,876,405,1281,-
chr1,202767258,2.7841260184159458,1346,670,2016,-
chr1,202767354,0.9799070605424764,865,453,1318,-
chr1,202767356,0.9799070605424764,865,453,1318,-
chr1,202940985,3.193405511811024,720,507,1227,-
chr1,202941101,1.7302377341299933,1774,1250,3024,-
chr1,202941342,2.6126299298869267,1431,1039,2470,-
chr1,202941474,1.8066148563166453,713,502,1215,-
chr1,202941642,1.8832056892778997,764,456,1220,-
chr1,202941687,2.1618773946360155,731,463,1194,-
chr1,202942076,1.0122679888126112,974,827,1801,-
chr1,202942077,0.8730910729926796,1595,1239,2834,-
chr1,202942214,3.4728775230528424,832,500,1332,-
chr1,202943849,1.0486131535227854,1077,850,1927,-
chr1,202945138,1.5715971023355662,1563,1105,2668,-
chr1,202946452,1.1768603396927624,1349,956,2305,-
chr1,202946587,5.062555085829396,2174,1612,3786,-
chr1,202948381,2.636500754147813,1517,662,2179,-
chr1,202948385,1.6623953183331652,1372,582,1954,-
chr1,202948388,0.5402298850574713,1127,521,1648,-
chr1,202948396,1.7251150076671775,1149,565,1714,-
chr1,202948405,1.0943482216732743,1878,920,2798,-
chr1,202948409,0.9361009419898281,1602,876,2478,-
chr1,202950968,3.0784663006772055,989,638,1627,-
chr1,202951018,0.5463741138824395,1088,793,1881,-
chr1,202951033,1.6304347826086956,649,459,1108,-
chr1,202951086,3.0717517776341303,575,441,1016,-
chr1,202951088,3.0717517776341303,575,441,1016,-
chr1,202951098,1.120235350295448,710,486,1196,-
chr1,202958311,0.8123812536945736,601,437,1038,-
chr1,204403530,2.58850261304249,711,488,1199,-
chr1,204403531,1.4739928607853134,860,741,1601,-
chr1,204403639,2.3529411764705883,767,575,1342,-
chr1,204403651,0.54642499722006,701,528,1229,-
chr1,204404006,2.0568898430162355,1094,770,1864,-
chr1,204404245,1.5363060303931741,3651,2410,6061,-
chr1,204404247,1.2899622691742036,3196,2067,5263,-
chr1,204404251,0.6859037213428585,1468,967,2435,-
chr1,204404253,0.6859037213428585,1468,967,2435,-
chr1,204404307,0.6555678364189002,729,516,1245,-
chr1,204404367,0.5194547442155034,699,618,1317,-
chr1,204404712,2.2735091743119265,609,435,1044,-
chr1,204404818,1.978161170561258,646,481,1127,-
chr1,204405068,1.8966763642775282,693,596,1289,-
chr1,204405180,2.1978056426332286,778,579,1357,-
chr1,204405280,0.6335453100158983,796,628,1424,-
chr1,204405437,1.93338618794356,1175,885,2060,-
chr1,204405486,1.3260130718954248,2535,1699,4234,-
chr1,204405583,0.8551863200012348,5795,4052,9847,-
chr1,204405584,0.7080123329907503,4991,3499,8490,-
chr1,204409563,1.6266943866943868,630,480,1110,-
chr1,204409634,2.074743213695107,1428,933,2361,-
chr1,204409857,2.751408987052552,668,504,1172,-
chr1,204409950,1.6580787138008306,2481,1870,4351,-
chr1,204409959,2.4223826714801437,670,553,1223,-
chr1,204410007,1.6262626262626259,919,549,1468,-
chr1,204410088,1.7498011928429424,606,502,1108,-
chr1,204410244,2.768986568986569,781,545,1326,-
chr1,204410249,1.8850907800579568,624,456,1080,-
chr1,204410556,2.1213125621478293,639,430,1069,-
chr1,204410653,1.8335719057161943,738,498,1236,-
chr1,204410682,1.7095873409866582,869,585,1454,-
chr1,204410767,1.897942197471488,1424,1028,2452,-
chr1,204410772,0.6827859836580766,1336,1031,2367,-
chr1,204410822,0.5556818181818182,814,499,1313,-
chr1,204410942,1.4484118291347206,1063,769,1832,-
chr1,204410962,0.5581074873679375,809,621,1430,-
chr1,204411048,1.9564530313088306,904,542,1446,-
chr1,204411219,1.717948717948718,803,584,1387,-
chr1,204411341,0.9044075283272518,896,507,1403,-
chr1,204411342,0.9044075283272518,896,507,1403,-
chr1,204411419,1.6809423347398031,582,473,1055,-
chr1,204411637,1.4669604342643778,982,682,1664,-
chr1,205096815,2.199975877454124,594,645,1239,-
chr1,205101627,1.0825244384623427,908,655,1563,-
chr1,205713352,2.8964019851116625,608,402,1010,-
chr1,205713777,1.9116337481447652,597,460,1057,-
chr1,205713895,1.7844444444444445,802,599,1401,-
chr1,205714241,4.160201735992367,2623,3197,5820,-
chr1,205714242,4.160201735992367,2623,3197,5820,-
chr1,205714288,16.178221512917084,3416,2240,5656,-
chr1,205714289,16.5057597718693,3632,2325,5957,-
chr1,205714290,14.03015569615842,3566,2099,5665,-
chr1,205714292,10.527477179284606,3031,1130,4161,-
chr1,205714293,20.611789064226343,2722,952,3674,-
chr1,205714294,18.86806399553644,3381,1171,4552,-
chr1,205714295,16.43799321870057,1012,340,1352,-
chr1,205714303,2.9460591133004934,885,279,1164,-
chr1,205714305,2.8027577016534138,1118,359,1477,-
chr1,205714310,2.3220973782771543,867,266,1133,-
chr1,205714311,2.4636106771969057,1081,336,1417,-
chr1,205714387,0.3971614829363699,737,511,1248,-
chr1,205714601,0.6730018028846153,866,623,1489,-
chr1,205714828,2.109223971278652,610,425,1035,-
chr1,205714933,2.516730401529637,701,522,1223,-
chr1,205715051,2.132448607858444,744,548,1292,-
chr1,205715324,1.978576669458253,1256,882,2138,-
chr1,205715471,1.8382113821138213,968,737,1705,-
chr1,205715472,1.8382113821138213,968,737,1705,-
chr1,205715553,1.6462189697230594,3529,2759,6288,-
chr1,205715554,1.475440925858477,6904,5152,12056,-
chr1,205715556,1.8382312762542263,3337,2491,5828,-
chr1,205715560,1.6391304347826086,1507,1034,2541,-
chr1,205715583,2.723619464188081,1106,707,1813,-
chr1,205715606,3.7244027936322666,1563,1019,2582,-
chr1,205715642,1.7312995013200352,907,486,1393,-
chr1,205715923,2.0749922528664397,647,460,1107,-
chr1,205715936,2.653065079438455,953,646,1599,-
chr1,205716190,2.009057059474691,712,522,1234,-
chr1,205716673,1.476470588235294,752,509,1261,-
chr1,205716682,0.5310077519379844,684,429,1113,-
chr1,205716705,4.39920634920635,722,419,1141,-
chr1,205716881,1.786354107108824,720,476,1196,-
chr1,205716964,2.5375647668393784,652,385,1037,-
chr1,205716983,1.2521241476428937,1005,689,1694,-
chr1,205717365,2.3228534402694425,980,698,1678,-
chr1,205717375,1.4860628714204043,1115,826,1941,-
chr1,205717621,31.586688118487995,2751,3237,5988,-
chr1,205717622,40.023315949168015,5261,4894,10155,-
chr1,205717623,40.728914746332265,6179,5005,11184,-
chr1,205717624,57.60638425160493,3659,1987,5646,-
chr1,205717625,52.84435406754838,3387,705,4092,-
chr1,205717627,6.167211753580688,4183,530,4713,-
chr1,205717628,6.681493052024731,5793,798,6591,-
chr1,205717629,7.504792121694741,6965,944,7909,-
chr1,205717630,7.363574491973001,5789,793,6582,-
chr1,205717631,9.764235957899164,4882,643,5525,-
chr1,205717633,14.39578947368421,1051,94,1145,-
chr1,205718054,1.722004357298475,759,458,1217,-
chr1,205718079,0.37266195523767487,670,444,1114,-
chr1,205718080,1.076398868851699,748,582,1330,-
chr1,205718082,0.8354105571847508,1112,867,1979,-
chr1,205718083,1.0621238517579978,724,573,1297,-
chr1,205718205,1.7407069970845477,931,685,1616,-
chr1,205718228,1.9161635582981518,1257,903,2160,-
chr1,205719675,1.2929048172925999,1097,810,1907,-
chr1,205720537,2.3511777301927195,548,466,1014,-
chr1,205720590,1.793268247483692,2083,1887,3970,-
chr1,205720591,1.9383638549667623,1444,1306,2750,-
chr1,205723941,1.623343129066448,3690,3419,7109,-
chr1,205723942,1.7333357023139018,2151,2312,4463,-
chr1,205723945,1.97265625,1009,1023,2032,-
chr1,205723948,2.1679606879606883,1934,1849,3783,-
chr1,205723949,2.1679606879606883,1934,1849,3783,-
chr1,205727769,2.1104104104104104,726,554,1280,-
chr1,205727800,1.9112125298205584,995,621,1616,-
chr1,205729619,0.3336538461538462,693,623,1316,-
chr1,205729620,0.4114223294639363,1441,1495,2936,-
chr1,205729621,0.43750555772326494,1700,1645,3345,-
chr1,205749972,0.5861467602736664,1807,2353,4160,-
chr1,205749974,0.6078730303666459,3369,4521,7890,-
chr1,205749975,0.6007889788242989,2430,3321,5751,-
chr1,205749976,0.5562437059571201,3635,4667,8302,-
chr1,205749979,1.6926136363636364,661,799,1460,-
chr1,205749984,0.550661762394291,603,921,1524,-
chr1,205749988,1.8308626540453652,602,508,1110,-
chr1,205749993,0.3714454976303317,494,843,1337,-
chr1,205749998,0.4422419747953104,1680,2879,4559,-
chr1,205749999,0.4195961106955871,1223,2291,3514,-
chr1,205750000,0.4195961106955871,1223,2291,3514,-
chr1,205750001,0.42256892355902265,1038,1514,2552,-
chr1,205750002,0.42256892355902265,1038,1514,2552,-
chr1,205750003,0.4166577212204343,1377,2203,3580,-
chr1,205750008,0.3433649289099526,566,1265,1831,-
chr1,205750009,0.44527002537151134,545,711,1256,-
chr1,205750010,0.38655214808290067,1961,3726,5687,-
chr1,205750011,0.4333394053436189,1279,2088,3367,-
chr1,205750012,0.39290509087699776,1282,2725,4007,-
chr1,205750013,0.4144214031450477,626,702,1328,-
chr1,205750014,0.3860131317758436,473,1061,1534,-
chr1,205750015,1.2281423218403462,875,1398,2273,-
chr1,205750017,5.910525325327143,1664,2851,4515,-
chr1,205750018,7.638928033840658,1562,2533,4095,-
chr1,205750019,9.99584336123348,1277,2097,3374,-
chr1,205750020,21.579508726567553,745,883,1628,-
chr1,205750021,28.64928716904277,555,490,1045,-
chr1,205768295,2.745800395256917,1169,1011,2180,-
chr1,205768302,1.724508212863983,2105,1562,3667,-
chr1,205768331,1.2842260237801857,749,552,1301,-
chr1,205768340,1.740623219552907,1059,720,1779,-
chr1,206591740,2.1174374927320865,861,659,1520,-
chr1,206595827,0.5880184331797236,637,524,1161,-
chr1,206599084,3.549780540882711,592,494,1086,-
chr1,206603060,2.169390927740066,937,653,1590,-
chr1,206605419,0.9888693614528411,843,568,1411,-
chr1,206605420,0.9888693614528411,843,568,1411,-
chr1,206605466,0.8654147775525252,856,634,1490,-
chr1,206611209,3.3211125158027803,709,564,1273,-
chr1,206611211,3.3211125158027803,709,564,1273,-
chr1,206611320,2.621712803364589,925,643,1568,-
chr1,206611325,2.487560934640136,769,530,1299,-
chr1,206611371,2.817140935193702,750,544,1294,-
chr1,206612388,2.5614454790899055,705,478,1183,-
chr1,206696168,0.7590124591503269,958,767,1725,-
chr1,206696189,0.6369603371893493,1374,1086,2460,-
chr1,206696190,0.7127001161974769,2826,2304,5130,-
chr1,206696192,1.007710843373494,968,829,1797,-
chr1,210265908,1.4328167132895056,720,471,1191,-
chr1,211663465,2.6923494009897224,940,553,1493,-
chr1,211663467,2.738095238095238,689,359,1048,-
chr1,211663521,3.067936110122226,656,457,1113,-
chr1,211669162,2.8217299578059074,534,473,1007,-
chr1,211675444,2.3866755201416554,788,501,1289,-
chr1,211675445,2.1708900800183937,1708,1324,3032,-
chr1,211675447,2.0032044498859674,2139,1787,3926,-
chr1,211675448,1.5254692460993555,804,786,1590,-
chr1,211675452,1.5843883575325806,700,592,1292,-
chr1,211675454,0.8646147223417993,617,605,1222,-
chr1,211675456,0.8700613764828862,621,522,1143,-
chr1,212365115,1.056038616725586,662,449,1111,-
chr1,212738553,0.4453009615735849,1163,818,1981,-
chr1,212738555,0.4953900709219858,761,563,1324,-
chr1,212791767,3.221036523609231,913,419,1332,-
chr1,214354368,2.5997150997151004,729,467,1196,-
chr1,214354389,2.2058921495397343,636,431,1067,-
chr1,214354402,1.7138422062147631,732,454,1186,-
chr1,219968738,0.4647577092511014,632,453,1085,-
chr1,219968800,2.3354673495518568,911,567,1478,-
chr1,219968916,2.043325119652611,1500,1139,2639,-
chr1,219968917,2.1305504244412075,1677,1130,2807,-
chr1,219972138,1.8749700023998082,600,462,1062,-
chr1,219973389,3.8625265392781323,765,627,1392,-
chr1,219973395,2.1762589928057547,725,555,1280,-
chr1,219978627,1.3843390903431017,4862,3688,8550,-
chr1,219978654,0.7525764368889717,1584,1211,2795,-
chr1,219978670,0.5758343526122663,1013,775,1788,-
chr1,219978672,2.202291616234972,1113,917,2030,-
chr1,219978710,0.498361684327942,840,651,1491,-
chr1,219980151,1.8235056542810986,773,618,1391,-
chr1,219980228,3.2656,627,499,1126,-
chr1,219980771,2.0104344613333316,1266,983,2249,-
chr1,219983268,2.00026664750301,1524,1203,2727,-
chr1,219983381,2.070712074303405,726,424,1150,-
chr1,219987154,1.600432665013861,1807,1297,3104,-
chr1,219987155,0.5438275371161277,572,446,1018,-
chr1,219988673,1.7876840140991086,957,688,1645,-
chr1,219988676,1.5569037186832941,1013,620,1633,-
chr1,219988767,1.9419020599481929,1729,1473,3202,-
chr1,219988768,1.9639814380311802,2527,2130,4657,-
chr1,219988770,1.886039886039886,1654,1376,3030,-
chr1,219988814,1.9151767151767152,657,480,1137,-
chr1,219997003,2.3823529411764706,701,441,1142,-
chr1,219997043,2.3672890216579536,586,514,1100,-
chr1,219997118,3.735294117647058,634,509,1143,-
chr1,219997281,1.5511536974176081,949,628,1577,-
chr1,219997297,1.6489805511487166,876,548,1424,-
chr1,219997330,2.1587301587301586,815,521,1336,-
chr1,220001184,2.0808427973699937,556,477,1033,-
chr1,220005355,2.438457529963523,708,504,1212,-
chr1,220006119,2.2,626,464,1090,-
chr1,220006127,1.839271255060729,825,569,1394,-
chr1,220006169,2.1096408317580337,743,528,1271,-
chr1,220007239,0.49518482694814747,784,552,1336,-
chr1,220011016,1.8316072113540467,763,473,1236,-
chr1,220011031,1.6958543983822043,598,429,1027,-
chr1,220011033,0.41016016016016016,595,443,1038,-
chr1,220019015,2.03021327014218,595,421,1016,-
chr1,220020187,2.149539649539649,578,480,1058,-
chr1,220020217,2.028811524609844,675,475,1150,-
chr1,220022489,0.44354345165238684,668,515,1183,-
chr1,220022508,1.847333004462287,1943,1296,3239,-
chr1,220025213,1.1531634225763192,1185,1051,2236,-
chr1,220025236,2.2180451127819545,589,531,1120,-
chr1,220030407,1.9509032759961964,609,502,1111,-
chr1,220030472,0.64012641451728,896,576,1472,-
chr1,220030479,0.7847773592195498,2538,1784,4322,-
chr1,220032395,0.992703691386764,4627,3099,7726,-
chr1,220032397,0.9260326377525627,7824,5527,13351,-
chr1,220032399,0.8344592047965023,3197,2428,5625,-
chr1,220032400,1.4287197437114383,2027,1375,3402,-
chr1,220032410,1.140370917188625,3332,2171,5503,-
chr1,220032411,0.9809782608695652,2241,1356,3597,-
chr1,220032417,1.6709237298219173,1811,1326,3137,-
chr1,220032418,1.6709237298219173,1811,1326,3137,-
chr1,220032509,0.672645739910314,824,668,1492,-
chr1,220032510,1.7375639237563922,649,477,1126,-
chr1,220032524,0.348111658456486,635,521,1156,-
chr1,220034958,2.0075665859564165,602,412,1014,-
chr1,220034999,1.8089668615984411,639,539,1178,-
chr1,220046439,1.8685814346598817,724,565,1289,-
chr1,220057854,3.102448568208065,610,511,1121,-
chr1,220057916,3.8864820728175737,800,528,1328,-
chr1,220057923,1.5060511856753382,1632,1247,2879,-
chr1,220057924,1.7897727272727273,719,511,1230,-
chr1,220057925,0.9130498033016491,892,595,1487,-
chr1,220058502,1.6613922384823279,709,533,1242,-
chr1,220059732,0.4521232833364978,892,686,1578,-
chr1,220059733,0.4521232833364978,892,686,1578,-
chr1,220059789,0.3349081473497788,668,469,1137,-
chr1,220167337,2.765082391393164,1127,1048,2175,-
chr1,220167374,0.6049280177187153,689,503,1192,-
chr1,220167380,2.008964257165696,1134,833,1967,-
chr1,220167381,2.008964257165696,1134,833,1967,-
chr1,222584163,1.9925673148840688,774,763,1537,-
chr1,222584164,1.9925673148840688,774,763,1537,-
chr1,224388116,0.29746618533263364,1013,1593,2606,-
chr1,224388118,0.25333855316758525,543,767,1310,-
chr1,224388124,9.923696057858786,864,1365,2229,-
chr1,224388125,10.674601192841626,784,1215,1999,-
chr1,224401048,1.9776839185526067,681,546,1227,-
chr1,224401049,1.4909206146667608,1451,1075,2526,-
chr1,224401051,1.5669230823719145,1254,904,2158,-
chr1,224401053,1.5060458985732037,810,605,1415,-
chr1,224401057,0.4313891182451616,755,551,1306,-
chr1,225402372,1.536087605774017,3085,2008,5093,-
chr1,225402437,3.017543859649123,895,607,1502,-
chr1,225402455,0.3554022988505747,1545,999,2544,-
chr1,225402456,1.4890564181859434,3484,2281,5765,-
chr1,225402464,1.8587368421052632,980,499,1479,-
chr1,225402471,1.7246919146748363,2643,1433,4076,-
chr1,225402488,1.852374839537869,1442,778,2220,-
chr1,225403321,0.9621012651730951,695,562,1257,-
chr1,225410409,0.7891556080994829,659,477,1136,-
chr1,225419409,2.6766544486433665,673,454,1127,-
chr1,225424078,1.2677163751704121,879,618,1497,-
chr1,225496325,9.699242302772637,1114,775,1889,-
chr1,225496326,10.466059185991199,899,536,1435,-
chr1,225496796,21.985067269278503,1715,1118,2833,-
chr1,225496797,21.985067269278503,1715,1118,2833,-
chr1,225920037,1.597413202586257,1659,1218,2877,-
chr1,225920066,0.3606478381947979,922,876,1798,-
chr1,225920129,12.12390516369009,2331,1893,4224,-
chr1,225920130,12.12390516369009,2331,1893,4224,-
chr1,225920131,12.642359877962173,2486,1975,4461,-
chr1,225920297,0.8458403260608965,881,775,1656,-
chr1,225920298,0.6142423250148005,1940,1636,3576,-
chr1,225920328,1.0780073800738006,540,541,1081,-
chr1,225920329,1.0780073800738006,540,541,1081,-
chr1,225920346,1.4742887376979383,1304,1038,2342,-
chr1,225922016,2.282383293004781,885,589,1474,-
chr1,225922017,2.3606297766943802,731,488,1219,-
chr1,225922036,2.225057167652807,678,467,1145,-
chr1,225922281,1.4080418788388114,613,553,1166,-
chr1,225923724,1.8317816537012308,1661,1129,2790,-
chr1,225923728,1.8494555353902,1602,1101,2703,-
chr1,225923729,1.7072502723561096,2296,1558,3854,-
chr1,225923731,1.7402019071600103,1477,985,2462,-
chr1,226164862,1.7655316999979078,1345,1222,2567,-
chr1,226164865,0.920126437827106,2249,1973,4222,-
chr1,226164867,0.5763102876504939,1141,1066,2207,-
chr1,226164897,1.2000183975535021,765,594,1359,-
chr1,226164908,2.5555898556231003,930,650,1580,-
chr1,226164909,2.383643617021277,716,469,1185,-
chr1,226361141,1.7916523334479992,624,458,1082,-
chr1,226361204,2.0647969052224373,853,563,1416,-
chr1,226361361,1.9525422953225278,4468,3383,7851,-
chr1,226361362,1.9525422953225278,4468,3383,7851,-
chr1,226361417,1.798107255520505,869,633,1502,-
chr1,226362009,0.6052575030441946,844,606,1450,-
chr1,226362049,1.7296142653705655,754,520,1274,-
chr1,226365022,2.553687230989957,1170,696,1866,-
chr1,226365024,2.3258397897782572,1717,1144,2861,-
chr1,226366031,1.6545265348595213,794,495,1289,-
chr1,226366040,1.6890547263681592,678,401,1079,-
chr1,226366042,0.6195175438596491,564,479,1043,-
chr1,226367597,0.5830251389117271,1182,863,2045,-
chr1,226368217,1.6221374045801529,899,523,1422,-
chr1,226374271,2.601674641148325,869,607,1476,-
chr1,226374311,1.7243733082264328,887,585,1472,-
chr1,226374314,2.9394997091332167,814,572,1386,-
chr1,226374327,0.639428490990991,789,591,1380,-
chr1,226374349,1.7661306947021236,744,440,1184,-
chr1,226377163,0.5843906189926951,987,662,1649,-
chr1,226377189,1.7088217635764935,1008,888,1896,-
chr1,226377249,2.104986938502644,997,699,1696,-
chr1,226379193,0.2297297297297297,560,517,1077,-
chr1,226379199,0.45235394214407265,637,515,1152,-
chr1,226379614,3.6437054631828976,648,420,1068,-
chr1,226379616,3.6437054631828976,648,420,1068,-
chr1,226379992,0.8021463202048265,774,632,1406,-
chr1,226379994,0.8021463202048265,774,632,1406,-
chr1,226380003,1.901432076148072,827,599,1426,-
chr1,226381096,0.5214610234337638,670,407,1077,-
chr1,226381097,1.473605248986193,976,721,1697,-
chr1,226381199,1.3416405944801584,1166,860,2026,-
chr1,226383053,2.6667510876488434,952,652,1604,-
chr1,226385544,1.6079065998935298,1004,872,1876,-
chr1,226385588,1.751726666101046,1298,820,2118,-
chr1,226386402,1.7428571428571429,975,615,1590,-
chr1,226388669,2.4928516228748068,758,646,1404,-
chr1,226388695,1.781194997684113,873,634,1507,-
chr1,226390568,1.0474592521572388,759,595,1354,-
chr1,226390569,1.4618155997836468,1233,945,2178,-
chr1,226402362,0.6124412876618169,593,601,1194,-
chr1,226402363,0.6124412876618169,593,601,1194,-
chr1,228106815,3.2778699121220773,636,564,1200,-
chr1,228457510,1.8835270800251473,665,530,1195,-
chr1,229495931,1.3658536585365852,818,532,1350,-
chr1,229602876,0.5686572519059134,1076,750,1826,-
chr1,231224236,2.9673573132956887,1001,784,1785,-
chr1,231224241,1.6289316702819954,800,460,1260,-
chr1,231224242,2.029152339136881,1022,842,1864,-
chr1,231224244,1.9285129604365616,797,732,1529,-
chr1,231224245,1.8310249307479225,660,360,1020,-
chr1,231224247,1.7423379595092867,1225,818,2043,-
chr1,231224248,1.6504515042601022,1730,1065,2795,-
chr1,231370575,2.336843613439358,931,516,1447,-
chr1,231370587,2.033237415985034,1792,1131,2923,-
chr1,231370590,1.5972222222222219,850,517,1367,-
chr1,231370641,2.598014234250066,923,598,1521,-
chr1,231370643,2.598014234250066,923,598,1521,-
chr1,232490904,4.630846915021688,677,379,1056,-
chr1,234357056,1.0743645973909133,720,455,1175,-
chr1,234357057,1.0743645973909133,720,455,1175,-
chr1,234604361,2.5541052631578944,673,474,1147,-
chr1,234604363,2.5541052631578944,673,474,1147,-
chr1,234604406,2.947908758023704,644,397,1041,-
chr1,234607191,2.126150751876746,835,620,1455,-
chr1,235109508,1.838345864661654,977,702,1679,-
chr1,235109544,1.5312738367658276,1094,827,1921,-
chr1,235109545,2.058319738988581,720,612,1332,-
chr1,235109867,1.6372493910436574,770,592,1362,-
chr1,235109874,0.5773678056385605,807,715,1522,-
chr1,235109875,0.5198265179677819,838,537,1375,-
chr1,235109902,1.5928030303030303,840,527,1367,-
chr1,235109903,2.602587800369686,703,540,1243,-
chr1,235110105,2.103373033912173,660,646,1306,-
chr1,235110186,0.5481306778476589,501,635,1136,-
chr1,235110218,8.566088883454956,3061,3296,6357,-
chr1,235110219,8.566088883454956,3061,3296,6357,-
chr1,235110237,2.1922839107432828,980,711,1691,-
chr1,235110271,0.18067716121954824,569,780,1349,-
chr1,235110301,13.518831470220654,3609,3288,6897,-
chr1,235110302,13.518831470220652,3609,3288,6897,-
chr1,235110303,13.518831470220652,3609,3288,6897,-
chr1,235110310,21.653641375208473,1554,844,2398,-
chr1,235110316,18.47571333776219,3480,914,4394,-
chr1,235110317,18.53160997765563,3487,893,4380,-
chr1,235110318,18.18666341369954,1884,508,2392,-
chr1,235110429,0.4949715182233007,1728,1362,3090,-
chr1,235110430,0.4872519406281464,1153,932,2085,-
chr1,235110601,2.0257907118585,749,498,1247,-
chr1,235110719,2.7453703703703702,592,413,1005,-
chr1,235110768,2.096846846846846,664,443,1107,-
chr1,235110771,1.8413216664490009,612,402,1014,-
chr1,235110790,1.6933920213951417,920,640,1560,-
chr1,235111326,2.0804626815265115,600,563,1163,-
chr1,235111366,1.6540642722117205,699,528,1227,-
chr1,235111935,2.432522123893805,732,564,1296,-
chr1,235112104,0.6957671957671957,1577,1133,2710,-
chr1,235113828,1.9381559266881794,1412,939,2351,-
chr1,235113900,1.1013062409288823,1083,847,1930,-
chr1,235113902,1.244573958786686,1565,1228,2793,-
chr1,235113903,0.9965105213069684,991,771,1762,-
chr1,235128647,1.0121446432974897,1706,1388,3094,-
chr1,235128656,3.728629579375849,686,468,1154,-
chr1,235128738,2.5142857142857142,1249,624,1873,-
chr1,235128739,2.5142857142857142,1249,624,1873,-
chr1,235128830,0.5531914893617021,584,422,1006,-
chr1,235128834,0.7737379770402915,2048,1438,3486,-
chr1,235128836,0.8719853564617979,1324,992,2316,-
chr1,235131841,4.446428571428571,663,447,1110,-
chr1,235131843,4.446428571428571,663,447,1110,-
chr1,235137906,2.8940896828840383,4123,3354,7477,-
chr1,235137908,2.3011380944711513,8340,6092,14432,-
chr1,235137910,2.3060779220779217,3967,3079,7046,-
chr1,235137915,2.0626644245142005,5281,3567,8848,-
chr1,235137916,2.0626644245142005,5281,3567,8848,-
chr1,235137917,2.0626644245142005,5281,3567,8848,-
chr1,235137921,0.6500940674777373,1671,937,2608,-
chr1,235137928,1.347702380952381,1432,874,2306,-
chr1,235138120,1.6727941176470587,909,543,1452,-
chr1,235138124,1.868421052631579,851,455,1306,-
chr1,235138144,1.9375,1177,607,1784,-
chr1,235138145,1.9375,1177,607,1784,-
chr1,235138146,2.513424109546889,1020,618,1638,-
chr1,235138149,2.43595818815331,970,573,1543,-
chr1,235160636,2.3618307426597585,546,578,1124,-
chr1,240490829,6.012862392940093,1473,1367,2840,-
chr1,240490830,6.161813515907983,1729,1652,3381,-
chr1,240490831,9.375462964982617,1063,769,1832,-
chr1,240490833,19.27407612987631,1019,628,1647,-
chr1,240491170,0.2591899850858976,469,738,1207,-
chr1,240491174,7.091503267973857,433,611,1044,-
chr1,240491175,13.519846038083486,1110,1534,2644,-
chr1,240491176,13.57027933376894,911,1198,2109,-
chr1,240491177,19.9213048855906,478,587,1065,-
chr1,240491926,1.337545777021125,615,477,1092,-
chr1,240491997,2.2043324792603607,1795,1665,3460,-
chr1,240491999,2.1417732923296366,4150,3580,7730,-
chr1,240492000,1.8982309859154929,3335,2839,6174,-
chr1,240492001,1.8982309859154929,3335,2839,6174,-
chr1,240492002,1.91273566249176,2458,2049,4507,-
chr1,240492195,0.5200447700447701,806,545,1351,-
chr1,240492197,0.5200447700447701,806,545,1351,-
chr1,241497932,1.7824711994578724,606,465,1071,-
chr1,241500466,1.742315024425116,6050,4795,10845,-
chr1,241500479,0.8381981362818621,7286,5676,12962,-
chr1,241500489,1.5322810176579926,6206,4351,10557,-
chr1,241500490,1.5322810176579926,6206,4351,10557,-
chr1,241500495,1.349327783304935,5530,3707,9237,-
chr1,241500496,1.322129473504536,7831,5351,13182,-
chr1,241500499,1.3190990465379548,10498,7029,17527,-
chr1,241500500,1.1352067620081354,23352,16883,40235,-
chr1,241500501,1.0311647723470514,16664,12671,29335,-
chr1,241500502,1.1826691309022175,20467,14906,35373,-
chr1,241500504,1.5674448767833984,4833,3083,7916,-
chr1,241500505,1.026613091314668,6354,4650,11004,-
chr1,241500507,1.7296818085454935,1661,978,2639,-
chr1,241500510,0.7141516516516516,1521,863,2384,-
chr1,241500513,1.6550451189499589,2689,1517,4206,-
chr1,241500514,1.6550451189499589,2689,1517,4206,-
chr1,241500516,1.710600236546422,1584,1423,3007,-
chr1,241500517,1.6590540739649329,1125,616,1741,-
chr1,241500531,0.4950248977019554,1689,996,2685,-
chr1,241500533,0.8301048155162036,3740,2468,6208,-
chr1,241500534,0.5392156862745098,1539,951,2490,-
chr1,241500552,1.5730289912108093,1152,846,1998,-
chr1,241500586,1.1669723812589579,1211,860,2071,-
chr1,241500587,1.8222222222222224,655,429,1084,-
chr1,241502498,1.9473684210526316,776,531,1307,-
chr1,241502563,1.9307684049857015,1124,820,1944,-
chr1,241506036,2.213055555555556,770,599,1369,-
chr1,241506050,0.7090681415005741,1358,1035,2393,-
chr1,241506097,1.5630252701307434,2243,1539,3782,-
chr1,241506126,3.3361663179916317,728,477,1205,-
chr1,241508651,2.212911235257604,712,536,1248,-
chr1,241508679,1.7452259332023574,693,508,1201,-
chr1,241508686,6.071908602150537,694,495,1189,-
chr1,241512122,1.6133056133056134,775,628,1403,-
chr1,241512125,2.0019723865877714,1304,818,2122,-
chr1,241513684,1.4420796594709635,929,714,1643,-
chr1,241517251,1.7173030502523592,1360,1115,2475,-
chr1,241517252,1.4078470009732866,4051,2844,6895,-
chr1,241517255,1.8461538461538465,2447,1886,4333,-
chr1,241517256,1.8461538461538465,2447,1886,4333,-
chr1,241517259,3.503240860772621,1125,811,1936,-
chr1,241517271,1.488991416309013,2060,1397,3457,-
chr1,241517272,1.488991416309013,2060,1397,3457,-
chr1,241517287,1.1919223545929718,1880,1383,3263,-
chr1,241517291,1.2026397022195205,2109,1408,3517,-
chr1,241517307,0.8748896163130475,1772,1305,3077,-
chr1,241517308,2.6426282051282053,775,415,1190,-
chr1,241517309,1.2096164182779026,1755,1302,3057,-
chr1,241519616,1.0243260192336523,1460,812,2272,-
chr1,241519618,1.5443563317042883,1417,737,2154,-
chr1,241519721,0.5080650248160475,686,496,1182,-
chr1,241519736,0.3558325403550721,872,612,1484,-
chr1,241519746,0.808901338313103,781,577,1358,-
chr1,241519747,0.808901338313103,781,577,1358,-
chr1,241519748,0.8262776807654835,1409,1162,2571,-
chr1,241593837,2.791590016826825,1168,834,2002,-
chr1,241594092,0.3772811425548797,633,397,1030,-
chr1,241594217,0.5698807157057655,636,502,1138,-
chr1,241594245,1.4868197278911564,1075,767,1842,-
chr1,241594298,0.6506226053639846,1044,695,1739,-
chr1,241594330,3.2178996170126988,613,450,1063,-
chr1,241594420,0.6175098002613404,826,486,1312,-
chr1,241597769,2.4217118997912315,869,478,1347,-
chr1,241597784,2.8709040663245164,1219,738,1957,-
chr1,241597795,1.6898418038903462,1802,1131,2933,-
chr1,241597866,0.3753676097758848,672,518,1190,-
chr1,241597982,2.2675324675324675,581,439,1020,-
chr1,241629157,2.350992746701172,998,645,1643,-
chr1,241629158,2.2926013805004315,732,487,1219,-
chr1,241629823,0.3600975557328911,625,377,1002,-
chr1,241630298,3.5040820786487252,640,448,1088,-
chr1,241639899,5.746332053323622,849,658,1507,-
chr1,244408991,28.444473931661932,2438,3217,5655,-
chr1,244408992,32.42270513570263,2148,2681,4829,-
chr1,244409007,4.44326178747361,677,463,1140,-
chr1,244409008,7.545067490634025,1436,1240,2676,-
chr1,244418888,2.253972653362897,786,450,1236,-
chr1,244418889,2.2762966344846967,1124,686,1810,-
chr1,244853820,0.3654349747474605,1081,777,1858,-
chr1,244853858,2.3322839371816526,656,588,1244,-
chr1,244853910,1.9074246880785617,804,611,1415,-
chr1,244854354,2.492260061919505,804,569,1373,-
chr1,244855525,1.649862907266893,720,877,1597,-
chr1,244855526,1.0409711684370258,538,658,1196,-
chr1,244855531,6.473325776439006,2418,1948,4366,-
chr1,244855532,6.131825789258895,3203,2350,5553,-
chr1,244855533,7.753275109170307,736,686,1422,-
chr1,244855534,4.239375785656482,1617,944,2561,-
chr1,244855572,2.2689307577046596,744,396,1140,-
chr1,244855981,2.4557800400599428,1161,834,1995,-
chr1,244856152,0.4644745762711864,805,589,1394,-
chr1,244856154,0.4644745762711864,805,589,1394,-
chr1,244857710,1.9895492220378947,885,635,1520,-
chr1,244859363,1.0254545454545456,563,549,1112,-
chr1,244859364,1.0254545454545456,563,549,1112,-
chr1,244860361,2.253975363941769,543,469,1012,-
chr1,244862687,2.400321813695321,853,690,1543,-
chr1,244862700,0.33666451587330365,612,418,1030,-
chr1,244864043,4.249160760910108,711,382,1093,-
chr1,244864283,2.389216092608993,611,455,1066,-
chr1,245749595,4.390091267595513,603,513,1116,-
chr1,245863856,2.099059622804482,3265,2476,5741,-
chr1,245863857,2.0725000234233732,2211,1808,4019,-
chr1,245863863,3.8622522522522527,996,739,1735,-
chr1,245863871,1.5551859099804306,882,583,1465,-
chr1,245915543,2.2363609760011713,678,403,1081,-
chr1,245915556,2.459672337744172,843,528,1371,-
chr1,245915557,2.530210539173292,1489,879,2368,-
chr1,245915565,1.8699064743823783,1309,683,1992,-
chr1,245915566,2.2873766233766237,687,384,1071,-
chr1,246557452,1.4334775113829692,1055,746,1801,-
chr1,246557453,0.2980734278444202,655,523,1178,-
chr1,246849895,2.1404406282141135,2352,1694,4046,-
chr1,246849920,1.9115703282055934,1614,1040,2654,-
