chromosome,position,rsr,t_read,c_read,total_reads,strand
chr3,3147530,0.34269794158881856,936,476,1412,+
chr3,3147535,2.200617283950617,805,467,1272,+
chr3,3147537,2.0596697493249216,1758,1130,2888,+
chr3,3147538,1.9897959183673468,1370,913,2283,+
chr3,3147539,1.4586638258917204,2948,1964,4912,+
chr3,3147541,1.4373880526184273,3223,2354,5577,+
chr3,3147542,1.890460583060204,1685,1363,3048,+
chr3,3147543,2.0381374722838137,2297,1926,4223,+
chr3,3147545,2.0743878094788473,2194,1565,3759,+
chr3,3147548,2.1736278279057486,3003,2139,5142,+
chr3,3147549,2.1736278279057486,3003,2139,5142,+
chr3,3147552,1.7975821795483198,2103,1058,3161,+
chr3,4639409,2.216529719203522,647,471,1118,+
chr3,4675132,1.0669651014069066,686,420,1106,+
chr3,4675133,1.0669651014069066,686,420,1106,+
chr3,4691182,1.053084112149533,625,427,1052,+
chr3,4691183,1.053084112149533,625,427,1052,+
chr3,4806215,2.5164850877918354,621,491,1112,+
chr3,4815052,2.4270814849864952,652,408,1060,+
chr3,4815075,0.8206893246687783,1734,986,2720,+
chr3,4815077,0.9873949579831932,1127,713,1840,+
chr3,4815087,2.4585766423357662,1496,821,2317,+
chr3,4815089,2.4585766423357662,1496,821,2317,+
chr3,4815104,0.5991451924876771,834,681,1515,+
chr3,4815105,1.0140958590055882,2096,996,3092,+
chr3,4815107,1.1963693767881012,3003,1540,4543,+
chr3,4815108,0.5860520802155044,978,770,1748,+
chr3,4815118,1.27838192468402,2286,1554,3840,+
chr3,4815149,1.6727761025254428,2730,1515,4245,+
chr3,4846844,2.22196261682243,633,427,1060,+
chr3,4979473,1.5212697325675455,900,561,1461,+
chr3,4979475,0.9911273029296286,698,422,1120,+
chr3,4979564,2.936863543788188,617,490,1107,+
chr3,4979572,1.9665970897903178,1393,1065,2458,+
chr3,4979786,1.7707935940232078,1035,829,1864,+
chr3,4979987,1.6149155722326456,625,491,1116,+
chr3,4980006,2.1088525835866263,652,375,1027,+
chr3,4980007,1.5590356016223526,747,633,1380,+
chr3,4980307,1.5876934414148858,833,707,1540,+
chr3,4980308,1.7961987634531715,1059,793,1852,+
chr3,4980309,1.503370375295914,3064,2160,5224,+
chr3,4980330,0.981154184161703,2511,1861,4372,+
chr3,4980331,0.981154184161703,2511,1861,4372,+
chr3,4980333,1.5729343120647468,1095,965,2060,+
chr3,4980398,1.711981381911564,1093,732,1825,+
chr3,4981406,0.6544040084388185,2126,1421,3547,+
chr3,4981407,0.6401620465631331,3821,2591,6412,+
chr3,4981423,1.51963074949606,1792,1283,3075,+
chr3,4982849,2.224390866181911,1112,870,1982,+
chr3,4982987,3.4866480669589484,728,385,1113,+
chr3,4983017,2.5698347107438018,690,483,1173,+
chr3,4983059,0.6074806907923282,874,500,1374,+
chr3,4983101,1.7327426204630962,2443,1521,3964,+
chr3,4983173,0.6488605733888754,661,461,1122,+
chr3,4983194,1.7837209302325583,707,515,1222,+
chr3,4983234,1.0252594347492408,1706,1302,3008,+
chr3,4983235,2.7575596816976127,677,434,1111,+
chr3,4983236,1.0252594347492408,1706,1302,3008,+
chr3,4983284,1.8972011784511784,948,703,1651,+
chr3,4983301,1.6629445474464857,876,697,1573,+
chr3,4983432,1.6611062335381916,703,535,1238,+
chr3,4983481,2.2129870129870133,638,384,1022,+
chr3,4983549,1.8864838864838864,813,692,1505,+
chr3,4983567,0.5898650313557108,1314,1055,2369,+
chr3,4983598,2.423553719008265,917,725,1642,+
chr3,4983852,1.9853571215101757,942,703,1645,+
chr3,4983890,0.5645874263261297,626,508,1134,+
chr3,4983970,1.7302602665773295,2019,1549,3568,+
chr3,4983998,0.5074599954924498,865,492,1357,+
chr3,4983999,1.6259498480243157,950,657,1607,+
chr3,4984036,0.4116309291747888,723,647,1370,+
chr3,4984116,1.80794732061762,970,733,1703,+
chr3,4984288,2.416064177478459,696,438,1134,+
chr3,4984323,0.2965350523771152,988,730,1718,+
chr3,4984325,1.706437768240343,709,465,1174,+
chr3,4984328,2.0995502248875564,777,666,1443,+
chr3,4984385,1.7191954387076336,834,573,1407,+
chr3,4984554,0.5783132530120482,1903,1244,3147,+
chr3,4984555,1.0554850237281712,2424,1850,4274,+
chr3,4984556,0.5783132530120482,1903,1244,3147,+
chr3,4984557,1.653320772491757,701,578,1279,+
chr3,4984815,1.5909463497183955,1743,1281,3024,+
chr3,4984946,2.0033508896247656,1185,664,1849,+
chr3,4984949,1.7074468085106382,534,469,1003,+
chr3,5172203,4.778121003067977,743,422,1165,+
chr3,5172205,4.779576172200901,681,460,1141,+
chr3,9371181,1.4123403863276656,666,543,1209,+
chr3,9797747,2.020618556701031,615,387,1002,+
chr3,9797750,1.8782608695652168,655,409,1064,+
chr3,9797755,2.4033333333333333,720,419,1139,+
chr3,9797757,1.792682926829268,818,532,1350,+
chr3,9800188,1.438593646918723,1682,994,2676,+
chr3,9800189,0.7996257596394292,1225,741,1966,+
chr3,9800192,1.6063510504405074,975,625,1600,+
chr3,9800201,1.5977823977823973,1047,584,1631,+
chr3,9800234,1.5375816993464049,940,662,1602,+
chr3,9800236,1.4509222222222222,1948,1124,3072,+
chr3,9800267,1.7300023820100303,2952,1568,4520,+
chr3,9801667,2.113636363636364,656,437,1093,+
chr3,9801677,1.8620442147573928,762,515,1277,+
chr3,9803967,2.360387953037264,951,652,1603,+
chr3,9806232,0.5084967320261438,777,509,1286,+
chr3,9806328,22.77303370786517,562,444,1006,+
chr3,9806329,19.432267762408955,1064,650,1714,+
chr3,9806330,16.31273183754938,1444,1144,2588,+
chr3,9806343,4.52290589667907,492,790,1282,+
chr3,9806350,4.319452380767858,634,966,1600,+
chr3,9806372,0.4210456352275824,476,594,1070,+
chr3,9806670,7.275135297252206,1306,1046,2352,+
chr3,9806673,7.537283518182396,1144,1001,2145,+
chr3,9893371,0.6842485654389091,800,651,1451,+
chr3,9942856,2.478951974842429,604,451,1055,+
chr3,10115771,1.6656103920576957,1903,1533,3436,+
chr3,10115790,1.8855367231638418,901,589,1490,+
chr3,10126394,1.9597701149425288,681,347,1028,+
chr3,10126474,10.103876134905319,5733,7680,13413,+
chr3,10126475,10.10387613490532,5733,7680,13413,+
chr3,10126513,0.5020174806157427,922,1082,2004,+
chr3,10126765,2.4399506356873126,909,664,1573,+
chr3,10149838,2.18572825024438,1203,692,1895,+
chr3,10149839,2.1295714801106373,1874,1116,2990,+
chr3,10149841,1.993232119992683,1281,780,2061,+
chr3,14125173,4.388253767103238,1098,753,1851,+
chr3,14125175,4.0395901576796875,910,629,1539,+
chr3,14178851,3.5349505840071873,994,596,1590,+
chr3,14181559,1.0621348911311737,1499,806,2305,+
chr3,14181560,1.3833630083327395,980,738,1718,+
chr3,14181561,1.0621348911311737,1499,806,2305,+
chr3,14181564,1.440523576240049,737,567,1304,+
chr3,14181565,1.591180654338549,986,569,1555,+
chr3,14181569,1.6886711417936564,2653,2192,4845,+
chr3,14181571,1.6886711417936564,2653,2192,4845,+
chr3,14181597,0.7256248086567902,3434,2628,6062,+
chr3,14181612,1.0849338612560906,3957,2986,6943,+
chr3,14181639,1.3361947968451455,2479,1685,4164,+
chr3,14198122,1.6849529780564263,1074,637,1711,+
chr3,14198138,0.9564500724034875,1320,1046,2366,+
chr3,14198139,0.9564500724034875,1320,1046,2366,+
chr3,14445737,0.4490968867592244,595,406,1001,+
chr3,14447748,0.4785668586052463,923,520,1443,+
chr3,14447750,0.7833799385840009,1426,820,2246,+
chr3,14447752,1.023736780258519,989,574,1563,+
chr3,14468090,0.7779075588186216,665,460,1125,+
chr3,14468091,0.7779075588186216,665,460,1125,+
chr3,14485115,0.31769991015274035,662,476,1138,+
chr3,14485117,0.31769991015274035,662,476,1138,+
chr3,14485340,1.9932523616734144,632,467,1099,+
chr3,14485405,0.5937701119835243,658,456,1114,+
chr3,14485739,1.8895384240652784,534,482,1016,+
chr3,14485991,1.0426008968609863,650,445,1095,+
chr3,14485993,1.0426008968609863,650,445,1095,+
chr3,14486034,1.9503381217797924,714,482,1196,+
chr3,14486110,20.02853105303653,1529,747,2276,+
chr3,14486111,20.327429383572465,2035,959,2994,+
chr3,14486112,20.02853105303653,1529,747,2276,+
chr3,14486115,18.120333814456757,836,461,1297,+
chr3,14486122,6.742607807882621,971,648,1619,+
chr3,14486438,0.8063514677301162,1195,772,1967,+
chr3,14486439,0.9695530328219256,971,568,1539,+
chr3,14486811,3.1985896149025455,763,525,1288,+
chr3,14486817,1.6483175051873191,647,539,1186,+
chr3,14486842,1.2770937796088702,1216,772,1988,+
chr3,14486844,0.9544159544159545,937,584,1521,+
chr3,14486868,1.6883749239196593,583,423,1006,+
chr3,14487090,4.797668170162901,2182,2010,4192,+
chr3,14487091,4.797668170162901,2182,2010,4192,+
chr3,14487202,1.2929702659950235,1126,820,1946,+
chr3,14487241,0.4597207303974221,641,398,1039,+
chr3,14488927,1.100897118215148,1055,780,1835,+
chr3,14488963,2.2032124430061053,1031,739,1770,+
chr3,14489010,1.852941176470588,1106,737,1843,+
chr3,14667479,2.367821616034253,1007,843,1850,+
chr3,15601746,1.3138394496569406,727,594,1321,+
chr3,15601747,1.1497067954467055,605,445,1050,+
chr3,15601748,1.1497067954467055,605,445,1050,+
chr3,15601798,0.8746781629842525,912,585,1497,+
chr3,15601800,0.8896743243258529,2473,1693,4166,+
chr3,15601801,1.1578628639089217,1767,1133,2900,+
chr3,15635635,3.6834109282957543,646,448,1094,+
chr3,15635641,0.4537931576473484,704,476,1180,+
chr3,17465339,0.9813102498524494,1246,662,1908,+
chr3,17465341,0.9813102498524494,1246,662,1908,+
chr3,19983917,2.5196881475761317,740,487,1227,+
chr3,19984618,9.728581775071513,847,816,1663,+
chr3,19984619,8.503157991859924,1320,1119,2439,+
chr3,19984620,13.469142239156232,1739,1406,3145,+
chr3,22381731,2.11278176294897,1253,910,2163,+
chr3,22381733,1.8602345272184222,2307,1615,3922,+
chr3,22381740,1.2489236713636234,2459,1760,4219,+
chr3,22381741,0.8825979242077608,2544,1827,4371,+
chr3,22381899,2.2470680579924283,1186,636,1822,+
chr3,22381913,1.7660098522167489,716,405,1121,+
chr3,22382000,2.0283576223936044,2166,1432,3598,+
chr3,23887673,3.0129098360655737,753,609,1362,+
chr3,23887674,3.0129098360655737,753,609,1362,+
chr3,23889232,2.3431773879142304,828,539,1367,+
chr3,23890680,15.84512222139178,3471,244,3715,+
chr3,23890681,16.052402804255017,4134,266,4400,+
chr3,23890682,30.16372391653291,1565,88,1653,+
chr3,23890684,27.09733870464587,3273,184,3457,+
chr3,23890685,44.64255160411016,6153,1168,7321,+
chr3,23890686,24.91317267840168,4185,2977,7162,+
chr3,23890687,24.894037733273485,7224,4889,12113,+
chr3,23890688,20.50194061026377,5174,4769,9943,+
chr3,23890706,2.86054307743882,741,941,1682,+
chr3,23917131,1.5034465870829508,685,604,1289,+
chr3,23917133,1.1823829640472419,1663,1402,3065,+
chr3,23917134,0.9941688955317809,1005,895,1900,+
chr3,23917171,1.5503713228540688,843,718,1561,+
chr3,23917187,1.8488855622089155,516,500,1016,+
chr3,23917190,1.7715664901899717,733,493,1226,+
chr3,23918455,1.9907908209638845,802,324,1126,+
chr3,23918476,1.5059417561611237,3025,2036,5061,+
chr3,23918477,1.2335744673147382,4968,3353,8321,+
chr3,23918478,1.1087271710703195,1339,620,1959,+
chr3,23918479,1.2073120516304192,3500,2385,5885,+
chr3,23918482,2.1146537842190014,937,413,1350,+
chr3,23918488,1.3610350534075522,1076,577,1653,+
chr3,23918492,1.8141402124653496,2625,1284,3909,+
chr3,23918504,1.4020477047840534,5924,3571,9495,+
chr3,23918530,1.2816891310461922,20348,13273,33621,+
chr3,23918532,1.2781253781841864,16136,11139,27275,+
chr3,23918534,1.1983694740022155,4779,3843,8622,+
chr3,23918538,1.386301397969102,15560,10044,25604,+
chr3,23919352,1.6312249900483966,3663,1617,5280,+
chr3,23919354,0.7877081167323248,6432,5004,11436,+
chr3,23919363,1.2980848110052379,4613,2066,6679,+
chr3,23919364,1.42083644510829,3804,2209,6013,+
chr3,23919384,1.3608614634354521,16675,10309,26984,+
chr3,23919408,1.4357190540702525,23680,15467,39147,+
chr3,23919462,1.428219541011779,7914,4504,12418,+
chr3,23919623,1.6083916083916083,1149,714,1863,+
chr3,23919626,1.4394849405241055,4074,2415,6489,+
chr3,23919642,1.8499053636738816,2130,1190,3320,+
chr3,23919647,1.8753193269908384,2332,1375,3707,+
chr3,23919654,1.9039630958484661,4465,2886,7351,+
chr3,23919934,0.6790013122765737,1538,1077,2615,+
chr3,23919955,1.5136698263390744,3609,2709,6318,+
chr3,23919998,0.4789245982694684,1106,808,1914,+
chr3,23920045,1.761198706953424,1694,1143,2837,+
chr3,23920130,1.7607034997335231,1165,865,2030,+
chr3,23920429,2.383330339500629,855,585,1440,+
chr3,23980369,5.873976522291003,506,662,1168,+
chr3,27633211,2.586759831374092,515,494,1009,+
chr3,27633215,1.3993167854226962,1344,1088,2432,+
chr3,27633217,1.3993167854226962,1344,1088,2432,+
chr3,27633553,1.3194566555301566,782,483,1265,+
chr3,27633554,1.1373394351765698,1346,895,2241,+
chr3,27633555,1.0397289663726699,2217,1426,3643,+
chr3,28319532,0.5805008944543828,648,515,1163,+
chr3,31533026,3.0502708614187353,931,714,1645,+
chr3,31533262,2.275564842627661,967,493,1460,+
chr3,31533263,1.7936058744288916,1255,679,1934,+
chr3,31533284,0.7338153801467144,2242,1477,3719,+
chr3,31533285,0.6178925660414417,967,598,1565,+
chr3,31533286,1.020408163265306,911,587,1498,+
chr3,31576396,3.0761060690782394,771,569,1340,+
chr3,31576410,0.570068998334523,598,466,1064,+
chr3,31576422,1.313878677084377,1035,780,1815,+
chr3,31576445,1.6847619047619047,792,545,1337,+
chr3,31579910,0.5799608691174956,703,497,1200,+
chr3,31579931,0.5839283690354754,643,518,1161,+
chr3,31579978,3.755952380952381,630,503,1133,+
chr3,31596798,0.5014781966001478,1179,819,1998,+
chr3,31596800,0.5014781966001478,1179,819,1998,+
chr3,31615180,2.85792770025272,764,478,1242,+
chr3,31622123,0.5293385490753911,686,455,1141,+
chr3,31622230,0.9940096618357487,642,574,1216,+
chr3,31622232,0.9940096618357487,642,574,1216,+
chr3,31623737,1.9305731142014328,732,451,1183,+
chr3,31624914,1.4711498088829948,814,494,1308,+
chr3,31624975,2.248354278874925,883,556,1439,+
chr3,31625957,2.117169373549884,583,430,1013,+
chr3,31626032,1.872053872053872,694,494,1188,+
chr3,31629377,2.662531017369728,1072,712,1784,+
chr3,31629379,2.0386540120793795,715,609,1324,+
chr3,31629388,1.8322218322218324,899,813,1712,+
chr3,31629393,1.518098415346122,957,871,1828,+
chr3,31632935,2.399395702775291,1020,1116,2136,+
chr3,31632945,1.7837073581613625,1288,1510,2798,+
chr3,31633007,2.615235971757711,925,584,1509,+
chr3,31635989,0.4725818181818182,854,624,1478,+
chr3,31636049,0.4061028612821442,689,501,1190,+
chr3,31636371,1.8671749598715894,704,444,1148,+
chr3,31636657,2.303586278586278,1080,739,1819,+
chr3,31637356,3.1079404466501237,667,495,1162,+
chr3,32685435,0.4778711484593838,852,398,1250,+
chr3,32685436,0.4778711484593838,852,398,1250,+
chr3,33114240,2.1298419584753643,710,460,1170,+
chr3,33114277,0.304222093695778,525,545,1070,+
chr3,33114279,0.304222093695778,525,545,1070,+
chr3,33114381,1.0790742526518804,745,609,1354,+
chr3,33114382,1.480566749960516,1358,1088,2446,+
chr3,33114498,2.111817004647721,906,560,1466,+
chr3,33114521,1.4166432123088468,905,560,1465,+
chr3,33120345,1.8531139835487667,746,620,1366,+
chr3,33120347,0.6316353887399464,1177,745,1922,+
chr3,33120348,1.6470479104220448,1344,1187,2531,+
chr3,33120354,1.4889632596041291,2414,1826,4240,+
chr3,33124452,1.3894014084507045,1878,1199,3077,+
chr3,33124455,1.5099399849962492,1842,1332,3174,+
chr3,33124492,1.4556827529476282,1572,1041,2613,+
chr3,33124495,1.1090413648231567,5921,4053,9974,+
chr3,33124496,0.6665244693195004,3550,2253,5803,+
chr3,33124540,1.3162077629082705,2566,1575,4141,+
chr3,33129941,0.7007966679194829,2067,1488,3555,+
chr3,33132565,1.165915616990006,5787,3901,9688,+
chr3,33132566,1.014239512685255,4194,2653,6847,+
chr3,33134196,1.8517297753401536,1324,997,2321,+
chr3,33142485,1.6398740715234394,900,700,1600,+
chr3,33142815,0.5608012344628286,1548,1162,2710,+
chr3,33142828,3.6388506650430488,624,457,1081,+
chr3,33142922,0.9589495113249787,3980,2747,6727,+
chr3,33142923,0.7649167775218196,1520,1257,2777,+
chr3,33142924,1.4912590126000032,1354,757,2111,+
chr3,33142932,0.6061794582392777,2386,1771,4157,+
chr3,33142933,0.6061794582392777,2386,1771,4157,+
chr3,33142934,1.9993751421831167,2385,1626,4011,+
chr3,33142935,2.2758896441423437,1422,1036,2458,+
chr3,33142993,1.3541285398619978,1426,1100,2526,+
chr3,33143691,3.064662676816726,765,579,1344,+
chr3,33143915,12.12338948839389,1108,373,1481,+
chr3,33143930,8.025682944002682,692,359,1051,+
chr3,33143933,9.757604658543586,1270,1133,2403,+
chr3,33143934,9.757604658543588,1270,1133,2403,+
chr3,33143948,0.2875275265216193,659,774,1433,+
chr3,33144126,2.3143812709030103,864,574,1438,+
chr3,33144127,2.3143812709030103,864,574,1438,+
chr3,33144153,2.4807298772169166,745,732,1477,+
chr3,33144157,1.6354580152671756,1241,1047,2288,+
chr3,33144159,1.8430776612528874,2822,2619,5441,+
chr3,33144161,2.1144644216133943,1326,1167,2493,+
chr3,33144362,0.3965695517304301,651,400,1051,+
chr3,33144364,0.3965695517304301,651,400,1051,+
chr3,33144518,1.7108695879547837,586,469,1055,+
chr3,33144841,0.29670042405438246,938,652,1590,+
chr3,33144958,4.5145889491966065,1170,885,2055,+
chr3,33144959,3.8111332007952283,638,502,1140,+
chr3,33826505,2.2834467120181405,688,545,1233,+
chr3,33826507,2.2834467120181405,688,545,1233,+
chr3,33836116,1.8671424453905545,919,696,1615,+
chr3,33838231,2.547915704615813,1024,717,1741,+
chr3,33838255,2.5240929340705973,963,707,1670,+
chr3,33855221,0.4814077025232404,724,501,1225,+
chr3,33866508,1.0204592901878915,657,478,1135,+
chr3,33866509,1.0204592901878915,657,478,1135,+
chr3,33869375,1.9655788582714195,835,685,1520,+
chr3,33869376,1.5221950622985734,1169,935,2104,+
chr3,37325932,2.1839601861686018,606,407,1013,+
chr3,37326090,2.956745948502212,902,665,1567,+
chr3,37326140,0.5273133193995819,652,553,1205,+
chr3,37326387,1.9898346327774021,854,594,1448,+
chr3,39391971,5.957771905038158,775,469,1244,+
chr3,39391988,3.5610076989013923,728,466,1194,+
chr3,39406719,0.8726876535054705,8711,3342,12053,+
chr3,39406720,1.05370217398933,11207,4507,15714,+
chr3,39406721,0.8690110922843814,8157,2797,10954,+
chr3,39406728,0.5941686367218282,883,845,1728,+
chr3,39406731,0.6457216940363008,963,889,1852,+
chr3,39406737,0.6832630098452883,1734,1579,3313,+
chr3,39407631,1.3742134905910417,7652,3919,11571,+
chr3,39407632,1.3742134905910417,7652,3919,11571,+
chr3,39407641,1.3628236362885575,9745,5367,15112,+
chr3,39407642,1.2782942368125312,21422,13303,34725,+
chr3,39407644,1.213163543655864,11677,7936,19613,+
chr3,39407715,1.5493581427897105,6777,4925,11702,+
chr3,39407716,1.5493581427897105,6777,4925,11702,+
chr3,39407723,1.3801887580389207,3965,1841,5806,+
chr3,39407736,1.5737831936775193,12143,7739,19882,+
chr3,39407742,1.2758791987853333,15701,11082,26783,+
chr3,39408611,1.1947671606295158,27680,18164,45844,+
chr3,39408617,1.513703787454646,16180,11160,27340,+
chr3,39408618,1.3516938740436462,29245,19015,48260,+
chr3,39408624,1.4982879883170748,9042,6526,15568,+
chr3,39410761,1.6344298578112857,1259,702,1961,+
chr3,39410776,0.24732872407291007,786,295,1081,+
chr3,39410783,1.672871287128713,639,504,1143,+
chr3,39410786,2.3324514991181657,1057,404,1461,+
chr3,39410788,1.7120379620379618,913,615,1528,+
chr3,39410790,0.4451242236024845,1302,459,1761,+
chr3,39410792,1.3981208053691276,1091,744,1835,+
chr3,39410795,1.5590400333202505,2878,1463,4341,+
chr3,39411719,1.8687404265347,792,413,1205,+
chr3,39411720,1.904160237885908,888,501,1389,+
chr3,39411722,0.8203944112786459,1061,575,1636,+
chr3,39411723,0.7394594985467333,1139,687,1826,+
chr3,39411728,0.4534656050124005,578,488,1066,+
chr3,39411730,0.4534656050124005,578,488,1066,+
chr3,39411746,1.4142463284513602,2311,1476,3787,+
chr3,39411752,0.5787416671875225,1982,1176,3158,+
chr3,39411757,1.4084120462677017,2367,1434,3801,+
chr3,39411760,1.3621949609814048,3081,2145,5226,+
chr3,39411762,1.3692165800449771,6576,4704,11280,+
chr3,39411763,1.4038356135130905,5105,3696,8801,+
chr3,39411764,1.382025214093616,7088,4653,11741,+
chr3,39411896,1.360106051154086,2447,1831,4278,+
chr3,39411899,0.9874712487388909,15615,8755,24370,+
chr3,39411900,1.1530831920353244,18550,10072,28622,+
chr3,39411901,1.0340026682174257,12307,6323,18630,+
chr3,39411902,1.3077551631999376,18892,13433,32325,+
chr3,39411903,1.3072786498553814,7923,5959,13882,+
chr3,39411906,1.3945904761904764,4575,3499,8074,+
chr3,39411922,1.484003068348159,10186,6639,16825,+
chr3,39411923,1.3467286605624562,17769,10863,28632,+
chr3,39411937,1.7452909800494305,6671,4773,11444,+
chr3,39411944,0.9436361604328342,26342,15171,41513,+
chr3,39411945,0.9436361604328342,26342,15171,41513,+
chr3,39412474,3.730763855461192,650,428,1078,+
chr3,40309954,2.5427916578672303,631,466,1097,+
chr3,40312012,0.48837401286354765,908,647,1555,+
chr3,40312194,1.9648161168314568,979,734,1713,+
chr3,40457328,1.3194247976130316,750,586,1336,+
chr3,40457330,1.501987054389685,975,708,1683,+
chr3,40457337,1.1143566708805148,771,728,1499,+
chr3,40458651,1.8803611738148984,781,442,1223,+
chr3,40458653,1.8803611738148984,781,442,1223,+
chr3,40458654,1.0747126436781609,747,347,1094,+
chr3,40458655,1.3788815621724975,1253,695,1948,+
chr3,40458664,1.8224043715847,666,365,1031,+
chr3,40458671,1.5310519645120404,905,525,1430,+
chr3,40458681,1.440029037092544,1756,1255,3011,+
chr3,40458687,1.4963552489917569,5632,3715,9347,+
chr3,40458688,1.472147669424663,6768,4286,11054,+
chr3,40458689,1.3463926089242553,4062,2542,6604,+
chr3,40458690,1.37559820342701,10993,6982,17975,+
chr3,40458692,1.4761290326675411,7001,4801,11802,+
chr3,40458709,1.1848248127148613,17041,11756,28797,+
chr3,40458710,1.308343727669636,12913,9216,22129,+
chr3,40458711,1.308343727669636,12913,9216,22129,+
chr3,40458722,1.2709891531865865,19059,15014,34073,+
chr3,40458723,1.2263838671991294,12802,9916,22718,+
chr3,40461404,0.9689561209894355,610,545,1155,+
chr3,40461607,1.176531742713282,11854,6453,18307,+
chr3,40461608,1.2391301145290703,7383,4300,11683,+
chr3,40461609,1.2276845308853306,14841,8669,23510,+
chr3,40461613,1.400312670414567,11544,6792,18336,+
chr3,40461614,1.3924830921512747,15081,9530,24611,+
chr3,40461622,1.2713228557333145,3468,2026,5494,+
chr3,40461627,1.4164864584414478,12174,8520,20694,+
chr3,40462042,0.4750785253760952,4234,3681,7915,+
chr3,40462043,0.5901920943559884,7616,5611,13227,+
chr3,40462048,0.6703879213601603,13396,8513,21909,+
chr3,40462049,0.7007713958473376,17150,11084,28234,+
chr3,40462062,1.5668173499267937,9221,6829,16050,+
chr3,40462063,1.5001041767879237,18613,12850,31463,+
chr3,40462072,1.6152781882999439,11502,9331,20833,+
chr3,40462073,1.5050925408369058,18191,13439,31630,+
chr3,40462076,1.4773022074434563,6456,5428,11884,+
chr3,40462077,1.3131520062686413,7614,4706,12320,+
chr3,40462140,1.2473955992888306,21808,16977,38785,+
chr3,40761620,0.9589372612631468,1214,658,1872,+
chr3,40761622,0.7657078277841011,2893,1434,4327,+
chr3,40761623,0.676383358786202,2941,1362,4303,+
chr3,40761627,0.8430911767486461,1134,432,1566,+
chr3,40761629,1.6298862372765373,2589,1298,3887,+
chr3,40761630,2.18693372802346,2107,870,2977,+
chr3,40761632,1.6104736317151094,8267,4144,12411,+
chr3,40761634,1.3753941705661756,9721,5236,14957,+
chr3,40761635,1.2885933503836318,10719,5864,16583,+
chr3,40761637,1.3896390324895471,13897,7315,21212,+
chr3,40761638,1.4500341721257244,12272,6963,19235,+
chr3,40761640,1.4126505466158406,21675,11542,33217,+
chr3,40761642,1.4234531597849327,14701,7574,22275,+
chr3,40761647,1.247170857056482,5380,3344,8724,+
chr3,40761657,2.059035146160608,19331,12408,31739,+
chr3,40761658,1.8988617902409066,24421,14575,38996,+
chr3,40761661,1.779010690437383,20407,14028,34435,+
chr3,40761663,1.565246836361258,39228,29661,68889,+
chr3,40761664,1.4063815422740809,55493,38816,94309,+
chr3,40761665,1.3492477425948923,56596,38760,95356,+
chr3,40761666,1.5634321710448356,36617,32192,68809,+
chr3,40761667,0.9105039766417611,26716,12022,38738,+
chr3,40761668,1.5250263752971467,25028,20808,45836,+
chr3,40761669,0.8841328918362042,30556,13688,44244,+
chr3,40761670,0.935003561730586,21853,9786,31639,+
chr3,41224577,2.058894230769231,570,467,1037,+
chr3,41224591,1.7352579852579857,564,443,1007,+
chr3,41224612,3.1972713864306788,666,451,1117,+
chr3,41224738,1.799950787401575,1329,1015,2344,+
chr3,41224739,1.799950787401575,1329,1015,2344,+
chr3,41224953,1.7200657894736844,580,455,1035,+
chr3,41224965,1.7611844222722883,683,477,1160,+
chr3,41225045,1.6483024807848006,1202,882,2084,+
chr3,41225049,2.2880593385214008,606,513,1119,+
chr3,41225128,2.291929463251384,613,456,1069,+
chr3,41225142,1.7316137566137566,688,503,1191,+
chr3,41225149,1.6555183946488294,719,551,1270,+
chr3,41225342,0.48009438009438027,588,517,1105,+
chr3,41225766,1.559396193393131,809,652,1461,+
chr3,41233646,2.1450292397660817,654,474,1128,+
chr3,41233718,2.103695029924538,702,426,1128,+
chr3,41233787,2.251842751842752,610,406,1016,+
chr3,41233805,0.5715691096901131,663,427,1090,+
chr3,41235727,3.136,636,454,1090,+
chr3,41235728,7.056758752989888,1517,1090,2607,+
chr3,41235740,2.180278281911676,815,683,1498,+
chr3,41235742,2.1197400955895755,1303,993,2296,+
chr3,41235745,0.8721576817647827,927,814,1741,+
chr3,41235746,0.8721576817647827,927,814,1741,+
chr3,41235788,1.90643585386576,618,427,1045,+
chr3,41235815,2.8318464904898164,700,456,1156,+
chr3,41236354,3.7375494071146234,787,459,1246,+
chr3,41236604,3.074688796680498,569,481,1050,+
chr3,41236635,0.5284005979073244,706,445,1151,+
chr3,41236636,1.9304915082667864,612,522,1134,+
chr3,41236644,1.8371647509578546,821,521,1342,+
chr3,41238026,1.7440653286556498,970,779,1749,+
chr3,41238032,2.3401072059574632,1217,827,2044,+
chr3,41239442,12.696334452079949,621,431,1052,+
chr3,41240015,0.47605322522701277,771,500,1271,+
chr3,41240022,0.8775506509269281,813,605,1418,+
chr3,41240024,0.845272612735291,658,523,1181,+
chr3,41240051,2.066898556249107,1057,676,1733,+
chr3,41240083,2.158426368952685,724,494,1218,+
chr3,41240135,1.9343283582089554,971,669,1640,+
chr3,41240293,1.6147071158954283,699,621,1320,+
chr3,41240349,2.9128043990573445,926,669,1595,+
chr3,44401258,2.070409632247088,790,565,1355,+
chr3,44401259,2.214463387940563,1049,780,1829,+
chr3,44401274,1.8012811387900358,683,561,1244,+
chr3,44840393,3.135678887369227,1392,812,2204,+
chr3,44840415,3.611570247933885,873,604,1477,+
chr3,44840416,3.611570247933885,873,604,1477,+
chr3,44840435,1.741204660105942,828,443,1271,+
chr3,44841084,1.7270805518469068,721,641,1362,+
chr3,44841092,1.0753327527563412,1485,1161,2646,+
chr3,44841096,1.8997005988023958,704,500,1204,+
chr3,44841099,1.545476006273153,1141,841,1982,+
chr3,44841102,4.508166969147005,1583,1275,2858,+
chr3,44841103,4.508166969147005,1583,1275,2858,+
chr3,45005354,0.40174486306803003,2068,1455,3523,+
chr3,45011286,1.776450518835849,767,576,1343,+
chr3,45011292,0.4441882780216322,596,418,1014,+
chr3,47409690,1.217947102445407,883,444,1327,+
chr3,47409694,2.0009510533566788,757,496,1253,+
chr3,47409709,2.5075817112513756,709,531,1240,+
chr3,47815966,3.0786662534161615,881,459,1340,+
chr3,47815974,1.4886558442649125,658,474,1132,+
chr3,47815992,0.4506517690875233,879,357,1236,+
chr3,47815993,0.4506517690875233,879,357,1236,+
chr3,47816017,3.5929807457957588,701,372,1073,+
chr3,47816018,2.346869912683143,1686,1164,2850,+
chr3,47816019,2.346869912683143,1686,1164,2850,+
chr3,47816020,2.346869912683143,1686,1164,2850,+
chr3,47816043,1.7834381096900065,865,658,1523,+
chr3,47825222,4.104408352668212,731,430,1161,+
chr3,47825234,2.1775040183957834,853,758,1611,+
chr3,47825236,2.297416974169741,565,541,1106,+
chr3,47827356,0.48252032520325217,1186,1019,2205,+
chr3,47827357,1.3744163878965907,2705,2278,4983,+
chr3,47827359,1.9915703306431956,1506,1320,2826,+
chr3,47827360,0.4927837573385518,710,583,1293,+
chr3,47827361,1.3546633297243287,1726,1469,3195,+
chr3,47827400,2.04854104172348,625,385,1010,+
chr3,47827425,1.6054184549356223,683,465,1148,+
chr3,47827439,2.0063888888888894,698,449,1147,+
chr3,47827442,1.7236467236467234,725,485,1210,+
chr3,47829037,2.2002677100494235,1256,606,1862,+
chr3,47829038,1.9229701667454815,3937,2860,6797,+
chr3,47829039,1.8142334026568736,5374,3972,9346,+
chr3,47829040,1.8142334026568736,5374,3972,9346,+
chr3,47829041,1.6789103019739455,4919,3568,8487,+
chr3,47841708,1.8424242424242423,607,395,1002,+
chr3,47846637,2.3057385003823483,901,611,1512,+
chr3,47846638,2.2270300069044344,674,488,1162,+
chr3,47847513,3.1915889269251987,728,505,1233,+
chr3,47847814,0.3398553451231239,738,468,1206,+
chr3,47847816,0.3398553451231239,738,468,1206,+
chr3,47848964,0.9908730885116666,782,425,1207,+
chr3,47849678,2.212068816788335,832,740,1572,+
chr3,48440409,0.6208060556464812,713,623,1336,+
chr3,48440411,1.1424433704075139,993,853,1846,+
chr3,48440595,0.9745632348093616,1313,957,2270,+
chr3,48440596,1.329859973046865,1958,1300,3258,+
chr3,48927512,2.8343695002676355,1062,757,1819,+
chr3,48974964,1.3585348203242547,866,598,1464,+
chr3,48974966,1.2569093827520794,581,444,1025,+
chr3,48983528,8.20958544368608,956,711,1667,+
chr3,49012541,7.282342426854622,584,646,1230,+
chr3,49012542,6.706130010752847,692,751,1443,+
chr3,49013714,2.7700807271149475,616,436,1052,+
chr3,49022706,0.3332146671413314,791,582,1373,+
chr3,49022708,0.3332146671413314,791,582,1373,+
chr3,49023136,3.6228992256326658,747,613,1360,+
chr3,49533193,1.3030078895463508,754,467,1221,+
chr3,49533746,7.459301975224025,1609,966,2575,+
chr3,49533747,6.49891156462585,1290,734,2024,+
chr3,49533748,8.20068468240199,2265,1475,3740,+
chr3,49533778,3.0523284831231496,969,819,1788,+
chr3,49534484,0.982406575060999,917,598,1515,+
chr3,49534486,1.2885760987400203,1070,708,1778,+
chr3,49534867,68.44280683696644,868,1104,1972,+
chr3,49676413,0.5613168724279836,681,431,1112,+
chr3,49677606,2.9102247284446667,687,571,1258,+
chr3,49680570,1.1896467547637724,1138,897,2035,+
chr3,49682865,0.45195610287341886,829,518,1347,+
chr3,49682866,1.3540580283258665,1251,807,2058,+
chr3,49682915,2.3944687045123727,563,457,1020,+
chr3,49682916,2.8346966292134828,583,444,1027,+
chr3,49682917,2.3944687045123727,563,457,1020,+
chr3,49682918,2.8346966292134828,583,444,1027,+
chr3,49683106,1.5315801735560206,1007,697,1704,+
chr3,49683266,1.5899074697596132,1197,989,2186,+
chr3,49683267,1.1909851860773215,878,721,1599,+
chr3,49683300,2.0579901153212523,1040,606,1646,+
chr3,49683301,2.0579901153212523,1040,606,1646,+
chr3,50118606,1.6421029617248841,845,619,1464,+
chr3,50118608,2.547330376873765,961,602,1563,+
chr3,50118629,3.1597791236195225,656,400,1056,+
chr3,50118630,3.1597791236195225,656,400,1056,+
chr3,50236393,1.2547033049903753,664,422,1086,+
chr3,50236416,1.999022124161327,1380,737,2117,+
chr3,50236417,2.078875416072278,1398,700,2098,+
chr3,50236419,1.935138871687425,1743,948,2691,+
chr3,50236435,2.602833352171171,1519,920,2439,+
chr3,50252457,1.207565751796291,604,460,1064,+
chr3,50252460,1.5304751930352913,1684,1231,2915,+
chr3,50252461,2.086312091704672,1230,1063,2293,+
chr3,50252463,2.270569309611658,1866,1490,3356,+
chr3,50252464,2.3025851083027056,1545,1234,2779,+
chr3,50252470,1.6515318060160102,1156,888,2044,+
chr3,50253120,2.1396101956034985,608,393,1001,+
chr3,50256193,2.4808673469387754,777,447,1224,+
chr3,50256194,2.4808673469387754,777,447,1224,+
chr3,50256225,0.30294105822624046,720,474,1194,+
chr3,50256984,2.462633178635892,1311,911,2222,+
chr3,50256992,0.4920332231545046,682,436,1118,+
chr3,50256993,0.9716589116478382,1056,773,1829,+
chr3,50273313,1.7100503855976963,963,757,1720,+
chr3,50273764,0.8478381156603814,755,493,1248,+
chr3,50275382,0.26494345579180184,592,441,1033,+
chr3,50276956,5.432101284652419,987,735,1722,+
chr3,51385351,1.8432818852065957,379,761,1140,+
chr3,51385390,0.25087520100683525,534,830,1364,+
chr3,51386278,2.2101873536299768,603,426,1029,+
chr3,51386297,2.7420413990007138,685,466,1151,+
chr3,51386325,1.9251989581127789,1570,1134,2704,+
chr3,51387769,2.251083591331269,660,379,1039,+
chr3,51387773,1.4575070821529743,1028,705,1733,+
chr3,51387776,2.0348338035079108,1105,788,1893,+
chr3,51387821,0.5825621746674379,1342,987,2329,+
chr3,51387827,1.505704830791772,2031,1152,3183,+
chr3,51387828,1.4328306765046714,5705,3576,9281,+
chr3,51387829,1.5500657914263385,2391,1656,4047,+
chr3,51387830,1.3022906674175194,3764,2238,6002,+
chr3,51387831,0.5501789549033643,914,634,1548,+
chr3,51387832,1.4700195822588857,13117,9390,22507,+
chr3,51387833,1.4234955274941519,13491,9646,23137,+
chr3,51387834,1.6527581966382425,7593,6282,13875,+
chr3,51387835,1.133712247854675,3178,1993,5171,+
chr3,51387836,1.5896580982001314,6225,5470,11695,+
chr3,51387838,1.6518315362105176,6609,6106,12715,+
chr3,51387840,1.4722780941951883,12320,11302,23622,+
chr3,51387841,1.4491654007625714,10105,9276,19381,+
chr3,51387842,1.6400332141195069,10341,10817,21158,+
chr3,51387844,1.517445049304752,18755,16317,35072,+
chr3,51387845,1.5541428429251256,12064,10918,22982,+
chr3,51389004,2.1933365758754864,621,513,1134,+
chr3,51389029,2.0001036054703687,714,507,1221,+
chr3,51389047,1.8827907612274968,1369,1131,2500,+
chr3,51389256,3.174909968416901,726,612,1338,+
chr3,52199346,2.2874493927125505,564,474,1038,+
chr3,52202621,2.8617768540307473,637,393,1030,+
chr3,52203869,0.2473685488934745,803,619,1422,+
chr3,52203870,0.30660271312375836,1157,855,2012,+
chr3,52204740,2.2850140056022408,752,611,1363,+
chr3,52204742,2.2850140056022408,752,611,1363,+
chr3,52205878,0.36356167442219034,579,452,1031,+
chr3,52206010,2.7869951384833667,916,681,1597,+
chr3,52208192,8.785729712978199,1129,377,1506,+
chr3,52208196,10.320902394106817,772,361,1133,+
chr3,52208197,16.040892772134036,2450,1366,3816,+
chr3,52208198,16.293788586887636,1942,1120,3062,+
chr3,52208199,16.086058341738273,2186,1255,3441,+
chr3,52208203,7.05093855259692,1496,1172,2668,+
chr3,52208204,9.250902902471955,2107,1883,3990,+
chr3,52208205,9.250902902471955,2107,1883,3990,+
chr3,52208209,2.80896043509965,827,1037,1864,+
chr3,52208228,0.40441678035470674,557,732,1289,+
chr3,52208230,0.40441678035470674,557,732,1289,+
chr3,52211308,1.213002371276614,479,544,1023,+
chr3,52211366,0.3318351007795491,524,490,1014,+
chr3,52211368,0.3318351007795491,524,490,1014,+
chr3,52211369,1.578703086233927,781,570,1351,+
chr3,52686031,0.9189999606272502,5761,1992,7753,+
chr3,52686092,1.652097902097902,1049,519,1568,+
chr3,52686095,2.3071325111214214,2459,1174,3633,+
chr3,52686768,1.7805312653226557,2319,1266,3585,+
chr3,52686773,2.0320386648583364,4099,2241,6340,+
chr3,52686774,1.8942954085738952,5717,3231,8948,+
chr3,52686784,2.129792264820132,1200,763,1963,+
chr3,52686800,2.67663364900327,2287,1536,3823,+
chr3,52687281,0.6849094567404427,1103,851,1954,+
chr3,52687523,1.0741931497174675,2558,1998,4556,+
chr3,52688154,1.6618517641487094,1275,823,2098,+
chr3,52689173,1.1051031936932516,7260,5887,13147,+
chr3,52689174,1.4389858417262382,5543,4957,10500,+
chr3,52689175,1.0880154151610195,10747,8685,19432,+
chr3,52689176,1.4083688333104305,4234,3829,8063,+
chr3,52690606,1.5059055118110236,1121,761,1882,+
chr3,52690640,1.4698717073836494,1872,1292,3164,+
chr3,52690955,0.9255130228887136,2384,1447,3831,+
chr3,52690956,0.9255130228887136,2384,1447,3831,+
chr3,52691580,0.513826043237808,1021,883,1904,+
chr3,52692913,1.9241600213539756,1226,730,1956,+
chr3,52693191,0.6736497847986055,1212,912,2124,+
chr3,52693437,0.35501204372799705,957,770,1727,+
chr3,52693519,1.4945054945054943,1495,923,2418,+
chr3,52693774,1.5715959690649168,957,752,1709,+
chr3,52693790,2.4181132075471696,1067,847,1914,+
chr3,52693796,1.2386359484654779,3631,3027,6658,+
chr3,52693797,1.5366650648726574,2438,2080,4518,+
chr3,52694194,2.4812542603953647,727,651,1378,+
chr3,52706649,1.7280750247663499,1094,902,1996,+
chr3,52706656,0.6420727205610927,604,515,1119,+
chr3,52706659,1.6736401673640169,799,477,1276,+
chr3,52706808,0.6903732902735563,880,657,1537,+
chr3,52707744,1.5387120712401052,956,757,1713,+
chr3,57249531,1.5398097520578538,588,493,1081,+
chr3,57249534,2.5051545814264613,625,499,1124,+
chr3,57272460,2.312395775430795,959,513,1472,+
chr3,57272462,2.2065963502427595,658,361,1019,+
chr3,57272506,2.243984962406015,888,664,1552,+
chr3,57272508,2.6327130264446623,1343,1020,2363,+
chr3,57272509,2.7520383693045565,905,694,1599,+
chr3,57928629,1.947164695767508,992,709,1701,+
chr3,58112273,2.27971184114474,588,431,1019,+
chr3,58126655,2.425916246460061,733,585,1318,+
chr3,58126657,2.425916246460061,733,585,1318,+
chr3,58142699,2.0867188924457576,761,439,1200,+
chr3,58146835,1.968532525863076,1050,1011,2061,+
chr3,58146837,1.9725880984251005,1108,908,2016,+
chr3,58163156,1.0889580482264312,760,538,1298,+
chr3,58163159,1.0404834073652542,678,529,1207,+
chr3,58170828,2.0046748302416555,923,594,1517,+
chr3,58171076,1.2797202797202798,731,571,1302,+
chr3,68635969,2.481876332622601,581,468,1049,+
chr3,68636259,0.5790956661746948,663,513,1176,+
chr3,69085170,0.4219758922152566,624,474,1098,+
chr3,69101990,1.4065210836736246,3328,2503,5831,+
chr3,69101991,1.4065210836736246,3328,2503,5831,+
chr3,69101998,1.9281416787967003,810,686,1496,+
chr3,69102040,1.941343761109136,888,678,1566,+
chr3,69102043,0.917787501929107,1560,1184,2744,+
chr3,69104814,1.713718049274065,1169,801,1970,+
chr3,69104851,1.7292623038326038,622,492,1114,+
chr3,69104879,0.5014004413512138,694,547,1241,+
chr3,69104945,3.3431334622823985,595,516,1111,+
chr3,69967417,31.327036153811108,709,456,1165,+
chr3,75214696,1.7867331393334538,793,560,1353,+
chr3,75214871,0.5786946851752436,1047,766,1813,+
chr3,75214872,0.5786946851752436,1047,766,1813,+
chr3,75214999,1.0383064516129032,617,495,1112,+
chr3,75215000,1.0383064516129032,617,495,1112,+
chr3,96349757,0.5739199053067666,1038,684,1722,+
chr3,96349761,1.5086419753086417,1221,809,2030,+
chr3,96349762,0.5194750996939627,658,525,1183,+
chr3,96349948,0.8833825282994419,616,491,1107,+
chr3,96349951,0.9315778039326683,1055,779,1834,+
chr3,96350051,2.780067998300042,1067,723,1790,+
chr3,96350052,2.780067998300042,1067,723,1790,+
chr3,96350580,1.7873191939165527,1390,996,2386,+
chr3,96350582,1.8289104779291907,824,625,1449,+
chr3,96350599,0.5944343617664852,577,434,1011,+
chr3,96350600,1.4695945945945947,869,739,1608,+
chr3,96350736,1.0427807486631016,623,407,1030,+
chr3,96350738,1.0427807486631016,623,407,1030,+
chr3,100146979,2.176151141586007,612,474,1086,+
chr3,100162331,2.8088888888888888,631,389,1020,+
chr3,100167763,2.4122585489045116,861,636,1497,+
chr3,100167764,2.4122585489045116,861,636,1497,+
chr3,100354789,2.0175471309853585,812,613,1425,+
chr3,100355205,3.434930209517149,614,493,1107,+
chr3,100355206,2.180799045915325,891,558,1449,+
chr3,100355207,2.180799045915325,891,558,1449,+
chr3,100558552,3.049600968631575,673,443,1116,+
chr3,100709671,1.2754745782898178,668,576,1244,+
chr3,100709672,1.2861374645201322,700,559,1259,+
chr3,100713642,2.211536210780543,712,479,1191,+
chr3,100713653,1.1841826988642719,904,688,1592,+
chr3,100713665,2.2074838287071152,673,530,1203,+
chr3,100713667,1.7772727272727273,1471,879,2350,+
chr3,100713668,1.7772727272727273,1471,879,2350,+
chr3,100713682,0.5319308278867102,600,458,1058,+
chr3,100713695,1.9237948960302456,856,735,1591,+
chr3,100713787,1.4966887417218542,1129,754,1883,+
chr3,100732525,0.9141472868217055,1779,1074,2853,+
chr3,100732526,0.9141472868217055,1779,1074,2853,+
chr3,100732551,1.81971018129352,1183,838,2021,+
chr3,100732554,1.7126939912455232,1075,717,1792,+
chr3,100744847,1.7661913250148544,614,458,1072,+
chr3,100748156,2.0887949260042284,721,472,1193,+
chr3,100748175,2.1100091892213935,1166,796,1962,+
chr3,100748212,1.8375,1028,839,1867,+
chr3,100748213,2.1863376930677623,1509,1238,2747,+
chr3,100748280,1.5867040448538243,565,453,1018,+
chr3,100748404,1.7082178217821782,638,504,1142,+
chr3,101565758,2.3292113566618564,833,571,1404,+
chr3,101565869,1.8831060942154247,844,550,1394,+
chr3,101574234,4.622843764896046,615,522,1137,+
chr3,101579853,1.5759055759055758,703,467,1170,+
chr3,101579888,2.1946169772256727,529,482,1011,+
chr3,101579892,1.758985200845666,703,472,1175,+
chr3,101579930,0.600910125142207,833,585,1418,+
chr3,101585450,2.493858551013292,1695,1225,2920,+
chr3,101585453,1.2694783607442464,1245,1087,2332,+
chr3,101585454,0.8586550435865504,590,437,1027,+
chr3,101585462,2.3114741314170426,1268,812,2080,+
chr3,101585467,0.5134121178015382,1931,1776,3707,+
chr3,101585469,0.5134121178015382,1931,1776,3707,+
chr3,101585489,2.0763187429854097,1257,917,2174,+
chr3,101590214,2.625963302752293,3242,2724,5966,+
chr3,101590216,2.625963302752293,3242,2724,5966,+
chr3,101592658,2.4975776139392147,739,489,1228,+
chr3,101592661,2.9426229508196724,717,426,1143,+
chr3,101592662,2.9426229508196724,717,426,1143,+
chr3,101592757,1.833527696793003,661,342,1003,+
chr3,101592783,7.181287770773092,2576,2235,4811,+
chr3,101592784,7.580125648771685,4257,3363,7620,+
chr3,101592799,9.340752145453925,3324,3211,6535,+
chr3,101592824,3.6577105888566153,802,1081,1883,+
chr3,101593979,0.5634469696969697,849,479,1328,+
chr3,101758344,2.6188703153315895,770,552,1322,+
chr3,107772792,2.133973710819009,937,515,1452,+
chr3,107772854,4.667884322678843,901,656,1557,+
chr3,107801138,3.0971033580693605,862,722,1584,+
chr3,107807526,0.9885222381635581,688,594,1282,+
chr3,107807527,0.9885222381635581,688,594,1282,+
chr3,107807564,1.489071038251366,544,487,1031,+
chr3,107807568,2.0079291044776117,573,535,1108,+
chr3,107807827,70.70550256403081,699,640,1339,+
chr3,111859524,2.542235082728969,755,409,1164,+
chr3,111859547,2.2374817453857436,857,546,1403,+
chr3,111884538,0.4181459566074951,741,363,1104,+
chr3,111884542,1.9536601062255543,2114,1220,3334,+
chr3,111884622,1.7028072848968372,1162,998,2160,+
chr3,111884623,1.6827058943557296,1757,1381,3138,+
chr3,111976038,1.5385248178758384,640,462,1102,+
chr3,111991623,1.6194042557620336,2162,1134,3296,+
chr3,111991628,1.8584831899921812,2376,1278,3654,+
chr3,111991630,1.8584831899921812,2376,1278,3654,+
chr3,111991666,2.3721307048339177,1097,528,1625,+
chr3,111991711,1.7156040756914122,1900,1144,3044,+
chr3,111991716,1.612093909481067,5463,3587,9050,+
chr3,111991718,1.92793750101653,4134,2752,6886,+
chr3,113811615,3.0636604774535807,692,434,1126,+
chr3,113811623,0.50859291084855,946,531,1477,+
chr3,113811625,0.5661259501747815,1758,950,2708,+
chr3,113811642,1.9010248666927234,1884,1232,3116,+
chr3,113811657,1.7295138888888888,878,539,1417,+
chr3,113811663,1.8810550727150568,1577,1072,2649,+
chr3,113811675,1.7641144624903324,2280,1723,4003,+
chr3,113811676,1.7641144624903324,2280,1723,4003,+
chr3,113811692,3.1505041246562793,1321,1090,2411,+
chr3,113811740,3.0561877845216547,785,582,1367,+
chr3,119500790,1.2709223042279947,648,510,1158,+
chr3,119504009,2.0093865236339257,665,470,1135,+
chr3,119513663,1.774617953648416,1168,722,1890,+
chr3,119513664,1.774617953648416,1168,722,1890,+
chr3,119517207,1.9238788637301087,2001,1192,3193,+
chr3,119517221,1.449861828431443,2842,1825,4667,+
chr3,119517224,1.547503755901725,3097,2062,5159,+
chr3,119517229,1.6490799404628618,3501,2448,5949,+
chr3,119517230,1.6490799404628618,3501,2448,5949,+
chr3,119517236,1.5667718868775364,2210,1633,3843,+
chr3,119517239,1.3967344740642824,2427,1835,4262,+
chr3,119523619,1.2115072276903291,972,656,1628,+
chr3,119523734,1.8856022808268,813,487,1300,+
chr3,119523918,0.2665770609318996,594,431,1025,+
chr3,120596337,1.175781366924155,914,570,1484,+
chr3,120596340,2.5596126239797052,723,544,1267,+
chr3,120596371,1.4747199999999998,708,499,1207,+
chr3,120596426,1.7180553640371525,2445,1712,4157,+
chr3,120596428,1.5490669593852906,1028,910,1938,+
chr3,120596476,0.5331032412965186,1145,951,2096,+
chr3,120596507,1.4072645739910312,1325,1114,2439,+
chr3,120601110,1.4386317907444668,1286,1064,2350,+
chr3,120601112,1.1361377151927265,2453,1821,4274,+
chr3,120601232,1.7884162222497826,1029,732,1761,+
chr3,120601237,2.6500175049597385,810,450,1260,+
chr3,120601240,2.037360320472275,1027,764,1791,+
chr3,120601242,1.7155388471177944,961,545,1506,+
chr3,120602210,1.7335428484056397,2130,1471,3601,+
chr3,120602211,1.7127108960139812,727,550,1277,+
chr3,120602214,1.478675234370434,4744,3152,7896,+
chr3,120602215,1.438769669287291,5393,3493,8886,+
chr3,120602216,1.4489967027212667,7407,4893,12300,+
chr3,120602217,1.423331811200133,4160,2724,6884,+
chr3,120602237,1.5457457873933846,1160,1044,2204,+
chr3,120806591,0.6548880289285035,1997,1432,3429,+
chr3,120806592,0.6282384496666895,2282,1638,3920,+
chr3,120806593,0.6548880289285035,1997,1432,3429,+
chr3,122384276,0.2811860940695297,549,488,1037,+
chr3,122384277,0.2811860940695297,549,488,1037,+
chr3,122402848,1.7016260162601626,643,491,1134,+
chr3,122402858,2.082089552238806,629,468,1097,+
chr3,122404259,2.247213154043019,904,730,1634,+
chr3,122404278,2.503968253968254,630,449,1079,+
chr3,122407302,0.5281045751633987,807,569,1376,+
chr3,122407321,1.9748943574446929,680,446,1126,+
chr3,122407366,1.5696302124311567,854,557,1411,+
chr3,122409776,1.8571428571428568,710,473,1183,+
chr3,122409781,1.9870626286386357,653,536,1189,+
chr3,122409873,2.032397928459593,674,436,1110,+
chr3,122409874,2.24439954309091,1278,917,2195,+
chr3,124738102,1.8730904900722556,1095,802,1897,+
chr3,124738103,1.4656170409817084,843,616,1459,+
chr3,124738104,1.0991352035435562,578,430,1008,+
chr3,124738116,1.4261951272401836,1334,1007,2341,+
chr3,124738117,2.0415959252971136,739,588,1327,+
chr3,124738120,1.0172012740560654,4366,3192,7558,+
chr3,124738121,1.0172012740560654,4366,3192,7558,+
chr3,124738143,1.5987874299995366,704,696,1400,+
chr3,124738222,1.5954952977407861,653,445,1098,+
chr3,126852659,3.406908197570764,870,600,1470,+
chr3,126852698,2.558204255642637,1068,533,1601,+
chr3,126852700,1.8820039677628553,1147,747,1894,+
chr3,126852710,1.9337853190604788,1096,593,1689,+
chr3,126914684,0.5520215337288508,772,443,1215,+
chr3,126914685,2.0960636007287583,1388,920,2308,+
chr3,126914686,2.0960636007287583,1388,920,2308,+
chr3,126914688,1.8653626556685516,1826,1110,2936,+
chr3,126914689,1.975416435012997,4189,2865,7054,+
chr3,126914690,1.9178375942044479,3632,2707,6339,+
chr3,126914691,1.9001472152920569,5238,4003,9241,+
chr3,126914692,2.523776592852456,5499,4122,9621,+
chr3,126914693,2.5166130052697793,4711,3534,8245,+
chr3,127599370,0.8886697348235811,810,467,1277,+
chr3,127599372,0.8886697348235811,810,467,1277,+
chr3,127604638,2.8020482240082965,654,405,1059,+
chr3,127604639,2.3152728214551614,1080,687,1767,+
chr3,127605013,1.049753151794412,740,462,1202,+
chr3,127605078,1.2756810345479144,609,489,1098,+
chr3,127606621,0.5158687441796257,656,440,1096,+
chr3,127606692,2.23342670401494,735,611,1346,+
chr3,127606694,2.23342670401494,735,611,1346,+
chr3,127608485,2.0915255294935373,908,656,1564,+
chr3,127608845,1.8111111111111111,1140,719,1859,+
chr3,127608847,1.8872921977126205,1971,1355,3326,+
chr3,127608930,1.3283300690189475,1517,1021,2538,+
chr3,127608958,2.5275621118012417,765,643,1408,+
chr3,127615889,2.27962128872139,799,472,1271,+
chr3,127616890,0.33583754086736,681,515,1196,+
chr3,127619172,2.2351262019230766,782,511,1293,+
chr3,127619173,2.2351262019230766,782,511,1293,+
chr3,127619177,1.8830693394428795,795,519,1314,+
chr3,127619231,2.631894131422561,1649,1216,2865,+
chr3,127619245,2.947878787878788,607,524,1131,+
chr3,127620706,1.9440620782726048,1225,779,2004,+
chr3,127620708,1.3533090864749164,1981,1390,3371,+
chr3,127620728,2.8494867149758454,754,413,1167,+
chr3,127620734,0.6522791448164583,1077,813,1890,+
chr3,127620736,1.818771501904865,3797,2520,6317,+
chr3,127620737,1.7541945114403503,6274,4552,10826,+
chr3,127620739,1.6904145077720207,3464,2894,6358,+
chr3,127620740,1.5605725085655429,2471,2122,4593,+
chr3,127620746,1.3911822201977644,1465,1350,2815,+
chr3,127620848,1.4408072225338486,1003,777,1780,+
chr3,127621105,0.6348684210526316,578,455,1033,+
chr3,127621156,2.0801410482449114,926,733,1659,+
chr3,127621158,1.9629976741525372,1759,1264,3023,+
chr3,127621668,1.834032012195122,1124,983,2107,+
chr3,127621669,1.7259998651471522,1875,1458,3333,+
chr3,127621674,1.757034298623947,589,540,1129,+
chr3,127621877,2.858728439325834,1061,837,1898,+
chr3,127622001,2.4802631578947367,695,455,1150,+
chr3,127622009,1.8408000000000002,707,499,1206,+
chr3,127622039,1.4005523901995187,1805,1377,3182,+
chr3,127622330,1.053717689607489,761,552,1313,+
chr3,127622332,1.053717689607489,761,552,1313,+
chr3,127639365,4.140613313388183,691,381,1072,+
chr3,127639366,4.140613313388183,691,381,1072,+
chr3,127639398,2.5059571333115853,720,464,1184,+
chr3,127639481,1.7897091722595078,703,446,1149,+
chr3,127660384,2.381859756097561,624,409,1033,+
chr3,127660419,2.980392156862745,607,407,1014,+
chr3,127660560,3.9446164702790005,1362,1074,2436,+
chr3,127660561,3.6981788418252513,582,542,1124,+
chr3,127660603,2.6469579622511046,718,613,1331,+
chr3,127661012,1.359384197407948,933,771,1704,+
chr3,127661013,0.9774951076320938,554,510,1064,+
chr3,127661045,1.0302287581699348,872,611,1483,+
chr3,127661046,1.0302287581699348,872,611,1483,+
chr3,127661106,2.03584229390681,993,755,1748,+
chr3,127661107,2.03584229390681,993,755,1748,+
chr3,127671572,1.2916237034980496,773,501,1274,+
chr3,127672286,0.903913043478261,566,599,1165,+
chr3,127672288,0.903913043478261,566,599,1165,+
chr3,127672289,2.24466213453708,607,529,1136,+
chr3,127672307,2.2389164103189643,1707,2273,3980,+
chr3,127672308,1.5915306195194985,832,1078,1910,+
chr3,127672309,2.3781688341402702,2332,2548,4880,+
chr3,127672310,2.2657419683834776,917,1324,2241,+
chr3,127672311,2.3500749625187405,989,666,1655,+
chr3,127672425,12.65264973525793,1045,732,1777,+
chr3,127672426,13.400706536180396,1277,952,2229,+
chr3,127672427,12.560177407195528,1402,1039,2441,+
chr3,127672436,7.626902125813771,747,813,1560,+
chr3,128052850,0.5300711237891061,650,488,1138,+
chr3,128052864,2.949553299572003,1292,986,2278,+
chr3,128052866,2.9863636363636363,656,483,1139,+
chr3,128056710,1.6472632451280138,809,596,1405,+
chr3,128056732,1.2910953005350334,1078,734,1812,+
chr3,128060553,1.1005903939236383,1166,813,1979,+
chr3,128066999,2.7545642941043367,1037,690,1727,+
chr3,128067001,2.9076479076479083,779,461,1240,+
chr3,128069873,0.5983224603914259,962,665,1627,+
chr3,128070052,1.8086608927381749,616,394,1010,+
chr3,128070152,2.7777310924369747,600,594,1194,+
chr3,128070154,2.7777310924369747,600,594,1194,+
chr3,128070216,1.541946902654867,846,564,1410,+
chr3,128070631,3.1923383878691136,749,536,1285,+
chr3,128070632,3.1923383878691136,749,536,1285,+
chr3,128070683,2.2164446410450944,993,766,1759,+
chr3,128070748,2.858749315187225,654,507,1161,+
chr3,128071372,1.559239074877333,879,609,1488,+
chr3,128071582,8.99009322194029,1531,1030,2561,+
chr3,128071584,6.656669107663783,1083,675,1758,+
chr3,128071602,8.456494366587256,1561,1486,3047,+
chr3,128071603,8.225106624160935,1821,1847,3668,+
chr3,128071604,8.654507884816507,1397,1456,2853,+
chr3,128726183,0.6197914456693143,1234,906,2140,+
chr3,128726191,0.6980937311121828,1154,610,1764,+
chr3,128726192,0.5863941167268135,2329,1357,3686,+
chr3,128795361,0.8298909925415949,525,497,1022,+
chr3,128795363,0.8298909925415949,525,497,1022,+
chr3,128806423,1.8343761501656235,814,682,1496,+
chr3,128806478,1.6530025714717895,682,600,1282,+
chr3,128806529,2.4399168399168403,651,480,1131,+
chr3,128807575,1.2410672894117865,991,644,1635,+
chr3,128807578,1.6625766871165644,1354,814,2168,+
chr3,128807580,1.6625766871165644,1354,814,2168,+
chr3,128807586,2.0241059079233352,787,481,1268,+
chr3,128807593,1.865934065934066,565,454,1019,+
chr3,128807594,1.1452671077835892,1530,1122,2652,+
chr3,128813358,1.17155507158859,1724,1209,2933,+
chr3,128813359,0.8287470387744467,1935,1377,3312,+
chr3,128813378,2.937140998961192,1116,897,2013,+
chr3,128813389,2.0206736152984752,633,610,1243,+
chr3,128813392,1.616554054054054,692,671,1363,+
chr3,128813608,2.3641795865633073,828,700,1528,+
chr3,128813913,0.5145354021758517,576,533,1109,+
chr3,128813939,0.3321818058660164,612,398,1010,+
chr3,128813961,0.5693536673928832,783,560,1343,+
chr3,128814151,1.8808823368497853,971,671,1642,+
chr3,128814413,4.290970772442589,608,478,1086,+
chr3,128814414,4.290970772442589,608,478,1086,+
chr3,128912694,2.5387986098136346,843,606,1449,+
chr3,128912944,26.81860959282587,815,472,1287,+
chr3,128912946,24.06250939980504,670,405,1075,+
chr3,129249709,2.200983803209285,648,403,1051,+
chr3,129249718,2.419198817506185,789,524,1313,+
chr3,129250709,3.054325259515571,678,509,1187,+
chr3,129250710,3.054325259515571,678,509,1187,+
chr3,129252304,1.3372444962202494,887,602,1489,+
chr3,129254687,2.039329702388657,2007,1498,3505,+
chr3,129254688,1.8552547455096418,4037,3008,7045,+
chr3,129254690,1.642206537633999,4224,3081,7305,+
chr3,129254691,1.541417863041545,3449,2777,6226,+
chr3,129254693,1.5970347294334832,2355,1925,4280,+
chr3,129254694,1.9526363226678685,1110,633,1743,+
chr3,129256133,2.2922897650029133,637,541,1178,+
chr3,129256135,2.2835402828271545,1031,836,1867,+
chr3,129257522,1.1767087724129806,1023,845,1868,+
chr3,129257523,1.0464204994277793,1519,1265,2784,+
chr3,129257769,1.23780676911724,703,534,1237,+
chr3,129260340,2.5995623632385123,703,456,1159,+
chr3,129260342,2.5995623632385123,703,456,1159,+
chr3,129260346,2.5152129817444218,559,492,1051,+
chr3,129260347,2.5152129817444218,559,492,1051,+
chr3,129263938,1.7310393258426966,985,711,1696,+
chr3,129263939,1.7310393258426966,985,711,1696,+
chr3,129265559,0.9733367031022936,1184,968,2152,+
chr3,129265560,0.9733367031022936,1184,968,2152,+
chr3,129265691,2.574075968065673,886,566,1452,+
chr3,129267941,2.7310890631941436,836,549,1385,+
chr3,129268546,1.9283422208109506,1068,683,1751,+
chr3,129268931,2.8875644004444894,793,520,1313,+
chr3,129268932,2.8875644004444894,793,520,1313,+
chr3,129268952,2.2738837643209413,2361,1644,4005,+
chr3,129268953,2.2738837643209413,2361,1644,4005,+
chr3,129268963,2.5545787545787544,633,419,1052,+
chr3,129268967,2.5514570753478605,626,585,1211,+
chr3,129272263,1.0561754887935144,790,698,1488,+
chr3,129272264,1.0561754887935144,790,698,1488,+
chr3,129272397,2.2707024557395776,1135,617,1752,+
chr3,129272398,2.2707024557395776,1135,617,1752,+
chr3,129272818,2.596437136005481,688,416,1104,+
chr3,129272830,3.1596153846153854,794,519,1313,+
chr3,129272844,1.7738951695786231,862,555,1417,+
chr3,129272852,1.677971151574842,1865,1206,3071,+
chr3,129277295,5.306685307574988,970,561,1531,+
chr3,129277296,5.306685307574988,970,561,1531,+
chr3,129277341,1.8485593220338985,660,589,1249,+
chr3,129277646,1.0058173356602675,493,572,1065,+
chr3,129277647,1.0058173356602675,493,572,1065,+
chr3,130930478,3.3473557692307687,556,519,1075,+
chr3,130930479,3.3473557692307687,556,519,1075,+
chr3,130930491,0.9736346516007532,516,530,1046,+
chr3,130930492,0.9736346516007532,516,530,1046,+
chr3,130932053,2.0625984842883454,1303,1067,2370,+
chr3,130964050,0.9715330839060758,884,567,1451,+
chr3,130994076,9.518765133171913,628,412,1040,+
chr3,130994077,9.518765133171913,628,412,1040,+
chr3,133573999,0.49347608899026585,580,470,1050,+
chr3,133575047,0.5741256494077027,543,570,1113,+
chr3,133575053,0.3328249336870027,716,519,1235,+
chr3,133575055,0.3328249336870027,716,519,1235,+
chr3,133584079,6.670996190399629,3204,1069,4273,+
chr3,133584080,4.511178861788618,771,327,1098,+
chr3,133584081,7.2317835381120865,5387,1870,7257,+
chr3,133584082,8.679338254414198,4923,1831,6754,+
chr3,133584083,9.10732538330494,1781,586,2367,+
chr3,133584084,5.40015467904099,1090,430,1520,+
chr3,133584086,8.424121023678545,1482,903,2385,+
chr3,133584087,10.399075396933823,4581,3347,7928,+
chr3,133584088,10.399075396933823,4581,3347,7928,+
chr3,133588075,2.16341616860648,654,373,1027,+
chr3,133588157,0.4699423247559894,891,735,1626,+
chr3,133588158,0.9380501395947696,1226,962,2188,+
chr3,133588566,1.8967348851741916,1064,864,1928,+
chr3,133588567,1.8967348851741916,1064,864,1928,+
chr3,133588778,19.888682662443863,2043,1327,3370,+
chr3,133588779,13.169061762540158,2181,1481,3662,+
chr3,133588780,10.884313725490196,914,449,1363,+
chr3,133588952,1.1317899316121174,729,625,1354,+
chr3,133589061,0.4772374417789353,732,486,1218,+
chr3,133589808,1.6026299475449266,562,508,1070,+
chr3,133589978,4.712882266169015,795,594,1389,+
chr3,133819716,5.728698496710565,1777,1298,3075,+
chr3,133819717,5.355220982429833,1527,1104,2631,+
chr3,133819777,0.41510417542133093,861,586,1447,+
chr3,134532810,3.057110862262038,629,422,1051,+
chr3,134532811,3.057110862262038,629,422,1051,+
chr3,136316958,1.0012056908608633,691,571,1262,+
chr3,136316959,1.0012056908608633,691,571,1262,+
chr3,136316977,2.1061333881801536,941,701,1642,+
chr3,136326815,1.914205342145783,1091,784,1875,+
chr3,136327707,2.6688713798453727,611,438,1049,+
chr3,136946025,0.3092772103622579,726,522,1248,+
chr3,136946233,1.5738281384776793,616,406,1022,+
chr3,136948386,2.476873186550606,906,566,1472,+
chr3,136948387,2.476873186550606,906,566,1472,+
chr3,136948512,1.9997970779220782,656,447,1103,+
chr3,136948635,2.250013903526405,618,460,1078,+
chr3,136948639,1.2103644487599852,832,601,1433,+
chr3,136948874,3.899667361973103,898,571,1469,+
chr3,139346896,0.5659369792455688,878,573,1451,+
chr3,139346909,1.3901812437910166,916,683,1599,+
chr3,139346910,0.8374617067833697,597,456,1053,+
chr3,139346912,1.6634391548855834,605,421,1026,+
chr3,139348162,1.987159437683333,2744,2010,4754,+
chr3,139348164,2.0331761782066042,2680,2145,4825,+
chr3,139348165,1.8510369576767969,1831,1490,3321,+
chr3,139348172,1.5586575454857916,2555,1785,4340,+
chr3,139348173,1.5586575454857916,2555,1785,4340,+
chr3,139350998,2.303403238576243,1024,669,1693,+
chr3,139352705,2.439601425752177,883,586,1469,+
chr3,140976715,1.6090817064285414,646,431,1077,+
chr3,140977318,3.275076194597518,896,568,1464,+
chr3,140977897,18.38678900645195,648,393,1041,+
chr3,140978222,2.0066574380628683,627,416,1043,+
chr3,140979469,2.1207972054145094,683,490,1173,+
chr3,141447582,1.3002742261452127,2113,1192,3305,+
chr3,141447583,0.976506285218899,1407,768,2175,+
chr3,141447589,1.431365517241379,978,624,1602,+
chr3,141447609,1.1362689626625557,3703,2391,6094,+
chr3,141447611,0.5511286292754373,2610,1589,4199,+
chr3,141447612,1.5483624193162802,1407,889,2296,+
chr3,141447613,2.3814762623480856,2447,1968,4415,+
chr3,141447615,2.0404031438347343,3730,3036,6766,+
chr3,141447616,1.7347304806721868,2524,2081,4605,+
chr3,141745261,1.576766288707236,610,443,1053,+
chr3,141876801,1.9262467295168684,862,629,1491,+
chr3,141876862,0.6896764252696457,745,589,1334,+
chr3,141876880,0.5888947123223852,808,647,1455,+
chr3,141903622,1.6866671602013625,746,613,1359,+
chr3,141903634,1.8719280027691239,675,427,1102,+
chr3,141903645,1.6323024054982818,774,581,1355,+
chr3,141903673,0.5714285714285714,931,698,1629,+
chr3,141903720,0.6913364955357142,1165,895,2060,+
chr3,141907183,1.5125951586690616,1504,865,2369,+
chr3,141907221,1.369096909690969,2231,1514,3745,+
chr3,141913669,2.035468693449149,1405,920,2325,+
chr3,141913672,1.4851865773646802,1524,991,2515,+
chr3,141913721,0.7140957446808511,1610,1127,2737,+
chr3,141915970,0.6062323913600274,1267,900,2167,+
chr3,141922050,1.8012368260604474,1319,800,2119,+
chr3,141925541,1.1385248482077583,2229,1465,3694,+
chr3,141925681,1.2968696526351815,2224,1460,3684,+
chr3,141925845,1.530169491525424,1627,1099,2726,+
chr3,141925908,1.9071203528670448,817,689,1506,+
chr3,141925977,1.6290351664908886,2106,1640,3746,+
chr3,143022551,0.5491844473888609,600,508,1108,+
chr3,143022572,1.230667605189555,1281,993,2274,+
chr3,143022578,0.5358799454297408,981,732,1713,+
chr3,143022582,1.7912079900852955,1169,956,2125,+
chr3,143022583,1.7912079900852955,1169,956,2125,+
chr3,143028519,1.9488339714584053,1017,675,1692,+
chr3,143028521,2.2328150179722255,1870,1284,3154,+
chr3,143028522,2.276223453370268,1048,721,1769,+
chr3,143028539,1.8264705882352938,643,475,1118,+
chr3,143036081,2.358783387257865,649,500,1149,+
chr3,143037285,1.957482533368396,686,493,1179,+
chr3,143050987,0.5899363794100636,611,398,1009,+
chr3,143051031,2.9271523178807946,584,452,1036,+
chr3,143055078,2.1097220743571277,690,434,1124,+
chr3,143056384,9.524090892480432,635,478,1113,+
chr3,150552359,1.0996038483305035,803,557,1360,+
chr3,150552360,1.0996038483305035,803,557,1360,+
chr3,150552373,2.1435160986159687,871,727,1598,+
chr3,150552396,1.732514442761793,1342,848,2190,+
chr3,150552397,0.5863581730769232,886,639,1525,+
chr3,150552398,1.732514442761793,1342,848,2190,+
chr3,150552405,0.2991343834255712,526,485,1011,+
chr3,150562549,2.040389175047012,733,452,1185,+
chr3,150562560,1.7754010695187166,580,475,1055,+
chr3,150562625,1.733798755501594,1007,598,1605,+
chr3,150563521,0.5443802521008403,690,475,1165,+
chr3,150563601,1.8174388489208635,830,694,1524,+
chr3,150567921,0.8650000000000001,1037,819,1856,+
chr3,150567922,0.8650000000000001,1037,819,1856,+
chr3,150567951,1.5913513513513513,1103,674,1777,+
chr3,150567956,2.1000691407330327,1848,1254,3102,+
chr3,150568190,3.5946107784431143,620,500,1120,+
chr3,150568269,1.7638965327462852,640,473,1113,+
chr3,150572260,1.768147145669291,870,507,1377,+
chr3,150572335,1.7632000789168658,1323,942,2265,+
chr3,150572357,0.6437978426874055,2071,1484,3555,+
chr3,150581622,1.7472222222222222,628,485,1113,+
chr3,150581678,0.6575757575757576,1022,791,1813,+
chr3,150583224,2.3818525519848768,664,528,1192,+
chr3,150583228,2.28502946169979,714,588,1302,+
chr3,150583861,1.601877565805361,1082,807,1889,+
chr3,150583940,1.5593443486274767,1973,1380,3353,+
chr3,150583984,1.4926000934725034,1473,916,2389,+
chr3,150583987,1.8805970149253728,1007,669,1676,+
chr3,150584096,1.2079724437859003,3670,1960,5630,+
chr3,150584126,1.7032640949554896,2435,2021,4456,+
chr3,150622418,2.7124349218064316,829,499,1328,+
chr3,150622426,3.1441504178272983,644,358,1002,+
chr3,150622428,3.1441504178272983,644,358,1002,+
chr3,150622430,1.839014965451747,619,473,1092,+
chr3,150627722,3.0248847997271766,914,593,1507,+
chr3,150627729,1.700666306726981,738,512,1250,+
chr3,150628271,1.8043577831577569,765,526,1291,+
chr3,152299554,4.6164466048410775,650,501,1151,+
chr3,152462836,5.018644094661287,754,469,1223,+
chr3,152463810,1.7861863464694214,789,607,1396,+
chr3,152463928,2.725526432849957,572,438,1010,+
chr3,152465114,2.2307531788067694,1642,1186,2828,+
chr3,155903946,2.5782554627820216,630,432,1062,+
chr3,155906247,2.0003574300777407,1091,588,1679,+
chr3,155910695,1.4742482230727176,1283,619,1902,+
chr3,155910702,0.5733315747823793,620,445,1065,+
chr3,155910706,1.441759336690212,3553,1812,5365,+
chr3,155910707,1.441759336690212,3553,1812,5365,+
chr3,155910711,1.8992272595405757,2322,1148,3470,+
chr3,155910712,1.5601429614374598,2136,1132,3268,+
chr3,155910713,1.8992272595405757,2322,1148,3470,+
chr3,155910715,1.890057670126874,2307,1274,3581,+
chr3,155910739,0.5978485838779957,1513,917,2430,+
chr3,155911253,1.9670658682634727,729,500,1229,+
chr3,155914442,1.7863108797049572,715,438,1153,+
chr3,155916098,0.6064030131826741,643,485,1128,+
chr3,155916177,0.5108773436381852,648,410,1058,+
chr3,155919239,2.4923747276688455,659,458,1117,+
chr3,155931810,2.4950683303624484,723,494,1217,+
chr3,155931811,2.4950683303624484,723,494,1217,+
chr3,155987605,1.727736364588037,826,449,1275,+
chr3,155987607,1.6277826213310085,835,369,1204,+
chr3,155987983,0.6346155963948475,806,626,1432,+
chr3,155987994,0.9571763741144848,1826,1227,3053,+
chr3,155987996,0.9571763741144848,1826,1227,3053,+
chr3,155988141,1.8400570354153625,1148,786,1934,+
chr3,155988142,1.8940455341506128,926,570,1496,+
chr3,156705210,50.285714285714285,807,201,1008,+
chr3,156705211,23.023000000000003,818,449,1267,+
chr3,156705212,15.522954880413977,2064,2460,4524,+
chr3,156705213,15.317990764032754,1863,2454,4317,+
chr3,156705214,13.783174384051726,1333,1759,3092,+
chr3,156705238,0.13378756982395523,350,683,1033,+
chr3,158537106,3.2033452009446455,637,401,1038,+
chr3,158537107,4.1644080159705155,618,418,1036,+
chr3,158649138,3.1758656979021125,760,593,1353,+
chr3,158652171,2.439617399867874,915,574,1489,+
chr3,158652177,2.186735474006116,672,435,1107,+
chr3,158652186,1.1615298281964948,1921,1187,3108,+
chr3,158652188,1.2015082552803191,2936,1947,4883,+
chr3,158652190,1.2715099180276581,1015,760,1775,+
chr3,158652193,0.4557155600866573,595,412,1007,+
chr3,158652212,2.7523425941147464,904,552,1456,+
chr3,158691855,1.949791921041921,907,731,1638,+
chr3,158692009,2.4952098081460967,685,455,1140,+
chr3,160399702,8.154816134910968,982,678,1660,+
chr3,160416314,1.7894895801872543,710,472,1182,+
chr3,160416379,0.6426802652564426,1224,721,1945,+
chr3,160416384,0.4014110429447853,1453,814,2267,+
chr3,160417752,1.2297714597934972,1036,593,1629,+
chr3,160419485,1.8653969270166455,665,567,1232,+
chr3,160419488,2.0940129900460915,1719,1409,3128,+
chr3,160419497,1.9445342016305431,1646,1711,3357,+
chr3,160419499,1.9445342016305431,1646,1711,3357,+
chr3,160423632,2.0963751330317004,749,642,1391,+
chr3,160424868,0.3238869761486445,984,536,1520,+
chr3,160424873,1.4532478632478631,693,584,1277,+
chr3,160424878,1.7683025591188855,793,685,1478,+
chr3,160424901,1.8613960470352764,959,570,1529,+
chr3,160424903,0.5844738355376654,1154,924,2078,+
chr3,160424994,0.38244170096021946,696,404,1100,+
chr3,160431044,1.863640491256585,968,714,1682,+
chr3,160433783,1.995646114822719,1070,843,1913,+
chr3,160434592,1.7370650183150185,606,415,1021,+
chr3,160434825,2.2750289671342303,883,701,1584,+
chr3,160434902,2.3688658790211954,753,836,1589,+
chr3,160434904,2.3688658790211954,753,836,1589,+
chr3,161234730,2.562110314159052,923,618,1541,+
chr3,161241093,2.07282251717354,807,594,1401,+
chr3,161241143,2.613369837954505,602,517,1119,+
chr3,161249462,1.985874613003096,932,759,1691,+
chr3,161249463,1.985874613003096,932,759,1691,+
chr3,161250273,2.644747064119592,730,560,1290,+
chr3,169966827,2.998951286490114,604,427,1031,+
chr3,169966829,4.768138468565628,777,533,1310,+
chr3,169975661,1.5046554278108486,838,648,1486,+
chr3,169977038,1.270532581721033,1132,806,1938,+
chr3,169982710,2.773785425101215,608,493,1101,+
chr3,169988298,0.3758948327476246,721,590,1311,+
chr3,169988299,0.3758948327476246,721,590,1311,+
chr3,169992766,2.4998575874161344,854,685,1539,+
chr3,169992872,4.224810974533905,1094,988,2082,+
chr3,169992873,3.7028001858571375,1718,1434,3152,+
chr3,169992909,0.32057245080500896,511,519,1030,+
chr3,169992911,0.32057245080500896,511,519,1030,+
chr3,169993090,3.9141865079365092,606,447,1053,+
chr3,170280277,0.6352040816326531,995,699,1694,+
chr3,170280296,1.5560903864152962,1057,830,1887,+
chr3,170280306,2.414035087719298,1203,1139,2342,+
chr3,170280309,1.4908033033033032,1221,665,1886,+
chr3,170303988,1.5278367560041768,631,396,1027,+
chr3,170304766,2.1102743402939845,743,457,1200,+
chr3,170305059,1.3527346741661292,736,569,1305,+
chr3,170496363,0.894056926910054,879,544,1423,+
chr3,172381074,0.4550375260142941,734,553,1287,+
chr3,172754550,1.1643549967213374,928,704,1632,+
chr3,172754551,2.4027767690224637,1026,716,1742,+
chr3,172754569,2.4840409048652003,667,460,1127,+
chr3,172762769,3.985111662531018,656,402,1058,+
chr3,172762928,1.80103835558381,695,592,1287,+
chr3,172764322,0.35431877669100426,642,426,1068,+
chr3,172773909,2.3012862487124415,770,520,1290,+
chr3,172782170,0.584643367545797,674,536,1210,+
chr3,172784747,0.7307130994917216,725,640,1365,+
chr3,172784748,0.7307130994917216,725,640,1365,+
chr3,172802945,2.272759856630824,745,557,1302,+
chr3,172802946,2.272759856630824,745,557,1302,+
chr3,172807875,0.6235092986406472,786,570,1356,+
chr3,172816743,0.7075805123766374,3759,2247,6006,+
chr3,172816744,0.7092848659149564,3628,2209,5837,+
chr3,172816746,0.7979262791146449,3365,2033,5398,+
chr3,174377803,1.2180500849163836,780,628,1408,+
chr3,174377804,0.5166566925992421,924,556,1480,+
chr3,174377805,1.1370969315378834,1582,1165,2747,+
chr3,174377807,2.1880885122410545,714,707,1421,+
chr3,174377811,0.5698753462603878,632,379,1011,+
chr3,179367455,2.009162852670591,623,392,1015,+
chr3,179367541,1.0568762020341242,713,467,1180,+
chr3,179368036,2.7860119047619047,850,335,1185,+
chr3,179368037,2.7300191204588913,1297,522,1819,+
chr3,179368039,2.530471482273669,1424,731,2155,+
chr3,179368044,1.6674386289949052,899,507,1406,+
chr3,179368046,1.802070114213198,1376,787,2163,+
chr3,179368048,2.184474241354976,937,544,1481,+
chr3,179368051,0.6812526900452952,772,502,1274,+
chr3,179390036,0.368361581920904,651,589,1240,+
chr3,179390038,0.368361581920904,651,589,1240,+
chr3,179392037,1.3188230643284296,652,395,1047,+
chr3,179392693,1.6909600795765851,1456,708,2164,+
chr3,179392694,1.358099352051836,916,462,1378,+
chr3,179392742,1.8439820601426362,759,468,1227,+
chr3,179465052,0.7948184184501765,1079,853,1932,+
chr3,179465053,0.8197519151029586,961,743,1704,+
chr3,179465054,0.8197519151029586,961,743,1704,+
chr3,179569824,2.2835658914728683,1132,644,1776,+
chr3,179569826,2.0775224775224777,1732,1000,2732,+
chr3,179569827,1.8650537660524136,1541,921,2462,+
chr3,179569856,1.0438216560509554,1204,784,1988,+
chr3,179569857,1.0438216560509554,1204,784,1988,+
chr3,179569865,2.1785725470545865,1363,862,2225,+
chr3,179569867,2.1785725470545865,1363,862,2225,+
chr3,179569886,1.4965921764632988,928,562,1490,+
chr3,179570068,1.5754963427377215,977,637,1614,+
chr3,179570069,1.7137441411634957,1080,701,1781,+
chr3,179573424,1.53823294581885,670,562,1232,+
chr3,179576653,2.6534150005778345,655,508,1163,+
chr3,179576654,2.6534150005778345,655,508,1163,+
chr3,179586561,3.1485654395388445,780,567,1347,+
chr3,179586568,3.0052684904826976,657,462,1119,+
chr3,179614982,1.8642533936651584,617,441,1058,+
chr3,179614991,0.474234693877551,714,489,1203,+
chr3,179615025,0.4898582600195504,843,743,1586,+
chr3,179623941,1.8176086208873086,905,670,1575,+
chr3,179624295,1.3104125624226877,2570,1678,4248,+
chr3,179624368,1.6068214026603163,3050,2118,5168,+
chr3,180604975,2.129733435811577,789,473,1262,+
chr3,180604987,2.7097106849670314,1067,686,1753,+
chr3,180605801,1.8920270974465867,625,504,1129,+
chr3,180605805,2.4044229198272853,1388,1253,2641,+
chr3,180605806,2.4044229198272853,1388,1253,2641,+
chr3,180933343,2.1665532910470904,743,521,1264,+
chr3,180933346,2.647314949201742,767,688,1455,+
chr3,180933347,2.647314949201742,767,688,1455,+
chr3,180935162,0.5643633683434679,805,602,1407,+
chr3,180935173,1.6157439446366784,848,509,1357,+
chr3,180947873,2.1153947368421053,698,399,1097,+
chr3,180948346,1.635678391959799,650,397,1047,+
chr3,180948358,0.4454841521031146,606,506,1112,+
chr3,180948751,1.9017341040462428,657,345,1002,+
chr3,180948782,2.5109452736318407,720,535,1255,+
chr3,180948789,1.664506092818253,855,531,1386,+
chr3,180948790,1.7609649122807016,802,607,1409,+
chr3,180951413,1.842424242424242,607,527,1134,+
chr3,180951431,3.459915611814345,614,473,1087,+
chr3,180951453,1.6888554216867468,622,497,1119,+
chr3,180957834,2.0808750882145377,640,544,1184,+
chr3,180957846,2.2498509242695293,685,558,1243,+
chr3,180957851,2.2802157900197115,708,566,1274,+
chr3,180957854,2.1657616641867268,1943,1508,3451,+
chr3,180957887,1.9363229914645712,793,670,1463,+
chr3,180957910,1.4490365316099694,2437,1687,4124,+
chr3,180961498,1.9375558817727578,2158,1727,3885,+
chr3,180962913,1.5566050250763566,2427,1839,4266,+
chr3,180968232,2.1250303019656753,962,548,1510,+
chr3,180970157,1.8995068947472127,1781,1364,3145,+
chr3,180970159,1.9331575292140146,1794,1360,3154,+
chr3,180970160,2.0025833118057355,1223,947,2170,+
chr3,180970162,0.4949896097898869,793,609,1402,+
chr3,180970163,1.6314790705657505,2544,1860,4404,+
chr3,180970164,1.7050789506403086,1746,1148,2894,+
chr3,180970227,2.2651060070671383,776,565,1341,+
chr3,180970327,1.9850467289719627,648,534,1182,+
chr3,180975318,2.0534508202082002,720,582,1302,+
chr3,180976125,1.810502258574505,1501,1051,2552,+
chr3,180976126,2.4637161084529504,834,569,1403,+
chr3,180976600,47.18044034466989,922,337,1259,+
chr3,180976601,31.91535378052368,742,288,1030,+
chr3,180976604,10.955809025180752,444,763,1207,+
chr3,180976605,15.902346860830379,1633,2590,4223,+
chr3,180976606,15.902346860830379,1633,2590,4223,+
chr3,180976610,6.052135269323729,790,2036,2826,+
chr3,180976659,0.4065995662428675,903,1306,2209,+
chr3,180976861,3.6030236422516166,653,424,1077,+
chr3,184149763,4.247494230839427,790,615,1405,+
chr3,184149764,3.9822393822393827,572,517,1089,+
chr3,184149765,3.9822393822393827,572,517,1089,+
chr3,184149799,0.41382499133048206,715,421,1136,+
chr3,184149803,1.2574570693355904,1056,859,1915,+
chr3,184149808,0.5545053560176434,604,528,1132,+
chr3,184149809,1.6668928086838537,636,468,1104,+
chr3,184149810,1.6208530805687205,1025,632,1657,+
chr3,184149815,0.44505299657196895,752,618,1370,+
chr3,184149822,1.7461069149506188,2097,1556,3653,+
chr3,184149918,1.0556803995006243,905,584,1489,+
chr3,184149919,0.9316433414943126,2899,1941,4840,+
chr3,184149921,1.0928037383177571,1062,699,1761,+
chr3,184149923,1.230881352638112,4905,4388,9293,+
chr3,184149925,1.230881352638112,4905,4388,9293,+
chr3,184149928,1.0153393102752084,2392,3267,5659,+
chr3,184149929,1.0153393102752084,2392,3267,5659,+
chr3,184149930,1.2532272688023487,2618,1877,4495,+
chr3,184149947,0.6386350369207802,7923,8877,16800,+
chr3,184149948,0.7048162463081512,11902,12734,24636,+
chr3,184149949,0.958709595712039,23471,20770,44241,+
chr3,184149950,0.994853320031826,21789,18561,40350,+
chr3,184149951,1.2202255212505617,23392,17023,40415,+
chr3,184150021,0.7448028673835126,1038,743,1781,+
chr3,184150025,1.71893899204244,952,649,1601,+
chr3,184150040,1.9759122737481833,1771,1304,3075,+
chr3,184150041,1.6904804743274522,2923,2124,5047,+
chr3,184150044,1.3640503708814904,1145,934,2079,+
chr3,184150045,0.6163197946273036,1158,838,1996,+
chr3,184150049,1.9679869777536625,1208,1066,2274,+
chr3,184150223,0.7681235980002603,789,630,1419,+
chr3,184150224,0.8878962195299657,1572,1326,2898,+
chr3,184150225,1.0887207207207208,1078,874,1952,+
chr3,184150227,0.708978013029316,1193,920,2113,+
chr3,184150229,1.4941678324958614,1852,1520,3372,+
chr3,184150230,0.6374764803541781,846,694,1540,+
chr3,184150233,0.7248905309250135,1629,1217,2846,+
chr3,184150236,2.1645683453237408,1244,1250,2494,+
chr3,184150406,2.066440637639781,708,466,1174,+
chr3,184150407,2.217737495556266,911,691,1602,+
chr3,184150408,2.066440637639781,708,466,1174,+
chr3,184150429,1.3892590618336889,694,535,1229,+
chr3,184176953,0.8095723583598926,785,733,1518,+
chr3,184177006,1.6103531811806708,841,505,1346,+
chr3,184178886,1.683418510923681,2262,1355,3617,+
chr3,184178888,1.5970384373030877,1917,1057,2974,+
chr3,184178923,0.610360599936177,905,552,1457,+
chr3,184178929,0.5487892591704627,762,581,1343,+
chr3,184178989,1.6168635164103817,1686,1237,2923,+
chr3,184180193,0.7775213287722046,3429,2553,5982,+
chr3,184180214,1.9896485315358687,2203,1487,3690,+
chr3,184180851,0.3677154624751382,814,569,1383,+
chr3,184180865,1.8867362146050672,632,487,1119,+
chr3,184180891,1.6310471138057343,697,545,1242,+
chr3,184181123,1.8341307814992023,674,626,1300,+
chr3,184181125,1.65060364231635,948,542,1490,+
chr3,184181126,1.6092352092352094,696,524,1220,+
chr3,184181132,1.9761904761904758,995,611,1606,+
chr3,184181136,0.5213903743315508,779,577,1356,+
chr3,184181148,2.118426103646833,565,520,1085,+
chr3,184181174,2.7480967687362545,785,770,1555,+
chr3,184181180,1.430167133049952,3102,2128,5230,+
chr3,184181779,0.5643825301204819,1498,1055,2553,+
chr3,184181781,1.62723976109215,802,585,1387,+
chr3,184181967,1.9190710042309622,2345,1383,3728,+
chr3,184181981,0.5949050949050949,1587,923,2510,+
chr3,184182169,1.8070175438596494,1029,607,1636,+
chr3,184182216,2.0172225591267443,615,484,1099,+
chr3,184182229,1.7537313432835815,704,535,1239,+
chr3,184182757,2.040227272727273,1145,824,1969,+
chr3,184182758,2.040227272727273,1145,824,1969,+
chr3,184182781,1.9066291982204941,1766,1234,3000,+
chr3,184182788,1.7838467614533964,960,632,1592,+
chr3,184183821,2.0894179894179894,717,419,1136,+
chr3,184183855,2.2894736842105257,695,455,1150,+
chr3,184183986,1.5450581395348841,1062,687,1749,+
chr3,184299859,1.70039673336128,1086,776,1862,+
chr3,184299861,2.1001347968419024,860,576,1436,+
chr3,184300345,2.0192941751129565,688,430,1118,+
chr3,184301558,1.775925925925926,684,399,1083,+
chr3,184302436,1.8361768950004242,675,560,1235,+
chr3,184302498,1.289253994078454,1557,1029,2586,+
chr3,184302509,2.2486085343228197,908,587,1495,+
chr3,184302686,1.8780599196200218,708,475,1183,+
chr3,184302738,4.319654427645788,639,462,1101,+
chr3,184303438,1.0177558795070258,1145,783,1928,+
chr3,184303450,0.7332510414633783,1913,1223,3136,+
chr3,184303451,1.1412740151779917,2017,1391,3408,+
chr3,184303671,2.4363636363636365,803,494,1297,+
chr3,184303708,1.9025664068283763,1139,768,1907,+
chr3,184305798,1.6496633340134668,692,506,1198,+
chr3,184305825,2.5229779411764706,731,543,1274,+
chr3,184306385,2.0950991831971995,1196,856,2052,+
chr3,184306387,2.0950991831971995,1196,856,2052,+
chr3,184306766,2.3459658430024746,1590,1113,2703,+
chr3,184306768,2.3459658430024746,1590,1113,2703,+
chr3,184306793,1.4079222240077134,648,507,1155,+
chr3,184307414,2.0544544648479084,771,698,1469,+
chr3,184307451,0.4119457426194004,555,565,1120,+
chr3,184307677,0.48627648440982757,1149,748,1897,+
chr3,184307947,2.364152199074074,838,634,1472,+
chr3,184307952,1.1461823778794704,726,622,1348,+
chr3,184319721,1.279265060413829,733,476,1209,+
chr3,184319754,2.638940789473684,620,520,1140,+
chr3,184320631,2.5330316742081447,621,519,1140,+
chr3,184320632,2.5330316742081447,621,519,1140,+
chr3,184321511,3.059429666906303,750,641,1391,+
chr3,184321513,3.059429666906303,750,641,1391,+
chr3,184321901,3.588389173446611,1174,744,1918,+
chr3,184321903,2.896223923950356,913,540,1453,+
chr3,184322073,0.9070459024060362,945,683,1628,+
chr3,184322646,2.405252030711027,771,472,1243,+
chr3,184322679,1.5659823783509843,1922,1353,3275,+
chr3,184322688,1.9290060851926978,950,781,1731,+
chr3,184322690,1.6980628246832064,1398,957,2355,+
chr3,184322835,1.8622725036891288,630,427,1057,+
chr3,184322846,1.9856490541422045,760,656,1416,+
chr3,184322847,2.182248356943503,3225,2446,5671,+
chr3,184322849,2.0626550868486357,1462,1022,2484,+
chr3,184323087,0.842608695652174,626,574,1200,+
chr3,184323088,0.842608695652174,626,574,1200,+
chr3,184323118,0.28181184668989545,673,409,1082,+
chr3,184323431,2.772412932793816,954,597,1551,+
chr3,184323442,3.2400335008375207,666,397,1063,+
chr3,184323444,2.437989116960401,1487,1011,2498,+
chr3,184323446,2.030892448512586,709,436,1145,+
chr3,184323491,2.9729826444802283,1071,971,2042,+
chr3,184323492,2.9729826444802283,1071,971,2042,+
chr3,184323493,2.9729826444802283,1071,971,2042,+
chr3,184324217,1.9749696361620108,934,652,1586,+
chr3,184324218,1.9749696361620108,934,652,1586,+
chr3,184324226,1.9623193707700752,595,496,1091,+
chr3,184324955,2.188447752963882,634,402,1036,+
chr3,184325272,2.723644416321358,1093,726,1819,+
chr3,184325492,1.339214275997318,2379,1467,3846,+
chr3,184325494,1.463280814482293,940,540,1480,+
chr3,184325515,1.7979756445030994,3718,2330,6048,+
chr3,184325518,1.4307076101468623,1367,748,2115,+
chr3,184325553,1.6558295964125558,632,445,1077,+
chr3,184325857,2.599732596507426,755,594,1349,+
chr3,184326899,2.9600959760979486,1525,1056,2581,+
chr3,184326950,2.101207457620599,995,789,1784,+
chr3,184326953,0.6169354838709679,764,619,1383,+
chr3,184327216,1.6760431317393345,714,473,1187,+
chr3,184327299,10.099162671452287,2067,1380,3447,+
chr3,184327300,10.936215949366684,2192,1494,3686,+
chr3,184327301,10.099162671452287,2067,1380,3447,+
chr3,184327306,4.859184678153323,554,581,1135,+
chr3,184327644,2.269886363636364,845,527,1372,+
chr3,184327645,2.434342653453333,1072,726,1798,+
chr3,184327649,1.7974808603934251,702,521,1223,+
chr3,184327677,2.273681417346661,945,712,1657,+
chr3,184328637,1.918601799750224,1090,796,1886,+
chr3,184328638,2.0642722117202266,587,482,1069,+
chr3,184328665,1.6791605301914578,690,484,1174,+
chr3,184332004,1.3234245762618622,969,690,1659,+
chr3,184363526,2.0356652949245544,529,485,1014,+
chr3,184363552,1.4846049918225128,948,685,1633,+
chr3,184363553,1.6602992677491244,744,697,1441,+
chr3,184365008,0.4124579685055099,952,612,1564,+
chr3,184366734,2.633625358010831,1025,910,1935,+
chr3,184368269,1.3277675883726596,1000,723,1723,+
chr3,184368417,2.4032761310452417,1026,640,1666,+
chr3,184368418,2.2150244964616226,1564,1001,2565,+
chr3,184368420,2.1384393063583818,1056,691,1747,+
chr3,184368507,1.6301669860388726,793,561,1354,+
chr3,186572199,1.0776829815895823,999,654,1653,+
chr3,186572201,1.0776829815895823,999,654,1653,+
chr3,186572208,0.5441586519153621,1098,855,1953,+
chr3,186572219,1.0914939365677374,1034,891,1925,+
chr3,186575895,1.4612312607520277,1398,938,2336,+
chr3,186575896,0.3719357565511411,791,506,1297,+
chr3,186575924,1.5983827493261455,1185,688,1873,+
chr3,186582025,0.3993878512007534,726,553,1279,+
chr3,186582027,0.3993878512007534,726,553,1279,+
chr3,186582744,2.607065217391304,818,643,1461,+
chr3,186582745,2.607065217391304,818,643,1461,+
chr3,186583866,1.1122606136815303,662,468,1130,+
chr3,186584469,2.2143718428795305,603,544,1147,+
chr3,186783577,0.5524381148559859,548,760,1308,+
chr3,186783578,0.5524381148559859,548,760,1308,+
chr3,186783579,0.5524381148559859,548,760,1308,+
chr3,186783597,0.9769175801202531,2180,2043,4223,+
chr3,186783599,0.615099055190802,2549,2606,5155,+
chr3,186783600,0.610531192591554,2283,2037,4320,+
chr3,186783607,1.073927419155668,2550,2139,4689,+
chr3,186783608,1.5156897392152084,1156,745,1901,+
chr3,186783610,1.5210788889963218,1798,1736,3534,+
chr3,186784430,0.8003842199620532,3654,2641,6295,+
chr3,186784431,0.8928247987533544,2912,2044,4956,+
chr3,186784450,1.6898842285063578,1112,957,2069,+
chr3,186784454,1.3814943863724352,1621,1229,2850,+
chr3,186784576,1.3967147167281262,2231,1412,3643,+
chr3,186785892,0.8041944709246901,4217,3146,7363,+
chr3,186785950,0.791239620744015,5134,3768,8902,+
chr3,186786168,1.6311140182223014,3603,2258,5861,+
chr3,186786550,0.6782734300558964,8948,6210,15158,+
chr3,186787171,1.3952562408317404,3048,1900,4948,+
chr3,186787397,0.7317544604927781,732,534,1266,+
chr3,186787564,1.3297764227642277,2616,1967,4583,+
chr3,186787569,1.9930347773112216,5000,4181,9181,+
chr3,186789119,1.6321312752758552,542,476,1018,+
chr3,186789162,4.186862244897959,2625,2351,4976,+
chr3,186900363,1.3410315150764658,536,520,1056,+
chr3,186900370,0.4275851581600385,1195,906,2101,+
chr3,191358004,2.2440952601573203,639,482,1121,+
chr3,193662865,2.407925109002308,568,556,1124,+
chr3,193662866,2.3004327890201384,941,844,1785,+
chr3,193667237,1.4152939856336688,701,477,1178,+
chr3,194136464,2.0482189539869533,1203,880,2083,+
chr3,196587058,1.5142944941367023,1910,1452,3362,+
chr3,196587059,1.5142944941367023,1910,1452,3362,+
chr3,196587083,2.229437229437229,617,566,1183,+
chr3,196728035,2.596690389905252,1061,618,1679,+
chr3,196728036,2.596690389905252,1061,618,1679,+
chr3,196728037,2.596690389905252,1061,618,1679,+
chr3,196943368,0.45708890697879084,597,436,1033,+
chr3,197756438,0.8294251641431061,618,438,1056,+
chr3,197756440,1.7020128479657388,640,466,1106,+
chr3,197756441,2.8852185386006837,780,559,1339,+
chr3,197781983,3.3933968844454783,694,390,1084,+
chr3,197781984,3.3933968844454783,694,390,1084,+
chr3,197782229,2.611416352182514,722,515,1237,+
chr3,197782621,1.0474955023824588,1121,729,1850,+
chr3,197782671,3.610658603579442,875,629,1504,+
chr3,197950191,0.9215789055453244,2812,1986,4798,+
chr3,197950192,1.0590596920001665,11803,7858,19661,+
chr3,197950193,1.0313049405327803,14836,9570,24406,+
chr3,197950194,1.0298684248629018,17994,12310,30304,+
chr3,197950195,1.054157798948021,15733,10492,26225,+
chr3,197950196,1.0304237161106424,5283,4437,9720,+
chr3,197950197,0.8634811986811562,12177,9352,21529,+
chr3,197950207,1.2175224343342033,12768,9197,21965,+
chr3,197950957,0.7834973381043813,6785,5391,12176,+
chr3,197951156,0.8786757054307989,1331,958,2289,+
chr3,197951157,0.9962724520092894,708,434,1142,+
chr3,197951174,1.270458344844852,10363,6537,16900,+
chr3,197951232,1.3646524655960266,12301,7787,20088,+
chr3,197954031,1.2311096711622715,8875,6893,15768,+
chr3,197954051,3.2720720844428075,19697,16059,35756,+
chr3,197954055,1.1842607544797878,29341,19602,48943,+
chr4,1339217,5.818212201270251,4236,2560,6796,+
chr4,1339218,5.790109697799952,4368,2649,7017,+
chr4,1339219,4.110567008536199,4904,3135,8039,+
chr4,1339221,1.2738028169014082,1291,1135,2426,+
chr4,1339236,0.22081020547278216,906,651,1557,+
chr4,1740879,1.9634030418250947,728,525,1253,+
chr4,1740881,2.5024001442651445,947,637,1584,+
chr4,1740918,1.5338463545063254,783,560,1343,+
chr4,1935197,1.9031627793381365,1038,861,1899,+
chr4,1935198,2.1438885519823536,2134,1691,3825,+
chr4,1935200,2.2125272331154684,1068,917,1985,+
chr4,2490368,0.29103367484902526,1296,657,1953,+
chr4,2490370,0.31279461279461285,928,494,1422,+
chr4,2490391,0.9804061928014837,2138,1118,3256,+
chr4,2490393,1.2869270581226495,842,501,1343,+
chr4,2490405,1.9879256037198139,2038,1355,3393,+
chr4,2490406,1.9879256037198139,2038,1355,3393,+
chr4,2884643,2.573099415204678,799,539,1338,+
chr4,2884644,2.573099415204678,799,539,1338,+
chr4,2907786,2.9586310018275466,635,462,1097,+
chr4,2907790,2.040893786348332,843,593,1436,+
chr4,2907791,2.040893786348332,843,593,1436,+
chr4,6640683,0.938571676716544,1793,908,2701,+
chr4,6640684,0.9412220354159333,2970,1629,4599,+
chr4,6640747,0.8990384615384618,879,519,1398,+
chr4,6640748,0.8990384615384618,879,519,1398,+
chr4,6640923,2.7324093816631128,698,468,1166,+
chr4,6640929,2.1242914979757086,953,569,1522,+
chr4,6640938,2.245656177436144,757,542,1299,+
chr4,6640971,1.9875111507582517,556,471,1027,+
chr4,6641037,1.6765957446808508,787,469,1256,+
chr4,6641058,1.8576052814757507,1034,827,1861,+
chr4,6641096,1.1176731418918922,1230,739,1969,+
chr4,6641097,1.3611612294082416,1783,1200,2983,+
chr4,6641101,0.6057725869244194,777,572,1349,+
chr4,6641110,0.39256415161313507,1589,1077,2666,+
chr4,6641178,1.4956346083465366,1689,1160,2849,+
chr4,6641226,1.188412441157311,1534,1140,2674,+
chr4,6641742,2.3941176470588235,879,679,1558,+
chr4,6641753,1.927139037433155,743,543,1286,+
chr4,6641771,1.9776594439328934,3097,2325,5422,+
chr4,6642106,1.923563162501216,1289,790,2079,+
chr4,6642148,1.6247778624016247,1199,908,2107,+
chr4,6642240,1.5042223786066151,1349,881,2230,+
chr4,6642259,1.5371621621621618,909,767,1676,+
chr4,6642447,1.4921827099938687,1179,931,2110,+
chr4,6642450,1.7307963354474982,1227,989,2216,+
chr4,6642596,1.4033334474143535,1205,957,2162,+
chr4,6693875,0.9458054195040692,4176,3521,7697,+
chr4,6693876,0.9608163625469207,5841,4874,10715,+
chr4,6693877,0.8656318037481848,11724,8536,20260,+
chr4,6693879,0.7172104483265368,9745,6621,16366,+
chr4,6693960,2.649462365591398,1567,1049,2616,+
chr4,6696899,1.5030404932044283,1218,792,2010,+
chr4,6696905,2.0575268817204297,1245,839,2084,+
chr4,6696915,2.1540930979133224,731,533,1264,+
chr4,6696917,1.6072353811991118,2395,1929,4324,+
chr4,6696919,1.4723160711997332,5337,3838,9175,+
chr4,6697012,1.46232508073197,1572,928,2500,+
chr4,6697035,1.5515429444922135,1623,1162,2785,+
chr4,8174883,1.4259910823132564,938,724,1662,+
chr4,13337743,1.0131038102588572,539,520,1059,+
chr4,13337744,2.152339049608191,738,611,1349,+
chr4,13337752,2.21476846057572,1105,798,1903,+
chr4,13337754,2.21476846057572,1105,798,1903,+
chr4,13337757,0.42827538567810275,774,504,1278,+
chr4,17606873,1.047482890489156,768,523,1291,+
chr4,17607587,1.892449807510762,627,426,1053,+
chr4,17823011,1.5018201971932406,626,479,1105,+
chr4,17828307,0.28728728728728725,655,443,1098,+
chr4,17828309,0.28728728728728725,655,443,1098,+
chr4,17834350,2.899574401338978,710,471,1181,+
chr4,25914304,4.3772749547966265,694,309,1003,+
chr4,25914320,2.069542037010847,1098,637,1735,+
chr4,25914321,2.9833333333333334,715,339,1054,+
chr4,25914338,1.109643453873739,2537,1707,4244,+
chr4,25914339,1.1181396916336674,1251,912,2163,+
chr4,25914352,2.1779220779220783,859,615,1474,+
chr4,25914353,1.7477302204928662,879,513,1392,+
chr4,25914355,1.5734198732807914,978,718,1696,+
chr4,25914359,1.8256978334399434,2124,1519,3643,+
chr4,25914362,1.4774164465655102,3612,2732,6344,+
chr4,39698333,0.24205219699276953,572,826,1398,+
chr4,39698334,0.2805307520523326,485,636,1121,+
chr4,39745782,2.5828740474198617,659,479,1138,+
chr4,39781642,1.8173908364083637,881,474,1355,+
chr4,39781664,2.486371404905514,967,609,1576,+
chr4,39781678,1.729776247848537,602,497,1099,+
chr4,41494538,1.0301176470588236,596,424,1020,+
chr4,41494540,1.0301176470588236,596,424,1020,+
chr4,41494590,1.7387994780339278,614,483,1097,+
chr4,41524421,2.21064667767755,579,462,1041,+
chr4,41598932,0.58048,906,624,1530,+
chr4,41613495,1.7466063348416287,578,458,1036,+
chr4,41619327,0.2672097759674135,655,490,1145,+
chr4,41619328,1.8617155870445343,544,493,1037,+
chr4,41644584,1.8077837840371767,543,468,1011,+
chr4,41646230,2.233062330623306,823,737,1560,+
chr4,41646515,2.3868319913713987,1048,686,1734,+
chr4,41646518,2.3129033858713157,2138,1452,3590,+
chr4,41646519,2.3129033858713157,2138,1452,3590,+
chr4,41646584,1.8325877323789643,708,478,1186,+
chr4,41650482,2.3661071143085532,591,416,1007,+
chr4,41650515,2.4883599540661865,807,617,1424,+
chr4,41666615,2.2249520153550866,643,520,1163,+
chr4,41680083,0.41657175398633256,664,438,1102,+
chr4,41682436,2.3949074074074077,738,539,1277,+
chr4,41684400,2.982535885167464,958,417,1375,+
chr4,41684402,2.982535885167464,958,417,1375,+
chr4,41684493,2.5740445859872607,914,627,1541,+
chr4,41684495,2.5740445859872607,914,627,1541,+
chr4,41685717,1.7706978760294754,1139,768,1907,+
chr4,41685718,0.6694433017962429,1654,1121,2775,+
chr4,41685720,0.6694433017962429,1654,1121,2775,+
chr4,41685724,1.5718485710467536,1496,1068,2564,+
chr4,41685727,1.9356833642547933,1564,1154,2718,+
chr4,41685731,0.5170940170940171,846,545,1391,+
chr4,41685734,1.6534247789601297,4426,3185,7611,+
chr4,41685747,1.2984269467079177,2503,2164,4667,+
chr4,41685752,1.713164225720677,2705,2450,5155,+
chr4,41685802,1.6035530621785883,1028,712,1740,+
chr4,41689586,0.3661460073504845,796,583,1379,+
chr4,41697176,3.1999508616339103,982,691,1673,+
chr4,41697381,3.20944783163291,829,539,1368,+
chr4,41697408,0.9701403813617449,1663,1150,2813,+
chr4,41697409,0.8807724454936995,2136,1449,3585,+
chr4,41697419,1.656090723751274,950,653,1603,+
chr4,41697656,2.350185873605948,653,537,1190,+
chr4,41697813,2.3881834672194877,575,453,1028,+
chr4,41698202,2.0917463277980612,1274,936,2210,+
chr4,41698216,1.0481974682299913,931,686,1617,+
chr4,41698373,1.9091784338896018,660,491,1151,+
chr4,41698625,2.1245811757538835,557,468,1025,+
chr4,41698717,1.6800107616267457,905,652,1557,+
chr4,42020451,2.373166066327257,594,428,1022,+
chr4,43899212,1.4988842834431069,571,576,1147,+
chr4,48832637,3.0592979894882886,633,578,1211,+
chr4,48833458,2.895927601809955,719,458,1177,+
chr4,48849989,1.746715653529281,540,498,1038,+
chr4,48851825,0.4441470079750153,723,416,1139,+
chr4,48851857,1.740101168672597,687,545,1232,+
chr4,48857231,1.8517316017316017,707,527,1234,+
chr4,48860728,0.4517320203973977,733,516,1249,+
chr4,48860787,1.6951983298538624,755,478,1233,+
chr4,52712872,3.143776404466662,1442,1113,2555,+
chr4,52712874,2.4235930212006735,1414,1145,2559,+
chr4,52712876,1.164064570787565,878,886,1764,+
chr4,52712878,0.9408058791587433,678,673,1351,+
chr4,52713525,2.0360552293120877,566,460,1026,+
chr4,52713606,3.900905432595573,659,567,1226,+
chr4,55411617,1.0174489897793086,586,455,1041,+
chr4,55411649,0.47761194029850756,1007,602,1609,+
chr4,55411650,0.893364158101412,1324,852,2176,+
chr4,55424589,2.532906316283282,1386,1135,2521,+
chr4,55424590,1.9745598860282891,791,633,1424,+
chr4,55424598,0.3879008967928256,956,730,1686,+
chr4,55424599,0.3879008967928256,956,730,1686,+
chr4,55425976,2.436192354036587,694,536,1230,+
chr4,55425978,2.2579828827479784,1196,866,2062,+
chr4,55425982,2.559852315400722,1048,722,1770,+
chr4,56436302,0.7101341418583302,1366,930,2296,+
chr4,56441665,2.0871213149272765,1534,1058,2592,+
chr4,56446738,0.5321052631578947,1010,799,1809,+
chr4,56448418,1.4677039748953975,1346,955,2301,+
chr4,56448488,0.5681679410765336,3586,2626,6212,+
chr4,56448489,0.5681679410765336,3586,2626,6212,+
chr4,56448491,1.8267581475128647,1348,1006,2354,+
chr4,56448711,2.14349376114082,1849,1019,2868,+
chr4,56448723,2.5488578398758044,1305,834,2139,+
chr4,56451941,1.6000555381998682,1719,1454,3173,+
chr4,56451942,1.6000555381998682,1719,1454,3173,+
chr4,56451943,1.6783811646984392,3140,2283,5423,+
chr4,56451944,1.7888377037562015,1421,829,2250,+
chr4,56451947,0.9173295389742679,2464,1832,4296,+
chr4,56451948,0.5646832724121038,1664,1337,3001,+
chr4,56453642,0.5132336018411968,891,473,1364,+
chr4,56453681,1.5607685009487668,996,526,1522,+
chr4,56453689,1.6053142260038806,848,692,1540,+
chr4,56453750,1.650140849571712,2016,1557,3573,+
chr4,56459379,1.6046316964285714,1490,1023,2513,+
chr4,56459540,1.6432981204554808,1129,984,2113,+
chr4,56459673,1.9185468993898118,675,485,1160,+
chr4,56459985,3.5512485458439422,802,671,1473,+
chr4,56459986,3.5512485458439422,802,671,1473,+
chr4,56460027,1.6550366300366297,582,454,1036,+
chr4,56460028,1.756953642384106,757,754,1511,+
chr4,56460029,1.756953642384106,757,754,1511,+
chr4,56460083,1.7207606519874175,829,537,1366,+
chr4,56460391,0.5683269476372924,889,608,1497,+
chr4,56460447,3.8463647566433057,1136,967,2103,+
chr4,56460673,2.7930049964311205,601,466,1067,+
chr4,56460985,1.807602851211057,840,670,1510,+
chr4,56460994,1.798128342245989,806,560,1366,+
chr4,56467633,0.5719129635581865,1637,759,2396,+
chr4,56467659,12.890497336434962,4689,3160,7849,+
chr4,56467660,12.890497336434962,4689,3160,7849,+
chr4,56467685,1.2805456149020107,1715,1458,3173,+
chr4,56467702,1.632823159873354,2131,1870,4001,+
chr4,56469652,1.5563694284228085,868,725,1593,+
chr4,56469653,1.2936259143155695,618,494,1112,+
chr4,56469712,1.702433628318584,683,451,1134,+
chr4,56478434,2.6863033203017594,857,620,1477,+
chr4,56483142,0.4112563543936093,808,509,1317,+
chr4,56483143,0.4112563543936093,808,509,1317,+
chr4,56483144,0.4112563543936093,808,509,1317,+
chr4,56483148,2.7418884433102444,653,421,1074,+
chr4,56483149,3.3535985600637637,997,633,1630,+
chr4,56483167,0.9883158742949234,891,583,1474,+
chr4,56483169,0.9883158742949234,891,583,1474,+
chr4,56483176,0.5281360737065911,620,414,1034,+
chr4,56490578,1.754009613440976,1282,949,2231,+
chr4,56490582,1.746947194719472,682,504,1186,+
chr4,56491436,1.7344271412680756,944,619,1563,+
chr4,56500538,2.5336512983571806,682,443,1125,+
chr4,56500547,1.7142129393785024,672,452,1124,+
chr4,56500548,1.6725833023329966,806,606,1412,+
chr4,56500560,0.6409429556321584,785,528,1313,+
chr4,56500578,1.6963064295485637,991,730,1721,+
chr4,56500599,1.3176590977259663,2983,2353,5336,+
chr4,56502111,1.8682692307692308,602,467,1069,+
chr4,56502589,2.5965405543035476,885,713,1598,+
chr4,56502590,2.288327078083907,1438,1090,2528,+
chr4,56502596,0.4452278365321843,619,413,1032,+
chr4,56502958,0.4832059491840529,730,514,1244,+
chr4,56502989,0.6272504091653028,802,571,1373,+
chr4,56994667,2.2905278539544986,758,552,1310,+
chr4,56999687,1.3464598080650962,649,458,1107,+
chr4,57005279,4.517124357931228,797,537,1334,+
chr4,57023341,2.094135273972603,688,583,1271,+
chr4,57023390,1.6677897574123988,824,847,1671,+
chr4,57023399,1.7626217891939768,994,1128,2122,+
chr4,57023401,2.0464767616191906,1455,1159,2614,+
chr4,57023402,2.0459055075883517,1089,1285,2374,+
chr4,57023405,1.9092189500640209,1146,1419,2565,+
chr4,57023408,1.8027449461374987,1229,1618,2847,+
chr4,57023502,3.8342195438969626,876,650,1526,+
chr4,57023504,3.8342195438969626,876,650,1526,+
chr4,57023693,0.2982857142857143,521,549,1070,+
chr4,57023694,0.2982857142857143,521,549,1070,+
chr4,57030226,1.8277619404035221,784,626,1410,+
chr4,65573607,1.6161891487189033,777,665,1442,+
chr4,65573609,1.6529820967572473,1917,1523,3440,+
chr4,65573610,1.932135064268328,2595,1658,4253,+
chr4,65573611,1.8183363186324983,2130,1446,3576,+
chr4,65573612,1.7635480777860175,2318,1666,3984,+
chr4,65573613,1.167523943040971,586,540,1126,+
chr4,65573614,1.552219485098778,1995,1544,3539,+
chr4,65573615,1.5810675898908624,2848,1862,4710,+
chr4,65573617,1.693647815599035,1423,727,2150,+
chr4,65573623,1.958736621546008,1807,1036,2843,+
chr4,65573624,1.8545159040622117,2384,1430,3814,+
chr4,65573634,1.7456401189423774,748,540,1288,+
chr4,65573635,1.3641354755707151,1360,856,2216,+
chr4,65573638,1.1870778898183334,1259,1010,2269,+
chr4,65573686,1.2319206492335435,2276,2217,4493,+
chr4,65573730,1.459812373225152,1644,951,2595,+
chr4,65573734,1.2628965517241382,1961,1565,3526,+
chr4,65573735,0.7452429576323383,1814,1581,3395,+
chr4,65573742,1.4971804511278195,1592,1119,2711,+
chr4,65573753,1.358423805160292,7547,5290,12837,+
chr4,65573755,1.3116500913334683,4135,3031,7166,+
chr4,65573756,1.2098829799559727,4176,2834,7010,+
chr4,65573845,2.733060372586701,672,594,1266,+
chr4,68376377,2.0271604938271603,820,809,1629,+
chr4,68376379,1.682617303325909,1350,1191,2541,+
chr4,68376391,1.871710526315789,568,626,1194,+
chr4,68376409,0.8203883495145631,985,985,1970,+
chr4,68376410,1.438367371223728,966,850,1816,+
chr4,68376412,1.6050047027285703,3312,2992,6304,+
chr4,68376601,0.6542599592904914,674,542,1216,+
chr4,68376610,1.7587411249023917,1623,1382,3005,+
chr4,68376611,3.0159930701192565,702,752,1454,+
chr4,70689903,0.3662020451884595,2978,1483,4461,+
chr4,70689905,0.3456528553978532,2283,1170,3453,+
chr4,70689935,0.6026469950097635,867,418,1285,+
chr4,70689939,3.542434924078092,900,460,1360,+
chr4,70689949,2.504369538077403,1002,533,1535,+
chr4,70689992,2.1653768988248783,1510,1162,2672,+
chr4,73099025,2.0211803491437412,829,445,1274,+
chr4,73099026,1.86674031986532,958,527,1485,+
chr4,73099028,1.5179532710650805,1603,1019,2622,+
chr4,73099029,1.7675438596491226,753,455,1208,+
chr4,73099031,1.703812845655989,1200,901,2101,+
chr4,73099032,1.6764052771367615,836,578,1414,+
chr4,74314598,1.1073667711598747,784,439,1223,+
chr4,74314599,1.1073667711598747,784,439,1223,+
chr4,74314631,1.7244160177975532,635,495,1130,+
chr4,74446534,1.9375247133254248,1299,842,2141,+
chr4,74446535,0.8688,723,624,1347,+
chr4,74446536,1.9283737535037488,2566,1863,4429,+
chr4,74446547,1.7392392077229977,1276,878,2154,+
chr4,74446560,2.251252790870752,925,694,1619,+
chr4,74446588,0.5820763087843833,819,574,1393,+
chr4,74446688,1.6411077744411078,847,554,1401,+
chr4,74450387,2.254326782047521,794,486,1280,+
chr4,74450413,0.5414141414141415,1071,791,1862,+
chr4,74450484,2.4576205890606886,3953,2377,6330,+
chr4,74450486,2.5112850032979552,3196,1961,5157,+
chr4,74450519,2.237078303930672,1806,1076,2882,+
chr4,74450521,2.237078303930672,1806,1076,2882,+
chr4,74452547,2.2638442300821717,1333,932,2265,+
chr4,74454897,1.9866507272365013,766,477,1243,+
chr4,75752404,2.3423514538558785,771,564,1335,+
chr4,75752406,2.3423514538558785,771,564,1335,+
chr4,75774765,0.9576180257510728,839,465,1304,+
chr4,75774767,1.2158488462013417,1542,925,2467,+
chr4,75774768,1.1749938469111496,867,477,1344,+
chr4,75782729,8.074824723201312,675,395,1070,+
chr4,75799638,1.1336924464114435,729,547,1276,+
chr4,75804141,1.7742857142857145,620,454,1074,+
chr4,75804146,3.1647398843930636,656,518,1174,+
chr4,75804173,1.5265894217078364,2204,2068,4272,+
chr4,75804174,1.2915037581334419,2978,2606,5584,+
chr4,75812302,2.9619686800894853,661,446,1107,+
chr4,75813831,1.9336604082280229,898,622,1520,+
chr4,77030788,4.012833412434741,611,439,1050,+
chr4,78573204,2.674436467610967,611,463,1074,+
chr4,78591550,0.9843423799582462,655,478,1133,+
chr4,78591551,0.9843423799582462,655,478,1133,+
chr4,82460702,4.64370236505068,664,493,1157,+
chr4,83049299,1.785875791377751,676,427,1103,+
chr4,83049300,0.5657520325203252,878,655,1533,+
chr4,83049882,2.1484593837535013,707,475,1182,+
chr4,83049883,2.2698611111111107,553,479,1032,+
chr4,83063225,0.9811218985976268,641,411,1052,+
chr4,83063226,0.9811218985976268,641,411,1052,+
chr4,83461157,1.9926209869875402,901,654,1555,+
chr4,87138833,1.214100383743241,639,537,1176,+
chr4,87891974,0.6691522126762847,1031,795,1826,+
chr4,87891975,0.6691522126762847,1031,795,1826,+
chr4,87891977,1.1875836571371927,2361,1537,3898,+
chr4,87891979,1.2088669322005274,3505,2343,5848,+
chr4,87891980,1.5836103807507738,3068,2315,5383,+
chr4,87891982,1.7396242527754053,1566,1170,2736,+
chr4,87891983,0.6631016042780749,1315,798,2113,+
chr4,87891985,1.9108370209961403,614,558,1172,+
chr4,87892186,1.8027654802398332,606,502,1108,+
chr4,87892348,0.7573062336534299,908,857,1765,+
chr4,87892350,1.540584443053182,1022,1045,2067,+
chr4,87892352,1.1605135702462566,1910,1860,3770,+
chr4,87892433,2.3888666821133473,960,727,1687,+
chr4,87892435,2.0723025583982206,647,463,1110,+
chr4,87892436,1.875370533412245,1240,917,2157,+
chr4,87892445,2.2154572940287234,960,734,1694,+
chr4,87892447,2.1155480033984704,1493,1176,2669,+
chr4,87892448,1.0535177450113866,2893,2213,5106,+
chr4,87892453,1.9184837302918485,601,541,1142,+
chr4,87892772,1.5705065565211618,692,580,1272,+
chr4,87892775,2.1328125,727,639,1366,+
chr4,87892776,1.0867622501426644,2615,2001,4616,+
chr4,87892777,0.6470992835872427,1888,1362,3250,+
chr4,87892778,0.6470992835872427,1888,1362,3250,+
chr4,87892784,1.3079007587618934,1173,873,2046,+
chr4,87892791,1.9771241830065363,604,611,1215,+
chr4,87892885,2.0317984074528113,655,480,1135,+
chr4,87892958,1.49036875962671,1393,1414,2807,+
chr4,87892960,1.1161761134822585,3021,2549,5570,+
chr4,87893518,1.3951537744641191,1496,1072,2568,+
chr4,87893520,1.2571008892529953,3036,2218,5254,+
chr4,87893522,1.0479872813990458,1771,1257,3028,+
chr4,87893533,1.486583440952791,591,605,1196,+
chr4,87893538,0.7038740920096853,1291,943,2234,+
chr4,87893539,1.5578817733990151,714,753,1467,+
chr4,87893542,0.5904261145799102,1539,1073,2612,+
chr4,87893556,1.5265516718093983,2535,1864,4399,+
chr4,87893560,1.325897233579609,2410,1548,3958,+
chr4,94665850,7.53069722739716,612,579,1191,+
chr4,105969609,1.7646485397664329,612,425,1037,+
chr4,105969739,1.654805627164319,733,529,1262,+
chr4,106316993,2.386764999706176,732,568,1300,+
chr4,106316996,2.0349904675645494,1233,1029,2262,+
chr4,106316997,1.6020166073546855,656,561,1217,+
chr4,106328098,1.6492307692307695,602,467,1069,+
chr4,106331825,0.6060445387062566,634,409,1043,+
chr4,106336873,1.6058872122501717,816,563,1379,+
chr4,106336973,1.997920997920998,681,480,1161,+
chr4,106336990,1.7236014227844294,1175,814,1989,+
chr4,106337013,0.5118795399515739,614,412,1026,+
chr4,108019605,2.7939147689691013,703,556,1259,+
chr4,108027690,5.719008256542219,732,447,1179,+
chr4,108027699,5.369637517140433,992,745,1737,+
chr4,108620570,1.8127791563275435,768,519,1287,+
chr4,108620574,1.695079617497843,3564,2993,6557,+
chr4,108620575,0.7906976744186046,1125,816,1941,+
chr4,108620576,1.3525706490296747,4105,3476,7581,+
chr4,108620580,1.4496041682474643,1548,1145,2693,+
chr4,108621951,1.38378122063575,6745,5269,12014,+
chr4,108621952,1.4368511273508693,4585,3533,8118,+
chr4,108621955,0.7182881678802961,7480,6851,14331,+
chr4,108621957,0.8379323746130967,16449,13941,30390,+
chr4,108621959,0.9474243500570828,8456,7701,16157,+
chr4,108621960,1.4682519177612843,8218,6588,14806,+
chr4,108621974,1.2297502541552858,5330,4296,9626,+
chr4,108622171,1.2748993733890213,24468,17109,41577,+
chr4,108625159,1.474967754039837,13929,9335,23264,+
chr4,108655580,0.657773081495179,1244,1016,2260,+
chr4,108655594,1.6006667750853798,634,472,1106,+
chr4,108657452,2.33485401459854,852,547,1399,+
chr4,108657520,1.7252072276223984,1051,817,1868,+
chr4,108667254,2.330111387277916,1807,1490,3297,+
chr4,108667255,2.330111387277916,1807,1490,3297,+
chr4,108667358,1.7413566908473532,920,681,1601,+
chr4,108667586,1.919534317384093,1946,1547,3493,+
chr4,109530437,4.274733893557423,1003,524,1527,+
chr4,109530438,5.179558011049724,674,361,1035,+
chr4,109818043,5.975748768081516,683,488,1171,+
chr4,109824424,7.236376028163997,664,734,1398,+
chr4,112650493,2.080449397902143,652,470,1122,+
chr4,118278816,0.3883586819224895,752,663,1415,+
chr4,118279082,2.027563905143209,626,381,1007,+
chr4,118279113,1.574334319526627,890,675,1565,+
chr4,118279390,2.3373963920039005,798,585,1383,+
chr4,118279398,1.5684996689837805,1284,911,2195,+
chr4,118279642,3.278755868544601,754,709,1463,+
chr4,118279713,2.863636363636364,701,527,1228,+
chr4,119293808,3.663685804507111,668,363,1031,+
chr4,119293849,1.8490838681157635,852,607,1459,+
chr4,119293863,0.4601178295116697,1319,830,2149,+
chr4,119293866,2.1780368657466345,1639,1159,2798,+
chr4,121811597,0.3547259373296129,789,546,1335,+
chr4,121811598,0.3547259373296129,789,546,1335,+
chr4,121813334,1.2047218426982014,652,465,1117,+
chr4,127822789,1.8129700499844765,1195,617,1812,+
chr4,127822803,1.8867103975646,1369,672,2041,+
chr4,127822805,2.065686274509804,2106,1053,3159,+
chr4,127822807,2.2210095497953617,1442,732,2174,+
chr4,127822816,2.1673351629019777,2519,1578,4097,+
chr4,127822817,2.1673351629019777,2519,1578,4097,+
chr4,127822818,2.165073355512387,2981,1828,4809,+
chr4,127822848,2.335456475583864,835,470,1305,+
chr4,127822872,1.7491592622747707,1122,688,1810,+
chr4,127822878,2.4031040268456376,1347,893,2240,+
chr4,127984382,2.9034311991510435,863,513,1376,+
chr4,127984383,2.529869909250735,778,561,1339,+
chr4,128082165,2.294666719853205,884,582,1466,+
chr4,128082166,2.2668892562260785,1766,1206,2972,+
chr4,128082168,2.900641573994868,928,667,1595,+
chr4,140373684,0.8889793470686408,724,501,1225,+
chr4,140379174,2.6663476213096655,731,607,1338,+
chr4,140381182,2.1897610030037877,728,402,1130,+
chr4,140381287,2.136708296164139,736,471,1207,+
chr4,140381419,2.1821566875186176,636,372,1008,+
chr4,140381499,1.7845740515214632,1238,758,1996,+
chr4,140381553,2.029691242922474,1107,653,1760,+
chr4,140381636,1.68201642594166,1023,534,1557,+
chr4,140381641,1.6905345601579167,3437,1922,5359,+
chr4,140381642,1.6905345601579167,3437,1922,5359,+
chr4,140381643,1.2973811513424367,5263,2761,8024,+
chr4,140381749,1.9593930635838146,1042,691,1733,+
chr4,140381788,2.8064747342014096,1145,760,1905,+
chr4,143525475,2.1339535393673197,620,435,1055,+
chr4,143526333,4.876225227879584,656,472,1128,+
chr4,143528646,1.0088815251791192,562,447,1009,+
chr4,143538864,2.746066196418882,722,387,1109,+
chr4,143538865,3.004730152840134,980,555,1535,+
chr4,143538871,2.48317237095386,747,418,1165,+
chr4,143543549,1.8392262814232754,639,474,1113,+
chr4,143547384,2.1861874498828997,595,539,1134,+
chr4,143547438,1.8644257703081228,767,764,1531,+
chr4,143547457,2.5126221498371337,560,613,1173,+
chr4,145098313,0.5279526384246943,1479,1090,2569,+
chr4,145098315,0.29174992863260063,729,564,1293,+
chr4,145105637,2.3678243227115403,619,398,1017,+
chr4,145123223,1.9758482738183436,634,396,1030,+
chr4,145125009,1.9392170442106733,870,737,1607,+
chr4,145127526,2.2112997184692422,897,518,1415,+
chr4,145127528,3.0015273393748085,866,426,1292,+
chr4,145127707,2.028449502133713,712,443,1155,+
chr4,145127727,1.8342131979695433,622,393,1015,+
chr4,145128219,1.074320356699451,978,724,1702,+
chr4,145128399,1.8762335526315788,675,511,1186,+
chr4,145128632,2.1457435344827585,589,463,1052,+
chr4,145128637,1.728270087875999,1348,1130,2478,+
chr4,145128639,1.728270087875999,1348,1130,2478,+
chr4,145128644,2.122893165228932,743,684,1427,+
chr4,145376051,3.0286738351254483,675,557,1232,+
chr4,145376052,2.8078886155836367,933,734,1667,+
chr4,145376072,2.0428571428571427,1176,641,1817,+
chr4,145376074,2.204372989575196,2315,1331,3646,+
chr4,145376075,1.868882733148661,1264,721,1985,+
chr4,145376080,1.0981556211892347,1529,1050,2579,+
chr4,145376082,1.7861111111111108,642,431,1073,+
chr4,145376083,2.8455882352941178,859,543,1402,+
chr4,145376092,0.6806784660766961,922,677,1599,+
chr4,145376093,1.6573537717791718,2191,1600,3791,+
chr4,145376139,1.7841411495005732,1062,787,1849,+
chr4,145376190,0.3387518472206433,595,462,1057,+
chr4,145376198,2.2984536082474225,685,484,1169,+
chr4,146187353,1.0255444626076438,706,403,1109,+
chr4,151099602,0.7174920523536652,1130,515,1645,+
chr4,151099604,0.8276752407932381,732,363,1095,+
chr4,151099620,1.5901813960395446,1627,905,2532,+
chr4,151099625,1.0399077399831984,20020,15415,35435,+
chr4,151099626,1.0250583727481501,29144,22309,51453,+
chr4,151099627,1.0085548801167283,19504,14528,34032,+
chr4,151099646,2.124655087062268,5783,4554,10337,+
chr4,151100487,0.7503946221263709,2352,2355,4707,+
chr4,151100493,0.7370821314424107,2787,2217,5004,+
chr4,151100494,0.7370821314424107,2787,2217,5004,+
chr4,151100500,0.7139795272392033,7850,5690,13540,+
chr4,151100501,0.7047808033172124,7338,4616,11954,+
chr4,151100504,0.6333844951408206,6477,4777,11254,+
chr4,151100505,0.7936880016144807,2493,1740,4233,+
chr4,151100519,1.2260557858183039,4377,3396,7773,+
chr4,151100974,1.3062568554392737,11605,7241,18846,+
chr4,151102879,0.4931052157566769,1366,669,2035,+
chr4,151102880,0.4964284041407092,1086,576,1662,+
chr4,151102883,2.358003720779746,910,316,1226,+
chr4,151102884,2.358003720779746,910,316,1226,+
chr4,151102887,1.6143048128342243,1889,1055,2944,+
chr4,151102889,1.6143048128342243,1889,1055,2944,+
chr4,151102891,1.0754395916052184,1421,988,2409,+
chr4,151102892,1.0754395916052184,1421,988,2409,+
chr4,151102894,1.023421213979154,2781,1630,4411,+
chr4,151102895,1.023421213979154,2781,1630,4411,+
chr4,151102897,1.4971094846552055,3201,1609,4810,+
chr4,151102899,1.4583259560906516,3520,1411,4931,+
chr4,151102900,1.4373807770034184,2454,998,3452,+
chr4,151102908,1.4311139774953232,4437,2613,7050,+
chr4,151102909,1.4340901801651769,5940,3536,9476,+
chr4,151102912,1.3285136696187911,1682,1059,2741,+
chr4,151102924,1.4960157550508035,5220,2338,7558,+
chr4,151102925,1.4960157550508035,5220,2338,7558,+
chr4,151102947,0.6118834507712817,3212,1887,5099,+
chr4,151102954,1.246957668053793,3727,2185,5912,+
chr4,151102961,1.2506998237949445,10332,6416,16748,+
chr4,151102991,1.2436240754503178,15733,9790,25523,+
chr4,151104504,0.4272772956307977,607,403,1010,+
chr4,151104517,0.5522480620155038,684,374,1058,+
chr4,151104521,2.1725150971111478,917,556,1473,+
chr4,151104535,1.8183673469387758,890,489,1379,+
chr4,163933062,1.1809177992541298,747,523,1270,+
chr4,164943353,1.0822758121272227,693,498,1191,+
chr4,164943354,1.5454223303892178,729,598,1327,+
chr4,164943693,1.9456171446986787,588,427,1015,+
chr4,164943695,1.9456171446986787,588,427,1015,+
chr4,164943711,2.0364819333100965,625,452,1077,+
chr4,164943744,0.5510286405808794,682,401,1083,+
chr4,164943768,1.7916496456692006,3888,2537,6425,+
chr4,164943769,2.2866138424956928,3940,2283,6223,+
chr4,164943770,2.2866138424956928,3940,2283,6223,+
chr4,164943771,2.306948130875896,2999,1771,4770,+
chr4,164943774,1.5094622509495568,1104,697,1801,+
chr4,164943788,1.5420700443920257,2964,2051,5015,+
chr4,164943789,1.5420700443920257,2964,2051,5015,+
chr4,164943793,1.4235508312518534,5283,3890,9173,+
chr4,164943794,1.9004620329449577,3212,2357,5569,+
chr4,164943795,1.4468170829975826,2051,1359,3410,+
chr4,165333505,2.407612556882471,723,464,1187,+
chr4,165340241,6.4988088095034,648,481,1129,+
chr4,165341855,2.1393723628691985,648,473,1121,+
chr4,165342624,0.6528540721280153,780,476,1256,+
chr4,165342625,0.6714090930711623,1120,717,1837,+
chr4,165342653,0.834367756723742,4669,3063,7732,+
chr4,165342654,0.6982960284186239,3958,2499,6457,+
chr4,165342655,0.7481448328147299,6257,4123,10380,+
chr4,165342756,0.5058491327148044,1139,739,1878,+
chr4,165342837,1.4303405572755417,1385,1036,2421,+
chr4,165497951,3.9016144907282446,740,462,1202,+
chr4,166003471,1.5927971589600294,1333,844,2177,+
chr4,166003473,1.5927971589600294,1333,844,2177,+
chr4,166003476,2.0981058241396133,1047,754,1801,+
chr4,166003477,1.6544505571017905,1173,838,2011,+
chr4,168894641,0.7514464979593793,680,489,1169,+
chr4,168898683,2.242148581329868,646,512,1158,+
chr4,168915928,0.37684409484446973,664,496,1160,+
chr4,168925030,3.31024929982515,674,483,1157,+
chr4,168926307,0.20862744368418476,674,378,1052,+
chr4,168926366,1.2875457875457876,835,530,1365,+
chr4,168926822,1.8512396694214879,735,483,1218,+
chr4,168927217,2.2750190097462366,954,676,1630,+
chr4,168927514,0.8549160671462829,712,555,1267,+
chr4,168927516,1.4731992843455122,1249,859,2108,+
chr4,168927627,2.8859570661896248,716,515,1231,+
chr4,168928171,0.5880952380952379,740,629,1369,+
chr4,176331191,0.2728194864392945,609,586,1195,+
chr4,176331192,0.29813736247415623,1091,977,2068,+
chr4,176331195,0.1533949179673652,836,657,1493,+
chr4,177341610,0.9474112225535376,698,356,1054,+
chr4,177341611,0.9474112225535376,698,356,1054,+
chr4,177351394,2.53475935828877,631,373,1004,+
chr4,177351402,1.0991962390165058,2968,2110,5078,+
chr4,177351403,0.9687715349714955,2602,1848,4450,+
chr4,177351407,1.0820568994633066,1616,1031,2647,+
chr4,177351419,1.7006143893237726,2088,1476,3564,+
chr4,183253923,0.7905325443786981,1168,844,2012,+
chr4,183253924,1.1214187963925144,1726,1180,2906,+
chr4,183253946,1.9097814498933905,1404,937,2341,+
chr4,183253947,1.4980285505362592,3165,2167,5332,+
chr4,183253948,1.103788551900157,2488,1764,4252,+
chr4,183253950,1.3160276671750069,1669,1090,2759,+
chr4,183253952,2.0718881118881116,822,571,1393,+
chr4,183316685,5.46342192015736,659,544,1203,+
chr4,183316686,5.46342192015736,659,544,1203,+
chr4,183316850,5.21536831534092,599,478,1077,+
chr4,183447860,1.591738844928916,654,491,1145,+
chr4,183668051,2.5969530469530464,684,460,1144,+
chr4,183674715,2.0310390600278256,870,601,1471,+
chr4,183679364,1.9118798512728654,689,463,1152,+
chr4,183679372,2.2472124278356085,864,603,1467,+
chr4,189940995,3.158522773036274,717,501,1218,+
chr4,190043097,1.524559906967382,697,561,1258,+
chr5,218321,1.2028253586721354,1723,1271,2994,+
chr5,218322,1.1350361262517428,592,489,1081,+
chr5,218323,1.3629330138764097,644,370,1014,+
chr5,223488,2.2296544035674466,799,551,1350,+
chr5,223489,2.0917871182587686,1766,1103,2869,+
chr5,223491,1.9692585895117543,967,552,1519,+
chr5,223494,2.2115158145890508,1356,1041,2397,+
chr5,223496,2.409464788732394,890,709,1599,+
chr5,223497,1.0428515608040638,1200,742,1942,+
chr5,223498,1.0428515608040638,1200,742,1942,+
chr5,223499,1.7710196779964218,692,558,1250,+
chr5,223501,1.8288876276958,1288,880,2168,+
chr5,223502,1.814599143339699,1827,1289,3116,+
chr5,223512,2.0506756756756763,606,480,1086,+
chr5,223518,2.1956098615916955,654,577,1231,+
chr5,224387,0.5591145833333333,790,559,1349,+
chr5,224439,0.6357369982287288,1323,996,2319,+
chr5,225442,1.8963157894736844,1200,759,1959,+
chr5,225452,1.7412480974124809,1000,656,1656,+
chr5,225457,1.5868680013573124,1392,841,2233,+
chr5,225476,1.8149887686338573,1759,1179,2938,+
chr5,225509,1.832969817140339,2160,1334,3494,+
chr5,225512,1.8086665271090643,1619,842,2461,+
chr5,225521,1.466895953937324,4375,2594,6969,+
chr5,225524,1.3556818705419924,12899,8266,21165,+
chr5,225526,1.6136203487149632,12932,8161,21093,+
chr5,225527,1.755637001108144,8845,6219,15064,+
chr5,225529,1.8387237762237763,6009,4289,10298,+
chr5,225924,0.6700209955300291,1539,1085,2624,+
chr5,225925,0.7594588033417278,1599,1015,2614,+
chr5,225926,2.1289230769230767,628,499,1127,+
chr5,225927,0.6260162601626017,615,491,1106,+
chr5,225952,2.3200255173931095,1487,1127,2614,+
chr5,225960,1.5915388683236384,835,609,1444,+
chr5,226004,1.7657433035629198,2453,1845,4298,+
chr5,228309,0.4737335834896811,1009,737,1746,+
chr5,230892,1.6990990990990993,942,554,1496,+
chr5,233535,2.1737592236935206,1264,760,2024,+
chr5,233536,2.0502994708379365,1931,1185,3116,+
chr5,233538,1.8560371517027865,1307,815,2122,+
chr5,233541,1.6257473406320366,721,476,1197,+
chr5,233555,0.29438161909890503,819,618,1437,+
chr5,233556,1.546165279888469,2092,1491,3583,+
chr5,233629,1.7261474269819193,1181,718,1899,+
chr5,235191,2.8546723208337603,938,814,1752,+
chr5,235247,0.6257796257796258,902,554,1456,+
chr5,235280,1.3451773451773452,627,480,1107,+
chr5,235300,1.8436571428571429,653,524,1177,+
chr5,235301,1.6517857142857142,924,559,1483,+
chr5,236529,1.6968325791855203,749,441,1190,+
chr5,236548,2.5012626262626263,848,527,1375,+
chr5,240376,2.8026700750534426,1070,761,1831,+
chr5,240393,1.7266666666666666,776,557,1333,+
chr5,240406,2.1103565365025467,677,588,1265,+
chr5,240416,1.5302289180199566,868,537,1405,+
chr5,251037,2.0512548978079,744,496,1240,+
chr5,251050,0.5056373958570896,1573,1302,2875,+
chr5,251386,2.3956979566272607,920,511,1431,+
chr5,254480,1.9631578947368427,745,379,1124,+
chr5,256365,1.6125136125136126,1017,818,1835,+
chr5,271773,0.45260600530646306,735,637,1372,+
chr5,271795,2.649756097560976,678,409,1087,+
chr5,304198,3.5997596153846163,598,415,1013,+
chr5,306604,2.3198172472872645,676,514,1190,+
chr5,306616,1.1245588058707878,1900,1332,3232,+
chr5,306643,1.7163825757575757,624,479,1103,+
chr5,306660,2.2375541125541125,826,703,1529,+
chr5,306664,1.5677588063374868,727,590,1317,+
chr5,306723,0.5372180773518566,736,597,1333,+
chr5,311310,1.574593857681763,1723,1412,3135,+
chr5,311334,1.6303204208512674,973,737,1710,+
chr5,311376,1.7020108144643458,1184,806,1990,+
chr5,314503,1.0471717786578616,2768,1909,4677,+
chr5,314511,2.202193748786643,1388,908,2296,+
chr5,446161,0.9167884278199886,616,505,1121,+
chr5,453844,0.7708243305075252,655,443,1098,+
chr5,453947,2.0590415671877684,1153,747,1900,+
chr5,453953,1.8306122448979596,623,391,1014,+
chr5,480728,3.3631578947368426,638,509,1147,+
chr5,480729,3.3631578947368426,638,509,1147,+
chr5,480730,3.3631578947368426,638,509,1147,+
chr5,894792,0.9084433270479784,812,665,1477,+
chr5,894793,0.9084433270479784,812,665,1477,+
chr5,894800,0.5510733663599906,583,470,1053,+
chr5,894806,1.7467948717948718,653,545,1198,+
chr5,896735,2.1065934065934067,567,454,1021,+
chr5,896768,2.0942480079681274,622,501,1123,+
chr5,904163,2.0414072444774765,1468,1127,2595,+
chr5,904180,2.2233515436412143,699,462,1161,+
chr5,904193,1.98,747,509,1256,+
chr5,907178,2.046439628482972,660,531,1191,+
chr5,908018,0.4330144738819052,785,486,1271,+
chr5,908416,0.5469755469755471,679,503,1182,+
chr5,911873,1.5457898244834483,891,642,1533,+
chr5,911886,1.6738895970193155,775,657,1432,+
chr5,911928,1.6635115317957605,733,576,1309,+
chr5,911958,1.576217959599389,757,547,1304,+
chr5,914473,2.306618480725624,756,671,1427,+
chr5,915933,1.778037110514646,585,450,1035,+
chr5,917065,1.6167032967032966,612,454,1066,+
chr5,917211,0.48311734109142207,684,596,1280,+
chr5,917226,2.2214396628216506,976,783,1759,+
chr5,917363,2.093712255772646,892,562,1454,+
chr5,917802,4.2118247524727845,1154,893,2047,+
chr5,917880,1.0820136940849998,943,770,1713,+
chr5,917881,1.0820136940849998,943,770,1713,+
chr5,1801413,0.8013555787278415,741,587,1328,+
chr5,1801414,0.8438718897773043,1746,1091,2837,+
chr5,1801415,1.1073051669845897,1907,1008,2915,+
chr5,1801417,1.5592529711375214,1119,588,1707,+
chr5,1801429,2.499062153217199,1535,1057,2592,+
chr5,1801432,3.4333333333333336,617,485,1102,+
chr5,1801448,1.705349794238683,559,485,1044,+
chr5,1801496,1.7676807760141091,852,647,1499,+
chr5,1801510,0.5253507014028056,748,498,1246,+
chr5,1801526,1.6348445338137338,2601,1990,4591,+
chr5,1801528,1.7154906997504145,2544,2032,4576,+
chr5,1801529,1.5997781598358385,1716,1386,3102,+
chr5,1802324,0.5381097302101387,2647,2083,4730,+
chr5,1802327,0.7126852113529007,1534,1053,2587,+
chr5,1814339,1.8549615758918083,1062,902,1964,+
chr5,1815850,1.586870401810979,700,588,1288,+
chr5,1815851,0.7852708481511727,2416,1478,3894,+
chr5,1815853,0.8712350981734623,7710,5366,13076,+
chr5,1815854,0.9495648572844836,2654,1617,4271,+
chr5,1815855,0.9048541655757448,1799,1468,3267,+
chr5,1815859,1.5903016867290014,4198,3199,7397,+
chr5,1815860,1.7562313790168118,2336,2031,4367,+
chr5,1815968,1.6440937979399517,1363,844,2207,+
chr5,5461418,2.021635883905013,1276,757,2033,+
chr5,5461420,2.021635883905013,1276,757,2033,+
chr5,5461432,1.8664373746059044,1627,1162,2789,+
chr5,5461433,1.8664373746059044,1627,1162,2789,+
chr5,5461530,4.000211327134403,822,727,1549,+
chr5,5461531,2.3775458676990406,564,456,1020,+
chr5,5461532,4.000211327134403,822,727,1549,+
chr5,5461537,0.6754065611636545,697,542,1239,+
chr5,5463867,1.9992820623384773,703,526,1229,+
chr5,5464064,3.1875924205084574,649,484,1133,+
chr5,5465120,1.7050051277282336,740,545,1285,+
chr5,5490041,0.6880563602049248,749,566,1315,+
chr5,6746307,2.1649797570850198,929,759,1688,+
chr5,6746308,2.4232418952618455,1428,1202,2630,+
chr5,6746310,2.4913625566832223,974,841,1815,+
chr5,6749614,0.38753843907362323,1009,647,1656,+
chr5,6749629,2.063118589513155,2183,1420,3603,+
chr5,6756825,0.4230557087699944,707,517,1224,+
chr5,6756827,0.4230557087699944,707,517,1224,+
chr5,7875307,1.2138464241785274,627,541,1168,+
chr5,7875309,1.2138464241785274,627,541,1168,+
chr5,7878087,1.4550705172641447,640,494,1134,+
chr5,7883242,1.7570807853234631,752,477,1229,+
chr5,7885749,2.3397430027775235,3947,2933,6880,+
chr5,7885750,2.3397430027775235,3947,2933,6880,+
chr5,7885751,2.0511475259985623,5783,4212,9995,+
chr5,7885754,3.5720730027548213,1420,1209,2629,+
chr5,7889181,0.9891262135922331,565,514,1079,+
chr5,7889182,0.9891262135922331,565,514,1079,+
chr5,7896915,2.046884100174724,638,403,1041,+
chr5,7899991,1.7342281879194632,645,446,1091,+
chr5,7900756,1.754054054054054,648,443,1091,+
chr5,7900915,1.7105097545626182,603,453,1056,+
chr5,7900920,2.5679598838743734,694,420,1114,+
chr5,7901049,1.6475706399956278,1815,1709,3524,+
chr5,7901050,1.65305912791562,3385,2669,6054,+
chr5,7901051,1.7260192377566004,4078,3391,7469,+
chr5,7901053,1.54745406824147,2875,3047,5922,+
chr5,7901054,1.503739340031837,4520,3961,8481,+
chr5,7901055,1.5724297498491044,2232,2417,4649,+
chr5,8460157,8.38060465412203,1097,826,1923,+
chr5,10250206,0.6820138556012191,1339,750,2089,+
chr5,10250208,0.9948755780839739,1501,782,2283,+
chr5,10250209,1.1264579251773938,2578,1333,3911,+
chr5,10250210,1.1701331510863364,2383,1209,3592,+
chr5,10250211,1.1725293132328307,1399,749,2148,+
chr5,10250215,0.9800332778702165,836,600,1436,+
chr5,10250217,0.9800332778702165,836,600,1436,+
chr5,10250268,2.7577236777063767,782,475,1257,+
chr5,10250274,1.5991523753203236,824,533,1357,+
chr5,10250275,0.4535856573705179,758,501,1259,+
chr5,10250279,0.6308829926054806,1035,626,1661,+
chr5,10250280,1.5443330078991744,869,592,1461,+
chr5,10250287,1.9057777777777773,1071,774,1845,+
chr5,10250298,2.3328917152446564,1298,998,2296,+
chr5,10250316,1.2611792197834817,7287,4773,12060,+
chr5,10250317,1.017776870370802,18726,12808,31534,+
chr5,10250318,0.8396981580721865,7952,5931,13883,+
chr5,10250319,0.8532875180664286,20600,14283,34883,+
chr5,10250321,0.6986551980954585,9115,6518,15633,+
chr5,10250322,0.8559014110095078,3686,2695,6381,+
chr5,10254146,1.393340656730598,10428,6123,16551,+
chr5,10254148,1.3082703418762724,22323,13347,35670,+
chr5,10254149,1.2640122004209282,25332,16083,41415,+
chr5,10254150,1.2640122004209282,25332,16083,41415,+
chr5,10254173,1.2336584621382392,11840,8066,19906,+
chr5,10254763,1.244120965835396,13113,9201,22314,+
chr5,10255973,1.293729075433687,19212,12040,31252,+
chr5,10255975,1.2862977479838122,14574,8559,23133,+
chr5,10255976,1.5360748389323515,5126,3935,9061,+
chr5,10258117,1.278038582296824,6389,4731,11120,+
chr5,10258130,1.2585605603500165,23385,16398,39783,+
chr5,10258139,1.2957348773999218,33594,24285,57879,+
chr5,10260847,1.516800571261046,12375,8014,20389,+
chr5,10261603,1.2252030480428702,12155,7714,19869,+
chr5,10261605,1.2432763318760514,16195,10897,27092,+
chr5,10261617,1.2702374742404898,9001,7228,16229,+
chr5,10261626,2.62805513236882,5203,4422,9625,+
chr5,10261694,1.5238980591329585,4276,3128,7404,+
chr5,10261697,1.3829119695938852,11093,7762,18855,+
chr5,10263144,1.363738565552928,10216,6860,17076,+
chr5,10263149,1.2631315596928896,15978,11655,27633,+
chr5,10263269,1.241515307201789,8054,6089,14143,+
chr5,10264657,1.4552492187481807,19342,13154,32496,+
chr5,10264658,1.6197500712337691,11261,8188,19449,+
chr5,10264693,0.8701585335429216,23106,17591,40697,+
chr5,10353891,1.1683933182906197,901,589,1490,+
chr5,10353892,1.3388737394684194,708,495,1203,+
chr5,10377833,0.7486974862504782,1252,876,2128,+
chr5,10377834,1.4208450210221182,1374,949,2323,+
chr5,10387002,1.1088636363636364,573,549,1122,+
chr5,10387004,1.1088636363636364,573,549,1122,+
chr5,10391680,11.851319338455191,890,819,1709,+
chr5,10391714,0.481558041853283,594,546,1140,+
chr5,10397328,1.7761790567545963,605,416,1021,+
chr5,10402128,1.7684729064039408,717,405,1122,+
chr5,10402416,1.8020392458637935,645,451,1096,+
chr5,10402553,2.241751464693185,726,422,1148,+
chr5,10402561,1.7010092514718251,808,491,1299,+
chr5,10403409,2.2424242424242418,665,461,1126,+
chr5,10429916,1.9350951374207188,677,472,1149,+
chr5,10433833,1.1793916821849784,911,536,1447,+
chr5,10433835,1.1793916821849784,911,536,1447,+
chr5,10433901,1.9978352049790287,641,388,1029,+
chr5,14696399,1.7278144071422725,737,728,1465,+
chr5,14696400,1.9492943773585814,603,430,1033,+
chr5,17217627,0.8433871674068075,1084,797,1881,+
chr5,17217629,1.0871365906717172,1360,1164,2524,+
chr5,17217630,1.6753626326044595,692,595,1287,+
chr5,17217637,0.3467896802204225,922,811,1733,+
chr5,17217639,0.3467896802204225,922,811,1733,+
chr5,17217646,1.8309283309283308,661,377,1038,+
chr5,17217660,1.525935631257139,856,725,1581,+
chr5,17217679,1.7731980332670785,1129,868,1997,+
chr5,17217706,1.3041158536585369,3218,2623,5841,+
chr5,17217708,1.3610407640503797,4381,3745,8126,+
chr5,17217751,0.916793863896229,3642,2100,5742,+
chr5,17217752,1.064863979376513,5346,3416,8762,+
chr5,17217775,1.3121346442342057,6226,4237,10463,+
chr5,17217779,1.2697817349037204,2990,1782,4772,+
chr5,17217784,1.5297158247367646,4414,3376,7790,+
chr5,17217790,1.5537264422271038,14600,11959,26559,+
chr5,17217791,1.6886980071986546,15560,13176,28736,+
chr5,17217793,1.7762933902714284,15592,13235,28827,+
chr5,17217799,1.7927283995248668,4393,2889,7282,+
chr5,17275353,1.363130943672275,1814,1366,3180,+
chr5,17275381,1.735192723371357,4270,3425,7695,+
chr5,17275382,1.7834570189566563,5991,4796,10787,+
chr5,17275429,1.6212719930243042,5334,4567,9901,+
chr5,17275430,1.6212719930243042,5334,4567,9901,+
chr5,17275436,2.0500995355009954,2811,2602,5413,+
chr5,17275574,1.737706655362442,862,673,1535,+
chr5,17275577,2.6855486173059773,668,353,1021,+
chr5,17275631,2.1222222222222222,763,647,1410,+
chr5,17275646,1.4129774704197955,1281,1114,2395,+
chr5,17275647,0.9825632366788972,2039,1793,3832,+
chr5,17275649,0.9825632366788972,2039,1793,3832,+
chr5,17275653,1.4485201966644172,1112,1011,2123,+
chr5,17275654,0.580064715499926,4647,3474,8121,+
chr5,17275656,0.9918630189875032,2544,2268,4812,+
chr5,17275658,0.8786052429085798,4323,3639,7962,+
chr5,17275704,1.5686642599277978,2294,1384,3678,+
chr5,17275794,1.4878413565411133,4264,2458,6722,+
chr5,17275795,1.5034142186535386,8387,5727,14114,+
chr5,17275833,1.4740951107571252,8593,7010,15603,+
chr5,17275835,1.3973787381205809,10028,7852,17880,+
chr5,17275836,1.1636196152049922,13452,9847,23299,+
chr5,17275863,1.4684649820098736,3531,2811,6342,+
chr5,17275877,1.1257060325384212,7640,5283,12923,+
chr5,17275974,1.3032229633267998,4578,3650,8228,+
chr5,17276109,9.372654074714662,12865,1211,14076,+
chr5,17276112,7.702029902459234,10623,1001,11624,+
chr5,17276113,6.954013586428129,26516,2516,29032,+
chr5,17276115,8.238746140348471,79529,6898,86427,+
chr5,17276116,26.788646850261554,92530,13853,106383,+
chr5,17276117,33.741910070798184,116893,66974,183867,+
chr5,17276118,31.146875731320645,93909,65024,158933,+
chr5,17276119,27.096564108461518,70971,63095,134066,+
chr5,17276153,0.34267471498935204,33178,68103,101281,+
chr5,17276267,0.6505207169355921,14409,8604,23013,+
chr5,17276268,1.1912996950077586,14135,8494,22629,+
chr5,17276272,0.9995327676101952,68433,40208,108641,+
chr5,17276273,0.9995327676101952,68433,40208,108641,+
chr5,17276297,1.2592808200505,39715,24422,64137,+
chr5,17276355,0.7745736232261424,10594,7680,18274,+
chr5,17276481,0.8984801007416552,17098,13512,30610,+
chr5,17276639,1.0572072354008886,3555,2457,6012,+
chr5,17276640,1.0572072354008886,3555,2457,6012,+
chr5,17276643,1.1096220326142416,2212,1292,3504,+
chr5,17276644,1.6301099644308694,3688,2350,6038,+
chr5,17276646,1.6692259311757907,7160,4942,12102,+
chr5,17276647,1.153458784599125,6086,4221,10307,+
chr5,17276649,1.0286132753215211,11577,7727,19304,+
chr5,17276650,0.99457006924769,12388,8378,20766,+
chr5,17276651,0.7935667503213565,5417,3161,8578,+
chr5,17276656,1.6558381775420639,4190,3136,7326,+
chr5,17276660,1.5064993182117141,6714,5143,11857,+
chr5,17276662,1.3894864832002594,3203,2242,5445,+
chr5,17276747,1.390734949179046,1422,1278,2700,+
chr5,17276757,1.0350492076274969,3531,3007,6538,+
chr5,21882998,1.796308954203691,656,398,1054,+
chr5,21883003,1.1770632827166654,1707,1078,2785,+
chr5,21883004,0.7375807415712903,5601,3827,9428,+
chr5,21883006,0.809303135715558,4660,3130,7790,+
chr5,21883007,1.6418813427010148,894,609,1503,+
chr5,21883008,1.254479682111261,2158,1367,3525,+
chr5,21883010,1.6141904761904764,996,749,1745,+
chr5,21883131,1.1016711032238982,950,587,1537,+
chr5,21883132,1.1016711032238982,950,587,1537,+
chr5,21883143,1.917389692250649,807,464,1271,+
chr5,21883279,0.8714550560781013,1481,1048,2529,+
chr5,21883280,1.0772464529689962,983,691,1674,+
chr5,21883527,0.8334022323274081,671,412,1083,+
chr5,21883528,1.9331333879170445,941,603,1544,+
chr5,21883529,1.3359084880636605,936,579,1515,+
chr5,21883531,1.6704366640440602,789,495,1284,+
chr5,21883533,2.724816220904605,708,474,1182,+
chr5,21883550,2.3243034055727554,692,407,1099,+
chr5,21883552,2.205353527540484,1011,675,1686,+
chr5,31535776,1.4703061125953587,992,660,1652,+
chr5,31535778,1.4703061125953587,992,660,1652,+
chr5,31535783,0.5783457734385365,1327,866,2193,+
chr5,31535787,2.8411035446132358,920,746,1666,+
chr5,31535789,2.328973685242558,1430,1185,2615,+
chr5,31535790,1.2982545806392383,1245,783,2028,+
chr5,31535791,2.0387581826430745,982,833,1815,+
chr5,31535795,1.9017811048012392,841,595,1436,+
chr5,31923460,0.7610596448155497,2337,1892,4229,+
chr5,31923461,0.8289182794864832,1643,1120,2763,+
chr5,31923462,0.7610596448155497,2337,1892,4229,+
chr5,31923514,1.754856552840864,1431,1077,2508,+
chr5,32585556,0.9197878319656769,778,431,1209,+
chr5,32585566,2.03674433472771,1287,756,2043,+
chr5,32585568,1.9324675324675324,1055,604,1659,+
chr5,32585570,1.9328896160808793,1447,915,2362,+
chr5,32585573,1.3045426150327981,1292,873,2165,+
chr5,32585584,1.5555555555555556,895,639,1534,+
chr5,32585585,1.4917438173919373,1634,1000,2634,+
chr5,32585591,1.4238835333464488,871,597,1468,+
chr5,32585592,1.7563895486935868,1421,841,2262,+
chr5,32585597,1.5665506742061768,1028,725,1753,+
chr5,32585598,2.358199587554918,796,586,1382,+
chr5,32591564,1.4514274869407602,6754,4901,11655,+
chr5,32591565,1.4801080729366818,9068,6200,15268,+
chr5,32591568,1.4974523494999057,7934,6055,13989,+
chr5,32591570,1.3331572382260282,15145,11269,26414,+
chr5,32591572,1.4830504639347488,20773,15048,35821,+
chr5,32591574,1.4743739772054703,16597,11804,28401,+
chr5,32591575,1.5821792444871616,5763,3918,9681,+
chr5,32591578,1.3371820615796521,3536,2240,5776,+
chr5,32591589,1.3648622451427104,12402,8882,21284,+
chr5,32591590,1.3989134254920337,9097,6401,15498,+
chr5,32591601,0.8190750202634351,17581,14713,32294,+
chr5,32591602,0.8190750202634351,17581,14713,32294,+
chr5,32591643,1.9663526386781318,9176,7907,17083,+
chr5,32598958,1.1983710665983847,612,443,1055,+
chr5,32601013,1.217229223918648,11093,7116,18209,+
chr5,32601014,1.3034473424128588,6379,3876,10255,+
chr5,32601020,1.4464233736329626,5525,3854,9379,+
chr5,33162155,0.7493305168813872,1176,610,1786,+
chr5,33162158,2.2817884114148232,2370,1150,3520,+
chr5,33162160,2.2817884114148232,2370,1150,3520,+
chr5,33162174,1.3253830287425001,9309,5532,14841,+
chr5,33162175,1.333424140827563,10214,6158,16372,+
chr5,33162176,1.30204600188906,6598,4394,10992,+
chr5,33162232,1.587710817488452,738,641,1379,+
chr5,33162242,1.7947067238912733,771,698,1469,+
chr5,33162245,1.5976249654791497,1156,780,1936,+
chr5,33162251,0.6288416075650117,911,647,1558,+
chr5,33162253,1.8787880626784472,1650,1539,3189,+
chr5,33162254,0.6215999197029007,1125,737,1862,+
chr5,33162280,1.3110216700207076,1137,1038,2175,+
chr5,33162338,1.5588562469999996,1675,1013,2688,+
chr5,33162339,1.5443037974683542,1158,645,1803,+
chr5,33162352,1.1281643032701065,706,655,1361,+
chr5,33162364,1.047586442998973,1359,1396,2755,+
chr5,33162365,1.047586442998973,1359,1396,2755,+
chr5,33162366,1.047586442998973,1359,1396,2755,+
chr5,33162368,0.8160685692646567,10722,7909,18631,+
chr5,33162369,1.1344428357132248,8837,7108,15945,+
chr5,33162370,0.7381111040866859,6656,5135,11791,+
chr5,33162371,1.2750459426506067,6997,5878,12875,+
chr5,33162375,1.2068784879619476,1867,1581,3448,+
chr5,33162381,1.249069275581007,7411,5591,13002,+
chr5,33162382,1.2559738805554177,9756,7582,17338,+
chr5,33162385,0.7200866323195695,16150,13819,29969,+
chr5,33162386,0.6626193317422434,4508,5027,9535,+
chr5,33440991,0.9527252974826433,1329,1075,2404,+
chr5,33440992,0.9527252974826433,1329,1075,2404,+
chr5,33445359,2.0657712903783034,1062,826,1888,+
chr5,33445363,1.9403283940728877,1139,907,2046,+
chr5,33445366,0.7138877835256665,1520,1076,2596,+
chr5,33448542,2.0125639094764383,1750,1096,2846,+
chr5,33453363,1.6685754278806388,1048,805,1853,+
chr5,33454947,1.9064500246184144,879,676,1555,+
chr5,33455006,2.234809997967893,1659,1035,2694,+
chr5,33456004,1.5046296296296295,1351,935,2286,+
chr5,33456013,1.4674633943161066,1453,1057,2510,+
chr5,33456169,0.7378454656797487,1731,1476,3207,+
chr5,33457285,1.4922505004289386,1778,1344,3122,+
chr5,33457335,1.6344358766233764,1809,1539,3348,+
chr5,33459743,1.480802627604953,1985,1231,3216,+
chr5,33460905,1.6284775465498356,1061,912,1973,+
chr5,33460910,2.0102564102564098,1567,935,2502,+
chr5,33460934,1.0863573391121883,2088,1720,3808,+
chr5,33460952,1.819555147519092,1013,772,1785,+
chr5,33460966,0.7874879757156129,5615,4039,9654,+
chr5,33460967,1.0263094212097157,2369,1770,4139,+
chr5,33461019,1.3535585803955748,3395,2296,5691,+
chr5,33461227,1.4911407766990292,2233,1441,3674,+
chr5,33461922,1.65470812031863,1686,1293,2979,+
chr5,33462100,1.791797752808989,861,711,1572,+
chr5,33462115,1.4484369785293132,1952,1211,3163,+
chr5,33462116,1.5449900299102692,1126,1002,2128,+
chr5,33462117,0.7014019866716963,1683,1445,3128,+
chr5,33463777,1.663231441048035,1586,915,2501,+
chr5,33463810,1.3960479293672483,1831,1135,2966,+
chr5,33466877,1.398200915315744,3807,2538,6345,+
chr5,33467577,1.6120172737456646,4415,3043,7458,+
chr5,33467715,1.454702305839165,2663,1894,4557,+
chr5,33467722,1.4810725340023647,4506,3218,7724,+
chr5,34915708,1.63606862225243,722,501,1223,+
chr5,34915798,2.2245179063360885,645,483,1128,+
chr5,34915862,1.903039636345629,1147,803,1950,+
chr5,34915874,1.847491780676636,669,448,1117,+
chr5,34918371,0.5888608791555064,1494,1153,2647,+
chr5,34918372,0.6015364679748242,2327,1775,4102,+
chr5,34918374,0.6127189642041128,1608,1211,2819,+
chr5,34918379,1.742270992366412,960,654,1614,+
chr5,34919843,1.0506771344455348,1486,1018,2504,+
chr5,34919845,1.2288942163147205,2806,1975,4781,+
chr5,34922566,1.7195187276726487,2330,1641,3971,+
chr5,34922714,1.5717208091908355,3060,2330,5390,+
chr5,34922715,1.6683399982983067,1823,1287,3110,+
chr5,34922726,2.027253209481663,1075,786,1861,+
chr5,34922753,1.4590536230625086,1546,1320,2866,+
chr5,34923011,2.274851529111395,1862,1675,3537,+
chr5,34923137,1.5671366936756814,1294,883,2177,+
chr5,34923149,1.5117085862966178,1659,1152,2811,+
chr5,34923152,1.9672995259595063,4436,2977,7413,+
chr5,34923158,1.6083637257638466,3832,2802,6634,+
chr5,34923159,1.2900575508461294,8968,6239,15207,+
chr5,34924874,1.8260617760617759,1050,739,1789,+
chr5,34924944,1.535979228486647,908,673,1581,+
chr5,34925235,3.151010101010101,1100,659,1759,+
chr5,34925236,3.0013487475915213,841,691,1532,+
chr5,34925259,1.6444848614528724,808,718,1526,+
chr5,34925303,1.5562358052730323,1181,778,1959,+
chr5,34925304,1.4079747870664034,1216,982,2198,+
chr5,34935715,2.504956125295424,757,485,1242,+
chr5,34937476,2.3254769921436593,443,593,1036,+
chr5,34937477,3.419853260818783,1299,1292,2591,+
chr5,34937478,4.1489682539682535,856,699,1555,+
chr5,34938873,1.672447833168932,1154,621,1775,+
chr5,34938874,0.7057893696897847,892,481,1373,+
chr5,34938875,0.9991383881230116,1205,655,1860,+
chr5,34944922,3.8193920155902865,893,552,1445,+
chr5,34953946,1.3859368643555323,899,592,1491,+
chr5,34954556,2.2040540540540543,698,369,1067,+
chr5,34954572,0.3307377049180327,806,487,1293,+
chr5,34954573,2.037977459106258,1255,690,1945,+
chr5,34954581,3.5826086956521737,926,620,1546,+
chr5,34954582,0.5746361746361747,690,454,1144,+
chr5,36166533,2.258143580266446,611,444,1055,+
chr5,36170404,2.0554419220120455,1308,843,2151,+
chr5,36170405,2.2587268993839835,769,486,1255,+
chr5,36606655,0.9967862326352892,640,370,1010,+
chr5,36606657,1.6633056438564633,822,517,1339,+
chr5,36608549,0.5677318295739349,696,419,1115,+
chr5,36629542,0.43465553235908144,693,478,1171,+
chr5,36677105,1.6605263157894736,630,455,1085,+
chr5,36679628,3.390991986736668,1247,657,1904,+
chr5,36679742,3.2345774815142567,803,558,1361,+
chr5,36683973,0.9059829059829058,635,539,1174,+
chr5,36683974,0.9059829059829058,635,539,1174,+
chr5,36686138,1.9720556089523988,1136,747,1883,+
chr5,36686411,2.1282620223867714,1410,875,2285,+
chr5,36686424,0.5379279811097992,728,461,1189,+
chr5,36686446,2.0088018817816224,853,572,1425,+
chr5,36686453,1.4928774928774928,1047,701,1748,+
chr5,36686973,2.3289237668161435,798,668,1466,+
chr5,36686975,2.3289237668161435,798,668,1466,+
chr5,36687037,0.3013546989024889,872,677,1549,+
chr5,36687103,2.446753246753247,941,604,1545,+
chr5,36687104,2.446753246753247,941,604,1545,+
chr5,36687107,2.0434487270777186,877,646,1523,+
chr5,36687210,1.4199441466919815,1048,897,1945,+
chr5,36687249,0.6241597849049357,649,507,1156,+
chr5,36687445,1.7703163348786473,1128,771,1899,+
chr5,36687460,0.6104536489151874,618,467,1085,+
chr5,36687906,1.5883361921097767,925,688,1613,+
chr5,36687955,1.7971014492753623,743,503,1246,+
chr5,37064543,1.3814418946947467,664,599,1263,+
chr5,38869052,1.4731687756949658,988,685,1673,+
chr5,38869070,0.5945059857930556,703,490,1193,+
chr5,38876239,0.5922939068100358,660,557,1217,+
chr5,38881649,1.9858847660360734,1147,784,1931,+
chr5,38881710,1.747919876733436,708,589,1297,+
chr5,38883826,2.2171908893709324,628,460,1088,+
chr5,38883831,1.7401397515527945,722,559,1281,+
chr5,38884058,2.613211845102506,716,438,1154,+
chr5,38884067,3.154549740688355,777,504,1281,+
chr5,38886433,0.5086304470854556,718,557,1275,+
chr5,38933851,2.700631911836993,659,437,1096,+
chr5,38934291,6.933122279382667,729,360,1089,+
chr5,41920632,19.676523153254543,818,431,1249,+
chr5,41920651,7.103723158070015,654,633,1287,+
chr5,41920658,8.638820382598611,1145,1707,2852,+
chr5,41920659,8.638820382598611,1145,1707,2852,+
chr5,41929873,1.7400956658268516,850,536,1386,+
chr5,41929875,1.8433434097943515,1144,751,1895,+
chr5,41933972,2.223030412613137,1012,797,1809,+
chr5,41933986,1.8604734576757533,797,696,1493,+
chr5,43173375,2.142111267058563,792,627,1419,+
chr5,43174989,1.9059792337987824,618,398,1016,+
chr5,43609208,1.202113970588235,901,639,1540,+
chr5,43609210,1.202113970588235,901,639,1540,+
chr5,43615895,2.5893048128342246,806,494,1300,+
chr5,43615896,2.5893048128342246,806,494,1300,+
chr5,43628222,5.041774419496569,687,506,1193,+
chr5,43628337,3.86288441268113,580,435,1015,+
chr5,43653151,4.014550264550264,606,419,1025,+
chr5,43653152,4.014550264550264,606,419,1025,+
chr5,43704936,0.46567806744797907,707,451,1158,+
chr5,43705293,1.7566869771764952,629,420,1049,+
chr5,44809473,3.428861781514973,1036,583,1619,+
chr5,44809475,3.428861781514973,1036,583,1619,+
chr5,44811945,1.669240382040525,958,658,1616,+
chr5,44811957,1.9800420168067228,579,447,1026,+
chr5,44812001,1.924923076923077,919,649,1568,+
chr5,44813154,1.9064625850340138,589,419,1008,+
chr5,44813169,1.710675107063535,1827,1300,3127,+
chr5,44815036,2.5531135531135534,696,454,1150,+
chr5,44815175,2.8388017118402282,994,700,1694,+
chr5,52800668,1.0008386968229959,706,433,1139,+
chr5,52801713,1.2656316080518375,1271,805,2076,+
chr5,52801715,1.2935267857142856,731,383,1114,+
chr5,52801853,1.178679712734553,1098,779,1877,+
chr5,52849463,0.9073426254229501,884,568,1452,+
chr5,52849464,1.0694665957823852,709,417,1126,+
chr5,52864789,1.3456688879025556,910,560,1470,+
chr5,52865736,1.9765397542870862,546,477,1023,+
chr5,52898278,3.964999514164923,646,451,1097,+
chr5,52908918,1.1243122398165482,1279,935,2214,+
chr5,52908919,0.6638903611721058,821,842,1663,+
chr5,52908923,1.4976465554129226,839,683,1522,+
chr5,52908950,1.7350457017239385,2943,2880,5823,+
chr5,52908951,1.7350457017239385,2943,2880,5823,+
chr5,52910197,1.787144867095413,620,416,1036,+
chr5,52910240,2.8941533434473103,799,450,1249,+
chr5,52910241,3.1716569605506817,1087,626,1713,+
chr5,52910349,2.297242038571393,666,512,1178,+
chr5,52918820,0.866738894907909,599,425,1024,+
chr5,52918822,0.866738894907909,599,425,1024,+
chr5,52947444,0.5968921942076304,616,446,1062,+
chr5,52952437,2.2034068136272538,732,498,1230,+
chr5,52952603,1.7016961651917406,709,451,1160,+
chr5,52953089,2.354196799723291,641,517,1158,+
chr5,52954334,2.0724826388888893,954,511,1465,+
chr5,52954335,2.0724826388888893,954,511,1465,+
chr5,52954344,2.5030051813471506,928,578,1506,+
chr5,52954346,1.3148388384392775,1463,910,2373,+
chr5,52954347,1.521520704997473,1099,627,1726,+
chr5,52954348,1.0095317032739328,1014,634,1648,+
chr5,52954377,0.4588165464341157,772,465,1237,+
chr5,52954378,1.8716744913928014,1039,709,1748,+
chr5,52954381,0.5578996939015776,1076,684,1760,+
chr5,53560725,2.109182098765432,780,479,1259,+
chr5,53560727,2.383961018716449,1125,682,1807,+
chr5,53603495,2.3773677360589485,1046,800,1846,+
chr5,53646347,0.5351041276967203,612,485,1097,+
chr5,53658553,3.135335203867842,836,539,1375,+
chr5,53658560,2.068178465355299,891,709,1600,+
chr5,53859239,2.8091954022988506,610,434,1044,+
chr5,55160177,0.8131318394997396,829,504,1333,+
chr5,55160179,0.9337498757286633,3043,1928,4971,+
chr5,55160180,1.025542136261232,3841,2447,6288,+
chr5,55161027,1.081005897866049,1375,1081,2456,+
chr5,55161079,2.0460351892022173,652,460,1112,+
chr5,55161167,0.642072213500785,817,571,1388,+
chr5,55161169,2.3813882250323655,1731,1218,2949,+
chr5,55164146,0.6163592622293503,853,644,1497,+
chr5,55164167,2.265763021626561,550,468,1018,+
chr5,55164380,0.6606567747872094,918,643,1561,+
chr5,55164405,2.155478964932436,984,676,1660,+
chr5,55350948,3.1463193905279505,670,578,1248,+
chr5,55400327,2.847357026639107,1083,795,1878,+
chr5,55944983,1.8453417788334652,607,420,1027,+
chr5,55944987,1.5978865406006677,675,495,1170,+
chr5,55944988,1.5912598204264872,1744,1295,3039,+
chr5,55945000,2.6417725441586613,549,460,1009,+
chr5,55945001,2.6417725441586613,549,460,1009,+
chr5,60945207,0.3540497193263833,882,405,1287,+
chr5,60945291,0.4964551452021138,672,517,1189,+
chr5,61152829,0.6254587921254589,977,665,1642,+
chr5,61152854,1.5372058144900784,1133,787,1920,+
chr5,61152863,1.4884677636903156,1050,673,1723,+
chr5,61152867,0.6811271607861711,1597,1029,2626,+
chr5,65563391,2.031957461051607,647,377,1024,+
chr5,65572098,0.4612941643509329,580,457,1037,+
chr5,65572100,0.4300205821817112,935,715,1650,+
chr5,65572102,0.3820929569432563,669,500,1169,+
chr5,65664637,4.857132077658583,709,418,1127,+
chr5,65992802,2.129895346378678,1087,621,1708,+
chr5,65992818,1.6344904184072677,2292,1370,3662,+
chr5,65992819,1.6344904184072677,2292,1370,3662,+
chr5,65992820,1.6344904184072677,2292,1370,3662,+
chr5,66025924,2.375607931163487,634,593,1227,+
chr5,66025925,2.454915203214523,934,781,1715,+
chr5,66053892,1.8287187934734364,1002,681,1683,+
chr5,66053894,1.8771965341323185,652,465,1117,+
chr5,66053898,2.55001992825827,913,771,1684,+
chr5,66053900,2.55001992825827,913,771,1684,+
chr5,66053910,2.3823383823383826,751,480,1231,+
chr5,66054219,3.3769848821674757,847,498,1345,+
chr5,66054256,1.776277160409319,1320,716,2036,+
chr5,66054260,2.664572864321608,807,397,1204,+
chr5,66054280,1.5361730899256254,1135,637,1772,+
chr5,66054285,3.1160248041775467,1272,765,2037,+
chr5,66054301,1.788028092334495,3623,2623,6246,+
chr5,66054302,1.788028092334495,3623,2623,6246,+
chr5,66054303,1.9387564282374943,4900,3626,8526,+
chr5,66054305,2.0119219435925193,2524,1927,4451,+
chr5,66054313,2.1363713263379673,3733,2717,6450,+
chr5,66079080,3.026353276353277,606,467,1073,+
chr5,69167254,2.6402805611222444,526,498,1024,+
chr5,69167991,1.853605442176871,785,440,1225,+
chr5,69168008,0.5989508822126848,627,465,1092,+
chr5,69168037,2.0784313725490198,635,431,1066,+
chr5,69168049,0.5255796196029432,796,685,1481,+
chr5,69168061,2.535991140642304,686,515,1201,+
chr5,69168276,3.067882472137791,756,422,1178,+
chr5,69168300,2.3463595228301117,743,428,1171,+
chr5,69168315,1.736618505174789,1571,1015,2586,+
chr5,69168316,2.063802083333333,633,479,1112,+
chr5,69171319,1.554521212121212,942,624,1566,+
chr5,69171397,0.6638864501024291,1395,1138,2533,+
chr5,69174891,1.5763766642699526,1155,760,1915,+
chr5,69174946,0.9671539894229992,4851,3444,8295,+
chr5,69174947,1.2175716320326784,7952,5728,13680,+
chr5,69174949,1.5571934158217022,6798,4774,11572,+
chr5,69174950,1.5170526303451553,3697,2490,6187,+
chr5,69174952,1.558903016378752,6552,4960,11512,+
chr5,69174954,1.5410136203500788,3583,2772,6355,+
chr5,69175040,0.6656167714462097,2031,1333,3364,+
chr5,69175101,1.4294254436961151,1944,1153,3097,+
chr5,69175440,1.9157913165266105,705,543,1248,+
chr5,69175480,0.5993466941742803,1060,701,1761,+
chr5,69175481,1.1330296422127761,1806,1386,3192,+
chr5,69177559,1.7684812311232558,1092,817,1909,+
chr5,69177594,0.6612513296586404,1051,765,1816,+
chr5,69194649,1.818674375192299,923,681,1604,+
chr5,69194651,1.8010055945046388,747,522,1269,+
chr5,69195720,4.45493412373161,1067,757,1824,+
chr5,69208214,1.7788461538461535,961,675,1636,+
chr5,69208226,2.1792136543736667,649,385,1034,+
chr5,69210173,2.3074047052286275,663,449,1112,+
chr5,69210269,1.9236138127630173,777,543,1320,+
chr5,69229220,2.6304890219560875,810,500,1310,+
chr5,69252430,0.9063594470046084,893,650,1543,+
chr5,69252432,1.2176383957377332,1166,835,2001,+
chr5,69269211,0.9683239775461108,574,429,1003,+
chr5,69269212,0.9683239775461108,574,429,1003,+
chr5,69276590,7.094896874090041,655,440,1095,+
chr5,69334329,0.2814685388619552,581,553,1134,+
chr5,69334331,0.2814685388619552,581,553,1134,+
chr5,71604356,0.430913769189274,1120,635,1755,+
chr5,72848474,1.991464510332435,681,423,1104,+
chr5,72848483,4.226791726791727,702,461,1163,+
chr5,72851257,0.5296758111764497,1229,786,2015,+
chr5,72855774,1.7141577408093582,1171,851,2022,+
chr5,72855806,1.5772200772200768,1101,811,1912,+
chr5,72877271,1.9134036144578312,846,663,1509,+
chr5,72882495,1.9441048034934496,635,457,1092,+
chr5,72887069,2.3035364031436147,989,792,1781,+
chr5,72887070,2.3622716585277628,705,581,1286,+
chr5,72888091,1.166270018686199,794,690,1484,+
chr5,72889824,1.875015701545032,648,418,1066,+
chr5,72889870,0.5595408895265424,714,450,1164,+
chr5,72889873,2.1489898989898992,850,599,1449,+
chr5,72889874,2.1489898989898992,850,599,1449,+
chr5,72896488,0.669014778325123,1005,724,1729,+
chr5,72900065,0.7557446446612229,1132,892,2024,+
chr5,72900066,0.8721642468239563,698,550,1248,+
chr5,72905316,3.3672985781990525,734,421,1155,+
chr5,72905334,1.7375260167632334,935,612,1547,+
chr5,72905337,1.6659850034083163,610,488,1098,+
chr5,72908830,28.27955997770969,2721,535,3256,+
chr5,72908831,27.74391854888507,2733,573,3306,+
chr5,72908833,27.674578989574982,1526,644,2170,+
chr5,72908834,52.25560243290757,2767,2080,4847,+
chr5,72908835,52.25560243290757,2767,2080,4847,+
chr5,72908838,13.590320060347596,1244,2066,3310,+
chr5,72908852,0.33029899667647117,778,1198,1976,+
chr5,72908853,0.5059171597633136,512,675,1187,+
chr5,72908876,0.6388092269326683,758,801,1559,+
chr5,72908962,0.5841025591929808,1717,1172,2889,+
chr5,72908970,1.9789473684210528,751,531,1282,+
chr5,72909167,0.42027673606620974,649,406,1055,+
chr5,72909193,2.6195426195426204,629,443,1072,+
chr5,72909225,4.2885032537960965,658,460,1118,+
chr5,72909385,13.096743502484513,1722,162,1884,+
chr5,72909386,13.126778491721073,2515,203,2718,+
chr5,72909387,12.497814933630464,3502,301,3803,+
chr5,72909388,30.926542987424906,4811,444,5255,+
chr5,72909389,68.10217025428747,6876,1956,8832,+
chr5,72909390,68.71062043783687,6406,2433,8839,+
chr5,72909391,67.76285567802479,5204,2338,7542,+
chr5,72909409,8.019135865002557,4057,5990,10047,+
chr5,72909410,8.019135865002557,4057,5990,10047,+
chr5,72909591,1.676407697790449,671,487,1158,+
chr5,72909661,2.2986438679245285,677,423,1100,+
chr5,72909968,1.2294085012814246,2395,1794,4189,+
chr5,72913025,0.3986765126341564,805,510,1315,+
chr5,72913251,2.3580740238306803,1111,752,1863,+
chr5,73498440,0.7200167120467963,1236,618,1854,+
chr5,73498441,0.8815263039539021,1742,1036,2778,+
chr5,73498442,0.9651569533933662,2531,1295,3826,+
chr5,73498443,1.0585239608309007,2077,1341,3418,+
chr5,73498447,0.7925676301838396,2211,1079,3290,+
chr5,73498452,1.7308141321044548,1656,650,2306,+
chr5,73498458,1.29579845616067,5643,3465,9108,+
chr5,73498517,0.5872337588006157,1853,1650,3503,+
chr5,73498522,1.5468095896726604,4017,2891,6908,+
chr5,73498523,1.5468095896726604,4017,2891,6908,+
chr5,73498541,0.9784738162870186,4870,4325,9195,+
chr5,73498542,1.3449024534027898,10499,8094,18593,+
chr5,73499137,1.3026614049305283,2334,1685,4019,+
chr5,73502492,1.859820788530466,2730,1859,4589,+
chr5,73502502,0.7826507786285812,3731,2831,6562,+
chr5,73502503,1.7004426522051495,3108,2270,5378,+
chr5,73502917,1.3422155959734634,4060,2595,6655,+
chr5,73502943,1.5002001405865584,3234,1765,4999,+
chr5,73503031,1.2535431295497006,5188,3267,8455,+
chr5,73504354,1.5706925824014988,2438,1652,4090,+
chr5,73505220,1.2862955312735964,3297,2256,5553,+
chr5,73505355,1.466225165562914,3074,1660,4734,+
chr5,73505357,1.3594299247932853,5276,3521,8797,+
chr5,73505358,1.3594299247932853,5276,3521,8797,+
chr5,73579959,0.6646935011363241,978,482,1460,+
chr5,74685209,0.9001452912429005,704,338,1042,+
chr5,74685210,0.9001452912429005,704,338,1042,+
chr5,74685211,2.3052943063556373,831,440,1271,+
chr5,74689366,1.9502923976608184,695,431,1126,+
chr5,74689376,1.1479001444596626,1202,837,2039,+
chr5,74689386,2.3145161290322585,737,495,1232,+
chr5,74689451,0.5518800635211154,931,700,1631,+
chr5,74693638,0.5915627996164909,2467,1638,4105,+
chr5,74693639,1.530718106662344,1063,795,1858,+
chr5,74693640,0.6713337411818445,5623,3567,9190,+
chr5,74693641,0.735730931963708,3156,1929,5085,+
chr5,74715512,1.9227005870841485,654,437,1091,+
chr5,74715572,1.584323317027719,1560,1112,2672,+
chr5,74716621,1.8937875751503008,699,498,1197,+
chr5,74718812,2.774774774774775,615,443,1058,+
chr5,74718837,1.5514473864727674,1076,787,1863,+
chr5,74718853,1.7874538745387454,1037,812,1849,+
chr5,74718857,1.896627104212568,1716,1311,3027,+
chr5,74718871,1.5365691046431305,1760,1399,3159,+
chr5,74718891,1.8180742680151019,2047,1633,3680,+
chr5,74718906,0.6882133018496656,1398,1088,2486,+
chr5,74720494,1.5758190327613104,1091,640,1731,+
chr5,74720651,2.4900596421471173,667,502,1169,+
chr5,74720676,2.7239527389903326,633,440,1073,+
chr5,74721176,2.331626557433009,718,557,1275,+
chr5,74721187,1.6206361616508904,2017,1433,3450,+
chr5,74767287,2.6314245628616035,758,578,1336,+
chr5,74768934,1.8242412518179452,593,489,1082,+
chr5,74769035,1.7099406238184456,1514,919,2433,+
chr5,74770688,0.814814369529672,1652,1123,2775,+
chr5,74770689,1.0463773966585892,2237,1513,3750,+
chr5,74770692,2.421311763671532,917,516,1433,+
chr5,74770708,1.7349579831932769,1146,679,1825,+
chr5,74770712,2.4304686017833426,1113,752,1865,+
chr5,74770714,2.0660874144286465,825,632,1457,+
chr5,74773879,1.4668079421384808,795,442,1237,+
chr5,74773889,2.502392228638604,2266,1502,3768,+
chr5,74773896,2.11437908496732,646,467,1113,+
chr5,74776607,0.6298115697631791,858,592,1450,+
chr5,74776632,1.6195350699110744,1179,852,2031,+
chr5,75351174,1.7637379834782825,701,540,1241,+
chr5,75351209,2.3078371602231273,940,750,1690,+
chr5,75351242,2.159357429718876,610,414,1024,+
chr5,75354579,3.5108581160441625,600,475,1075,+
chr5,75354613,0.4053310908851075,590,493,1083,+
chr5,75358755,1.1824390243902443,605,409,1014,+
chr5,75358757,1.1824390243902443,605,409,1014,+
chr5,75587037,1.9175546003566757,640,496,1136,+
chr5,76376827,0.6900631051520605,878,692,1570,+
chr5,77419844,3.2180396753549165,993,688,1681,+
chr5,77419846,2.2219684554936188,1179,720,1899,+
chr5,77419848,2.357824823578248,709,437,1146,+
chr5,77582353,1.313677377576019,2670,2320,4990,+
chr5,77582354,0.9209137939070048,1758,1090,2848,+
chr5,77582355,1.1709635875416542,4428,3410,7838,+
chr5,78415537,1.170258620689655,542,463,1005,+
chr5,85465194,1.0242803642403195,920,941,1861,+
chr5,85465195,1.2098214285714286,812,527,1339,+
chr5,85465196,0.8875441649528027,820,881,1701,+
chr5,85465197,0.9845504282014408,2009,1544,3553,+
chr5,85465199,0.6593851644666067,1041,652,1693,+
chr5,85465200,0.6442026369763039,1616,1339,2955,+
chr5,85465202,0.9826451189997636,4708,3242,7950,+
chr5,85465204,0.9301876527301096,5458,3820,9278,+
chr5,85465205,1.0606730217739093,8684,7736,16420,+
chr5,85465206,1.1632766377804928,3277,3644,6921,+
chr5,85465207,1.0338973539913656,6030,5785,11815,+
chr5,86617927,0.7398593905704417,1295,512,1807,+
chr5,86617932,2.3204942498530525,1241,574,1815,+
chr5,86617934,1.7237567318113527,2151,974,3125,+
chr5,86617936,1.798552106598189,4309,2246,6555,+
chr5,86617937,1.825750305792927,3934,2320,6254,+
chr5,86617938,1.7191812145490692,6486,3951,10437,+
chr5,86617939,2.1042385137390145,1939,1615,3554,+
chr5,86617940,1.6162997998710558,5305,3639,8944,+
chr5,86617942,1.5921367456574032,5781,3784,9565,+
chr5,86617943,1.1885010325564576,2472,1533,4005,+
chr5,86617944,2.2794202898550733,982,574,1556,+
chr5,86617945,1.438644945517316,1257,712,1969,+
chr5,86617962,1.547519982614754,5116,3357,8473,+
chr5,86617964,1.5172024159682218,3655,2443,6098,+
chr5,86617968,0.7015218100014363,3366,2512,5878,+
chr5,86617969,1.4980164938315752,2602,1903,4505,+
chr5,86617975,0.6886617329005305,11077,7666,18743,+
chr5,86617977,0.9698786473546328,9403,6037,15440,+
chr5,86617978,1.3175300497737144,11585,8049,19634,+
chr5,86618110,1.2211966868308446,12318,6032,18350,+
chr5,86619350,1.2689070645377905,18829,9800,28629,+
chr5,86619351,1.5760001992839523,17146,7029,24175,+
chr5,86619352,1.3497513926065687,62118,30653,92771,+
chr5,86619353,1.4299629545770745,57045,28286,85331,+
chr5,86619362,1.5228173556315692,10233,4558,14791,+
chr5,86619369,1.7108673803430177,49938,32571,82509,+
chr5,86619370,1.4111772871927122,122782,73018,195800,+
chr5,86619372,1.4861917055425358,122748,73531,196279,+
chr5,86619373,1.592173199215746,83942,50805,134747,+
chr5,86619376,1.3036149597260156,17333,8011,25344,+
chr5,86619386,1.3995372269423665,8054,4548,12602,+
chr5,86619387,1.0886371570773736,22014,10868,32882,+
chr5,86619390,1.336850955803072,32693,16995,49688,+
chr5,86619400,1.562444143345683,72326,38509,110835,+
chr5,86619404,1.5623789163563875,66490,35913,102403,+
chr5,86619407,1.1646419931711764,122723,81210,203933,+
chr5,86619412,1.5639831814329719,80028,46298,126326,+
chr5,86619418,1.029353290959857,175526,119208,294734,+
chr5,86619426,1.3319537887635982,50005,33257,83262,+
chr5,86619440,1.2960101254067358,133060,92142,225202,+
chr5,86619441,1.2960101254067358,133060,92142,225202,+
chr5,86619444,1.7416461874980158,73913,53927,127840,+
chr5,86620664,1.0130957492486043,1088,713,1801,+
chr5,86620666,1.2096588246542324,1561,1087,2648,+
chr5,93593963,3.3000403594822156,749,255,1004,+
chr5,93593964,3.661500549944136,1268,397,1665,+
chr5,93593966,8.311723602484474,792,275,1067,+
chr5,93593967,8.775013975627576,962,436,1398,+
chr5,93593970,6.67942020030233,1549,1112,2661,+
chr5,93593971,4.42374074995504,2079,1578,3657,+
chr5,93593973,2.881117543216047,1332,1211,2543,+
chr5,93593974,0.3174387947269303,601,589,1190,+
chr5,93593978,0.44031083216608496,842,660,1502,+
chr5,93593989,0.47550142721128325,1560,1083,2643,+
chr5,93593991,0.45762711864406774,989,648,1637,+
chr5,93593992,0.47233910942932655,2222,1553,3775,+
chr5,93593993,0.548575417221905,1364,917,2281,+
chr5,93593995,0.5164329455902437,3016,1916,4932,+
chr5,93593997,0.5339775166421505,3800,2389,6189,+
chr5,93593998,1.1618145706159406,3875,2398,6273,+
chr5,93593999,0.4628340757238307,699,448,1147,+
chr5,93594094,2.1730027548209367,543,483,1026,+
chr5,93594175,2.3025267485682184,640,421,1061,+
chr5,94628814,3.556438577586207,676,463,1139,+
chr5,94628815,3.556438577586207,676,463,1139,+
chr5,94653294,2.6431235128960515,949,519,1468,+
chr5,94653377,2.3715265866209263,891,582,1473,+
chr5,94694836,2.193960923623446,771,562,1333,+
chr5,94694839,1.7191971383147855,843,628,1471,+
chr5,94694867,1.8246869409660107,985,558,1543,+
chr5,94694902,2.3495163865151656,694,462,1156,+
chr5,94694926,1.8866551007146741,2928,2068,4996,+
chr5,94695410,3.7645283018867928,687,529,1216,+
chr5,94695479,1.5923022095509622,1116,731,1847,+
chr5,94696571,1.9638200647224433,681,485,1166,+
chr5,95793640,2.125082991741636,689,485,1174,+
chr5,95793665,4.078387872065077,718,484,1202,+
chr5,95794302,1.211023643273099,829,644,1473,+
chr5,95795702,4.239361805642048,653,494,1147,+
chr5,95796178,1.628842504743833,739,526,1265,+
chr5,96722678,0.985949851778656,1100,703,1803,+
chr5,96722679,0.985949851778656,1100,703,1803,+
chr5,96729626,2.0443864229765016,666,382,1048,+
chr5,96736180,1.001404253861698,885,678,1563,+
chr5,96736182,1.3170991418253168,1300,1036,2336,+
chr5,96736206,1.6027925304094568,566,448,1014,+
chr5,96742656,2.914851060696145,794,510,1304,+
chr5,96748526,2.2433807225772795,687,450,1137,+
chr5,96748556,2.8562874251497012,741,500,1241,+
chr5,96748592,1.6317016317016315,799,571,1370,+
chr5,96750586,1.225397045476071,802,655,1457,+
chr5,96754087,3.455368161250514,671,441,1112,+
chr5,96754121,1.7536880175121348,995,552,1547,+
chr5,96754667,1.8374060150375942,1954,1063,3017,+
chr5,96754670,0.4778499777635025,2468,1371,3839,+
chr5,96754682,1.4687982838098403,2017,1102,3119,+
chr5,96754701,1.4652302426882389,2897,1606,4503,+
chr5,96767985,2.054405677114133,578,444,1022,+
chr5,96770569,2.6290115532734277,703,450,1153,+
chr5,96771687,2.2169135212613478,869,597,1466,+
chr5,96772658,1.7098484171077946,2342,1685,4027,+
chr5,96772705,1.6901574803149606,794,507,1301,+
chr5,96774558,1.3627566910398103,1074,810,1884,+
chr5,102866218,2.3671810791664867,703,517,1220,+
chr5,102866220,2.3671810791664867,703,517,1220,+
chr5,102924980,0.3751597239969333,733,601,1334,+
chr5,102924981,0.3792463083899664,957,779,1736,+
chr5,102948424,2.8573008849557517,573,451,1024,+
chr5,102949908,3.003702234824872,683,495,1178,+
chr5,102950778,2.1705999435590297,1191,847,2038,+
chr5,102950780,2.767353165522502,906,620,1526,+
chr5,102990307,2.191696829113008,671,438,1109,+
chr5,103007573,0.5515554951772857,579,432,1011,+
chr5,103009789,2.749454013210141,656,493,1149,+
chr5,103019805,1.5928723876771216,1334,901,2235,+
chr5,103019806,1.024163370041698,926,596,1522,+
chr5,103019809,2.637761518276991,1444,1099,2543,+
chr5,103025311,3.3462993848238343,1283,983,2266,+
chr5,103025312,4.327156020291955,971,742,1713,+
chr5,109817383,2.047178988326848,1241,1027,2268,+
chr5,109817385,1.9356918238993712,1893,1589,3482,+
chr5,109817386,1.8037684603632655,1287,1095,2382,+
chr5,109845950,4.958246259432735,580,428,1008,+
chr5,109867921,18.260547411759312,552,941,1493,+
chr5,109867947,0.16867045024438904,661,1077,1738,+
chr5,109867949,0.22989874925550924,385,656,1041,+
chr5,110762217,0.5230345814133637,1056,713,1769,+
chr5,112161078,1.6265137029955383,637,522,1159,+
chr5,112161079,1.6265137029955383,637,522,1159,+
chr5,112161080,1.6265137029955383,637,522,1159,+
chr5,112161108,2.361087866108787,593,477,1070,+
chr5,112161109,2.361087866108787,593,477,1070,+
chr5,112161118,3.739195790810359,582,445,1027,+
chr5,112864715,3.438065914071327,789,569,1358,+
chr5,112867541,2.1621875,628,399,1027,+
chr5,112867609,5.928814113517208,1198,983,2181,+
chr5,112867670,1.4950265251989387,1001,753,1754,+
chr5,115512913,1.006156371521276,2311,2037,4348,+
chr5,115512914,0.9021813713278992,3656,3220,6876,+
chr5,115512915,1.0049921364640109,1810,1202,3012,+
chr5,115512916,0.7106507327458673,3428,2978,6406,+
chr5,115512917,0.5852608929532007,543,714,1257,+
chr5,115512920,0.5958829902491874,439,567,1006,+
chr5,115512928,1.2819183247993688,1973,1889,3862,+
chr5,115512929,1.227310557410737,1421,1144,2565,+
chr5,115512931,0.6852496876538068,682,865,1547,+
chr5,115512935,0.6581559632379149,2736,2187,4923,+
chr5,115513200,1.2504907729517107,726,682,1408,+
chr5,115513246,1.1931028863478264,3432,2716,6148,+
chr5,115513247,1.6319675655752808,1013,1114,2127,+
chr5,115913722,2.5953859804791484,674,482,1156,+
chr5,116562524,0.8589009264692888,882,372,1254,+
chr5,116562551,1.9579087606548666,850,576,1426,+
chr5,119118946,1.7035741674361415,958,660,1618,+
chr5,119118953,2.0798491551739784,639,478,1117,+
chr5,119493860,0.8318799091102277,776,530,1306,+
chr5,119496603,2.132663096065553,746,545,1291,+
chr5,119499325,1.0906569801528125,633,403,1036,+
chr5,119536480,1.4389490566827412,2226,1414,3640,+
chr5,119536481,1.743358395989975,1738,1084,2822,+
chr5,119536492,1.8888851147401193,1910,1089,2999,+
chr5,119536494,1.9623146819703492,1337,696,2033,+
chr5,119536507,1.535298273784002,2718,1852,4570,+
chr5,119536508,0.4789622109419064,1543,984,2527,+
chr5,119536514,2.239583333333333,945,527,1472,+
chr5,119541902,0.8717477441051269,665,550,1215,+
chr5,119541903,0.7213542750068044,771,653,1424,+
chr5,119541905,1.6156018499570253,1461,921,2382,+
chr5,119541908,2.1468903436988542,1589,1039,2628,+
chr5,119541911,1.6557185895860311,4329,2963,7292,+
chr5,119541912,1.6657503638261282,3407,2305,5712,+
chr5,119541923,1.4954006735844831,4352,3005,7357,+
chr5,119541944,3.465342876035629,2805,2187,4992,+
chr5,122799808,0.3991840860974032,877,562,1439,+
chr5,122808278,2.7277052998535014,966,809,1775,+
chr5,122808285,2.0890499778555003,865,752,1617,+
chr5,122808287,2.3936781609195403,594,579,1173,+
chr5,122808288,2.274216839401652,1147,1095,2242,+
chr5,122818864,2.8298429319371734,704,381,1085,+
chr5,122818866,1.8745113757885243,1265,813,2078,+
chr5,126810192,0.5674191580231849,1424,1044,2468,+
chr5,126810193,0.8236051661156356,1697,1239,2936,+
chr5,126810240,2.1103896103896105,1104,747,1851,+
chr5,126836582,5.838383838383839,577,439,1016,+
chr5,126836583,5.225713482217362,1262,929,2191,+
chr5,126836584,4.952014871148483,1700,1253,2953,+
chr5,126836690,3.936355115104778,1019,850,1869,+
chr5,126836915,25.165813946175774,737,613,1350,+
chr5,126836919,12.754752376463852,1186,1907,3093,+
chr5,126836920,12.754752376463852,1186,1907,3093,+
chr5,126836930,0.3148724046464831,404,753,1157,+
chr5,126836931,0.3148724046464831,404,753,1157,+
chr5,127530304,6.710588040616276,1794,1531,3325,+
chr5,127530305,6.710588040616276,1794,1531,3325,+
chr5,127552022,1.5040456788767218,874,581,1455,+
chr5,127552869,2.9555028024160634,615,466,1081,+
chr5,127554876,2.2295699487286806,760,502,1262,+
chr5,132575785,1.282511210762332,571,445,1016,+
chr5,132591957,2.8611296667408888,837,498,1335,+
chr5,132591958,2.8611296667408888,837,498,1335,+
chr5,132594869,0.6369901285155523,683,412,1095,+
chr5,132594870,1.8305805805805808,1044,665,1709,+
chr5,132594873,1.4994012370476766,1208,776,1984,+
chr5,132594877,2.064913347522044,866,597,1463,+
chr5,132603941,1.5018435239815011,597,414,1011,+
chr5,132608680,0.3327335640138408,600,424,1024,+
chr5,132608681,0.3327335640138408,600,424,1024,+
chr5,132616070,1.8008185538881312,989,732,1721,+
chr5,132616072,1.8008185538881312,989,732,1721,+
chr5,132616093,2.2114495798319327,568,475,1043,+
chr5,132616096,2.00871178057554,626,555,1181,+
chr5,132616103,2.0025252525252517,792,611,1403,+
chr5,132866638,1.3907639625147996,545,502,1047,+
chr5,132866879,0.9798690977092098,2721,1549,4270,+
chr5,132866880,0.7855090104067388,4163,2552,6715,+
chr5,132866890,1.929703040322509,1673,1265,2938,+
chr5,132866898,1.1259515308294545,3098,2246,5344,+
chr5,132867487,1.6809262916480856,1867,1426,3293,+
chr5,132867511,1.6861874513870885,2537,2127,4664,+
chr5,133052331,0.46657597043426224,637,397,1034,+
chr5,133052334,2.741219048898026,690,439,1129,+
chr5,133052335,0.9731333018097408,538,540,1078,+
chr5,133052337,0.9731333018097408,538,540,1078,+
chr5,133067434,1.9784776466677745,820,546,1366,+
chr5,133067478,3.2345454545454544,592,439,1031,+
chr5,133067528,2.9236912156166808,658,482,1140,+
chr5,133070399,1.8162811034263453,736,598,1334,+
chr5,133070466,1.6014414414414415,1110,674,1784,+
chr5,133076740,1.0369229790440708,2121,1374,3495,+
chr5,133076758,1.5968063872255491,639,500,1139,+
chr5,133076841,0.3541501976284585,959,758,1717,+
chr5,133088403,0.5292056074766355,603,427,1030,+
chr5,133088408,0.5887445887445888,679,461,1140,+
chr5,133088416,2.0203317281968967,943,622,1565,+
chr5,133088420,1.7829724370337052,1635,1190,2825,+
chr5,133088512,0.5769254410228041,987,560,1547,+
chr5,133091202,1.8596846830299278,1223,951,2174,+
chr5,133091255,1.9940431914184766,2247,1414,3661,+
chr5,133091269,0.6015684052841461,3060,2149,5209,+
chr5,133091302,1.6610900990788218,1626,1213,2839,+
chr5,133096169,2.9958246346555324,614,478,1092,+
chr5,133097223,0.3642311886586696,667,523,1190,+
chr5,133099582,1.8756181200780182,3339,2268,5607,+
chr5,133101798,1.966452533904354,550,466,1016,+
chr5,133103911,0.6325670498084291,761,579,1340,+
chr5,133104304,0.6208955223880597,831,535,1366,+
chr5,133104377,2.0099105503870955,1202,773,1975,+
chr5,133104584,12.67230197901734,654,515,1169,+
chr5,134675084,2.5184503483302336,754,447,1201,+
chr5,134741075,0.9576236544488349,752,536,1288,+
chr5,134741076,0.9576236544488349,752,536,1288,+
chr5,134741204,0.3172695393133696,704,473,1177,+
chr5,134741290,2.6217201166180764,1198,587,1785,+
chr5,134741292,2.6217201166180764,1198,587,1785,+
chr5,134741295,1.6287150542375872,1025,666,1691,+
chr5,134741313,2.4480260536021756,1871,1072,2943,+
chr5,134741323,2.4804584897506365,2902,1858,4760,+
chr5,134741492,2.8161057692307687,638,415,1053,+
chr5,134750811,2.1301369863013697,621,510,1131,+
chr5,134751001,0.47074133154227177,800,553,1353,+
chr5,134751054,1.6991418475517417,1121,848,1969,+
chr5,134763948,0.4658540957160782,1016,796,1812,+
chr5,134763950,1.4081060971803776,1966,1382,3348,+
chr5,134763952,2.1247311827956987,779,464,1243,+
chr5,134763954,1.9467977641592031,875,478,1353,+
chr5,134763955,1.9467977641592031,875,478,1353,+
chr5,134763975,2.161052338530067,574,448,1022,+
chr5,134770916,0.7439489643114108,715,503,1218,+
chr5,134770978,1.4506405066159984,1269,848,2117,+
chr5,134770979,0.973639787040644,651,452,1103,+
chr5,134770982,2.7224033535165346,667,451,1118,+
chr5,134770988,2.2854973699210532,803,576,1379,+
chr5,134781994,2.308191780981036,573,436,1009,+
chr5,134783012,2.037456496440045,606,500,1106,+
chr5,134785555,3.4105392156862746,604,407,1011,+
chr5,134785557,3.4105392156862746,604,407,1011,+
chr5,134817566,3.2844588851257965,658,454,1112,+
chr5,134817575,1.8016378525932664,791,627,1418,+
chr5,134817577,0.7406976744186046,818,644,1462,+
chr5,134893620,2.170492073976222,1142,756,1898,+
chr5,134893621,2.170492073976222,1142,756,1898,+
chr5,134896293,1.9471183800623053,1086,641,1727,+
chr5,134896295,2.7396025517630487,1666,1024,2690,+
chr5,134896331,2.590674318507891,925,696,1621,+
chr5,134896337,2.208679281003572,3219,2570,5789,+
chr5,134896338,2.031231114024043,2625,2138,4763,+
chr5,134899662,4.685417237912439,663,379,1042,+
chr5,136028989,1.2275552486187844,710,361,1071,+
chr5,136033782,2.4987767895119823,612,404,1016,+
chr5,136033796,0.8986686390532546,674,519,1193,+
chr5,136033798,0.8986686390532546,674,519,1193,+
chr5,136033805,1.727941176470588,704,543,1247,+
chr5,136033809,0.4551705170517052,661,403,1064,+
chr5,136033838,1.7350909621558517,614,540,1154,+
chr5,136046850,1.0684343926691362,684,445,1129,+
chr5,136046852,1.0684343926691362,684,445,1129,+
chr5,136046945,1.6819765600253405,589,450,1039,+
chr5,136046970,1.7179125528913963,869,708,1577,+
chr5,136046977,0.5934728472191882,848,486,1334,+
chr5,136046978,0.6242038216560509,1028,784,1812,+
chr5,136047304,2.422279792746114,1121,578,1699,+
chr5,136047324,1.2485763402234562,3498,2506,6004,+
chr5,136047334,1.4268309496672669,2796,1843,4639,+
chr5,136047340,1.3885180933853998,3772,2401,6173,+
chr5,136047342,1.9693601150772013,7091,5583,12674,+
chr5,136047344,1.6510470599691978,18694,14838,33532,+
chr5,136047345,1.518220652223705,16112,12592,28704,+
chr5,136047346,1.6671409808119,11658,9785,21443,+
chr5,136047349,1.4537263994464702,8868,7140,16008,+
chr5,136047352,2.1952662721893494,3444,2196,5640,+
chr5,136049480,2.4219168302694984,589,430,1019,+
chr5,136049487,1.6365384615384615,628,519,1147,+
chr5,136049544,2.030964281360478,832,630,1462,+
chr5,136049564,1.8804542737597127,725,477,1202,+
chr5,136052915,2.0048309178743957,829,665,1494,+
chr5,136052927,0.6704819277108434,741,519,1260,+
chr5,136054740,1.77251356238698,675,552,1227,+
chr5,136056723,0.4203681472589035,572,440,1012,+
chr5,136056743,0.9829885343968096,1261,943,2204,+
chr5,136056745,1.2736592842526557,2344,1754,4098,+
chr5,136056778,1.6992044063647491,616,515,1131,+
chr5,136060833,1.801854864510002,844,540,1384,+
chr5,136060854,0.5897639721169133,642,480,1122,+
chr5,136060914,1.896792189679219,543,477,1020,+
chr5,136061527,0.5949027498323273,886,709,1595,+
chr5,136062671,1.813002070393375,841,482,1323,+
chr5,136063194,0.4958189158016148,904,679,1583,+
chr5,136063196,2.5098039215686274,747,560,1307,+
chr5,136063199,3.2302483069977432,794,442,1236,+
chr5,136063200,2.2465625,1026,767,1793,+
chr5,136063388,1.875687568756876,619,403,1022,+
chr5,136063430,1.7053310800430173,739,565,1304,+
chr5,136063487,2.723642172523961,774,625,1399,+
chr5,136063575,1.472405380312086,2547,1996,4543,+
chr5,136063637,1.6874350986500517,874,748,1622,+
chr5,136180235,2.910611303344868,720,407,1127,+
chr5,136180236,2.910611303344868,720,407,1127,+
chr5,138179175,2.4185990080837905,666,348,1014,+
chr5,138183706,1.102994077389445,955,582,1537,+
chr5,138184038,3.9704836182021475,708,427,1135,+
chr5,138184039,4.782704057653142,847,490,1337,+
chr5,138184863,1.1609468937875749,805,498,1303,+
chr5,138184864,1.1609468937875749,805,498,1303,+
chr5,138184906,2.0590378093204373,682,418,1100,+
chr5,138184913,1.7541731366459632,722,447,1169,+
chr5,138184918,1.7131925313743497,771,483,1254,+
chr5,138185111,1.8074685646499549,1503,963,2466,+
chr5,138185128,0.5913689195006457,784,403,1187,+
chr5,138185131,2.0264855338145753,2183,1279,3462,+
chr5,138185132,2.500502271139064,1708,953,2661,+
chr5,138185148,1.6045465834132373,2979,1976,4955,+
chr5,138185151,0.7336889133814875,1961,1363,3324,+
chr5,138187408,3.3387278799958446,835,618,1453,+
chr5,138419026,2.2802565318652452,1473,831,2304,+
chr5,138419027,2.5065048098946403,896,589,1485,+
chr5,138419029,2.4414827948206,1013,633,1646,+
chr5,138753448,2.5374339403944206,725,455,1180,+
chr5,138753481,1.6258847320525784,803,436,1239,+
chr5,138783187,1.8610234840518753,860,633,1493,+
chr5,138783212,2.1011444229529337,840,563,1403,+
chr5,138783303,1.7769924098671726,796,619,1415,+
chr5,138810071,1.7268940380109348,736,500,1236,+
chr5,138810131,1.9725343320848938,631,444,1075,+
chr5,138810138,1.8371990475350561,671,492,1163,+
chr5,138810163,1.7824041811846691,786,614,1400,+
chr5,138812187,2.3587734893183256,1790,1268,3058,+
chr5,138824575,2.006159420289855,790,574,1364,+
chr5,138824584,1.5751544269045985,764,610,1374,+
chr5,138824638,2.4107142857142856,809,503,1312,+
chr5,138824652,1.7568403521294311,567,466,1033,+
chr5,138824671,2.1888099774813794,935,501,1436,+
chr5,138824703,1.861138715665749,1437,904,2341,+
chr5,138827514,0.5223701571308624,669,396,1065,+
chr5,138827523,0.39163179916318,545,477,1022,+
chr5,138886221,0.5746895820714718,892,507,1399,+
chr5,138887590,1.5225,985,799,1784,+
chr5,138904363,1.7923391953746084,719,592,1311,+
chr5,138904373,0.6435441562226756,827,656,1483,+
chr5,138904382,2.4033532041728765,826,670,1496,+
chr5,138904389,2.1114844593783757,1034,640,1674,+
chr5,138917826,1.5331239291833236,1091,823,1914,+
chr5,138924617,2.736016902023013,2070,1488,3558,+
chr5,138924626,2.201530612244898,862,559,1421,+
chr5,138924638,1.8327841845140032,889,606,1495,+
chr5,138924650,1.6438202247191012,664,533,1197,+
chr5,138925330,2.0600529100529097,598,419,1017,+
chr5,138925331,1.969010989010989,866,524,1390,+
chr5,138925337,2.5530827067669173,652,474,1126,+
chr5,138929270,1.897532687783796,990,676,1666,+
chr5,138929276,1.8170880149812731,1048,711,1759,+
chr5,138929283,0.5451066156369601,996,774,1770,+
chr5,138929296,1.7153817287245128,934,826,1760,+
chr5,138930508,1.9500158847823783,681,496,1177,+
chr5,138930509,1.5650023287525983,1576,1002,2578,+
chr5,138930540,1.745136186770428,689,513,1202,+
chr5,138930544,2.005858452234716,731,556,1287,+
chr5,138930571,1.549514563106796,930,720,1650,+
chr5,138932635,1.9928698752228164,687,373,1060,+
chr5,138932687,2.0247093023255816,596,515,1111,+
chr5,138933813,1.7716064453125,630,511,1141,+
chr5,138933820,1.5008620344011865,912,508,1420,+
chr5,138933884,2.443603133159269,763,765,1528,+
chr5,138933889,1.2645291492613855,2780,2436,5216,+
chr5,138933891,0.727812317837453,3863,2846,6709,+
chr5,138933892,0.7356285498131232,1067,1066,2133,+
chr5,138933897,1.40739350722462,1249,1021,2270,+
chr5,138933900,0.9897618257375789,4608,3842,8450,+
chr5,138933901,0.7341348944576188,3198,2936,6134,+
chr5,138933919,1.4194180481376153,1604,1108,2712,+
chr5,138933921,0.7381362575084989,2316,2038,4354,+
chr5,138933946,1.929700454109903,2292,1904,4196,+
chr5,138934026,1.5661473788328386,716,673,1389,+
chr5,138934128,1.6619433198380569,820,493,1313,+
chr5,138934141,2.7395256504022565,873,562,1435,+
chr5,138934197,1.7557456109425649,2989,2180,5169,+
chr5,138934480,2.1769323671497585,720,643,1363,+
chr5,138934549,1.5571544289321961,859,676,1535,+
chr5,138934556,2.3064935064935064,887,714,1601,+
chr5,138934832,3.1908843419379727,1165,914,2079,+
chr5,139307388,0.5459155215252777,768,480,1248,+
chr5,139307538,1.9851180074091221,1135,791,1926,+
chr5,139307588,1.57157960199005,682,535,1217,+
chr5,139307603,3.1717323327079425,817,532,1349,+
chr5,139307822,2.33795476892822,766,564,1330,+
chr5,139307925,3.485611510791367,968,555,1523,+
chr5,139307954,1.7108066971080669,1123,656,1779,+
chr5,139308214,2.0325974025974025,998,769,1767,+
chr5,139308215,1.5875069893761482,1045,641,1686,+
chr5,139308216,1.885623548332172,1840,1402,3242,+
chr5,139308236,2.014093137254902,864,679,1543,+
chr5,139314687,1.9543689320388347,670,514,1184,+
chr5,139317058,2.275549354726195,1397,845,2242,+
chr5,139317059,2.1659245765459443,1805,1199,3004,+
chr5,139317595,0.4574529947664276,589,468,1057,+
chr5,139318954,2.130693912303108,1364,782,2146,+
chr5,139318955,0.41755430370716595,942,766,1708,+
chr5,139319362,1.6881735718478228,3216,2434,5650,+
chr5,139321955,1.7251447584473016,1769,1352,3121,+
chr5,139322012,1.4571576227390182,1483,1074,2557,+
chr5,139322597,1.4026940801134349,1318,805,2123,+
chr5,139322828,1.8935652173913045,1360,999,2359,+
chr5,139322861,1.2908874473811331,2049,1347,3396,+
chr5,139322891,0.7690608527025921,2780,1926,4706,+
chr5,139325464,0.6265361767146564,1398,960,2358,+
chr5,139325513,1.5050973123262281,1739,1078,2817,+
chr5,139326167,1.9694805194805196,673,461,1134,+
chr5,139326190,2.039415130324221,801,571,1372,+
chr5,139329352,1.8011125443405354,676,442,1118,+
chr5,139329355,2.059041394335512,726,509,1235,+
chr5,139329612,1.943305359526988,1044,748,1792,+
chr5,139329743,1.4380050870923082,1513,1070,2583,+
chr5,139329813,1.6658579566767262,2332,1538,3870,+
chr5,139329819,1.4311347111596993,1585,1010,2595,+
chr5,139329894,1.5211538461538463,1468,909,2377,+
chr5,139329965,1.8283892792089516,610,426,1036,+
chr5,139341868,0.4740487286619802,750,516,1266,+
chr5,139341885,2.2776436130471986,708,425,1133,+
chr5,139341905,5.221882423108982,1161,782,1943,+
chr5,139363758,4.151373551166461,1717,1301,3018,+
chr5,139363759,3.7089758451164117,3182,2516,5698,+
chr5,139363761,2.9357520786092213,970,881,1851,+
chr5,139363768,0.5833814861897607,630,508,1138,+
chr5,139363774,0.4745636441038741,685,521,1206,+
chr5,139363784,0.5938438438438438,790,629,1419,+
chr5,139363788,0.6144035725098393,954,733,1687,+
chr5,139364646,1.833277647844972,1301,1021,2322,+
chr5,139368746,2.9342121626663347,1003,730,1733,+
chr5,139369500,0.6269675090252707,826,553,1379,+
chr5,139369529,1.702310361560329,1606,1165,2771,+
chr5,139614750,1.9870342396777443,901,661,1562,+
chr5,139614761,1.8618556701030928,558,484,1042,+
chr5,139614899,1.1271147584678736,1680,1197,2877,+
chr5,139614919,1.778353132297695,564,468,1032,+
chr5,139614922,1.7934782608695652,604,505,1109,+
chr5,139623378,1.8247781523318647,2021,1618,3639,+
chr5,139623385,2.7070677137353685,811,793,1604,+
chr5,139623394,2.3146055549688453,706,556,1262,+
chr5,139623395,1.677976485554724,1523,1486,3009,+
chr5,139623409,2.2872266449261462,1550,1603,3153,+
chr5,139623410,2.128905069622963,2597,2707,5304,+
chr5,139626761,0.9281694803045348,1401,1006,2407,+
chr5,139626762,0.9281694803045348,1401,1006,2407,+
chr5,139627125,26.193970173263402,2158,1255,3413,+
chr5,139627126,26.193970173263402,2158,1255,3413,+
chr5,139627146,8.45904780975301,2822,3737,6559,+
chr5,139627147,6.358554570711533,3385,4662,8047,+
chr5,139627148,4.62407668090829,2169,3162,5331,+
chr5,139627149,4.027159176571512,1643,2667,4310,+
chr5,139627361,2.451516479227028,829,542,1371,+
chr5,140175210,0.6639700537283966,1040,533,1573,+
chr5,140243445,3.205069196205456,926,687,1613,+
chr5,140243499,1.60403973571595,1031,785,1816,+
chr5,140243549,0.3753623188405797,776,597,1373,+
chr5,140243592,1.8597416020671835,946,644,1590,+
chr5,140243619,1.9217413837781805,617,453,1070,+
chr5,140243625,0.5268762677484787,1038,713,1751,+
chr5,140440151,2.7331975560081467,853,490,1343,+
chr5,140440153,2.7331975560081467,853,490,1343,+
chr5,140440193,1.932125307125307,698,406,1104,+
chr5,140440196,2.1291690039526254,1491,1041,2532,+
chr5,140440213,1.6206867316659603,1061,673,1734,+
chr5,140440214,2.8251470079557244,725,412,1137,+
chr5,140440249,0.6710750047232193,1183,710,1893,+
chr5,140440251,0.5131104406906467,2667,1841,4508,+
chr5,140440252,1.4754556803995007,1342,800,2142,+
chr5,140445786,2.04780206581792,681,723,1404,+
chr5,140445788,2.04780206581792,681,723,1404,+
chr5,140445933,0.959420977693403,932,587,1519,+
chr5,140445935,0.959420977693403,932,587,1519,+
chr5,140445942,0.5490375546474059,1199,713,1912,+
chr5,140445951,1.9730939895119,1192,669,1861,+
chr5,140445953,1.7010738329468509,2702,1628,4330,+
chr5,140445954,0.41924000331153244,843,513,1356,+
chr5,140445955,1.4960396039603965,1510,959,2469,+
chr5,140445958,1.2313151937542104,2470,1600,4070,+
chr5,140445959,1.77725096877137,885,534,1419,+
chr5,140449209,1.4022092267706299,1247,1025,2272,+
chr5,140449210,1.4022092267706299,1247,1025,2272,+
chr5,140449212,1.4035053585615382,1291,800,2091,+
chr5,140449213,2.3565031982942437,1227,1004,2231,+
chr5,140496692,1.978903373469997,977,772,1749,+
chr5,140496693,1.3705326282672508,1636,1258,2894,+
chr5,140496814,4.028984249576952,1271,1212,2483,+
chr5,140496815,4.028984249576952,1271,1212,2483,+
chr5,140505759,3.073732718894009,1103,495,1598,+
chr5,140505760,3.073732718894009,1103,495,1598,+
chr5,140564828,0.8578637882662506,724,541,1265,+
chr5,140566642,0.5795100142367468,809,559,1368,+
chr5,140567437,2.0939570633448183,1373,685,2058,+
chr5,140567438,2.1794527709512757,2266,1334,3600,+
chr5,140567439,2.07791185729276,1868,952,2820,+
chr5,140567440,1.865981543624161,1434,744,2178,+
chr5,140567452,0.5521844660194175,734,411,1145,+
chr5,140567455,1.4060495745680932,1284,822,2106,+
chr5,140567462,0.42408799485899606,1050,868,1918,+
chr5,140567463,0.6854344656231409,1702,1059,2761,+
chr5,140567464,1.4704447912602416,1004,698,1702,+
chr5,140567466,1.344308112688268,2902,1672,4574,+
chr5,140567467,1.4219300909076098,4037,2473,6510,+
chr5,140567469,0.5838430406936386,1650,1261,2911,+
chr5,140567476,1.5718732965901518,1425,1044,2469,+
chr5,140567482,0.7929354905082223,4442,2913,7355,+
chr5,140567486,1.5788899684717732,1749,1362,3111,+
chr5,140567491,1.7635748893304055,3911,3284,7195,+
chr5,140567493,1.7635748893304055,3911,3284,7195,+
chr5,140567494,1.317121517822378,3049,2189,5238,+
chr5,140567497,1.3826082105156086,5649,4033,9682,+
chr5,140568433,2.442664632595983,738,512,1250,+
chr5,140568434,2.442664632595983,738,512,1250,+
chr5,140568666,0.42100532445340233,886,668,1554,+
chr5,140647838,0.4569063938825971,620,467,1087,+
chr5,140653010,3.0144927536231885,935,647,1582,+
chr5,140653012,2.5247954293416233,1548,1096,2644,+
chr5,140653031,1.822805285411176,1429,1106,2535,+
chr5,140657588,2.3791484716157205,702,457,1159,+
chr5,140657589,1.7685387163926227,983,683,1666,+
chr5,140657637,0.4873068432671082,882,603,1485,+
chr5,140657638,0.4873068432671082,882,603,1485,+
chr5,140658751,1.908440007880933,948,597,1545,+
chr5,140658962,2.626044568245125,1256,717,1973,+
chr5,140658978,1.7808675167716497,1390,848,2238,+
chr5,140659003,1.5507380126703054,4429,2698,7127,+
chr5,140659005,1.580047770961569,3901,2269,6170,+
chr5,140659021,3.4330953965277367,3289,2167,5456,+
chr5,140659023,2.395363999543862,6510,4196,10706,+
chr5,140659025,2.3668068659770376,3379,2314,5693,+
chr5,140660116,1.2609543010752688,646,479,1125,+
chr5,140660117,1.4503617756339222,889,666,1555,+
chr5,140660118,1.4503617756339222,889,666,1555,+
chr5,140660119,1.6632114891683103,856,640,1496,+
chr5,140703918,2.5592512184456297,933,600,1533,+
chr5,140703958,2.014092140921409,928,629,1557,+
chr5,140703968,2.0886778670562456,985,739,1724,+
chr5,140704426,2.1966215849220574,1661,968,2629,+
chr5,140704428,2.1966215849220574,1661,968,2629,+
chr5,140704430,1.5272947994987465,906,607,1513,+
chr5,140704431,1.6336,1020,624,1644,+
chr5,140704442,1.8034335752966928,1091,788,1879,+
chr5,140704463,1.9751198706512043,1402,1120,2522,+
chr5,140705876,10.363393814299416,1527,191,1718,+
chr5,140705877,8.257525320527884,2554,327,2881,+
chr5,140705878,9.358687546607008,1254,148,1402,+
chr5,140705879,6.395922243233635,3940,536,4476,+
chr5,140705880,6.4167039705291256,2164,307,2471,+
chr5,140705881,6.158308072552924,2432,328,2760,+
chr5,140705885,11.372127215406882,936,122,1058,+
chr5,140705889,50.838948342379595,1684,959,2643,+
chr5,140705890,24.9854649279447,3847,3147,6994,+
chr5,140705891,24.9854649279447,3847,3147,6994,+
chr5,140705892,22.653963957268626,3361,3089,6450,+
chr5,142131863,2.452380952380953,720,538,1258,+
chr5,142131865,2.452380952380953,720,538,1258,+
chr5,142135751,2.4237000968123863,1101,759,1860,+
chr5,142137798,2.5173282168125675,1311,806,2117,+
chr5,142137837,1.7252921075575602,3265,1951,5216,+
chr5,142137841,1.6000296000295997,1137,692,1829,+
chr5,142140571,1.4841935483870967,1390,805,2195,+
chr5,142140614,1.4598845663252296,7964,5216,13180,+
chr5,142144572,1.28258456928078,7565,4921,12486,+
chr5,142144573,1.28258456928078,7565,4921,12486,+
chr5,142151807,1.5755322556512026,1259,1042,2301,+
chr5,142151955,1.6158199356913183,738,621,1359,+
chr5,142152256,1.328485410644009,2563,1906,4469,+
chr5,142152276,2.224861765308212,775,513,1288,+
chr5,142152335,3.8058305830583055,628,403,1031,+
chr5,145229403,1.2435252961358076,693,422,1115,+
chr5,146229858,2.581968675082077,732,335,1067,+
chr5,146229866,3.0719836932951687,743,355,1098,+
chr5,146469570,2.082269050659855,1117,647,1764,+
chr5,146469571,2.082269050659855,1117,647,1764,+
chr5,146469580,1.8676518883415438,846,608,1454,+
chr5,146469583,0.6640690464219875,950,662,1612,+
chr5,146469596,1.5011033017325923,2369,1310,3679,+
chr5,146469598,1.5011033017325923,2369,1310,3679,+
chr5,146469599,1.4410507548053146,2584,1725,4309,+
chr5,146469602,2.0171035508458823,2974,1792,4766,+
chr5,146469604,1.886783092547049,4282,2597,6879,+
chr5,146469614,1.6076421248835042,1655,1043,2698,+
chr5,146469617,1.5338427453994663,2055,1300,3355,+
chr5,146469622,2.085903567419843,1920,1321,3241,+
chr5,146469695,1.8099189528819397,1959,1293,3252,+
chr5,146469703,2.0003276236646084,3306,2404,5710,+
chr5,146469707,1.482015109905681,3104,2431,5535,+
chr5,146470656,2.109533468559837,831,492,1323,+
chr5,146470657,2.109533468559837,831,492,1323,+
chr5,146503377,2.2898263265061685,674,481,1155,+
chr5,146503451,2.101622662266226,898,605,1503,+
chr5,146503453,2.101622662266226,898,605,1503,+
chr5,146503516,2.8138040042149632,1241,729,1970,+
chr5,146503834,1.7409024745269286,1091,686,1777,+
chr5,146503840,1.5677701237402728,1198,602,1800,+
chr5,146503848,1.9805003296207626,1426,738,2164,+
chr5,146503868,1.2635288946855399,4598,3016,7614,+
chr5,146503891,2.4940929074449585,2509,2136,4645,+
chr5,146503899,0.22562521122000678,1525,1075,2600,+
chr5,146509217,2.385117210788468,1799,1287,3086,+
chr5,146510670,2.4254841119915755,634,403,1037,+
chr5,148417132,2.0494505494505493,745,363,1108,+
chr5,148417133,1.621970547140521,998,527,1525,+
chr5,148417148,2.3689661911276145,1101,601,1702,+
chr5,148417150,2.3689661911276145,1101,601,1702,+
chr5,148417156,1.5170542635658917,720,429,1149,+
chr5,148417157,1.9795396419437339,687,390,1077,+
chr5,148417164,1.69954128440367,740,435,1175,+
chr5,148417172,1.8630317542460864,2150,1343,3493,+
chr5,148417178,2.3105924596050267,818,556,1374,+
chr5,149354158,1.8935714285714287,722,399,1121,+
chr5,150094283,0.5688475691303145,709,608,1317,+
chr5,150094284,1.0692537599693128,668,702,1370,+
chr5,150094285,0.8511436058908666,1242,1162,2404,+
chr5,150094290,0.5656265967792448,745,748,1493,+
chr5,150094291,0.5804677150469745,2439,2302,4741,+
chr5,150094293,0.6399235969919663,3665,3243,6908,+
chr5,150094295,0.5527464761542461,6730,5119,11849,+
chr5,150094296,0.5608197624740011,6747,4917,11664,+
chr5,150094297,0.595749372123123,2714,2181,4895,+
chr5,150094298,0.4347875270509541,3356,2391,5747,+
chr5,150094299,0.8415766047097111,3367,2198,5565,+
chr5,150094307,1.0497014945282466,4840,3172,8012,+
chr5,150094308,0.6828290327847185,5822,3515,9337,+
chr5,150094309,1.549030706098769,800,572,1372,+
chr5,150094310,0.6827438494597983,7479,4219,11698,+
chr5,150094311,1.3779315419065898,4996,4167,9163,+
chr5,150094312,1.1289193068830345,8366,5943,14309,+
chr5,150094313,1.157699137947958,7983,5822,13805,+
chr5,150094588,1.1736869127616576,994,460,1454,+
chr5,150094589,0.8400828861378249,1295,648,1943,+
chr5,150094591,1.0812407222480795,1873,1028,2901,+
chr5,150094593,1.0669035485529947,1140,585,1725,+
chr5,150094611,1.5322484042644215,2441,1358,3799,+
chr5,150094612,1.5332426175429321,3268,1956,5224,+
chr5,150094616,2.335351976856316,1407,849,2256,+
chr5,150094617,0.6573886639676113,865,493,1358,+
chr5,150094629,2.1997368421052634,1285,599,1884,+
chr5,150094636,1.8061331795515452,1438,718,2156,+
chr5,150094650,1.3977118956821255,1975,1477,3452,+
chr5,150094653,1.3824823243694944,8245,5709,13954,+
chr5,150094661,1.9570514773073409,2569,1567,4136,+
chr5,150094674,1.3785396825396825,3311,2249,5560,+
chr5,150361171,2.187767384262578,1072,711,1783,+
chr5,150361173,1.7919670514983579,835,557,1392,+
chr5,150364142,0.6079665492957746,726,567,1293,+
chr5,150364147,1.5713462722739822,1129,708,1837,+
chr5,150364148,1.5713462722739822,1129,708,1837,+
chr5,150364157,1.6488170810138163,1101,842,1943,+
chr5,150364163,2.6780180486974285,982,838,1820,+
chr5,150364167,1.4966755377962873,4325,3590,7915,+
chr5,150364168,1.5408220885176316,2167,2013,4180,+
chr5,150376247,2.0462962962962963,1364,1439,2803,+
chr5,150376248,2.0462962962962963,1364,1439,2803,+
chr5,150376249,2.0462962962962963,1364,1439,2803,+
chr5,151772004,1.4919445100190245,847,567,1414,+
chr5,151772006,1.2151368760064414,685,413,1098,+
chr5,151790911,2.0763664449861077,884,601,1485,+
chr5,151790936,1.337332091794998,913,651,1564,+
chr5,151790970,0.2729651494735382,731,578,1309,+
chr5,151790982,4.091564964323452,950,663,1613,+
chr5,151791011,0.5311085972850679,625,415,1040,+
chr5,151800800,4.677432475927592,1208,780,1988,+
chr5,151804012,5.143779857803155,865,593,1458,+
chr5,151804941,1.9115442278860568,662,376,1038,+
chr5,151804980,0.6015789031662047,753,566,1319,+
chr5,151810294,1.2090457928723761,775,501,1276,+
chr5,154446749,1.9982715177156676,652,456,1108,+
chr5,154455935,1.075912921490903,1008,928,1936,+
chr5,154455936,0.6147119341563786,716,728,1444,+
chr5,154455963,2.3748622673136355,1019,913,1932,+
chr5,154795299,0.2624236301534613,1090,506,1596,+
chr5,154795300,0.2624236301534613,1090,506,1596,+
chr5,154795301,0.2624236301534613,1090,506,1596,+
chr5,154795304,2.2819200718903665,1171,678,1849,+
chr5,154795305,1.8056621140150495,2006,1135,3141,+
chr5,154795306,2.3673384309244168,1703,907,2610,+
chr5,154814157,6.949017998948672,611,571,1182,+
chr5,154814159,6.977645131974905,722,672,1394,+
chr5,154814180,4.339787190234014,488,710,1198,+
chr5,154814758,0.838578701092093,890,618,1508,+
chr5,154814760,1.634778240025427,768,476,1244,+
chr5,154815676,10.94774514802025,910,544,1454,+
chr5,154815677,10.94774514802025,910,544,1454,+
chr5,154815678,10.94774514802025,910,544,1454,+
chr5,154816732,2.315448912306282,864,617,1481,+
chr5,154817141,4.14197638728344,936,658,1594,+
chr5,154865249,3.346970983143552,871,691,1562,+
chr5,154871831,1.4533773295618722,939,730,1669,+
chr5,154871840,0.5688320825515948,692,415,1107,+
chr5,154871841,0.5302112986648491,695,508,1203,+
chr5,154872545,1.673175745118191,887,555,1442,+
chr5,154876132,0.5114300903774588,591,455,1046,+
chr5,154956413,2.2450980392156863,686,407,1093,+
chr5,154966716,2.213067837206471,1159,735,1894,+
chr5,154966718,2.172937293729373,822,504,1326,+
chr5,159272069,0.5981500513874615,581,555,1136,+
chr5,159272072,1.8215459734895159,1726,1411,3137,+
chr5,159272074,1.536790049727369,2033,1487,3520,+
chr5,159272075,1.0458498023715417,1133,824,1957,+
chr5,159272081,1.6849168008588302,875,827,1702,+
chr5,160010788,2.7400346620450606,743,576,1319,+
chr5,160010792,1.8424456945410108,1285,1216,2501,+
chr5,160036707,2.8896814310004806,602,437,1039,+
chr5,160049522,2.736790480793365,964,647,1611,+
chr5,160258498,1.4195125994694957,684,463,1147,+
chr5,160258501,0.4862233954792938,841,550,1391,+
chr5,160421861,2.8466676783405713,736,478,1214,+
chr5,160421868,1.614390664428567,1133,711,1844,+
chr5,160421869,2.083906938325991,864,453,1317,+
chr5,160421877,0.6323259207487321,2553,1787,4340,+
chr5,160421878,0.739351620179342,2062,1694,3756,+
chr5,160421879,0.7030891449292545,4042,2832,6874,+
chr5,160422303,1.5319116892425433,1834,1098,2932,+
chr5,160422309,1.9058105566039287,1733,1072,2805,+
chr5,160422310,2.286334913112164,826,632,1458,+
chr5,160422322,2.0818801089918253,1294,733,2027,+
chr5,160422341,1.5680345184137972,3946,2870,6816,+
chr5,160422347,1.5009322469353303,1675,1194,2869,+
chr5,160422708,0.5101067887109078,1069,759,1828,+
chr5,160422720,1.768677528254807,1204,756,1960,+
chr5,160422734,0.669914834620717,1207,764,1971,+
chr5,160422736,1.5402492809204218,933,744,1677,+
chr5,160422742,1.5625256814135051,1425,893,2318,+
chr5,160422787,1.471543425367608,1293,821,2114,+
chr5,160422829,1.4718061860919005,1118,961,2079,+
chr5,160424242,1.996434937611408,1119,662,1781,+
chr5,160424250,1.9638345558272208,2604,1635,4239,+
chr5,160424251,1.8209179115727585,3577,2329,5906,+
chr5,160424258,1.4453789663294998,3160,2061,5221,+
chr5,160424259,1.4453789663294998,3160,2061,5221,+
chr5,160427714,1.7033326692660158,1196,856,2052,+
chr5,160427782,1.6366782006920415,945,645,1590,+
chr5,160427783,1.441742567451452,986,758,1744,+
chr5,160427809,1.9923611111111108,905,719,1624,+
chr5,163441310,1.8880167451596024,655,363,1018,+
chr5,163443959,0.6059187600769751,931,662,1593,+
chr5,163444397,2.546813824565581,921,726,1647,+
chr5,163444769,2.1259505885108156,933,691,1624,+
chr5,163444798,1.9035714285714285,1039,699,1738,+
chr5,163471421,4.960112359550561,653,355,1008,+
chr5,163471423,4.960112359550561,653,355,1008,+
chr5,163491147,2.0025335943597007,847,668,1515,+
chr5,163505699,5.478525720421505,734,2287,3021,+
chr5,163505700,5.3627865021392935,635,2082,2717,+
chr5,163505701,2.3009487666034154,300,1084,1384,+
chr5,163505709,0.17696773719409126,343,1236,1579,+
chr5,163505710,0.26306434411660146,369,1260,1629,+
chr5,163505711,0.26306434411660146,369,1260,1629,+
chr5,163505712,0.31630482333654153,536,1531,2067,+
chr5,163505714,0.3138550789449535,478,1316,1794,+
chr5,163512120,0.5887300252312868,524,491,1015,+
chr5,163512153,0.5359774066797642,581,508,1089,+
chr5,163513649,0.5670352976821693,787,643,1430,+
chr5,163513844,1.8508217446270545,1707,1242,2949,+
chr5,163513845,0.48945319572696,982,788,1770,+
chr5,163513846,1.8508217446270545,1707,1242,2949,+
chr5,163513854,2.570731707317073,1053,819,1872,+
chr5,163513859,2.0792712571024463,2474,1815,4289,+
chr5,163513865,1.5716896006523349,2596,2104,4700,+
chr5,163518640,2.2859375,615,511,1126,+
chr5,163518784,3.0881037959147895,926,670,1596,+
chr5,163519020,2.9454853591940493,868,558,1426,+
chr5,163519021,2.9454853591940493,868,558,1426,+
chr5,166382423,1.224915822622964,770,597,1367,+
chr5,166382427,0.8463358904479775,3702,2573,6275,+
chr5,166382429,1.0466712266847154,2098,1813,3911,+
chr5,166382435,0.8842761163086014,11954,4925,16879,+
chr5,166382436,0.827929629522477,30191,12380,42571,+
chr5,166382437,1.0322262540350229,11871,10595,22466,+
chr5,166382438,0.8400632325254174,40381,23168,63549,+
chr5,166382575,2.1254180602006687,778,597,1375,+
chr5,168371427,2.526832312029141,817,1012,1829,+
chr5,168371428,2.2857142857142856,699,881,1580,+
chr5,168371429,2.2857142857142856,699,881,1580,+
chr5,168454039,8.39740906798188,611,891,1502,+
chr5,168454058,0.4163421353799834,481,689,1170,+
chr5,168469015,0.4444165876437458,693,499,1192,+
chr5,168469218,1.7183585313174945,611,462,1073,+
chr5,168488612,1.9179965212199097,683,421,1104,+
chr5,168488641,1.565907558230015,773,520,1293,+
chr5,168488710,2.3366733466933867,582,498,1080,+
chr5,168493912,2.2774327122153206,699,440,1139,+
chr5,168495393,2.0801117838844903,637,451,1088,+
chr5,168497256,1.3308708890695322,920,753,1673,+
chr5,168497296,1.7857080610021787,660,424,1084,+
chr5,168497299,1.9173200285103351,806,548,1354,+
chr5,168500702,1.6943467041989209,698,440,1138,+
chr5,168506770,2.222473404255319,618,469,1087,+
chr5,168506779,0.5651014902363823,764,555,1319,+
chr5,168506783,0.5855018587360594,664,537,1201,+
chr5,168510672,2.19361879191488,1236,923,2159,+
chr5,168516791,3.1243333333333334,720,499,1219,+
chr5,168516834,1.695016053219974,1157,849,2006,+
chr5,168516853,1.9012715930902109,586,520,1106,+
chr5,168516888,0.5485269823788546,612,453,1065,+
chr5,168516901,3.0452127659574466,686,563,1249,+
chr5,168517844,2.7512477313974597,734,463,1197,+
chr5,168517906,1.9039821953739768,825,546,1371,+
chr5,168518016,0.3840583777715408,621,508,1129,+
chr5,168616309,0.9759889235702051,860,600,1460,+
chr5,168616631,1.2740134357298916,1085,876,1961,+
chr5,168616633,1.2085390647690968,802,625,1427,+
chr5,168616637,1.6398166339227245,625,508,1133,+
chr5,168616638,0.5001021033285685,1421,1061,2482,+
chr5,168616639,0.5001021033285685,1421,1061,2482,+
chr5,168616648,1.4902467433360556,1408,1321,2729,+
chr5,168616649,1.1772634193747786,3908,3118,7026,+
chr5,168616651,0.8562569075765086,7036,4998,12034,+
chr5,168616652,0.7697718096725746,2919,2072,4991,+
chr5,168616653,0.9275890212199988,4720,3331,8051,+
chr5,168616654,1.0367078774473015,3326,2348,5674,+
chr5,168616819,1.1812169312169314,664,503,1167,+
chr5,168616820,0.8153629032258065,830,599,1429,+
chr5,168616822,1.1573713490959665,978,718,1696,+
chr5,168616823,1.2066272468342767,1949,1349,3298,+
chr5,168616824,1.2941166337738892,1231,830,2061,+
chr5,168616838,0.5377223860717344,627,456,1083,+
chr5,168616854,0.6242298682482296,921,716,1637,+
chr5,168616855,1.636436705657578,3548,2393,5941,+
chr5,168616856,1.5717525105280208,3638,2834,6472,+
chr5,168616858,1.4932878889260623,2483,1951,4434,+
chr5,168616884,1.564978299334232,7063,4410,11473,+
chr5,168616886,1.2649832969110395,2336,1780,4116,+
chr5,168616889,0.7637361071530351,3457,1814,5271,+
chr5,168616890,1.4023344390793293,6183,4305,10488,+
chr5,168616908,1.5975306593640766,17926,12083,30009,+
chr5,168616909,1.6327786135240416,8832,5680,14512,+
chr5,169593355,3.1092634028511785,973,724,1697,+
chr5,169594425,1.6961890712214418,1607,1218,2825,+
chr5,169594426,1.5045871559633026,901,653,1554,+
chr5,169594427,1.5045871559633026,901,653,1554,+
chr5,169594430,0.5712958215842091,848,663,1511,+
chr5,169594454,1.4863877662479519,2378,1830,4208,+
chr5,169594455,1.3630723566322067,4914,3573,8487,+
chr5,169594456,0.9888299216578216,2043,1318,3361,+
chr5,169594460,2.5170603674540684,547,507,1054,+
chr5,171387848,0.9451451517398954,6015,4225,10240,+
chr5,171387849,0.9809823334908143,7581,5535,13116,+
chr5,171387850,1.0426229940021503,6579,5307,11886,+
chr5,171387851,1.4209304766891535,6253,5172,11425,+
chr5,171387852,1.383562127129617,3240,2648,5888,+
chr5,171387853,1.4118043948254066,4267,3123,7390,+
chr5,171387857,1.3306821855803426,3165,2061,5226,+
chr5,171387859,1.292351754528221,5609,3505,9114,+
chr5,171387860,0.7495010948886474,3536,3162,6698,+
chr5,171387878,1.6606040564373898,3274,3023,6297,+
chr5,171387879,1.249142158735009,3682,2649,6331,+
chr5,171387885,0.8244394180559046,4025,3632,7657,+
chr5,171387896,1.1595524534390236,5509,4072,9581,+
chr5,171390051,1.4002114201626479,15937,10004,25941,+
chr5,171390052,1.3725432882585995,12947,8538,21485,+
chr5,171390053,1.5821534178599979,16246,9482,25728,+
chr5,171390054,1.4903033804151236,20931,13275,34206,+
chr5,171390056,1.4495891644523302,23967,15289,39256,+
chr5,171390057,1.4174103101746063,21625,14223,35848,+
chr5,171390058,1.2313777512947124,29244,19206,48450,+
chr5,171390059,1.2983777718983645,11166,8003,19169,+
chr5,171390060,1.0826562821659542,21962,14479,36441,+
chr5,171390061,0.8095950241048498,14654,9382,24036,+
chr5,171391307,1.275203223789342,5319,3889,9208,+
chr5,171392734,1.9711215557404316,1189,647,1836,+
chr5,171392751,1.6854604042573968,1487,1044,2531,+
chr5,171392752,1.6854604042573968,1487,1044,2531,+
chr5,171392753,1.9594247560349254,762,353,1115,+
chr5,171392757,1.0937086718307198,1653,947,2600,+
chr5,171392759,1.3298953795086097,2527,1466,3993,+
chr5,171392760,1.7829814303703313,2834,1794,4628,+
chr5,171392761,1.6106463878326998,1058,525,1583,+
chr5,171400153,1.3633578431372548,624,509,1133,+
chr5,171400155,1.3633578431372548,624,509,1133,+
chr5,171400158,1.3064647377938516,584,631,1215,+
chr5,171400161,1.4537955177676523,1207,1279,2486,+
chr5,171400167,0.6790775350615731,1379,1019,2398,+
chr5,171400170,1.3441519032439513,2002,2204,4206,+
chr5,171400838,0.7952817172699668,1521,1698,3219,+
chr5,171400839,0.9858928675740406,1569,1006,2575,+
chr5,171400840,0.9858928675740406,1569,1006,2575,+
chr5,171400841,0.6470946013417213,1228,1508,2736,+
chr5,171400842,1.4917620137299772,635,459,1094,+
chr5,171400845,0.5708507994017652,2167,1636,3803,+
chr5,171400846,0.5708507994017652,2167,1636,3803,+
chr5,171400860,0.6379598745200137,5670,4337,10007,+
chr5,171405302,1.4172678031368908,27460,17106,44566,+
chr5,171405303,1.496326126790773,30364,18525,48889,+
chr5,171405304,1.5595378109654867,18058,10161,28219,+
chr5,171405305,1.5750189702852557,31403,18972,50375,+
chr5,171405306,1.4828514709049914,29845,18728,48573,+
chr5,171405307,1.4509240790507263,27737,17943,45680,+
chr5,171405316,1.3959243928976315,19512,13837,33349,+
chr5,171405317,1.5850697298857503,8127,5885,14012,+
chr5,171406400,2.048528086714453,3521,2805,6326,+
chr5,171406402,2.048528086714453,3521,2805,6326,+
chr5,171406519,1.7250417966635214,4053,2709,6762,+
chr5,171407706,2.556689342403628,983,440,1423,+
chr5,171407707,2.2703898840885146,1538,714,2252,+
chr5,171407709,2.099342311305982,1063,514,1577,+
chr5,171407711,1.54162743841941,2448,1441,3889,+
chr5,171407712,1.5211527919179264,1981,1129,3110,+
chr5,171407714,0.9123057338891674,4582,2935,7517,+
chr5,171407715,0.9742316048316666,4046,2596,6642,+
chr5,171407716,1.0482763844311265,2559,1852,4411,+
chr5,171407721,1.7753765540376019,1562,1007,2569,+
chr5,171407723,2.036289576004444,845,490,1335,+
chr5,171407724,1.7277082367485703,1039,718,1757,+
chr5,171407730,1.1119469259616832,3101,2173,5274,+
chr5,171407732,1.305081757341024,3474,2373,5847,+
chr5,171407733,1.4647220871819802,765,560,1325,+
chr5,171407735,0.7228074015882721,2955,2021,4976,+
chr5,171407739,1.4135547710208345,1655,1182,2837,+
chr5,171407740,1.6332535066712282,1084,789,1873,+
chr5,171407745,1.0544526022309517,3500,2529,6029,+
chr5,171407746,0.6176844783715012,1941,1178,3119,+
chr5,171407757,2.517823094294717,2640,2025,4665,+
chr5,171410525,1.7370380145432698,2415,1426,3841,+
chr5,171410526,1.3761793614641469,5092,3053,8145,+
chr5,171410528,1.4008185538881308,4895,2931,7826,+
chr5,171410530,1.3744804106364457,6287,4751,11038,+
chr5,171410531,1.2974189406041208,6951,4386,11337,+
chr5,171410533,1.2503477341830902,15614,10346,25960,+
chr5,171410534,1.3127078783478725,15484,10922,26406,+
chr5,171410550,1.2127432119127737,11601,8437,20038,+
chr5,171410706,0.6596305257114738,1738,1095,2833,+
chr5,171410707,1.335155612013429,2486,1235,3721,+
chr5,171410722,1.2929741264337158,3245,1724,4969,+
chr5,172834379,1.9147310513447435,894,408,1302,+
chr5,172834419,0.504,832,594,1426,+
chr5,172834420,0.950034552211059,1107,850,1957,+
chr5,172888706,2.8902941176470587,633,399,1032,+
chr5,172897055,0.5719558359124097,3454,2506,5960,+
chr5,172897056,0.5990056598208907,5974,4274,10248,+
chr5,172897057,0.6053350249251718,4744,3402,8146,+
chr5,172897058,0.5938840201379825,3674,2594,6268,+
chr5,172909668,1.749,1451,879,2330,+
chr5,172909712,0.9942760681438937,2696,1764,4460,+
chr5,172909713,1.2946866903407264,4069,2713,6782,+
chr5,172909723,0.7083043668760042,1782,1024,2806,+
chr5,172909732,0.6665914348586582,1431,957,2388,+
chr5,172909735,1.854796781514339,3413,2219,5632,+
chr5,172909736,1.854796781514339,3413,2219,5632,+
chr5,172909750,2.5742762221167537,1807,1246,3053,+
chr5,172914769,1.634041580787163,1436,1209,2645,+
chr5,172914788,1.8812435538529542,797,616,1413,+
chr5,172914791,0.5236586084905661,1014,767,1781,+
chr5,172924029,0.4705248478701826,570,492,1062,+
chr5,172924040,3.7044685990338166,828,551,1379,+
chr5,172924052,0.5907978463044542,567,453,1020,+
chr5,172924060,0.6429804372842348,893,631,1524,+
chr5,172926521,1.9687732342007438,661,537,1198,+
chr5,172935233,1.123308731493698,1322,1107,2429,+
chr5,172935295,1.4894179894179893,1125,755,1880,+
chr5,172950768,2.478448275862069,597,463,1060,+
chr5,172950786,0.5381475667189953,856,489,1345,+
chr5,172950805,1.760395791583166,936,498,1434,+
chr5,172950904,0.5250311332503113,1053,656,1709,+
chr5,172950944,13.549727181419088,4988,3561,8549,+
chr5,172950945,10.464400646915218,3709,2575,6284,+
chr5,172950965,2.1592248062015504,732,644,1376,+
chr5,172951092,2.0739779840554804,3556,2438,5994,+
chr5,172951095,7.059046108842703,7404,6552,13956,+
chr5,172951096,7.376976545569714,9614,8007,17621,+
chr5,172951097,7.376976545569714,9614,8007,17621,+
chr5,172951136,0.6203602767522906,2225,1826,4051,+
chr5,172951143,0.5605639319392868,1691,1664,3355,+
chr5,172951304,1.799587912087912,793,559,1352,+
chr5,172951306,1.5760148822115934,1690,1310,3000,+
chr5,172951414,1.5750000000000004,881,649,1530,+
chr5,172951428,0.4868378465853922,949,712,1661,+
chr5,172951434,1.9808823807778373,2447,1690,4137,+
chr5,172951460,1.587707656163061,2473,1794,4267,+
chr5,172951532,1.4581135061802832,2344,1487,3831,+
chr5,172951534,1.4581135061802832,2344,1487,3831,+
chr5,172951639,0.7118182396741551,1363,826,2189,+
chr5,172951660,0.739465180577849,2942,1831,4773,+
chr5,172951692,3.2539405554605385,7907,4972,12879,+
chr5,172951693,2.4490374798121364,4456,2614,7070,+
chr5,172951702,1.401157335001564,1580,1111,2691,+
chr5,172951773,1.8192431396395732,2546,1890,4436,+
chr5,172952005,2.0678440084954173,720,582,1302,+
chr5,172952041,2.0477624013040976,1390,924,2314,+
chr5,172952052,0.4899397855779117,833,618,1451,+
chr5,172952055,0.5824508320726173,923,660,1583,+
chr5,172952069,1.6785595751742448,594,523,1117,+
chr5,172952086,0.5709728867623605,715,626,1341,+
chr5,172952103,1.5568898367952522,818,673,1491,+
chr5,172952148,0.7423565750164565,1903,1361,3264,+
chr5,172952455,18.064253322974757,1736,130,1866,+
chr5,172952456,20.12284730195178,2061,133,2194,+
chr5,172952457,44.722481231213465,2840,372,3212,+
chr5,172952458,51.011867372284364,6568,875,7443,+
chr5,172952459,53.189439582736014,5886,836,6722,+
chr5,172952460,36.49011829418694,4032,680,4712,+
chr5,172952462,43.24558055452807,3960,2280,6240,+
chr5,172952463,18.395575134057157,6911,6474,13385,+
chr5,172952464,18.395575134057157,6911,6474,13385,+
chr5,172952465,18.1685657366782,5925,6258,12183,+
chr5,172952469,3.528169014084507,667,567,1234,+
chr5,172952521,0.32749219488861386,414,693,1107,+
chr5,172952522,0.5641538075211868,635,830,1465,+
chr5,172952523,0.5204340798891711,643,487,1130,+
chr5,172952525,0.5204340798891711,643,487,1130,+
chr5,172952528,0.6261227072937025,1858,1392,3250,+
chr5,172952529,0.6261227072937025,1858,1392,3250,+
chr5,172952558,1.210188715770753,1895,1514,3409,+
chr5,172952559,1.0085238631820002,1046,901,1947,+
chr5,172959906,1.3323189519156267,729,489,1218,+
chr5,172968531,1.6607894570005997,1752,1220,2972,+
chr5,172968552,2.1059692086071853,1016,765,1781,+
chr5,172968554,2.1059692086071853,1016,765,1781,+
chr5,172969447,0.5752078609221467,760,587,1347,+
chr5,172969453,2.40316573556797,622,536,1158,+
chr5,172969455,1.8511773940345368,736,454,1190,+
chr5,172969604,2.533190578158458,727,466,1193,+
chr5,172969605,2.533190578158458,727,466,1193,+
chr5,172975784,1.5572957656210422,817,503,1320,+
chr5,172975888,2.4405025868440497,634,450,1084,+
chr5,172976299,0.4254110118062452,700,476,1176,+
chr5,172976300,0.7792630214672988,1599,1205,2804,+
chr5,172976302,1.226923076923077,747,519,1266,+
chr5,172983857,3.316153142649507,772,612,1384,+
chr5,172994778,0.41236346042911104,1107,852,1959,+
chr5,172994780,0.41236346042911104,1107,852,1959,+
chr5,172994787,0.5098632528367762,673,490,1163,+
chr5,173020265,2.0540116187784583,843,578,1421,+
chr5,173020313,0.48172094508301416,709,521,1230,+
chr5,173034421,0.6493227118416187,742,632,1374,+
chr5,173034577,2.817110655737705,610,487,1097,+
chr5,173034711,1.9818404907975464,672,488,1160,+
chr5,173034718,2.061630760839924,755,578,1333,+
chr5,173034727,0.6603666245259164,1347,903,2250,+
chr5,173034728,1.396987275449102,1658,1335,2993,+
chr5,173034742,0.744880666572518,1917,1459,3376,+
chr5,173959079,1.4081944469287864,753,416,1169,+
chr5,175512123,2.8775736979195545,582,431,1013,+
chr5,175526641,2.5078768608180373,722,406,1128,+
chr5,175528178,2.5670593890043394,869,559,1428,+
chr5,175528179,2.5670593890043394,869,559,1428,+
chr5,176388756,1.4501652682430712,670,683,1353,+
chr5,176388757,1.4501652682430712,670,683,1353,+
chr5,176388758,1.0873321750118463,942,973,1915,+
chr5,176388760,0.7782874617737003,508,544,1052,+
chr5,176388824,2.2422519309102245,1202,796,1998,+
chr5,176388925,2.218818681318681,556,454,1010,+
chr5,176389420,1.633932526880713,786,609,1395,+
chr5,176389530,0.6544655929721815,893,682,1575,+
chr5,176389620,2.149122807017544,587,455,1042,+
chr5,177303866,2.635902031063321,705,371,1076,+
chr5,177303868,2.635902031063321,705,371,1076,+
chr5,177303946,1.4420450099496254,688,571,1259,+
chr5,177303947,1.7091699673876655,581,491,1072,+
chr5,177303982,1.4271497526129624,739,512,1251,+
chr5,177303987,1.1934306569343065,653,547,1200,+
chr5,177303989,1.1934306569343065,653,547,1200,+
chr5,177304692,3.4037014704749895,766,435,1201,+
chr5,177304709,2.1290415704387997,589,432,1021,+
chr5,177304712,2.870488322717622,623,470,1093,+
chr5,177304734,1.8643410852713176,1169,644,1813,+
chr5,177304735,0.6309523809523809,794,629,1423,+
chr5,177304737,1.6587631948117654,1287,736,2023,+
chr5,177305901,1.9726731469882042,794,561,1355,+
chr5,177305904,1.8442111959287533,1093,785,1878,+
chr5,177305906,1.7208066577103391,2189,1606,3795,+
chr5,177305907,2.573763952407894,1502,1124,2626,+
chr5,177306097,0.9953058176497672,1047,822,1869,+
chr5,177306098,1.1395348837209305,783,687,1470,+
chr5,177306105,2.740820734341253,845,462,1307,+
chr5,177306107,2.740820734341253,845,462,1307,+
chr5,177306118,1.7182698884266714,855,527,1382,+
chr5,177306519,3.161214953271029,901,427,1328,+
chr5,177306521,3.161214953271029,901,427,1328,+
chr5,177306537,2.1238026759426876,1484,831,2315,+
chr5,177306538,1.767163156993665,1190,648,1838,+
chr5,177306550,2.821711877608485,1213,843,2056,+
chr5,177306553,2.1112499544672456,1270,908,2178,+
chr5,177592202,0.9112387923686707,755,316,1071,+
chr5,177592206,2.740036151626492,1112,527,1639,+
chr5,177592207,2.604411764705882,692,339,1031,+
chr5,177592211,1.981136701945692,1404,587,1991,+
chr5,177592212,2.1852693416094,916,346,1262,+
chr5,177592239,2.7278911564625847,801,391,1192,+
chr5,177592267,2.469346733668341,818,397,1215,+
chr5,177592273,1.911184210526316,580,436,1016,+
chr5,177592276,1.3954248135854974,1639,995,2634,+
chr5,177592296,3.306073153899241,870,413,1283,+
chr5,177592299,2.148833616546694,2431,1491,3922,+
chr5,177592316,1.4925230733872819,4722,3241,7963,+
chr5,177592317,1.4925230733872819,4722,3241,7963,+
chr5,177592318,1.4925230733872819,4722,3241,7963,+
chr5,177592319,2.10375,1121,599,1720,+
chr5,177592329,1.6550037459175637,3874,2634,6508,+
chr5,177592371,1.6368306462115678,2054,1622,3676,+
chr5,177592576,2.263929313929314,750,480,1230,+
chr5,177592612,0.9116694882532894,876,782,1658,+
chr5,177592613,0.9116694882532894,876,782,1658,+
chr5,177592642,1.6965313100566124,1135,932,2067,+
chr5,177592643,1.8076305220883533,642,497,1139,+
chr5,177593688,1.5905631659056314,626,510,1136,+
chr5,177593701,0.6323300833686589,1073,673,1746,+
chr5,177593725,0.7350616036107648,2239,1526,3765,+
chr5,177594150,0.6227514133972931,1453,897,2350,+
chr5,177594157,1.5532108501603263,1604,1048,2652,+
chr5,177594164,1.4372397382510411,1811,1229,3040,+
chr5,177594166,1.7125073787284282,1616,928,2544,+
chr5,177594167,0.9997256826768252,3720,2682,6402,+
chr5,177594178,1.3623912533497042,4571,2951,7522,+
chr5,177594185,1.3534071193567412,4823,3533,8356,+
chr5,177594187,1.3196026132821863,2564,1551,4115,+
chr5,177594199,0.7783378803196278,3037,1771,4808,+
chr5,177594204,1.3754713574760848,12151,8342,20493,+
chr5,177594205,1.3942776468676363,8669,6351,15020,+
chr5,177594262,1.5749949093870903,2218,1636,3854,+
chr5,177594271,1.1777706210312886,5899,4390,10289,+
chr5,177595336,2.1047619047619053,577,475,1052,+
chr5,177595342,1.7292327203551048,605,497,1102,+
chr5,177595391,3.2909559060186675,817,477,1294,+
chr5,177595401,1.655527708159287,819,512,1331,+
chr5,177595402,0.5031055900621119,845,643,1488,+
chr5,177595455,1.8213245997088792,714,457,1171,+
chr5,177595564,1.7356486210418791,707,444,1151,+
chr5,177595567,1.9122739515198155,709,451,1160,+
chr5,177595576,3.704638218923933,767,489,1256,+
chr5,177595579,1.6313840564521767,933,733,1666,+
chr5,177595599,0.507533703409992,599,484,1083,+
chr5,177595638,0.5621352140077821,602,513,1115,+
chr5,177595732,5.782297317575082,2426,436,2862,+
chr5,177595733,6.276592852584557,2744,390,3134,+
chr5,177595734,5.231030626262626,2855,520,3375,+
chr5,177595735,6.7438636693159975,3813,585,4398,+
chr5,177595737,15.366761578066079,7523,6082,13605,+
chr5,177595738,10.65581450654624,7747,8640,16387,+
chr5,177595739,10.65581450654624,7747,8640,16387,+
chr5,177595740,8.325826622298159,4659,6436,11095,+
chr5,177595746,5.798772176390611,2220,4698,6918,+
chr5,177595751,0.5861108929378117,1317,2148,3465,+
chr5,177595777,0.4021686357015698,709,1335,2044,+
chr5,177595815,1.5064560727131677,1221,1345,2566,+
chr5,177595816,0.3828615287371889,847,962,1809,+
chr5,177595901,6.480842351564785,1230,262,1492,+
chr5,177595902,4.015160870365625,2240,658,2898,+
chr5,177595903,5.65070001752456,2850,684,3534,+
chr5,177595905,4.839588313719895,4737,1175,5912,+
chr5,177595906,25.15984037729004,2366,744,3110,+
chr5,177595907,17.771588065066076,7735,4438,12173,+
chr5,177595908,16.883203597359476,9298,8123,17421,+
chr5,177595909,17.023782257777135,8712,8005,16717,+
chr5,177595910,17.58377574045613,6945,7541,14486,+
chr5,177595922,1.6772128060263654,1167,2159,3326,+
chr5,177595923,2.309683045960507,3156,4955,8111,+
chr5,177595979,0.5169342288475715,934,841,1775,+
chr5,177595980,0.5172222222222222,797,959,1756,+
chr5,177595998,0.4888888888888889,769,734,1503,+
chr5,177596029,7.175964978032797,1905,1563,3468,+
chr5,178055657,2.129464285714286,635,447,1082,+
chr5,178055660,0.6149055846947472,1309,1243,2552,+
chr5,178055683,1.2950662408669684,7415,6632,14047,+
chr5,178055684,1.2348507403243536,8613,7158,15771,+
chr5,178055685,1.1307976756908462,5918,5258,11176,+
chr5,178055686,0.796276776785665,10524,7741,18265,+
chr5,178055687,0.7772969858461493,4536,3146,7682,+
chr5,178055691,1.2971400546292904,7764,6455,14219,+
chr5,178055692,1.2904593581186683,9427,6786,16213,+
chr5,178055694,1.3264054633398914,11220,9943,21163,+
chr5,178055912,0.9836065573770492,874,609,1483,+
chr5,178055913,0.9836065573770492,874,609,1483,+
chr5,178055940,2.4014616935483866,732,495,1227,+
chr5,178055970,2.3015479876161,707,339,1046,+
chr5,178056003,1.4477450347560643,2479,1626,4105,+
chr5,178056004,1.4019656927630884,4598,2745,7343,+
chr5,178056005,1.4019656927630884,4598,2745,7343,+
chr5,178056010,1.5410945643503784,1591,902,2493,+
chr5,178056013,1.5917681525735292,1910,1087,2997,+
chr5,178056015,1.5892288444040044,1619,1255,2874,+
chr5,178056016,1.502139159357314,3154,2311,5465,+
chr5,178056017,1.4692631184998424,5022,3039,8061,+
chr5,178056018,1.4132746677332677,8898,6822,15720,+
chr5,178056019,1.3977281058491688,17685,12471,30156,+
chr5,178056021,1.4046997379376387,9960,6966,16926,+
chr5,178056047,1.916196819511924,7793,6772,14565,+
chr5,178204531,0.8494555298074359,893,402,1295,+
chr5,178204532,0.8347978720344025,1248,617,1865,+
chr5,178204537,1.6983416252072967,930,401,1331,+
chr5,178204955,1.5877322267496237,808,423,1231,+
chr5,178204979,2.018646616541353,838,759,1597,+
chr5,178204981,2.018646616541353,838,759,1597,+
chr5,178204991,1.4317135874567557,570,642,1212,+
chr5,178205841,0.9182316912213232,3182,2046,5228,+
chr5,178205842,0.988248696969892,3163,2080,5243,+
chr5,178205843,0.7155315315315315,1167,739,1906,+
chr5,178205845,1.5965087810160554,1558,1267,2825,+
chr5,178205846,1.6621691039449635,4579,3225,7804,+
chr5,178205891,1.2102795148217564,4759,3158,7917,+
chr5,178205906,0.5202177886079805,2101,1175,3276,+
chr5,178205926,1.9529860513817732,2691,1572,4263,+
chr5,178205930,0.6697836086541129,5390,3655,9045,+
chr5,178205933,1.0557438715574345,12917,7941,20858,+
chr5,178205936,1.665999173212071,4078,2418,6496,+
chr5,178206766,1.659892397109645,1536,1060,2596,+
chr5,178206770,1.583520935451485,6323,4837,11160,+
chr5,178206771,1.616805337125286,11970,8920,20890,+
chr5,178206772,1.7155839289946149,3755,2938,6693,+
chr5,178206776,1.3449096592760672,4386,2856,7242,+
chr5,178206777,0.7491023309862421,8213,6394,14607,+
chr5,178206778,0.9845719882269552,20575,15139,35714,+
chr5,178206779,1.4003069172779703,7336,5348,12684,+
chr5,178206780,0.7173074373050108,9759,7410,17169,+
chr5,178206794,1.7407183573581644,3217,2627,5844,+
chr5,178206822,1.5202072640621276,18585,15097,33682,+
chr5,178209357,3.024233896185116,666,532,1198,+
chr5,178210131,14.100039479307643,2124,2121,4245,+
chr5,178210132,14.100039479307643,2124,2121,4245,+
chr5,178210133,8.65515521755392,950,616,1566,+
chr5,178210135,0.3886068876991463,465,851,1316,+
chr5,178210226,1.23234283811154,989,755,1744,+
chr5,178210553,7.120411844833531,2175,1594,3769,+
chr5,178210559,3.0406237132355125,3618,3380,6998,+
chr5,178210560,2.8424279586070442,2268,2375,4643,+
chr5,178210563,1.6666641035645806,1472,1164,2636,+
chr5,178210566,0.5562862669245648,718,604,1322,+
chr5,178210600,0.6072443181818182,854,895,1749,+
chr5,178210605,1.6018052057094878,1173,793,1966,+
chr5,178210695,0.5691261587689992,1465,1075,2540,+
chr5,178210718,1.7864064869141012,1593,1378,2971,+
chr5,178210761,1.612957937584803,950,736,1686,+
chr5,178210907,1.3274869725069907,3327,2369,5696,+
chr5,178210942,1.766071428571429,643,559,1202,+
chr5,178210953,1.852126682986536,780,687,1467,+
chr5,179698985,0.5295407089272681,659,399,1058,+
chr5,179698986,0.648813551797046,997,507,1504,+
chr5,179699009,1.8565916349681828,1026,464,1490,+
chr5,179699021,0.48169611307420507,851,282,1133,+
chr5,179699025,0.9337553956834532,2079,624,2703,+
chr5,179699026,0.7397591079840201,2756,1081,3837,+
chr5,179699027,0.8199383076249327,4835,1705,6540,+
chr5,179699028,0.7397591079840201,2756,1081,3837,+
chr5,179699059,4.636091001413762,7569,2876,10445,+
chr5,179699060,9.274745853285449,8909,4226,13135,+
chr5,179699061,9.217534798786355,13172,5697,18869,+
chr5,179699062,9.88661054276411,10558,4794,15352,+
chr5,179699066,8.43134199635147,3065,2075,5140,+
chr5,179699067,15.973680479025715,5418,3184,8602,+
chr5,179699068,16.808708389393264,4464,2362,6826,+
chr5,179699073,11.08833456063264,3968,2557,6525,+
chr5,179699074,17.92907296069626,6372,4813,11185,+
chr5,179705690,1.7438967136150232,781,709,1490,+
chr5,179705722,0.9137944417476224,1274,1365,2639,+
chr5,179705742,1.769175627240143,616,619,1235,+
chr5,179706260,0.4806414662084765,1048,872,1920,+
chr5,179709884,1.7659858440000282,2794,1738,4532,+
chr5,179709970,2.045977511242616,12708,7683,20391,+
chr5,179709971,1.7092350081441525,24410,14635,39045,+
chr5,179709972,2.0698938157493267,17184,10586,27770,+
chr5,179709973,2.133184571817758,13078,8204,21282,+
chr5,179716152,1.877798975458092,3526,2592,6118,+
chr5,179716153,1.7317500107701915,6588,4641,11229,+
chr5,179716162,1.2438663880369207,9669,6656,16325,+
chr5,179716186,1.3349586648019527,19642,15072,34714,+
chr5,179716187,1.4919590542110828,14754,11621,26375,+
chr5,179716245,1.4607379375591296,1543,1056,2599,+
chr5,179716249,2.5026377237741078,1091,745,1836,+
chr5,179716264,1.438449731303043,2941,1871,4812,+
chr5,179716270,1.835703001579779,1244,843,2087,+
chr5,179719694,1.639029607114714,786,657,1443,+
chr5,179719727,1.7798969072164947,1150,969,2119,+
chr5,179720421,1.972034317769345,682,550,1232,+
chr5,179720452,2.060727969348659,693,579,1272,+
chr5,179720501,0.5486525343366676,943,640,1583,+
chr5,179720521,1.4041671077237925,1348,845,2193,+
chr5,179722811,1.633502417231593,1650,1247,2897,+
chr5,179722992,1.7863809194607672,607,525,1132,+
chr5,179723714,1.811688311688312,1115,727,1842,+
chr5,179723721,1.935266281705812,2311,1714,4025,+
chr5,179723744,1.8369113061953188,1980,1674,3654,+
chr5,179723751,3.0805970149253734,2561,2344,4905,+
chr5,179723753,2.6410056696024666,6305,5717,12022,+
chr5,179723754,3.1884980612238483,3932,3880,7812,+
chr5,179723756,2.5626812103253163,2639,2653,5292,+
chr5,179723759,1.914379411815472,2933,2862,5795,+
chr5,179724654,0.7182318390494192,1508,1609,3117,+
chr5,179724656,0.7182318390494192,1508,1609,3117,+
chr5,179724657,1.594437135876715,908,938,1846,+
chr5,179724660,0.6406185060641554,1442,1392,2834,+
chr5,179724674,1.7793621337016097,2513,2725,5238,+
chr5,179724676,1.7793621337016097,2513,2725,5238,+
chr5,179724680,1.4636867885839095,4377,4637,9014,+
chr5,179724681,1.388590313990511,5596,6273,11869,+
chr5,179724762,2.1026422060689973,1570,962,2532,+
chr5,179724769,2.9401488565788356,4126,2842,6968,+
chr5,179726680,1.4665841584158414,1184,807,1991,+
chr5,179726688,1.4629788450543169,1609,1112,2721,+
chr5,179726703,2.3864783910997005,1527,1229,2756,+
chr5,179726706,1.411877831628919,3814,2892,6706,+
chr5,179726741,1.8990080383102448,2094,1948,4042,+
chr5,179728608,1.6521674803965083,858,750,1608,+
chr5,179729377,2.4243918474687707,589,467,1056,+
chr5,179729388,1.1028175769019137,2307,1542,3849,+
chr5,179729437,1.6534979423868312,860,674,1534,+
chr5,179729442,1.8348101265822787,668,473,1141,+
chr5,179729488,2.877551020408163,704,538,1242,+
chr5,179729583,1.843936838877817,775,592,1367,+
chr5,179730455,0.4699876237623762,1084,807,1891,+
chr5,179730457,1.4363804558069126,1707,1033,2740,+
chr5,179776021,1.14414104850301,713,440,1153,+
chr5,179776064,2.1560395240976007,1090,854,1944,+
chr5,179776066,2.1560395240976007,1090,854,1944,+
chr5,179820903,0.9197617972454276,638,411,1049,+
chr5,179820904,0.8148223917253062,1682,1174,2856,+
chr5,179820991,0.9472355465791468,937,465,1402,+
chr5,179820992,2.2625048263673975,1587,1003,2590,+
chr5,179822978,0.44551342513991066,544,512,1056,+
chr5,179822993,0.5346713098729228,760,681,1441,+
chr5,179822994,0.5394363119947564,822,596,1418,+
chr5,179823926,1.828231667033693,592,477,1069,+
chr5,179823927,0.3792718791197647,679,518,1197,+
chr5,179823928,0.3792718791197647,679,518,1197,+
chr5,179823932,2.0049960757074086,1428,1111,2539,+
chr5,179824184,1.8405550685088972,826,544,1370,+
chr5,179825149,2.651489151635184,786,498,1284,+
chr5,179825167,0.648125358930183,631,477,1108,+
chr5,179825172,1.7166804303805183,1072,775,1847,+
chr5,179825181,2.0714263593707023,1491,1015,2506,+
chr5,179825184,1.7980516468223289,645,445,1090,+
chr5,179833035,2.0700357418223714,1902,1244,3146,+
chr5,179833041,2.240845796802476,789,553,1342,+
chr5,179833123,1.7679431102542138,2176,1525,3701,+
chr5,179833600,2.6875901875901875,744,461,1205,+
chr5,179833602,1.9267935578330893,783,682,1465,+
chr5,179833604,1.9267935578330893,783,682,1465,+
chr5,179833607,1.9385230723650093,726,586,1312,+
chr5,179833639,1.727633779264214,854,551,1405,+
chr5,179833768,0.4696635410921125,523,517,1040,+
chr5,179836452,0.3692602040816326,578,538,1116,+
chr5,179836468,2.3424930674049986,1201,970,2171,+
chr5,179836528,1.951083565575475,997,828,1825,+
chr5,179836530,1.951083565575475,997,828,1825,+
chr5,179836566,1.7335604770017037,847,586,1433,+
chr5,179836656,1.7691224849661624,1790,1284,3074,+
chr5,179836895,1.601568243077677,816,741,1557,+
chr5,179836931,0.6193740685543965,1038,731,1769,+
chr5,179837191,0.5792765578405175,964,905,1869,+
chr6,1613022,2.359956236323851,718,456,1174,+
chr6,1613023,2.359956236323851,718,456,1174,+
chr6,1613026,2.6927899686520376,858,637,1495,+
chr6,1613028,2.1685285464546107,1320,997,2317,+
chr6,1613030,2.082922748589612,1537,998,2535,+
chr6,2779371,2.194503347549498,610,471,1081,+
chr6,2785251,0.6853448275862069,529,479,1008,+
chr6,3010138,2.4038155802861687,701,480,1181,+
chr6,3010178,1.9230769230769231,719,467,1186,+
chr6,3016929,3.202622938247915,879,625,1504,+
chr6,3978849,1.5990681421083286,703,504,1207,+
chr6,3978856,0.48538498260928864,1976,1332,3308,+
chr6,3978857,0.8641202757527118,2619,1870,4489,+
chr6,4032586,2.5413978494623657,651,371,1022,+
chr6,4037519,1.5809255344139066,672,472,1144,+
chr6,4037520,1.5217241616745851,883,617,1500,+
chr6,4061232,1.4728053435114503,881,523,1404,+
chr6,4061233,1.4728053435114503,881,523,1404,+
chr6,4061234,1.10445133172453,1319,874,2193,+
chr6,4061248,2.3971320677239616,780,563,1343,+
chr6,4891986,2.0032813932451656,1150,726,1876,+
chr6,4891995,2.1378397638196067,749,516,1265,+
chr6,7395099,1.4701739191751866,557,444,1001,+
chr6,7400985,0.5080745341614906,817,459,1276,+
chr6,7400990,1.5600746268656718,903,535,1438,+
chr6,7400991,2.5354251012145745,834,493,1327,+
chr6,7400993,2.5354251012145745,834,493,1327,+
chr6,7401002,2.2509988584474883,630,437,1067,+
chr6,7402605,1.6700654717183645,3889,2540,6429,+
chr6,7402606,1.6303411232968392,5504,3492,8996,+
chr6,7402607,1.6700654717183645,3889,2540,6429,+
chr6,7402628,1.4571012993031527,3648,2467,6115,+
chr6,7402634,1.8828955456536702,3961,2864,6825,+
chr6,7402641,1.2297610949095525,7687,5729,13416,+
chr6,7402839,4.537232128550336,562,493,1055,+
chr6,7575391,2.5509372153400576,854,598,1452,+
chr6,7575428,2.259568345323741,905,833,1738,+
chr6,7575429,2.259568345323741,905,833,1738,+
chr6,7576308,2.021270987000083,546,469,1015,+
chr6,7578526,2.960955679419882,1350,1086,2436,+
chr6,7578528,2.082405839725508,2146,1602,3748,+
chr6,7578531,1.846416285218776,2254,2068,4322,+
chr6,7578532,1.9989610246211391,2623,2307,4930,+
chr6,7578533,1.9499007511801454,3004,2581,5585,+
chr6,7580066,2.9057404816765415,748,428,1176,+
chr6,7580124,2.1866886716765364,1681,1281,2962,+
chr6,7580125,2.9858299595141697,884,740,1624,+
chr6,7582777,0.5866819396213561,866,524,1390,+
chr6,7582779,2.684826152002091,721,377,1098,+
chr6,7582806,3.055714285714286,712,349,1061,+
chr6,7582807,3.674164294983206,960,487,1447,+
chr6,7582828,1.5074805909746034,1144,626,1770,+
chr6,7582829,0.9872659176029964,658,355,1013,+
chr6,7582892,0.6134085213032582,978,607,1585,+
chr6,7582904,1.7405159332321698,1053,658,1711,+
chr6,7582905,1.5953861069921296,1096,796,1892,+
chr6,7582916,2.0388459975619666,895,534,1429,+
chr6,7583877,0.7945485794206066,689,425,1114,+
chr6,7584239,2.110410108413286,820,560,1380,+
chr6,7584240,2.110410108413286,820,560,1380,+
chr6,7584328,2.7664048059149717,613,540,1153,+
chr6,7586439,5.702010767786605,608,479,1087,+
chr6,7593821,3.044087773449386,621,466,1087,+
chr6,7601384,3.302378254039497,624,490,1114,+
chr6,7602632,1.1388379861896265,949,670,1619,+
chr6,7606035,0.8895509213284784,555,476,1031,+
chr6,7606036,0.8895509213284784,555,476,1031,+
chr6,7606145,1.7509048753735437,707,551,1258,+
chr6,7608871,1.234220005990055,908,669,1577,+
chr6,7609322,3.7545573457865307,737,489,1226,+
chr6,7609568,4.050803402646503,552,528,1080,+
chr6,7609570,3.3778684468351643,790,809,1599,+
chr6,7609648,9.556944444444444,982,159,1141,+
chr6,7609649,17.259377494014366,982,178,1160,+
chr6,7609651,10.734445429426671,2293,523,2816,+
chr6,7609652,12.920748975707326,1076,262,1338,+
chr6,7609653,7.158736645749632,1130,256,1386,+
chr6,7609658,88.65179381283615,2400,1978,4378,+
chr6,7609659,107.6508763411565,2043,1904,3947,+
chr6,7610112,1.1660101891614216,658,448,1106,+
chr6,7610232,0.3390783064818283,904,627,1531,+
chr6,7610233,0.3390783064818283,904,627,1531,+
chr6,7610611,2.1914452484285336,1518,1124,2642,+
chr6,7610618,1.6692368214004722,815,614,1429,+
chr6,7611496,3.2883143028996886,742,481,1223,+
chr6,10629183,2.7337031900138697,875,411,1286,+
chr6,10629184,2.5116268382352938,1332,639,1971,+
chr6,10629186,2.4844720496894412,899,440,1339,+
chr6,10702370,2.8005829999980283,625,438,1063,+
chr6,10702474,2.2612752721617415,726,642,1368,+
chr6,10702475,2.2612752721617415,726,642,1368,+
chr6,10704578,2.737769169881239,867,576,1443,+
chr6,10709314,2.527348273931417,758,559,1317,+
chr6,10709317,2.3225492054846497,684,479,1163,+
chr6,10709393,2.183781550580505,1358,996,2354,+
chr6,10723165,0.6873026785896775,1179,773,1952,+
chr6,10723166,2.214524605828954,823,597,1420,+
chr6,10723167,0.5990767145720982,689,427,1116,+
chr6,10723168,2.214524605828954,823,597,1420,+
chr6,10723176,1.8377142857142859,1607,734,2341,+
chr6,10723177,1.8377142857142859,1607,734,2341,+
chr6,10723190,2.6001646090534978,717,404,1121,+
chr6,10723211,2.021585557299843,1211,636,1847,+
chr6,10724583,1.8791788094967818,2589,1828,4417,+
chr6,10724605,0.6248570121253717,873,743,1616,+
chr6,10724960,1.5353611953713069,840,773,1613,+
chr6,10725025,1.5387851253575635,1859,1131,2990,+
chr6,10725944,1.849652904640117,1214,781,1995,+
chr6,10725978,1.5915831974532184,1107,971,2078,+
chr6,10728640,1.624131274131274,894,739,1633,+
chr6,10728647,1.462932040557444,2689,1943,4632,+
chr6,10730641,1.353570544445202,7270,5484,12754,+
chr6,10730642,1.3984479141909416,4412,3336,7748,+
chr6,10730645,1.3474287275665098,5481,3671,9152,+
chr6,10730782,1.6211138572612254,5314,3821,9135,+
chr6,10747833,0.38458508141941955,801,551,1352,+
chr6,10749662,0.7644580508557964,688,441,1129,+
chr6,10749664,0.8062667365973414,619,478,1097,+
chr6,10751205,1.7324840764331209,543,470,1013,+
chr6,10756497,1.4069790628115653,895,679,1574,+
chr6,10756512,2.1616396761133605,677,493,1170,+
chr6,10756665,2.0237885870319805,910,696,1606,+
chr6,10756682,1.0225365177761645,5811,4381,10192,+
chr6,10756684,1.0225365177761645,5811,4381,10192,+
chr6,10756685,1.788361581920904,2260,1415,3675,+
chr6,10756829,1.6702577276870805,1389,1096,2485,+
chr6,11136853,0.7102529135863878,757,583,1340,+
chr6,11136854,0.6067477193952665,1364,959,2323,+
chr6,12514068,0.9449240719910011,1025,761,1786,+
chr6,12514069,0.9449240719910011,1025,761,1786,+
chr6,12514072,1.2326054384902292,1375,1234,2609,+
chr6,12514073,1.2326054384902292,1375,1234,2609,+
chr6,12514075,1.6342708333333331,1081,799,1880,+
chr6,12514080,1.3728586325040966,959,958,1917,+
chr6,12514082,1.6965187350518205,911,851,1762,+
chr6,12514083,0.6656229332010581,1570,1151,2721,+
chr6,12514194,2.098280435379128,1066,840,1906,+
chr6,12514213,2.597729115977291,3202,1369,4571,+
chr6,12514215,2.597729115977291,3202,1369,4571,+
chr6,12514225,1.6506036077046493,3155,1779,4934,+
chr6,12514243,1.1051096264717364,14489,10049,24538,+
chr6,12514244,1.3203423852482792,6430,3764,10194,+
chr6,12514245,0.8026666968243916,14194,11052,25246,+
chr6,12514246,0.7677637304207094,11503,8861,20364,+
chr6,12514247,0.835268036422718,17404,13747,31151,+
chr6,12514248,1.1998739204437998,4460,2734,7194,+
chr6,12514249,1.1111834420395348,8950,7127,16077,+
chr6,12514265,1.2976284341437143,8399,6783,15182,+
chr6,12514697,0.8613312681166208,804,638,1442,+
chr6,12514714,1.456989708404803,1113,847,1960,+
chr6,13615715,1.5445909398242057,748,579,1327,+
chr6,13617773,2.0552511415525108,642,437,1079,+
chr6,13617774,1.154580656516765,1380,1032,2412,+
chr6,13617776,1.154580656516765,1380,1032,2412,+
chr6,13618120,0.6390032261653131,1435,800,2235,+
chr6,13620255,2.0797230113636367,688,511,1199,+
chr6,13620266,2.9738805970149254,796,468,1264,+
chr6,13620430,1.9446661346102685,730,536,1266,+
chr6,13620768,2.2380174291939,586,458,1044,+
chr6,13976950,3.2772070015220702,688,437,1125,+
chr6,13977116,2.4037923909079857,823,432,1255,+
chr6,13977382,0.562037037037037,606,404,1010,+
chr6,13977426,1.6980308785331228,948,551,1499,+
chr6,13977724,1.8527777777777776,695,431,1126,+
chr6,13978362,1.9700571404858171,885,659,1544,+
chr6,13978441,0.5530145530145529,702,480,1182,+
chr6,13978469,0.9315750114799427,1312,989,2301,+
chr6,13978587,1.198899455919881,1040,760,1800,+
chr6,13979027,0.6215931863727455,652,498,1150,+
chr6,13979459,0.3063973063973064,636,440,1076,+
chr6,14118044,1.836615006329757,1162,714,1876,+
chr6,14131547,3.5668187179780655,1096,856,1952,+
chr6,14131599,1.7672701798391983,1398,915,2313,+
chr6,14131602,1.870337477797513,701,562,1263,+
chr6,14133667,0.5303800532558702,625,458,1083,+
chr6,14135139,1.62573673870334,661,508,1169,+
chr6,14135187,0.8582350415993785,1311,922,2233,+
chr6,14135188,0.8582350415993785,1311,922,2233,+
chr6,14135657,1.8228754946745545,1519,1015,2534,+
chr6,14135660,1.6326234970302766,643,530,1173,+
chr6,14135733,1.687873692077728,622,445,1067,+
chr6,14135734,1.5564103973182395,832,586,1418,+
chr6,14135771,1.8144897157081097,553,448,1001,+
chr6,14135904,2.292899408284024,774,506,1280,+
chr6,14136024,3.1147105682421667,781,537,1318,+
chr6,14136026,3.1147105682421667,781,537,1318,+
chr6,14136139,2.421311900440757,565,531,1096,+
chr6,17608473,1.0201155731109648,733,440,1173,+
chr6,17608475,1.0201155731109648,733,440,1173,+
chr6,17608513,2.6083532292523994,1249,689,1938,+
chr6,21598264,0.980083857442348,659,423,1082,+
chr6,21598266,0.980083857442348,659,423,1082,+
chr6,24667161,2.279491292694881,840,541,1381,+
chr6,24667192,1.119008054487291,1095,747,1842,+
chr6,24667247,1.8308910891089112,1339,1009,2348,+
chr6,24667248,1.8308910891089112,1339,1009,2348,+
chr6,24667249,1.705111516098238,613,500,1113,+
chr6,24667260,1.5766546762589928,826,694,1520,+
chr6,24667269,1.922179541897852,915,851,1766,+
chr6,24667274,2.003058350100604,975,993,1968,+
chr6,24667294,1.9195753151957533,903,684,1587,+
chr6,24667296,1.8508114856429465,1185,889,2074,+
chr6,24697882,2.5143876337693216,1743,1681,3424,+
chr6,24698054,2.070727419236686,3768,2991,6759,+
chr6,24698056,1.8985053306234905,9540,7380,16920,+
chr6,24698057,1.906768659434003,6288,4769,11057,+
chr6,24701462,1.9349371377014735,2954,2490,5444,+
chr6,24701485,2.1271631039072902,1597,1160,2757,+
chr6,24701491,1.4196617351617533,4560,3635,8195,+
chr6,24701495,2.2324727888045373,2012,1681,3693,+
chr6,24701500,1.5540487794923392,8991,8732,17723,+
chr6,24701505,1.602804445876289,3540,3199,6739,+
chr6,24701520,0.7238288516827329,5349,5693,11042,+
chr6,24701527,1.4926214426956925,11837,12223,24060,+
chr6,24701533,1.0910855701606883,12905,13525,26430,+
chr6,24780692,1.996951219512195,654,491,1145,+
chr6,24780695,1.7115238336713996,870,543,1413,+
chr6,24780713,1.5327613104524183,785,640,1425,+
chr6,24781516,1.8178947368421048,627,399,1026,+
chr6,24781527,1.6097831916034628,1024,915,1939,+
chr6,24781529,1.7520819586217824,1850,1348,3198,+
chr6,24781580,1.716206688154714,920,583,1503,+
chr6,24784120,0.5901167439628979,737,480,1217,+
chr6,24784121,1.6329674561910261,794,576,1370,+
chr6,24784122,2.694683908045977,681,521,1202,+
chr6,24784451,1.0842236177880094,918,723,1641,+
chr6,24784473,1.8269121004566207,825,583,1408,+
chr6,24785735,1.6517173485014218,1056,652,1708,+
chr6,24785738,1.5710098587796428,1071,833,1904,+
chr6,25141073,0.8687782805429863,629,454,1083,+
chr6,25141075,1.043638615975507,1357,1002,2359,+
chr6,25141076,0.8728706582329446,1259,1032,2291,+
chr6,26545344,2.1756125464772618,1140,616,1756,+
chr6,26545345,2.1756125464772618,1140,616,1756,+
chr6,26545387,2.007650705711648,760,360,1120,+
chr6,26545404,1.9388365529788363,3533,1872,5405,+
chr6,26545405,1.941874619598296,2126,1112,3238,+
chr6,26545805,1.7220271040102018,714,508,1222,+
chr6,26545959,3.5460206263643004,780,507,1287,+
chr6,26546435,3.264646464646465,605,404,1009,+
chr6,29725516,2.3907611112619795,1582,1122,2704,+
chr6,29725517,1.8515334947538336,1066,707,1773,+
chr6,29725527,1.8676309814145156,693,516,1209,+
chr6,29887968,1.3685096435301334,934,873,1807,+
chr6,29887970,1.9555157486191967,523,637,1160,+
chr6,29887971,0.8539589442815249,895,619,1514,+
chr6,29887973,0.8539589442815249,895,619,1514,+
chr6,29888602,0.8242486010714979,629,464,1093,+
chr6,29890263,0.5499399759903961,2035,1665,3700,+
chr6,29890264,0.5499399759903961,2035,1665,3700,+
chr6,29890265,1.3397543893109551,1323,977,2300,+
chr6,29891020,1.8568688431368767,551,491,1042,+
chr6,29942530,0.9136437585898642,16243,5257,21500,+
chr6,29942531,0.9318283054761912,32870,12537,45407,+
chr6,29942774,1.8117247238742569,1776,748,2524,+
chr6,29942777,1.3989137852593263,1586,1098,2684,+
chr6,29942782,1.434331942864366,1620,585,2205,+
chr6,29942819,1.5287098656886542,5385,3430,8815,+
chr6,29942842,1.446445157820979,2275,1125,3400,+
chr6,29942845,1.4694130614494352,2132,1527,3659,+
chr6,29942849,1.4412329042190044,2609,1347,3956,+
chr6,29942863,1.9787605920484965,5121,4108,9229,+
chr6,29942864,1.7995030825404534,10883,8173,19056,+
chr6,29942866,1.9858659336312376,5443,4716,10159,+
chr6,29942926,1.4645211530114637,5385,2955,8340,+
chr6,29942927,1.4645211530114637,5385,2955,8340,+
chr6,29942948,1.5125078566939032,2047,1719,3766,+
chr6,29942967,1.3794633507853404,2612,2291,4903,+
chr6,29943005,1.6077204253433761,3856,2317,6173,+
chr6,29943007,1.3128623664168402,2953,2516,5469,+
chr6,29943358,1.5661404261858958,3837,2028,5865,+
chr6,29943360,1.7166800766145918,7008,4448,11456,+
chr6,29943362,1.7028183823301426,7751,6122,13873,+
chr6,29943363,1.582177514577312,6203,4972,11175,+
chr6,29943372,1.948304191468254,1590,1343,2933,+
chr6,29943417,1.508318425760286,1847,1039,2886,+
chr6,29943422,1.4427087699687953,1701,1262,2963,+
chr6,29943431,1.5766411903706985,1876,1463,3339,+
chr6,29943503,1.3340716342848837,4446,2946,7392,+
chr6,29944276,0.7108864892014063,870,361,1231,+
chr6,29944283,2.9260589546693088,944,366,1310,+
chr6,29944284,2.9260589546693088,944,366,1310,+
chr6,29944285,2.9260589546693088,944,366,1310,+
chr6,29944298,1.8285775552369237,2301,1378,3679,+
chr6,29944299,0.6193968209198782,1117,1012,2129,+
chr6,29944300,1.2668651761245662,2740,1906,4646,+
chr6,29944326,1.713774399468654,1326,660,1986,+
chr6,29944331,1.3299616775516814,1520,954,2474,+
chr6,29944334,1.6830308605837585,1676,1086,2762,+
chr6,29944336,0.672065694126621,1818,911,2729,+
chr6,29944337,0.9125149859204916,9638,6623,16261,+
chr6,29944338,1.1364837587453112,8694,5760,14454,+
chr6,29944339,1.226716553946972,16251,10220,26471,+
chr6,29944340,1.325189677025657,19317,12587,31904,+
chr6,29944341,1.1680770861174994,18000,12876,30876,+
chr6,29944342,1.1812520581229962,15735,11367,27102,+
chr6,29944343,1.435707508887441,10989,7952,18941,+
chr6,29944345,1.4719099405187666,5712,4207,9919,+
chr6,29944503,1.6527575730633324,4158,2200,6358,+
chr6,29944504,1.6571288227954646,4128,2480,6608,+
chr6,29944507,1.5657755453351745,5030,2837,7867,+
chr6,29944508,1.5473322768092976,3445,1892,5337,+
chr6,29944513,1.4007353216763925,10648,6773,17421,+
chr6,29944514,1.4007353216763925,10648,6773,17421,+
chr6,29944515,1.2565828815522186,13516,9871,23387,+
chr6,29944517,1.3097115481722943,18072,13182,31254,+
chr6,29944519,1.486271081057671,14377,9964,24341,+
chr6,29944520,1.4214285714285717,6168,4339,10507,+
chr6,29944521,0.7142254629442423,5341,4430,9771,+
chr6,29944522,1.5149252187155993,6478,4737,11215,+
chr6,29944523,1.5149252187155993,6478,4737,11215,+
chr6,29944532,1.5281217450118365,3715,2956,6671,+
chr6,29944534,1.2852576181941917,4579,3861,8440,+
chr6,29944550,1.1016442118546712,12678,10153,22831,+
chr6,29945235,1.257893486388816,1704,1310,3014,+
chr6,29945236,1.293525854621745,2403,1824,4227,+
chr6,29945268,1.4977983663775563,2968,2002,4970,+
chr6,29945456,1.5686511278270832,5519,3779,9298,+
chr6,29945458,1.3728688565571723,3993,2711,6704,+
chr6,29945462,1.4760591316205411,2267,1573,3840,+
chr6,29945463,1.336846370179703,2572,1997,4569,+
chr6,29945477,1.6079035614295984,5674,4136,9810,+
chr6,29945484,1.2348644713174428,2954,2306,5260,+
chr6,29945490,1.6060169700062883,3500,2912,6412,+
chr6,29945609,1.6368719965050242,3229,2179,5408,+
chr6,29945615,1.42714827643081,3379,2349,5728,+
chr6,29945618,1.4142888286717519,19372,13258,32630,+
chr6,29945619,1.461498758931218,16358,10622,26980,+
chr6,29945628,1.561790961772038,5054,3100,8154,+
chr6,29945673,1.3831909076841074,4151,3060,7211,+
chr6,29945702,1.2707293834882,4190,3238,7428,+
chr6,29945709,0.9981854270191907,12033,9125,21158,+
chr6,30061355,1.6184213907958505,592,451,1043,+
chr6,30061621,1.98509390280508,1051,791,1842,+
chr6,30067280,4.198075012782336,810,750,1560,+
chr6,30067281,3.5674919187511933,1110,948,2058,+
chr6,30067295,4.2374718052633575,555,494,1049,+
chr6,30069794,4.02948694931049,694,449,1143,+
chr6,30070090,5.8264254842307475,1818,1257,3075,+
chr6,30070091,5.8264254842307475,1818,1257,3075,+
chr6,30070213,1.3281817538259564,546,463,1009,+
chr6,30485967,1.2452235185606775,1521,1248,2769,+
chr6,30485969,1.2452235185606775,1521,1248,2769,+
chr6,30486026,0.9011999955014228,1195,830,2025,+
chr6,30486028,0.9011999955014228,1195,830,2025,+
chr6,30486029,1.9974432726110583,624,446,1070,+
chr6,30486038,1.4655287817938418,905,663,1568,+
chr6,30486039,0.5664943271578342,685,632,1317,+
chr6,30486043,2.0147642806231545,841,853,1694,+
chr6,30486044,2.0147642806231545,841,853,1694,+
chr6,30486047,2.2275615808267264,955,1065,2020,+
chr6,30486048,2.2275615808267264,955,1065,2020,+
chr6,30486050,1.5276279053834163,1426,997,2423,+
chr6,30486053,0.5960337380026499,3501,2404,5905,+
chr6,30486054,0.5960337380026499,3501,2404,5905,+
chr6,30486174,1.0782598054212813,711,471,1182,+
chr6,30486175,1.0782598054212813,711,471,1182,+
chr6,30486176,1.0782598054212813,711,471,1182,+
chr6,30486309,1.0795470423205498,916,890,1806,+
chr6,30486311,0.48770491803278687,594,619,1213,+
chr6,30486316,1.0325889585409136,2860,2158,5018,+
chr6,30486317,1.0423339627479775,1465,1085,2550,+
chr6,30486318,1.02252017380509,1395,1073,2468,+
chr6,30486324,0.5141776937618148,1631,1448,3079,+
chr6,30486326,0.5633265063521093,3729,3000,6729,+
chr6,30486362,0.6470902399347892,3758,2823,6581,+
chr6,30486463,1.245899452045151,910,675,1585,+
chr6,30486492,1.5882352941176472,881,636,1517,+
chr6,30486493,0.6484975541579314,927,782,1709,+
chr6,30486495,0.5627073656270736,635,547,1182,+
chr6,30486537,1.9223138963567252,1295,965,2260,+
chr6,30486539,1.9223138963567252,1295,965,2260,+
chr6,30491155,1.3917430011866547,1547,931,2478,+
chr6,30491157,1.439650830955179,1138,628,1766,+
chr6,30571443,0.824104117664001,476,530,1006,+
chr6,30578537,0.649333087891255,983,699,1682,+
chr6,30578538,0.7458780709736124,758,524,1282,+
chr6,30582410,3.0947072801292843,1384,773,2157,+
chr6,30582412,2.4548293811451702,785,454,1239,+
chr6,30582430,2.6490783246555316,1168,802,1970,+
chr6,30582433,2.893475347397678,2751,1965,4716,+
chr6,30582434,2.5642857450921404,1793,1201,2994,+
chr6,30582437,2.695449586330464,2930,2502,5432,+
chr6,30582439,6.85548271086534,5045,5540,10585,+
chr6,30582440,7.752566000423388,4003,4718,8721,+
chr6,30582443,1.6684280614451577,1182,1788,2970,+
chr6,30582447,0.5965245223696696,1169,1833,3002,+
chr6,30582452,0.5925260913477725,879,1406,2285,+
chr6,30582454,0.49317379694266966,2175,2900,5075,+
chr6,30586498,2.8411627682348,668,488,1156,+
chr6,30586500,2.7094231576876937,670,504,1174,+
chr6,30590317,3.017631103074141,800,552,1352,+
chr6,30590318,3.017631103074141,800,552,1352,+
chr6,30590319,2.5552447552447557,608,428,1036,+
chr6,30590907,2.142192918623568,1258,804,2062,+
chr6,30590909,2.142192918623568,1258,804,2062,+
chr6,30617860,2.6548082329699527,809,492,1301,+
chr6,30617875,1.952928297755884,1114,608,1722,+
chr6,30617876,1.952928297755884,1114,608,1722,+
chr6,30617877,1.952928297755884,1114,608,1722,+
chr6,30619533,1.7762139338494018,630,405,1035,+
chr6,30619581,1.7081031307550643,741,542,1283,+
chr6,30619708,1.5914103050234567,932,577,1509,+
chr6,30619772,2.286102431734818,600,432,1032,+
chr6,30619923,2.067400147928994,1136,831,1967,+
chr6,30619924,1.0800791382943309,1142,762,1904,+
chr6,30619925,2.5436347454054307,1732,1306,3038,+
chr6,30619926,2.970414847161572,1182,915,2097,+
chr6,30619968,2.9935878317924245,802,478,1280,+
chr6,30624924,1.3339203341392123,718,583,1301,+
chr6,30625577,4.904113736250574,711,450,1161,+
chr6,30625650,2.0680042613636367,612,511,1123,+
chr6,30625652,2.0680042613636367,612,511,1123,+
chr6,30625740,1.2165957915990349,804,680,1484,+
chr6,30625920,0.5093378607809846,599,493,1092,+
chr6,30625986,0.5221900089206066,668,471,1139,+
chr6,30626139,1.1821499168625218,980,633,1613,+
chr6,30626209,0.4680021566919664,867,512,1379,+
chr6,30626263,12.428292563693688,2977,1829,4806,+
chr6,30626266,7.564569603406639,2979,1986,4965,+
chr6,30626281,22.13547477707762,2650,2131,4781,+
chr6,30626305,0.586366262276141,769,576,1345,+
chr6,30720343,1.5416101135805784,649,355,1004,+
chr6,30720344,1.4754305103370609,612,407,1019,+
chr6,30720349,0.9884796090860514,1632,882,2514,+
chr6,30720351,0.9236077069716777,1498,764,2262,+
chr6,30720355,1.0734355220433283,8425,5198,13623,+
chr6,30720356,1.064166089987019,7215,4281,11496,+
chr6,30720359,0.8404142513784816,6447,3857,10304,+
chr6,30720468,1.9720949604331535,3787,2400,6187,+
chr6,30722546,1.6483340250686989,5516,3640,9156,+
chr6,30722551,1.6680475504322765,1028,693,1721,+
chr6,30722556,1.503058943045271,4040,2575,6615,+
chr6,30722606,1.4285955449764929,4061,2322,6383,+
chr6,30722621,1.2600479993330118,3157,2675,5832,+
chr6,30722632,0.8362985571948274,3363,2518,5881,+
chr6,30722922,1.4106885346433184,8735,5802,14537,+
chr6,30722923,0.7584448462929476,3755,2764,6519,+
chr6,30723378,2.161735065318107,1513,859,2372,+
chr6,30723381,2.0490345881372414,893,625,1518,+
chr6,30723397,2.1985107967237534,797,394,1191,+
chr6,30723401,1.388888888888889,1055,527,1582,+
chr6,30723405,1.7115848007414272,683,414,1097,+
chr6,30723411,1.6479532163742687,1408,721,2129,+
chr6,30723418,1.6583910880336215,2791,1586,4377,+
chr6,30723423,1.7756508984231758,2200,1514,3714,+
chr6,30723425,1.7756508984231758,2200,1514,3714,+
chr6,30723433,1.4792801364170602,6408,4455,10863,+
chr6,30723441,1.7912581699346404,3507,2015,5522,+
chr6,30723533,1.5642195721994736,10322,6390,16712,+
chr6,30723534,1.4945990919447962,8336,4683,13019,+
chr6,30723551,1.7019962659773091,1692,1054,2746,+
chr6,30723554,1.1593222829300789,5617,3764,9381,+
chr6,30723640,0.7813634301270419,2994,2319,5313,+
chr6,30723736,0.8068487244450606,12775,9012,21787,+
chr6,30723815,0.7708741208935,4797,3945,8742,+
chr6,30723816,0.9426041640874238,6869,5450,12319,+
chr6,30723969,1.1318927871340965,28466,17272,45738,+
chr6,30723970,1.1609963164464245,32732,20092,52824,+
chr6,30723987,1.3727228128823592,4626,2980,7606,+
chr6,30724062,1.2710572844226649,9307,6748,16055,+
chr6,30724064,1.346416344066773,2734,1942,4676,+
chr6,30724157,1.6221814026815546,2548,1665,4213,+
chr6,30724274,1.476450373964019,2074,1648,3722,+
chr6,30724363,1.6224,4055,2499,6554,+
chr6,30724425,1.0266318205758984,4421,3391,7812,+
chr6,30724426,1.1846421232547868,4611,3062,7673,+
chr6,30724684,1.4928391959798994,1164,994,2158,+
chr6,30724834,3.5427589976014895,6762,4535,11297,+
chr6,30725088,10.25221324047421,10998,10853,21851,+
chr6,30725089,8.384176424327825,14767,15450,30217,+
chr6,30725090,8.384176424327826,14767,15450,30217,+
chr6,30725091,4.815523321895691,12581,13873,26454,+
chr6,30725093,1.9319802931242838,2795,2734,5529,+
chr6,30725109,0.3014220505617977,1745,2669,4414,+
chr6,30725110,0.2823769166895025,5226,6643,11869,+
chr6,30725113,0.5213013587397824,962,1420,2382,+
chr6,30725134,0.5533947368421052,1236,1424,2660,+
chr6,30725347,1.6416973015918492,1230,842,2072,+
chr6,31280289,0.9365317763238358,24709,20785,45494,+
chr6,31280457,1.3502722813735402,1377,891,2268,+
chr6,31280459,0.7997552032840461,1300,901,2201,+
chr6,31280472,2.4493181832108135,2001,1483,3484,+
chr6,31280474,1.8274705039553105,2473,1844,4317,+
chr6,31280475,0.9930413687436157,914,711,1625,+
chr6,31280478,1.392980128939794,2622,1891,4513,+
chr6,31280479,1.7503694652987647,2491,1824,4315,+
chr6,31280505,1.6199787347127959,2777,2374,5151,+
chr6,31280507,1.678853233525586,2368,2247,4615,+
chr6,31280508,1.6387066541705715,1613,1551,3164,+
chr6,31280661,0.8992947007243614,572,429,1001,+
chr6,31280662,1.113906383401541,2335,1525,3860,+
chr6,31280664,1.1796602667794533,3530,2414,5944,+
chr6,31280665,1.0567736593699744,3220,2387,5607,+
chr6,31280666,1.1314067769897558,2812,2114,4926,+
chr6,31280667,0.8664973864486493,10643,7536,18179,+
chr6,31410780,0.47666585750697904,1365,748,2113,+
chr6,31410781,0.47666585750697904,1365,748,2113,+
chr6,31411139,2.7397260273972597,599,437,1036,+
chr6,31411140,2.7397260273972597,599,437,1036,+
chr6,31411226,3.1014056224899598,3088,1493,4581,+
chr6,31411227,3.1014056224899598,3088,1493,4581,+
chr6,31411228,2.9514057525227995,4174,2058,6232,+
chr6,31411230,2.8880538827784137,3253,1697,4950,+
chr6,31411232,2.751318240661804,2205,1172,3377,+
chr6,31463184,0.7088384466545047,1037,154,1191,+
chr6,31463188,9.992002931497499,999,200,1199,+
chr6,31463193,15.837199072484081,862,160,1022,+
chr6,31505854,1.7409336309353483,1771,1037,2808,+
chr6,31505855,1.7409336309353483,1771,1037,2808,+
chr6,31505856,1.7409336309353483,1771,1037,2808,+
chr6,31633926,1.7832383665716998,405,647,1052,+
chr6,31633927,3.0615373475795282,478,775,1253,+
chr6,31633928,1.7832383665716998,405,647,1052,+
chr6,31666828,1.82960413080895,1062,580,1642,+
chr6,31666829,1.82960413080895,1062,580,1642,+
chr6,31667928,1.7170658682634732,1146,667,1813,+
chr6,31668544,2.3294560762157968,750,530,1280,+
chr6,31668607,1.8635133229954264,2624,1944,4568,+
chr6,31669148,1.827477130888262,667,556,1223,+
chr6,31669320,3.851707167749688,1004,754,1758,+
chr6,31669357,1.983162826094692,1236,868,2104,+
chr6,31669849,1.7989392478302797,636,426,1062,+
chr6,31669969,1.9180177424288767,626,466,1092,+
chr6,31670001,0.6505576208178439,755,537,1292,+
chr6,31815694,6.27300100368016,749,426,1175,+
chr6,31815696,6.27300100368016,749,426,1175,+
chr6,31815723,0.40036938322679755,582,536,1118,+
chr6,31817457,3.181019332161687,904,568,1472,+
chr6,31817458,2.5825546445272187,1111,653,1764,+
chr6,31817564,1.358215010141988,743,339,1082,+
chr6,31817565,1.358215010141988,743,339,1082,+
chr6,31817566,1.358215010141988,743,339,1082,+
chr6,31817646,4.946859561929319,758,509,1267,+
chr6,31817708,2.6972170470046133,713,589,1302,+
chr6,31827736,0.961327417196494,963,658,1621,+
chr6,31827900,3.469334778726627,944,672,1616,+
chr6,31827901,3.453129866085332,692,493,1185,+
chr6,31829611,4.060150375939848,719,341,1060,+
chr6,31829619,3.144338685441876,756,443,1199,+
chr6,31829630,2.0886809903244172,826,501,1327,+
chr6,31829631,2.0886809903244172,826,501,1327,+
chr6,31829651,1.5727272727272728,691,439,1130,+
chr6,31829840,3.8614169006643984,720,563,1283,+
chr6,31829843,2.6473563759005185,637,510,1147,+
chr6,31829845,3.5621903520208598,718,589,1307,+
chr6,31829846,7.564207246743747,663,561,1224,+
chr6,31829997,0.5065999999999999,893,599,1492,+
chr6,31830010,1.9997377736987016,1115,788,1903,+
chr6,31834915,0.9650932323971397,1939,817,2756,+
chr6,31834916,0.962392139258816,934,488,1422,+
chr6,31834917,0.9679725085910652,1005,329,1334,+
chr6,31834921,2.473256065078108,1226,478,1704,+
chr6,31834923,1.9856179741981177,3158,1536,4694,+
chr6,31834924,1.6422536718308864,2647,1675,4322,+
chr6,31834925,1.8126434416409056,2758,1477,4235,+
chr6,31834937,2.2256348020911134,882,411,1293,+
chr6,31834944,2.3467432950191567,1028,782,1810,+
chr6,31834991,15.124134447932313,1703,1470,3173,+
chr6,31834996,3.2500985667218156,3625,2970,6595,+
chr6,31835058,1.9979177247333673,1268,894,2162,+
chr6,31835059,1.8705310663446424,1950,1391,3341,+
chr6,31835067,8.224265126320772,3849,3246,7095,+
chr6,31835068,7.774447932431336,4437,3622,8059,+
chr6,31835071,6.530863312418733,2567,2394,4961,+
chr6,31835076,0.47327409432672596,576,626,1202,+
chr6,31835081,0.6631935830645828,801,833,1634,+
chr6,31835109,0.4518683819025116,897,878,1775,+
chr6,31835189,1.7842759898784704,1614,1193,2807,+
chr6,31835410,1.887876896303863,2913,2135,5048,+
chr6,31835411,1.887876896303863,2913,2135,5048,+
chr6,31835435,1.8488762983947118,1578,1058,2636,+
chr6,31837075,1.0971866349866468,1100,873,1973,+
chr6,31837235,1.8815098468271336,1185,913,2098,+
chr6,31837307,1.4104875693941588,1600,1380,2980,+
chr6,31839542,1.5345323322274609,2463,1493,3956,+
chr6,31839543,1.1931933092684268,3565,2428,5993,+
chr6,31839555,1.7316793345762227,1724,1100,2824,+
chr6,31839587,1.6132517764266354,1914,1240,3154,+
chr6,31949482,2.0048046934428716,730,522,1252,+
chr6,31960521,2.3496569843818422,1369,805,2174,+
chr6,31960523,2.3496569843818422,1369,805,2174,+
chr6,32157900,1.734224052235219,855,549,1404,+
chr6,32162568,1.2156342720747897,2156,988,3144,+
chr6,32162569,1.6092109143395372,3045,1437,4482,+
chr6,32162570,1.6092109143395372,3045,1437,4482,+
chr6,32180612,1.4210834401225119,605,410,1015,+
chr6,32858007,1.5472562952303626,745,480,1225,+
chr6,32858030,0.675039246467818,644,363,1007,+
chr6,32972459,2.4636484500734728,977,460,1437,+
chr6,32972551,2.7052413243079543,809,464,1273,+
chr6,32975398,1.4265876998111124,973,683,1656,+
chr6,32976708,1.7861807071017546,541,472,1013,+
chr6,32977490,2.4653414882772684,690,653,1343,+
chr6,32977491,2.4653414882772684,690,653,1343,+
chr6,32977799,2.9644329896907218,638,484,1122,+
chr6,32977800,2.9644329896907218,638,484,1122,+
chr6,32977937,8.431185465920668,1013,989,2002,+
chr6,32978132,0.37851518560179975,672,507,1179,+
chr6,32978133,0.37851518560179975,672,507,1179,+
chr6,32978138,1.8442549371633752,586,556,1142,+
chr6,32978154,1.6275418994413409,746,715,1461,+
chr6,32978169,2.9868315026082533,1618,1386,3004,+
chr6,32978170,2.9868315026082533,1618,1386,3004,+
chr6,32979985,0.4278665246716365,708,625,1333,+
chr6,32979986,0.9331083042973288,1093,983,2076,+
chr6,32979988,1.2380481371579295,750,673,1423,+
chr6,32980654,2.1926075483603973,676,503,1179,+
chr6,32980989,15.247795309224882,929,537,1466,+
chr6,32981145,8.699565406671175,1064,629,1693,+
chr6,32981153,20.350703673879355,2322,2166,4488,+
chr6,32981154,20.350703673879355,2322,2166,4488,+
chr6,32981155,21.33128620871608,2160,2031,4191,+
chr6,33201135,3.65302077116251,830,623,1453,+
chr6,33201401,0.3684586278289426,793,608,1401,+
chr6,33201402,0.3684586278289426,793,608,1401,+
chr6,33201778,0.4149096385542169,782,663,1445,+
chr6,33201779,0.4149096385542169,782,663,1445,+
chr6,33201852,0.5479569892473117,587,449,1036,+
chr6,33202299,2.517720926304069,828,543,1371,+
chr6,33202306,1.2564890515589304,988,714,1702,+
chr6,33202328,0.5709607433787711,633,478,1111,+
chr6,33202596,1.2815735412647375,964,623,1587,+
chr6,33202684,0.4756711409395973,566,446,1012,+
chr6,33202953,2.3328464784160987,574,473,1047,+
chr6,33202956,1.6370247314600181,1209,1022,2231,+
chr6,33203006,2.836940836940837,982,824,1806,+
chr6,33203013,4.432886423177685,1045,926,1971,+
chr6,33203666,0.4799092339409745,856,530,1386,+
chr6,33203775,4.9716894614875455,559,475,1034,+
chr6,33203908,0.9513009243409793,584,507,1091,+
chr6,33203909,0.9513009243409793,584,507,1091,+
chr6,33203945,3.3135,845,749,1594,+
chr6,33203946,3.3135,845,749,1594,+
chr6,33204157,0.5578785211267605,584,425,1009,+
chr6,33204303,4.786143326986324,1144,164,1308,+
chr6,33204310,7.658660814967938,1508,161,1669,+
chr6,33204312,10.629614286196272,2481,300,2781,+
chr6,33204313,32.422498483873035,2589,906,3495,+
chr6,33204314,33.475349397471916,4522,1765,6287,+
chr6,33204315,35.29865701345356,3696,1674,5370,+
chr6,33204320,10.797677717111526,3561,5300,8861,+
chr6,33204321,10.797677717111526,3561,5300,8861,+
chr6,33204322,5.713979909555934,1410,1926,3336,+
chr6,33209963,1.1042854480339344,604,446,1050,+
chr6,33210000,1.2449791017267693,714,546,1260,+
chr6,33272074,1.115728033996433,813,704,1517,+
chr6,33272075,0.9200793465152239,1261,1270,2531,+
chr6,33272076,0.8397160116805242,1602,793,2395,+
chr6,33272077,0.898226613988456,4319,3522,7841,+
chr6,33272078,0.9670637093833403,6341,4911,11252,+
chr6,33272080,1.212739890453705,6696,4297,10993,+
chr6,33272081,0.7150343924009172,1183,1135,2318,+
chr6,33272082,1.3177411862585364,3188,2274,5462,+
chr6,33272083,1.231071160881092,7743,4761,12504,+
chr6,33272085,1.2152262843313741,8887,5547,14434,+
chr6,33272087,0.6568025568508427,1969,1525,3494,+
chr6,33272091,1.2363578938460478,18516,13084,31600,+
chr6,33272093,1.246271975126098,21316,13968,35284,+
chr6,33272094,0.7687903932801893,3040,2694,5734,+
chr6,33272095,1.2726209593375777,15517,9215,24732,+
chr6,33272096,1.2987795327767135,10779,6442,17221,+
chr6,33272632,1.2331985072497778,7594,4738,12332,+
chr6,33272634,1.3188738509811644,11563,9425,20988,+
chr6,33272640,0.6589680426700758,6523,5481,12004,+
chr6,33272645,1.1853609299229522,10913,6803,17716,+
chr6,33272655,0.8667172651703037,38421,30231,68652,+
chr6,33272656,0.8667172651703037,38421,30231,68652,+
chr6,33272657,1.0176011443398583,72910,55286,128196,+
chr6,33275789,0.9751698824236286,951,521,1472,+
chr6,33275790,0.9985774481712456,718,348,1066,+
chr6,33275794,0.672243264164732,1273,861,2134,+
chr6,33275798,1.6553581044695749,6292,3713,10005,+
chr6,33275804,1.342362402526314,58326,35715,94041,+
chr6,33275805,1.3449060408313733,62865,36130,98995,+
chr6,33275806,1.2133837136285779,67577,39576,107153,+
chr6,33275807,1.2664588793098077,91251,54668,145919,+
chr6,33275808,1.2535589072920645,99062,60708,159770,+
chr6,33275809,1.2808138062711525,101127,64356,165483,+
chr6,33275810,1.268526373347255,85231,53056,138287,+
chr6,33275812,1.2060306463855923,30319,17723,48042,+
chr6,33275839,1.2253663904549297,20404,16263,36667,+
chr6,33275963,0.7360075003465102,1090,848,1938,+
chr6,33275974,1.392562749912109,73112,54370,127482,+
chr6,33276006,1.1201348399732989,19911,15838,35749,+
chr6,33289596,0.37097012276629987,941,776,1717,+
chr6,33289600,0.45046716825807803,3075,1661,4736,+
chr6,33289603,1.6761533232963721,2706,1666,4372,+
chr6,33289866,1.9304685992252308,1469,935,2404,+
chr6,33289872,1.816249050873197,735,438,1173,+
chr6,33290177,0.5932239051926128,1613,1232,2845,+
chr6,33290222,1.6851454823889738,916,652,1568,+
chr6,33290362,2.3286679536679538,578,443,1021,+
chr6,33290431,2.199203693610786,1134,763,1897,+
chr6,33290873,8.714447991904068,2039,1112,3151,+
chr6,33290874,8.05788016014917,2397,1298,3695,+
chr6,33290875,7.879880786513776,2579,1446,4025,+
chr6,33290876,7.431408448402796,1619,906,2525,+
chr6,33290877,7.60615740941368,1464,1408,2872,+
chr6,33290878,7.276824720469726,2110,2432,4542,+
chr6,33290879,7.167169685696122,1752,2246,3998,+
chr6,33688123,2.8117266324005334,843,617,1460,+
chr6,33688124,2.8117266324005334,843,617,1460,+
chr6,34236872,0.7994353125883898,693,401,1094,+
chr6,34236873,0.9573413646720059,645,390,1035,+
chr6,34236876,0.7871742462953499,584,569,1153,+
chr6,34236878,0.5705567010309279,1152,969,2121,+
chr6,34236879,0.5762992283676384,2930,1856,4786,+
chr6,34236903,1.0135171839351031,2194,1041,3235,+
chr6,34236904,1.5136930436252214,1999,1402,3401,+
chr6,34236905,1.2698610806810484,4193,2443,6636,+
chr6,34237207,1.643333333333333,985,749,1734,+
chr6,34237277,0.49361533452249495,757,578,1335,+
chr6,34240760,1.8452302631578947,862,607,1469,+
chr6,34240764,2.235547940859192,1354,926,2280,+
chr6,34240766,1.5760423448158738,1919,1441,3360,+
chr6,34240768,1.6071630453983394,2982,2294,5276,+
chr6,34240769,1.627080745341615,1553,1126,2679,+
chr6,34240770,1.5228876567324052,2056,1613,3669,+
chr6,34240777,1.5058408979030622,3028,2338,5366,+
chr6,34240829,1.402565871154642,1431,1317,2748,+
chr6,34240884,1.8710765002290424,1673,924,2597,+
chr6,34240885,0.6313827241353251,963,748,1711,+
chr6,34242712,1.5563069544364507,876,694,1570,+
chr6,34244831,1.408453887613135,1383,928,2311,+
chr6,34244833,1.0443378902264844,1088,844,1932,+
chr6,34244834,1.0443378902264844,1088,844,1932,+
chr6,34244837,1.909013914095584,1287,869,2156,+
chr6,34244839,1.8564536326711527,1937,1377,3314,+
chr6,34244840,1.6343449296817172,1007,578,1585,+
chr6,34244849,1.9705312275664033,1338,795,2133,+
chr6,34244855,1.4590499590499588,1017,791,1808,+
chr6,34244983,2.1822742474916392,1043,597,1640,+
chr6,34244984,2.1822742474916392,1043,597,1640,+
chr6,34244986,2.4479450424593145,776,637,1413,+
chr6,34245013,0.5756578947368421,574,436,1010,+
chr6,34245017,1.4634102541079284,561,517,1078,+
chr6,34245040,1.7143146714233592,1725,1450,3175,+
chr6,34245042,1.7143146714233592,1725,1450,3175,+
chr6,34245126,3.22485549132948,796,345,1141,+
chr6,34245127,2.913736275656045,1173,545,1718,+
chr6,34245130,2.2433842182973667,852,434,1286,+
chr6,34245136,1.919849203049203,956,669,1625,+
chr6,34245154,1.956082786471479,999,565,1564,+
chr6,34245159,1.7458064516129033,692,650,1342,+
chr6,34245164,0.5714809720311783,778,726,1504,+
chr6,34245165,1.1505354053426993,3504,2213,5717,+
chr6,34245166,1.4493670575656363,2037,1386,3423,+
chr6,34245168,1.3931009143196305,1642,918,2560,+
chr6,34245172,1.4452654535985157,1775,990,2765,+
chr6,34245173,1.489980732177264,1220,864,2084,+
chr6,34245379,8.24119798811157,1242,485,1727,+
chr6,34245381,8.24119798811157,1242,485,1727,+
chr6,34245409,1.7867841409691634,844,453,1297,+
chr6,34245417,1.6969416785206262,722,379,1101,+
chr6,34245418,1.522879684418146,1102,649,1751,+
chr6,34245420,1.86026936026936,844,467,1311,+
chr6,34245429,0.8680175141729046,3213,2050,5263,+
chr6,34245430,2.3469616005964955,993,618,1611,+
chr6,34245431,0.795992253454945,4243,2855,7098,+
chr6,34245440,1.447393168563587,4065,2716,6781,+
chr6,34245459,1.7497292614251678,1962,1481,3443,+
chr6,34245539,1.4602687786804853,3327,1899,5226,+
chr6,34245547,1.4947115828334103,1445,984,2429,+
chr6,34245716,1.7317259854573288,1085,803,1888,+
chr6,34245784,0.2529616724738676,725,614,1339,+
chr6,34245785,0.3310028207277439,1048,911,1959,+
chr6,34245788,1.7363083164300204,641,492,1133,+
chr6,34245811,0.6848142904730179,888,631,1519,+
chr6,34245814,1.989149607988361,1439,1088,2527,+
chr6,34245816,1.4057987532775802,2765,2216,4981,+
chr6,34245817,1.523018703172393,2360,1999,4359,+
chr6,34245820,0.5070270270270271,1205,887,2092,+
chr6,34245823,0.9928060246800257,3641,2912,6553,+
chr6,34245824,1.0054671420948766,3440,2337,5777,+
chr6,34245825,1.06612450205341,5705,4257,9962,+
chr6,34245826,0.7352980964344383,1855,1309,3164,+
chr6,34245961,1.4212917529894955,1663,1018,2681,+
chr6,34246091,0.5269223842967765,797,616,1413,+
chr6,34246097,1.6159244027171806,2945,1778,4723,+
chr6,34246099,1.6719769119769117,1744,1124,2868,+
chr6,34246153,1.6407773851590108,1307,1131,2438,+
chr6,34744161,0.6480830238792021,1443,1035,2478,+
chr6,34744162,0.6480830238792021,1443,1035,2478,+
chr6,34744163,1.0959826873893368,3315,2549,5864,+
chr6,34744164,1.1002932900094518,5299,4047,9346,+
chr6,34744165,0.8865920320268963,5629,4185,9814,+
chr6,34744166,0.877171610902698,3579,2725,6304,+
chr6,34757516,1.5621728811182065,981,668,1649,+
chr6,34757915,2.060427463333672,1105,756,1861,+
chr6,34757916,2.060427463333672,1105,756,1861,+
chr6,34757921,1.9115103127079174,662,500,1162,+
chr6,34757922,1.8264061885407104,994,525,1519,+
chr6,34757935,1.6350210970464139,1239,710,1949,+
chr6,34762600,1.66509951418273,849,708,1557,+
chr6,34762606,1.5397384538660344,2602,1885,4487,+
chr6,34770310,1.7587337960771618,722,419,1141,+
chr6,34773474,2.4997101586703665,1291,696,1987,+
chr6,34773475,2.1752136752136755,1017,519,1536,+
chr6,34773483,1.7469258658003994,1008,616,1624,+
chr6,34773502,1.62741270873997,803,476,1279,+
chr6,34773525,1.5504849396847016,1396,1117,2513,+
chr6,34773546,1.5962837837837838,899,739,1638,+
chr6,34773627,1.671264367816092,726,554,1280,+
chr6,34773690,1.9778687000185975,708,565,1273,+
chr6,35468403,0.8178313590299421,13125,6630,19755,+
chr6,35468404,0.8661202656495602,16484,8999,25483,+
chr6,35468405,0.8976225140653995,15276,6950,22226,+
chr6,35468407,1.0107515223794292,6991,2708,9699,+
chr6,35468412,1.7287583105107949,4063,1700,5763,+
chr6,35468799,1.2886934409095394,8315,4401,12716,+
chr6,35468969,1.2555976116853598,8991,5705,14696,+
chr6,35468974,1.2944411993769471,3667,2567,6234,+
chr6,35468988,1.5136401326699835,6637,4287,10924,+
chr6,35469378,0.654901057882035,589,418,1007,+
chr6,35469383,1.4313850520740283,8328,6192,14520,+
chr6,35469384,1.3185209833740417,20906,14835,35741,+
chr6,35470183,1.828343181228863,3313,1948,5261,+
chr6,35470214,1.7462329876863252,9075,6171,15246,+
chr6,35470216,1.7462329876863252,9075,6171,15246,+
chr6,35470223,1.281896610094193,13621,9085,22706,+
chr6,35470613,1.311863327081079,6431,4177,10608,+
chr6,35470618,0.8400334775409225,8947,6642,15589,+
chr6,35555974,0.6848242197260417,1262,1035,2297,+
chr6,35556162,1.1351231257704946,1235,819,2054,+
chr6,35556163,1.1194525889764475,1074,666,1740,+
chr6,36075882,3.807500498997098,594,435,1029,+
chr6,36109560,1.2148337595907928,674,390,1064,+
chr6,36109561,1.2148337595907928,674,390,1064,+
chr6,36475027,3.4880956615094814,650,455,1105,+
chr6,36479597,2.264855875831486,658,450,1108,+
chr6,36479599,2.3140094146541137,1004,697,1701,+
chr6,36479600,2.5634095634095635,684,480,1164,+
chr6,36488146,5.057828993298322,1239,938,2177,+
chr6,36489073,1.1988832045624602,634,461,1095,+
chr6,36489627,1.3183912804143505,762,561,1323,+
chr6,36490677,3.114712827907775,868,521,1389,+
chr6,36490678,2.5573383084577115,708,401,1109,+
chr6,36490679,2.5573383084577115,708,401,1109,+
chr6,36594384,2.673436376707405,594,427,1021,+
chr6,36594418,1.2786046783479883,1764,1262,3026,+
chr6,36594423,3.961304614986578,2049,1873,3922,+
chr6,36594424,2.5837602388963696,6146,5379,11525,+
chr6,36594425,2.7052640770038923,8053,6837,14890,+
chr6,36594426,1.8731553404318424,4097,3506,7603,+
chr6,36596770,0.6682875230893103,1659,1305,2964,+
chr6,36596796,0.7495592590851394,3110,1911,5021,+
chr6,36596813,0.7015006956867422,1485,935,2420,+
chr6,36596814,1.4974596666369553,1119,862,1981,+
chr6,36596834,1.1335476213670528,12148,7037,19185,+
chr6,36596848,0.6865095807041021,3368,1701,5069,+
chr6,36596859,1.4678076396339816,4277,2162,6439,+
chr6,36596887,1.0986662526451063,40919,25039,65958,+
chr6,36596888,1.0921005333281237,51960,30113,82073,+
chr6,36596889,1.5433870933378784,17582,9349,26931,+
chr6,36596915,1.3261720377210278,8854,5362,14216,+
chr6,36596922,1.549811051891652,103845,59425,163270,+
chr6,36596923,1.5219879290667464,108047,61373,169420,+
chr6,36598893,0.6830350274373045,1365,1053,2418,+
chr6,36598900,1.6059027777777777,924,665,1589,+
chr6,36601155,1.7146902707351068,2121,1248,3369,+
chr6,36601157,1.6639880808680003,3259,1945,5204,+
chr6,36601158,1.578904030549934,4134,2673,6807,+
chr6,36601161,2.613426827684716,693,452,1145,+
chr6,36601717,0.47094339622641507,727,524,1251,+
chr6,36601755,1.4916768234011162,1430,916,2346,+
chr6,36601968,0.9145216740883043,2330,1809,4139,+
chr6,36601983,1.7213826315622724,1597,1001,2598,+
chr6,36601994,1.7728879374719968,1841,1136,2977,+
chr6,36602096,2.062868790902264,1011,716,1727,+
chr6,36602168,1.375920120747707,2278,1484,3762,+
chr6,36602325,2.1925824175824182,1040,779,1819,+
chr6,36602480,2.3411078717201166,1605,1028,2633,+
chr6,36685797,1.1128798842071346,773,545,1318,+
chr6,37045059,1.9480981158905084,547,484,1031,+
chr6,37045060,2.4560982680647756,796,667,1463,+
chr6,37045065,1.5721912173651809,1699,1017,2716,+
chr6,37045067,1.776517094017094,1170,599,1769,+
chr6,37045070,1.6519280205655529,713,388,1101,+
chr6,37045078,1.707712709065141,1404,931,2335,+
chr6,41787686,0.5707893034817453,1173,779,1952,+
chr6,41787688,0.7037433155080213,1409,934,2343,+
chr6,41787689,1.473338277678347,1838,1270,3108,+
chr6,41787691,1.9790218933470596,1539,1044,2583,+
chr6,41787693,2.0500963391136797,683,345,1028,+
chr6,41787697,1.6685082872928174,1358,723,2081,+
chr6,41787753,1.5445402298850572,1074,869,1943,+
chr6,41789267,1.4441495589727582,1761,1113,2874,+
chr6,41789558,2.427689298821712,949,721,1670,+
chr6,41789567,1.6340972047343238,1235,1082,2317,+
chr6,41789569,1.4198792473475448,981,838,1819,+
chr6,41789665,1.4240958304538125,1685,1446,3131,+
chr6,41932783,4.157643922328207,751,655,1406,+
chr6,42887115,0.5522886228426203,658,423,1081,+
chr6,42888876,0.2345052081097213,1119,768,1887,+
chr6,42889597,0.560897435897436,624,399,1023,+
chr6,42938094,4.489665896143715,630,458,1088,+
chr6,42938120,1.8723994767744048,556,447,1003,+
chr6,43008208,1.895816042297422,989,563,1552,+
chr6,43017944,0.7901234567901234,671,566,1237,+
chr6,43017945,0.7901234567901234,671,566,1237,+
chr6,43018450,0.975459199036435,681,491,1172,+
chr6,43018451,1.822047474346871,1187,810,1997,+
chr6,43018647,1.8446667356429496,593,416,1009,+
chr6,43018877,0.7764857881136951,600,429,1029,+
chr6,43018879,0.69538924597861,998,664,1662,+
chr6,43019336,0.5796239620110243,856,633,1489,+
chr6,43021041,5.145904243249375,781,338,1119,+
chr6,43021042,6.051888854590617,1075,525,1600,+
chr6,43021043,6.051888854590617,1075,525,1600,+
chr6,43021097,1.4707158351409981,677,460,1137,+
chr6,43021098,1.0572003748568255,922,612,1534,+
chr6,43021099,1.0572003748568255,922,612,1534,+
chr6,43021100,0.7795709703287891,706,463,1169,+
chr6,43025268,3.1574365207276642,762,646,1408,+
chr6,43029516,2.6498800959232613,594,416,1010,+
chr6,43029517,2.6498800959232613,594,416,1010,+
chr6,43310344,1.9603917821309125,872,597,1469,+
chr6,43310345,1.9603917821309125,872,597,1469,+
chr6,43310363,0.5895691609977324,779,489,1268,+
chr6,43310371,0.45540475979212364,1416,912,2328,+
chr6,43519764,1.8653055813336867,803,396,1199,+
chr6,43519765,2.2028325746079918,1272,658,1930,+
chr6,43519766,1.0267359539387149,1091,728,1819,+
chr6,43519767,2.228253339930727,882,469,1351,+
chr6,43519770,1.607264353378343,829,578,1407,+
chr6,43770473,2.5580474088399168,590,503,1093,+
chr6,43771252,0.8215195950063471,612,470,1082,+
chr6,43777490,4.090637265523,978,693,1671,+
chr6,43777515,2.0430186279540177,954,744,1698,+
chr6,43781993,1.3449684536738984,659,425,1084,+
chr6,43784545,2.9624893435635125,694,413,1107,+
chr6,43784547,2.9624893435635125,694,413,1107,+
chr6,43784872,1.639433551198257,644,404,1048,+
chr6,43785203,1.7815197248320471,589,460,1049,+
chr6,43785246,3.313421550094518,625,528,1153,+
chr6,43785518,1.852083690089711,632,453,1085,+
chr6,43785779,0.5994043186895011,919,631,1550,+
chr6,43785970,1.9727867241827264,911,671,1582,+
chr6,44003364,6.360208966034837,650,411,1061,+
chr6,44004376,2.453195944943526,999,713,1712,+
chr6,44004377,2.5331905781584583,675,466,1141,+
chr6,44232381,0.6862367122721807,579,495,1074,+
chr6,44247097,0.9901037203302216,1575,972,2547,+
chr6,44247098,0.7323642481011592,3819,1963,5782,+
chr6,44247099,0.7422669702335778,3537,1769,5306,+
chr6,44247100,0.8035412198126782,6795,3265,10060,+
chr6,44247102,0.8892933209140471,11306,5121,16427,+
chr6,44247103,1.3390900308244535,11822,5413,17235,+
chr6,44247104,1.3167953852673018,13567,5971,19538,+
chr6,44247105,1.5234521575984992,11222,5030,16252,+
chr6,44247106,1.4988088130666244,8795,4037,12832,+
chr6,44247110,2.1335012264064326,3535,1772,5307,+
chr6,44247146,1.1843924087591242,4651,3424,8075,+
chr6,44248685,1.4487330634717648,16776,12780,29556,+
chr6,44248686,1.4203923997341785,8722,5925,14647,+
chr6,44248687,1.3711925628462294,39156,28869,68025,+
chr6,44248689,1.4022392559945622,25157,18594,43751,+
chr6,44249385,1.1921976719435794,24130,16705,40835,+
chr6,44249386,1.1693292076911563,24567,17567,42134,+
chr6,44249690,1.3522302712396743,12462,8552,21014,+
chr6,44249702,1.396133087381294,3192,2379,5571,+
chr6,44249740,1.405863101810229,17193,13760,30953,+
chr6,44249741,1.405863101810229,17193,13760,30953,+
chr6,44249753,1.7471449420265324,9113,7840,16953,+
chr6,44249794,1.5959968606475772,16771,14227,30998,+
chr6,44249797,1.5718415554662872,4370,3630,8000,+
chr6,44250061,1.0423317566357928,38383,34535,72918,+
chr6,44250062,1.0423317566357928,38383,34535,72918,+
chr6,44250063,1.5013986650566018,17970,16766,34736,+
chr6,44250125,1.5535688248567956,16535,8229,24764,+
chr6,44250131,0.8152680798052797,18669,10019,28688,+
chr6,44250387,1.2812663629183216,63052,39988,103040,+
chr6,44250484,1.6157480314960633,7091,4924,12015,+
chr6,44250486,1.6157480314960633,7091,4924,12015,+
chr6,44251087,1.2189401581590642,6743,4656,11399,+
chr6,44251091,1.2957780480745569,12396,9279,21675,+
chr6,44251417,1.2276450543808055,9551,5789,15340,+
chr6,44251418,1.351455981574188,20539,12886,33425,+
chr6,44251420,1.372096287444029,15928,10111,26039,+
chr6,44251495,1.4915276926499932,5075,2750,7825,+
chr6,44251512,1.6582534149224255,2518,1501,4019,+
chr6,44251521,1.2843837058479437,7913,4827,12740,+
chr6,44251732,0.8503843095679828,712,527,1239,+
chr6,44251733,0.7104605717994458,1899,1472,3371,+
chr6,44251735,0.8515188742461469,662,483,1145,+
chr6,44251757,1.530729833546735,3187,2271,5458,+
chr6,44251826,1.2804783679212102,3831,2842,6673,+
chr6,44252001,1.4273962729934928,3411,1900,5311,+
chr6,44252026,1.5097769994058359,4522,2658,7180,+
chr6,44252047,0.9554966876362282,16042,9350,25392,+
chr6,44252069,0.8534065759457037,7791,4297,12088,+
chr6,44252083,1.750460292297843,74604,43819,118423,+
chr6,44252084,1.7504602922978432,74604,43819,118423,+
chr6,44252126,1.3478046466023845,48447,30867,79314,+
chr6,44252127,1.3478046466023845,48447,30867,79314,+
chr6,44252136,1.031969356049273,31337,21552,52889,+
chr6,44252140,1.7326464385287916,12839,9008,21847,+
chr6,44252155,1.388320155858747,21118,13871,34989,+
chr6,44253054,1.2812525470858123,10440,6688,17128,+
chr6,44253096,1.564676798972132,4692,3434,8126,+
chr6,44253179,0.8439197831071537,8977,5761,14738,+
chr6,44253262,1.2531855222573545,6323,4729,11052,+
chr6,44253354,1.4486260454002389,3782,3158,6940,+
chr6,44253711,1.2127956062841412,3441,2757,6198,+
chr6,44253746,1.2448560207896795,11417,8272,19689,+
chr6,44253747,1.3330398415144178,3027,2463,5490,+
chr6,44403867,2.9265620052330714,595,467,1062,+
chr6,44422724,1.000355366027008,562,468,1030,+
chr6,44422725,1.000355366027008,562,468,1030,+
chr6,44422754,2.4337986833118355,755,497,1252,+
chr6,44424534,2.7100232181522648,628,502,1130,+
chr6,44429783,0.36105831507477887,645,458,1103,+
chr6,44446634,0.9693877551020409,659,538,1197,+
chr6,44446635,0.9693877551020409,659,538,1197,+
chr6,44446789,2.58975229046488,635,420,1055,+
chr6,44446852,1.2519649010332419,783,521,1304,+
chr6,49472111,1.551218344355775,731,580,1311,+
chr6,52995779,1.0011711560983771,1121,416,1537,+
chr6,52995781,1.0011711560983771,1121,416,1537,+
chr6,52995782,1.5435982145995149,975,768,1743,+
chr6,52995787,1.5975901253918494,1116,927,2043,+
chr6,52995807,1.2902865674913018,1828,1586,3414,+
chr6,52995834,0.8196354807176868,3660,2882,6542,+
chr6,52995835,1.4677009727816774,2374,1298,3672,+
chr6,52995843,1.4709012032413848,2395,1285,3680,+
chr6,52995848,0.8334953508979623,6069,4736,10805,+
chr6,52995856,2.0661497326203206,953,679,1632,+
chr6,52995857,2.0661497326203206,953,679,1632,+
chr6,53071110,6.696891076523571,630,486,1116,+
chr6,53081006,1.1150734668911528,622,417,1039,+
chr6,53082515,0.7123982913005411,1091,770,1861,+
chr6,53082516,0.7123982913005411,1091,770,1861,+
chr6,57004667,0.860538214539796,733,467,1200,+
chr6,57150723,2.2840979404225226,679,418,1097,+
chr6,57150724,2.2840979404225226,679,418,1097,+
chr6,57169476,2.3623348956401298,617,404,1021,+
chr6,57183921,1.7169898333508016,1436,1014,2450,+
chr6,57183958,1.5651006711409394,1165,744,1909,+
chr6,57183969,1.5378376749872527,5099,3138,8237,+
chr6,57183971,1.4908744203679656,3763,2222,5985,+
chr6,57183986,0.7405615467190636,3226,2332,5558,+
chr6,57183996,1.8481945895739,2053,1565,3618,+
chr6,57184013,1.3018325003786158,3683,2200,5883,+
chr6,57184395,1.0320583891687336,1231,963,2194,+
chr6,57184524,2.3347701149425286,649,434,1083,+
chr6,57184604,0.2978524743230625,637,377,1014,+
chr6,57184608,2.4181835833211984,1606,980,2586,+
chr6,57184609,2.486374171442825,1935,1286,3221,+
chr6,57184631,2.332230576441103,726,474,1200,+
chr6,57184632,1.9866028708133967,691,626,1317,+
chr6,63527987,0.2963038560021837,742,502,1244,+
chr6,63528060,4.057834853664152,653,468,1121,+
chr6,63572628,3.0588235294117654,971,458,1429,+
chr6,63572629,3.0588235294117654,971,458,1429,+
chr6,63572652,2.540085078534032,674,381,1055,+
chr6,63572676,1.9024651469984468,1718,1056,2774,+
chr6,63572677,1.9024651469984468,1718,1056,2774,+
chr6,63572681,1.3311976744186047,1230,999,2229,+
chr6,63572686,2.128497895291581,1780,1216,2996,+
chr6,63572698,1.5790917283805497,774,542,1316,+
chr6,63572704,1.943737544074812,817,592,1409,+
chr6,63576558,1.4799741602067185,1184,1031,2215,+
chr6,63576868,1.5311128460499663,1934,1480,3414,+
chr6,63576940,1.5906285632839223,2300,1753,4053,+
chr6,63578934,1.1290219274932278,8833,6345,15178,+
chr6,63580071,1.484963781371186,2254,1729,3983,+
chr6,63580173,1.3779324116976257,6857,4645,11502,+
chr6,63580264,0.5802538703363189,1819,1465,3284,+
chr6,63580526,1.4499624182124609,9039,6498,15537,+
chr6,63580572,1.284533728142751,2864,2330,5194,+
chr6,63580925,2.052498466240483,36259,12918,49177,+
chr6,63580926,2.040332394669913,49145,17775,66920,+
chr6,63580927,2.040332394669913,49145,17775,66920,+
chr6,63580928,1.9716343503598464,50567,18743,69310,+
chr6,63580930,1.9777237234871237,41554,16060,57614,+
chr6,63580931,1.9833201503312237,28668,11203,39871,+
chr6,63580932,2.104412815299225,6537,2934,9471,+
chr6,63580942,41.5139958896147,30859,24520,55379,+
chr6,63580943,41.5139958896147,30859,24520,55379,+
chr6,63580944,30.14760673068418,17394,12700,30094,+
chr6,63581147,1.2089625177779124,6399,4588,10987,+
chr6,63581218,1.162641557995882,8558,5827,14385,+
chr6,63581674,2.160204991087344,830,611,1441,+
chr6,63582206,1.600578034682081,922,691,1613,+
chr6,63582265,1.9399101665205958,786,651,1437,+
chr6,63582268,1.666765140324963,805,676,1481,+
chr6,63582343,2.5256124721603563,566,448,1014,+
chr6,63582482,1.7634277591633671,667,468,1135,+
chr6,63583020,1.7501998401278975,603,416,1019,+
chr6,73292039,0.9110761705101328,559,476,1035,+
chr6,73292040,0.9110761705101328,559,476,1035,+
chr6,73292041,0.9783443403471048,909,765,1674,+
chr6,73292042,1.4606620786864213,716,574,1290,+
chr6,73292043,0.7256854180907517,843,747,1590,+
chr6,73292135,1.3870714754443596,1300,981,2281,+
chr6,73292136,1.0828335832083955,962,666,1628,+
chr6,73292201,1.4545184816139285,1069,637,1706,+
chr6,73292219,0.9577651515151516,777,351,1128,+
chr6,73292220,0.9147631076777494,1862,1022,2884,+
chr6,73292222,0.8526627646506251,1179,658,1837,+
chr6,73292224,1.0230360934182592,837,470,1307,+
chr6,73292227,1.4893165593797046,1243,691,1934,+
chr6,73292233,1.5398015475022226,2018,1327,3345,+
chr6,73292236,1.5608959999999998,1681,1249,2930,+
chr6,73292237,1.5537220465153767,2472,1579,4051,+
chr6,73292240,1.6223787169281632,2665,1464,4129,+
chr6,73292242,1.6716819449980074,1765,771,2536,+
chr6,73292247,1.5648477106702323,1073,610,1683,+
chr6,73292248,1.3624374049699093,2626,1613,4239,+
chr6,73292254,0.7941640378548896,1695,1267,2962,+
chr6,73292257,1.9802591564560184,3313,1818,5131,+
chr6,73292261,1.3723610740683858,3614,2052,5666,+
chr6,73292267,1.6117355325456253,1960,1305,3265,+
chr6,73292270,1.463668188736682,2598,1459,4057,+
chr6,80031478,2.187835616438356,643,364,1007,+
chr6,80031480,1.695010438911282,827,493,1320,+
chr6,82366278,2.0640552238467578,922,694,1616,+
chr6,82366668,0.7529973338146445,862,627,1489,+
chr6,82366669,0.9438520718045621,665,477,1142,+
chr6,83194589,3.462813562029141,1708,1205,2913,+
chr6,83194591,4.29452026881647,1776,1151,2927,+
chr6,89084256,3.1436898851813027,616,497,1113,+
chr6,89084451,1.6971052476507835,585,420,1005,+
chr6,89084523,1.7045643153526968,631,481,1112,+
chr6,89721288,1.6655052264808359,716,510,1226,+
chr6,89721289,0.7383043656258141,1057,775,1832,+
chr6,89721290,1.1158427345571775,4081,3112,7193,+
chr6,89721291,1.3091250600787843,4074,3483,7557,+
chr6,89721292,1.0826207949477626,5965,4948,10913,+
chr6,89721293,1.3815541718555415,1966,1824,3790,+
chr6,89721294,0.7010069068819172,1403,1181,2584,+
chr6,89721296,1.6736774193548385,951,999,1950,+
chr6,89721298,1.6628479008019408,1174,780,1954,+
chr6,89721343,1.7892113065503104,1659,1197,2856,+
chr6,89721345,1.6071882951653944,1115,863,1978,+
chr6,89721346,1.3872013639094207,1518,1177,2695,+
chr6,89721348,0.9158415841584158,1304,908,2212,+
chr6,89721349,0.9158415841584158,1304,908,2212,+
chr6,89721350,1.5470631093224159,1036,778,1814,+
chr6,89721384,0.4988683515048476,2145,1496,3641,+
chr6,89721387,1.529679461812426,858,721,1579,+
chr6,89721441,1.6794721407624635,1078,805,1883,+
chr6,89721448,0.6470588235294118,607,543,1150,+
chr6,89721462,1.6490438695163103,732,634,1366,+
chr6,89721463,0.6598592637330225,1739,1452,3191,+
chr6,89721464,0.6598592637330225,1739,1452,3191,+
chr6,89721507,0.744856098626517,2055,1525,3580,+
chr6,89721529,1.021105358135658,15265,9727,24992,+
chr6,89721530,1.1891760649749792,10315,5720,16035,+
chr6,89721531,0.9809005591864631,18282,11960,30242,+
chr6,89721538,1.3549002181191119,15709,10480,26189,+
chr6,89721544,1.2390742806091133,27558,18170,45728,+
chr6,89721545,1.2971083657824756,22264,13670,35934,+
chr6,89721547,1.3289983189034886,9453,6070,15523,+
chr6,89721564,1.4295091703833045,13084,8514,21598,+
chr6,95606290,2.7094837935174065,670,538,1208,+
chr6,95606292,2.7094837935174065,670,538,1208,+
chr6,96542925,10.839950252792013,1189,949,2138,+
chr6,96542926,10.715246607184204,1077,851,1928,+
chr6,96542927,11.04147852832931,937,762,1699,+
chr6,96542971,2.0022362255629833,856,661,1517,+
chr6,96542972,2.4903842749765985,696,509,1205,+
chr6,110892303,2.943818362611866,572,430,1002,+
chr6,110892305,1.951226126960811,932,713,1645,+
chr6,110893017,0.3603448275862069,683,579,1262,+
chr6,110893628,0.3135287033319952,780,529,1309,+
chr6,110893630,0.30553090811820616,1098,805,1903,+
chr6,110893796,3.125448028673835,871,464,1335,+
chr6,110893797,2.981075977995785,1192,707,1899,+
chr6,110895023,2.874986210162123,682,530,1212,+
chr6,110895519,2.340036821979889,805,613,1418,+
chr6,110895520,2.340036821979889,805,613,1418,+
chr6,113581561,0.6183775321732692,737,529,1266,+
chr6,113581748,0.6743288917201962,718,620,1338,+
chr6,113581749,0.8027168860400256,1066,855,1921,+
chr6,113581752,0.7578674564975935,1067,875,1942,+
chr6,113581754,0.5579416531604539,713,616,1329,+
chr6,113581755,0.7588393421884884,1296,1019,2315,+
chr6,113581761,1.0700488237530812,5617,4551,10168,+
chr6,113581762,1.5047785751794154,3183,2954,6137,+
chr6,113581764,1.2070219420908546,3459,3264,6723,+
chr6,113581765,0.8768468975132243,5600,5204,10804,+
chr6,113581766,0.7302022625985601,3194,2916,6110,+
chr6,113581779,1.3853340891191899,6617,5407,12024,+
chr6,113581782,1.288853262919653,5213,5301,10514,+
chr6,113581783,1.288853262919653,5213,5301,10514,+
chr6,113581786,1.6260443676174012,2821,2924,5745,+
chr6,116571566,2.8865769660865803,622,427,1049,+
chr6,116571567,3.0459142787278113,623,428,1051,+
chr6,116580296,2.1854374482250245,640,396,1036,+
chr6,116580302,2.2844872993900105,830,533,1363,+
chr6,116584757,1.4776839801371358,1335,911,2246,+
chr6,116584758,1.201468189233279,981,612,1593,+
chr6,116584762,1.6725457027484942,1269,849,2118,+
chr6,116588847,2.4638958444326766,1022,726,1748,+
chr6,116588962,1.7318123116659494,744,504,1248,+
chr6,116590325,2.575280898876404,572,444,1016,+
chr6,116590356,1.632163216321632,679,605,1284,+
chr6,116593016,1.0437433318091751,855,728,1583,+
chr6,116593018,1.0437433318091751,855,728,1583,+
chr6,117998934,1.0216189039718453,1015,662,1677,+
chr6,117998935,0.7352628860399851,1740,1305,3045,+
chr6,117998947,2.002392344497608,998,702,1700,+
chr6,117998951,1.6453446255461086,2787,2111,4898,+
chr6,117998954,1.6323942620526468,1317,965,2282,+
chr6,117998961,1.2999441028507548,2651,1788,4439,+
chr6,117998967,1.4350536537353393,5397,4364,9761,+
chr6,117998968,0.7798242828411137,3752,2537,6289,+
chr6,117999055,1.3429226861132229,8073,3773,11846,+
chr6,117999056,1.411655852116315,14820,8489,23309,+
chr6,117999061,1.3911292636235129,4371,2141,6512,+
chr6,117999065,1.4622239224621767,9404,4668,14072,+
chr6,117999066,1.4622239224621767,9404,4668,14072,+
chr6,117999278,2.278867623604466,696,569,1265,+
chr6,117999280,2.4501929437706726,1070,906,1976,+
chr6,117999281,2.4689219371356983,730,632,1362,+
chr6,117999303,1.8222942983953567,1524,706,2230,+
chr6,117999304,1.8222942983953567,1524,706,2230,+
chr6,117999305,0.6726853630426431,617,547,1164,+
chr6,117999307,1.4259297612355395,944,462,1406,+
chr6,117999308,1.6360225140712943,871,532,1403,+
chr6,117999313,1.6096130094689174,801,693,1494,+
chr6,117999326,2.146448087431694,981,914,1895,+
chr6,118905692,2.238920201703701,686,541,1227,+
chr6,125220114,1.6575220564856448,667,529,1196,+
chr6,125229126,3.254095441595441,730,467,1197,+
chr6,125248295,1.9731852135606203,605,453,1058,+
chr6,125248318,1.8252627042177239,1804,1407,3211,+
chr6,125263056,2.384814152256013,856,558,1414,+
chr6,125263057,2.5609941990815495,1486,1055,2541,+
chr6,125915433,2.3885641025641027,990,749,1739,+
chr6,125915435,2.3239002521714767,1507,1161,2668,+
chr6,125915436,2.5979233300885367,1018,798,1816,+
chr6,125915440,0.5728301886792452,758,582,1340,+
chr6,125915441,2.23326359832636,609,477,1086,+
chr6,125915442,2.343368495910869,1162,766,1928,+
chr6,125915444,2.343368495910869,1162,766,1928,+
chr6,125919411,2.1290691104125026,1503,1207,2710,+
chr6,125919412,1.9146515095145504,2301,1850,4151,+
chr6,125919413,1.7135728428690786,1969,1550,3519,+
chr6,125919414,1.6795180722891565,1631,1327,2958,+
chr6,125919415,1.3986724621421978,2017,1743,3760,+
chr6,125919416,0.7041019514137794,611,485,1096,+
chr6,125922775,1.8318548387096771,825,639,1464,+
chr6,125922776,1.8318548387096771,825,639,1464,+
chr6,125922777,1.8318548387096771,825,639,1464,+
chr6,125929148,1.8395604395604397,620,454,1074,+
chr6,125929152,1.783734939759036,657,497,1154,+
chr6,125929290,1.0025583626479055,1044,766,1810,+
chr6,125929292,1.0025583626479055,1044,766,1810,+
chr6,125930675,1.5372220129536758,618,420,1038,+
chr6,125930832,2.9464809646100525,836,449,1285,+
chr6,125998276,4.914818615672141,557,489,1046,+
chr6,126346234,2.9675455814443654,633,430,1063,+
chr6,126348466,1.2204175453281572,1555,905,2460,+
chr6,132814567,0.8283821173729433,1921,1307,3228,+
chr6,132814568,0.8757923119628525,19858,8386,28244,+
chr6,132814569,0.8888340957511709,20233,8293,28526,+
chr6,132814570,0.9269559112253436,20295,7540,27835,+
chr6,132814571,1.6170363786149318,9206,4996,14202,+
chr6,132814572,1.3610938547054723,18852,8329,27181,+
chr6,132814573,1.9228752081673717,7287,4022,11309,+
chr6,132814732,1.8643884527961567,4766,2571,7337,+
chr6,132814733,1.7844684655317569,14968,8031,22999,+
chr6,132814735,1.4190386332862779,7880,5355,13235,+
chr6,132814736,1.4851693191158248,14377,9411,23788,+
chr6,132814738,1.3834215498576297,42343,23837,66180,+
chr6,132814739,1.3801409662155337,29937,15308,45245,+
chr6,132814740,1.3572114896713827,36883,20382,57265,+
chr6,132814755,1.6587160204707192,9025,6634,15659,+
chr6,132814987,1.3229127001853365,20798,13857,34655,+
chr6,132814988,1.3580211892791243,11436,8525,19961,+
chr6,132814997,0.7997286040324959,17054,12744,29798,+
chr6,132814998,1.0734198620497784,52806,37018,89824,+
chr6,132814999,1.2092851888481484,35752,24274,60026,+
chr6,132815183,1.8256875114840447,827,562,1389,+
chr6,132816515,1.8872114784778542,2520,1144,3664,+
chr6,132816529,1.5070162481536191,2808,1353,4161,+
chr6,132816538,1.3441081478350114,26215,17219,43434,+
chr6,132816539,1.274111546517127,10971,5775,16746,+
chr6,132816540,1.3316616366568694,23018,14718,37736,+
chr6,132816961,1.4762616363604468,29215,20218,49433,+
chr6,132816963,1.5846149578381565,19701,12569,32270,+
chr6,132816964,0.6879323122529645,5921,4223,10144,+
chr6,132816966,1.2328586842205875,23828,15526,39354,+
chr6,132816968,1.2473467731521923,36704,24044,60748,+
chr6,132816969,1.2245378924561374,39423,26148,65571,+
chr6,132816971,1.2684132496745086,39282,27714,66996,+
chr6,132816972,1.2611756085414192,17806,13931,31737,+
chr6,132816973,1.2611756085414192,17806,13931,31737,+
chr6,132817476,0.8371818691202927,751,507,1258,+
chr6,132817478,0.38600476557498953,1397,1089,2486,+
chr6,142063258,2.6356580699798906,731,462,1193,+
chr6,142063260,1.3382838834982365,1502,937,2439,+
chr6,142063261,1.1313671741699918,1104,729,1833,+
chr6,142063262,1.4761269792696619,1660,1044,2704,+
chr6,142063276,3.6481339609682184,810,507,1317,+
chr6,142063282,0.3839040687268822,584,492,1076,+
chr6,142147265,2.5362753203803226,1066,471,1537,+
chr6,142147266,2.5362753203803226,1066,471,1537,+
chr6,142147272,1.719588677264876,1198,592,1790,+
chr6,142147279,2.6511068872987487,1008,558,1566,+
chr6,142147280,2.3920828659192215,1883,1045,2928,+
chr6,142169588,2.2421759316707996,1489,990,2479,+
chr6,142169589,2.150538059809553,1258,822,2080,+
chr6,142218576,0.9600662178379856,657,380,1037,+
chr6,146549701,2.0188796745930735,929,521,1450,+
chr6,146554495,0.5415624191785865,2221,1326,3547,+
chr6,146554497,0.5550964187327824,1611,967,2578,+
chr6,146554505,1.6845582163501236,815,518,1333,+
chr6,146554509,1.4124674322900383,1783,1110,2893,+
chr6,146554513,2.047742045357781,1001,718,1719,+
chr6,146554587,3.169499729440091,655,432,1087,+
chr6,147291099,1.0281272297141055,925,540,1465,+
chr6,147386196,3.9701028926422057,817,302,1119,+
chr6,149021428,1.9512531700961309,589,453,1042,+
chr6,149075292,2.217018750883999,944,748,1692,+
chr6,149580683,2.8265361812369254,634,401,1035,+
chr6,149590848,0.716290222621482,854,588,1442,+
chr6,149594220,2.0429391701039648,620,502,1122,+
chr6,149594226,1.2580518257910356,1285,968,2253,+
chr6,149594227,0.7775320940005673,1310,1050,2360,+
chr6,149594229,2.5478170478170483,687,480,1167,+
chr6,149594230,1.575400307962232,1286,940,2226,+
chr6,149594233,0.6480273209878935,1250,896,2146,+
chr6,149749817,3.4686961943681918,1513,1074,2587,+
chr6,149749818,3.9319016127011155,1372,983,2355,+
chr6,149749821,3.9601859996872313,532,476,1008,+
chr6,149749824,5.794218331155727,558,551,1109,+
chr6,149749838,0.4387312186978298,510,598,1108,+
chr6,149749839,0.964984967314243,840,834,1674,+
chr6,149749909,0.46123843288357425,1053,917,1970,+
chr6,149749933,0.20076293910852677,1682,1293,2975,+
chr6,149749935,0.26030844015884713,3213,2092,5305,+
chr6,149749938,2.383222506393862,831,390,1221,+
chr6,149771162,1.8068031979710195,1448,769,2217,+
chr6,149771175,1.7657413676371017,651,421,1072,+
chr6,149773147,0.5455645678340797,1857,1288,3145,+
chr6,149789976,1.267690774064863,1754,1271,3025,+
chr6,149789984,2.513181019332162,714,568,1282,+
chr6,149789990,0.6924204001127079,1116,818,1934,+
chr6,149796453,2.0654205607476634,611,427,1038,+
chr6,149802200,2.209940857302198,992,708,1700,+
chr6,149802204,1.9239274966757642,742,432,1174,+
chr6,149802209,1.9508330338035558,1236,827,2063,+
chr6,149802213,0.42364793213149526,798,459,1257,+
chr6,149802231,1.8752657689581855,587,497,1084,+
chr6,149802263,0.5376907950182601,1043,723,1766,+
chr6,149802303,0.4692760942760942,668,593,1261,+
chr6,149802307,2.404201095092991,1362,1215,2577,+
chr6,149802352,2.8981302385557703,619,516,1135,+
chr6,149802387,2.4803652968036527,678,437,1115,+
chr6,149802430,1.9283422459893047,600,439,1039,+
chr6,149978062,3.384201422256391,567,472,1039,+
chr6,149978063,3.384201422256391,567,472,1039,+
chr6,149978064,0.5063165293619996,716,564,1280,+
chr6,149978067,0.4700058227292939,690,529,1219,+
chr6,149978071,1.405249625817563,840,690,1530,+
chr6,150876135,2.176470588235294,702,509,1211,+
chr6,150877655,1.6681688396573668,897,708,1605,+
chr6,150877660,1.937431906614786,777,513,1290,+
chr6,150877663,0.6507777936349365,949,714,1663,+
chr6,150877667,0.9062966345246507,3400,2603,6003,+
chr6,150877668,0.6666346779997944,2371,1789,4160,+
chr6,150877669,1.487460815047022,948,637,1585,+
chr6,150877779,1.586631720733928,3808,2972,6780,+
chr6,150877782,1.4710764908696208,1679,1336,3015,+
chr6,150877807,1.5093081472074286,4282,3767,8049,+
chr6,150882790,1.8003508771929828,732,474,1206,+
chr6,150882862,4.138336820083682,632,477,1109,+
chr6,150887908,1.7551283137872902,1271,927,2198,+
chr6,150926123,1.1889356665405988,792,510,1302,+
chr6,150926149,0.4278521429448606,803,478,1281,+
chr6,150926162,1.6836275390589215,1789,1153,2942,+
chr6,150926171,0.3715386096668592,876,576,1452,+
chr6,150926210,1.6169287553789577,3804,2498,6302,+
chr6,150926213,1.5469879741131065,7561,5160,12721,+
chr6,150926214,1.59199676033189,9111,5915,15026,+
chr6,150926225,1.4599680557572239,1861,969,2830,+
chr6,150926275,1.5889328591904908,9471,6107,15578,+
chr6,151013806,2.92009463459672,628,465,1093,+
chr6,151015658,1.2168326751930216,665,360,1025,+
chr6,151015659,1.2168326751930216,665,360,1025,+
chr6,151015667,1.782281284606866,618,429,1047,+
chr6,151034508,1.660964793193954,991,761,1752,+
chr6,151034531,3.3479107648725215,1718,1411,3129,+
chr6,151034535,1.6115348837209305,1845,1624,3469,+
chr6,151325655,1.323671497584541,410,620,1030,+
chr6,151325657,1.8006731793757282,827,1109,1936,+
chr6,151325673,0.34772871039989056,472,602,1074,+
chr6,151325675,0.4005900116959068,1628,1753,3381,+
chr6,151325677,0.40988647757340746,810,964,1774,+
chr6,151325754,1.7723676202069385,623,476,1099,+
chr6,151325817,1.8928138528138527,642,461,1103,+
chr6,151325824,1.951694030558983,1370,1027,2397,+
chr6,151325825,1.6679489593954917,2540,1848,4388,+
chr6,151325829,2.4965986394557818,733,587,1320,+
chr6,151325837,1.7056944018908389,865,736,1601,+
chr6,151349036,1.552874743326489,1209,973,2182,+
chr6,151349059,1.8384410801963995,1230,1039,2269,+
chr6,151349073,1.5301973586585549,1288,1171,2459,+
chr6,151349202,1.4957264957264955,1812,1442,3254,+
chr6,151349209,1.1008501279360206,3241,2579,5820,+
chr6,151349210,0.8244577470263547,1514,1353,2867,+
chr6,151349211,1.479996492151188,1360,904,2264,+
chr6,151349233,1.7878844292203433,1548,1032,2580,+
chr6,151349324,1.7136363636363636,1507,959,2466,+
chr6,151349475,1.5956584111524892,1967,1331,3298,+
chr6,151349506,1.845601851851852,937,539,1476,+
chr6,151349508,0.5090474564697849,1135,807,1942,+
chr6,151349514,1.6333992094861662,797,505,1302,+
chr6,151349517,1.3657520325203252,1660,1352,3012,+
chr6,151349572,1.9751916095199675,1398,803,2201,+
chr6,151349593,1.3376777567300766,2864,2025,4889,+
chr6,151349607,0.9741953630011736,7795,5586,13381,+
chr6,151349608,1.0646871682541699,12105,8630,20735,+
chr6,151349610,1.074002379914483,10503,7255,17758,+
chr6,151349613,1.2863369957657005,7213,4987,12200,+
chr6,151349614,1.3934104157943894,2703,1526,4229,+
chr6,151349625,1.5593969418497649,12622,9382,22004,+
chr6,151349626,1.5593969418497649,12622,9382,22004,+
chr6,151349669,2.077043577646556,1637,1141,2778,+
chr6,151349697,1.6397637795275593,587,507,1094,+
chr6,151349724,1.5045095413046952,5254,4194,9448,+
chr6,151349725,1.562594843461446,6411,4957,11368,+
chr6,151349726,1.5045095413046952,5254,4194,9448,+
chr6,151349736,1.3979956012638275,3692,2883,6575,+
chr6,151349746,1.7613265306122452,841,699,1540,+
chr6,151349830,2.0275111476811234,2701,1895,4596,+
chr6,151349890,1.5336093936127968,1501,1155,2656,+
chr6,151349966,1.0977722332006068,4597,3279,7876,+
chr6,151350069,1.7607458912768648,618,451,1069,+
chr6,151350129,1.5799320056265482,2344,1785,4129,+
chr6,151350191,1.5672709923664125,1094,785,1879,+
chr6,151350192,1.6922077386354262,1344,1053,2397,+
chr6,151350193,0.8080941966554002,1828,1145,2973,+
chr6,151350195,0.8080941966554002,1828,1145,2973,+
chr6,151350200,1.5658307210031346,998,637,1635,+
chr6,151350230,0.9575396901728438,3885,2587,6472,+
chr6,151350231,0.9324611852370255,4134,2755,6889,+
chr6,151350233,1.6648648648648652,857,584,1441,+
chr6,151350330,1.4303785329450944,1802,1381,3183,+
chr6,151350390,2.9368181818181816,922,659,1581,+
chr6,151350425,0.7265291873425929,1820,1347,3167,+
chr6,151350455,1.803202614379085,1173,764,1937,+
chr6,151350456,1.5985604661897068,1704,1237,2941,+
chr6,151350502,2.0583403780122524,2215,1680,3895,+
chr6,151350546,1.5529536639026265,2095,1752,3847,+
chr6,151350588,0.6835212201591512,1301,927,2228,+
chr6,151350624,2.4259634888438133,827,492,1319,+
chr6,151350673,3.007511637748624,916,555,1471,+
chr6,151350675,1.541908013693406,2705,2082,4787,+
chr6,151350676,1.9420817824239065,1935,1241,3176,+
chr6,151350677,1.7015151830376318,4640,3323,7963,+
chr6,151350699,0.6176470588235294,1917,1369,3286,+
chr6,151350757,1.3907388502819245,3636,2553,6189,+
chr6,151350955,1.9096050038557104,1310,1060,2370,+
chr6,151351034,1.771924908938078,1427,1161,2588,+
chr6,151351062,1.6350474588489732,1600,1188,2788,+
chr6,151351110,0.5080210472279261,608,486,1094,+
chr6,151351111,1.4052665846777108,1553,1201,2754,+
chr6,151351262,1.698148148148148,916,557,1473,+
chr6,151351390,1.5346283056249463,962,610,1572,+
chr6,151351482,2.108873579461815,1234,998,2232,+
chr6,151351486,1.6407118061083246,2099,1624,3723,+
chr6,151351531,0.6498702772823091,1172,880,2052,+
chr6,151351729,5.740967851774656,4737,3642,8379,+
chr6,151351802,0.5792151162790699,796,607,1403,+
chr6,151351967,0.6752158996805868,1501,1069,2570,+
chr6,151351968,1.2549372177892657,2727,1604,4331,+
chr6,151352017,0.6985344473359815,1784,1042,2826,+
chr6,151352028,1.3415593428483947,10950,6306,17256,+
chr6,151352029,1.293342432899773,8869,5132,14001,+
chr6,151352031,1.3983075889858965,5147,2977,8124,+
chr6,151352032,1.4744436388414834,10130,5922,16052,+
chr6,151352033,1.5314834882792452,2651,1575,4226,+
chr6,151352065,1.5491008667034292,28846,19086,47932,+
chr6,151352066,1.5956120689651787,53363,35338,88701,+
chr6,151352067,1.3365338740458017,8321,4863,13184,+
chr6,151352068,1.6981866655180458,30992,21323,52315,+
chr6,151352228,1.4811351505520924,2667,1943,4610,+
chr6,151352492,1.5568120945181836,1508,950,2458,+
chr6,151352561,1.6329059721417596,1705,1368,3073,+
chr6,151352604,2.1609683584625192,635,553,1188,+
chr6,151352618,1.4967878120411158,1387,907,2294,+
chr6,151352799,1.5671547054840895,4114,3375,7489,+
chr6,151352800,1.6596737839744509,5003,4026,9029,+
chr6,151352834,1.9570852534562209,1358,867,2225,+
chr6,151352851,1.5908690141621202,1990,1577,3567,+
chr6,151352867,1.7036455929856942,1464,984,2448,+
chr6,151352984,1.5941469489414697,1254,802,2056,+
chr6,151352998,1.327997735269139,2026,1564,3590,+
chr6,151353084,0.6906009439793224,2621,1923,4544,+
chr6,151353214,1.6775967013548008,1423,925,2348,+
chr6,151353404,1.4877979568671964,1390,880,2270,+
chr6,151353580,1.2925856395970852,2520,2358,4878,+
chr6,151353693,1.5009337068160598,1285,1070,2355,+
chr6,151355857,1.0217290190520383,6208,4524,10732,+
chr6,151356463,2.1984002469072297,2513,1976,4489,+
chr6,151356511,1.4528581809682894,4501,3347,7848,+
chr6,151356791,2.0469552457813647,929,657,1586,+
chr6,151357355,2.429650949927312,767,499,1266,+
chr6,151357440,0.6120466550856171,1078,841,1919,+
chr6,151357534,1.8943965517241383,878,637,1515,+
chr6,151357765,1.6346308062426744,802,558,1360,+
chr6,151358313,2.00812887969258,646,397,1043,+
chr6,151468984,0.7162860172308084,664,463,1127,+
chr6,151469083,2.3825072886297374,680,342,1022,+
chr6,151469085,2.3886662468980333,901,486,1387,+
chr6,151763873,2.805380973669763,690,440,1130,+
chr6,151764309,1.5659370522259004,772,546,1318,+
chr6,151764310,0.8806461382980294,2147,1526,3673,+
chr6,151764312,0.980529937051676,1575,1187,2762,+
chr6,151764314,0.6297244211654068,919,633,1552,+
chr6,151764320,2.0072992700729926,959,821,1780,+
chr6,154576284,0.9210636691552719,1219,1702,2921,+
chr6,154576285,0.8932041292836346,3925,3162,7087,+
chr6,154576287,0.8334018246075449,3379,2046,5425,+
chr6,157901910,3.7297281310277386,681,502,1183,+
chr6,157936008,0.24321653487381031,763,530,1293,+
chr6,157943981,2.844259567387687,813,600,1413,+
chr6,157943983,2.662245009227832,808,599,1407,+
chr6,159748331,2.2265658252449327,683,445,1128,+
chr6,159748336,1.4409363865773475,1026,670,1696,+
chr6,159748338,1.1646586345381524,724,497,1221,+
chr6,159748340,2.510869565217391,692,413,1105,+
chr6,159748342,2.510869565217391,692,413,1105,+
chr6,159755825,0.4103322072072072,582,443,1025,+
chr6,159755826,0.4103322072072072,582,443,1025,+
chr6,159762943,2.224586384133475,718,440,1158,+
chr6,159767170,1.291651677496408,973,650,1623,+
chr6,159768512,0.41285849237119565,908,604,1512,+
chr6,159768517,2.6785716109849975,964,636,1600,+
chr6,159768543,1.007454739084132,1418,938,2356,+
chr6,159768544,1.007454739084132,1418,938,2356,+
chr6,159768553,2.6666666666666665,671,503,1174,+
chr6,159768593,1.8473060120657372,1183,758,1941,+
chr6,159775170,1.802320796642252,729,418,1147,+
chr6,159775206,2.4521260324258183,667,466,1133,+
chr6,159777304,1.8078897948376793,1073,730,1803,+
chr6,159777336,2.3048780487804885,566,491,1057,+
chr6,159777337,1.8679245283018868,560,476,1036,+
chr6,159777424,0.5786860198624904,605,461,1066,+
chr6,159778800,3.2549773415216974,3382,3087,6469,+
chr6,159778801,3.254977341521698,3382,3087,6469,+
chr6,159778895,0.5597722960151803,589,441,1030,+
chr6,159778910,2.441025641025641,594,454,1048,+
chr6,159778978,0.6197052947052947,1837,1455,3292,+
chr6,159778979,0.6197052947052947,1837,1455,3292,+
chr6,159778993,2.103734439834025,1169,1204,2373,+
chr6,159790505,2.8453961927980433,877,771,1648,+
chr6,159790508,0.5273568029162589,743,558,1301,+
chr6,159790510,0.5273568029162589,743,558,1301,+
chr6,159797379,0.42791080053437464,693,525,1218,+
chr6,159797380,2.060496613995485,651,442,1093,+
chr6,159797425,1.847924187725632,818,553,1371,+
chr6,159798052,2.0296102284363577,1672,1356,3028,+
chr6,159798053,2.06163622695455,1505,1255,2760,+
chr6,159798337,1.841010867908876,1426,1069,2495,+
chr6,160272631,2.403271983640082,903,488,1391,+
chr6,160272671,0.5792233009708738,627,514,1141,+
chr6,160275935,4.633301857097892,735,352,1087,+
chr6,160276069,0.5760869565217391,741,482,1223,+
chr6,160276373,4.912130191253699,602,435,1037,+
chr6,160276619,0.5976419878907031,704,589,1293,+
chr6,160442807,2.5466658276575203,732,442,1174,+
chr6,163561989,3.7223891810668674,733,483,1216,+
chr6,163561991,3.7223891810668674,733,483,1216,+
chr6,163563594,1.131683335199069,716,510,1226,+
chr6,163563629,0.8317744606762135,882,601,1483,+
chr6,163563699,2.788477366255144,725,485,1210,+
chr6,163570961,2.3850164898390167,595,421,1016,+
chr6,163571025,2.323128664840001,940,725,1665,+
chr6,163572474,2.408735228160363,870,615,1485,+
chr6,163572865,0.26811010019578485,581,456,1037,+
chr6,163572965,1.9528023598820055,661,451,1112,+
chr6,163573162,2.423645320197044,614,434,1048,+
chr7,874405,1.6445940890385335,627,395,1022,+
chr7,874503,0.4831741081595026,681,489,1170,+
chr7,1539188,1.933854008646655,909,721,1630,+
chr7,1539212,1.4112185662091772,1142,951,2093,+
chr7,1540058,1.7924174174174174,572,443,1015,+
chr7,1540081,1.912126325940212,546,487,1033,+
chr7,1540428,5.983622169827075,574,598,1172,+
chr7,1540429,5.767357219090002,705,618,1323,+
chr7,1540440,0.4099749330106319,526,502,1028,+
chr7,1540442,0.4099749330106319,526,502,1028,+
chr7,1540644,0.9463812492184203,624,560,1184,+
chr7,1540733,2.088823067522542,935,682,1617,+
chr7,1540767,2.44689333986761,1445,999,2444,+
chr7,1541093,3.097429469972104,1188,923,2111,+
chr7,1541369,5.649038461538463,949,415,1364,+
chr7,1541370,4.466284430438843,1761,687,2448,+
chr7,1541371,4.8598853577814545,1946,762,2708,+
chr7,1541397,8.482941801632723,2321,986,3307,+
chr7,1541398,5.9468775107628495,2621,1165,3786,+
chr7,1541399,6.523946261301041,3670,1576,5246,+
chr7,1541400,6.284287922791386,2338,1083,3421,+
chr7,1541411,5.805812691681571,2299,1524,3823,+
chr7,1541412,5.363304099498548,3091,1925,5016,+
chr7,1541413,5.363304099498548,3091,1925,5016,+
chr7,1541471,4.579486341788807,1679,642,2321,+
chr7,1541474,3.861095954187952,795,387,1182,+
chr7,1541480,15.454253035138697,1036,521,1557,+
chr7,1541589,60.88385269121813,795,352,1147,+
chr7,1541590,18.870268528398427,2991,1313,4304,+
chr7,1541591,18.230771191842585,3070,1532,4602,+
chr7,1541592,17.464905423032768,2802,1472,4274,+
chr7,1541694,2.733882383219663,606,408,1014,+
chr7,1541695,2.733882383219663,606,408,1014,+
chr7,1541981,1.1154232055849733,665,506,1171,+
chr7,1542047,1.5080548168756607,877,613,1490,+
chr7,1542064,0.6502590673575129,752,578,1330,+
chr7,1542073,2.4407252440725244,559,477,1036,+
chr7,1542119,0.6122943595769682,793,591,1384,+
chr7,1542171,1.7836317135549873,633,390,1023,+
chr7,1542186,1.9532854209445587,760,486,1246,+
chr7,1542437,1.1875525620507281,672,497,1169,+
chr7,1542508,1.96317594834544,670,471,1141,+
chr7,1542605,3.178751387800329,1488,1080,2568,+
chr7,1542620,1.3318412908930153,1251,927,2178,+
chr7,1542684,1.932074652777778,1534,1151,2685,+
chr7,1542685,1.932074652777778,1534,1151,2685,+
chr7,1542794,0.437061521856449,588,435,1023,+
chr7,1542821,2.4092008513931886,1276,645,1921,+
chr7,1542822,2.4092008513931886,1276,645,1921,+
chr7,1542829,1.9166666666666667,855,641,1496,+
chr7,1542833,2.227122109055521,2565,1887,4452,+
chr7,1542834,2.0222416890617807,1815,1432,3247,+
chr7,1542838,1.9963031423290205,827,540,1367,+
chr7,1542840,2.0695464482486647,1700,1483,3183,+
chr7,1542841,1.5920956804609234,973,678,1651,+
chr7,1542848,1.421237375810822,1412,1281,2693,+
chr7,2355311,3.6350617373500884,641,375,1016,+
chr7,2355395,3.5154166666666664,648,399,1047,+
chr7,2360731,2.7269273266711105,868,649,1517,+
chr7,2360742,1.7769230769230768,637,376,1013,+
chr7,2360811,1.995187870797627,1061,819,1880,+
chr7,2360812,1.995187870797627,1061,819,1880,+
chr7,2360814,2.0812007342619587,837,440,1277,+
chr7,2362646,2.104715750232992,1312,724,2036,+
chr7,2362647,1.8822432587492828,1192,829,2021,+
chr7,2362648,1.9938907797403678,2504,1553,4057,+
chr7,2362693,1.856890012642225,1495,790,2285,+
chr7,2362694,2.04342676211603,2082,1216,3298,+
chr7,2362720,1.7881944444444446,617,431,1048,+
chr7,2363103,1.8423427578279798,1581,1254,2835,+
chr7,2363660,1.540138888888889,852,674,1526,+
chr7,2363731,0.4854043640323323,1219,757,1976,+
chr7,2366555,1.9598482672396402,1137,914,2051,+
chr7,2366556,2.158830275229358,752,435,1187,+
chr7,2366562,2.516997907949791,769,477,1246,+
chr7,2371794,2.1483235531590963,1285,960,2245,+
chr7,2371813,0.5117475160724723,795,589,1384,+
chr7,2372674,1.3008076693602246,1215,831,2046,+
chr7,2372767,1.5866534445546288,679,552,1231,+
chr7,2374576,0.47952025345100696,651,490,1141,+
chr7,2375470,1.3284738383589376,1124,777,1901,+
chr7,2376962,2.709795321637426,673,341,1014,+
chr7,2376963,2.709795321637426,673,341,1014,+
chr7,2376998,2.4951597650216466,840,607,1447,+
chr7,2378694,2.4817136886102404,874,608,1482,+
chr7,2378695,2.149482351962407,1377,1044,2421,+
chr7,2379467,0.5287975349051031,1796,1150,2946,+
chr7,2379468,0.511166253101737,1235,805,2040,+
chr7,2380325,3.261324517707901,750,562,1312,+
chr7,2380435,1.1005763163850442,1064,751,1815,+
chr7,2380566,1.823576798480301,1171,776,1947,+
chr7,2380584,0.42978924934880414,659,411,1070,+
chr7,5199591,1.7692806512125157,687,429,1116,+
chr7,5199594,1.7422668133547232,1230,776,2006,+
chr7,5217105,2.128041180702626,609,493,1102,+
chr7,5222616,0.3034043907095132,595,448,1043,+
chr7,5222618,0.3034043907095132,595,448,1043,+
chr7,5592982,2.1264916467780437,647,418,1065,+
chr7,5592997,1.6369797793087995,834,540,1374,+
chr7,5592999,1.5544711668796716,853,905,1758,+
chr7,5593000,1.580364656381487,938,619,1557,+
chr7,5593001,1.5544711668796716,853,905,1758,+
chr7,5593266,2.7073999918878005,673,385,1058,+
chr7,5593338,2.3472037037037037,1062,618,1680,+
chr7,5593339,2.1533333333333333,835,439,1274,+
chr7,5603257,2.825295508274232,628,469,1097,+
chr7,5603258,2.39829706717124,974,754,1728,+
chr7,5603260,2.5530445699937228,663,530,1193,+
chr7,5603271,1.2835384744384124,1135,936,2071,+
chr7,5605343,0.8286334056399132,572,460,1032,+
chr7,5605345,0.8286334056399132,572,460,1032,+
chr7,5605988,8.517125983654072,2980,2025,5005,+
chr7,5605989,5.385287955527345,4900,3429,8329,+
chr7,5605991,4.630237396074841,2971,2160,5131,+
chr7,5606146,12.768821730594986,1661,239,1900,+
chr7,5606148,6.529247984779587,2285,263,2548,+
chr7,5606149,8.052149272055754,3250,453,3703,+
chr7,5606150,6.078338839075035,1287,162,1449,+
chr7,5606151,10.01306632143128,3147,480,3627,+
chr7,5606152,8.50806014518615,1666,315,1981,+
chr7,5606153,8.991906474820144,1110,277,1387,+
chr7,5606154,8.054089034759846,2425,400,2825,+
chr7,5606155,7.4092741532462565,3799,622,4421,+
chr7,5606156,7.966842682834873,2825,374,3199,+
chr7,5606157,7.028943000483087,2763,457,3220,+
chr7,5606160,29.35830367418076,2354,1006,3360,+
chr7,5606161,28.891155128502614,4374,4040,8414,+
chr7,5606162,17.0300368449038,5624,6582,12206,+
chr7,5606163,16.706858405692383,4848,6462,11310,+
chr7,5606164,15.211862305335208,3651,6022,9673,+
chr7,5606171,0.25840743864425697,596,1352,1948,+
chr7,5606181,0.4168010752688172,442,619,1061,+
chr7,5606182,0.22807415815361332,273,880,1153,+
chr7,5606185,0.24613259668508286,296,904,1200,+
chr7,5606186,0.2914044865264377,520,1220,1740,+
chr7,5606188,0.39062751728714507,849,2179,3028,+
chr7,5606211,0.26582672958774817,852,1020,1872,+
chr7,5606417,2.9383336795830157,728,572,1300,+
chr7,5606510,0.7597760591575082,731,382,1113,+
chr7,5606561,1.981608784929917,715,486,1201,+
chr7,6015148,3.2515611061552185,728,530,1258,+
chr7,6015152,1.8473784139039,972,667,1639,+
chr7,6015153,2.4750799492856532,1769,1189,2958,+
chr7,6015155,3.2550669216061183,797,522,1319,+
chr7,6015319,2.628,583,499,1082,+
chr7,6017904,3.836466028016945,641,430,1071,+
chr7,6017955,1.1621763602251407,533,532,1065,+
chr7,6017956,0.7029602655303546,1397,1219,2616,+
chr7,6017958,0.5436120401337793,601,574,1175,+
chr7,6023320,2.135279259051361,950,508,1458,+
chr7,6023476,1.0341017336635552,1356,1085,2441,+
chr7,6023477,1.0341017336635552,1356,1085,2441,+
chr7,6023541,0.4740550928891736,739,445,1184,+
chr7,6023543,1.8259181605987853,1379,971,2350,+
chr7,6023545,0.5754123795525069,828,470,1298,+
chr7,6023587,2.4138886770288033,892,573,1465,+
chr7,6146154,0.7115573309701848,744,450,1194,+
chr7,6146168,0.9052871814378092,594,477,1071,+
chr7,6146169,0.9052871814378092,594,477,1071,+
chr7,6401921,2.3706299436953384,647,459,1106,+
chr7,6401925,2.1808437067773165,741,481,1222,+
chr7,6401926,1.6506339416424471,1040,722,1762,+
chr7,6403153,4.067815232888234,1253,972,2225,+
chr7,6403366,1.9348628691983123,666,473,1139,+
chr7,6585187,2.6579797543234593,1249,1041,2290,+
chr7,6585188,2.7055895865237365,763,652,1415,+
chr7,6585189,2.7055895865237365,763,652,1415,+
chr7,6588826,0.3164882298650467,586,433,1019,+
chr7,6588866,1.2947716546923156,602,444,1046,+
chr7,10451481,1.3168318083008947,680,523,1203,+
chr7,10451482,1.2003138852984823,1217,893,2110,+
chr7,10451483,1.2124616564223134,1541,1218,2759,+
chr7,10451485,1.0818387264348346,2546,1921,4467,+
chr7,10451486,1.0586824295382506,1701,1296,2997,+
chr7,10451489,0.915962090036164,1498,1214,2712,+
chr7,10451490,1.2064531945901746,1839,1620,3459,+
chr7,10451491,1.04308918476379,6569,5379,11948,+
chr7,10451493,0.9972957591242624,7821,6063,13884,+
chr7,10451494,0.9624739677403711,4622,3405,8027,+
chr7,10451495,1.3731552400523073,2168,1817,3985,+
chr7,10453408,2.098371607515657,697,478,1175,+
chr7,10453409,2.098371607515657,697,478,1175,+
chr7,10453436,1.8704473685168959,1934,1319,3253,+
chr7,10453438,1.22531442679317,2330,1622,3952,+
chr7,10453439,1.0451583325146545,1615,1130,2745,+
chr7,11040678,7.807667054914225,611,442,1053,+
chr7,12235440,2.547950287516231,807,598,1405,+
chr7,12235441,2.547950287516231,807,598,1405,+
chr7,16646238,2.2565718633354517,848,531,1379,+
chr7,16665444,2.3769391062746013,1043,616,1659,+
chr7,16665445,2.3769391062746013,1043,616,1659,+
chr7,16681338,2.1704175513092707,901,470,1371,+
chr7,16685946,1.8344774980930587,649,569,1218,+
chr7,16689876,1.4618411420204978,1064,682,1746,+
chr7,16694848,1.5550562860656514,842,681,1523,+
chr7,16694875,1.5471226021684743,1059,653,1712,+
chr7,16694944,1.9985294117647057,603,509,1112,+
chr7,16696933,1.7527882843565123,582,490,1072,+
chr7,16696934,0.593252503953611,661,541,1202,+
chr7,16697023,1.842746400885936,935,601,1536,+
chr7,16698096,1.6568536763019677,1164,831,1995,+
chr7,16698146,0.6587888531618434,1293,932,2225,+
chr7,16706254,0.5948685460880583,625,450,1075,+
chr7,17344908,0.29515994511718374,803,454,1257,+
chr7,20381778,0.8020833086588333,668,465,1133,+
chr7,20410226,2.4777777777777783,891,719,1610,+
chr7,20827406,1.0962924893285937,661,542,1203,+
chr7,20827407,0.9095226922662877,809,722,1531,+
chr7,20827408,1.7158429424270032,622,504,1126,+
chr7,20827412,0.7533654780008631,2626,1980,4606,+
chr7,20827413,1.0887337986041874,1169,849,2018,+
chr7,22727586,0.4226266496381439,626,521,1147,+
chr7,22727587,1.2246140792885112,1274,1080,2354,+
chr7,22727617,1.6428966279712551,742,602,1344,+
chr7,22728698,1.8240115718418517,581,487,1068,+
chr7,22728739,1.5931818181818187,700,615,1315,+
chr7,22728761,1.5176063423075379,876,752,1628,+
chr7,22731568,2.3148,642,499,1141,+
chr7,22731571,1.6494082840236686,668,506,1174,+
chr7,22731674,1.6395563770794825,886,540,1426,+
chr7,22731815,4.274739583333333,1004,767,1771,+
chr7,23185117,2.845291479820628,563,445,1008,+
chr7,23185119,2.845291479820628,563,445,1008,+
chr7,23185131,2.87085881074225,840,565,1405,+
chr7,23299569,14.75805646182693,1598,1091,2689,+
chr7,23299570,14.758056461826932,1598,1091,2689,+
chr7,23299571,9.036317567567568,822,591,1413,+
chr7,23299584,3.6892479106817158,1402,1294,2696,+
chr7,23299585,3.8281355164081847,1255,1138,2393,+
chr7,23299591,0.5315935725504409,549,533,1082,+
chr7,23299592,0.5315935725504409,549,533,1082,+
chr7,23300841,1.3618651268287492,538,479,1017,+
chr7,23300899,1.1560437642177628,1082,831,1913,+
chr7,23300955,2.9403726708074536,788,574,1362,+
chr7,23300982,2.4153354632587862,791,625,1416,+
chr7,23307867,2.4977675211960064,921,642,1563,+
chr7,23307868,1.7102490553386809,1416,1027,2443,+
chr7,23307869,3.4683253588516747,696,474,1170,+
chr7,23309383,1.7675756891298187,1165,883,2048,+
chr7,26201755,1.5951234479119512,1060,692,1752,+
chr7,26201780,1.1627988900261965,1209,883,2092,+
chr7,26201790,1.7253857253857254,1071,545,1616,+
chr7,26202970,1.7086830277236384,1370,810,2180,+
chr7,26202974,1.3890985114006695,2484,1528,4012,+
chr7,26202982,1.5255057760938069,4618,2923,7541,+
chr7,26202983,0.5254353021509047,1538,956,2494,+
chr7,26202993,1.6204715571847303,4184,2669,6853,+
chr7,26202996,1.3475565111762366,5986,4034,10020,+
chr7,26206386,0.7926117117161622,10509,6423,16932,+
chr7,26206404,1.7647982056540819,11125,8356,19481,+
chr7,26206405,1.3174592818427147,22110,14442,36552,+
chr7,26208401,1.5620917781416108,3577,2542,6119,+
chr7,26208402,1.7100861758085975,1909,1362,3271,+
chr7,26208425,1.8575459349995058,2368,1527,3895,+
chr7,26208434,1.7490107405313735,2685,1768,4453,+
chr7,26208439,1.4732449680903292,3000,2036,5036,+
chr7,26211720,1.8484848484848486,731,395,1126,+
chr7,26211735,1.7376760563380282,986,567,1553,+
chr7,26211737,1.6287693830419003,725,432,1157,+
chr7,26212083,0.9473588365869218,4953,3433,8386,+
chr7,26212084,1.3649266462472192,3381,2197,5578,+
chr7,26212090,1.445117796158937,3132,2304,5436,+
chr7,26212248,1.554952762015431,2179,1197,3376,+
chr7,26212249,1.6757712772299238,3072,1637,4709,+
chr7,26212251,1.6444268693502775,5071,2581,7652,+
chr7,26212252,1.8382499060660464,2717,1408,4125,+
chr7,26212253,1.72554850654072,4179,2170,6349,+
chr7,26212263,1.830640482029143,2697,1736,4433,+
chr7,26212264,1.8835026112588515,2260,1356,3616,+
chr7,26212269,1.6272040804898178,3687,2371,6058,+
chr7,26212270,1.6649222098557859,2603,1744,4347,+
chr7,26212274,2.007703435804701,1290,789,2079,+
chr7,26212291,1.7698961937716264,1022,832,1854,+
chr7,26212295,1.6225817712647552,3194,2480,5674,+
chr7,26212609,3.6024449277862756,2180,1690,3870,+
chr7,26212610,4.317615935262993,894,713,1607,+
chr7,26212662,0.3975993998499625,1165,945,2110,+
chr7,26212945,2.0892408730925247,1247,1001,2248,+
chr7,27099257,3.634444956942683,598,483,1081,+
chr7,27099842,3.4673934413337526,823,277,1100,+
chr7,27099843,3.987052103240151,1101,356,1457,+
chr7,27099844,3.987052103240151,1101,356,1457,+
chr7,27099856,21.14277944472422,1119,638,1757,+
chr7,27099857,18.928396223645017,1384,849,2233,+
chr7,27099870,8.607007831495629,1102,1195,2297,+
chr7,27099871,8.388278422205715,1334,1403,2737,+
chr7,27099915,1.2246994212876134,511,619,1130,+
chr7,27740157,1.8004698977937894,626,442,1068,+
chr7,27740180,2.417293656398614,753,595,1348,+
chr7,27748579,0.43271852445870096,851,644,1495,+
chr7,27748581,1.0619132519989722,1106,849,1955,+
chr7,27748640,2.188035043804756,1065,1174,2239,+
chr7,27748641,2.188035043804756,1065,1174,2239,+
chr7,27748642,2.0274923179850295,2023,2023,4046,+
chr7,27748644,1.9069061020280536,735,860,1595,+
chr7,27769676,2.181092023197287,642,480,1122,+
chr7,27769677,2.181092023197287,642,480,1122,+
chr7,27769740,2.9719764011799414,619,451,1070,+
chr7,27785427,2.0704422653592154,738,525,1263,+
chr7,27793117,0.6822966507177033,620,494,1114,+
chr7,27793150,3.255379482902419,573,544,1117,+
chr7,27796127,5.080670625356157,784,556,1340,+
chr7,27828968,2.2635790280261157,664,560,1224,+
chr7,27829018,0.5527868063079331,655,425,1080,+
chr7,27829085,2.1517447199265383,720,483,1203,+
chr7,30594937,1.7282732447817837,620,464,1084,+
chr7,30595113,2.823792729245795,770,387,1157,+
chr7,30595115,2.823792729245795,770,387,1157,+
chr7,30598876,1.8369349978476108,761,504,1265,+
chr7,30599965,2.1653095804620413,1662,1089,2751,+
chr7,30599996,1.76248955072127,4101,2586,6687,+
chr7,30599997,1.8474226804123712,3071,1939,5010,+
chr7,30600015,0.6565792600808048,1343,970,2313,+
chr7,30601111,1.556637846376683,4000,3256,7256,+
chr7,30603045,2.8005822416302766,987,686,1673,+
chr7,30609664,0.5499367888748421,1391,1119,2510,+
chr7,30612096,1.7857713929077819,1834,1215,3049,+
chr7,30612101,1.9669631512071155,1079,786,1865,+
chr7,30612228,1.7791851236618677,1150,773,1923,+
chr7,30616028,1.7737048479087454,852,525,1377,+
chr7,30616041,1.9772701729120037,2585,1857,4442,+
chr7,30616042,2.0140840885455358,1831,1269,3100,+
chr7,30617123,1.156900341895404,1660,1193,2853,+
chr7,30617130,1.6917293233082706,924,702,1626,+
chr7,30617159,1.5173395445134576,901,643,1544,+
chr7,30621402,2.098701298701299,605,461,1066,+
chr7,30621429,2.478709005726184,743,564,1307,+
chr7,30621463,0.4725100572961112,683,630,1313,+
chr7,30621480,0.9263399257259928,1686,1368,3054,+
chr7,30622373,1.5828975947228705,936,801,1737,+
chr7,30622432,0.6389644653310248,1249,932,2181,+
chr7,30631505,0.6600790513833993,1001,758,1759,+
chr7,30632264,2.171250537172325,939,715,1654,+
chr7,30632394,1.950704492055985,1620,1266,2886,+
chr7,30633752,2.0214477211796247,1217,1118,2335,+
chr7,30633753,2.0214477211796247,1217,1118,2335,+
chr7,35903118,2.4624497555423552,606,407,1013,+
chr7,35904310,0.534020618556701,776,484,1260,+
chr7,35904453,1.3755892766359132,1047,723,1770,+
chr7,36396308,0.980229273965775,589,462,1051,+
chr7,36396310,0.980229273965775,589,462,1051,+
chr7,36399109,1.3059056346157984,778,575,1353,+
chr7,36399191,2.237704918032787,1273,853,2126,+
chr7,36399193,2.237704918032787,1273,853,2126,+
chr7,36399199,2.010170195101702,744,437,1181,+
chr7,36399214,1.62064495350334,1713,1098,2811,+
chr7,36399217,2.0404181184668992,914,573,1487,+
chr7,36399226,1.9665543168265491,1024,664,1688,+
chr7,36399228,0.6723473443333735,1275,721,1996,+
chr7,36399235,1.559712619148485,2721,1672,4393,+
chr7,36399247,1.0252195345029562,2965,2078,5043,+
chr7,36399256,1.9142351900972587,1731,1391,3122,+
chr7,36406358,2.1610177665125225,723,552,1275,+
chr7,36407871,1.946410485000466,898,719,1617,+
chr7,36410573,2.316489794847681,940,586,1526,+
chr7,36410602,2.444082558739608,713,494,1207,+
chr7,36411120,2.7029220779220777,554,447,1001,+
chr7,36411121,2.7029220779220777,554,447,1001,+
chr7,36419297,2.3372519276956134,859,585,1444,+
chr7,36419298,0.6560100297758972,1195,708,1903,+
chr7,36419302,1.6291173251069757,2141,1545,3686,+
chr7,36419304,1.4009174791522905,4591,3137,7728,+
chr7,36419305,1.7858966531609033,2257,1675,3932,+
chr7,36419353,1.6772997032640948,968,673,1641,+
chr7,36420245,1.7134099616858238,687,434,1121,+
chr7,36421862,1.7251122549556457,715,396,1111,+
chr7,36421896,0.7292561983471073,1102,604,1706,+
chr7,36427015,2.2069377990430623,614,417,1031,+
chr7,36452548,1.7546990245063048,589,466,1055,+
chr7,36452845,1.6383082158483224,1010,560,1570,+
chr7,36452853,0.5534031967820472,1306,704,2010,+
chr7,36452860,0.5094722598105548,1505,738,2243,+
chr7,36453309,3.493203883495145,770,514,1284,+
chr7,38217064,3.311011789550215,627,448,1075,+
chr7,38228816,1.359071669245649,614,439,1053,+
chr7,39686741,11.659903135194114,1020,556,1576,+
chr7,39686742,24.083697552447553,576,571,1147,+
chr7,39686743,18.951739435846097,2960,2671,5631,+
chr7,39686744,19.65071177673803,2457,2453,4910,+
chr7,39686745,6.5836541143654115,723,716,1439,+
chr7,39690394,0.458763786654666,788,822,1610,+
chr7,39696708,2.572407468389394,761,383,1144,+
chr7,39696818,2.6111482720178367,955,689,1644,+
chr7,39706186,1.2724022604082572,648,376,1024,+
chr7,39706188,1.2724022604082572,648,376,1024,+
chr7,39706561,6.298151001540831,544,471,1015,+
chr7,39706562,6.298151001540831,544,471,1015,+
chr7,39706563,12.963290608850127,639,651,1290,+
chr7,42796755,0.8633964945260337,865,663,1528,+
chr7,42935016,0.48021932108282106,917,657,1574,+
chr7,42935069,2.106878306878307,904,566,1470,+
chr7,42935072,2.0731042007637748,949,610,1559,+
chr7,42935086,1.867798303155941,1322,874,2196,+
chr7,42937342,1.7517130906825666,1063,660,1723,+
chr7,42937388,1.943068282427369,4073,3346,7419,+
chr7,42937390,1.943068282427369,4073,3346,7419,+
chr7,42937439,1.6225138722062151,2019,1398,3417,+
chr7,42937440,1.6225138722062151,2019,1398,3417,+
chr7,42937452,1.6292376681614351,585,445,1030,+
chr7,42937453,1.8549747048903882,1099,592,1691,+
chr7,43791280,0.390479978785468,588,418,1006,+
chr7,43791281,0.390479978785468,588,418,1006,+
chr7,43803688,1.000639314863405,695,498,1193,+
chr7,43803759,0.4108139876579489,698,414,1112,+
chr7,43803761,0.4108139876579489,698,414,1112,+
chr7,43806993,1.8318370005116995,742,580,1322,+
chr7,43806994,1.8318370005116995,742,580,1322,+
chr7,44212253,3.219984942750849,645,445,1090,+
chr7,44467877,0.7714087158659642,5695,2903,8598,+
chr7,44467878,0.8846981290958773,19898,12445,32343,+
chr7,44467879,0.9844130964820619,11304,9866,21170,+
chr7,44467880,1.0016677710998882,28770,19454,48224,+
chr7,44467881,1.1160849762127663,37990,28524,66514,+
chr7,44467882,1.1013119407154917,57168,35860,93028,+
chr7,44467883,1.10217642439159,49418,31069,80487,+
chr7,44467887,1.3819616770184147,61088,39946,101034,+
chr7,44467888,1.3819616770184147,61088,39946,101034,+
chr7,44467976,2.760378847671665,782,542,1324,+
chr7,44467977,1.9467731724681059,1888,1264,3152,+
chr7,44467978,1.8943552261621626,2086,1427,3513,+
chr7,44467980,1.2944809990600243,963,676,1639,+
chr7,44467982,0.7992810828811535,858,718,1576,+
chr7,44467983,0.9661985159847764,4429,2966,7395,+
chr7,44467985,1.1309896013167258,4330,3048,7378,+
chr7,44468134,2.030681556661074,1896,1314,3210,+
chr7,44468137,1.6630241436226398,1421,883,2304,+
chr7,44468140,1.5269279393173196,791,451,1242,+
chr7,44468141,1.3706812255541068,1868,1415,3283,+
chr7,44468143,1.421979470759959,3019,2336,5355,+
chr7,44468144,1.4265632731300457,3427,2784,6211,+
chr7,44468145,1.1499125012323772,3162,1931,5093,+
chr7,44468146,1.1499125012323772,3162,1931,5093,+
chr7,44468147,1.609726475868624,1364,1113,2477,+
chr7,44468149,0.9606971597196606,4295,2710,7005,+
chr7,44468151,0.8746965901652201,16784,12999,29783,+
chr7,44468152,0.9299847483536273,10634,8776,19410,+
chr7,44468153,1.1039463209371092,5709,4884,10593,+
chr7,44468158,1.392981743047793,6999,4541,11540,+
chr7,44468159,1.4808328143758704,10879,7144,18023,+
chr7,44468161,1.4764832497832143,7449,4933,12382,+
chr7,44468163,0.9818335310175398,10053,8623,18676,+
chr7,44468165,1.0900725915058085,5765,5414,11179,+
chr7,44468169,1.3546735054993473,7982,7385,15367,+
chr7,44468170,0.9339836228046483,19791,14249,34040,+
chr7,44468172,0.7884433031692484,18340,14037,32377,+
chr7,44468319,0.6601417138196461,739,502,1241,+
chr7,44645435,0.892502258355917,571,450,1021,+
chr7,44645436,0.892502258355917,571,450,1021,+
chr7,44645444,1.0926518538866514,719,603,1322,+
chr7,44645465,2.3274515148687733,1109,776,1885,+
chr7,44697739,2.167674508288736,612,441,1053,+
chr7,44708428,1.6645169036614784,1011,687,1698,+
chr7,44708429,1.6054446723664864,871,599,1470,+
chr7,44708910,51.6035300263195,880,532,1412,+
chr7,44708911,49.96871779021333,1110,855,1965,+
chr7,44708929,6.786330931852243,362,680,1042,+
chr7,44708940,0.18528346305022036,991,1378,2369,+
chr7,44708941,0.17924437397496565,886,1139,2025,+
chr7,44796678,0.8446467184215558,13459,4473,17932,+
chr7,44796679,0.9081895773702005,27105,11745,38850,+
chr7,44796680,0.9081895773702005,27105,11745,38850,+
chr7,44799431,1.4046987333105099,1312,735,2047,+
chr7,44799433,1.3637297851056778,1945,1092,3037,+
chr7,44799447,1.7905136444295242,1696,718,2414,+
chr7,44799449,1.7905136444295242,1696,718,2414,+
chr7,44799453,1.4805125939019002,1046,464,1510,+
chr7,44799454,0.7014483766899373,4008,2890,6898,+
chr7,44799456,0.7011322938504543,2334,1907,4241,+
chr7,44799458,0.6563831081903371,937,497,1434,+
chr7,44799708,1.4595531183495016,4490,2806,7296,+
chr7,44799710,1.4150146925016034,2463,1145,3608,+
chr7,44799711,1.3598204857444562,2345,1893,4238,+
chr7,44799720,1.5849242922975644,3423,1735,5158,+
chr7,44799721,1.3270783929614736,4040,2861,6901,+
chr7,44799737,1.2347629692703357,14126,9323,23449,+
chr7,44799747,1.2298334994960958,19001,13046,32047,+
chr7,44799752,0.8634669568427803,16457,12719,29176,+
chr7,44799754,0.8407020827405896,35777,27303,63080,+
chr7,44799755,0.8315540726931666,28185,21389,49574,+
chr7,44799756,0.8315540726931666,28185,21389,49574,+
chr7,44799768,1.5873564849454318,7548,5536,13084,+
chr7,44801306,0.6204325130499627,2079,893,2972,+
chr7,44801372,1.5829087423699741,1081,460,1541,+
chr7,44801374,1.5829087423699741,1081,460,1541,+
chr7,44801375,2.3426342634263424,975,605,1580,+
chr7,44801380,1.6769332670972017,1065,670,1735,+
chr7,44801381,1.1412942085765303,2446,1136,3582,+
chr7,44801382,1.1412942085765303,2446,1136,3582,+
chr7,44801383,1.1067255259495548,4544,2627,7171,+
chr7,44801387,1.2519522433871988,1760,1165,2925,+
chr7,44801392,1.4830248073266015,5427,3474,8901,+
chr7,44801393,1.5938982876005776,6574,4439,11013,+
chr7,44801395,1.6945759456703593,4480,3060,7540,+
chr7,44801411,1.44427908210162,5110,3500,8610,+
chr7,44801420,1.4423416347086817,7373,3763,11136,+
chr7,44801421,1.3693235309226797,17888,11461,29349,+
chr7,44801433,1.290095210383105,12197,7088,19285,+
chr7,44801434,1.3074469756505727,16143,10832,26975,+
chr7,44801436,1.3778668448007123,7292,4490,11782,+
chr7,44801441,1.2882715278050727,24036,14424,38460,+
chr7,44801442,1.1700061806520115,15904,11421,27325,+
chr7,44801443,1.3447997229597135,15144,8662,23806,+
chr7,55155843,2.268422418266736,1075,655,1730,+
chr7,55155845,2.268422418266736,1075,655,1730,+
chr7,55206505,3.0603492131029104,2113,1331,3444,+
chr7,55206511,1.883613462560831,2349,1286,3635,+
chr7,55206512,1.883613462560831,2349,1286,3635,+
chr7,55206522,2.068210862619808,1176,625,1801,+
chr7,55206535,1.6300982366336487,4579,2801,7380,+
chr7,55206537,1.6974824120603011,3156,1989,5145,+
chr7,55206552,1.9067499106598558,2045,1412,3457,+
chr7,55206556,2.3100349696781906,2151,1557,3708,+
chr7,55206560,1.479653238143804,2417,1854,4271,+
chr7,55206928,2.031307686627778,785,466,1251,+
chr7,55206934,1.8406177348589128,2563,1552,4115,+
chr7,55206935,1.7084883923967005,2861,1701,4562,+
chr7,55206945,1.605745186296574,1092,743,1835,+
chr7,55207173,1.8422419614565475,864,620,1484,+
chr7,55207191,2.550570228091237,738,391,1129,+
chr7,55209991,2.898995362987123,1012,631,1643,+
chr7,55425401,1.9713826755125121,790,575,1365,+
chr7,55773225,0.9695223549014164,797,553,1350,+
chr7,55773226,0.9695223549014164,797,553,1350,+
chr7,55773232,2.283878075651854,690,388,1078,+
chr7,55773234,3.6003800201601246,990,614,1604,+
chr7,55773281,2.213376835236541,847,612,1459,+
chr7,55954911,1.6285299345153899,743,505,1248,+
chr7,55978144,0.45764374683809284,719,574,1293,+
chr7,55978168,4.415536669491956,598,503,1101,+
chr7,55978359,0.4096296296296297,552,494,1046,+
chr7,55981500,1.7238587184140723,685,493,1178,+
chr7,55982227,2.5083056478405314,754,601,1355,+
chr7,55982228,2.3501459843856516,835,679,1514,+
chr7,55994938,1.2447883782673792,1826,1279,3105,+
chr7,55994939,1.0484111520050037,1300,893,2193,+
chr7,55994966,2.915728962818004,768,583,1351,+
chr7,55999377,2.2391451831750344,942,736,1678,+
chr7,55999552,1.0873383908537237,1070,840,1910,+
chr7,56051787,1.713861264726559,959,546,1505,+
chr7,56051793,0.4470083487940631,770,351,1121,+
chr7,56051811,1.8730987862958983,1015,565,1580,+
chr7,56051912,1.3645654499667137,1435,810,2245,+
chr7,56051915,1.5296442687747036,1061,505,1566,+
chr7,56051950,0.5415860735009672,559,461,1020,+
chr7,56051953,2.099875156054932,695,533,1228,+
chr7,56051968,2.043440807285257,614,477,1091,+
chr7,56051974,1.7638705416116247,871,756,1627,+
chr7,56052445,2.3154362416107386,804,595,1399,+
chr7,56052447,1.2763906227614095,2714,1797,4511,+
chr7,56052451,1.497951928278847,880,680,1560,+
chr7,56054397,1.5361272689046184,952,750,1702,+
chr7,56054424,0.6053459119496856,1374,1059,2433,+
chr7,56057994,2.3395522388059704,835,535,1370,+
chr7,56058007,1.6082300362593809,1489,1004,2493,+
chr7,56058044,1.6282705183896058,3434,2208,5642,+
chr7,56058653,1.5495318352059926,1272,889,2161,+
chr7,56059573,1.330023273855702,2142,1288,3430,+
chr7,56060398,1.5005331862474716,948,734,1682,+
chr7,56060836,2.0937589876330165,727,548,1275,+
chr7,56060857,1.4947054151506893,3703,2668,6371,+
chr7,56060861,1.4060885333863276,1432,1087,2519,+
chr7,56060909,1.54460974405979,1955,1090,3045,+
chr7,56063075,1.9190482348377085,1119,813,1932,+
chr7,56063112,1.4948302342164446,1626,1235,2861,+
chr7,56063261,1.3727553732023632,9521,6902,16423,+
chr7,56068481,2.034042553191489,716,469,1185,+
chr7,56068482,2.034042553191489,716,469,1185,+
chr7,56068522,3.0436103694137446,1013,772,1785,+
chr7,56068539,0.41237353169957214,1278,900,2178,+
chr7,56068590,2.0865051903114185,602,407,1009,+
chr7,56068611,2.7190979563072593,741,472,1213,+
chr7,56073010,0.6110530997408826,789,506,1295,+
chr7,56073015,1.780065005417118,847,567,1414,+
chr7,56079534,2.799655319687229,651,472,1123,+
chr7,56079536,2.637869822485207,742,506,1248,+
chr7,56079668,0.5520262869660459,755,497,1252,+
chr7,56079944,0.5951923773639591,1132,745,1877,+
chr7,56080131,0.9776666189785198,2484,1731,4215,+
chr7,56080132,0.9776666189785198,2484,1731,4215,+
chr7,56080377,0.2792803263589788,904,690,1594,+
chr7,56080384,0.7071762222091552,766,418,1184,+
chr7,56080386,0.9749033698078284,813,470,1283,+
chr7,56080387,2.258425373758522,1290,856,2146,+
chr7,56080391,1.7588087039841946,1889,1442,3331,+
chr7,56080392,1.474271579475341,2521,1924,4445,+
chr7,56080532,0.6108590810728803,1148,685,1833,+
chr7,56080533,0.7043104030967224,1171,656,1827,+
chr7,56288113,0.5432354012187605,678,441,1119,+
chr7,56288115,0.5662984284279083,846,512,1358,+
chr7,56288120,3.6601744781430225,1169,676,1845,+
chr7,56289333,0.9716935221722297,615,426,1041,+
chr7,56289344,1.6384794879743727,612,423,1035,+
chr7,56291187,0.478905711761386,1074,777,1851,+
chr7,56291189,0.4476656099648262,1116,854,1970,+
chr7,56291217,0.9867482227128578,1936,1464,3400,+
chr7,66955760,3.97603570867775,855,634,1489,+
chr7,66955769,4.37,620,599,1219,+
chr7,66955771,4.37,620,599,1219,+
chr7,66955775,2.3938397892823806,636,655,1291,+
chr7,66955778,1.901006923526584,772,747,1519,+
chr7,66955787,2.8253242111227888,732,690,1422,+
chr7,66955788,0.4973931178310741,529,547,1076,+
chr7,66955803,1.5969477107830872,490,570,1060,+
chr7,73686699,0.5106291715680221,1454,1018,2472,+
chr7,73686700,0.6243282169257289,1843,1278,3121,+
chr7,73686701,0.547455881548039,2621,1855,4476,+
chr7,73686712,1.7911641548964625,1586,1030,2616,+
chr7,73686715,1.6754716981132074,776,529,1305,+
chr7,73686879,2.3576548891942726,1549,1196,2745,+
chr7,73690947,2.681337881687329,870,706,1576,+
chr7,73690949,1.9638833571080556,1346,1028,2374,+
chr7,73693335,1.2077605303215888,665,522,1187,+
chr7,73697630,3.9681837361205132,765,597,1362,+
chr7,73697665,0.43004314797038606,682,568,1250,+
chr7,73697853,1.0792253521126762,612,425,1037,+
chr7,73697854,1.0792253521126762,612,425,1037,+
chr7,74174381,1.330864128449077,1063,604,1667,+
chr7,74187675,2.1913473423980223,1107,808,1915,+
chr7,74187677,2.1913473423980223,1107,808,1915,+
chr7,74187688,1.5828493999225708,883,573,1456,+
chr7,74187691,1.3195597929971867,2760,1836,4596,+
chr7,74187692,0.8289568274768434,3149,2075,5224,+
chr7,74187697,1.5134549953603464,931,731,1662,+
chr7,74187704,0.7165577889447237,1500,994,2494,+
chr7,74194746,3.2047945692317414,1381,676,2057,+
chr7,74194748,2.5741634394294874,1879,958,2837,+
chr7,74194749,2.593568994889268,1148,586,1734,+
chr7,74194752,2.097131228906095,1362,827,2189,+
chr7,74194754,1.8120639969745396,2526,1520,4046,+
chr7,74194755,2.012100745743633,1429,926,2355,+
chr7,74194758,2.3031076117794544,1539,1108,2647,+
chr7,74194759,2.3031076117794544,1539,1108,2647,+
chr7,74194766,2.8899200000000005,820,624,1444,+
chr7,74194770,2.079508883674153,2408,1255,3663,+
chr7,74194771,1.7906947598185208,4016,2328,6344,+
chr7,74194772,2.079508883674153,2408,1255,3663,+
chr7,74194793,1.8774062816616008,1089,657,1746,+
chr7,74194797,1.603765227021041,1113,601,1714,+
chr7,74194798,1.6193232578916017,1380,1167,2547,+
chr7,74194805,1.932346723044397,1370,773,2143,+
chr7,74194819,0.5595970000321885,914,660,1574,+
chr7,74194824,1.76132024438001,9751,6669,16420,+
chr7,74194825,1.76132024438001,9751,6669,16420,+
chr7,74194831,2.11134576109209,11205,8276,19481,+
chr7,74194832,2.11134576109209,11205,8276,19481,+
chr7,74194836,1.5609850898720503,6953,5066,12019,+
chr7,74194837,1.5609850898720503,6953,5066,12019,+
chr7,74195168,2.2795893719806757,754,551,1305,+
chr7,74195169,2.2795893719806757,754,551,1305,+
chr7,74195301,0.3715880631322656,1360,691,2051,+
chr7,74195545,1.0693374422187982,693,471,1164,+
chr7,74195546,1.0693374422187982,693,471,1164,+
chr7,74195560,2.1757084636608552,1427,959,2386,+
chr7,74195561,1.4788604771108125,1625,1025,2650,+
chr7,74195660,1.382048353200087,2053,1543,3596,+
chr7,74195661,0.5115656530990459,1027,856,1883,+
chr7,74195669,2.0173353509533074,1283,1008,2291,+
chr7,74195673,0.5100190407108531,749,537,1286,+
chr7,74195678,0.5035260670506573,1090,887,1977,+
chr7,74195680,0.5636447948063993,571,453,1024,+
chr7,74195685,1.5975,638,543,1181,+
chr7,74196022,4.071341463414634,606,409,1015,+
chr7,74196056,1.3416697017047126,1108,703,1811,+
chr7,74196191,8.319520881001438,3413,1751,5164,+
chr7,74196193,7.66103710632448,3927,2085,6012,+
chr7,74196196,18.802038284186313,2267,1694,3961,+
chr7,74196214,3.4445422535211274,601,567,1168,+
chr7,74196294,0.8511783618525356,1083,789,1872,+
chr7,74196334,2.077679669162848,640,388,1028,+
chr7,74196337,1.1065550999544398,1531,908,2439,+
chr7,74196339,1.1065550999544398,1531,908,2439,+
chr7,74196348,0.6448170731707318,845,655,1500,+
chr7,74196349,1.5573698658246493,2226,1631,3857,+
chr7,74196350,1.67920059215396,1193,964,2157,+
chr7,74196380,0.7629670191565379,2072,1525,3597,+
chr7,74196818,1.745369341200842,988,660,1648,+
chr7,74196839,1.7981499202551836,828,474,1302,+
chr7,74196842,2.369145569620253,650,394,1044,+
chr7,74196843,3.0373406193078325,919,548,1467,+
chr7,74196858,3.4830252100840333,941,594,1535,+
chr7,74196875,1.3906577062906245,1941,1251,3192,+
chr7,74691023,2.1229211858279102,733,460,1193,+
chr7,74691025,2.1229211858279102,733,460,1193,+
chr7,74716929,2.9320024359215235,773,591,1364,+
chr7,75954057,1.2934768131810577,729,541,1270,+
chr7,75954133,1.7745085605580215,635,414,1049,+
chr7,75954138,0.33270676691729323,707,447,1154,+
chr7,75980469,1.8007824628110713,586,481,1067,+
chr7,75983534,1.043791591026326,875,688,1563,+
chr7,75983803,2.67599609384194,959,718,1677,+
chr7,75985152,3.0592396109637487,691,347,1038,+
chr7,75985154,2.379602478276218,878,487,1365,+
chr7,75986023,2.418906003260173,701,452,1153,+
chr7,75986031,0.41113490364025695,543,466,1009,+
chr7,75986183,2.825910931174089,697,474,1171,+
chr7,75986435,0.7594430992736078,696,471,1167,+
chr7,75986436,0.7594430992736078,696,471,1167,+
chr7,76054839,1.7614250828536544,1302,935,2237,+
chr7,76054840,1.7614250828536544,1302,935,2237,+
chr7,76054868,0.4428492136910269,703,574,1277,+
chr7,76054878,1.0298922291548498,1625,1229,2854,+
chr7,76054879,1.8734853884533145,750,609,1359,+
chr7,76054880,1.0298922291548498,1625,1229,2854,+
chr7,76054882,0.5518492365631013,2200,1436,3636,+
chr7,76054884,0.9175262685349438,3485,2200,5685,+
chr7,76054891,1.5566860465116281,1364,859,2223,+
chr7,76054893,2.284005332756819,1218,956,2174,+
chr7,76054895,1.3636363636363635,1609,1057,2666,+
chr7,76054896,1.817728632284963,1718,1002,2720,+
chr7,76054901,0.7397476340694007,1607,1267,2874,+
chr7,76054966,0.5628351747754734,842,736,1578,+
chr7,76054971,1.5903189910979227,979,673,1652,+
chr7,76057424,1.9685594405594409,925,714,1639,+
chr7,76057970,1.6867142371729529,729,544,1273,+
chr7,76057991,1.6556776556776558,790,587,1377,+
chr7,76058040,0.549979967948718,866,623,1489,+
chr7,76060374,1.0089308208653012,1773,1488,3261,+
chr7,76063514,2.249289520426288,816,562,1378,+
chr7,76063519,1.6179437812860993,1340,794,2134,+
chr7,76064396,0.6141065494693966,673,490,1163,+
chr7,76064423,2.8597689075630246,604,475,1079,+
chr7,76064806,0.6287262872628726,695,566,1261,+
chr7,76064812,2.4990240997791178,1370,960,2330,+
chr7,76064865,1.866654931127052,963,732,1695,+
chr7,76066278,1.52604957005564,861,658,1519,+
chr7,76066375,1.7409924686798384,1711,1310,3021,+
chr7,76066437,0.5040262745180778,1747,1280,3027,+
chr7,76302674,0.7905970343985248,1926,1162,3088,+
chr7,76302772,2.49057075059323,766,470,1236,+
chr7,76302899,0.509815977391372,2165,1117,3282,+
chr7,76302900,0.509815977391372,2165,1117,3282,+
chr7,76302901,2.3433246988199503,1095,736,1831,+
chr7,76302902,2.3433246988199503,1095,736,1831,+
chr7,76302912,2.037914188615123,618,427,1045,+
chr7,76302926,2.355769230769231,734,493,1227,+
chr7,76302928,2.355769230769231,734,493,1227,+
chr7,76302982,0.5284064231383229,661,462,1123,+
chr7,76303001,1.7558286643773722,1004,502,1506,+
chr7,76303010,1.8423043946906594,3554,2420,5974,+
chr7,76303011,1.9038465120610968,1596,1192,2788,+
chr7,76303013,3.435648148148148,904,674,1578,+
chr7,76303045,1.4943396226415095,998,794,1792,+
chr7,76303997,1.908303355113428,1528,1027,2555,+
chr7,76303998,1.908303355113428,1528,1027,2555,+
chr7,76304003,0.6276223776223777,717,597,1314,+
chr7,76304005,1.9938498164864595,1004,592,1596,+
chr7,76304010,1.661188369152971,1094,677,1771,+
chr7,76304087,1.8127875016068198,781,542,1323,+
chr7,76304104,1.7956801818870787,717,454,1171,+
chr7,76304110,2.1895890410958896,998,510,1508,+
chr7,77632358,2.407407407407407,727,377,1104,+
chr7,77632362,1.4633215729618387,2356,1591,3947,+
chr7,77632363,1.9292529252925292,1530,1110,2640,+
chr7,77632383,3.482992161935926,994,772,1766,+
chr7,77632387,1.8455334964303645,3681,2582,6263,+
chr7,77632388,2.179663510747185,3464,2930,6394,+
chr7,77632390,2.2969320204023846,3886,2801,6687,+
chr7,77632396,1.5604381840962924,7785,4775,12560,+
chr7,77632397,1.5571235882260583,6515,3593,10108,+
chr7,80199295,0.9711375212224108,571,455,1026,+
chr7,80199297,1.6348762899631384,825,696,1521,+
chr7,80199298,0.753609439845978,962,683,1645,+
chr7,80199300,1.268610920445779,987,780,1767,+
chr7,80199306,3.090583459364802,946,738,1684,+
chr7,80199307,3.090583459364802,946,738,1684,+
chr7,80217974,0.6357333333333334,595,524,1119,+
chr7,80217976,0.7158640817177402,605,532,1137,+
chr7,87182257,5.004328817740022,700,433,1133,+
chr7,87195117,1.6140092876042051,642,413,1055,+
chr7,87195425,0.9090734739843774,1539,1039,2578,+
chr7,87195435,1.373139927208644,3698,2633,6331,+
chr7,87195436,1.373139927208644,3698,2633,6331,+
chr7,87195437,2.0391113082695647,1969,1523,3492,+
chr7,87907644,0.5008802782558582,1089,532,1621,+
chr7,87907654,2.0078952284788913,2621,1346,3967,+
chr7,87907656,2.0078952284788913,2621,1346,3967,+
chr7,87908105,3.994729683781026,660,462,1122,+
chr7,92458449,1.6103080066409683,809,536,1345,+
chr7,92458452,1.0413630406290957,763,544,1307,+
chr7,92458454,0.8869751931414801,1082,754,1836,+
chr7,93809028,2.8287800775888607,1035,741,1776,+
chr7,93809070,1.8782542022724897,1270,994,2264,+
chr7,93921872,1.6138745588364176,734,503,1237,+
chr7,93922042,6.170847780631098,875,478,1353,+
chr7,93922043,6.170847780631098,875,478,1353,+
chr7,93922051,0.526691242249437,784,420,1204,+
chr7,93922053,0.6039245984292253,2079,1064,3143,+
chr7,93922105,1.8987760680864523,2148,1131,3279,+
chr7,93922107,2.066149597795708,2781,1531,4312,+
chr7,93922133,1.6034359483614704,1582,1324,2906,+
chr7,93922134,2.080588180714897,2947,1920,4867,+
chr7,93922135,1.9022008930242937,4529,3244,7773,+
chr7,93922215,1.7305061559507524,1724,1074,2798,+
chr7,94668512,2.163102582323814,1365,848,2213,+
chr7,94668513,2.3015456928500413,877,480,1357,+
chr7,94668520,1.0274952876307548,1131,795,1926,+
chr7,94668525,2.246525990735975,1163,803,1966,+
chr7,94668527,2.246525990735975,1163,803,1966,+
chr7,94668564,1.5265195104090383,1215,868,2083,+
chr7,99348865,1.749688678801199,672,520,1192,+
chr7,99348867,1.0468807678110004,708,386,1094,+
chr7,99348868,1.1421828908554572,703,451,1154,+
chr7,99348869,1.0468807678110004,708,386,1094,+
chr7,99348870,1.5195761286426568,1136,730,1866,+
chr7,99358357,0.3893457335117135,579,464,1043,+
chr7,99359565,1.6323170519134413,1258,895,2153,+
chr7,99359566,1.6323170519134413,1258,895,2153,+
chr7,99363571,2.3076988359833823,826,602,1428,+
chr7,99385718,3.7290813005973753,706,450,1156,+
chr7,99385736,0.9831613253666486,542,525,1067,+
chr7,99385737,0.9831613253666486,542,525,1067,+
chr7,99385766,1.9092771084337348,688,414,1102,+
chr7,99386701,1.803024193548387,812,495,1307,+
chr7,99386723,1.524092654527437,768,701,1469,+
chr7,99388065,0.571629213483146,665,355,1020,+
chr7,99388191,2.1683354192740927,692,375,1067,+
chr7,99388196,1.9970992239463266,1325,906,2231,+
chr7,99388238,1.6397080291970805,701,547,1248,+
chr7,99389923,0.5416303188911505,761,542,1303,+
chr7,99389924,1.6817307692307693,582,467,1049,+
chr7,99390953,1.1143967293964343,1011,688,1699,+
chr7,99390969,2.0323515210043457,731,435,1166,+
chr7,99390974,1.8335600907029483,621,489,1110,+
chr7,99391183,3.800841134174467,823,566,1389,+
chr7,99391184,3.800841134174467,823,566,1389,+
chr7,99391201,1.1257027497083227,1383,959,2342,+
chr7,99394029,2.573155800428528,730,593,1323,+
chr7,99394030,2.573155800428528,730,593,1323,+
chr7,99394062,1.7191283292978208,709,412,1121,+
chr7,99394069,1.5120867208672089,753,449,1202,+
chr7,99394101,0.4940755467196819,653,502,1155,+
chr7,99394102,0.5836152375349316,743,522,1265,+
chr7,99394545,3.0752212389380533,694,338,1032,+
chr7,99394548,19.175474605517714,5798,3965,9763,+
chr7,99394549,19.175474605517714,5798,3965,9763,+
chr7,99394550,5.820551252122241,3057,1983,5040,+
chr7,99394552,4.585007842914248,3432,2950,6382,+
chr7,99394571,0.6354958419028883,916,843,1759,+
chr7,99394640,4.813975258308222,3352,3129,6481,+
chr7,99410033,1.7453260526597836,781,653,1434,+
chr7,99410035,1.5425328947368422,956,759,1715,+
chr7,99410037,1.1307113938692883,679,531,1210,+
chr7,99410144,2.206853582554517,758,534,1292,+
chr7,99411067,1.0848106007838738,2354,1765,4119,+
chr7,99411071,2.9089251743817366,940,663,1603,+
chr7,99416200,0.5228227597766694,1074,791,1865,+
chr7,99416207,0.4732234403344114,599,408,1007,+
chr7,99416224,2.637979861548144,620,453,1073,+
chr7,100089016,2.2783049204158425,571,448,1019,+
chr7,100089614,2.20344578559005,738,638,1376,+
chr7,100089626,2.301561661936652,872,721,1593,+
chr7,100089646,0.5193398659102629,1006,830,1836,+
chr7,100089647,0.5358053320526108,1189,830,2019,+
chr7,100089648,0.5193398659102629,1006,830,1836,+
chr7,100089652,2.981332921937674,772,462,1234,+
chr7,100089662,1.9159474671669796,850,532,1382,+
chr7,100090452,0.5048425583680344,1659,736,2395,+
chr7,100090455,1.6035335417414034,4869,3159,8028,+
chr7,100090456,1.547659039533152,11142,6329,17471,+
chr7,100090457,1.5560106819470525,8706,4955,13661,+
chr7,100090598,1.7006498348780226,613,446,1059,+
chr7,100090607,1.7244365000920734,1330,948,2278,+
chr7,100090628,2.036124794745484,619,579,1198,+
chr7,100091272,0.9778572783695152,901,752,1653,+
chr7,100091273,1.4129901344426306,1481,1072,2553,+
chr7,100091429,2.5514803947719398,910,651,1561,+
chr7,100091430,2.5514803947719398,910,651,1561,+
chr7,100091431,0.3238997555012225,756,408,1164,+
chr7,100091433,0.5979554684217896,609,578,1187,+
chr7,100091473,0.5421602787456445,777,524,1301,+
chr7,100091723,2.326259106746912,611,450,1061,+
chr7,100091727,0.6265263869522965,673,482,1155,+
chr7,100091780,1.6679000925069378,600,422,1022,+
chr7,100091846,2.466136002916095,909,678,1587,+
chr7,100091950,2.6669711985528313,651,422,1073,+
chr7,100091968,1.1596582420688435,1073,691,1764,+
chr7,100153868,1.8266060931400812,1261,783,2044,+
chr7,100153870,2.459323114449649,1364,838,2202,+
chr7,100153872,2.3329326355248563,1626,980,2606,+
chr7,100153884,1.7245508982035929,799,500,1299,+
chr7,100153956,0.9926854754440961,799,527,1326,+
chr7,100153958,0.9926854754440961,799,527,1326,+
chr7,100153993,2.7848605577689236,698,501,1199,+
chr7,100153995,2.7848605577689236,698,501,1199,+
chr7,100602356,1.2273545522571672,828,571,1399,+
chr7,100602362,0.7125542786390667,680,400,1080,+
chr7,100602363,0.4584335739107191,685,644,1329,+
chr7,100602516,2.556989535517948,1058,733,1791,+
chr7,100602519,2.068209504284224,1109,803,1912,+
chr7,100602520,1.8392732354996506,845,476,1321,+
chr7,100603433,2.4280334728033472,828,477,1305,+
chr7,100603434,2.4262582056892783,615,456,1071,+
chr7,100603463,1.535254031918056,1898,1289,3187,+
chr7,100603511,0.6149981158145962,1019,837,1856,+
chr7,100603527,1.892200956937799,1113,949,2062,+
chr7,100603985,1.8073834875196368,1061,673,1734,+
chr7,100604085,2.1190965092402467,644,486,1130,+
chr7,100604112,2.0914798206278027,582,445,1027,+
chr7,100605096,0.5689075630252101,676,339,1015,+
chr7,100605162,1.6783970226678113,2209,1585,3794,+
chr7,100605164,1.6787790697674418,1259,1031,2290,+
chr7,100605182,2.0970873786407767,1052,617,1669,+
chr7,100605192,1.6844636844636844,617,566,1183,+
chr7,100605685,1.7646350035144092,605,432,1037,+
chr7,100605693,1.52073732718894,659,495,1154,+
chr7,100605697,1.3798630303182666,2706,1923,4629,+
chr7,100605786,2.4898815141029678,765,560,1325,+
chr7,100606423,1.5851894539691689,1037,630,1667,+
chr7,100606438,1.4363717010423596,1221,834,2055,+
chr7,100606466,0.6062705792958715,1425,952,2377,+
chr7,100606567,2.060267857142857,922,543,1465,+
chr7,100607496,1.5191208791208792,863,649,1512,+
chr7,100607701,0.5940949935815146,1067,819,1886,+
chr7,100607702,1.5735447012164114,2091,1562,3653,+
chr7,100607941,1.2528289724824213,2133,1392,3525,+
chr7,100607943,0.625537139349294,1018,904,1922,+
chr7,100608044,2.162080536912752,757,595,1352,+
chr7,100678551,5.187319884726223,809,346,1155,+
chr7,100678552,5.187319884726223,809,346,1155,+
chr7,100706839,1.3383336960069636,720,492,1212,+
chr7,100706840,1.3383336960069636,720,492,1212,+
chr7,100867959,28.15207211492431,1279,1095,2374,+
chr7,100867960,26.957825411905198,1727,1704,3431,+
chr7,100867961,27.873323378218593,1528,1653,3181,+
chr7,100870619,8.887930099720998,1865,1579,3444,+
chr7,100870620,8.887930099720998,1865,1579,3444,+
chr7,100870621,7.4148116049388015,998,1006,2004,+
chr7,100870627,5.372378164543914,806,825,1631,+
chr7,100872635,0.5511324948913456,1043,847,1890,+
chr7,100872660,1.6235189573459716,755,421,1176,+
chr7,100873311,1.6121583538105586,571,505,1076,+
chr7,100884204,1.2434146374718376,840,708,1548,+
chr7,100884211,3.293890977443609,688,528,1216,+
chr7,100887461,0.9344626280291659,522,521,1043,+
chr7,101157390,1.270718638753263,638,446,1084,+
chr7,101160789,0.7360022443865804,627,481,1108,+
chr7,101161131,9.483768828856324,1155,693,1848,+
chr7,101161132,9.483768828856324,1155,693,1848,+
chr7,101161221,5.755927464787067,505,822,1327,+
chr7,101161222,5.712567343313596,564,986,1550,+
chr7,101222687,2.001,1011,799,1810,+
chr7,101222688,2.001,1011,799,1810,+
chr7,101222689,1.5730268273509027,1466,1030,2496,+
chr7,101223480,1.5511256029209575,849,674,1523,+
chr7,101224013,2.565289256198348,581,483,1064,+
chr7,101224015,1.6799537032988092,1276,1106,2382,+
chr7,101224016,0.8064852754339165,1144,956,2100,+
chr7,101224071,2.4708097928436907,573,530,1103,+
chr7,101224073,2.4708097928436907,573,530,1103,+
chr7,101310500,3.250096895841678,693,355,1048,+
chr7,103097286,2.5069014254942816,720,476,1196,+
chr7,103297529,0.5117464362506968,1070,865,1935,+
chr7,103297535,1.6069906223358907,1039,735,1774,+
chr7,103300219,0.2328159645232816,629,491,1120,+
chr7,103300239,1.6761904761904762,687,386,1073,+
chr7,103307609,2.501820132551236,675,550,1225,+
chr7,103312080,0.2000686341798216,582,469,1051,+
chr7,103347663,0.5618181818181819,617,439,1056,+
chr7,103347664,0.5894305194047604,1189,909,2098,+
chr7,103347678,1.9769107785772972,1531,1093,2624,+
chr7,103347709,0.6377520759193357,781,561,1342,+
chr7,103347741,2.068312814823845,988,709,1697,+
chr7,103348655,0.9086204512229629,1227,952,2179,+
chr7,103348656,1.0223284172365494,986,741,1727,+
chr7,103353936,2.005275974025974,548,461,1009,+
chr7,103355769,3.014630733882261,1360,933,2293,+
chr7,103363351,2.6189401140684407,710,525,1235,+
chr7,103366082,0.4584707646176912,555,459,1014,+
chr7,103366092,2.7238421955403087,793,582,1375,+
chr7,103366094,2.7238421955403087,793,582,1375,+
chr7,103366103,1.3033496632365669,2081,1558,3639,+
chr7,103366136,1.7354222675442665,719,468,1187,+
chr7,103367509,0.6096999154691463,2933,1689,4622,+
chr7,103367510,1.031573551084259,5045,2740,7785,+
chr7,103367511,1.6480452373988497,2112,1051,3163,+
chr7,103367519,1.457590361445783,1840,1049,2889,+
chr7,103367520,1.9883588374931485,2640,1700,4340,+
chr7,103367522,1.5809493317988614,5387,3210,8597,+
chr7,103367532,1.572601717058604,1148,854,2002,+
chr7,103367968,2.4773504273504274,747,584,1331,+
chr7,104668456,3.163175944034681,327,766,1093,+
chr7,104668463,2.163947239831194,1180,2823,4003,+
chr7,104668464,1.973965433258574,933,2489,3422,+
chr7,104668465,1.9619649371614307,569,1408,1977,+
chr7,104668469,0.4108887350297226,732,1325,2057,+
chr7,104668470,0.3753224061901989,346,706,1052,+
chr7,104668476,0.3569964377832008,685,1173,1858,+
chr7,104668477,0.4006906452489039,448,780,1228,+
chr7,104668480,0.37440543002288496,1088,1899,2987,+
chr7,104668481,0.3145203793483954,993,1332,2325,+
chr7,104668482,0.4780069493812985,819,1501,2320,+
chr7,104668484,0.4148915755133372,939,964,1903,+
chr7,104668485,0.3929155702204152,1301,1488,2789,+
chr7,104669204,1.7543383947939262,646,460,1106,+
chr7,104669205,1.425161974505052,1156,811,1967,+
chr7,104669225,0.751118940235168,1935,1096,3031,+
chr7,104669237,1.4840260545905708,1366,805,2171,+
chr7,104669267,1.0073885854310796,9616,6540,16156,+
chr7,104669268,1.0398111747495875,9932,6346,16278,+
chr7,104669287,2.742113895563947,2764,1941,4705,+
chr7,104669388,2.494082356086588,992,580,1572,+
chr7,104669391,1.6175388620720135,1838,1332,3170,+
chr7,104669393,1.542320753954366,2416,1720,4136,+
chr7,104669396,1.607267645003494,574,476,1050,+
chr7,104670442,1.0242148581556885,680,573,1253,+
chr7,107201699,2.8757334734764046,1039,789,1828,+
chr7,107917398,1.337098408535495,2990,1765,4755,+
chr7,107917400,2.348744128079762,1660,1097,2757,+
chr7,107919017,1.233156635395444,634,456,1090,+
chr7,112327811,2.6968186134852803,613,467,1080,+
chr7,112327813,2.6968186134852803,613,467,1080,+
chr7,112340980,3.291228605627461,569,433,1002,+
chr7,112461891,0.5605769230769231,582,467,1049,+
chr7,112462318,1.1980408424283429,793,588,1381,+
chr7,116234571,3.0708154792303626,615,444,1059,+
chr7,116252366,2.350947603121516,658,389,1047,+
chr7,116252367,2.350947603121516,658,389,1047,+
chr7,116526660,1.4671460562196474,670,582,1252,+
chr7,116699495,0.7129407747164832,1029,547,1576,+
chr7,116771592,3.9484813869103608,635,428,1063,+
chr7,116904233,3.4746031746031747,596,419,1015,+
chr7,116916059,2.3745266132562084,723,518,1241,+
chr7,116916089,3.3109217171717167,616,395,1011,+
chr7,116916090,3.3109217171717167,616,395,1011,+
chr7,116917910,0.5485714285714286,663,414,1077,+
chr7,116918325,1.887515356265356,792,591,1383,+
chr7,118185682,2.0294117647058822,620,390,1010,+
chr7,118188338,0.5225042301184434,771,590,1361,+
chr7,118191925,3.56514604529045,638,553,1191,+
chr7,125034270,1.5211640211640214,969,755,1724,+
chr7,125034272,1.5211640211640214,969,755,1724,+
chr7,125034274,1.1811926075523491,2094,1432,3526,+
chr7,125034275,1.057275815973615,2429,1901,4330,+
chr7,125034276,1.1811926075523491,2094,1432,3526,+
chr7,127589084,3.7640896726134985,676,520,1196,+
chr7,127590108,3.5979020979020984,685,571,1256,+
chr7,127590109,3.5979020979020984,685,571,1256,+
chr7,127590116,3.146519072401855,796,639,1435,+
chr7,127590999,1.2501731789983312,619,472,1091,+
chr7,127591627,14.558263555204878,765,386,1151,+
chr7,127591628,12.618659715273319,975,466,1441,+
chr7,127591639,11.62705521103817,1511,981,2492,+
chr7,127591640,12.031684916530894,1624,1041,2665,+
chr7,127591646,15.225162365611002,1366,1246,2612,+
chr7,127591647,15.225162365611002,1366,1246,2612,+
chr7,127591650,7.767609183243385,532,552,1084,+
chr7,127686703,2.2219035076434634,1171,925,2096,+
chr7,127686704,2.515178571428572,625,559,1184,+
chr7,127694861,1.6336238198983293,817,611,1428,+
chr7,127694900,1.7354464285714286,626,447,1073,+
chr7,127694921,2.1138695796094007,617,476,1093,+
chr7,127698897,2.2024602559797857,1137,914,2051,+
chr7,127698911,1.8146888813328799,592,518,1110,+
chr7,127701170,1.7415051598288445,813,547,1360,+
chr7,127701212,2.15878679750223,604,412,1016,+
chr7,127701261,0.6009656347628516,528,502,1030,+
chr7,127702434,1.9841741328019031,1108,751,1859,+
chr7,127703169,0.9788013797068124,1541,993,2534,+
chr7,127703170,0.8724122554042012,2156,1464,3620,+
chr7,127703198,0.2667391304347826,817,551,1368,+
chr7,127703199,2.15878345018268,642,532,1174,+
chr7,127703205,1.5484320557491291,1009,699,1708,+
chr7,127703220,0.574992574992575,1209,776,1985,+
chr7,127704844,1.9945229234888953,1495,1070,2565,+
chr7,127704923,1.9420621250139363,1811,1309,3120,+
chr7,127721287,1.9600978246878624,563,456,1019,+
chr7,127807487,0.6531958762886598,692,484,1176,+
chr7,127807492,1.5279460621457883,822,601,1423,+
chr7,127807525,2.1264843087362166,646,523,1169,+
chr7,127887981,1.9065253631817096,592,493,1085,+
chr7,127929193,2.1940128836680564,964,636,1600,+
chr7,127929234,3.840346534653465,534,504,1038,+
chr7,128074517,2.6822597378100537,631,460,1091,+
chr7,128074519,3.3734227503009113,1508,1080,2588,+
chr7,128074526,3.487717302386622,1068,807,1875,+
chr7,128074539,0.27508361204013376,657,505,1162,+
chr7,128074541,0.27508361204013376,657,505,1162,+
chr7,128074613,1.163054580749474,752,570,1322,+
chr7,128074642,1.8296622613803235,622,453,1075,+
chr7,128081366,2.324883271678717,850,592,1442,+
chr7,128081486,2.486320109439124,726,429,1155,+
chr7,128084792,2.71497919556172,674,514,1188,+
chr7,128087006,0.5550239234449761,695,417,1112,+
chr7,128089527,0.7284948148229194,1366,985,2351,+
chr7,128089528,0.9259234893589029,852,706,1558,+
chr7,128089564,3.113012224823248,623,511,1134,+
chr7,128089597,1.3858589904336343,1036,743,1779,+
chr7,128089672,1.0103233642022165,1209,940,2149,+
chr7,128089673,1.0103233642022165,1209,940,2149,+
chr7,128091839,1.0923276421007129,682,660,1342,+
chr7,128091841,0.7922210154765137,1060,1015,2075,+
chr7,128091842,0.6242759843014886,2491,1996,4487,+
chr7,128091844,0.349439550469724,795,726,1521,+
chr7,128092213,7.471397746467269,1000,395,1395,+
chr7,128092222,26.834760163626104,3278,2047,5325,+
chr7,128092223,26.834760163626104,3278,2047,5325,+
chr7,128092242,8.642880059409126,3334,3158,6492,+
chr7,128092243,8.642880059409126,3334,3158,6492,+
chr7,128092429,0.5551724876335682,893,696,1589,+
chr7,128092503,1.9229079497907953,592,477,1069,+
chr7,128479400,0.8762761476404656,721,482,1203,+
chr7,128479402,0.8762761476404656,721,482,1203,+
chr7,128739407,1.2261010768170009,1013,713,1726,+
chr7,128748576,0.7942399617247797,1518,1184,2702,+
chr7,128748577,1.716796875,878,511,1389,+
chr7,128748622,2.6110758489368453,1096,821,1917,+
chr7,128748641,1.8896705146705148,1185,923,2108,+
chr7,128754275,1.7646819752082912,1001,776,1777,+
chr7,128754386,1.7105960264900664,1007,754,1761,+
chr7,128754429,1.4074688796680501,1247,722,1969,+
chr7,128754694,2.0454630017666973,1586,1191,2777,+
chr7,128758871,1.5372367745249098,1557,1120,2677,+
chr7,128758877,1.39875283446712,1897,1259,3156,+
chr7,128758936,1.266336806312394,1598,1217,2815,+
chr7,128759813,1.4063714063714066,1809,1286,3095,+
chr7,128767460,2.1233003446890395,4341,2865,7206,+
chr7,128767461,2.1233003446890395,4341,2865,7206,+
chr7,128767600,1.5092271578187069,2013,1419,3432,+
chr7,128767635,1.2275530888709574,5499,3442,8941,+
chr7,128769084,1.5193865002204332,1678,1213,2891,+
chr7,128769144,1.8775241548893467,2723,2118,4841,+
chr7,128769145,1.8679389185115713,3959,3177,7136,+
chr7,128769432,1.2740053718314588,3372,2219,5591,+
chr7,128769466,1.432701873652794,1749,1303,3052,+
chr7,128769754,2.299753289473684,1315,911,2226,+
chr7,128769769,1.4762026612077788,1281,976,2257,+
chr7,128770094,1.8508735868448098,1304,972,2276,+
chr7,128770576,0.1693818945773411,647,469,1116,+
chr7,128770578,0.3587837674752505,976,727,1703,+
chr7,128770583,1.3737416777629827,991,750,1741,+
chr7,128770584,1.3737416777629827,991,750,1741,+
chr7,128770585,1.5768503107908303,2813,2020,4833,+
chr7,128770587,1.1026009639769465,2488,1977,4465,+
chr7,128770588,1.2422859542918707,2145,1934,4079,+
chr7,128770589,0.9400279260151873,2193,1412,3605,+
chr7,128770590,1.0493164330284697,3716,2790,6506,+
chr7,128770592,1.0131751687921982,2400,1332,3732,+
chr7,128770593,1.1792961711952363,6241,4052,10293,+
chr7,128770595,1.1214092331493266,2585,1433,4018,+
chr7,128770599,1.5321357285429142,1671,1001,2672,+
chr7,128770601,1.9951571637426901,1984,1367,3351,+
chr7,128770655,0.636317907444668,1264,1007,2271,+
chr7,128770836,1.8001310494222396,3011,2092,5103,+
chr7,128770953,2.1837500381658055,5476,4102,9578,+
chr7,128770955,1.7291368071593984,4952,3675,8627,+
chr7,128771176,1.4400302686341282,1037,880,1917,+
chr7,128771261,1.5586640022837568,1399,1129,2528,+
chr7,128862854,0.9944134433669448,1169,966,2135,+
chr7,128862855,0.8728403553834102,1975,1404,3379,+
chr7,128862860,0.6044315837173875,1949,1151,3100,+
chr7,128862863,0.5252475319973183,1391,896,2287,+
chr7,128862864,1.3620557681793328,1383,707,2090,+
chr7,128862889,2.0734264867704506,1616,1164,2780,+
chr7,128862890,1.4862442040185473,2403,1293,3696,+
chr7,128862915,2.7509334260025686,12750,7660,20410,+
chr7,128862916,2.7372494010245085,14180,8678,22858,+
chr7,128862917,2.0716190477568643,5863,3319,9182,+
chr7,128862932,1.6926467641755158,2303,1952,4255,+
chr7,128862941,1.6836921015639668,4542,2875,7417,+
chr7,128862944,1.8677309977097047,3694,1995,5689,+
chr7,128862946,1.8677309977097047,3694,1995,5689,+
chr7,128862954,1.3407324058919805,4368,2547,6915,+
chr7,128862955,1.134355371437315,9840,6869,16709,+
chr7,128862958,1.415295028155782,5052,3269,8321,+
chr7,128862975,1.3809844466500287,7279,4937,12216,+
chr7,128862983,1.6842639394486756,23959,19159,43118,+
chr7,128862984,1.801494589683566,4090,3301,7391,+
chr7,128862985,1.3178190967243422,9737,6996,16733,+
chr7,128862988,1.2047871736703142,10974,8865,19839,+
chr7,128862989,1.3009776383809122,17151,14037,31188,+
chr7,128862991,1.349316242707314,33203,25952,59155,+
chr7,128862992,1.338777537906137,27604,21402,49006,+
chr7,128862998,1.6474164425637767,15004,13833,28837,+
chr7,128862999,0.9586586336632289,57039,46650,103689,+
chr7,128863000,0.6709891965194283,46233,35931,82164,+
chr7,128863005,1.2013714724552358,18376,15094,33470,+
chr7,128863006,0.6288003168635049,9857,6877,16734,+
chr7,128865379,2.8436578171091447,963,564,1527,+
chr7,128865381,2.8436578171091447,963,564,1527,+
chr7,128865423,2.082219029941701,1033,775,1808,+
chr7,128865552,3.482739559538452,608,476,1084,+
chr7,128865664,1.9146370870508798,793,637,1430,+
chr7,128865767,1.8782470169703311,984,738,1722,+
chr7,131242829,1.0852267998335414,2209,1349,3558,+
chr7,131242831,1.1627223697581472,4311,3007,7318,+
chr7,131242836,1.4408603815658236,3551,2375,5926,+
chr7,131242908,1.9797034263825029,799,582,1381,+
chr7,131242909,2.4089861751152077,696,475,1171,+
chr7,131242911,2.964884318067839,673,484,1157,+
chr7,131242915,2.024563791920184,744,580,1324,+
chr7,131242927,1.4743278294353448,1366,1251,2617,+
chr7,131242928,1.5489675516224188,444,564,1008,+
chr7,131242929,1.4275678294573644,922,687,1609,+
chr7,131242935,2.0100664720741417,954,697,1651,+
chr7,131242940,1.8168805660935776,1467,952,2419,+
chr7,131242942,1.3386203818669102,2798,1948,4746,+
chr7,131242943,1.3377859682470286,2523,1839,4362,+
chr7,131242945,0.6637566519155343,1282,1357,2639,+
chr7,133275048,3.742604820653601,619,395,1014,+
chr7,134064776,38.089491432443765,1146,485,1631,+
chr7,134064777,30.68147666841517,1435,969,2404,+
chr7,134064780,7.967601062043752,756,1112,1868,+
chr7,134679225,2.116253101736973,921,519,1440,+
chr7,134679226,2.106791236719366,1344,795,2139,+
chr7,134679258,3.40725178960473,754,458,1212,+
chr7,134679260,3.3695408734602466,648,516,1164,+
chr7,134679265,2.165546844066503,2233,1698,3931,+
chr7,134679266,2.210549258936356,1382,1146,2528,+
chr7,134947719,2.3420429365342685,714,382,1096,+
chr7,134947742,3.7391874180865012,633,435,1068,+
chr7,134947743,3.0675513447611147,1251,779,2030,+
chr7,134947752,1.6670081502999634,1409,821,2230,+
chr7,134950392,1.6381482834185537,2096,1368,3464,+
chr7,134950394,1.6381482834185537,2096,1368,3464,+
chr7,134950398,1.6213832275309052,1010,729,1739,+
chr7,134950402,1.7488008592747895,1756,1191,2947,+
chr7,134950423,1.8468307233407901,853,446,1299,+
chr7,134950427,1.7536033868950256,1980,1093,3073,+
chr7,134950428,1.7536033868950256,1980,1093,3073,+
chr7,134950440,1.5636463180947169,1223,842,2065,+
chr7,134950447,1.843630316468454,1354,967,2321,+
chr7,134950458,0.6484935804532047,2622,2103,4725,+
chr7,134950460,1.6637678122380557,1607,1192,2799,+
chr7,134950470,2.5985915492957745,1844,1561,3405,+
chr7,134968505,2.932616446233468,667,508,1175,+
chr7,134968623,1.585944172509363,856,600,1456,+
chr7,134969697,2.610333835511785,687,516,1203,+
chr7,134970492,2.5068791771094405,669,547,1216,+
chr7,135571140,3.2279792746113993,622,385,1007,+
chr7,135571141,3.2279792746113993,622,385,1007,+
chr7,135587902,2.742810592891203,628,403,1031,+
chr7,135602949,2.6264695352438676,1092,773,1865,+
chr7,135619846,5.841721537560011,604,424,1028,+
chr7,135622839,1.1053361344537815,1421,679,2100,+
chr7,135622841,1.2696962003892698,2177,1052,3229,+
chr7,135622842,1.6804979253112031,1484,722,2206,+
chr7,135674326,2.8928571428571432,647,367,1014,+
chr7,135674328,2.8928571428571432,647,367,1014,+
chr7,137513815,1.0237414046318596,8995,7807,16802,+
chr7,137513816,0.955222787952847,115163,93156,208319,+
chr7,137513817,0.9554701725633256,115013,93098,208111,+
chr7,137513818,0.9616698193952554,155568,123420,278988,+
chr7,137513820,0.7805880343325137,79019,59354,138373,+
chr7,137721967,1.277985266740001,5143,3722,8865,+
chr7,137721968,0.9773211056787166,13054,9771,22825,+
chr7,137721969,1.0557590220966493,12534,9798,22332,+
chr7,137721970,0.7626230077655436,6194,4694,10888,+
chr7,137721977,1.0595565728084373,3731,3453,7184,+
chr7,137721980,1.1291228182759427,10242,8661,18903,+
chr7,139398612,2.686251002279011,639,448,1087,+
chr7,139407300,2.7195709746768335,573,436,1009,+
chr7,139409588,2.134389235739523,791,622,1413,+
chr7,139417657,2.561882685677312,766,451,1217,+
chr7,139417677,2.205984504408229,1435,787,2222,+
chr7,139417679,2.205984504408229,1435,787,2222,+
chr7,139417690,2.401178125549499,880,516,1396,+
chr7,139417699,1.683941058941059,898,571,1469,+
chr7,139417715,1.8555856110460656,1120,798,1918,+
chr7,139422168,1.4825709515859766,1082,598,1680,+
chr7,139422174,1.4173847729924451,3935,2311,6246,+
chr7,139422175,1.3471103582485155,4666,2952,7618,+
chr7,139422181,1.5301327885597549,1497,978,2475,+
chr7,139422201,1.679741920749115,2262,1667,3929,+
chr7,139422246,1.8888525661981037,962,804,1766,+
chr7,139422259,2.1953125,1123,1023,2146,+
chr7,139422492,3.7634776256237448,979,686,1665,+
chr7,139423047,10.814060223814247,1587,1461,3048,+
chr7,139423048,11.455778652525495,1408,1341,2749,+
chr7,140696736,5.020982030951416,763,642,1405,+
chr7,140696737,4.7691485476025886,873,738,1611,+
chr7,140696743,0.2325440400930069,663,519,1182,+
chr7,140702882,1.0426380368098158,1132,651,1783,+
chr7,140702884,1.0426380368098158,1132,651,1783,+
chr7,140702896,1.980444349229665,1101,802,1903,+
chr7,140702903,2.066318801548561,743,456,1199,+
chr7,140702920,1.5561349693251536,800,488,1288,+
chr7,140702990,1.61427048160654,981,661,1642,+
chr7,141738369,1.5185798086434323,697,495,1192,+
chr7,141738370,1.3336499953432057,694,499,1193,+
chr7,141738378,0.508411214953271,767,641,1408,+
chr7,141738400,0.7506960983043648,1996,1476,3472,+
chr7,141738424,2.4784602158754416,836,550,1386,+
chr7,141738425,25.71659481604431,1444,964,2408,+
chr7,141739133,0.5653623442709247,715,555,1270,+
chr7,141743933,1.688921933085502,630,537,1167,+
chr7,141743938,1.7510531242759066,1810,1560,3370,+
chr7,141745532,0.6609648880796042,1122,862,1984,+
chr7,143263544,3.5271852106623864,905,629,1534,+
chr7,143265051,2.418717940726494,647,480,1127,+
chr7,143265282,2.5769538623045176,948,510,1458,+
chr7,143267622,2.7663722205300028,716,468,1184,+
chr7,143267623,2.7663722205300028,716,468,1184,+
chr7,143268869,0.7210537147621772,759,628,1387,+
chr7,143383133,2.263607516152615,647,423,1070,+
chr7,148757039,1.2038352272727273,677,511,1188,+
chr7,148757041,1.2038352272727273,677,511,1188,+
chr7,148767647,1.6087281832635358,995,666,1661,+
chr7,148784006,2.3995924023803705,851,512,1363,+
chr7,148784018,1.261439524723904,847,544,1391,+
chr7,148784026,0.9428770059672094,650,420,1070,+
chr7,148784027,0.9428770059672094,650,420,1070,+
chr7,148788571,2.0735468736424454,2202,1605,3807,+
chr7,148788572,1.854994778606491,3350,2344,5694,+
chr7,148788575,1.6937698618081058,2483,1739,4222,+
chr7,148788584,1.5970772442588728,3624,2394,6018,+
chr7,148788585,1.5970772442588728,3624,2394,6018,+
chr7,148941487,0.9935751068791294,1664,1487,3151,+
chr7,148941533,0.8576917482851848,4497,3422,7919,+
chr7,148941534,1.0001933123707685,3243,2208,5451,+
chr7,149334261,0.7132799670135708,1268,876,2144,+
chr7,149334262,1.2474400816596392,1047,800,1847,+
chr7,150373207,0.4597883118122613,620,487,1107,+
chr7,150373208,0.4597883118122613,620,487,1107,+
chr7,150373231,3.821465756123362,708,491,1199,+
chr7,150373290,1.6723981900452491,846,714,1560,+
chr7,150373291,1.6932088241086545,1342,1044,2386,+
chr7,150373425,1.2052964042759962,725,503,1228,+
chr7,150373426,1.2052964042759962,725,503,1228,+
chr7,150373454,0.3547418967587035,590,475,1065,+
chr7,150373461,1.8573619631901843,691,325,1016,+
chr7,150373467,2.088572655339508,1361,958,2319,+
chr7,150373468,2.088572655339508,1361,958,2319,+
chr7,151087007,0.7434616406391723,728,493,1221,+
chr7,152094438,1.3294631928658858,1187,664,1851,+
chr7,152094439,1.3294631928658858,1187,664,1851,+
chr7,152094440,1.1096660430942946,1510,861,2371,+
chr7,152094446,2.0907811167945436,710,486,1196,+
chr7,155298290,1.270141414967311,665,464,1129,+
chr7,155298558,2.2402082614501686,786,528,1314,+
chr7,155301580,2.0606570564871785,762,605,1367,+
chr7,155301597,0.6030032467532468,781,559,1340,+
chr7,155301610,1.8973684210526314,720,436,1156,+
chr7,155301621,1.6572192513368984,1032,769,1801,+
chr7,155302389,1.6292287304290238,1790,1267,3057,+
chr7,155302401,1.9356805807622501,807,550,1357,+
chr7,155302750,1.8173462566844918,749,543,1292,+
chr7,155302770,2.4802426134998803,1058,723,1781,+
chr7,155302788,1.4875195726259558,1291,923,2214,+
chr7,155302835,1.9763353617308994,1105,608,1713,+
chr7,155308242,2.9477751132427388,850,416,1266,+
chr7,155308250,1.840813464235624,1049,551,1600,+
chr7,155308285,2.4885714285714284,1728,949,2677,+
chr7,155308291,1.3896191081902338,2347,1271,3618,+
chr7,155308308,1.3825617161225114,5672,3261,8933,+
chr7,155308309,1.3778832531361007,8884,5155,14039,+
chr7,155308311,1.0525302675460178,22930,12945,35875,+
chr7,155308312,0.8834310314575461,29474,16629,46103,+
chr7,155308313,0.9134698785807349,36814,21072,57886,+
chr7,155308314,0.6601759581409575,14131,7250,21381,+
chr7,155308315,0.9723043308972578,13925,8484,22409,+
chr7,155308321,1.8648983160340855,9411,6204,15615,+
chr7,155308322,1.8648983160340855,9411,6204,15615,+
chr7,155308327,1.6486449950953355,10351,6268,16619,+
chr7,155308332,1.6554453883175972,12588,6471,19059,+
chr7,155308334,1.6554453883175972,12588,6471,19059,+
chr7,155308369,1.6762603130824574,1952,1504,3456,+
chr7,155308436,1.8966841399487995,840,630,1470,+
chr7,155308517,0.560431654676259,778,555,1333,+
chr7,155308746,2.091173361522199,771,687,1458,+
chr7,155308748,2.091173361522199,771,687,1458,+
chr7,155308756,0.6092221704704238,653,451,1104,+
chr7,155308850,2.126581361813648,1294,900,2194,+
chr7,155308932,1.0594311880127367,1430,1236,2666,+
chr7,155309067,1.85831856166118,1128,717,1845,+
chr7,155309098,0.5474867965762157,1949,1291,3240,+
chr7,155309099,1.1501822262042276,3628,2106,5734,+
chr7,155309105,2.062259348691509,1999,1392,3391,+
chr7,155309147,1.5325526647837553,6888,3393,10281,+
chr7,155309174,2.273714230595938,19081,10567,29648,+
chr7,155309176,2.273714230595938,19081,10567,29648,+
chr7,155309480,1.4828603583051982,1107,842,1949,+
chr7,155309603,2.5720502901353965,590,516,1106,+
chr7,155309808,2.009807126511932,635,398,1033,+
chr7,155309819,2.2739110911540186,632,392,1024,+
chr7,155309846,1.8034257748776508,736,612,1348,+
chr7,155309937,0.6905621096460793,962,654,1616,+
chr7,155310151,2.0429495073891624,576,447,1023,+
chr7,157174971,1.9329841525651357,777,437,1214,+
chr7,157174975,1.910978803325702,1666,938,2604,+
chr7,157182229,2.8995058672214284,628,576,1204,+
chr7,157192324,0.9984455958549224,2236,1929,4165,+
chr7,157192328,0.9503562065078898,5149,3400,8549,+
chr7,157192329,0.9503562065078898,5149,3400,8549,+
chr7,157231264,2.5359032501889645,670,440,1110,+
chr7,157231265,2.5359032501889645,670,440,1110,+
chr7,157267998,0.356057752820541,1114,754,1868,+
chr7,157268489,8.27370673929542,1167,812,1979,+
chr7,157268490,9.547158446792904,1280,935,2215,+
chr8,1926416,2.717752355319524,1099,670,1769,+
chr8,6757455,2.5805916696154507,614,419,1033,+
chr8,11790023,2.493674089068826,656,493,1149,+
chr8,11790024,2.493674089068826,656,493,1149,+
chr8,11790054,1.055727477695153,874,702,1576,+
chr8,11790055,0.9589683961620917,1004,819,1823,+
chr8,11790062,1.0611398132837335,666,547,1213,+
chr8,11790067,1.0781891559922794,797,694,1491,+
chr8,11790068,0.9700035760876208,1838,1705,3543,+
chr8,11790069,1.1378290659935089,543,589,1132,+
chr8,11790070,1.0654012234616768,910,793,1703,+
chr8,11802796,1.393360433604336,790,491,1281,+
chr8,11802797,2.5095785440613025,654,347,1001,+
chr8,11802798,1.854990478984732,1193,679,1872,+
chr8,11802865,1.987083954297069,749,548,1297,+
chr8,11802890,1.9825777777777776,815,674,1489,+
chr8,11808826,0.5979210805084746,820,471,1291,+
chr8,11809682,1.0739882105335314,1548,1082,2630,+
chr8,11809690,1.578591251586704,1723,1260,2983,+
chr8,11809716,2.5070531400966183,997,620,1617,+
chr8,11809742,1.4251303935514463,1155,739,1894,+
chr8,11809746,2.7142857142857144,1315,986,2301,+
chr8,11826108,1.4496620670233735,1395,1071,2466,+
chr8,11826131,2.052785923753665,1359,1053,2412,+
chr8,11826147,1.5027746947835738,1353,1070,2423,+
chr8,11830316,1.45759587020649,1205,903,2108,+
chr8,11830349,2.118560772268539,1237,1059,2296,+
chr8,11830353,1.3427214125637146,3297,2769,6066,+
chr8,11830381,1.329612391123815,2373,1706,4079,+
chr8,11831527,1.7420926449594776,2691,1836,4527,+
chr8,11831536,0.43790627487080996,4292,3017,7309,+
chr8,11831550,0.6084100030873727,1448,1024,2472,+
chr8,11831581,0.6102987921169739,1439,857,2296,+
chr8,11838396,1.4958144963894042,2562,2250,4812,+
chr8,11838397,1.4958144963894042,2562,2250,4812,+
chr8,11838483,2.0350705329153604,1221,927,2148,+
chr8,11838511,1.6357315684502376,2508,1807,4315,+
chr8,11838550,1.876134356430719,3863,2832,6695,+
chr8,11838606,2.661497124701078,2075,1463,3538,+
chr8,17286403,1.1386890183061336,622,503,1125,+
chr8,17548746,3.1481837401499133,584,472,1056,+
chr8,17548747,2.7208680512374084,892,730,1622,+
chr8,17548749,2.469123505976096,602,501,1103,+
chr8,17565981,1.6791791791791792,989,665,1654,+
chr8,17565994,1.7379297242683571,2140,1630,3770,+
chr8,17565995,1.862843111461896,3267,2533,5800,+
chr8,17565997,1.928272154245458,2212,1739,3951,+
chr8,17566008,2.144464720194647,1281,1095,2376,+
chr8,17567854,1.4445913289643764,614,420,1034,+
chr8,17568387,3.3436225895316816,801,519,1320,+
chr8,17570160,1.9541130709114,587,459,1046,+
chr8,17937332,2.546117263113281,1175,626,1801,+
chr8,19334845,0.9726744186046513,716,515,1231,+
chr8,19334847,0.9726744186046513,716,515,1231,+
chr8,19395852,1.9617572254335258,1073,864,1937,+
chr8,19395853,2.2128875055299937,1395,1069,2464,+
chr8,19395856,2.8305264754968897,582,506,1088,+
chr8,19395859,1.9892424921559835,1267,1163,2430,+
chr8,19395860,2.014860748315521,1658,1426,3084,+
chr8,19818278,4.361094395629014,751,521,1272,+
chr8,19820380,0.4238865061035962,583,432,1015,+
chr8,19820381,1.0872539438782634,648,550,1198,+
chr8,19820382,1.0872539438782634,648,550,1198,+
chr8,19820454,2.766690856313498,609,423,1032,+
chr8,19823904,1.8105943152454784,636,386,1022,+
chr8,19823947,0.576022048690859,797,621,1418,+
chr8,19832028,2.0695389266817843,591,440,1031,+
chr8,19837103,1.9829293620936932,965,647,1612,+
chr8,19939489,5.384321912779303,669,445,1114,+
chr8,19953310,2.619047619047619,615,391,1006,+
chr8,19953312,1.8944163746084512,859,611,1470,+
chr8,19953399,0.4815375655212579,635,504,1139,+
chr8,19954289,1.696106821106821,810,443,1253,+
chr8,19955911,2.3121367483757576,1494,1076,2570,+
chr8,19955912,2.3343659539891317,977,678,1655,+
chr8,19959284,1.515861240638689,912,673,1585,+
chr8,19960913,0.5273925892248238,695,497,1192,+
chr8,19960982,1.6403075968904048,1861,1270,3131,+
chr8,19961049,2.0217803030303028,1189,815,2004,+
chr8,19961055,1.8604344963791968,1255,867,2122,+
chr8,19961056,1.7336136265631734,1236,772,2008,+
chr8,19961069,2.0996229412037346,3109,2214,5323,+
chr8,19965434,1.687642730271505,738,562,1300,+
chr8,19965561,2.1761991816836423,861,546,1407,+
chr8,19965646,2.2088641188959657,573,470,1043,+
chr8,19965727,1.9749565217391305,834,574,1408,+
chr8,19965909,1.8476837865055389,894,661,1555,+
chr8,19965968,2.9191146881287726,805,496,1301,+
chr8,19966007,2.6700531580120552,1352,1051,2403,+
chr8,19966247,3.491578947368422,641,569,1210,+
chr8,19966266,1.7869759143621766,625,589,1214,+
chr8,19966357,1.938094134013448,642,453,1095,+
chr8,19966422,2.1416826380790335,1599,1154,2753,+
chr8,19966429,2.0435922330097087,678,514,1192,+
chr8,19966435,3.6246980676328495,685,551,1236,+
chr8,19966564,0.6263106388927723,895,621,1516,+
chr8,19966616,2.160864345738295,1199,832,2031,+
chr8,19966617,1.4380962824871146,995,828,1823,+
chr8,19966625,2.2939778129952457,964,630,1594,+
chr8,19966672,2.066532258064516,614,464,1078,+
chr8,19966715,1.8946445372848915,1246,938,2184,+
chr8,22245552,4.820017961093103,719,438,1157,+
chr8,22245554,3.72798184398954,628,391,1019,+
chr8,22245557,2.7173399154883797,730,442,1172,+
chr8,22245569,2.86322188449848,627,516,1143,+
chr8,22245571,2.86322188449848,627,516,1143,+
chr8,22245577,0.615240818490875,1492,1235,2727,+
chr8,22245578,0.6595769961977186,1280,1051,2331,+
chr8,22245579,0.6595769961977186,1280,1051,2331,+
chr8,22245586,0.6129310344827587,631,463,1094,+
chr8,22245591,1.7171110317279905,704,580,1284,+
chr8,22245593,0.9841377165343684,1653,1012,2665,+
chr8,22245594,0.9841377165343684,1653,1012,2665,+
chr8,22248577,3.9152731326644368,877,758,1635,+
chr8,22248578,3.9152731326644368,877,758,1635,+
chr8,22248610,2.3834745762711864,584,471,1055,+
chr8,25243676,2.3989708404802745,776,582,1358,+
chr8,25243677,2.1084322483527878,1067,826,1893,+
chr8,25243678,2.1084322483527878,1067,826,1893,+
chr8,25243679,1.3674631588300477,1695,1255,2950,+
chr8,25243681,1.352125314153492,1836,1170,3006,+
chr8,25243682,1.9393863309124493,1505,977,2482,+
chr8,28162058,2.608320493066256,735,589,1324,+
chr8,28162060,2.608320493066256,735,589,1324,+
chr8,30028665,1.6663432381840966,605,490,1095,+
chr8,30156368,0.8987281443386457,1065,817,1882,+
chr8,30164114,1.138345727519613,851,597,1448,+
chr8,30175115,3.346978557504873,908,512,1420,+
chr8,30175116,3.346978557504873,908,512,1420,+
chr8,30183357,2.076655261420253,934,616,1550,+
chr8,30352047,1.6306397306397304,667,539,1206,+
chr8,30352212,0.5780793267361398,1217,928,2145,+
chr8,30352213,0.8526954177897573,702,423,1125,+
chr8,30352218,2.4489251656699533,818,537,1355,+
chr8,30352220,2.3756956674885523,1248,834,2082,+
chr8,30352221,2.2331154684095864,849,577,1426,+
chr8,30352229,0.5318990175351325,909,945,1854,+
chr8,30352231,0.850153600544229,2403,2073,4476,+
chr8,30352232,1.0751894498572974,1494,1128,2622,+
chr8,30352246,1.7457142857142856,610,489,1099,+
chr8,30352260,0.7425114936776126,4415,3311,7726,+
chr8,30352261,1.47595589960122,1143,1014,2157,+
chr8,30352267,0.6289110497729499,3070,2041,5111,+
chr8,30352269,2.327732773277328,1329,1211,2540,+
chr8,30352272,0.6829587438423645,2334,2029,4363,+
chr8,33500463,0.9689532457970302,751,561,1312,+
chr8,33500465,0.9689532457970302,751,561,1312,+
chr8,33500493,1.7295768747381652,717,433,1150,+
chr8,33500502,1.6785547785547785,757,571,1328,+
chr8,33500503,2.0986725663716808,836,564,1400,+
chr8,38030541,1.9631321424394645,1103,887,1990,+
chr8,38030543,1.3580004145450868,2429,2089,4518,+
chr8,38030544,0.8816506762105094,1326,1202,2528,+
chr8,38030567,1.992119089316988,584,570,1154,+
chr8,38030573,1.640290519877676,612,435,1047,+
chr8,38030669,2.958589945323924,642,408,1050,+
chr8,38057089,1.8192461908580595,596,429,1025,+
chr8,38057095,0.7616112342941611,768,549,1317,+
chr8,38057101,1.8797115699770568,929,677,1606,+
chr8,38057102,0.4972570532915361,845,579,1424,+
chr8,38057104,1.6213092805299132,718,616,1334,+
chr8,38057218,1.0904582975765236,1446,1031,2477,+
chr8,38057231,1.6719478098788445,896,517,1413,+
chr8,38057243,1.4807394116963222,2017,1359,3376,+
chr8,38059930,1.404484069752196,1338,1051,2389,+
chr8,38059992,2.3904715127701373,941,508,1449,+
chr8,38060019,1.7275360319977933,1065,852,1917,+
chr8,38060066,2.3744591275874165,751,502,1253,+
chr8,38060074,1.6591591591591592,1954,1034,2988,+
chr8,38060075,1.6876337224831701,2730,1601,4331,+
chr8,38060192,1.8194680249009625,642,464,1106,+
chr8,38060208,2.565187239944521,1369,1029,2398,+
chr8,38060210,2.565187239944521,1369,1029,2398,+
chr8,38060241,1.6283849918433935,712,612,1324,+
chr8,39016154,1.2693806036153252,845,614,1459,+
chr8,39017325,2.1900301868156546,1001,755,1756,+
chr8,39017326,2.594287988854612,868,772,1640,+
chr8,39017328,2.857570093457944,587,534,1121,+
chr8,39018855,2.520145027708053,692,498,1190,+
chr8,39026681,1.4338512315819159,641,480,1121,+
chr8,39054509,0.9859912268289232,803,572,1375,+
chr8,39054510,1.347037570389458,1014,745,1759,+
chr8,39055679,1.228835096915343,903,743,1646,+
chr8,39082983,1.679435880543043,676,487,1163,+
chr8,39103773,2.3548087899543377,942,583,1525,+
chr8,39103775,2.3548087899543377,942,583,1525,+
chr8,39104162,1.5805749128919857,763,573,1336,+
chr8,39104776,0.4950700570835495,635,375,1010,+
chr8,40153481,0.9875612371796672,871,259,1130,+
chr8,40153482,1.0591341148122293,1085,326,1411,+
chr8,40153491,2.5876896692280824,813,335,1148,+
chr8,40153492,2.508979287379748,741,450,1191,+
chr8,40153495,6.007692307692308,709,324,1033,+
chr8,40153497,6.007692307692308,709,324,1033,+
chr8,40153506,0.8909757214841959,777,766,1543,+
chr8,40153508,0.8909757214841959,777,766,1543,+
chr8,40153628,1.5200671140939597,780,595,1375,+
chr8,40153629,0.6022143698468786,1161,848,2009,+
chr8,40153643,1.9174854779890413,4886,4012,8898,+
chr8,40153644,1.9174854779890413,4886,4012,8898,+
chr8,40153647,1.750154334597407,881,781,1662,+
chr8,40153650,1.4179803425804423,4089,3676,7765,+
chr8,40153651,1.4939068100358424,2083,1952,4035,+
chr8,40153653,1.2198982888001724,2556,2277,4833,+
chr8,40153658,2.2035123966942147,947,725,1672,+
chr8,40153662,1.5078544009147583,1748,1596,3344,+
chr8,40153665,1.1893547786186778,10217,8958,19175,+
chr8,40153666,1.2239247275281535,7816,7049,14865,+
chr8,40153667,1.0701245487951612,2401,1909,4310,+
chr8,40153672,0.6767862930795856,2918,2530,5448,+
chr8,40153674,1.200638309356311,12598,11634,24232,+
chr8,40153675,1.276151168624287,10949,10394,21343,+
chr8,40154031,1.4149047833258361,1347,987,2334,+
chr8,40154292,5.126740301968433,4942,1563,6505,+
chr8,40154293,5.126740301968433,4942,1563,6505,+
chr8,40154298,18.052422657181,5105,2565,7670,+
chr8,40154299,18.052422657181,5105,2565,7670,+
chr8,40154302,3.066643777281781,2674,1742,4416,+
chr8,40154307,16.08623178982598,5618,7634,13252,+
chr8,40154308,16.08623178982598,5618,7634,13252,+
chr8,40154313,0.4867405693052342,4219,8191,12410,+
chr8,40154314,0.46024766329484323,1922,4050,5972,+
chr8,40154317,0.21625905797101452,954,2207,3161,+
chr8,40154352,0.5024946543121881,1268,2012,3280,+
chr8,40154484,1.8014343974124596,853,546,1399,+
chr8,40154555,2.1369651142808044,828,528,1356,+
chr8,42169395,2.3091575091575094,1181,935,2116,+
chr8,42169396,2.3091575091575094,1181,935,2116,+
chr8,42169397,2.3091575091575094,1181,935,2116,+
chr8,42169481,3.4901954777802233,650,475,1125,+
chr8,42329170,1.7656229894112905,613,467,1080,+
chr8,42393857,1.973456790123456,694,539,1233,+
chr8,42393858,1.973456790123456,694,539,1233,+
chr8,42395097,0.9759538706907128,1074,714,1788,+
chr8,42395098,0.9759538706907128,1074,714,1788,+
chr8,42398813,1.6113069981473735,792,576,1368,+
chr8,42403404,3.2488167680865447,774,492,1266,+
chr8,42404899,4.0363349131121655,729,421,1150,+
chr8,42404900,4.0363349131121655,729,421,1150,+
chr8,42405394,2.093599739301713,1234,917,2151,+
chr8,42405482,1.9332371174160616,1258,836,2094,+
chr8,42405504,1.8830697674418608,652,429,1081,+
chr8,42405509,3.036420293560637,1101,786,1887,+
chr8,42405566,1.8471635150166847,873,619,1492,+
chr8,43084832,1.8936420198858075,600,476,1076,+
chr8,47157578,0.9904058525982795,611,408,1019,+
chr8,47157588,0.5638699325062374,3189,2468,5657,+
chr8,47157590,0.6263277210634038,2233,1888,4121,+
chr8,47157591,1.2492129989825842,1696,1077,2773,+
chr8,47157595,1.259139532149994,2315,1503,3818,+
chr8,47279876,2.6499388218850166,677,496,1173,+
chr8,47963003,3.0533333333333332,686,449,1135,+
chr8,47964578,1.5240581241743638,1565,1182,2747,+
chr8,47964613,1.781630170316302,706,547,1253,+
chr8,47967419,2.217286618596388,870,596,1466,+
chr8,47970552,3.0023768852159525,953,612,1565,+
chr8,47970646,1.8719616356794557,710,470,1180,+
chr8,47970690,2.0796559325536617,1159,648,1807,+
chr8,47970692,2.5384297710273938,921,588,1509,+
chr8,47970695,2.0335871025526195,955,637,1592,+
chr8,47970698,2.6403162055335967,1001,712,1713,+
chr8,47970709,0.28894142369319675,824,485,1309,+
chr8,47970716,0.5085673959068455,1125,544,1669,+
chr8,47970717,1.5667893931245602,1305,1050,2355,+
chr8,47970722,1.5641189918511234,4844,3165,8009,+
chr8,47970734,1.867749419953596,1679,861,2540,+
chr8,47970749,0.5796193425006829,2447,2084,4531,+
chr8,47970764,0.9794078258408017,5110,3586,8696,+
chr8,47970774,1.8653557806950198,5616,3984,9600,+
chr8,47970775,1.8653557806950198,5616,3984,9600,+
chr8,47970784,1.240957924864121,10910,7881,18791,+
chr8,47970787,1.4119006431129923,7905,4735,12640,+
chr8,47970789,1.4119006431129923,7905,4735,12640,+
chr8,47975803,1.6629749460759915,852,587,1439,+
chr8,47977301,1.357001512218602,819,537,1356,+
chr8,47977776,3.4766020864381515,863,670,1533,+
chr8,47977777,3.4766020864381515,863,670,1533,+
chr8,47977787,1.7818432552475107,1630,1033,2663,+
chr8,47977789,1.7818432552475107,1630,1033,2663,+
chr8,48049887,1.8798968204105224,930,626,1556,+
chr8,48061159,1.7563232160744895,684,582,1266,+
chr8,54136539,1.7585317051852973,914,672,1586,+
chr8,54136621,1.2467808106262954,818,630,1448,+
chr8,54142739,2.250188794778805,640,405,1045,+
chr8,54147669,2.3441295546558703,578,436,1014,+
chr8,54147785,2.464873879508026,738,532,1270,+
chr8,55952097,1.8904175477376566,623,500,1123,+
chr8,58565019,2.3306504410371316,741,443,1184,+
chr8,58565028,0.4423414565629609,662,490,1152,+
chr8,58565029,0.4279451224530566,931,698,1629,+
chr8,58570925,0.2467706013363029,553,448,1001,+
chr8,58572208,1.6017316017316017,591,461,1052,+
chr8,58572237,1.852176027230732,585,456,1041,+
chr8,58578164,1.749445097482672,1698,1203,2901,+
chr8,58581865,1.8306390262457206,712,477,1189,+
chr8,58581867,2.5448275862068965,737,463,1200,+
chr8,58581884,1.2164666931728865,2169,1523,3692,+
chr8,58581897,1.5956367326230338,739,656,1395,+
chr8,60591928,2.9283605968451685,675,568,1243,+
chr8,60620772,3.292815112772141,793,476,1269,+
chr8,61202480,1.172024047126562,2317,1620,3937,+
chr8,61202481,1.1886358462919657,3401,2531,5932,+
chr8,61203179,0.7496669477389591,588,505,1093,+
chr8,61578142,0.8429739893523202,764,1011,1775,+
chr8,61578143,0.8429739893523202,764,1011,1775,+
chr8,61578146,0.529960861440799,584,600,1184,+
chr8,61578628,1.058722849341864,865,462,1327,+
chr8,61578633,2.47155070754717,728,423,1151,+
chr8,61578634,2.47155070754717,728,423,1151,+
chr8,61578792,1.6692783505154638,879,499,1378,+
chr8,61578794,1.6932143905788972,1689,1065,2754,+
chr8,61578796,2.169040870606521,1543,987,2530,+
chr8,61578802,0.7656796518302941,868,558,1426,+
chr8,61578803,0.7656796518302941,868,558,1426,+
chr8,61578806,1.0199854436785594,1642,1011,2653,+
chr8,61578807,0.9264723223564325,2110,1288,3398,+
chr8,61578897,1.7095776658088795,1646,1058,2704,+
chr8,61578898,1.7121843201719429,1979,1236,3215,+
chr8,61578900,0.5615615615615616,832,332,1164,+
chr8,61578903,1.4115042578080776,1078,742,1820,+
chr8,61579176,1.000855017556419,967,831,1798,+
chr8,61579177,0.7828947368421052,758,417,1175,+
chr8,61579178,0.9372760728239549,843,708,1551,+
chr8,61579189,1.4678362573099413,1505,854,2359,+
chr8,61579193,1.514089443431936,1799,1018,2817,+
chr8,61579431,2.8554721997560994,1160,401,1561,+
chr8,61579432,2.6487093153759824,1474,494,1968,+
chr8,61579434,2.1904578930515535,1005,346,1351,+
chr8,61579437,2.3493048030146397,1276,529,1805,+
chr8,61579438,2.16222872094813,1755,711,2466,+
chr8,61579439,0.23741056367650953,651,362,1013,+
chr8,61579440,1.9250946104658748,1843,775,2618,+
chr8,61579441,2.1548835794196695,2086,933,3019,+
chr8,61579443,2.2134656547966536,1299,570,1869,+
chr8,66430643,27.401767131883492,1500,1726,3226,+
chr8,66430644,27.401767131883492,1500,1726,3226,+
chr8,69130127,0.36971723928245664,607,597,1204,+
chr8,69130129,0.36971723928245664,607,597,1204,+
chr8,69130236,1.0719864176570455,901,588,1489,+
chr8,69130237,1.0719864176570455,901,588,1489,+
chr8,69130238,2.034216432281626,1956,1221,3177,+
chr8,69130240,2.034216432281626,1956,1221,3177,+
chr8,69130243,2.1714961561206385,611,444,1055,+
chr8,73297333,0.6245336344552372,918,664,1582,+
chr8,73322970,2.747422409657291,566,452,1018,+
chr8,73322991,1.8409090909090908,674,449,1123,+
chr8,73323258,1.5367606412382533,833,602,1435,+
chr8,73323511,1.66875,978,659,1637,+
chr8,73323920,1.3743254219930092,756,537,1293,+
chr8,73981592,2.2937193160656846,672,402,1074,+
chr8,75376901,1.1169130611691307,674,504,1178,+
chr8,75376902,0.6957430711315694,1938,1338,3276,+
chr8,75376903,0.6034062412928392,989,591,1580,+
chr8,81753209,1.9689785626513827,779,442,1221,+
chr8,89924558,1.082939062195614,706,595,1301,+
chr8,89924559,0.5214372313457512,746,632,1378,+
chr8,89924560,0.5214372313457512,746,632,1378,+
chr8,89924561,0.19073418841220705,574,475,1049,+
chr8,89926120,6.478661997453429,1289,476,1765,+
chr8,89926121,6.478661997453429,1289,476,1765,+
chr8,89926124,22.78637969498387,1313,1295,2608,+
chr8,89926126,10.657240396846264,2012,2187,4199,+
chr8,89926127,4.995942003194958,1366,1584,2950,+
chr8,93922249,0.5573430692876272,670,382,1052,+
chr8,96262203,0.7745210114251397,788,504,1292,+
chr8,96295208,1.591711177846828,639,487,1126,+
chr8,96299739,2.302848807586102,678,412,1090,+
chr8,96299770,1.5830923248053392,592,434,1026,+
chr8,96333534,0.30547943258838656,712,531,1243,+
chr8,96333576,1.7475524475524473,832,494,1326,+
chr8,96333599,3.5304695304695306,588,454,1042,+
chr8,96333602,1.6888446215139443,627,501,1128,+
chr8,96333665,2.9360410830999064,661,356,1017,+
chr8,96333980,1.122396015352137,668,477,1145,+
chr8,96334266,3.081456953642384,845,603,1448,+
chr8,96493903,3.2356140027145024,947,651,1598,+
chr8,96602502,0.576104525862069,610,463,1073,+
chr8,96610266,2.067289719626168,631,427,1058,+
chr8,97686718,2.419809523809524,793,499,1292,+
chr8,97686720,2.419809523809524,793,499,1292,+
chr8,97690999,0.9704909355564376,771,457,1228,+
chr8,97691001,0.9704909355564376,771,457,1228,+
chr8,97706697,1.2874759174128427,801,555,1356,+
chr8,97706698,2.285346916300297,947,623,1570,+
chr8,97706716,2.431309904948034,657,480,1137,+
chr8,97719101,2.4384043272481413,643,492,1135,+
chr8,97719103,2.4384043272481413,643,492,1135,+
chr8,97722930,1.5516596205590016,748,659,1407,+
chr8,97722931,0.4371595426215831,523,496,1019,+
chr8,97724683,0.6252525252525252,618,404,1022,+
chr8,97724788,1.5055702917771885,1055,753,1808,+
chr8,97776013,2.0254616909851255,764,499,1263,+
chr8,97815329,1.6233096604728086,926,540,1466,+
chr8,97815366,2.6755555555555555,1189,764,1953,+
chr8,97816058,1.8325750584205835,1125,888,2013,+
chr8,97816073,1.8972536348949918,733,618,1351,+
chr8,97851472,3.6275045537340618,568,487,1055,+
chr8,97851506,1.0544950738916257,1369,1159,2528,+
chr8,97851508,1.2422931018784953,1823,1505,3328,+
chr8,97851537,0.4615848550846038,860,634,1494,+
chr8,97851832,1.4149963475944254,1342,966,2308,+
chr8,100150637,0.9350036310820624,617,458,1075,+
chr8,100150638,0.7894288082221846,820,582,1402,+
chr8,100150655,1.7760992488817622,914,696,1610,+
chr8,100150656,1.7845107677190117,1380,1014,2394,+
chr8,100150676,3.128340365682138,573,473,1046,+
chr8,100151351,1.3453134344155209,1468,1032,2500,+
chr8,100151352,0.947304368991116,1111,746,1857,+
chr8,100151834,0.4944467297408474,600,441,1041,+
chr8,100151846,1.8070508938997591,1177,868,2045,+
chr8,100151872,2.584090909090909,757,549,1306,+
chr8,100153641,2.305005990242211,651,459,1110,+
chr8,100153651,2.272024729520865,734,646,1380,+
chr8,100153652,2.272024729520865,734,646,1380,+
chr8,103420998,0.8010118043844857,949,592,1541,+
chr8,103420999,0.8010118043844857,949,592,1541,+
chr8,103421000,0.8010118043844857,949,592,1541,+
chr8,103421014,1.200220196143417,1409,995,2404,+
chr8,103426064,2.5221822895186468,2313,1542,3855,+
chr8,103426065,2.5221822895186468,2313,1542,3855,+
chr8,103435689,0.7593354949139861,742,555,1297,+
chr8,103435755,2.469897686820776,728,550,1278,+
chr8,103441555,0.4224493901913257,886,742,1628,+
chr8,103442807,2.180974632843792,882,534,1416,+
chr8,103442809,2.180974632843792,882,534,1416,+
chr8,106752252,2.1198386783281347,762,529,1291,+
chr8,108443656,3.7237580479471672,675,371,1046,+
chr8,108449900,0.4402116402116402,799,524,1323,+
chr8,108476805,1.6297258225975324,772,574,1346,+
chr8,108486581,2.570871996891564,1411,949,2360,+
chr8,108486583,3.0396551724137932,901,579,1480,+
chr8,109334339,2.0311237997051284,674,374,1048,+
chr8,109334378,1.128825345964521,873,775,1648,+
chr8,109336133,1.9682336182336182,1010,701,1711,+
chr8,109336134,1.9682336182336182,1010,701,1711,+
chr8,109339322,1.7584097859327217,1149,653,1802,+
chr8,109339323,1.890690452116134,2553,1931,4484,+
chr8,109339324,1.890690452116134,2553,1931,4484,+
chr8,109339325,1.890690452116134,2553,1931,4484,+
chr8,109343447,1.2320568676908965,1193,889,2082,+
chr8,109343448,1.2320568676908965,1193,889,2082,+
chr8,109550868,2.307056803517915,668,402,1070,+
chr8,109554729,2.8047863247863245,1171,674,1845,+
chr8,109554730,2.9055543911129744,1823,1100,2923,+
chr8,109554732,2.8195361511111185,1775,1039,2814,+
chr8,117530796,1.2276850521119747,546,485,1031,+
chr8,119240166,0.7122362314909428,574,471,1045,+
chr8,119243795,1.0897878212868726,664,373,1037,+
chr8,119243796,1.0897878212868726,664,373,1037,+
chr8,119245296,3.2667553451089244,791,580,1371,+
chr8,120517975,2.1778206588164277,955,550,1505,+
chr8,120517976,2.050079741597577,811,486,1297,+
chr8,123100820,1.5476521218646462,860,630,1490,+
chr8,123100825,1.6298051075268818,1065,991,2056,+
chr8,123100826,1.75906497948687,1623,1354,2977,+
chr8,123100830,2.474226804123711,584,581,1165,+
chr8,123182673,0.49676419585569054,582,424,1006,+
chr8,123182695,0.6716930236824803,1513,1016,2529,+
chr8,123182698,0.8431115287914663,730,576,1306,+
chr8,123182783,1.2383956992181877,1468,907,2375,+
chr8,123182788,1.887702387702388,1222,857,2079,+
chr8,123182789,1.887702387702388,1222,857,2079,+
chr8,123182806,2.0436084150536042,1260,827,2087,+
chr8,123182900,1.838284600389864,841,512,1353,+
chr8,123182908,2.123328204521245,689,496,1185,+
chr8,123182996,2.588726513569937,619,478,1097,+
chr8,123183061,2.0257094348775158,575,433,1008,+
chr8,123183125,1.5457169396233117,1014,581,1595,+
chr8,123183141,3.2014435695538057,696,380,1076,+
chr8,123183206,1.1200268621400538,1394,1018,2412,+
chr8,123183209,0.536063285248953,639,613,1252,+
chr8,123183228,1.3307618229686082,2499,1977,4476,+
chr8,123183229,1.6234564070741544,1777,1464,3241,+
chr8,123183247,0.6224280350569646,3633,2422,6055,+
chr8,123183249,0.5859568707865922,2185,1462,3647,+
chr8,123191845,1.3767024039440057,2470,1708,4178,+
chr8,123191858,1.8166147253603429,810,603,1413,+
chr8,123191885,1.6356506238859183,991,679,1670,+
chr8,123191947,1.613292201653957,2186,1457,3643,+
chr8,123191953,0.6907738095238095,843,629,1472,+
chr8,123194054,1.721311253417011,3108,2002,5110,+
chr8,123194077,1.7029797426216862,1582,965,2547,+
chr8,123207280,2.3687839225465748,733,400,1133,+
chr8,123207339,3.051282051282051,730,386,1116,+
chr8,123207648,0.47685884933940154,736,390,1126,+
chr8,123207740,0.6172869497619279,604,501,1105,+
chr8,123207744,0.8736126029359113,1219,930,2149,+
chr8,123207746,0.7595356946359237,1645,1344,2989,+
chr8,123207801,1.7059851463521192,780,653,1433,+
chr8,123207821,1.9733015139085688,734,582,1316,+
chr8,123207869,2.6214660995746812,675,570,1245,+
chr8,123207882,1.4442176201485564,850,700,1550,+
chr8,123207995,2.160076919469068,1509,926,2435,+
chr8,123208007,1.613583138173302,1013,853,1866,+
chr8,123208018,1.5130941483780225,1188,952,2140,+
chr8,123208048,1.5275542801785298,3428,2476,5904,+
chr8,123208220,1.8574766355140186,1324,962,2286,+
chr8,123208280,1.4389275074478651,965,759,1724,+
chr8,123208359,2.2152997083441894,2620,2136,4756,+
chr8,123208380,1.195748422748905,2168,1580,3748,+
chr8,123208498,1.6878358573522227,690,533,1223,+
chr8,123208506,3.078683035714286,612,447,1059,+
chr8,123208527,0.6841294298921418,1055,648,1703,+
chr8,123208556,2.077960204414483,658,540,1198,+
chr8,123208576,2.0685151697809925,709,552,1261,+
chr8,123208586,2.223843572158178,761,622,1383,+
chr8,123208610,1.5339187051298482,2520,1971,4491,+
chr8,123208695,1.9676895725438663,1183,760,1943,+
chr8,123208735,0.4184759095359425,2125,1360,3485,+
chr8,123208745,2.1228512079570745,1748,1121,2869,+
chr8,123208785,2.6871559633027524,706,544,1250,+
chr8,123208827,2.2893448956812907,807,612,1419,+
chr8,123208846,0.32400983337885825,658,522,1180,+
chr8,123208852,0.7080789946140036,1478,1113,2591,+
chr8,123208855,1.7654195011337868,1353,881,2234,+
chr8,123209025,10.864259583254254,1908,1873,3781,+
chr8,123209026,8.672393963730869,3684,3275,6959,+
chr8,123209050,0.6645925011334393,1703,1524,3227,+
chr8,123209097,2.1122573876551844,754,601,1355,+
chr8,123209222,1.6150706436420719,642,454,1096,+
chr8,123209282,1.759733606557377,686,487,1173,+
chr8,123209283,1.5965338213872184,1095,652,1747,+
chr8,123209301,0.6608294930875576,716,650,1366,+
chr8,123209314,0.635091629519564,891,672,1563,+
chr8,123209344,3.712726596922084,1864,1601,3465,+
chr8,123209385,2.5318613869826523,1187,808,1995,+
chr8,123209388,1.4934933925148792,1259,861,2120,+
chr8,123209422,0.4582713293650794,777,767,1544,+
chr8,123209544,1.262537559004792,2581,1824,4405,+
chr8,123209879,2.5362969153961514,1479,1027,2506,+
chr8,123209882,2.048669537409937,1487,1093,2580,+
chr8,123209942,2.3929578936370293,618,562,1180,+
chr8,123209956,2.695108695652174,550,459,1009,+
chr8,123210025,0.6052848399246704,604,471,1075,+
chr8,123437311,1.6815625856150704,1645,1381,3026,+
chr8,123437313,1.7290140955980784,1236,995,2231,+
chr8,123437321,0.6369467563010085,1322,1287,2609,+
chr8,123441311,1.7276714513556617,618,659,1277,+
chr8,123441807,3.495935866444305,787,599,1386,+
chr8,123785666,1.907189758848049,549,482,1031,+
chr8,124539142,2.1927570757739843,734,370,1104,+
chr8,124539214,1.708313932055136,1320,890,2210,+
chr8,124539223,2.4158701529319986,2209,1526,3735,+
chr8,124539224,2.840426867545512,1211,884,2095,+
chr8,124539240,2.203703703703704,713,539,1252,+
chr8,124539243,0.5360181508791831,944,730,1674,+
chr8,124539262,1.7280211895121669,2353,1574,3927,+
chr8,124543088,0.5299676025917927,1207,925,2132,+
chr8,124543090,1.144162435785993,2537,1672,4209,+
chr8,124549799,2.1414247231367853,1046,770,1816,+
chr8,124549826,0.6141385968676251,1144,789,1933,+
chr8,124999254,3.8707942712538412,800,626,1426,+
chr8,125005583,1.5629370629370627,595,519,1114,+
chr8,125018087,1.1707047903600964,616,480,1096,+
chr8,125091925,11.005689674281955,1183,1517,2700,+
chr8,125091926,11.005689674281955,1183,1517,2700,+
chr8,125151187,1.7902964510658914,656,464,1120,+
chr8,125151233,1.041808111488297,685,385,1070,+
chr8,125151234,1.041808111488297,685,385,1070,+
chr8,127736067,0.9833462486791124,982,834,1816,+
chr8,127736068,0.9145083331873791,3730,2654,6384,+
chr8,127736150,1.9298245614035086,769,512,1281,+
chr8,127736170,1.759823406297022,3702,2393,6095,+
chr8,127736171,1.64774443157253,5300,3251,8551,+
chr8,127736172,1.64774443157253,5300,3251,8551,+
chr8,127736175,1.3899851079672374,1309,789,2098,+
chr8,127736190,5.571033282066258,4285,3156,7441,+
chr8,127736203,1.482168473728107,1531,1089,2620,+
chr8,127736230,0.7888347825333082,3363,2525,5888,+
chr8,127736291,1.69077513628605,2657,1968,4625,+
chr8,127736292,1.9608671171171168,1392,767,2159,+
chr8,127736336,1.552979504048583,1326,831,2157,+
chr8,127736383,1.2667879587398185,2849,1936,4785,+
chr8,127736385,1.035538885550283,1611,1176,2787,+
chr8,127736389,2.785383086774122,840,646,1486,+
chr8,127736422,0.7202872622536891,1773,1133,2906,+
chr8,127736427,1.7404572269977794,3363,2351,5714,+
chr8,127736471,1.5201356506994488,1140,1010,2150,+
chr8,127736511,1.696603898385663,5129,2873,8002,+
chr8,127736512,1.696603898385663,5129,2873,8002,+
chr8,127736513,1.696603898385663,5129,2873,8002,+
chr8,127736532,1.811579855822926,2000,1205,3205,+
chr8,127736562,1.7794300150695863,3029,2333,5362,+
chr8,127736563,1.5222997500853073,7857,5501,13358,+
chr8,127736564,1.349871976092598,4828,3168,7996,+
chr8,127738277,1.797381251007288,2714,2243,4957,+
chr8,127738293,1.6650046968711614,1685,1317,3002,+
chr8,127738416,1.859317815839555,976,758,1734,+
chr8,127738443,1.569597905822908,1356,698,2054,+
chr8,127738450,1.6450857072388705,1449,764,2213,+
chr8,127738493,2.2043789808917205,838,627,1465,+
chr8,127738515,1.8900343642611683,824,678,1502,+
chr8,127738541,2.673469387755102,785,636,1421,+
chr8,127738559,1.8329501915708808,896,724,1620,+
chr8,127738560,1.1867415395391838,2376,1768,4144,+
chr8,127738593,2.4097363083164303,1223,985,2208,+
chr8,127738611,1.3702521118248314,5674,4342,10016,+
chr8,127738637,1.4158919466153066,1570,1420,2990,+
chr8,127738640,1.350081361157898,1688,1522,3210,+
chr8,127738746,1.9203227433182049,951,660,1611,+
chr8,127738784,0.6098631771876731,1532,808,2340,+
chr8,127738788,1.3722049981210072,1578,886,2464,+
chr8,127738791,1.680554872349845,948,700,1648,+
chr8,127738797,1.9536257853671704,3439,2333,5772,+
chr8,127738910,2.516144414168937,858,733,1591,+
chr8,127738946,2.131116038433112,1108,901,2009,+
chr8,127738983,0.6976451222789573,1064,975,2039,+
chr8,127740404,0.710417347717119,1988,1448,3436,+
chr8,127740416,1.3237634115293688,2451,1691,4142,+
chr8,127740419,1.3697670345069188,1471,1383,2854,+
chr8,127740475,1.7453170764934265,1754,1384,3138,+
chr8,127740580,1.573871878393051,2058,1534,3592,+
chr8,127740584,1.3590560471976398,2214,1694,3908,+
chr8,127740692,1.698566312928015,2014,1627,3641,+
chr8,127740776,1.4684514637904469,2327,1887,4214,+
chr8,127740798,1.2612842950437533,4106,2829,6935,+
chr8,127740826,1.9828884325804244,2896,2434,5330,+
chr8,127740827,0.6906283476783274,4673,3102,7775,+
chr8,127741036,1.2397180520257227,5301,3560,8861,+
chr8,127741319,4.018034027342342,3776,3053,6829,+
chr8,132011936,3.4346507122278322,626,444,1070,+
chr8,132011947,2.862823061630219,575,502,1077,+
chr8,132011948,2.388659390355264,885,792,1677,+
chr8,132011949,1.0175282234105765,684,458,1142,+
chr8,132011950,2.4875031637560108,924,877,1801,+
chr8,132011951,1.6453328210565206,1319,1077,2396,+
chr8,132011954,1.8262611495877217,954,711,1665,+
chr8,133408267,2.8634049773755663,1124,679,1803,+
chr8,133408269,2.8634049773755663,1124,679,1803,+
chr8,133408281,1.8599404668651105,741,490,1231,+
chr8,140515215,2.258540547686335,647,474,1121,+
chr8,140515355,3.6859236203880954,599,413,1012,+
chr8,140515834,2.4613026462362106,950,671,1621,+
chr8,142701659,1.234915112731902,1013,680,1693,+
chr8,142703093,3.2107651314265118,642,443,1085,+
chr8,143018528,0.7429841799730313,1121,669,1790,+
chr8,143018529,0.8214688064618982,677,484,1161,+
chr8,143018562,3.1350383631713554,907,459,1366,+
chr8,143020886,1.6247628083491459,684,371,1055,+
chr8,143020896,1.5485388806339768,1182,672,1854,+
chr8,143020942,1.7200120554550933,877,710,1587,+
chr8,143020949,1.7071038251366117,922,731,1653,+
chr8,143021340,1.5616438356164384,1367,1167,2534,+
chr8,143021346,2.181740746476692,804,586,1390,+
chr8,143021572,1.4786024395286337,893,690,1583,+
chr8,143021687,0.6536681911792238,1879,1132,3011,+
chr8,143021814,0.8110957151236979,1358,1172,2530,+
chr8,143021828,2.359550561797753,719,533,1252,+
chr8,143021933,1.782543103448276,918,479,1397,+
chr8,143021942,0.5689488910318226,943,487,1430,+
chr8,143021973,1.7946843853820598,1094,644,1738,+
chr8,143021994,0.6237816764132553,735,620,1355,+
chr8,143021996,1.645486555697823,893,780,1673,+
chr8,143022225,0.568771561421929,789,564,1353,+
chr8,143022355,1.2997381460641164,941,752,1693,+
chr8,143651416,2.3401869158878505,625,427,1052,+
chr8,143651417,2.5320876962461867,1006,785,1791,+
chr8,143991741,1.9636363636363636,695,434,1129,+
chr8,143991908,1.9781205374060102,1082,893,1975,+
chr8,143991934,1.773676055054234,670,476,1146,+
chr8,143991959,2.381679389312977,623,523,1146,+
chr8,143991968,1.6799230857056353,1376,1171,2547,+
chr8,143992013,0.6635944700460831,943,650,1593,+
chr8,143992289,2.2409266970776835,841,615,1456,+
chr8,143992311,1.3637930392303914,966,689,1655,+
chr8,143992356,2.785176606832658,554,470,1024,+
chr8,143992889,2.9188373891333006,752,445,1197,+
chr8,143992955,2.3057711693140632,1286,1063,2349,+
chr8,143992956,2.206150681750324,874,700,1574,+
chr8,143992968,3.1827411167512687,626,393,1019,+
chr8,143993291,3.680576012594443,612,408,1020,+
chr8,144083732,3.00172954928772,687,419,1106,+
chr8,144083841,2.5908751493428914,665,475,1140,+
chr8,144083956,0.9756692481248858,639,528,1167,+
chr8,144083957,0.9756692481248858,639,528,1167,+
chr8,144083959,0.4532163742690058,619,455,1074,+
chr8,144084432,1.916335592428137,655,388,1043,+
chr8,144084833,1.36150215691294,581,485,1066,+
chr8,144085376,3.1719921104536493,730,389,1119,+
chr8,144085378,3.1719921104536493,730,389,1119,+
chr8,144085466,1.5078989313683762,1114,702,1816,+
chr8,144085468,0.9929092653361752,934,696,1630,+
chr8,144095179,1.9352336597404165,855,560,1415,+
chr8,144095850,1.8483633010603968,852,481,1333,+
chr8,144095937,1.8479159369372655,1568,939,2507,+
chr8,144095949,1.521306818181818,1070,615,1685,+
chr8,144095981,2.114509803921569,673,524,1197,+
chr8,144096140,0.674254930923625,775,676,1451,+
chr8,144096142,0.5759822090437361,2996,2222,5218,+
chr8,144096143,0.6515384031415021,5764,4113,9877,+
chr8,144096144,0.8642187375189325,5160,3916,9076,+
chr8,144096146,1.4750499741178664,3116,2129,5245,+
chr8,144096221,1.5718094560966938,716,581,1297,+
chr8,144096232,0.5369127516778524,1247,893,2140,+
chr8,144096370,1.6988847583643123,913,806,1719,+
chr8,144096606,1.5901199574834235,1427,858,2285,+
chr8,144096671,1.6385461260807521,975,626,1601,+
chr8,144096714,1.6183908045977011,1055,782,1837,+
chr8,144097115,0.6620765451254202,1671,1288,2959,+
chr8,144097231,1.6290726817042607,935,755,1690,+
chr8,144097237,1.478935233703626,1511,1100,2611,+
chr8,144097241,1.969238138780712,2886,2284,5170,+
chr8,144097436,3.651673855001027,634,540,1174,+
chr8,144105689,2.133462532299742,1347,859,2206,+
chr8,144105690,2.133462532299742,1347,859,2206,+
chr8,144105696,1.9008034514021324,1558,1102,2660,+
chr8,144105698,1.9008034514021324,1558,1102,2660,+
chr8,144106150,2.314949049269881,786,500,1286,+
chr8,144106152,2.314949049269881,786,500,1286,+
chr8,144106589,3.2296990617457744,1278,1000,2278,+
chr8,144308938,5.651991179988199,611,394,1005,+
chr8,144314616,3.786666666666666,567,629,1196,+
chr8,144314618,3.786666666666666,567,629,1196,+
chr8,144361112,3.1716721669854744,801,462,1263,+
chr8,144510709,1.8397553151430885,684,549,1233,+
chr8,145054248,3.035460348763547,1224,831,2055,+
chr8,145054249,2.8162410706954595,926,640,1566,+
chr8,145054329,2.1948529411764706,596,441,1037,+
chr8,145055067,1.198748074565155,1042,804,1846,+
chr8,145055407,3.6605783866057844,739,437,1176,+
chr8,145055409,3.6605783866057844,739,437,1176,+
chr9,6639128,0.43189435428747913,1662,1303,2965,+
chr9,15423965,3.661962692619627,663,410,1073,+
chr9,15433555,1.6228908057856422,1015,740,1755,+
chr9,15433556,2.106701550918967,896,665,1561,+
chr9,19049715,3.499633817817853,1227,773,2000,+
chr9,19049829,2.906707742741151,716,475,1191,+
chr9,19050550,2.4588178294573644,579,515,1094,+
chr9,19050551,2.4588178294573644,579,515,1094,+
chr9,31254613,0.7613814756671898,624,454,1078,+
chr9,31254614,0.7017357004363165,989,775,1764,+
chr9,31254615,0.7613814756671898,624,454,1078,+
chr9,32424564,2.868304053423476,606,421,1027,+
chr9,33025274,0.8571832945633656,924,536,1460,+
chr9,33025284,1.8312585499316003,652,429,1081,+
chr9,33026488,3.225253807106599,781,393,1174,+
chr9,33026495,0.6132404181184669,714,454,1168,+
chr9,33026498,1.377514544563042,3112,2104,5216,+
chr9,33026942,1.4516624040920716,989,574,1563,+
chr9,33029894,2.150901756372837,1076,701,1777,+
chr9,33029902,1.6222222222222222,802,494,1296,+
chr9,33029962,0.49989880590973496,1139,971,2110,+
chr9,33030454,1.6437643849206967,1833,1286,3119,+
chr9,33030580,0.721826371103435,3396,1776,5172,+
chr9,33030592,1.5789473684210529,959,645,1604,+
chr9,33030597,1.5807741853240114,4382,2242,6624,+
chr9,33030600,1.6863636363636365,2967,1484,4451,+
chr9,33030603,1.6379171151776106,1738,928,2666,+
chr9,33030621,1.644478266628854,7904,4342,12246,+
chr9,33030622,1.644478266628854,7904,4342,12246,+
chr9,33030647,1.4581135368937148,2641,1573,4214,+
chr9,33034217,1.552535508805405,7248,3694,10942,+
chr9,33034218,1.552535508805405,7248,3694,10942,+
chr9,33034221,1.4268763301405065,15756,8785,24541,+
chr9,33034222,1.382839886067751,22960,13481,36441,+
chr9,33034237,1.1307199928451654,17503,10879,28382,+
chr9,33034255,1.6696182841892733,12363,9331,21694,+
chr9,33034257,1.6696182841892733,12363,9331,21694,+
chr9,33034260,1.2692877759839227,66199,44015,110214,+
chr9,33034261,1.2929126536644941,62932,42029,104961,+
chr9,33037085,1.9787696257529377,690,532,1222,+
chr9,33037086,1.6144004314736022,1252,813,2065,+
chr9,33037098,1.799270072992701,713,547,1260,+
chr9,33038688,1.5920257039491992,1310,840,2150,+
chr9,33038717,1.6452944748026712,796,609,1405,+
chr9,33038912,2.275051124744376,889,651,1540,+
chr9,33265039,1.597575003735844,619,437,1056,+
chr9,33265101,0.5200337015540162,1110,762,1872,+
chr9,33265102,0.5200337015540162,1110,762,1872,+
chr9,33266011,1.9684679161835636,1569,1022,2591,+
chr9,33266012,0.4632602726976592,904,740,1644,+
chr9,33266015,1.3943774863710034,1915,1275,3190,+
chr9,33266087,1.9376778937381405,796,543,1339,+
chr9,33266088,1.9376778937381405,796,543,1339,+
chr9,33267852,0.4888582342954161,812,588,1400,+
chr9,33270660,2.00903342366757,1250,971,2221,+
chr9,33271160,2.663231505336768,1875,1462,3337,+
chr9,33276455,1.624116424116424,836,584,1420,+
chr9,33276487,2.052502050861362,833,476,1309,+
chr9,33276493,1.8561640434682996,1463,1091,2554,+
chr9,33276504,0.5891686058811085,1113,814,1927,+
chr9,33280825,1.1924905603696088,1216,723,1939,+
chr9,33280832,2.4420207956600364,696,552,1248,+
chr9,33280961,1.5990755516425466,1452,1068,2520,+
chr9,33281164,1.841873347601662,1063,675,1738,+
chr9,33281307,1.5864510799008615,1033,686,1719,+
chr9,33348048,6.918641603139557,1493,2135,3628,+
chr9,33348049,6.205671895094961,1456,2268,3724,+
chr9,33348050,6.2236672097002685,1340,2079,3419,+
chr9,33348053,0.1752074401082139,528,788,1316,+
chr9,33348089,0.25833333333333336,991,1319,2310,+
chr9,33348091,0.25833333333333336,991,1319,2310,+
chr9,33624227,1.5757994638341304,1160,796,1956,+
chr9,33624229,1.6785257699393885,991,776,1767,+
chr9,33624239,1.886576243762398,1375,943,2318,+
chr9,33624253,1.850288148852521,1569,1269,2838,+
chr9,33624271,0.5375035922981128,1266,1000,2266,+
chr9,33624286,2.4647887323943656,764,638,1402,+
chr9,33624317,1.401307638092239,5057,3902,8959,+
chr9,33624363,1.597310490927512,1507,986,2493,+
chr9,33624364,1.597310490927512,1507,986,2493,+
chr9,33624391,1.4397198152601236,1872,1360,3232,+
chr9,33624393,2.6747909199522097,964,836,1800,+
chr9,33624394,2.3265073542505075,1467,1305,2772,+
chr9,33624396,1.953227544994017,1894,1569,3463,+
chr9,33624397,1.5350785568176872,1330,998,2328,+
chr9,33624400,2.316753926701571,530,572,1102,+
chr9,33624411,0.6465105705842238,1342,900,2242,+
chr9,33624500,1.0564360656028366,3078,2414,5492,+
chr9,33624501,1.1422297446789682,2613,1943,4556,+
chr9,33624502,1.1422297446789682,2613,1943,4556,+
chr9,33624510,0.9605771857923497,2488,1919,4407,+
chr9,33624511,0.9605771857923497,2488,1919,4407,+
chr9,33624613,2.5,797,740,1537,+
chr9,33624622,1.449010654490107,1329,854,2183,+
chr9,33624624,2.097286197902214,662,486,1148,+
chr9,33624654,1.0505154992704009,1719,1434,3153,+
chr9,33624655,0.653198596396518,1248,811,2059,+
chr9,33624663,1.8079351143442453,3413,2277,5690,+
chr9,33624664,1.7049547181404594,4583,3257,7840,+
chr9,33624765,1.6818011257035645,1659,1229,2888,+
chr9,33624850,0.5835722891304199,1012,530,1542,+
chr9,33624854,2.4055522717406355,1005,549,1554,+
chr9,33624883,3.010878010878011,619,467,1086,+
chr9,33624889,3.020080321285141,986,580,1566,+
chr9,33624903,4.6968079539508105,1180,734,1914,+
chr9,33624904,4.6968079539508105,1180,734,1914,+
chr9,33624910,1.5490073889432918,724,477,1201,+
chr9,33624918,1.9085285019885108,1850,1313,3163,+
chr9,33624919,1.7529174693244354,4976,3491,8467,+
chr9,33624921,1.7677337744477961,1963,1433,3396,+
chr9,33624924,2.208949704142012,1085,831,1916,+
chr9,33624949,1.1220929932014025,7057,5504,12561,+
chr9,33625100,0.5178205454050182,1150,871,2021,+
chr9,33625102,0.5651827956989247,640,499,1139,+
chr9,33625103,1.0142857142857142,1632,1126,2758,+
chr9,33625105,0.8826283752146089,2609,1787,4396,+
chr9,33625106,1.0384295428240742,1892,1295,3187,+
chr9,33625219,1.6630162703379223,1062,751,1813,+
chr9,33625220,1.2720410405018823,1512,992,2504,+
chr9,33625222,0.9731978507336438,3226,2195,5421,+
chr9,33625224,1.1021641792791084,3881,2791,6672,+
chr9,34234244,2.251632569132807,616,412,1028,+
chr9,34241459,0.8145662847790507,710,469,1179,+
chr9,34241460,1.281668124398509,975,674,1649,+
chr9,34241466,2.9618906669133285,780,568,1348,+
chr9,34241467,2.9618906669133285,780,568,1348,+
chr9,34241473,2.166382568179422,870,721,1591,+
chr9,34241481,1.675943698016635,675,520,1195,+
chr9,34241486,1.6511278195488719,548,474,1022,+
chr9,34241492,1.4280239153763603,674,592,1266,+
chr9,34241505,1.855593852471897,1825,1800,3625,+
chr9,34241507,1.7271789473684207,2828,2849,5677,+
chr9,34241509,1.6057096181961352,4321,4267,8588,+
chr9,34241510,1.5919413344998203,3161,3412,6573,+
chr9,34241512,1.519008835365716,4897,5042,9939,+
chr9,34241513,1.4920510815741463,2289,2557,4846,+
chr9,34251707,6.474327833928784,968,629,1597,+
chr9,34251708,7.1817713919342605,1457,1089,2546,+
chr9,34251709,5.970646790240565,992,686,1678,+
chr9,34251719,9.817587506679441,618,484,1102,+
chr9,34251884,8.565725783353384,908,150,1058,+
chr9,34251898,34.81351377195967,1112,1377,2489,+
chr9,34251899,34.81351377195967,1112,1377,2489,+
chr9,34251938,0.13966735796089652,388,724,1112,+
chr9,34251969,0.2935120082794715,541,644,1185,+
chr9,34252375,1.8885448916408667,609,436,1045,+
chr9,36197553,1.2876937677950018,635,544,1179,+
chr9,36197554,1.2876937677950018,635,544,1179,+
chr9,36197555,1.2876937677950018,635,544,1179,+
chr9,36197557,2.4033616321432034,1494,836,2330,+
chr9,36197558,2.7908882333661094,1309,677,1986,+
chr9,36197559,2.7908882333661094,1309,677,1986,+
chr9,36198992,1.4939000547430985,848,672,1520,+
chr9,36199072,1.47970690937055,2271,2003,4274,+
chr9,36211623,2.4118260512275795,1423,957,2380,+
chr9,36211773,1.58974358974359,836,467,1303,+
chr9,36211774,1.9524127017470034,1252,978,2230,+
chr9,36211985,31.528089887640444,1517,978,2495,+
chr9,36211986,31.528089887640444,1517,978,2495,+
chr9,36674851,3.5174086363022705,644,445,1089,+
chr9,36674907,1.0058913934426228,692,487,1179,+
chr9,36674908,1.0058913934426228,692,487,1179,+
chr9,37090287,1.327666792286285,863,670,1533,+
chr9,37126388,3.158776595744681,641,375,1016,+
chr9,37126389,3.5417672743369955,631,373,1004,+
chr9,37126493,3.977609851665268,645,396,1041,+
chr9,37126496,4.443207126948776,664,448,1112,+
chr9,37429752,0.7389181800429603,515,568,1083,+
chr9,37429755,1.324526536391464,794,619,1413,+
chr9,37430537,2.276969625080635,881,747,1628,+
chr9,37430539,0.4916883116883117,630,549,1179,+
chr9,70217458,0.4403225806451613,636,433,1069,+
chr9,70217460,0.41119093377566307,2017,1318,3335,+
chr9,70217473,1.4404674717569146,1301,754,2055,+
chr9,70217477,1.0359610374900894,1662,980,2642,+
chr9,70217479,1.2316963315006368,2585,1532,4117,+
chr9,70217480,1.0662521962427356,1792,1056,2848,+
chr9,70217489,1.35177816299616,12444,7761,20205,+
chr9,70217490,1.35177816299616,12444,7761,20205,+
chr9,70217491,1.2711006558311948,6483,4007,10490,+
chr9,70217493,1.2891499197804015,12555,8321,20876,+
chr9,70217494,1.221566310002945,7091,4574,11665,+
chr9,70217497,1.401845238095238,4281,2799,7080,+
chr9,70217502,1.3938120080578194,2828,2308,5136,+
chr9,70347068,2.2487046632124352,929,578,1507,+
chr9,70347069,2.2487046632124352,929,578,1507,+
chr9,70601875,3.6102864297283617,827,652,1479,+
chr9,70601876,3.745543875685557,668,546,1214,+
chr9,70601893,0.6986131186805207,664,441,1105,+
chr9,70601971,2.169486358011283,790,622,1412,+
chr9,70601989,1.6332703213610587,755,528,1283,+
chr9,70602018,2.580228514654744,847,731,1578,+
chr9,70602022,1.8205150513311288,929,820,1749,+
chr9,70603379,1.8521341463414633,674,491,1165,+
chr9,70603690,2.909893992932862,731,565,1296,+
chr9,70603857,1.7616736959889825,2598,2367,4965,+
chr9,70603858,1.7782270682768673,3242,2864,6106,+
chr9,70603951,2.0929312901631243,583,475,1058,+
chr9,70604116,2.5097035991531405,568,435,1003,+
chr9,70607135,1.2745889095385627,857,639,1496,+
chr9,70607158,1.8607954545454544,654,527,1181,+
chr9,70607159,2.1778965451422025,1140,844,1984,+
chr9,70607160,2.1778965451422025,1140,844,1984,+
chr9,70607371,0.9363518212792864,1747,1371,3118,+
chr9,70607372,0.9363518212792864,1747,1371,3118,+
chr9,70607404,1.5183354171211267,1454,1185,2639,+
chr9,70607546,1.7049467898491402,716,502,1218,+
chr9,70607548,1.7465462074157727,1117,804,1921,+
chr9,70607549,1.5902641878669275,787,583,1370,+
chr9,70607639,2.0432687270822423,590,414,1004,+
chr9,70607640,0.4686990428925913,600,454,1054,+
chr9,71589554,1.5223605723063398,736,539,1275,+
chr9,72195530,1.34482638987473,1065,854,1919,+
chr9,72202701,1.5244667503136764,944,796,1740,+
chr9,72210730,2.0112244897959184,1021,783,1804,+
chr9,72225690,1.6583835650141467,1036,738,1774,+
chr9,72225701,1.5651239750082886,2684,1998,4682,+
chr9,72225713,0.9861913937058444,2323,1556,3879,+
chr9,72225714,0.6070065239317222,1284,966,2250,+
chr9,72225715,0.9861913937058444,2323,1556,3879,+
chr9,72225735,1.782803672316384,3481,2831,6312,+
chr9,72231123,2.3281355932203387,605,589,1194,+
chr9,72241188,0.6009428161508505,732,475,1207,+
chr9,72245165,0.388676844783715,610,392,1002,+
chr9,72245207,1.9215070643642078,781,636,1417,+
chr9,72245243,0.546204122674711,678,509,1187,+
chr9,72248737,1.8718502519798415,699,462,1161,+
chr9,72248981,0.5246458087367178,789,615,1404,+
chr9,72249271,2.4783362218370883,714,576,1290,+
chr9,72249306,0.6278039420896564,817,636,1453,+
chr9,72249540,0.39675421365076585,914,613,1527,+
chr9,72249550,2.632601880877743,987,637,1624,+
chr9,72249831,1.8013204141730788,924,725,1649,+
chr9,72249891,1.5684463562753037,1126,831,1957,+
chr9,72250606,1.8788856226399007,1069,799,1868,+
chr9,72250611,1.5371332757058502,1446,1246,2692,+
chr9,72250612,1.5874240583377033,1841,1580,3421,+
chr9,72250902,1.804839391377853,898,727,1625,+
chr9,72251068,1.5153719008264463,763,604,1367,+
chr9,72251220,2.3858741049006915,1427,880,2307,+
chr9,72251272,1.5272240170199354,880,685,1565,+
chr9,73151865,2.386615979405313,610,692,1302,+
chr9,73151867,1.293261868300153,562,652,1214,+
chr9,73151868,1.8276332924957677,787,707,1494,+
chr9,73151878,0.8745058067704473,1230,851,2081,+
chr9,73151880,0.8745058067704473,1230,851,2081,+
chr9,73151883,1.3542250233426705,1131,713,1844,+
chr9,73151894,0.5064708287250781,1306,1216,2522,+
chr9,73151900,1.7842511306198454,705,715,1420,+
chr9,73158531,1.4408587692169779,1890,1331,3221,+
chr9,73158533,0.7358149348202848,1394,1153,2547,+
chr9,73158694,1.60893404048704,1736,1216,2952,+
chr9,73158753,0.9828679528126352,6862,4227,11089,+
chr9,73158766,1.3005920574530845,3715,2511,6226,+
chr9,73158769,1.2875653173913,11743,6986,18729,+
chr9,73158782,0.7851802221128589,3578,2648,6226,+
chr9,73158789,1.3096383930347,5487,3560,9047,+
chr9,73159334,1.5728050926992845,6655,4641,11296,+
chr9,73159338,1.899158668088636,7501,5625,13126,+
chr9,73160269,1.6137909428453516,4974,3624,8598,+
chr9,73160280,1.3433267587113742,2553,1637,4190,+
chr9,73162827,1.4025604551920343,2609,1997,4606,+
chr9,73170051,1.6789652982273804,2076,1254,3330,+
chr9,73170075,1.4078885204025517,5396,4365,9761,+
chr9,75133369,4.370826913199794,739,353,1092,+
chr9,75146695,3.2858412698412702,641,409,1050,+
chr9,75146765,0.367155357451119,665,465,1130,+
chr9,78178378,1.4840889220335973,995,941,1936,+
chr9,78178379,1.2617260312001988,1825,1612,3437,+
chr9,78178381,0.880217897677115,1710,1365,3075,+
chr9,78178383,0.5175046823224321,897,630,1527,+
chr9,78178397,0.625,709,496,1205,+
chr9,78178402,1.5248447204968945,981,735,1716,+
chr9,78178403,1.9667691593664796,1313,1566,2879,+
chr9,78178404,0.5537836147592246,643,623,1266,+
chr9,78178405,1.6166437297972691,4421,4364,8785,+
chr9,78178406,1.4781394652030901,5093,4679,9772,+
chr9,78178408,1.365071475906466,2525,2011,4536,+
chr9,78297234,1.1017162676708916,1145,909,2054,+
chr9,78300611,0.6208649454392572,1047,736,1783,+
chr9,78301957,1.5820504421880115,1287,851,2138,+
chr9,78304787,1.721067606653953,2202,1556,3758,+
chr9,78306313,2.226861517049408,799,478,1277,+
chr9,78306320,1.9146800501882053,1198,796,1994,+
chr9,78306334,2.1536014542149506,1353,977,2330,+
chr9,78306340,2.1146535129932627,1301,1038,2339,+
chr9,78306347,1.4933618462086786,1675,1246,2921,+
chr9,78308558,0.5969986430034856,830,636,1466,+
chr9,78308563,1.8516460810872857,822,750,1572,+
chr9,78317677,2.7064558058925474,805,576,1381,+
chr9,78317680,1.3976094005890438,2954,2168,5122,+
chr9,78317793,1.5595442594215603,1533,1140,2673,+
chr9,78328068,1.5183256172839503,1388,971,2359,+
chr9,78329103,1.4853557639271926,1380,739,2119,+
chr9,78329116,1.6701388888888888,1819,1279,3098,+
chr9,78329136,1.4313625204582652,1998,1221,3219,+
chr9,78329218,1.4481900452488687,1902,1429,3331,+
chr9,78329312,1.3699342105263157,1892,1519,3411,+
chr9,78329466,1.4865244639294048,2234,1226,3460,+
chr9,78329473,1.54946949602122,1668,753,2421,+
chr9,78329479,1.2790689984871493,5610,2978,8588,+
chr9,78329487,1.7320345571800932,2971,1678,4649,+
chr9,78329514,1.4174058742361522,2560,1156,3716,+
chr9,78329524,1.4235276771421348,4628,2859,7487,+
chr9,78329526,0.646040713837324,1800,1133,2933,+
chr9,78329527,1.416529993366943,11359,7308,18667,+
chr9,78329529,1.485528749612866,17468,11400,28868,+
chr9,78329530,1.6741520447503155,11997,7933,19930,+
chr9,78329533,1.074209693317019,13410,7616,21026,+
chr9,79391823,1.8169236813208844,997,679,1676,+
chr9,79391825,2.491148642934563,1557,1074,2631,+
chr9,79391826,3.9951734539969843,615,441,1056,+
chr9,79391840,1.864129372679304,586,601,1187,+
chr9,79391842,0.8904444615798243,3752,2950,6702,+
chr9,79391843,0.6652221018418202,2455,1845,4300,+
chr9,79391846,1.4580138192656822,911,670,1581,+
chr9,79391851,1.9744917529727655,709,473,1182,+
chr9,87525398,0.9260247498497803,1874,1610,3484,+
chr9,87525399,0.8854743762152644,2239,1894,4133,+
chr9,87525400,0.8697529488215153,2647,2230,4877,+
chr9,87525401,0.7290128520645337,773,620,1393,+
chr9,87525407,1.8892334605597965,1032,785,1817,+
chr9,87525409,1.73852957435047,739,602,1341,+
chr9,87525410,0.9560316939378308,1435,1384,2819,+
chr9,87525412,0.7093639850760283,7261,5700,12961,+
chr9,87525414,0.6701852775415709,7661,5703,13364,+
chr9,87525427,1.7049971607041452,1200,1173,2373,+
chr9,87726184,1.904985153930301,1271,971,2242,+
chr9,87726231,0.6437492302007636,2528,1764,4292,+
chr9,87726232,0.6437492302007636,2528,1764,4292,+
chr9,87726327,16.605519772809892,772,630,1402,+
chr9,87727595,2.0060903149138443,729,560,1289,+
chr9,87727597,0.6619718309859155,986,734,1720,+
chr9,87727598,1.74,840,649,1489,+
chr9,87727599,0.5829210134128167,1907,1341,3248,+
chr9,87727600,1.4646367986080906,1103,835,1938,+
chr9,87727604,1.6952133724738592,1074,876,1950,+
chr9,87727611,1.4784470848300637,1188,986,2174,+
chr9,87728256,1.4225431996067608,1446,997,2443,+
chr9,87728257,1.7893940974032747,1106,891,1997,+
chr9,87728274,1.8938211628966144,1222,940,2162,+
chr9,87728606,1.3162790355669611,1988,1270,3258,+
chr9,87728666,1.4222461114657172,2204,1444,3648,+
chr9,87728678,1.4741379310344829,1424,1304,2728,+
chr9,87728710,1.1828095830794485,4821,3310,8131,+
chr9,87729584,1.4291387959866217,1160,935,2095,+
chr9,87730385,0.7091424576666149,2882,1967,4849,+
chr9,87731015,1.511232076473712,1865,1075,2940,+
chr9,87731059,0.7643835616438356,2231,1678,3909,+
chr9,87731218,1.255124884772398,2823,2070,4893,+
chr9,88016294,0.8259149357072207,667,527,1194,+
chr9,88016295,0.7688875109229553,1845,1277,3122,+
chr9,89311231,1.6426055121917522,579,466,1045,+
chr9,89311232,1.5015074579498568,756,547,1303,+
chr9,89311263,1.2871275331065446,2155,1807,3962,+
chr9,89311264,1.6752732429441062,1326,1111,2437,+
chr9,89311269,1.5126362735381569,1442,1008,2450,+
chr9,89311289,1.4322916666666663,1484,1052,2536,+
chr9,89311305,1.5901169480533066,1245,1016,2261,+
chr9,89311311,0.7810011428571428,1856,1249,3105,+
chr9,89316379,0.7009894646924829,2423,1755,4178,+
chr9,89316570,1.5253979797979798,2775,1874,4649,+
chr9,92379783,1.4233923931202108,1186,795,1981,+
chr9,93527167,3.6196709874435107,640,491,1131,+
chr9,93561205,5.1867548308254285,543,564,1107,+
chr9,93561206,4.297196585104284,788,833,1621,+
chr9,93564580,2.3885017421602788,913,573,1486,+
chr9,93564581,2.3885017421602788,913,573,1486,+
chr9,93564600,2.204723199511025,853,595,1448,+
chr9,93564945,2.5378670734596187,717,451,1168,+
chr9,94459903,1.7842723004694838,690,425,1115,+
chr9,94459911,2.081246546007184,612,400,1012,+
chr9,96146149,0.8189749603016646,918,739,1657,+
chr9,96146151,0.7284148614021417,1677,1488,3165,+
chr9,96146152,0.5788594523876273,934,695,1629,+
chr9,96146500,2.8142183787152817,627,567,1194,+
chr9,96146529,0.5655818323277697,895,840,1735,+
chr9,96146530,1.075098348202348,1464,1254,2718,+
chr9,96146597,1.8767283938978847,946,632,1578,+
chr9,96146600,1.970198675496689,594,452,1046,+
chr9,96146601,0.5305839683768695,650,462,1112,+
chr9,96146608,1.9096869517037582,751,636,1387,+
chr9,96146609,0.5620254766491285,2338,1612,3950,+
chr9,96146610,0.5547953000441616,2599,1710,4309,+
chr9,96146611,1.6630434782608694,917,791,1708,+
chr9,96146615,2.155602785431575,2308,1560,3868,+
chr9,96146618,1.2383168585957027,3591,3302,6893,+
chr9,96146620,1.2918425867021108,5324,4591,9915,+
chr9,96146621,0.9681230462996594,4257,2925,7182,+
chr9,96146622,1.1255568669593286,6715,4665,11380,+
chr9,96146623,1.1694041832593314,5615,4095,9710,+
chr9,96146624,1.190355128721487,8922,6320,15242,+
chr9,96147758,1.212699915824916,776,575,1351,+
chr9,96147759,1.212699915824916,776,575,1351,+
chr9,96147760,1.212699915824916,776,575,1351,+
chr9,96147769,1.9852216748768476,712,321,1033,+
chr9,97664419,1.3490616223018597,589,458,1047,+
chr9,97983577,1.010279548624086,1159,781,1940,+
chr9,97998557,2.206368399838775,1563,826,2389,+
chr9,97998559,2.1101565388875505,2175,1203,3378,+
chr9,97998569,1.7313432835820894,927,535,1462,+
chr9,97998573,1.98665130776528,1010,627,1637,+
chr9,97998574,1.8775907636667135,793,552,1345,+
chr9,97998580,1.5787137888171379,1721,1246,2967,+
chr9,97998603,1.875448028673835,965,743,1708,+
chr9,98004966,0.4613636363636364,608,439,1047,+
chr9,98004967,1.7007451048345177,754,397,1151,+
chr9,98004971,1.96222028480093,843,464,1307,+
chr9,98005109,1.557802948579648,1332,926,2258,+
chr9,98011285,2.1807214682577607,1526,1109,2635,+
chr9,98015370,2.1068897637795274,972,634,1606,+
chr9,98015400,1.7853392144507458,749,620,1369,+
chr9,98015555,2.217679348854817,807,586,1393,+
chr9,98015556,2.0947614819501292,1350,962,2312,+
chr9,98015562,0.49912022150055,1609,1093,2702,+
chr9,98015563,0.5825633105477976,1471,1028,2499,+
chr9,98015567,1.91430138488962,606,428,1034,+
chr9,98015568,2.070539754363284,624,441,1065,+
chr9,98015613,1.7096836810270943,2066,1447,3513,+
chr9,98015619,1.4904589371980677,902,620,1522,+
chr9,98056852,34.008256823079996,1853,1411,3264,+
chr9,98056853,34.008256823079996,1853,1411,3264,+
chr9,98060791,3.0756338054832573,661,447,1108,+
chr9,98060821,0.37372441367786596,1502,1288,2790,+
chr9,98060823,0.37372441367786596,1502,1288,2790,+
chr9,98060825,1.8728657735749932,619,422,1041,+
chr9,98060827,2.0258930458676807,660,497,1157,+
chr9,98060834,1.770438373777081,1745,1258,3003,+
chr9,98060971,1.468761285662694,663,425,1088,+
chr9,98076922,0.6840986394557822,1608,1007,2615,+
chr9,98076924,1.8793053545586105,1056,690,1746,+
chr9,98076925,0.6367048501096758,1865,1118,2983,+
chr9,98076997,1.5575981758734105,11154,6903,18057,+
chr9,98076998,1.4734399346330707,6969,4295,11264,+
chr9,98076999,1.361716472695208,14172,9242,23414,+
chr9,98078204,1.8941012171260243,6877,4687,11564,+
chr9,98078210,1.0427449097617967,8790,6407,15197,+
chr9,98080863,2.4119421564706083,645,432,1077,+
chr9,98080924,1.1435350503852244,885,635,1520,+
chr9,98080926,0.3740558686008872,623,438,1061,+
chr9,99003547,2.1800636034652925,1135,828,1963,+
chr9,99003548,2.452107279693487,1535,1159,2694,+
chr9,99003549,1.8798379114858579,2471,1852,4323,+
chr9,99003550,1.7920300685377095,2190,1593,3783,+
chr9,99003551,0.7541488625473287,1453,1016,2469,+
chr9,99152542,2.6441470890836682,938,689,1627,+
chr9,99152547,1.6680221811460254,845,540,1385,+
chr9,99152549,2.0839250213007667,586,502,1088,+
chr9,99222276,0.8225437213841413,722,424,1146,+
chr9,99222282,2.7059679767103346,571,457,1028,+
chr9,99222284,2.7059679767103346,571,457,1028,+
chr9,99222324,1.796547314578005,668,390,1058,+
chr9,99227947,3.0441440581566006,851,573,1424,+
chr9,99230356,3.0075046904315195,686,491,1177,+
chr9,99230368,1.9163814908495762,804,610,1414,+
chr9,99230395,2.6739236790606653,642,583,1225,+
chr9,99230406,0.480905233380481,679,605,1284,+
chr9,105774126,2.142026752820061,657,485,1142,+
chr9,105774242,3.1370843020081853,737,521,1258,+
chr9,107283626,2.3546099290780145,746,422,1168,+
chr9,107283628,2.2358337631714686,1144,661,1805,+
chr9,107283629,2.1604230282267074,783,462,1245,+
chr9,107283647,2.0274509803921568,563,509,1072,+
chr9,107300141,2.0727323082616884,1658,1162,2820,+
chr9,107300142,1.7514518002322879,1072,776,1848,+
chr9,107300170,0.6965174129353234,839,773,1612,+
chr9,107300171,1.8133389261744965,785,595,1380,+
chr9,107306459,1.8704773869346734,708,397,1105,+
chr9,107306579,0.4407018431986071,1012,834,1846,+
chr9,107306598,2.215686274509804,677,526,1203,+
chr9,107306624,1.6178897090751196,1034,657,1691,+
chr9,107306632,0.5952301811533987,753,546,1299,+
chr9,107311682,2.4620630861040067,721,482,1203,+
chr9,107311717,1.7227027577083545,890,633,1523,+
chr9,107318814,2.02382458359688,661,526,1187,+
chr9,107322028,0.4702024199932149,692,477,1169,+
chr9,107322080,1.9413238426341546,1750,1266,3016,+
chr9,107323903,1.6312661208926769,1038,722,1760,+
chr9,107323922,1.5193699756283874,1070,742,1812,+
chr9,107324919,12.606354497763258,2041,704,2745,+
chr9,107324921,16.93167701863354,1785,873,2658,+
chr9,107324922,11.145840291647058,4487,2071,6558,+
chr9,107324923,11.30479864108275,3128,1572,4700,+
chr9,107324928,9.171736915723956,5591,6760,12351,+
chr9,107324930,9.250981385949052,8549,13057,21606,+
chr9,107324931,8.032723816435801,5881,10832,16713,+
chr9,107324937,0.2801347133337579,1617,4095,5712,+
chr9,107324963,0.3327872392943372,2363,4771,7134,+
chr9,107324969,0.4521981647337094,8147,12919,21066,+
chr9,107324970,0.4221687479145847,5666,9768,15434,+
chr9,107329583,0.6913706118551068,3447,3146,6593,+
chr9,107329599,2.071636459107035,5171,5640,10811,+
chr9,107329600,1.5113003843521529,9476,9221,18697,+
chr9,107329782,8.64155007772596,2058,154,2212,+
chr9,107329784,13.439732177316277,4991,350,5341,+
chr9,107329785,10.341176470588236,1171,67,1238,+
chr9,107329786,12.407662653879527,6034,419,6453,+
chr9,107329788,9.242976625290902,7556,588,8144,+
chr9,107329789,14.246758751859852,7596,710,8306,+
chr9,107329790,32.78837617226108,9550,2238,11788,+
chr9,107329791,32.52483507164769,7673,2104,9777,+
chr9,107329792,31.70625752981763,5796,1962,7758,+
chr9,107329796,5.554344384329374,2170,5384,7554,+
chr9,107329801,0.16395147313691508,515,1153,1668,+
chr9,107329811,1.871257447789282,4923,12431,17354,+
chr9,107329812,1.871257447789282,4923,12431,17354,+
chr9,107329813,0.9538182244895189,4051,11758,15809,+
chr9,107329835,0.3096439297859167,4031,7517,11548,+
chr9,107329836,0.3093841717206023,5394,11342,16736,+
chr9,107329837,0.26598949962498664,2386,4574,6960,+
chr9,107329852,0.4423101881894873,851,1674,2525,+
chr9,107329965,1.5047345767575322,1025,764,1789,+
chr9,107330124,2.1703333333333337,765,499,1264,+
chr9,107330220,12.0625,964,159,1123,+
chr9,107330227,13.066666666666665,930,170,1100,+
chr9,107330228,5.985286294682415,6986,1237,8223,+
chr9,107330229,5.985286294682415,6986,1237,8223,+
chr9,107330230,6.212679222763099,10448,1884,12332,+
chr9,107330232,5.9568603003979135,4861,900,5761,+
chr9,107330233,11.250315210880204,7892,1715,9607,+
chr9,107330235,28.392977892677642,15728,16056,31784,+
chr9,107330236,27.698116884247142,12398,15412,27810,+
chr9,107330237,27.698116884247142,12398,15412,27810,+
chr9,107330270,0.5496568577239936,1317,1846,3163,+
chr9,107330283,0.29714812194895024,1495,4093,5588,+
chr9,107330507,3.807792207792208,732,538,1270,+
chr9,110169395,3.685855630009529,739,528,1267,+
chr9,110169417,0.4261806981519508,592,486,1078,+
chr9,110169419,0.4577141763093113,879,763,1642,+
chr9,110169452,0.46959243327374767,976,709,1685,+
chr9,110169462,2.005265671913384,1780,1515,3295,+
chr9,110169463,2.005265671913384,1780,1515,3295,+
chr9,110169464,2.005265671913384,1780,1515,3295,+
chr9,111669433,2.0819112627986347,914,585,1499,+
chr9,111669435,1.928289204279447,1624,982,2606,+
chr9,111669660,1.6029038112522684,827,569,1396,+
chr9,111670069,1.5993055555555549,986,674,1660,+
chr9,111897253,3.851658767772512,601,421,1022,+
chr9,111914698,2.888675623800384,644,520,1164,+
chr9,111933173,1.815945469177363,944,602,1546,+
chr9,111933223,1.7768835640985279,1798,1201,2999,+
chr9,111933295,1.5386467976217355,1075,617,1692,+
chr9,111933296,1.4137473460721868,760,470,1230,+
chr9,111933870,9.281876955837015,2940,2119,5059,+
chr9,111933871,9.281876955837015,2940,2119,5059,+
chr9,111933875,0.6216216216216215,781,628,1409,+
chr9,111934209,1.0005757052389177,631,578,1209,+
chr9,111934211,1.0005757052389177,631,578,1209,+
chr9,111934742,1.79771144278607,622,401,1023,+
chr9,111934767,1.5933232169954479,1007,658,1665,+
chr9,111935049,1.7713414634146343,746,503,1249,+
chr9,112471357,0.8845314953760252,750,520,1270,+
chr9,112471358,0.8845314953760252,750,520,1270,+
chr9,112471380,0.5937744794887652,757,769,1526,+
chr9,112471381,0.5937744794887652,757,769,1526,+
chr9,114587802,1.4355914050428022,632,465,1097,+
chr9,114587823,0.6104804075087912,1901,1307,3208,+
chr9,114592552,1.3428714859437751,1069,829,1898,+
chr9,114592553,1.3428714859437751,1069,829,1898,+
chr9,114592554,1.459971881736339,1530,1102,2632,+
chr9,114592600,2.5204328306665134,754,510,1264,+
chr9,114597654,0.6120326813567715,617,576,1193,+
chr9,114597718,0.6091081593927894,962,712,1674,+
chr9,114597791,1.871249318057829,979,610,1589,+
chr9,114597793,1.9905876951331496,666,483,1149,+
chr9,114597859,1.9051948051948049,651,461,1112,+
chr9,114597864,3.4413273001508298,712,509,1221,+
chr9,114598063,1.9723752786674629,807,540,1347,+
chr9,114598153,1.5973936108868647,728,597,1325,+
chr9,114598164,1.7350465219317681,1245,853,2098,+
chr9,114598231,0.4358182358182359,666,480,1146,+
chr9,121326704,1.4639782326185833,610,607,1217,+
chr9,121326705,1.2681124439362401,1209,1115,2324,+
chr9,121327307,2.914647799406945,1429,1196,2625,+
chr9,121327308,2.914647799406945,1429,1196,2625,+
chr9,121332434,1.6535131794670814,690,451,1141,+
chr9,121332763,3.619846384552267,774,552,1326,+
chr9,122285179,2.6356600502522864,707,512,1219,+
chr9,122285216,1.318116344072463,719,525,1244,+
chr9,122313320,1.9622618190692822,689,446,1135,+
chr9,122313321,3.6351861417729183,653,476,1129,+
chr9,124313925,0.6463514519731944,642,394,1036,+
chr9,124313926,0.6512768197972884,732,427,1159,+
chr9,124874996,2.795629019452221,782,531,1313,+
chr9,124875114,1.63421167989869,698,418,1116,+
chr9,124877026,2.179190751445087,740,518,1258,+
chr9,124877097,1.8563535911602207,643,361,1004,+
chr9,124877131,0.4448717948717949,693,389,1082,+
chr9,124877133,2.6733067729083664,670,501,1171,+
chr9,124877247,5.158224514734652,1316,974,2290,+
chr9,124877271,2.9736093197623648,820,643,1463,+
chr9,126833618,2.79456740442656,730,496,1226,+
chr9,126833620,2.1824732001640204,1128,793,1921,+
chr9,126833622,2.0861023796851934,1364,1027,2391,+
chr9,126833623,1.603775425763089,1138,802,1940,+
chr9,127612328,2.5972222222222223,594,419,1013,+
chr9,127612329,3.0805597579425115,904,660,1564,+
chr9,127612331,2.6085597029509486,939,730,1669,+
chr9,127612332,2.7099463966646815,636,510,1146,+
chr9,127807456,1.5082051692435785,878,640,1518,+
chr9,127807457,1.0701941747572816,754,514,1268,+
chr9,127807458,0.8350744139413615,733,546,1279,+
chr9,128160406,0.739139533786946,789,641,1430,+
chr9,128160465,3.1984891403880273,742,470,1212,+
chr9,128288896,15.778104735576992,1205,694,1899,+
chr9,128288897,14.3604413830074,1372,835,2207,+
chr9,128371368,0.43174361260338,801,595,1396,+
chr9,128371370,0.49355401071820576,636,478,1114,+
chr9,128390451,3.685534450006018,1852,1381,3233,+
chr9,128390452,3.685534450006018,1852,1381,3233,+
chr9,128459567,2.84718360110182,614,535,1149,+
chr9,128459570,4.4854904952848145,510,511,1021,+
chr9,128615672,0.478448275862069,591,463,1054,+
chr9,128615699,3.2099654377880187,742,495,1237,+
chr9,128615700,3.2099654377880187,742,495,1237,+
chr9,128615701,3.2099654377880187,742,495,1237,+
chr9,128689600,0.2455610241199149,923,571,1494,+
chr9,128689607,0.5858455168844611,565,523,1088,+
chr9,128689609,0.5858455168844611,565,523,1088,+
chr9,128689610,0.5491861288039632,775,470,1245,+
chr9,128689621,1.8780176086339109,574,502,1076,+
chr9,128692963,1.8067924528301889,1196,824,2020,+
chr9,128693735,2.034763313609468,916,571,1487,+
chr9,128693932,1.9803206997084548,1481,979,2460,+
chr9,128693933,1.9803206997084548,1481,979,2460,+
chr9,128694644,5.320715755927579,2140,1343,3483,+
chr9,128694651,2.169005356115268,2099,1188,3287,+
chr9,128694653,1.9438662950146364,3886,2254,6140,+
chr9,128694654,1.958465818759936,2159,1257,3416,+
chr9,128694666,2.162857142857143,756,489,1245,+
chr9,128694752,1.4686468646864683,669,401,1070,+
chr9,128694753,1.4686468646864683,669,401,1070,+
chr9,128694770,2.3484364970252067,1006,770,1776,+
chr9,128694773,1.9128154140316687,1071,747,1818,+
chr9,128694779,1.650064278534203,2199,1569,3768,+
chr9,128694781,1.5455488652153777,1793,1269,3062,+
chr9,128694795,1.966842686970404,571,478,1049,+
chr9,128694927,0.4886586890516164,683,508,1191,+
chr9,128694931,1.8428571428571427,902,489,1391,+
chr9,128695203,5.283422459893049,987,186,1173,+
chr9,128695206,8.061749955558376,1663,302,1965,+
chr9,128695215,48.62782782782782,1785,554,2339,+
chr9,128695216,34.52944695096687,8347,2193,10540,+
chr9,128695217,33.92298931909068,12151,3681,15832,+
chr9,128695218,32.78087916432603,11254,3535,14789,+
chr9,128695219,29.766658564533486,3428,928,4356,+
chr9,128695226,9.506682252698782,7191,5164,12355,+
chr9,128695227,9.506682252698782,7191,5164,12355,+
chr9,128695271,0.5919025073581429,4812,5190,10002,+
chr9,128695413,1.5049180327868854,1121,609,1730,+
chr9,128695638,1.920560348509439,802,508,1310,+
chr9,128695691,1.555505927231464,746,612,1358,+
chr9,128695853,0.5307807807807807,706,503,1209,+
chr9,128695895,1.5336933693806847,1174,894,2068,+
chr9,128695912,1.7757847533632287,560,445,1005,+
chr9,128695962,0.5086659663865546,595,447,1042,+
chr9,128695978,1.6755219985085756,718,446,1164,+
chr9,128696111,1.823104265402844,668,421,1089,+
chr9,128696289,1.7271138593897029,875,518,1393,+
chr9,128818498,1.510408955325203,1087,651,1738,+
chr9,128822374,2.3453461198366248,570,446,1016,+
chr9,128909120,1.5672235481304695,787,418,1205,+
chr9,128909133,1.137216137993616,1368,1112,2480,+
chr9,128959018,0.5885405482358926,961,613,1574,+
chr9,128959026,1.73133296460177,1317,903,2220,+
chr9,128959027,1.73133296460177,1317,903,2220,+
chr9,128959031,3.0188679245283017,699,529,1228,+
chr9,128959035,2.421507802218462,735,590,1325,+
chr9,128959038,1.953528930503583,3148,2359,5507,+
chr9,128968580,0.3555254237288135,873,499,1372,+
chr9,128968581,1.0150322310556503,1554,879,2433,+
chr9,128968589,0.7160373093375149,2007,1137,3144,+
chr9,128968590,0.7160373093375149,2007,1137,3144,+
chr9,128968634,1.7373029772329247,1084,570,1654,+
chr9,128968638,1.6152725563909773,928,559,1487,+
chr9,128968655,1.7072217881459983,1329,866,2195,+
chr9,128968666,1.7539693632246882,2126,1153,3279,+
chr9,128968667,1.7648845244589924,1590,1169,2759,+
chr9,128981306,4.291548338378503,647,445,1092,+
chr9,128994390,3.136518859848494,589,484,1073,+
chr9,128995464,3.653575284290397,659,472,1131,+
chr9,128999638,0.9563117923062702,590,442,1032,+
chr9,129111562,4.8590715724765765,486,531,1017,+
chr9,129136579,2.496949213388116,691,523,1214,+
chr9,129137657,5.050045495905368,665,470,1135,+
chr9,129137659,5.050045495905368,665,470,1135,+
chr9,129137681,0.9436019577826186,761,609,1370,+
chr9,129142514,1.9880920800542337,949,788,1737,+
chr9,129142515,1.9880920800542337,949,788,1737,+
chr9,129142539,0.6694860117111255,1028,635,1663,+
chr9,129142540,0.6569599711503786,1040,563,1603,+
chr9,129147598,3.7916995260658357,1649,699,2348,+
chr9,129147599,4.180614225368194,1076,460,1536,+
chr9,129147600,3.727876091866593,1691,748,2439,+
chr9,129147604,12.011197224490761,2032,1159,3191,+
chr9,129147605,12.011197224490761,2032,1159,3191,+
chr9,129147613,7.050855736099485,2872,2198,5070,+
chr9,129147614,7.050855736099485,2872,2198,5070,+
chr9,129147615,7.559038958749588,2375,1821,4196,+
chr9,129147622,0.33093527244357224,869,751,1620,+
chr9,129147623,0.927267909784512,791,722,1513,+
chr9,129147648,1.6556055942177874,972,976,1948,+
chr9,129147650,1.107981220657277,707,638,1345,+
chr9,129147742,2.6758620689655173,581,434,1015,+
chr9,129147743,2.6758620689655173,581,434,1015,+
chr9,129148015,14.483628010250568,734,663,1397,+
chr9,129148020,7.350822005293381,504,810,1314,+
chr9,129148095,1.0585403265597395,584,540,1124,+
chr9,129148292,3.514344262295082,1028,487,1515,+
chr9,129148293,3.514344262295082,1028,487,1515,+
chr9,129148294,3.514344262295082,1028,487,1515,+
chr9,129148308,12.587921661707687,2495,1446,3941,+
chr9,129148309,12.587921661707687,2495,1446,3941,+
chr9,129148310,14.390516039051608,736,477,1213,+
chr9,129148316,14.00015505113829,2261,2354,4615,+
chr9,129148317,14.00015505113829,2261,2354,4615,+
chr9,129489200,2.8245666483457046,563,555,1118,+
chr9,130137801,1.1515199333716561,1529,949,2478,+
chr9,130137805,1.846503367746603,1329,847,2176,+
chr9,130137810,2.8333992876929166,715,360,1075,+
chr9,130138771,1.5225609946405294,668,506,1174,+
chr9,130138773,0.8403483634067509,661,522,1183,+
chr9,130217896,0.5879125131276545,736,465,1201,+
chr9,130233235,2.608962553713935,749,542,1291,+
chr9,130233237,2.9639553502985043,1280,895,2175,+
chr9,130233469,5.643620273578141,799,456,1255,+
chr9,130233470,4.910561400885504,1010,591,1601,+
chr9,130233478,7.2927222689259885,2399,2016,4415,+
chr9,130233479,5.8918179892712095,2550,2183,4733,+
chr9,130233480,5.891817989271208,2550,2183,4733,+
chr9,130234159,4.071230020194264,624,437,1061,+
chr9,130235351,3.280992707193192,614,461,1075,+
chr9,130444966,1.3552412234951727,1370,950,2320,+
chr9,130444971,1.6515151515151516,653,593,1246,+
chr9,130452224,1.116452164688907,6056,3872,9928,+
chr9,130452225,0.9504217207165052,4578,2645,7223,+
chr9,130452227,0.7080668608815202,5656,4489,10145,+
chr9,130452228,1.214418018018018,3105,1849,4954,+
chr9,130452247,1.3194682512474765,3463,2916,6379,+
chr9,130452259,1.343023474634404,5701,3534,9235,+
chr9,130458399,1.3238434616069084,1964,1197,3161,+
chr9,130458401,1.382344956168757,3864,2283,6147,+
chr9,130458404,1.4302063789868669,4234,2664,6898,+
chr9,130458406,1.3949652412475997,6743,4142,10885,+
chr9,130458410,1.3263074700050226,5351,3416,8767,+
chr9,130458437,1.257434365058887,12196,8750,20946,+
chr9,130458526,0.7730919189114135,5552,4154,9706,+
chr9,130458527,1.4849623453649148,11364,7947,19311,+
chr9,130458536,1.3708188794708207,17416,13505,30921,+
chr9,130458559,1.2412108393188932,5500,4636,10136,+
chr9,130458560,1.2581401583246603,7646,4877,12523,+
chr9,130466747,1.2549325000323304,9810,7662,17472,+
chr9,130466748,1.2549325000323304,9810,7662,17472,+
chr9,130466749,0.8554579755550847,6363,4923,11286,+
chr9,130466755,1.5773635347946373,5784,4698,10482,+
chr9,130471485,1.7284871077974526,1069,869,1938,+
chr9,130476868,0.914037995664924,617,681,1298,+
chr9,130476869,0.6293950552506553,1703,1468,3171,+
chr9,130476872,1.7818136384324996,2193,1258,3451,+
chr9,130476889,1.4814180741177732,9574,6515,16089,+
chr9,130476891,1.4150473128166565,16501,12517,29018,+
chr9,130476892,1.3438940231997643,9451,8084,17535,+
chr9,130476893,1.3438940231997643,9451,8084,17535,+
chr9,130476896,1.2705320808831913,12356,11335,23691,+
chr9,130476897,1.099560137501859,20465,17741,38206,+
chr9,130476898,1.099560137501859,20465,17741,38206,+
chr9,130479753,0.7873361263109895,4032,3439,7471,+
chr9,130479780,1.425446739073599,26642,16639,43281,+
chr9,130479781,1.412382959403439,32050,21096,53146,+
chr9,130479787,1.4958661747964193,6523,4668,11191,+
chr9,130489332,1.3354225190742517,4310,2506,6816,+
chr9,130489335,1.29229848245334,8587,5519,14106,+
chr9,130489338,1.2740000434195824,10090,6744,16834,+
chr9,130489341,1.5854132243383483,4971,3832,8803,+
chr9,130494889,1.2674463862141665,13843,8888,22731,+
chr9,130494913,1.2476199506794596,22584,16110,38694,+
chr9,130495004,1.3171559442015408,7714,4802,12516,+
chr9,130500977,2.327758650745228,3473,2085,5558,+
chr9,130500981,1.3520183324519657,4129,2561,6690,+
chr9,130500982,0.7507954490987693,8440,6666,15106,+
chr9,130500983,0.7507954490987693,8440,6666,15106,+
chr9,130500984,1.211440115894216,10090,5906,15996,+
chr9,130500998,1.2407435897885388,13353,8240,21593,+
chr9,130501015,1.1645018311208244,15911,11697,27608,+
chr9,130501157,1.5191831070922752,18172,11465,29637,+
chr9,130501226,38.57189251773715,29390,16593,45983,+
chr9,130501228,38.57189251773715,29390,16593,45983,+
chr9,130617808,3.11650344899704,1151,750,1901,+
chr9,130617809,3.0684502936729916,1214,771,1985,+
chr9,130623694,1.5060371743601566,918,625,1543,+
chr9,130630735,1.9318436490673003,861,388,1249,+
chr9,130630736,1.9318436490673003,861,388,1249,+
chr9,130637635,33.01789505229849,3487,2461,5948,+
chr9,130637636,33.01789505229849,3487,2461,5948,+
chr9,130699345,0.9763293059286526,838,462,1300,+
chr9,130703114,1.203468109126584,1039,615,1654,+
chr9,130703131,1.80749695245835,658,427,1085,+
chr9,130703134,2.2547447206629245,1445,1043,2488,+
chr9,130703136,2.344045920015001,2205,1626,3831,+
chr9,130703137,2.218439768866031,2251,1520,3771,+
chr9,130887515,3.7042472661381574,650,447,1097,+
chr9,133019420,0.9751089853063464,21681,15474,37155,+
chr9,133019421,0.9751089853063464,21681,15474,37155,+
chr9,133019431,0.7521985302975545,6243,5533,11776,+
chr9,133019446,1.0822431143269422,24260,17146,41406,+
chr9,133019665,1.0049357581845337,9089,5060,14149,+
chr9,133019666,0.9722607627369866,8090,3933,12023,+
chr9,133019667,0.9388970827914133,13770,8013,21783,+
chr9,133019668,1.0219657782679472,14762,7788,22550,+
chr9,133019669,1.016969416083786,15262,8052,23314,+
chr9,133019670,1.0424152258983346,14288,6345,20633,+
chr9,133019671,1.4422119549274388,6892,3383,10275,+
chr9,133019672,1.7519402028045874,4953,2156,7109,+
chr9,133019673,1.6173439947242598,3487,1732,5219,+
chr9,133019693,1.5742372881355933,1418,648,2066,+
chr9,133019704,0.631947762382545,1791,896,2687,+
chr9,133019717,1.8047880615096572,2221,1152,3373,+
chr9,133019720,1.6831635614079372,10763,5807,16570,+
chr9,133019721,1.6579534708821684,8550,4747,13297,+
chr9,133019726,1.5081415604657558,3356,1677,5033,+
chr9,133019735,2.284395158493445,3961,2217,6178,+
chr9,133019746,1.576242189418538,4096,2734,6830,+
chr9,133019960,0.7898715041572184,740,440,1180,+
chr9,133019962,0.8759756279134393,2099,1092,3191,+
chr9,133019963,0.8779505034261734,2180,1229,3409,+
chr9,133019964,0.8888998207180024,1332,755,2087,+
chr9,133019966,1.1790567213257055,1596,1122,2718,+
chr9,133019968,0.9600982474984849,1709,1236,2945,+
chr9,133019971,0.5974648627347958,826,661,1487,+
chr9,133019972,1.442449088710249,2990,1412,4402,+
chr9,133019975,0.7023291139240505,1066,394,1460,+
chr9,133019978,1.24454166302097,1993,1038,3031,+
chr9,133019979,0.8641531914505848,3850,2945,6795,+
chr9,133019980,1.3942258975101331,1656,627,2283,+
chr9,133019981,0.7643312441242771,10745,7028,17773,+
chr9,133019983,0.637367230172799,4574,3434,8008,+
chr9,133019986,1.3238471890437382,11762,6286,18048,+
chr9,133019987,1.0811653265684185,7993,4177,12170,+
chr9,133019988,1.366851010888072,6716,3650,10366,+
chr9,133019989,0.9578095195658783,17041,10656,27697,+
chr9,133019990,1.1068673156263469,6184,3295,9479,+
chr9,133019991,0.7726680631949464,8226,5972,14198,+
chr9,133019993,1.3712031558185405,9767,5549,15316,+
chr9,133019994,1.4782710686388472,13738,7172,20910,+
chr9,133019998,1.4822722993149058,9040,3968,13008,+
chr9,133019999,1.5817661430536316,14604,7439,22043,+
chr9,133020372,0.9405316091954024,1081,579,1660,+
chr9,133020374,0.8746622683283202,2898,1722,4620,+
chr9,133020375,1.0294878824432503,1538,828,2366,+
chr9,133020419,3.9197802197802187,860,454,1314,+
chr9,133020422,1.819756554307116,844,355,1199,+
chr9,133020470,1.4908771428885204,4813,2460,7273,+
chr9,133020471,1.5716679091836085,7976,4728,12704,+
chr9,133020472,1.504087183579009,9785,6087,15872,+
chr9,133020474,1.3286034403654476,3444,2548,5992,+
chr9,133020475,1.4231964409469942,7552,4363,11915,+
chr9,133020476,1.244842097668001,12713,7473,20186,+
chr9,133020477,1.3353534449510156,12569,7726,20295,+
chr9,133020478,1.327389818656142,11243,6652,17895,+
chr9,133020479,0.9500308216137915,6580,5893,12473,+
chr9,133020480,1.1676082582665532,17860,13195,31055,+
chr9,133020484,1.290969235746162,6880,4806,11686,+
chr9,133020485,1.5290167509168402,3525,2359,5884,+
chr9,133020488,1.4234549986027925,15910,11700,27610,+
chr9,133020490,1.2598647722142018,7129,5881,13010,+
chr9,133020491,1.0264220153243144,10689,8420,19109,+
chr9,133020492,1.1844887299154032,6017,3913,9930,+
chr9,133020495,1.279568428689671,11596,9884,21480,+
chr9,133020502,1.2362177018768312,14735,10253,24988,+
chr9,133020505,1.2292891290415116,16473,11722,28195,+
chr9,133053886,1.2819118549688926,813,577,1390,+
chr9,133056874,2.391738840772818,717,473,1190,+
chr9,133056875,2.292261200554887,985,695,1680,+
chr9,133057909,5.448487690259024,1075,526,1601,+
chr9,133057911,5.319959692821859,1176,580,1756,+
chr9,133057912,8.182568117400974,1088,632,1720,+
chr9,133057915,5.815174239028719,693,544,1237,+
chr9,133057918,5.748436313656048,1098,2026,3124,+
chr9,133057919,5.393319851405472,657,1253,1910,+
chr9,133057938,0.23164967409917836,571,1329,1900,+
chr9,133057940,0.20917307041708955,540,1253,1793,+
chr9,133057941,0.28648668695234153,1189,2271,3460,+
chr9,133057942,0.2782059950416948,728,1333,2061,+
chr9,133057948,0.32803944715750905,501,990,1491,+
chr9,133058062,4.104115074540319,667,441,1108,+
chr9,133348204,1.0752112852453382,983,534,1517,+
chr9,133348205,1.2195053760205412,733,421,1154,+
chr9,133348216,0.9383653782113205,3343,1605,4948,+
chr9,133348217,0.9786471499985252,4523,2110,6633,+
chr9,133348218,1.2093723507624117,5570,2683,8253,+
chr9,133348219,0.8142493638676845,4799,1964,6763,+
chr9,133348221,1.1950181474628956,5139,2709,7848,+
chr9,133348225,1.6025458786705593,2459,1275,3734,+
chr9,133349607,1.5678776290630976,819,522,1341,+
chr9,133349609,1.393584641033467,1458,804,2262,+
chr9,133349639,0.5793199065966141,933,570,1503,+
chr9,133349662,1.6468697311733682,4918,2585,7503,+
chr9,133349663,1.7230939379276973,3115,1257,4372,+
chr9,133349666,1.444180350176903,1808,754,2562,+
chr9,133349670,1.4781347210466538,3863,2338,6201,+
chr9,133349673,1.6248570560050952,2244,972,3216,+
chr9,133349913,1.3489783091111995,3320,1590,4910,+
chr9,133349935,1.1698771733599385,18914,12675,31589,+
chr9,133349937,1.2960449825137292,14587,9698,24285,+
chr9,133349938,1.3108242435092217,16331,10260,26591,+
chr9,133349941,1.3332652520343713,12245,7636,19881,+
chr9,133349943,0.717203463583918,11740,9714,21454,+
chr9,133349960,0.9872007720309691,17913,13471,31384,+
chr9,133349964,1.290748939580891,39790,32177,71967,+
chr9,133349965,1.2602175013656478,52737,40023,92760,+
chr9,133350266,1.5421822027274983,23204,14141,37345,+
chr9,133350271,1.3972367017697571,25637,16578,42215,+
chr9,133350624,0.9534776304299327,37885,27584,65469,+
chr9,133350625,1.098920651429514,73611,57195,130806,+
chr9,133350627,1.2596383529266584,63614,46938,110552,+
chr9,133351048,1.2610183766258438,4449,3432,7881,+
chr9,133351059,1.2898146539814275,8877,5615,14492,+
chr9,133351259,0.9617780676578601,1418,1062,2480,+
chr9,133351260,0.8539432390211902,1490,1023,2513,+
chr9,133351282,1.2102485099280693,22765,16099,38864,+
chr9,133351283,1.3973473704539254,28973,19779,48752,+
chr9,134079147,1.129319581631205,601,464,1065,+
chr9,134079150,2.286130798276547,592,461,1053,+
chr9,134142018,4.137122002085507,682,455,1137,+
chr9,134843392,1.7351464435146442,571,477,1048,+
chr9,134843459,2.2473229824193273,1529,1249,2778,+
chr9,135087921,0.8207706802717678,866,477,1343,+
chr9,135087922,0.9751815301320754,1435,796,2231,+
chr9,135087947,0.2835989767807949,1152,527,1679,+
chr9,135087949,0.2835989767807949,1152,527,1679,+
chr9,135087957,2.118703358208955,1816,937,2753,+
chr9,135087958,2.0047317889170504,2652,1266,3918,+
chr9,135087969,1.7945772058823528,2254,1311,3565,+
chr9,135087970,1.332298180844621,3512,2134,5646,+
chr9,135087972,1.0694273004030206,2418,1280,3698,+
chr9,135088007,2.47684482235044,1449,711,2160,+
chr9,135088038,1.7970173041894353,573,487,1060,+
chr9,135088052,1.5857758620689655,848,695,1543,+
chr9,135088085,2.133228650803237,608,486,1094,+
chr9,135088123,2.4193081941245422,1063,668,1731,+
chr9,135090218,2.90865671641791,695,334,1029,+
chr9,135090266,1.687415592387968,858,542,1400,+
chr9,135090285,1.8463082437275984,547,464,1011,+
chr9,135090293,3.391376451077944,817,602,1419,+
chr9,135090295,1.8074074074074076,1036,764,1800,+
chr9,135090296,1.5942828840302836,1047,672,1719,+
chr9,135090314,1.4754511826028471,1052,810,1862,+
chr9,135090316,0.5596393645253935,1431,1037,2468,+
chr9,135095867,0.615220789035261,1193,868,2061,+
chr9,135095933,1.7992619926199265,1218,1083,2301,+
chr9,135095939,2.086488356945123,1576,1067,2643,+
chr9,135097976,1.6176470588235294,824,611,1435,+
chr9,135098337,1.4038095238095243,1607,1049,2656,+
chr9,135098354,1.630673248320307,1419,1143,2562,+
chr9,135098367,0.5218518518518519,1408,1124,2532,+
chr9,135098385,0.6561616161616163,1826,1484,3310,+
chr9,135106841,2.5772994129158513,877,510,1387,+
chr9,135119522,0.6303953399541634,977,747,1724,+
chr9,135119527,1.629767630919314,890,508,1398,+
chr9,135119572,1.7902964959568732,1106,635,1741,+
chr9,135119580,2.9420277517664086,959,690,1649,+
chr9,135119633,1.6948165404775766,969,605,1574,+
chr9,135119645,2.0132627332324757,1078,660,1738,+
chr9,135119651,1.4388920293951384,978,724,1702,+
chr9,135119656,1.5038991601923906,2380,1630,4010,+
chr9,135119659,1.5893311504485146,2197,1684,3881,+
chr9,135119660,1.6593377067692534,2980,2345,5325,+
chr9,135119666,1.601225934559268,1090,890,1980,+
chr9,135119827,1.7472035794183445,780,446,1226,+
chr9,135119882,2.4748040313549837,679,375,1054,+
chr9,135119888,2.140806561859193,695,398,1093,+
chr9,135119939,2.129943502824859,701,530,1231,+
chr9,135119945,1.9339375149057956,953,598,1551,+
chr9,135119993,1.6795415805316791,841,706,1547,+
chr9,135120035,1.5394242803504383,989,798,1787,+
chr9,135120047,1.8967083391862152,987,790,1777,+
chr9,135120068,0.6354400316664467,687,688,1375,+
chr9,135120146,3.0984555984555984,534,517,1051,+
chr9,135120216,1.788698985505769,2047,1357,3404,+
chr9,135120249,0.5225478756263299,992,856,1848,+
chr9,135120321,1.5701884920634919,1947,1279,3226,+
chr9,135120358,1.5895743609821582,1420,940,2360,+
chr9,135120369,1.0780858676207512,2126,1559,3685,+
chr9,135120370,1.0780858676207512,2126,1559,3685,+
chr9,135120417,1.921540312876053,997,553,1550,+
chr9,135120447,0.5729248939815546,1024,798,1822,+
chr9,135120451,0.7312252964426877,1183,879,2062,+
chr9,135120608,2.2535559678416823,910,692,1602,+
chr9,135120614,1.6344849400766177,1010,768,1778,+
chr9,135120663,1.3642801455301454,1264,1039,2303,+
chr9,135120791,1.9839980893240983,1916,1184,3100,+
chr9,135120842,0.7843191964285714,2810,1663,4473,+
chr9,135120853,1.9319491419265944,2517,1773,4290,+
chr9,135120863,0.8285913946291306,4149,2861,7010,+
chr9,135120922,1.5202496641371868,14563,9026,23589,+
chr9,135120924,1.3865030347936782,31919,19483,51402,+
chr9,135121024,1.5356290520714104,3449,2775,6224,+
chr9,135121028,2.1036385230706105,3483,2932,6415,+
chr9,135121113,2.070594224279989,3768,3351,7119,+
chr9,135501097,1.7685366960575302,683,414,1097,+
chr9,135501848,0.3193352301860994,660,433,1093,+
chr9,135501852,0.8919075316781774,1351,884,2235,+
chr9,135501854,1.159919028340081,954,584,1538,+
chr9,135503669,1.7662836888452,698,511,1209,+
chr9,135503888,2.4507592108476426,735,562,1297,+
chr9,136417171,1.8797249925519661,826,507,1333,+
chr9,136791988,1.8517899446455082,600,519,1119,+
chr9,136792294,1.1885088465181737,1704,964,2668,+
chr9,136792295,1.076420364709603,850,536,1386,+
chr9,136792296,1.30969030969031,854,428,1282,+
chr9,136793150,9.148354705747654,648,543,1191,+
chr9,136849443,4.987681650488829,553,507,1060,+
chr9,136850014,4.807256235827664,529,503,1032,+
chr9,136850015,4.807256235827664,529,503,1032,+
chr9,136850020,2.4690431519699816,867,532,1399,+
chr9,136850021,2.4690431519699816,867,532,1399,+
chr9,137188751,0.8875741476711484,549,528,1077,+
chr9,137188753,0.4230371900826447,636,615,1251,+
chr9,137189187,2.6666666666666665,639,439,1078,+
chr9,137189188,2.6666666666666665,639,439,1078,+
chr9,137189205,0.49311674008810585,596,453,1049,+
chr9,137241367,2.089057012702005,750,475,1225,+
chr9,137241915,0.4166164576672661,875,487,1362,+
chr9,137241941,1.6508034560351414,992,564,1556,+
chr9,137242512,2.8244827593766053,1162,860,2022,+
chr9,137242513,3.2768588405331625,582,478,1060,+
chr9,137242538,0.5209959123002601,700,482,1182,+
chr9,137242671,2.301853848706038,942,565,1507,+
chr9,137242678,1.9970902885235728,945,621,1566,+
chr9,137242690,1.5837695272874823,696,464,1160,+
chr9,137242796,1.5902358099300866,1319,872,2191,+
chr9,137242797,1.6572535991140642,729,644,1373,+
chr9,137242993,1.2283496732026142,581,543,1124,+
chr9,137242994,1.2283496732026142,581,543,1124,+
chr9,137243106,2.06,720,419,1139,+
chr9,137243164,2.0016860906760816,1126,758,1884,+
chr9,137243437,2.0572385871841408,920,493,1413,+
chr9,137243439,2.0572385871841408,920,493,1413,+
chr9,137243460,1.806903181425015,878,589,1467,+
chr9,137243488,3.3101549053356285,600,414,1014,+
chr9,137243545,3.503929501967274,1014,715,1729,+
chr9,137243548,3.438063610659859,792,590,1382,+
chr9,137243551,2.72540593129331,1474,1259,2733,+
chr9,137243553,2.5201232428268816,568,576,1144,+
chr9,137243558,2.3910753021382085,642,460,1102,+
chr9,137243563,0.4698236651351971,1044,822,1866,+
chr9,137243601,0.5068516042780749,673,543,1216,+
chr9,137552380,2.217857142857143,620,489,1109,+
chr9,137552381,2.217857142857143,620,489,1109,+
chr9,137552425,0.41647713170863787,821,556,1377,+
chr10,996114,1.751942501942502,621,467,1088,+
chr10,999047,1.0572082821743927,768,503,1271,+
chr10,1000824,2.139312440104658,715,589,1304,+
chr10,1000983,0.8789773115588998,1662,1131,2793,+
chr10,1005829,2.7150793650793648,621,419,1040,+
chr10,1010445,0.5728351272015655,968,671,1639,+
chr10,1010473,1.6485424850113706,885,690,1575,+
chr10,1014257,1.8327134024307274,2375,1559,3934,+
chr10,1014259,1.99549887471868,1595,1031,2626,+
chr10,1014265,1.8516129032258064,1229,929,2158,+
chr10,1014267,1.8516129032258064,1229,929,2158,+
chr10,1014271,1.5859114707282245,713,572,1285,+
chr10,1014278,1.573399949615728,3030,2271,5301,+
chr10,1014284,2.8585526315789482,868,740,1608,+
chr10,1014287,1.65570419918246,937,827,1764,+
chr10,1015797,2.461791831357049,706,505,1211,+
chr10,1015799,1.8487011829109863,1017,724,1741,+
chr10,1017150,5.457755277035626,1299,971,2270,+
chr10,1017163,1.9256926952141056,1111,793,1904,+
chr10,1017165,1.9256926952141056,1111,793,1904,+
chr10,1017225,0.5590928602088997,520,481,1001,+
chr10,1017286,0.4877802973041068,725,566,1291,+
chr10,1017298,2.9066353493834414,549,523,1072,+
chr10,3067547,0.8697565028526968,1119,400,1519,+
chr10,3082429,1.4934326908171116,845,664,1509,+
chr10,3099300,0.42114562023433133,646,565,1211,+
chr10,3099302,0.9962682810231867,1163,900,2063,+
chr10,3101370,2.3253409897907114,745,526,1271,+
chr10,3101431,3.849610871936778,855,551,1406,+
chr10,3101523,4.342781646313028,585,445,1030,+
chr10,3103804,1.7718681318681313,972,636,1608,+
chr10,3103805,1.7718681318681313,972,636,1608,+
chr10,3103847,1.3886321625881461,840,711,1551,+
chr10,3105137,1.4893135799632669,622,471,1093,+
chr10,3105458,1.7271540469973894,636,382,1018,+
chr10,3105475,1.5363984674329498,801,492,1293,+
chr10,3105488,1.8994805559455288,614,418,1032,+
chr10,3107226,2.4014184816274406,4206,2294,6500,+
chr10,3107227,2.5146150929086084,3187,1757,4944,+
chr10,3107228,2.5146150929086084,3187,1757,4944,+
chr10,3107257,2.3931086182431534,1514,910,2424,+
chr10,3112261,1.6929185108044782,764,500,1264,+
chr10,3113452,0.9776519303373522,844,713,1557,+
chr10,3113453,0.9776519303373522,844,713,1557,+
chr10,3113474,1.9418105855335517,1208,659,1867,+
chr10,3113486,1.5209699211260768,1292,758,2050,+
chr10,3116779,1.1182847003742526,1499,870,2369,+
chr10,3116781,0.9471984603753179,2034,1249,3283,+
chr10,3116782,2.038690810932404,635,522,1157,+
chr10,3116795,1.6166089965397925,729,577,1306,+
chr10,3116809,0.49049140422942333,805,625,1430,+
chr10,3116827,1.4358654375715372,5256,3785,9041,+
chr10,3116828,1.5242420790814881,8156,5931,14087,+
chr10,3116830,1.4536203627686224,6966,4917,11883,+
chr10,3118807,2.199637796953233,711,446,1157,+
chr10,3119910,4.561514195583597,722,633,1355,+
chr10,3119912,4.561514195583597,722,633,1355,+
chr10,3119927,2.227913440540004,723,437,1160,+
chr10,3119928,1.6121807179772205,1090,736,1826,+
chr10,3129942,1.715212134767936,1024,750,1774,+
chr10,3132401,1.0091802473307914,2301,1604,3905,+
chr10,3132402,1.0091802473307914,2301,1604,3905,+
chr10,3134502,0.6021185038066865,641,476,1117,+
chr10,3134503,0.37937219730941707,563,445,1008,+
chr10,3135738,0.5940318984736752,752,594,1346,+
chr10,3135739,0.8921820081694691,1760,1304,3064,+
chr10,3135741,0.8921820081694691,1760,1304,3064,+
chr10,3136495,2.263693131132917,792,589,1381,+
chr10,3136594,2.2212982832618025,636,465,1101,+
chr10,3136643,1.6038492381716118,1124,782,1906,+
chr10,4963413,0.9926924191611807,606,497,1103,+
chr10,4963414,0.7753167197872517,1182,926,2108,+
chr10,4963415,0.6387555590585654,1363,1156,2519,+
chr10,4965943,0.4000748806719643,611,517,1128,+
chr10,4965944,0.6376149329788411,1000,707,1707,+
chr10,4966991,1.7317487266553482,611,398,1009,+
chr10,4972636,1.5399332810047095,729,391,1120,+
chr10,4972637,4.116114534734059,1321,713,2034,+
chr10,4972638,1.5399332810047095,729,391,1120,+
chr10,4972664,1.4285407748507657,782,565,1347,+
chr10,4977837,2.4893643719684437,589,508,1097,+
chr10,4977840,0.3270440251572327,687,515,1202,+
chr10,5094453,0.4649202001105596,1243,787,2030,+
chr10,5096450,1.2241720681673542,1561,1034,2595,+
chr10,5096527,1.0885027885027885,840,656,1496,+
chr10,5096528,0.38996138996139,605,517,1122,+
chr10,5105621,2.1241221910112356,980,711,1691,+
chr10,5105623,2.1241221910112356,980,711,1691,+
chr10,5105626,1.7357954545454546,610,447,1057,+
chr10,5107601,0.6045254981425194,894,629,1523,+
chr10,5724435,2.1655106888361044,813,420,1233,+
chr10,5724436,2.1655106888361044,813,420,1233,+
chr10,5724505,2.5823686553873557,1449,1122,2571,+
chr10,5724506,2.9914197597532732,2205,1772,3977,+
chr10,5724508,2.6484232963450567,1490,1226,2716,+
chr10,5746727,1.0351212063370874,637,402,1039,+
chr10,5746728,1.0351212063370874,637,402,1039,+
chr10,5749902,3.1467567131311633,579,429,1008,+
chr10,6101287,2.1093366117525485,589,459,1048,+
chr10,6104967,2.5635562377805177,754,559,1313,+
chr10,6104984,1.3292637661381794,684,487,1171,+
chr10,6106151,1.4242557386887285,722,536,1258,+
chr10,6112268,8.35757779290491,1285,1142,2427,+
chr10,6112269,9.01745429056133,1125,1079,2204,+
chr10,6114073,11.130485164003753,1207,1098,2305,+
chr10,6115279,0.38396929283768594,681,509,1190,+
chr10,6115494,3.2012595690955536,689,483,1172,+
chr10,7788187,0.661034388007588,1077,707,1784,+
chr10,7788246,1.7841502097615882,810,673,1483,+
chr10,7796123,1.7775537634408602,1057,650,1707,+
chr10,7796126,1.4292866679382032,1198,748,1946,+
chr10,7797060,1.4891200382592062,794,611,1405,+
chr10,7797096,1.51357200829651,1048,852,1900,+
chr10,7797100,1.476799078871618,1165,964,2129,+
chr10,7798997,1.1311682067285924,4436,3304,7740,+
chr10,7798998,1.0980503606380156,5434,3801,9235,+
chr10,7799059,1.5751612728356914,1185,857,2042,+
chr10,7799125,1.9352232667450058,849,591,1440,+
chr10,7799172,1.736941247428106,3893,2846,6739,+
chr10,7799814,2.2931386146691684,1040,720,1760,+
chr10,7800037,1.565929565929566,955,725,1680,+
chr10,7802284,1.558857142857143,1084,874,1958,+
chr10,7802373,1.5478941255577967,1150,797,1947,+
chr10,7802823,1.6716417910447758,1175,937,2112,+
chr10,12196216,1.4649872448979595,740,783,1523,+
chr10,12196217,2.4043956043004386,1533,1508,3041,+
chr10,12196218,2.4043956043004386,1533,1508,3041,+
chr10,12196248,0.5409739982949702,780,815,1595,+
chr10,12196249,0.5409739982949702,780,815,1595,+
chr10,12198738,0.5467531162263503,1039,819,1858,+
chr10,12198749,2.2538699690402475,701,512,1213,+
chr10,12209968,1.168358900783578,682,532,1214,+
chr10,12209969,1.168358900783578,682,532,1214,+
chr10,12217380,1.6620560747663546,740,534,1274,+
chr10,12235072,2.169407894736842,1318,879,2197,+
chr10,12235073,2.169407894736842,1318,879,2197,+
chr10,12249639,1.9835798173118744,628,483,1111,+
chr10,12250438,2.1339572413757906,646,513,1159,+
chr10,12250486,1.8521560574948663,615,486,1101,+
chr10,13610071,2.181526313506009,810,590,1400,+
chr10,13610072,1.6803408637025596,1886,1285,3171,+
chr10,13610074,2.311248073959938,839,648,1487,+
chr10,14867260,3.4209754117161535,908,550,1458,+
chr10,14867741,2.5957612972938104,1280,720,2000,+
chr10,14867749,3.2629139960311138,1137,668,1805,+
chr10,14867752,2.200284479457301,1086,676,1762,+
chr10,14867759,2.2616291887125217,1414,1007,2421,+
chr10,14867760,2.2616291887125217,1414,1007,2421,+
chr10,16505143,1.8325275680373727,1037,897,1934,+
chr10,16505144,1.8325275680373727,1037,897,1934,+
chr10,17229282,0.5270962583349464,748,682,1430,+
chr10,17229283,1.6275473761325978,1052,750,1802,+
chr10,17229458,1.7026949889649001,1509,927,2436,+
chr10,17229579,0.6235521235521235,911,517,1428,+
chr10,17229674,1.6638240574506284,1010,556,1566,+
chr10,17229681,2.4791666666666665,1070,593,1663,+
chr10,17229696,2.2537539814955254,1142,693,1835,+
chr10,17229698,1.5148181635523408,568,473,1041,+
chr10,17229705,1.5174386194527254,1203,808,2011,+
chr10,17229708,1.8006102955062766,1708,1416,3124,+
chr10,17229710,1.6337479439747373,3101,2367,5468,+
chr10,17229725,0.5345911949685535,849,749,1598,+
chr10,17229767,1.4665607120152573,1356,1209,2565,+
chr10,17229913,1.0601618810964184,1821,1309,3130,+
chr10,17229920,1.6948730711796909,1134,783,1917,+
chr10,17229921,1.747277009125699,1318,789,2107,+
chr10,17230671,1.6153019447287615,1168,976,2144,+
chr10,17230695,2.0640582838640045,1341,1089,2430,+
chr10,17230697,1.0469830126722357,3909,2700,6609,+
chr10,17233587,0.7819720921155346,1930,1463,3393,+
chr10,17233644,1.379460745440127,1714,1357,3071,+
chr10,17233875,1.483637406358651,1591,1212,2803,+
chr10,17233909,2.2187078109932497,1437,1219,2656,+
chr10,17234722,2.7906737967914435,1207,934,2141,+
chr10,17234762,1.4658052891079492,3031,2359,5390,+
chr10,17235168,0.6513634169884169,1769,1294,3063,+
chr10,17235187,1.4214188312768152,2400,1404,3804,+
chr10,17235196,1.4617769827072151,1750,1364,3114,+
chr10,17235207,1.5097795652395254,1876,1510,3386,+
chr10,17236294,1.4983273849219616,4658,3307,7965,+
chr10,17236295,1.6004338376084597,2748,1998,4746,+
chr10,17236303,1.2700120351902182,1755,1350,3105,+
chr10,17236321,1.4750802276497212,3991,3341,7332,+
chr10,17236322,1.4750802276497212,3991,3341,7332,+
chr10,17237384,1.5359116022099448,3419,2714,6133,+
chr10,17237408,1.5192929707074851,3334,2438,5772,+
chr10,22326431,3.5160986124208535,579,570,1149,+
chr10,22326432,1.2244711173422977,1015,749,1764,+
chr10,22326433,2.8492594803700975,1814,1607,3421,+
chr10,22326434,4.580437853107345,820,943,1763,+
chr10,22326435,4.580437853107345,820,943,1763,+
chr10,22326436,3.536334687127518,861,935,1796,+
chr10,22327762,2.9329018677459118,657,467,1124,+
chr10,22327967,2.375699990734735,576,428,1004,+
chr10,22328003,0.4012385086823289,837,711,1548,+
chr10,22328007,1.3496894409937892,953,839,1792,+
chr10,27165388,3.5787350282210806,723,479,1202,+
chr10,27165450,1.9666332999666325,1262,998,2260,+
chr10,27165451,1.8936269480748484,1929,1335,3264,+
chr10,27170112,0.8192112076396102,835,424,1259,+
chr10,27170184,2.2226333641689795,635,422,1057,+
chr10,27170185,0.6219630709426628,679,356,1035,+
chr10,27170190,2.318036475481714,1514,937,2451,+
chr10,27170198,1.5436590436590438,854,480,1334,+
chr10,27170199,1.1713529519666677,1787,1230,3017,+
chr10,27170201,1.1713529519666677,1787,1230,3017,+
chr10,27170204,1.5289008685235101,1020,741,1761,+
chr10,27170207,1.5929719626168224,2225,1749,3974,+
chr10,27170208,1.5580817659514072,3471,2449,5920,+
chr10,27170217,1.8945964684301613,4305,3332,7637,+
chr10,27170218,1.9078904343889125,2708,2394,5102,+
chr10,27186543,0.9317673378076062,594,446,1040,+
chr10,27186544,0.9317673378076062,594,446,1040,+
chr10,27538414,2.8382024208173995,837,547,1384,+
chr10,27539023,1.0206919945725916,1002,736,1738,+
chr10,27539025,1.0206919945725916,1002,736,1738,+
chr10,28535650,1.465200378522733,940,589,1529,+
chr10,28583486,2.344533333333333,627,374,1001,+
chr10,28595751,2.374486266424151,583,441,1024,+
chr10,28608345,1.6249891589247067,708,525,1233,+
chr10,28610753,2.630065924565006,675,486,1161,+
chr10,28610769,1.4136468136700149,1438,971,2409,+
chr10,28610789,1.9461743772241995,874,561,1435,+
chr10,28611776,1.6580867242087958,1093,810,1903,+
chr10,28611780,1.9935525047773481,3512,2755,6267,+
chr10,28611781,2.3931398416886545,3627,3031,6658,+
chr10,28611783,1.9046323103647944,3884,3453,7337,+
chr10,28611784,1.5826038434761514,3370,2940,6310,+
chr10,28616269,1.6422545847886219,923,700,1623,+
chr10,28620103,2.4976395730265635,683,505,1188,+
chr10,28620306,1.699189882504315,1390,1068,2458,+
chr10,28620386,2.980272108843537,673,489,1162,+
chr10,28620442,2.1860674111983207,944,754,1698,+
chr10,28620480,6.4334705075445795,669,728,1397,+
chr10,28620481,6.072687202946656,1580,1458,3038,+
chr10,28620550,0.5108225108225108,589,419,1008,+
chr10,35195132,0.925854234317382,1259,502,1761,+
chr10,35195137,4.710657931129313,1019,404,1423,+
chr10,35211296,2.3141886814743877,998,713,1711,+
chr10,35211615,2.922201138519924,699,526,1225,+
chr10,35211617,2.922201138519924,699,526,1225,+
chr10,35211698,1.8606542562804986,709,502,1211,+
chr10,35211740,2.469444444444445,761,539,1300,+
chr10,38057975,5.753826428060429,1483,966,2449,+
chr10,38057976,5.52662736400736,1614,1044,2658,+
chr10,42567345,0.4316979736291637,728,605,1333,+
chr10,42785496,0.991109371505256,708,525,1233,+
chr10,42785498,2.0316337754091927,1203,823,2026,+
chr10,42817452,0.6307847136185769,623,442,1065,+
chr10,42820565,0.40646976090014064,1189,629,1818,+
chr10,42820566,0.40646976090014064,1189,629,1818,+
chr10,43184649,0.8187890477602962,624,391,1015,+
chr10,45972711,3.2567726737338045,631,565,1196,+
chr10,45972712,2.9786892716616076,1030,801,1831,+
chr10,45982557,1.9158485273492285,682,433,1115,+
chr10,46003286,1.6684474397961695,724,528,1252,+
chr10,46003563,1.519834850593138,1327,1028,2355,+
chr10,46003574,0.619445372535917,720,510,1230,+
chr10,50069687,0.7024367501581111,630,379,1009,+
chr10,52315068,0.5517867271695973,607,409,1016,+
chr10,52315069,0.5088291412312769,804,612,1416,+
chr10,52316413,2.060544464609801,886,550,1436,+
chr10,52316417,1.8524687785941394,1641,1112,2753,+
chr10,52316421,1.9403669724770645,704,544,1248,+
chr10,52316680,0.5337482384137603,1597,1108,2705,+
chr10,52316698,0.4913200723327306,626,473,1099,+
chr10,52316700,1.94834928748733,2066,1347,3413,+
chr10,52317011,1.6322501028383383,767,560,1327,+
chr10,58269161,1.0846721388811198,1912,2909,4821,+
chr10,58269162,1.0082776877234996,2874,4296,7170,+
chr10,58269164,0.6381756074341044,2145,3089,5234,+
chr10,58269169,0.3680251017152386,2033,2462,4495,+
chr10,58269170,0.29714912280701755,1354,1519,2873,+
chr10,58269177,0.48992373452497195,13038,9088,22126,+
chr10,58269178,0.4890589744412935,14442,10056,24498,+
chr10,58269179,0.5411332780737151,23219,14614,37833,+
chr10,58269181,0.6928497618544185,21287,11953,33240,+
chr10,58269183,1.0629028780319203,11349,6785,18134,+
chr10,58269281,1.6784274193548387,665,371,1036,+
chr10,58269288,2.2823457223001404,788,495,1283,+
chr10,58277189,1.986915334517466,906,562,1468,+
chr10,58277205,1.0600416698168127,1827,1330,3157,+
chr10,58287648,1.6711437274993075,1340,784,2124,+
chr10,58287656,2.6306180861762205,1387,833,2220,+
chr10,58395039,2.1698768178433574,648,502,1150,+
chr10,58702083,2.333991228070176,733,759,1492,+
chr10,58702084,3.2359843371978396,1016,983,1999,+
chr10,60778556,0.5960459645313066,849,613,1462,+
chr10,60778557,0.5833110218652386,816,497,1313,+
chr10,60784765,0.6515774336449388,3283,2294,5577,+
chr10,60785729,0.6434614379084967,1662,1124,2786,+
chr10,60788066,1.6262905162064825,1177,832,2009,+
chr10,60791990,2.0830819215595264,1231,972,2203,+
chr10,60792193,0.6757701792484082,1835,1344,3179,+
chr10,60792220,2.0233889602053914,1486,1024,2510,+
chr10,60792264,2.110163158550255,1254,867,2121,+
chr10,60792267,1.6375380496241365,3051,2080,5131,+
chr10,60793916,1.4997404964994276,5724,4332,10056,+
chr10,60794151,1.8001167201634083,596,446,1042,+
chr10,60794417,5.561375899280577,852,555,1407,+
chr10,60794538,1.9088743125254284,4921,3653,8574,+
chr10,60794539,1.4330749240998817,11236,7454,18690,+
chr10,62806735,0.8762491933246991,615,397,1012,+
chr10,62806963,4.303104077609585,589,420,1009,+
chr10,62806971,1.0780898679603526,1077,829,1906,+
chr10,63153829,1.855077605321508,580,450,1030,+
chr10,63610300,2.0086653881667735,706,360,1066,+
chr10,63610301,1.3341784212624237,1123,638,1761,+
chr10,63619691,1.9274734443695645,1017,662,1679,+
chr10,63619693,1.9274734443695645,1017,662,1679,+
chr10,63619696,1.9944743240256393,1176,830,2006,+
chr10,63619697,1.9524699947330983,2162,1268,3430,+
chr10,63619703,2.106090373280943,1071,508,1579,+
chr10,64826333,1.3552775659996665,662,643,1305,+
chr10,67917145,2.7690532553760314,970,656,1626,+
chr10,68166520,4.754610815879962,584,456,1040,+
chr10,68175473,2.9675725875694337,724,395,1119,+
chr10,68175494,1.0852177347684409,784,493,1277,+
chr10,68175496,1.0852177347684409,784,493,1277,+
chr10,68175535,2.3573369565217392,693,367,1060,+
chr10,68189090,1.3199382845921874,648,440,1088,+
chr10,68189093,1.9337084148727983,509,510,1019,+
chr10,68189102,1.7490347490347489,905,628,1533,+
chr10,68189103,0.6436561420312661,671,712,1383,+
chr10,68201863,0.6998726568803956,691,472,1163,+
chr10,68206823,3.4822811767203636,865,572,1437,+
chr10,68211204,3.0181511849946765,899,581,1480,+
chr10,68211321,1.7038951110772698,1066,744,1810,+
chr10,68337199,0.5478260869565217,611,390,1001,+
chr10,68337233,0.5236864771748493,799,644,1443,+
chr10,68337235,1.9292786421499293,991,605,1596,+
chr10,68337932,2.5019007857453377,1347,895,2242,+
chr10,68337953,1.8156147732585317,1386,929,2315,+
chr10,68337954,1.7717843104064401,2140,1436,3576,+
chr10,68337956,1.6708715596330277,1456,980,2436,+
chr10,68337981,1.6632860040567952,819,543,1362,+
chr10,68337982,2.095106026463281,979,640,1619,+
chr10,68338640,1.644151962185361,1980,1151,3131,+
chr10,68339149,4.120341987424436,5555,3692,9247,+
chr10,68339167,2.2199201305393337,1694,1135,2829,+
chr10,68339170,1.8516204228357958,3441,2141,5582,+
chr10,68339173,1.6672297297297296,3842,2927,6769,+
chr10,68339174,1.579634009150385,5815,4063,9878,+
chr10,68339470,2.766457252116908,632,522,1154,+
chr10,68339537,0.4828033744321869,1115,870,1985,+
chr10,68341268,1.9917184265010348,1039,643,1682,+
chr10,68341585,1.7662428882489287,761,618,1379,+
chr10,68341609,1.7875,593,479,1072,+
chr10,68341802,3.3825849020446155,1351,1027,2378,+
chr10,68341999,2.590322479071494,1848,1408,3256,+
chr10,68342001,2.976392158185243,2420,1804,4224,+
chr10,68342002,3.9812457947638995,1249,958,2207,+
chr10,68342032,4.299188442159265,951,668,1619,+
chr10,68342035,5.15394483243227,917,865,1782,+
chr10,68342044,6.077467210861831,4863,4892,9755,+
chr10,68342045,6.07746721086183,4863,4892,9755,+
chr10,68342046,4.455782753396097,1869,1456,3325,+
chr10,68342049,0.5399948559670782,441,647,1088,+
chr10,68342051,0.42625076266015854,1448,1191,2639,+
chr10,68342052,0.44861944520294256,2610,2837,5447,+
chr10,68342054,0.5707558416785886,765,698,1463,+
chr10,68342055,0.5489021956087825,749,1001,1750,+
chr10,68342058,0.47486199456384676,1841,1404,3245,+
chr10,68342060,0.47486199456384676,1841,1404,3245,+
chr10,68342067,0.6563676286072773,1084,796,1880,+
chr10,68342258,1.6906729634002362,1073,725,1798,+
chr10,68342501,1.8130002425418383,649,433,1082,+
chr10,68749219,2.2345679012345685,723,431,1154,+
chr10,68749220,2.2345679012345685,723,431,1154,+
chr10,68749248,2.3572388632872503,570,433,1003,+
chr10,68913473,2.1525367866609244,932,714,1646,+
chr10,68913478,2.907722210570749,614,455,1069,+
chr10,68914181,1.2604713095590572,795,620,1415,+
chr10,68934251,0.4721257991775387,595,431,1026,+
chr10,68946585,2.393050173869846,722,498,1220,+
chr10,68956231,1.066605359957961,705,691,1396,+
chr10,68956232,1.5244084880450384,1049,1038,2087,+
chr10,68956277,1.5205402223818336,1790,1432,3222,+
chr10,68959816,2.0657028805696407,933,712,1645,+
chr10,68959824,2.454442771084337,794,663,1457,+
chr10,68959832,0.9631056505305681,3137,2414,5551,+
chr10,68959941,1.6178409090909092,1237,879,2116,+
chr10,68962083,1.6968817984046412,779,590,1369,+
chr10,68962100,2.2089321588626176,1020,718,1738,+
chr10,68963359,0.4600033823778116,1119,656,1775,+
chr10,68963361,2.044037685060565,903,742,1645,+
chr10,68963391,2.3350035790980668,931,761,1692,+
chr10,68963449,1.7673989860193577,718,565,1283,+
chr10,68965413,1.7627118644067796,909,589,1498,+
chr10,68965414,2.028180354267311,686,620,1306,+
chr10,68967054,2.45213963963964,669,443,1112,+
chr10,68967060,1.982029598308668,674,472,1146,+
chr10,68967083,1.6457934991402663,1966,1294,3260,+
chr10,68967107,1.7790633777017948,1294,861,2155,+
chr10,68969061,3.1759016723755797,887,708,1595,+
chr10,68970238,2.2076923076923083,860,649,1509,+
chr10,68970299,1.6922326307572209,666,487,1153,+
chr10,68970330,2.286633850814085,731,555,1286,+
chr10,68972033,3.2403240324032403,599,504,1103,+
chr10,68973613,2.247015915119364,1003,831,1834,+
chr10,68973615,2.0034540588154837,1696,1332,3028,+
chr10,68973630,0.584075924500824,1338,1070,2408,+
chr10,68973633,1.7006352047586013,1309,1034,2343,+
chr10,68973638,1.7418426103646834,604,520,1124,+
chr10,68977567,0.8188983462597398,1378,910,2288,+
chr10,68977568,0.8188983462597398,1378,910,2288,+
chr10,68977637,1.7271234728861846,760,530,1290,+
chr10,68978875,2.5187969924812026,669,503,1172,+
chr10,68978889,2.345679012345679,1044,626,1670,+
chr10,68981565,0.6260532524435457,742,551,1293,+
chr10,68982544,2.139371103080478,1526,1044,2570,+
chr10,68982545,2.3330935251798564,1033,694,1727,+
chr10,68982675,4.555458713592269,662,541,1203,+
chr10,68982751,1.665415330011603,609,636,1245,+
chr10,68982758,0.6803135888501742,638,573,1211,+
chr10,68982777,0.609117698041255,1003,640,1643,+
chr10,68983107,1.6211453744493391,1031,680,1711,+
chr10,68983176,1.6482545293857709,745,583,1328,+
chr10,68983294,0.6060603846278133,3949,2801,6750,+
chr10,68983295,0.3369568987888813,3380,2326,5706,+
chr10,68983296,0.8674141749723147,1842,1259,3101,+
chr10,68983511,1.7039297046619477,1073,722,1795,+
chr10,68983594,1.5727124183006533,824,611,1435,+
chr10,68983724,1.4546045263657021,631,475,1106,+
chr10,68983732,2.0143084991534916,1593,1205,2798,+
chr10,68983733,0.8579638752052545,714,608,1322,+
chr10,68983734,1.6754490860049045,1996,1641,3637,+
chr10,68983736,2.495221712538226,745,653,1398,+
chr10,68983738,0.5952088452088452,569,439,1008,+
chr10,68983742,0.9404794294582446,2260,1736,3996,+
chr10,68983921,2.2131752305665353,907,689,1596,+
chr10,68984251,2.4549528949053325,1219,753,1972,+
chr10,68984332,2.9990167158308747,914,677,1591,+
chr10,68984350,1.8991051214310286,1664,1351,3015,+
chr10,68984663,1.5617899373985629,841,680,1521,+
chr10,68984817,1.875,919,735,1654,+
chr10,68984877,1.7510123799606618,1315,803,2118,+
chr10,68984952,1.5351003553250746,694,533,1227,+
chr10,69016179,2.9971181556195963,779,693,1472,+
chr10,69016180,3.2014715969320946,1193,1105,2298,+
chr10,69016182,2.8273366418527712,1242,1239,2481,+
chr10,69016184,2.2333296703975876,1251,1176,2427,+
chr10,69016189,1.3967869190828759,785,747,1532,+
chr10,69124245,1.8787000824698321,695,351,1046,+
chr10,69124246,1.8337416410753897,683,379,1062,+
chr10,69124254,4.520784104699089,675,458,1133,+
chr10,69124256,4.842918985776128,572,440,1012,+
chr10,69124268,6.402597402597403,645,626,1271,+
chr10,69124269,7.966369041167839,1131,980,2111,+
chr10,69168524,1.5043163734550253,632,537,1169,+
chr10,69171336,2.7274605989597505,823,576,1399,+
chr10,69171564,3.101413010051234,823,453,1276,+
chr10,69392228,5.569647147601373,962,1233,2195,+
chr10,69392229,5.569647147601373,962,1233,2195,+
chr10,69395002,2.0157913109383685,642,482,1124,+
chr10,70163818,1.3524008639825682,563,459,1022,+
chr10,70163824,0.5783106580033744,715,625,1340,+
chr10,70163826,0.5783106580033744,715,625,1340,+
chr10,70163842,1.4743589743589742,919,753,1672,+
chr10,70163848,0.9170428939811764,1426,1412,2838,+
chr10,70163849,1.1296909267883204,3165,2602,5767,+
chr10,70423620,0.2401934799893984,724,307,1031,+
chr10,70423622,0.2401934799893984,724,307,1031,+
chr10,72216116,6.421057174664812,909,1100,2009,+
chr10,72216117,6.092680955865297,1705,1723,3428,+
chr10,72216118,5.455928038514528,1866,1890,3756,+
chr10,72223912,2.0136752136752136,588,467,1055,+
chr10,72230373,1.946355446355446,678,443,1121,+
chr10,72230395,0.4974093264248705,611,578,1189,+
chr10,72233066,1.817801047120419,1231,954,2185,+
chr10,72233067,1.817801047120419,1231,954,2185,+
chr10,72233068,2.465843023255814,701,515,1216,+
chr10,72233077,1.2403197248148867,1446,1109,2555,+
chr10,72233084,1.5853844201979193,780,562,1342,+
chr10,72233093,0.5475285171102662,671,525,1196,+
chr10,72233118,1.6736866573686653,972,716,1688,+
chr10,72233123,1.0116940354456556,1836,1368,3204,+
chr10,72233126,0.6328312678741659,1382,1048,2430,+
chr10,72233148,1.833265488636013,3178,2401,5579,+
chr10,72233149,1.776993217613672,4899,3768,8667,+
chr10,72233151,1.7520375237018062,3343,2613,5956,+
chr10,72233152,1.4331928292209144,3490,2434,5924,+
chr10,72233203,1.6988991842876378,691,548,1239,+
chr10,72233257,2.034080717488789,809,668,1477,+
chr10,72233476,2.511760752688172,1494,929,2423,+
chr10,72233477,2.511760752688172,1494,929,2423,+
chr10,72233649,2.008672659968271,1186,914,2100,+
chr10,72273927,0.5143788199415931,762,582,1344,+
chr10,72273933,0.9699647025704324,1017,732,1749,+
chr10,72273934,0.9699647025704324,1017,732,1749,+
chr10,72273939,0.3944795859689477,685,469,1154,+
chr10,72273940,1.7272861761158864,1278,922,2200,+
chr10,72273947,1.69017094017094,903,623,1526,+
chr10,72273951,1.6470747317740493,1740,1311,3051,+
chr10,72273965,1.801629834254144,1330,904,2234,+
chr10,72273975,1.7579143389199257,1471,1073,2544,+
chr10,72273985,1.453283269297939,1512,1226,2738,+
chr10,72273999,1.5923133375556697,2056,1400,3456,+
chr10,72274179,1.4341787624140565,2801,2199,5000,+
chr10,72274293,1.2792389301823264,1954,1484,3438,+
chr10,72274364,1.285889278484647,4102,3143,7245,+
chr10,72274694,1.8179160186625194,1718,1285,3003,+
chr10,72274707,0.6985476695463244,1830,1486,3316,+
chr10,72274755,1.5927170208454413,5607,4371,9978,+
chr10,72274818,1.7273298640281198,5255,3668,8923,+
chr10,72274873,0.7247396584738873,2166,1137,3303,+
chr10,72274951,1.4869883437245863,2066,1053,3119,+
chr10,72274952,1.7071200805571873,1749,1401,3150,+
chr10,72275009,1.054461120897935,3424,2932,6356,+
chr10,72275012,1.3821328679687312,1605,1417,3022,+
chr10,72275032,1.4395755598416158,2469,1912,4381,+
chr10,72275051,1.2713643178410794,2447,2000,4447,+
chr10,72275140,1.2554447414308196,22770,15946,38716,+
chr10,72275141,1.4309044261487232,17557,12150,29707,+
chr10,72275142,1.0187427855513949,8666,6457,15123,+
chr10,72275143,1.509367490761744,6733,5122,11855,+
chr10,72275324,1.386350598454074,10600,7409,18009,+
chr10,72275325,1.3501645051684532,7210,5223,12433,+
chr10,72275420,3.283512613619672,7588,7320,14908,+
chr10,72275485,1.4529249886518385,4433,4405,8838,+
chr10,72275509,1.4864688400899444,4407,4676,9083,+
chr10,72275554,0.7220676262214204,9757,3451,13208,+
chr10,72275594,3.036709200954919,17898,5183,23081,+
chr10,72275597,5.747876202494453,18401,5731,24132,+
chr10,72275601,2.758840892418389,19294,6492,25786,+
chr10,72275604,5.442354139590526,19649,6978,26627,+
chr10,72275610,3.4746887735268355,21809,8605,30414,+
chr10,72275613,3.890020872241143,49109,34101,83210,+
chr10,72275614,4.493631387080751,76279,59072,135351,+
chr10,72275616,3.013780772354264,61620,51106,112726,+
chr10,72275617,2.0467205959310566,27447,24758,52205,+
chr10,72275619,0.41898495552293263,29812,25543,55355,+
chr10,72275620,0.44978330526406707,15138,10374,25512,+
chr10,72275621,0.36016761540731856,45728,36080,81808,+
chr10,72275627,0.4373142273644406,33237,23925,57162,+
chr10,72275636,0.3238701510569368,14916,9625,24541,+
chr10,72275673,0.8849082876737182,7916,6222,14138,+
chr10,72275765,15.782333657389614,6597,4020,10617,+
chr10,72275766,11.948388009902528,18782,11419,30201,+
chr10,72275776,8.71845117434993,15146,11431,26577,+
chr10,72275780,3.4191192196452023,16062,15865,31927,+
chr10,72275877,10.082340522002625,11650,8213,19863,+
chr10,72275897,1.7563408556871474,12607,10704,23311,+
chr10,72275900,1.4095677905308464,3164,2787,5951,+
chr10,72275910,0.9852126734508707,8734,6892,15626,+
chr10,73782144,0.4785867237687366,893,466,1359,+
chr10,73782145,0.8421031027011376,1095,659,1754,+
chr10,73783088,1.7433775761381005,1442,942,2384,+
chr10,73783093,1.9139764881507746,788,465,1253,+
chr10,73783283,3.803231907433087,1628,1226,2854,+
chr10,74043088,2.6717934312459617,704,441,1145,+
chr10,74043129,0.2194004719004719,712,583,1295,+
chr10,74089264,2.5885434251383783,868,579,1447,+
chr10,74089324,1.8444007325510408,823,640,1463,+
chr10,74089328,0.5485646449384849,597,451,1048,+
chr10,74090095,1.7512315270935959,710,405,1115,+
chr10,74095708,3.946978343712241,680,486,1166,+
chr10,74100949,1.4784903119741184,710,549,1259,+
chr10,74103862,1.6921753951912193,875,590,1465,+
chr10,74114311,0.3924251439753567,744,631,1375,+
chr10,74118103,3.053245805981036,643,456,1099,+
chr10,74118104,3.053245805981036,643,456,1099,+
chr10,74118206,1.06553911205074,734,472,1206,+
chr10,74118207,1.06553911205074,734,472,1206,+
chr10,74118584,1.8195740185563463,653,499,1152,+
chr10,74119100,0.35888930449983253,852,768,1620,+
chr10,74119397,0.40056235054782807,814,622,1436,+
chr10,74119465,0.4135433871172659,650,462,1112,+
chr10,74119531,1.7077759197324416,816,551,1367,+
chr10,74119601,1.789998281491665,743,528,1271,+
chr10,74200787,2.4255646855751407,909,800,1709,+
chr10,74224538,2.390763274336283,664,451,1115,+
chr10,74314692,1.0768922767137943,1605,1129,2734,+
chr10,74314697,0.5969139716761783,705,497,1202,+
chr10,74398477,2.193418940609952,910,622,1532,+
chr10,74398479,2.193418940609952,910,622,1532,+
chr10,74398506,1.002626581991275,1507,1199,2706,+
chr10,74398508,0.5286713286713287,755,571,1326,+
chr10,74398513,0.6404842342342343,909,591,1500,+
chr10,74600424,0.9856178676904747,2262,1581,3843,+
chr10,74708346,1.850719424460432,1028,555,1583,+
chr10,74708395,0.4741993957703927,871,661,1532,+
chr10,75219084,0.8585874646230165,899,766,1665,+
chr10,75219085,0.6946333620333416,1525,1239,2764,+
chr10,75219095,1.940687361419069,777,655,1432,+
chr10,75219102,1.4425465838509315,928,827,1755,+
chr10,75219328,1.921420291623452,1085,885,1970,+
chr10,75219330,1.921420291623452,1085,885,1970,+
chr10,75219336,2.1194073639430835,601,400,1001,+
chr10,75219344,2.014144271570014,711,504,1215,+
chr10,75220745,1.680212840603438,820,502,1322,+
chr10,75230910,0.4510268270120258,716,574,1290,+
chr10,75230911,0.4510268270120258,716,574,1290,+
chr10,75230915,2.154253308128544,813,528,1341,+
chr10,75230916,2.154253308128544,813,528,1341,+
chr10,75230925,1.5220985467936867,1087,849,1936,+
chr10,75231068,2.325752508361204,731,459,1190,+
chr10,75231069,2.2857789855539212,1033,622,1655,+
chr10,75231094,1.8293434661312518,1367,862,2229,+
chr10,75231100,2.028193226749184,693,553,1246,+
chr10,75231107,0.6150863108492238,2595,1782,4377,+
chr10,75231122,1.3912687904042371,1428,1040,2468,+
chr10,78033838,0.5965926197753086,1985,1183,3168,+
chr10,78033858,1.6957547169811322,718,423,1141,+
chr10,78033860,0.8662124468425625,1753,1150,2903,+
chr10,78033861,0.813818781506943,6362,2832,9194,+
chr10,78033862,0.8123770987888119,8561,4297,12858,+
chr10,78033864,1.1987603120401058,21964,14523,36487,+
chr10,78033865,1.430446196068143,29496,16446,45942,+
chr10,78033866,1.426983157767581,31192,17694,48886,+
chr10,78033868,1.0510441428315824,5139,3725,8864,+
chr10,78033869,1.7274531143012362,9226,4884,14110,+
chr10,78033872,1.5801575539930752,11877,6520,18397,+
chr10,78033876,1.5546231353708755,9629,5294,14923,+
chr10,78033878,1.527294250585165,5321,4091,9412,+
chr10,78033880,1.549553644097479,12674,7502,20176,+
chr10,78033883,1.7468775838450843,22397,13282,35679,+
chr10,78033885,1.541061740559202,31683,18172,49855,+
chr10,78033886,1.2893813507128344,26943,16497,43440,+
chr10,78033887,1.0437861758022302,14601,11691,26292,+
chr10,78033888,1.155739746150364,9133,8071,17204,+
chr10,78033889,1.2761744868669354,38293,25886,64179,+
chr10,78033890,1.2444711429138797,42661,30145,72806,+
chr10,78035351,1.184917888724117,5613,4997,10610,+
chr10,78035354,0.8354621924830744,6230,5451,11681,+
chr10,78035509,0.9686532715149524,675,464,1139,+
chr10,78035513,1.2723550243470565,11496,8207,19703,+
chr10,78035549,1.2753443739359231,14831,11430,26261,+
chr10,78035554,1.1855626828136803,39571,27279,66850,+
chr10,78035564,1.2061383229312257,28858,20748,49606,+
chr10,78035565,1.266228456411955,44192,30337,74529,+
chr10,78037194,1.4291683612072086,13439,7913,21352,+
chr10,78037211,1.2880650599259882,11875,7273,19148,+
chr10,78037222,1.4191891227812243,21619,16058,37677,+
chr10,78037223,1.4191891227812243,21619,16058,37677,+
chr10,78040610,0.9004844180743531,624,486,1110,+
chr10,78040612,0.7687683997674649,2050,1505,3555,+
chr10,78040621,1.1351003243785511,43695,30482,74177,+
chr10,79353776,1.1781506645842932,968,745,1713,+
chr10,79512808,2.3282353561438347,845,365,1210,+
chr10,79512854,1.6669885205450057,913,477,1390,+
chr10,79512859,1.808612440191388,643,417,1060,+
chr10,79512866,2.312740439013352,729,490,1219,+
chr10,79513006,2.4360045096678884,832,559,1391,+
chr10,79513011,0.5526824034334765,605,465,1070,+
chr10,79513013,1.549763176154705,933,761,1694,+
chr10,79513014,0.6601633393829399,969,607,1576,+
chr10,79513015,1.549763176154705,933,761,1694,+
chr10,80408579,0.7784184424479114,1543,805,2348,+
chr10,80408580,0.810302707512885,1413,632,2045,+
chr10,80408614,2.151482653888485,756,377,1133,+
chr10,80420591,1.3516833012471976,600,509,1109,+
chr10,80420629,3.005414296405506,711,536,1247,+
chr10,80427468,1.3939439979967094,620,536,1156,+
chr10,80431986,4.043859292188054,908,605,1513,+
chr10,80431987,3.1479154768703594,688,411,1099,+
chr10,80432010,1.236128300037226,796,584,1380,+
chr10,80432026,2.534557037612971,909,724,1633,+
chr10,80432066,2.1545031055900616,554,482,1036,+
chr10,80432393,0.6376670004628263,1628,1300,2928,+
chr10,80432677,0.825533346146454,746,483,1229,+
chr10,80432754,0.5143939393939394,775,479,1254,+
chr10,84139560,1.162380960671321,797,808,1605,+
chr10,84141500,0.7400031826138354,1251,945,2196,+
chr10,84141532,1.9053080071620534,2637,1786,4423,+
chr10,84141600,0.6787220772399758,2362,1765,4127,+
chr10,84142671,1.4070714266391335,3759,2578,6337,+
chr10,84142672,1.4214693033829224,6875,4371,11246,+
chr10,84142712,1.729017251405311,2675,1875,4550,+
chr10,84143995,1.5024000910031308,4889,3239,8128,+
chr10,84143999,1.5592203898050974,1319,956,2275,+
chr10,84144000,1.4110843373493973,1951,1244,3195,+
chr10,84144007,1.8437112834396363,1469,1146,2615,+
chr10,84144031,1.8054169278996863,3788,3189,6977,+
chr10,84144033,1.8597708483154267,5770,4944,10714,+
chr10,84144034,1.7663368920304716,3916,3412,7328,+
chr10,84144037,1.5129014996300987,5646,4297,9943,+
chr10,84144081,1.3843048114568308,2470,1687,4157,+
chr10,84144875,1.6259004979935214,1268,961,2229,+
chr10,84150083,0.5915798611111112,1080,827,1907,+
chr10,84150088,1.4163533834586466,1506,1006,2512,+
chr10,84150177,0.628708647445274,2158,1707,3865,+
chr10,84150179,1.4409097231882044,1418,909,2327,+
chr10,84150713,0.7498761931375936,2517,1785,4302,+
chr10,84150749,1.4031384651216956,1529,1107,2636,+
chr10,84150752,1.7418370722248302,2965,2249,5214,+
chr10,84150753,1.901170236255244,1831,1293,3124,+
chr10,84150763,1.62019918490729,1739,1105,2844,+
chr10,84150765,1.6631227217496962,1094,822,1916,+
chr10,84150773,1.426553672316384,4039,2713,6752,+
chr10,84150774,1.698469167538617,6771,5082,11853,+
chr10,84150813,1.4534149813337631,1369,1181,2550,+
chr10,84152277,1.363339423766182,4141,2674,6815,+
chr10,84152388,1.4401488474313826,1820,1482,3302,+
chr10,84152853,2.481278538812785,857,729,1586,+
chr10,84560554,1.037956910182409,568,470,1038,+
chr10,84560956,0.7734487734487735,559,461,1020,+
chr10,84560961,0.6061482820976491,837,629,1466,+
chr10,84560962,0.7429208916867542,2301,2120,4421,+
chr10,84560963,0.7200618504080826,3257,2945,6202,+
chr10,84560964,0.7200618504080826,3257,2945,6202,+
chr10,84560965,0.5931213137530403,6320,5122,11442,+
chr10,84560968,1.1278545139640617,3991,2979,6970,+
chr10,84560970,1.2612584314754123,6584,5171,11755,+
chr10,84560972,0.7753201396973225,2219,1717,3936,+
chr10,87151350,0.8179243423665559,794,525,1319,+
chr10,87151369,1.5316779676747974,996,706,1702,+
chr10,87151376,2.1618583042973287,877,860,1737,+
chr10,87151377,1.8584507042253517,608,425,1033,+
chr10,87151378,2.1618583042973287,877,860,1737,+
chr10,87151380,1.577265848326887,937,625,1562,+
chr10,87152457,2.344325699745547,742,392,1134,+
chr10,87152459,2.6383103399256993,928,489,1417,+
chr10,87152468,2.976970258348056,637,386,1023,+
chr10,87152491,5.066830988634489,1059,702,1761,+
chr10,87552257,3.314167932306357,610,418,1028,+
chr10,87552280,2.1052631578947367,679,356,1035,+
chr10,87552299,0.6790623465881199,1005,775,1780,+
chr10,87552323,0.6096942783086373,2232,1547,3779,+
chr10,87552330,1.5635521885521884,1485,863,2348,+
chr10,87552331,1.967241265438214,1123,720,1843,+
chr10,87552916,2.6246094331200718,629,516,1145,+
chr10,87552953,1.9074335322843192,650,484,1134,+
chr10,87552967,0.6695081967213116,1020,949,1969,+
chr10,87552968,1.9082125603864732,789,683,1472,+
chr10,87552971,1.6379769299023956,1195,1126,2321,+
chr10,87552989,1.6323238973008558,869,979,1848,+
chr10,87552994,1.5535289452815229,1958,2424,4382,+
chr10,87552995,1.6594637540082453,3010,3775,6785,+
chr10,87552997,1.8264729620661824,2045,2595,4640,+
chr10,87553000,1.3448526070212603,3475,3489,6964,+
chr10,87864441,2.440783833435395,948,709,1657,+
chr10,87864443,1.687469974570138,2429,1645,4074,+
chr10,87945960,0.83204064081988,1748,1453,3201,+
chr10,87945962,0.9209555237661748,1265,1351,2616,+
chr10,87945963,1.0132480607692618,1044,1111,2155,+
chr10,87945964,2.0559006211180124,992,689,1681,+
chr10,87945969,0.8568098870987912,1683,1123,2806,+
chr10,87945970,1.3737250403917074,3592,2456,6048,+
chr10,87945971,1.450560326989131,4710,3771,8481,+
chr10,87960986,2.962183136357886,874,640,1514,+
chr10,88905442,1.4881075194763738,656,451,1107,+
chr10,88905481,3.7054085155350984,643,631,1274,+
chr10,88905483,3.7054085155350984,643,631,1274,+
chr10,88905523,2.022403704492566,1080,908,1988,+
chr10,88905537,0.602788081847553,1859,1463,3322,+
chr10,88905538,0.8833902159838017,2466,2043,4509,+
chr10,88908710,2.2000845448410287,695,523,1218,+
chr10,88908731,2.26522325943279,806,586,1392,+
chr10,88913232,1.6094276094276094,716,593,1309,+
chr10,88913242,1.917374080362196,846,588,1434,+
chr10,89014171,0.38355752168845514,585,428,1013,+
chr10,89014337,0.6929025753298381,623,398,1021,+
chr10,91855068,2.330665279328134,1314,798,2112,+
chr10,91865079,12.594073272593652,408,804,1212,+
chr10,91865080,8.852355004193544,674,1380,2054,+
chr10,91865111,0.067578125,345,767,1112,+
chr10,91865113,0.067578125,345,767,1112,+
chr10,91966656,1.829683822777039,916,673,1589,+
chr10,91966660,1.7919720186542305,1014,789,1803,+
chr10,91989554,6.87694065117686,619,458,1077,+
chr10,92216477,1.0057083435822942,632,470,1102,+
chr10,92216533,0.46222410865874364,725,588,1313,+
chr10,92216534,0.46222410865874364,725,588,1313,+
chr10,92216552,2.8113525091799265,734,687,1421,+
chr10,92216553,0.5685614849187935,1182,861,2043,+
chr10,92216554,1.4885978721806497,1916,1548,3464,+
chr10,92593423,1.840987508704273,945,887,1832,+
chr10,92593424,1.8347151360544216,841,767,1608,+
chr10,92593426,2.571042996265979,1056,1076,2132,+
chr10,92593427,3.3069569835369097,478,537,1015,+
chr10,92609075,2.8625594935771663,682,453,1135,+
chr10,92653733,2.2479440069991248,885,634,1519,+
chr10,92653735,2.1970319780635927,1934,1230,3164,+
chr10,92653739,2.187750044255621,1012,806,1818,+
chr10,92653741,2.187750044255621,1012,806,1818,+
chr10,92974111,2.650606377276011,676,385,1061,+
chr10,93515412,0.4536205614979028,611,402,1013,+
chr10,93517091,1.9450561925303669,658,382,1040,+
chr10,93517104,2.710583153347732,752,462,1214,+
chr10,93517139,1.797730390322983,900,593,1493,+
chr10,93517157,2.0703961102397224,2666,1879,4545,+
chr10,93517158,2.485415431067019,1486,1090,2576,+
chr10,94590670,1.7974491808780393,814,480,1294,+
chr10,94590672,0.7871657754010695,643,373,1016,+
chr10,96750284,0.8360967705467838,7099,6243,13342,+
chr10,96750391,1.2252597983712616,6740,4476,11216,+
chr10,96750426,1.3650276185513286,3003,1918,4921,+
chr10,96750429,1.3264331210191085,2400,1569,3969,+
chr10,96750431,0.9202673013147594,13062,10340,23402,+
chr10,96750432,0.9202673013147594,13062,10340,23402,+
chr10,96750433,0.8915206078299639,17315,12969,30284,+
chr10,96750434,1.3274621848739496,6581,4549,11130,+
chr10,96750435,1.3274621848739496,6581,4549,11130,+
chr10,96750437,0.8653226865478603,5878,4492,10370,+
chr10,96750525,0.6478174603174603,1305,699,2004,+
chr10,96750534,1.3391655603356258,3659,2322,5981,+
chr10,96750555,0.9809171036674722,3708,2112,5820,+
chr10,96750557,0.972607238632253,3987,2369,6356,+
chr10,96750560,1.4142909356725144,1198,683,1881,+
chr10,96750563,1.041208102047775,6374,3720,10094,+
chr10,96750564,1.1436110357195743,4892,2724,7616,+
chr10,96750569,1.4961849463897696,3255,2094,5349,+
chr10,96750570,1.4961849463897696,3255,2094,5349,+
chr10,96750573,1.3016091572660915,2530,1319,3849,+
chr10,96750580,1.3906447555723582,10530,6780,17310,+
chr10,96750582,1.3143276664171815,14038,8815,22853,+
chr10,96750583,1.2691767452879095,9397,5717,15114,+
chr10,96750588,1.239048148927476,7218,4662,11880,+
chr10,96750659,1.31195452083229,10859,6436,17295,+
chr10,96750875,1.946207638515331,1205,857,2062,+
chr10,96750876,2.092161908457985,1436,1033,2469,+
chr10,97432561,1.9442432147564583,1249,594,1843,+
chr10,97432562,2.679900744416873,863,402,1265,+
chr10,97432563,2.679900744416873,863,402,1265,+
chr10,97432601,2.087769565547505,1696,1076,2772,+
chr10,97432612,1.769875478927203,1166,695,1861,+
chr10,97432619,0.5302369900750972,1518,875,2393,+
chr10,97432620,1.8655053503750152,1681,1085,2766,+
chr10,97432629,1.4622319956019791,1143,679,1822,+
chr10,97432995,2.3758642784566657,1136,591,1727,+
chr10,97432996,2.8870864228870508,972,527,1499,+
chr10,97433017,3.5606215846994536,718,365,1083,+
chr10,97433018,3.5606215846994536,718,365,1083,+
chr10,97433019,3.5606215846994536,718,365,1083,+
chr10,97433028,1.6914831398503047,1282,949,2231,+
chr10,97433035,1.7305640620369456,686,381,1067,+
chr10,99743175,0.5295229784758579,661,381,1042,+
chr10,99743177,1.6816805080605763,661,444,1105,+
chr10,99743188,0.4990233545647558,903,470,1373,+
chr10,100347207,1.5309096732863552,868,445,1313,+
chr10,100347232,0.6942167110746738,738,573,1311,+
chr10,100347233,2.3619047619047624,619,449,1068,+
chr10,100347243,1.7581069237510951,1179,651,1830,+
chr10,100347246,1.3421218766613503,754,607,1361,+
chr10,100347327,1.53995370595038,2691,1727,4418,+
chr10,100347420,2.421010101010101,641,494,1135,+
chr10,100348064,0.5941644562334217,671,376,1047,+
chr10,100348065,1.3236743838685587,632,514,1146,+
chr10,100348066,0.9345587309580764,1030,844,1874,+
chr10,100348068,0.952661661733678,1162,954,2116,+
chr10,100348092,0.6751906684611934,988,742,1730,+
chr10,100348093,1.3682141797493563,2830,1929,4759,+
chr10,100348131,1.8961378643269133,3589,3060,6649,+
chr10,100348132,1.6434110592938045,2228,1974,4202,+
chr10,100348136,1.5433593025412726,1446,1197,2643,+
chr10,100348255,1.5045618146815098,1437,918,2355,+
chr10,100348258,1.3416751787538304,2200,1363,3563,+
chr10,100348324,1.6240378084672853,1738,1261,2999,+
chr10,100352436,0.9238039478086316,3759,2988,6747,+
chr10,100352437,1.2726508988254934,7393,5416,12809,+
chr10,100354428,1.7637735849056606,778,529,1307,+
chr10,100354432,1.5469149616368283,2694,1495,4189,+
chr10,100354433,1.5469149616368283,2694,1495,4189,+
chr10,100354436,2.2771787960467207,821,635,1456,+
chr10,100354466,1.7688369788773628,1840,1128,2968,+
chr10,100354469,0.6505715201367375,1049,850,1899,+
chr10,100354475,2.056673259223897,1137,945,2082,+
chr10,100354476,0.8033930431515856,1844,1491,3335,+
chr10,100354488,1.466270574523126,1562,1212,2774,+
chr10,100354498,0.9792714483590315,4072,3182,7254,+
chr10,100354576,2.2129466614501827,1762,1277,3039,+
chr10,100360734,2.4816230520435165,843,536,1379,+
chr10,100360786,3.1390909090909087,1150,659,1809,+
chr10,100360799,2.0330409018850584,2910,2030,4940,+
chr10,100360804,1.9075962018990507,930,666,1596,+
chr10,100360808,1.1023002687949908,2820,2053,4873,+
chr10,100360820,0.7568059815950919,1578,1303,2881,+
chr10,100360824,1.3992307795392718,1355,1050,2405,+
chr10,100361260,1.6670588800307367,1901,1435,3336,+
chr10,100361373,1.3605442176870748,2887,1994,4881,+
chr10,100361467,1.572550831792976,3402,2163,5565,+
chr10,100361622,1.7505950217490711,1658,1272,2930,+
chr10,100361623,0.6623034878968831,2713,1988,4701,+
chr10,100361651,1.8709575343332696,1597,1373,2970,+
chr10,100361753,1.2578477057178885,3018,1971,4989,+
chr10,100361780,1.602204992605208,1649,1262,2911,+
chr10,100361852,1.5031424248250724,4706,3232,7938,+
chr10,100361854,1.7163509211474848,8189,5809,13998,+
chr10,100361869,2.1398951473545544,3462,2732,6194,+
chr10,100362167,1.919014303482587,1602,1339,2941,+
chr10,100362174,0.8397244636322578,3007,2022,5029,+
chr10,100362187,1.5704950266018969,2088,1571,3659,+
chr10,100362324,1.6071087429506075,3298,2278,5576,+
chr10,100362341,1.8933394813799131,1695,1350,3045,+
chr10,100362471,1.4878119057223536,1654,1294,2948,+
chr10,100362477,1.341211411723899,2890,1921,4811,+
chr10,100362868,1.020611982244032,2887,2084,4971,+
chr10,100362882,1.3724298553886691,3709,2773,6482,+
chr10,100362883,1.4005491570067217,5743,4335,10078,+
chr10,100362885,1.4508474998638738,5839,4093,9932,+
chr10,100363029,1.4910835597826086,1950,1407,3357,+
chr10,100363030,1.4546916323330041,3368,2234,5602,+
chr10,100363094,1.349395843659173,4778,3224,8002,+
chr10,100363137,0.9230618829647486,6452,3601,10053,+
chr10,100363138,0.9230618829647486,6452,3601,10053,+
chr10,100363147,1.4308105266552815,6484,3962,10446,+
chr10,100363160,1.6418567376821651,9691,5195,14886,+
chr10,100363165,1.822168387862081,10381,5692,16073,+
chr10,100363169,1.5334828001518108,17323,10251,27574,+
chr10,100363170,1.5017094815506773,17174,10704,27878,+
chr10,100363172,1.5071054912238568,11702,7366,19068,+
chr10,100363177,1.542891368486435,6623,4433,11056,+
chr10,100363223,1.2104356011865256,13304,7419,20723,+
chr10,100363231,0.9609917774003139,30651,19232,49883,+
chr10,100363236,0.8446314739817717,18952,10921,29873,+
chr10,100363243,1.2278433965538436,39060,23582,62642,+
chr10,100363638,0.47547072956730335,2158,1244,3402,+
chr10,100363643,0.8122579486080239,2969,1556,4525,+
chr10,100363712,7.2590163934426215,1106,304,1410,+
chr10,100363718,4.826506640304907,2280,645,2925,+
chr10,100363721,65.4573486828294,8635,5086,13721,+
chr10,100363722,65.45734868282942,8635,5086,13721,+
chr10,100363725,2.1166783363674555,1127,964,2091,+
chr10,100363735,0.6019841269841268,1024,1049,2073,+
chr10,100363742,1.650505050505051,1538,1457,2995,+
chr10,100363854,0.657348665080624,2029,1454,3483,+
chr10,100363967,1.8821000848921339,3902,2704,6606,+
chr10,100363989,1.7776779266629223,1815,1132,2947,+
chr10,100364134,4.801147227533461,809,522,1331,+
chr10,100364140,1.4108550785052845,2539,1736,4275,+
chr10,100364141,2.1889862327909886,635,563,1198,+
chr10,100364341,2.145391903531438,957,644,1601,+
chr10,100364435,1.448489010989011,1368,1035,2403,+
chr10,100373909,1.8387944629402488,635,438,1073,+
chr10,100381358,2.2382164074317834,948,631,1579,+
chr10,100381390,1.9843362282878407,852,623,1475,+
chr10,100381397,1.642581392356196,1041,817,1858,+
chr10,100923976,2.061150231822215,790,449,1239,+
chr10,101039716,1.951036460547139,770,411,1181,+
chr10,101039717,1.951036460547139,770,411,1181,+
chr10,101039734,7.371233563211512,989,663,1652,+
chr10,101039739,4.612889345065599,2094,1875,3969,+
chr10,101039740,4.39761165683692,1987,1797,3784,+
chr10,102152435,3.999307479224376,874,360,1234,+
chr10,102152436,3.999307479224376,874,360,1234,+
chr10,102152451,2.0769230769230766,1079,571,1650,+
chr10,102152452,2.0769230769230766,1079,571,1650,+
chr10,102152453,0.4382282996432819,701,579,1280,+
chr10,102152454,0.4382282996432819,701,579,1280,+
chr10,102157018,2.105504587155964,620,435,1055,+
chr10,102157025,1.924503542202883,920,810,1730,+
chr10,102157052,0.6057845957174816,668,446,1114,+
chr10,102157058,0.5541608408597339,1412,1059,2471,+
chr10,102159207,2.1695257922359645,1114,707,1821,+
chr10,102159434,4.76846810327429,644,505,1149,+
chr10,102159441,1.1132591235192095,1003,796,1799,+
chr10,102159935,1.0989270958283353,766,491,1257,+
chr10,102159936,0.913407214254672,1200,766,1966,+
chr10,102159938,1.2319118147769832,826,533,1359,+
chr10,102159976,1.0948892911850716,1007,834,1841,+
chr10,102159978,1.821986008241057,1390,1161,2551,+
chr10,102160236,1.9816529506744711,1717,1325,3042,+
chr10,102160293,1.7275991138950422,1027,688,1715,+
chr10,102160495,2.9,782,485,1267,+
chr10,102160506,1.7934065934065937,815,545,1360,+
chr10,102160514,1.3092993532853134,1413,985,2398,+
chr10,102160548,1.7825849665095508,997,694,1691,+
chr10,102160551,2.7422360248447206,882,643,1525,+
chr10,102160570,0.6716293074606892,1313,1280,2593,+
chr10,102160592,1.7190697674418605,1187,1074,2261,+
chr10,102160747,2.515557867277256,1206,901,2107,+
chr10,102160810,1.558696505692972,793,565,1358,+
chr10,102160976,1.7675095506639986,693,477,1170,+
chr10,102161032,1.011713746376323,1176,1140,2316,+
chr10,102161033,1.011713746376323,1176,1140,2316,+
chr10,102161059,0.4468375793618902,694,540,1234,+
chr10,102161079,1.5821917808219177,890,656,1546,+
chr10,102161559,0.4107675111773473,734,609,1343,+
chr10,102161618,2.5332994407727503,905,561,1466,+
chr10,102161837,1.1694386694386694,1304,961,2265,+
chr10,102161838,1.3615842284991038,1705,1368,3073,+
chr10,102162170,2.7399014778325124,617,405,1022,+
chr10,102162194,0.4971046770601336,557,448,1005,+
chr10,102162225,1.9851086929731112,1251,907,2158,+
chr10,102162246,0.5818830879071842,651,497,1148,+
chr10,102162282,0.49437111801242234,848,643,1491,+
chr10,102163009,1.8144,647,374,1021,+
chr10,102163441,2.046843830244292,1262,978,2240,+
chr10,102163490,2.9429280397022333,592,433,1025,+
chr10,102163511,0.5678665616330445,828,678,1506,+
chr10,102163513,1.7250207296849087,978,602,1580,+
chr10,102163519,0.6486158183617767,1108,865,1973,+
chr10,102163521,1.5152027027027029,896,665,1561,+
chr10,102163522,1.5095548914753063,1145,747,1892,+
chr10,102163617,2.3446982611660423,597,418,1015,+
chr10,102163646,1.4302252816020025,652,475,1127,+
chr10,102399631,3.0328288450815717,1063,693,1756,+
chr10,102399644,1.998929348520078,732,437,1169,+
chr10,103423565,1.3470992262195556,679,561,1240,+
chr10,103993034,1.3323143958667818,732,494,1226,+
chr10,104254900,0.6830848570241218,967,539,1506,+
chr10,104255215,2.3335997259961183,729,460,1189,+
chr10,104259579,0.5003254010922158,841,598,1439,+
chr10,104259580,2.3664596273291925,634,643,1277,+
chr10,104259587,1.5852410029881774,1270,894,2164,+
chr10,104259588,0.3621138211382114,785,737,1522,+
chr10,104259682,1.6970911882623902,864,616,1480,+
chr10,104259713,3.3709077380952377,883,671,1554,+
chr10,104259730,1.5267507002801122,990,815,1805,+
chr10,104259781,0.6893120918024782,1472,1142,2614,+
chr10,104262992,1.1841605282291066,2844,2133,4977,+
chr10,104263017,0.6100876366377685,2203,1515,3718,+
chr10,104263018,1.543189368770764,1857,1203,3060,+
chr10,104266129,2.0225234619395205,1118,821,1939,+
chr10,104267294,2.008,752,509,1261,+
chr10,104267295,2.3986226685796272,1160,696,1856,+
chr10,110133461,2.4233130694537723,628,463,1091,+
chr10,110578666,2.5404040718042795,761,644,1405,+
chr10,110584190,2.7180537155245097,867,436,1303,+
chr10,110584191,2.7180537155245097,867,436,1303,+
chr10,110584275,2.665823538163964,873,610,1483,+
chr10,110584276,2.665823538163964,873,610,1483,+
chr10,110598232,2.8776086956521736,853,574,1427,+
chr10,110598234,2.8776086956521736,853,574,1427,+
chr10,110599675,3.8076502732240436,1071,487,1558,+
chr10,110599692,1.576084340137944,1931,1156,3087,+
chr10,110599698,1.1817795058171916,4058,2098,6156,+
chr10,110599710,1.8154549075882724,2334,1498,3832,+
chr10,110599714,2.1985793510259546,5254,3035,8289,+
chr10,110600521,2.3223748643085504,792,577,1369,+
chr10,110601652,2.1969821673525383,1539,1349,2888,+
chr10,110601654,2.1969821673525383,1539,1349,2888,+
chr10,110601655,0.4359640831758034,614,459,1073,+
chr10,110601674,1.6607966457023062,931,953,1884,+
chr10,110601684,0.6474647464746475,1078,1110,2188,+
chr10,110601689,1.1710884148713367,2233,2090,4323,+
chr10,110601703,0.5919046640641052,1107,784,1891,+
chr10,110601706,1.5033072052350351,1204,866,2070,+
chr10,110601713,1.4998663220746815,2804,2060,4864,+
chr10,110601714,1.4998663220746815,2804,2060,4864,+
chr10,110601717,1.7563510669408928,3270,3022,6292,+
chr10,110601718,1.7563510669408928,3270,3022,6292,+
chr10,110601721,2.457866987327722,1751,1706,3457,+
chr10,110601857,2.537374564816711,707,513,1220,+
chr10,110601858,2.537374564816711,707,513,1220,+
chr10,110602606,4.2149182405110395,663,555,1218,+
chr10,110602952,2.8391275912757523,592,427,1019,+
chr10,110883065,4.250263658077093,1122,923,2045,+
chr10,110883067,1.21554091158704,698,606,1304,+
chr10,110883069,1.3069156485271534,738,585,1323,+
chr10,110887798,2.362818590704648,590,434,1024,+
chr10,110894095,1.248153870136711,607,454,1061,+
chr10,110894474,2.1290287691974905,634,401,1035,+
chr10,110896050,0.8458670834489069,1552,1263,2815,+
chr10,110896051,0.3093368700265252,1028,869,1897,+
chr10,110898493,2.221447868758266,860,654,1514,+
chr10,110898641,1.7610748002904866,678,458,1136,+
chr10,110985644,0.5405033928848995,681,578,1259,+
chr10,111000425,2.720491030293375,745,458,1203,+
chr10,119676803,0.34076311520083147,579,443,1022,+
chr10,119676869,2.6777981345769484,544,631,1175,+
chr10,119676870,2.229154752189112,1378,1487,2865,+
chr10,119676872,1.9172281401739002,834,856,1690,+
chr10,119676874,2.9256554393839034,585,456,1041,+
chr10,119677410,0.3032042752358119,1008,837,1845,+
chr10,120909341,2.634977064220184,620,435,1055,+
chr10,120909343,2.634977064220184,620,435,1055,+
chr10,122511977,5.40683444733392,655,501,1156,+
chr10,123154969,1.9737739773061738,1161,780,1941,+
chr10,123154999,1.5342996627912828,870,536,1406,+
chr10,123155077,0.6281227694503926,659,466,1125,+
chr10,123157729,0.4812012368171932,1892,1264,3156,+
chr10,123157735,1.5301794453507342,736,612,1348,+
chr10,123157819,0.5730632795514361,1251,970,2221,+
chr10,123157838,1.678263020198672,1746,1363,3109,+
chr10,123160407,1.7170950491633605,710,526,1236,+
chr10,123160408,1.5519967837041009,938,573,1511,+
chr10,123160523,2.124934090297235,1475,1102,2577,+
chr10,123160527,1.6486803519061584,936,659,1595,+
chr10,123162235,1.7293497363796138,819,568,1387,+
chr10,123162239,0.48008444454018645,1012,760,1772,+
chr10,123162242,1.8086288141192526,1780,1251,3031,+
chr10,123162275,0.6028860759493672,1133,999,2132,+
chr10,123162645,1.5855282199710563,912,690,1602,+
chr10,123162649,1.5005701254275938,1315,876,2191,+
chr10,123162652,0.7017305631127458,2999,2245,5244,+
chr10,123164576,3.5388295914611696,640,493,1133,+
chr10,123164578,3.5388295914611696,640,493,1133,+
chr10,123164990,1.3397995617377931,825,712,1537,+
chr10,123165053,1.589235474006116,811,544,1355,+
chr10,124484298,5.92018779342723,581,425,1006,+
chr10,124806884,3.9124681354605837,696,458,1154,+
chr10,124819384,2.1693925233644857,618,427,1045,+
chr10,125823645,2.9399260982897912,1282,1104,2386,+
chr10,125823646,2.2631225806451614,755,774,1529,+
chr10,125826647,1.8513101767215112,783,546,1329,+
chr10,125831513,1.1163158013493084,1705,1342,3047,+
chr10,125831514,1.4131482701509301,2211,1799,4010,+
chr10,125833799,1.3830074307897149,989,698,1687,+
chr10,125833823,2.039267447615905,823,550,1373,+
chr10,125833892,0.6903137524541313,3359,2102,5461,+
chr10,125833895,1.9942479395604398,1601,895,2496,+
chr10,125833896,0.7080976969100894,2334,1469,3803,+
chr10,125836268,1.6125553097345133,832,564,1396,+
chr10,126905551,1.5117554678032965,951,638,1589,+
chr10,126970701,0.5189382642409781,579,478,1057,+
chr10,126970704,0.5589896214896214,1464,1133,2597,+
chr10,126970705,0.5589896214896214,1464,1133,2597,+
chr10,126970706,2.246679316888045,511,495,1006,+
chr10,126970707,1.4771509876129896,1960,1132,3092,+
chr10,126970709,1.659285460231917,3120,2356,5476,+
chr10,126970710,1.8955102040816334,1160,1224,2384,+
chr10,130145215,4.16637017665918,675,557,1232,+
chr10,130160002,2.732324373164672,671,465,1136,+
chr10,130160027,1.6756361986890929,2196,1481,3677,+
chr10,130160032,1.878224687933426,1097,720,1817,+
chr10,130160846,1.002286319933379,1975,1553,3528,+
chr10,130160847,1.002286319933379,1975,1553,3528,+
chr10,130166511,1.1072073478000264,1779,1202,2981,+
chr10,130171622,1.9944087223930667,860,510,1370,+
chr10,130171624,1.4179404346359297,1495,935,2430,+
chr10,130174879,1.853837471783296,656,442,1098,+
chr10,130179348,1.9735614307931568,845,642,1487,+
chr10,130179349,0.5778611632270169,615,532,1147,+
chr10,130179358,0.4899945175438597,714,575,1289,+
chr10,130179399,1.6989540700318326,933,732,1665,+
chr10,130179455,2.0542279411764706,893,543,1436,+
chr11,251867,1.4797061761087666,666,411,1077,+
chr11,251885,1.9065661849775584,935,673,1608,+
chr11,252585,2.653876425468368,607,409,1016,+
chr11,252621,3.950695056587332,576,426,1002,+
chr11,252689,0.4709639188459182,637,420,1057,+
chr11,308193,1.8026141840793481,1086,865,1951,+
chr11,308196,0.9286794987649278,2894,2368,5262,+
chr11,308199,1.3758007657025892,1036,712,1748,+
chr11,308322,2.7705409177697518,768,443,1211,+
chr11,308372,2.6772068511198945,507,551,1058,+
chr11,308373,2.6772068511198945,507,551,1058,+
chr11,309040,1.7783088235294118,690,339,1029,+
chr11,309042,1.7783088235294118,690,339,1029,+
chr11,309063,1.686040682454082,2801,2063,4864,+
chr11,309064,1.5821323845244515,4065,3491,7556,+
chr11,309066,1.523229093389923,6050,4975,11025,+
chr11,309067,1.4602602172300871,3603,2687,6290,+
chr11,309070,2.0785063789488745,2697,2448,5145,+
chr11,309073,1.3468914297765926,1396,1217,2613,+
chr11,309074,2.5289968652037618,921,695,1616,+
chr11,309078,0.6179087424252623,2418,2798,5216,+
chr11,309079,1.5434846393235242,3629,3102,6731,+
chr11,309080,1.1162116712592658,15742,15318,31060,+
chr11,309081,1.1519807028630884,14677,14061,28738,+
chr11,309082,1.2386838562567801,10502,9763,20265,+
chr11,309094,0.6665272104692846,34732,31575,66307,+
chr11,309095,0.663287296007062,42013,37698,79711,+
chr11,309096,0.663287296007062,42013,37698,79711,+
chr11,309097,0.6316786407506298,20164,17467,37631,+
chr11,309105,0.5812143665595759,3757,2902,6659,+
chr11,309109,0.7473217507146624,5821,4733,10554,+
chr11,309176,1.840506620610248,1507,964,2471,+
chr11,314014,1.5836357777000774,868,853,1721,+
chr11,314015,1.1570878581993609,1219,1432,2651,+
chr11,314016,0.9825657775558181,3825,3856,7681,+
chr11,314017,0.927577536076677,2848,2619,5467,+
chr11,314018,0.9289170151862457,2676,2829,5505,+
chr11,314039,0.5279503105590062,849,601,1450,+
chr11,314064,0.5595307917888563,794,619,1413,+
chr11,314116,1.7376739544911888,2437,1438,3875,+
chr11,314118,1.7376739544911888,2437,1438,3875,+
chr11,314131,1.4907312925170069,1118,839,1957,+
chr11,314240,2.183983096520791,2004,1521,3525,+
chr11,314242,2.195018464681386,1163,978,2141,+
chr11,314245,1.451121512826009,2878,1818,4696,+
chr11,314246,1.2232011746917089,2527,1810,4337,+
chr11,314296,1.9534043705977966,1039,790,1829,+
chr11,314972,2.29694669674573,845,756,1601,+
chr11,314986,1.9100495166387075,1924,1129,3053,+
chr11,314988,1.865846434267487,1387,769,2156,+
chr11,314990,0.6568620817969621,862,720,1582,+
chr11,314991,1.8632978723404254,677,469,1146,+
chr11,315003,1.5613091634317462,1095,652,1747,+
chr11,315163,2.283843241583956,1239,673,1912,+
chr11,315215,1.1445963752947712,2581,1878,4459,+
chr11,747463,1.0080251571864596,2576,1404,3980,+
chr11,747464,1.0242859496960484,2404,1319,3723,+
chr11,747465,1.0492865513200524,1415,651,2066,+
chr11,747481,1.7948767615409702,926,659,1585,+
chr11,747539,0.5074509803921569,646,449,1095,+
chr11,755907,1.7181506366549635,762,611,1373,+
chr11,755977,1.7546975546975547,801,554,1355,+
chr11,758964,1.7689594356261018,1002,701,1703,+
chr11,760174,1.6893079548935268,3760,2664,6424,+
chr11,760176,1.7331211834523093,2238,1509,3747,+
chr11,760177,1.49740131437653,1963,1501,3464,+
chr11,760179,1.6971571084883676,4082,3223,7305,+
chr11,760180,1.6895937854021688,3131,2504,5635,+
chr11,760181,1.6895937854021688,3131,2504,5635,+
chr11,760184,1.452365930599369,1150,950,2100,+
chr11,760191,0.5689301905361147,1215,872,2087,+
chr11,760202,1.4231692100969384,3706,3170,6876,+
chr11,760204,1.4231692100969384,3706,3170,6876,+
chr11,760208,0.9916010144249284,10260,7715,17975,+
chr11,760209,1.3909218972977686,7274,6684,13958,+
chr11,760210,0.8772101806151837,9040,5703,14743,+
chr11,760211,1.3393552869187846,10767,10220,20987,+
chr11,760212,1.242580043438375,18307,14357,32664,+
chr11,760213,1.3742276416149202,15303,12486,27789,+
chr11,763357,2.5365853658536586,571,450,1021,+
chr11,763369,0.5810147299509002,567,469,1036,+
chr11,763435,2.404817044928208,707,380,1087,+
chr11,763463,1.8297258297258299,633,494,1127,+
chr11,763490,1.485758876316816,1189,931,2120,+
chr11,763491,0.5859046283309958,1113,735,1848,+
chr11,763749,2.0149855907780982,919,693,1612,+
chr11,763770,1.4796731298693695,1030,793,1823,+
chr11,763836,1.6232777374909353,725,590,1315,+
chr11,764302,1.7877906976744184,614,429,1043,+
chr11,764303,1.8166293393057107,926,657,1583,+
chr11,764304,1.504370830457787,637,377,1014,+
chr11,764305,1.8166293393057107,926,657,1583,+
chr11,764346,1.6735854858548584,621,541,1162,+
chr11,764392,1.5059735227639652,635,488,1123,+
chr11,764873,0.4904282115869018,1002,793,1795,+
chr11,764896,1.654896180466547,832,663,1495,+
chr11,764912,2.8858754027926965,976,783,1759,+
chr11,764916,1.6155095412099068,1210,820,2030,+
chr11,809966,0.9511924318077044,762,660,1422,+
chr11,809967,0.4759096641599327,714,315,1029,+
chr11,809968,0.9511924318077044,762,660,1422,+
chr11,809969,1.0687677455990914,648,586,1234,+
chr11,809971,1.0687677455990914,648,586,1234,+
chr11,809985,1.7872534835909542,651,570,1221,+
chr11,809989,2.0388272357866692,2000,1130,3130,+
chr11,810004,1.084645471496301,2313,1422,3735,+
chr11,810005,1.7240586941535632,1009,742,1751,+
chr11,810007,1.6713623395149786,1441,700,2141,+
chr11,810011,2.3532557828586715,1099,830,1929,+
chr11,810233,2.043333333333333,612,464,1076,+
chr11,810241,2.0602776868221975,2066,1426,3492,+
chr11,810250,1.686743095389186,2353,1405,3758,+
chr11,810253,1.5116028295376118,814,643,1457,+
chr11,810303,1.4714999205056936,6241,4676,10917,+
chr11,810304,1.4518122594345886,8519,6457,14976,+
chr11,810305,1.4518122594345886,8519,6457,14976,+
chr11,810306,1.4069287725981547,7946,6044,13990,+
chr11,810313,1.0260233138067383,5223,3712,8935,+
chr11,811597,1.6753758052970649,1811,1396,3207,+
chr11,811615,0.7162037596711798,1662,1407,3069,+
chr11,811616,1.3497835277985857,5185,3987,9172,+
chr11,811617,1.358726040112824,7985,6214,14199,+
chr11,811621,1.8690568004168842,3091,2524,5615,+
chr11,812765,1.77973891591856,7851,5443,13294,+
chr11,812767,1.7412218407045954,8130,5981,14111,+
chr11,812768,1.5510422203698297,8377,5919,14296,+
chr11,836769,2.2900094525473293,610,489,1099,+
chr11,836772,1.3282948907038106,671,534,1205,+
chr11,837480,1.441878012865225,775,490,1265,+
chr11,838386,5.265818422281007,1466,298,1764,+
chr11,838388,3.307837070543757,1963,492,2455,+
chr11,838389,2.7673636494763967,1501,389,1890,+
chr11,838397,13.260188364764309,1211,662,1873,+
chr11,838398,8.125645541263884,3117,1933,5050,+
chr11,838399,7.423248238980913,3361,2254,5615,+
chr11,838400,6.752725448080805,2965,2112,5077,+
chr11,838401,4.820369560095587,708,802,1510,+
chr11,838411,10.325941380947885,3118,3818,6936,+
chr11,838412,10.325941380947885,3118,3818,6936,+
chr11,838413,10.325941380947885,3118,3818,6936,+
chr11,838501,1.2155330882352942,919,511,1430,+
chr11,838502,1.2155330882352942,919,511,1430,+
chr11,838503,1.2155330882352942,919,511,1430,+
chr11,865555,2.447681248649807,606,406,1012,+
chr11,866878,22.53632059766422,1960,2434,4394,+
chr11,866879,22.53632059766421,1960,2434,4394,+
chr11,866880,23.77407665408181,1813,2357,4170,+
chr11,866891,0.4141761255163317,627,872,1499,+
chr11,866893,0.453817587135021,443,598,1041,+
chr11,866912,0.16979124006841073,533,1013,1546,+
chr11,970258,3.032051282051282,604,571,1175,+
chr11,970260,2.6967068305658235,1029,859,1888,+
chr11,2395479,3.6068180124176092,664,501,1165,+
chr11,2395922,1.7643564356435644,659,403,1062,+
chr11,2396966,1.5602734234946007,777,579,1356,+
chr11,2397110,4.192850838874988,647,458,1105,+
chr11,2571382,2.254653940288698,750,503,1253,+
chr11,2848874,3.4770900074673277,703,438,1141,+
chr11,2848875,5.368421052631579,645,360,1005,+
chr11,2848877,3.713171528274257,708,431,1139,+
chr11,2925158,5.178818612064687,673,473,1146,+
chr11,4083281,1.5026455026455023,922,503,1425,+
chr11,4083283,2.2859989535889005,936,584,1520,+
chr11,4094826,2.604844704911891,1126,396,1522,+
chr11,4094827,2.4938333934367107,973,294,1267,+
chr11,4094828,2.3717558340530447,1168,406,1574,+
chr11,4094832,1.9619513782089197,869,1263,2132,+
chr11,4094833,2.051169494363203,5952,7508,13460,+
chr11,4094834,2.051169494363203,5952,7508,13460,+
chr11,4094835,2.040538609390465,5779,7372,13151,+
chr11,4094839,0.5354441184484707,5096,7263,12359,+
chr11,4094840,0.5354441184484707,5096,7263,12359,+
chr11,4094861,0.6182859738705039,4203,4999,9202,+
chr11,4094862,0.6091505979460984,5765,7121,12886,+
chr11,4095002,1.7335526315789471,1394,911,2305,+
chr11,4102012,1.9918522899007816,1976,1538,3514,+
chr11,4102013,1.7964779235000248,3217,2587,5804,+
chr11,4102033,1.6959970821555577,1549,996,2545,+
chr11,4106064,1.6169415907062603,3196,2275,5471,+
chr11,4106174,1.5645606042440952,1159,877,2036,+
chr11,4106189,1.474660581426735,3061,2093,5154,+
chr11,4109665,1.4145267090721791,3550,2536,6086,+
chr11,4118359,1.498077979132345,1935,1213,3148,+
chr11,4118450,1.8959381044487431,1351,1033,2384,+
chr11,4121614,1.4044134727061557,3022,2204,5226,+
chr11,4121621,0.7189594504021448,1906,1491,3397,+
chr11,4121639,1.953876658513083,3260,2997,6257,+
chr11,4121640,1.3624725345285251,9483,7786,17269,+
chr11,4121641,1.3953156737805728,14587,12123,26710,+
chr11,4121643,1.4625942025239034,20805,17905,38710,+
chr11,4121644,1.6036627643548003,19512,17455,36967,+
chr11,4121645,1.4780338606030647,15946,13871,29817,+
chr11,4122160,1.3622681595434527,2168,1371,3539,+
chr11,4122198,2.47381394623914,3873,2586,6459,+
chr11,4123187,1.3015219085411112,12515,9380,21895,+
chr11,4123188,1.3717546079612153,7997,5339,13336,+
chr11,4123189,1.1854430842818144,9274,7579,16853,+
chr11,4123190,1.2269848407952861,14448,11109,25557,+
chr11,4123205,1.5023834087999846,6269,5735,12004,+
chr11,4123206,1.6189142729227115,9662,8990,18652,+
chr11,4123208,1.2568013037610166,19988,16850,36838,+
chr11,4123209,1.6454115072885633,10527,10317,20844,+
chr11,4123211,1.5318287876036731,10900,10901,21801,+
chr11,4123212,1.5211955363206868,7393,7470,14863,+
chr11,4126688,2.061881188118812,881,605,1486,+
chr11,4126691,2.1076807228915664,932,663,1595,+
chr11,4126696,1.9165775401069518,1119,824,1943,+
chr11,4126733,1.6460488123952417,1437,1202,2639,+
chr11,4127077,2.398186329972324,2735,2182,4917,+
chr11,4127078,1.7715710723192017,1997,1202,3199,+
chr11,4127090,1.7093781344032095,1202,996,2198,+
chr11,4127096,1.3810990490616848,1843,1397,3240,+
chr11,4127223,2.023570428201079,1150,906,2056,+
chr11,4127230,1.33581353247341,1777,1472,3249,+
chr11,4132295,1.7615816190221747,1267,984,2251,+
chr11,4132366,2.0026549612375657,1528,1377,2905,+
chr11,4132389,1.245375787578758,3117,2019,5136,+
chr11,4135201,1.3746133333333337,1840,1624,3464,+
chr11,4138679,1.6803496081977096,1370,1105,2475,+
chr11,4138773,1.7105248259072638,1118,1038,2156,+
chr11,4138825,1.9534748049296289,723,652,1375,+
chr11,5634661,2.77276295133438,784,489,1273,+
chr11,5634663,2.77276295133438,784,489,1273,+
chr11,5634669,2.2349910394265238,906,743,1649,+
chr11,5634671,1.88013554596803,1160,916,2076,+
chr11,5634680,2.865684863971982,1620,1251,2871,+
chr11,5634681,3.2243045047142362,1107,780,1887,+
chr11,6608138,0.9620118706542975,705,431,1136,+
chr11,6608140,0.7907873837077377,819,451,1270,+
chr11,6608141,0.7462179160292368,877,476,1353,+
chr11,6608143,1.578845777497995,775,459,1234,+
chr11,6609086,3.0773809523809517,892,531,1423,+
chr11,6609088,3.0773809523809517,892,531,1423,+
chr11,6609321,4.2041958041958045,667,428,1095,+
chr11,6609323,4.2041958041958045,667,428,1095,+
chr11,6609577,2.468505646858457,821,591,1412,+
chr11,6609578,1.3091471176577558,625,422,1047,+
chr11,6609622,2.7709702521225155,687,528,1215,+
chr11,6609789,2.3164360208819836,765,620,1385,+
chr11,6609957,0.36746854535387674,689,654,1343,+
chr11,6609990,1.2723739291484932,617,485,1102,+
chr11,7987341,2.4069959375304557,709,492,1201,+
chr11,7987345,2.0235821231295326,1955,966,2921,+
chr11,7987346,2.030795816540836,2292,1175,3467,+
chr11,7987347,2.0235821231295326,1955,966,2921,+
chr11,7987484,1.2841474445952057,830,602,1432,+
chr11,7987485,1.2841474445952057,830,602,1432,+
chr11,7992118,2.4820853858233036,787,659,1446,+
chr11,7992924,1.8160539877727966,897,616,1513,+
chr11,7992981,0.5587381982690794,908,655,1563,+
chr11,7992983,0.5587381982690794,908,655,1563,+
chr11,7992990,1.8839999207900613,1215,822,2037,+
chr11,7993001,2.048485246123683,2033,1389,3422,+
chr11,7993010,0.582050786521048,2469,1831,4300,+
chr11,7993011,1.8592436974789917,884,531,1415,+
chr11,7994458,2.6170494699646643,1184,848,2032,+
chr11,7994460,2.5882472035228017,1087,858,1945,+
chr11,7995256,2.270728484291237,923,540,1463,+
chr11,7995267,1.9560683230206857,1084,748,1832,+
chr11,7995271,0.5417390783244442,564,450,1014,+
chr11,7995274,0.6135709644481574,660,512,1172,+
chr11,7995305,1.34335496522254,2751,2097,4848,+
chr11,7995307,1.0745486313337216,1844,1413,3257,+
chr11,7995355,4.589482612383375,772,392,1164,+
chr11,7995946,1.9152921178544449,1414,721,2135,+
chr11,7995948,1.9152921178544449,1414,721,2135,+
chr11,8682790,0.9014008301842127,1567,1052,2619,+
chr11,8682791,0.7354525938544244,2766,1736,4502,+
chr11,8683201,1.456525625683826,2359,1518,3877,+
chr11,8683203,0.5635376756066411,1058,971,2029,+
chr11,8683204,1.5869652139144343,1133,853,1986,+
chr11,8683206,1.0372143836078096,2656,1893,4549,+
chr11,8683207,0.7964989708728842,10551,7291,17842,+
chr11,8683208,0.5714954208168995,3707,2136,5843,+
chr11,8683209,1.038951507208388,2935,2099,5034,+
chr11,8683213,1.3356409869463517,1784,1370,3154,+
chr11,8683215,0.5853977475071225,2146,1535,3681,+
chr11,8683216,1.3822040498442367,2060,1604,3664,+
chr11,8683224,1.4357808808140502,2613,2090,4703,+
chr11,8684769,1.6573841421703535,1127,598,1725,+
chr11,8684780,1.045185287229646,842,426,1268,+
chr11,8684782,1.045185287229646,842,426,1268,+
chr11,8684790,0.9818228366615463,766,433,1199,+
chr11,8684791,0.9818228366615463,766,433,1199,+
chr11,8684792,1.2542323414782923,2623,1494,4117,+
chr11,8684794,0.9570974624455386,1916,1118,3034,+
chr11,8684797,0.4796192443919716,1412,615,2027,+
chr11,8684799,1.0923225659440818,3663,1835,5498,+
chr11,8684800,1.4032810935495164,4654,2376,7030,+
chr11,8684801,1.1714062862322658,2415,1065,3480,+
chr11,8684802,1.6305837215675532,2239,1311,3550,+
chr11,8684803,0.3990121479108264,853,680,1533,+
chr11,8684808,1.66935736677116,1252,579,1831,+
chr11,8684810,1.6014295324587955,1560,990,2550,+
chr11,8684815,1.6768978853651486,4694,2811,7505,+
chr11,8684820,1.3369924690733368,4446,3122,7568,+
chr11,8684822,1.4246023696643924,8979,5935,14914,+
chr11,8684824,1.5153074710409704,4753,3384,8137,+
chr11,8684827,0.44774485672152425,4427,2938,7365,+
chr11,8684836,1.156368941158899,21129,13755,34884,+
chr11,8684837,1.0765171169096959,17967,11294,29261,+
chr11,8684844,1.3673838511999568,3617,2178,5795,+
chr11,8684846,1.1965849319472726,9776,5424,15200,+
chr11,8684847,1.1234922813102017,20222,12398,32620,+
chr11,8684849,1.0195178635780917,22134,13425,35559,+
chr11,8684850,1.0100221770906137,11472,6392,17864,+
chr11,8684872,1.5994576049283138,6927,4386,11313,+
chr11,8684874,1.1801930074355322,8951,5291,14242,+
chr11,8685683,1.365344239049801,9293,6408,15701,+
chr11,8685687,1.1675678999987262,74371,52007,126378,+
chr11,8685688,1.2522350466469756,49884,32808,82692,+
chr11,8685868,4.565600036310821,617,463,1080,+
chr11,9384691,3.2355924901393918,996,590,1586,+
chr11,9384709,1.373254945518218,844,553,1397,+
chr11,9384725,1.4848139667775706,613,446,1059,+
chr11,9384740,0.7742301059374229,826,614,1440,+
chr11,9384741,0.7742301059374229,826,614,1440,+
chr11,9384764,0.8539941882778662,1415,896,2311,+
chr11,9384766,0.8539941882778662,1415,896,2311,+
chr11,9384770,2.0045045045045047,711,369,1080,+
chr11,9384771,0.6429537526991433,1128,628,1756,+
chr11,9384772,0.6187991826442328,992,560,1552,+
chr11,9384779,1.5105000758788245,2293,1370,3663,+
chr11,9403341,1.8441114616193481,1219,950,2169,+
chr11,9403342,1.8441114616193481,1219,950,2169,+
chr11,9403351,1.0424749050994322,1989,1250,3239,+
chr11,9403352,1.9376631433762626,1716,1463,3179,+
chr11,9408525,1.946297015843281,4611,3772,8383,+
chr11,9408527,2.3070967741935484,7151,6199,13350,+
chr11,9408528,1.9572753340751428,11168,9314,20482,+
chr11,9408530,1.884085640779105,8824,7360,16184,+
chr11,9408533,1.7861197110423117,1977,1291,3268,+
chr11,9408535,1.7469552505738117,6122,6560,12682,+
chr11,9408537,1.7768408571449439,8326,8056,16382,+
chr11,9410017,1.6192555624870035,1197,915,2112,+
chr11,9414257,1.616271347248577,830,619,1449,+
chr11,9420444,1.446716255442671,1398,1039,2437,+
chr11,9423124,2.3818527410964383,820,475,1295,+
chr11,9423780,2.2641878669275934,711,437,1148,+
chr11,9424955,2.4599483204134365,679,429,1108,+
chr11,9424956,2.347622323996504,1028,642,1670,+
chr11,9425209,0.7103401544924787,1007,784,1791,+
chr11,9425212,0.9974960004870275,1850,1336,3186,+
chr11,9428569,0.6852315394242804,1094,798,1892,+
chr11,9429681,1.865979381443299,723,387,1110,+
chr11,9429684,2.0388301794052595,1463,938,2401,+
chr11,9429686,2.0388301794052595,1463,938,2401,+
chr11,9429689,0.939435248296008,1607,1104,2711,+
chr11,9429691,0.939435248296008,1607,1104,2711,+
chr11,9429692,0.439731411726171,715,567,1282,+
chr11,9429696,1.6797438672438674,744,615,1359,+
chr11,9430877,1.6820478723404253,972,469,1441,+
chr11,9430886,1.5695196821957385,1271,638,1909,+
chr11,9430891,1.7753691783415373,3254,1945,5199,+
chr11,9430893,1.7753691783415373,3254,1945,5199,+
chr11,9430950,2.2721989123251207,7219,5502,12721,+
chr11,9430951,2.015323085267032,11954,8011,19965,+
chr11,9430952,2.015323085267032,11954,8011,19965,+
chr11,9430955,2.275351176673411,5076,3608,8684,+
chr11,9433605,0.4339137316976651,730,531,1261,+
chr11,9433726,2.0273007485689125,1150,756,1906,+
chr11,9433738,0.6533888228299644,1098,840,1938,+
chr11,9433822,1.731560559006211,810,482,1292,+
chr11,9436292,1.8506041683561756,1562,1120,2682,+
chr11,9436293,1.8506041683561756,1562,1120,2682,+
chr11,9437763,1.9434691011235956,983,711,1694,+
chr11,9437782,2.0132105965849205,954,748,1702,+
chr11,9437858,1.7938190841416648,1135,805,1940,+
chr11,9437872,1.6929394319607618,1085,796,1881,+
chr11,9440502,2.3142375737152485,1721,1186,2907,+
chr11,9440508,1.3740812074997053,1815,1338,3153,+
chr11,9440548,1.5134576148019787,1082,966,2048,+
chr11,9442080,2.182574916759157,683,423,1106,+
chr11,9442082,1.1327774768379288,1741,1102,2843,+
chr11,9442084,2.130427841634738,1569,1043,2612,+
chr11,9442085,0.4485888102124265,691,541,1232,+
chr11,9442086,1.9345454545454548,2431,1649,4080,+
chr11,9442087,1.6187687575517027,3925,2633,6558,+
chr11,9442093,1.5172070678124097,2094,1408,3502,+
chr11,9445201,1.8453038674033149,667,542,1209,+
chr11,9445311,1.9963673695016981,789,602,1391,+
chr11,9445392,19.183733291269366,3303,285,3588,+
chr11,9445393,24.509590350089837,5378,762,6140,+
chr11,9445394,19.016482529429545,6814,1306,8120,+
chr11,9445395,16.22362959140604,6447,1543,7990,+
chr11,9445396,14.895794782514763,5782,1768,7550,+
chr11,9445397,9.096100641793761,2520,931,3451,+
chr11,9445398,5.771503484249562,2775,1106,3881,+
chr11,9445400,12.488689206614707,4519,5794,10313,+
chr11,9445401,11.777626105021735,3743,5472,9215,+
chr11,9445402,6.644917028183116,1485,1938,3423,+
chr11,9445410,0.1904961649089166,373,1191,1564,+
chr11,9445436,0.3514265381380604,678,1130,1808,+
chr11,9445437,0.19990307111519234,460,1451,1911,+
chr11,9445440,0.4413309160840055,2611,4455,7066,+
chr11,9445441,0.5469565217391303,1529,2249,3778,+
chr11,9445444,0.4720535852963126,1712,3264,4976,+
chr11,9445445,0.4172386751545688,1511,3628,5139,+
chr11,9445691,1.6073305484436058,993,723,1716,+
chr11,9445889,28.612326761973566,5512,2980,8492,+
chr11,9445890,23.29239177891846,4250,2087,6337,+
chr11,9445915,1.9733133086876158,588,540,1128,+
chr11,9445922,1.7009222661396577,1290,896,2186,+
chr11,9445930,1.8012575039191117,1392,1236,2628,+
chr11,9445987,1.7723684210526316,897,759,1656,+
chr11,9446108,1.628517980790708,1240,813,2053,+
chr11,9446164,1.6770172732253432,2284,1643,3927,+
chr11,9446315,3.9349533627884137,942,581,1523,+
chr11,9446360,2.059188374977849,1244,1025,2269,+
chr11,9446477,3.1635317237507015,726,547,1273,+
chr11,9446557,1.4475983796296297,1020,719,1739,+
chr11,9446645,2.2868574946137272,742,512,1254,+
chr11,9446783,2.6997890789782053,719,501,1220,+
chr11,9446925,1.802145922746781,645,465,1110,+
chr11,9446952,0.3756796836381611,759,577,1336,+
chr11,9447115,1.754367201426025,702,509,1211,+
chr11,9447125,2.3884892086330933,829,694,1523,+
chr11,9497713,1.9148614333302523,1053,744,1797,+
chr11,9497715,2.051475634866163,609,469,1078,+
chr11,9606488,1.8040101003192208,622,461,1083,+
chr11,9606490,1.14056536259542,749,767,1516,+
chr11,9606491,0.9858053391631,1379,1381,2760,+
chr11,9606493,0.7204606982390901,2448,2295,4743,+
chr11,9606495,0.6714142577606736,4434,3682,8116,+
chr11,9606496,0.6379358654217199,3804,3068,6872,+
chr11,9606507,1.497936067727339,2965,2634,5599,+
chr11,9606508,1.4534540139489325,4838,4432,9270,+
chr11,9606509,1.1158361406425457,3425,3077,6502,+
chr11,9606510,1.2623641844999556,6818,6239,13057,+
chr11,9606513,0.6294559768385473,2126,1920,4046,+
chr11,9747958,1.1407943515563046,676,395,1071,+
chr11,9747973,2.252602493252795,854,501,1355,+
chr11,9747975,2.3087182994843736,1790,1117,2907,+
chr11,9747976,2.211734693877551,1376,881,2257,+
chr11,9747977,2.0039398905198564,1899,1246,3145,+
chr11,9747979,1.9974025974025973,1537,1077,2614,+
chr11,9747980,1.9904772888184612,1671,1118,2789,+
chr11,10767932,2.0008948545861296,687,446,1133,+
chr11,10772584,1.346166128996375,1417,874,2291,+
chr11,10772605,1.5187350182934525,925,552,1477,+
chr11,10772608,1.8246957331344156,2382,1663,4045,+
chr11,10772609,1.897217641542988,2076,1585,3661,+
chr11,10772611,1.8334860983806904,1411,1090,2501,+
chr11,10772614,1.8278715120051916,1185,803,1988,+
chr11,10772625,1.0651771674954245,2485,1836,4321,+
chr11,11947966,1.3782168978466944,718,528,1246,+
chr11,11947967,1.208533237326104,1117,757,1874,+
chr11,11947968,1.0892330383480826,632,451,1083,+
chr11,11948057,0.4190612172050687,586,430,1016,+
chr11,11948064,1.7355667588225727,695,558,1253,+
chr11,11948082,2.261336898395722,862,747,1609,+
chr11,11948084,0.6658597812443966,3182,2573,5755,+
chr11,11948085,1.0758859554638907,4605,3767,8372,+
chr11,11948092,1.1948035010861426,4394,3589,7983,+
chr11,12942235,1.7600467289719626,728,427,1155,+
chr11,12942247,1.8912280701754385,1735,1177,2912,+
chr11,12942248,1.8912280701754385,1735,1177,2912,+
chr11,12944174,3.499838053873917,1062,412,1474,+
chr11,12944179,7.682716286207559,800,400,1200,+
chr11,12944180,5.3877559329900695,2334,1045,3379,+
chr11,12944182,4.2018326977242575,2013,868,2881,+
chr11,12944183,2.4128397375820057,812,290,1102,+
chr11,12944247,19.066909894102622,681,797,1478,+
chr11,12944248,13.460364335752299,1019,1631,2650,+
chr11,13707910,2.813261784182077,634,435,1069,+
chr11,13728780,1.9166666666666663,781,543,1324,+
chr11,13728793,0.6944444444444444,999,719,1718,+
chr11,13728795,2.263605509281837,1637,1033,2670,+
chr11,13728799,2.7386546038231434,1563,978,2541,+
chr11,13728801,2.7386546038231434,1563,978,2541,+
chr11,13728804,2.222247504783576,2085,1584,3669,+
chr11,13728806,2.222247504783576,2085,1584,3669,+
chr11,13728834,2.4041095890410955,1520,1240,2760,+
chr11,13728835,0.6752408596837944,1772,1055,2827,+
chr11,16738662,1.8690271680346122,762,337,1099,+
chr11,16738663,1.9665873446353397,933,474,1407,+
chr11,16738708,0.5488558352402746,737,436,1173,+
chr11,16738753,0.9765227467378707,1490,862,2352,+
chr11,16738754,1.2474081775750325,2650,1764,4414,+
chr11,16738755,1.5563909774436089,1160,902,2062,+
chr11,16748131,1.6148495913754126,752,638,1390,+
chr11,16754913,2.247369651624971,1067,657,1724,+
chr11,16754959,3.4394141145139816,1007,750,1757,+
chr11,16755260,1.8337595907928392,716,390,1106,+
chr11,16755277,1.087733361776231,1537,1180,2717,+
chr11,16755413,1.65121412803532,1297,905,2202,+
chr11,16755580,1.4921115963989662,1115,862,1977,+
chr11,16755690,2.829620263033423,2406,1546,3952,+
chr11,16755691,2.955481233742103,1347,896,2243,+
chr11,17301775,2.236012649242218,1265,938,2203,+
chr11,17312093,1.6781914893617016,630,375,1005,+
chr11,17315403,1.1417751763330466,694,449,1143,+
chr11,18394560,0.9304523751852977,3308,2850,6158,+
chr11,18394561,0.8462370705184562,3911,3392,7303,+
chr11,18394562,0.9779525248353368,1934,1798,3732,+
chr11,18394564,0.8750096913176869,1462,798,2260,+
chr11,18394565,1.065128205128205,2277,1274,3551,+
chr11,18394567,1.6600188812839272,1562,891,2453,+
chr11,18394576,1.5287114845938377,1179,713,1892,+
chr11,18394582,0.7116883116883117,1369,1209,2578,+
chr11,18394594,0.8379374195775665,2705,1709,4414,+
chr11,18396833,1.656698400085573,2903,2110,5013,+
chr11,18396839,0.9169150031936084,11416,8220,19636,+
chr11,18396847,1.2191742081447965,4789,3119,7908,+
chr11,18399431,1.2701993374173841,2821,2000,4821,+
chr11,18399438,1.3431611337730032,7847,6356,14203,+
chr11,18399441,1.7206364263539153,3469,2675,6144,+
chr11,18400840,1.6089648763465332,6786,4393,11179,+
chr11,18400842,1.6089648763465332,6786,4393,11179,+
chr11,18402848,1.7209928054970518,5744,3420,9164,+
chr11,18402915,1.2962541590640766,2215,1693,3908,+
chr11,18402965,1.4750289473349365,1587,1138,2725,+
chr11,18402995,2.110942139090224,9458,7566,17024,+
chr11,18402998,1.5200296119997787,2132,1623,3755,+
chr11,18403002,1.3563905470311801,9410,7658,17068,+
chr11,18403707,1.2462390779617543,2976,2610,5586,+
chr11,18403710,1.0213883543898783,8135,6323,14458,+
chr11,18403711,1.0213883543898783,8135,6323,14458,+
chr11,18405459,1.416244022417918,16246,12253,28499,+
chr11,18405465,1.3869671436695563,3438,2610,6048,+
chr11,18405538,1.2441341747672587,6917,4413,11330,+
chr11,18407177,1.3513305403797105,4164,3053,7217,+
chr11,18407183,1.2693870377021874,10952,8622,19574,+
chr11,18407680,1.1589005635589769,8347,7425,15772,+
chr11,20364246,1.832845712413677,1241,890,2131,+
chr11,20364273,0.5634896664796998,652,538,1190,+
chr11,20364274,0.6213945037474449,1025,628,1653,+
chr11,20364290,1.697588126159555,1219,769,1988,+
chr11,20364373,0.5346655206990402,1492,1073,2565,+
chr11,20376583,5.912427733048951,5859,4736,10595,+
chr11,20376584,5.912427733048951,5859,4736,10595,+
chr11,20376650,0.6385798461999399,1486,1177,2663,+
chr11,20383028,2.09970812541192,768,558,1326,+
chr11,20383195,1.6175893207695329,823,565,1388,+
chr11,20383216,1.9893899204244032,999,753,1752,+
chr11,20383225,1.6541095890410955,1448,875,2323,+
chr11,20383252,1.5366679338691853,4500,2933,7433,+
chr11,20383275,1.0493834577962815,4181,2916,7097,+
chr11,20383276,1.0493834577962815,4181,2916,7097,+
chr11,20383330,1.4037162012819568,4715,3877,8592,+
chr11,20383333,1.4463472060536424,16359,14330,30689,+
chr11,20383334,1.165158376859862,44312,35707,80019,+
chr11,20383335,1.4468290806986088,22364,19838,42202,+
chr11,20383336,1.2186025646011434,40696,34088,74784,+
chr11,20383338,1.4833557473433587,12498,11676,24174,+
chr11,20383383,1.5573837468429654,1552,1015,2567,+
chr11,20383431,1.559672161114342,2371,1752,4123,+
chr11,20383541,1.7933817594834542,807,530,1337,+
chr11,20383574,1.6132167152575316,829,685,1514,+
chr11,20389756,1.355324576885997,786,681,1467,+
chr11,20389758,0.8534214145664738,686,569,1255,+
chr11,20462026,2.0270990120474464,1072,686,1758,+
chr11,20462028,1.8084733441091865,3934,2734,6668,+
chr11,20462029,1.7461915937700019,2211,1634,3845,+
chr11,20462030,1.7461915937700019,2211,1634,3845,+
chr11,20462041,0.6804185779816514,878,544,1422,+
chr11,20462060,1.7499309528506608,1007,684,1691,+
chr11,20462062,1.6095575338385677,1157,736,1893,+
chr11,20462063,0.6743042237495297,1632,1078,2710,+
chr11,20462074,0.7407134947301616,3643,2202,5845,+
chr11,20462086,2.051218667735232,7876,5024,12900,+
chr11,20462087,1.827480878364639,12249,7959,20208,+
chr11,20462089,1.5933039234487822,12990,8682,21672,+
chr11,20462090,1.3368087186893145,14979,9643,24622,+
chr11,20462092,1.0183775906735753,5390,3087,8477,+
chr11,20494188,0.7834271254196404,817,660,1477,+
chr11,20508478,6.309432465142489,957,709,1666,+
chr11,20508597,3.8218605937672874,789,545,1334,+
chr11,20508978,0.986373369671014,562,466,1028,+
chr11,20508980,0.986373369671014,562,466,1028,+
chr11,30331011,1.8180411579189055,595,454,1049,+
chr11,30331270,5.084893393279936,564,454,1018,+
chr11,32091145,3.109987515605493,858,533,1391,+
chr11,32091147,3.109987515605493,858,533,1391,+
chr11,32091353,1.3823180145062766,1271,595,1866,+
chr11,32091355,2.198094452154995,1148,502,1650,+
chr11,32091356,2.2119637173854616,1036,566,1602,+
chr11,32091365,1.5657674058478115,986,588,1574,+
chr11,32091367,1.1096627016457552,907,721,1628,+
chr11,32091368,1.5166013866124783,1998,1391,3389,+
chr11,32091391,1.723149494335981,3440,2484,5924,+
chr11,32091392,2.3406444269328435,1257,971,2228,+
chr11,32097144,0.6960413080895008,673,414,1087,+
chr11,32097145,1.593551797040169,629,472,1101,+
chr11,32097152,1.7755829384916924,2310,1644,3954,+
chr11,32097156,1.590828924162257,725,566,1291,+
chr11,32097163,1.5239619076994255,840,700,1540,+
chr11,32097166,1.5818815331010454,907,737,1644,+
chr11,32097238,1.74735547926139,1964,1657,3621,+
chr11,32097239,1.6011456427562816,3240,2665,5905,+
chr11,32097265,0.6182867288060364,1989,1501,3490,+
chr11,32098416,2.3113407278198697,2283,1416,3699,+
chr11,32098417,2.3113407278198697,2283,1416,3699,+
chr11,32098420,1.2054291578825393,2595,1794,4389,+
chr11,32098434,1.596386554621849,1726,1049,2775,+
chr11,32103393,1.8620097148332944,1149,570,1719,+
chr11,32103394,1.3248095479939055,1798,894,2692,+
chr11,32103395,1.9492861885790167,670,501,1171,+
chr11,32103396,1.194905070896419,1242,626,1868,+
chr11,32103413,3.0063492063492063,946,509,1455,+
chr11,32103418,1.4851752021563345,1139,635,1774,+
chr11,32103424,2.062415196743555,1044,736,1780,+
chr11,32104618,2.75,767,383,1150,+
chr11,32104631,1.9958419958419957,863,467,1330,+
chr11,32104645,1.9990384615384609,1462,1039,2501,+
chr11,32104668,1.4472608024691356,1630,1079,2709,+
chr11,32104690,1.7073164873174476,1652,1300,2952,+
chr11,32104777,1.6071904127829562,2413,1501,3914,+
chr11,32104819,5.336934384131761,2008,1472,3480,+
chr11,32104861,1.1871262031585832,3126,2213,5339,+
chr11,32105019,1.7155080213903742,801,560,1361,+
chr11,32105041,2.041835357624832,711,493,1204,+
chr11,32105056,1.8213457076566124,784,430,1214,+
chr11,32105093,0.7272165585418597,1711,1078,2789,+
chr11,32105095,1.5283863804589195,1353,964,2317,+
chr11,32105096,0.7388414736187812,2648,1718,4366,+
chr11,32105249,1.3879411764705882,1715,1189,2904,+
chr11,32583824,1.1641838908352535,666,429,1095,+
chr11,32583828,1.419514671356714,887,475,1362,+
chr11,32583831,2.064693016587011,963,740,1703,+
chr11,32583845,1.9660526546315742,1118,609,1727,+
chr11,32583858,1.0976601727227235,1506,1296,2802,+
chr11,32583887,1.5129130494566347,2024,1249,3273,+
chr11,32583903,1.5505229961319398,2342,1632,3974,+
chr11,32583914,1.603400875674575,1085,853,1938,+
chr11,32587016,2.01390356500247,4600,3667,8267,+
chr11,32587018,2.439261667648037,1984,1748,3732,+
chr11,32587025,1.5774789915966387,1082,1019,2101,+
chr11,32587041,0.9701237024336385,4862,3490,8352,+
chr11,32587058,1.3726159245604084,2064,1311,3375,+
chr11,32587063,1.3031432096654003,2318,1501,3819,+
chr11,32588593,1.565449297188755,1918,1244,3162,+
chr11,32588632,1.5448995399119738,6345,4900,11245,+
chr11,32588680,2.068406357388316,2265,1551,3816,+
chr11,32589015,1.56539814518708,1779,1059,2838,+
chr11,32589053,1.8721894502863983,1435,1113,2548,+
chr11,32589054,1.417030366363413,2248,1567,3815,+
chr11,32589064,1.3652249259874363,2071,1258,3329,+
chr11,32589096,1.353555866791161,2382,1427,3809,+
chr11,32589112,1.470154107168104,1551,1285,2836,+
chr11,32589552,1.4829081375415951,1289,1054,2343,+
chr11,32593890,0.6666187412386326,1685,1293,2978,+
chr11,32594914,1.7415727824609462,3089,2075,5164,+
chr11,33032750,1.7732884399551063,631,485,1116,+
chr11,33032768,2.3389978213507625,670,404,1074,+
chr11,33237053,0.7107640529050543,962,583,1545,+
chr11,33237054,1.811395634508173,638,556,1194,+
chr11,33237065,0.9104232424476428,5385,4091,9476,+
chr11,33237067,0.7494430693069307,4403,3231,7634,+
chr11,33237068,0.7513672869452028,4173,3296,7469,+
chr11,33337157,2.021021021021021,672,443,1115,+
chr11,34052611,0.539578744493392,602,453,1055,+
chr11,34071737,2.129003359462486,678,469,1147,+
chr11,34071922,1.7114228456913827,670,498,1168,+
chr11,34071949,2.4188282647584973,745,558,1303,+
chr11,34076371,2.7338014682413023,570,481,1051,+
chr11,34076374,2.387143803843605,580,502,1082,+
chr11,34076615,1.770250368188513,600,484,1084,+
chr11,34079714,2.4983768341773795,739,452,1191,+
chr11,34079751,2.651378989773784,712,460,1172,+
chr11,34086067,0.4682432432432432,629,399,1028,+
chr11,34086102,0.4447439353099731,659,423,1082,+
chr11,34086322,1.0113240418118468,1241,942,2183,+
chr11,34086324,1.2019029963989774,1770,1284,3054,+
chr11,34090249,1.2207722811260795,1112,960,2072,+
chr11,34090251,1.2207722811260795,1112,960,2072,+
chr11,34090643,3.036186770428016,866,513,1379,+
chr11,34091911,1.5967190704032812,875,531,1406,+
chr11,34091912,2.1057124921531702,598,530,1128,+
chr11,34097245,1.7670995670995668,627,559,1186,+
chr11,34097248,2.949389179755672,844,572,1416,+
chr11,34097257,2.339737108190091,1156,988,2144,+
chr11,34097258,2.1262577641181073,1772,1451,3223,+
chr11,34097711,0.2708286379685974,514,492,1006,+
chr11,34099319,2.013833862731696,1022,593,1615,+
chr11,34099321,2.5589528700104522,874,591,1465,+
chr11,34099645,1.7873303167420809,789,526,1315,+
chr11,34100188,1.6012726694241168,698,448,1146,+
chr11,34100203,2.2863606981254043,654,454,1108,+
chr11,34100441,2.258597724741795,1276,1116,2392,+
chr11,34100442,2.2216084177729662,2690,2032,4722,+
chr11,34101107,56.01467901054532,858,349,1207,+
chr11,34136985,2.946002494133829,1186,913,2099,+
chr11,34136986,4.626785414216098,705,540,1245,+
chr11,34136994,1.3357964944457008,992,718,1710,+
chr11,34136997,1.6983826927116152,621,413,1034,+
chr11,34449303,2.273365665961956,882,683,1565,+
chr11,34451028,1.6438926843537576,958,705,1663,+
chr11,34453904,1.8287176399759182,674,452,1126,+
chr11,34456093,1.132623885043403,789,544,1333,+
chr11,34456137,2.8622332589384416,999,798,1797,+
chr11,34461346,1.7706338278725753,709,470,1179,+
chr11,34464146,1.1640127526097905,674,512,1186,+
chr11,34470963,1.661333333333333,622,464,1086,+
chr11,34471463,1.1538841622125438,839,680,1519,+
chr11,34471760,1.867430970450508,770,562,1332,+
chr11,34471808,1.987169861429584,4607,3068,7675,+
chr11,34471809,2.08193289129998,3622,2369,5991,+
chr11,34471812,1.4446178720076635,8768,6092,14860,+
chr11,34471813,1.4446178720076635,8768,6092,14860,+
chr11,34471814,1.334771789582259,6510,4431,10941,+
chr11,34471827,1.5412355447352404,1446,1165,2611,+
chr11,34471899,2.1364592619005167,2932,2484,5416,+
chr11,34471900,2.1364592619005167,2932,2484,5416,+
chr11,34471901,2.1082075964047546,3968,3448,7416,+
chr11,34471903,2.0015036566765723,3177,2481,5658,+
chr11,34957395,0.5340136054421768,627,391,1018,+
chr11,34957398,2.7229567307692304,984,639,1623,+
chr11,34957400,2.7229567307692304,984,639,1623,+
chr11,34957412,2.0032471925314566,672,388,1060,+
chr11,34970166,1.065578231292517,711,489,1200,+
chr11,34970167,1.065578231292517,711,489,1200,+
chr11,34970204,2.187778081775346,856,563,1419,+
chr11,35139301,1.6460040983606559,832,426,1258,+
chr11,35139304,1.604798877013645,2153,1309,3462,+
chr11,35139305,0.5835586449494335,1807,1200,3007,+
chr11,35139306,0.5835586449494335,1807,1200,3007,+
chr11,35139307,1.7744223006930813,3354,2443,5797,+
chr11,35139309,1.5690043290043287,5303,3959,9262,+
chr11,35139310,1.489010053450599,3741,2873,6614,+
chr11,35176602,0.5064071370640714,891,684,1575,+
chr11,35176603,0.8256138666789384,2330,1631,3961,+
chr11,35176604,0.9876782087195928,1738,1116,2854,+
chr11,35176619,0.5660514187097764,2132,1532,3664,+
chr11,35176706,1.7688442211055275,1279,994,2273,+
chr11,35180333,1.824314108761241,1911,1293,3204,+
chr11,35180336,1.254762689518787,2085,1479,3564,+
chr11,35180338,1.254762689518787,2085,1479,3564,+
chr11,35180350,1.74585635359116,631,542,1173,+
chr11,35180361,1.5241675617615469,1121,832,1953,+
chr11,35186860,0.7117839309313349,1577,1180,2757,+
chr11,35189881,0.6708776834032182,1290,785,2075,+
chr11,35189903,1.7746969696969697,900,824,1724,+
chr11,35189981,0.6194569855897087,938,850,1788,+
chr11,35214862,1.7486281682780245,1194,889,2083,+
chr11,35219322,1.7062500000000005,1021,729,1750,+
chr11,35221659,1.6344510190664037,1242,779,2021,+
chr11,35221668,0.5942234329189522,2885,1944,4829,+
chr11,35229226,1.4939637826961771,1295,851,2146,+
chr11,35229271,1.6290468643875935,1598,1261,2859,+
chr11,35229350,1.8442133512244208,1717,1354,3071,+
chr11,35229695,1.6705,770,499,1269,+
chr11,35229720,3.1666666666666665,740,503,1243,+
chr11,35229748,1.6570561456752655,951,658,1609,+
chr11,35229754,1.2509126763238225,1391,890,2281,+
chr11,35229796,2.2565232050502773,1678,1202,2880,+
chr11,35229799,4.444444444444444,559,449,1008,+
chr11,35229802,1.7175102599179208,836,601,1437,+
chr11,35229814,1.4156142365097588,1232,870,2102,+
chr11,35229816,1.6021335807050092,908,615,1523,+
chr11,35230133,2.7499860090868724,787,886,1673,+
chr11,35231350,3.0128604935477683,649,474,1123,+
chr11,35726122,1.613338495148633,584,550,1134,+
chr11,35726139,2.193472916170989,850,933,1783,+
chr11,35726140,2.193472916170989,850,933,1783,+
chr11,35806867,1.306075918245345,997,681,1678,+
chr11,35806907,1.4386028877145642,1761,1334,3095,+
chr11,35806912,2.1194743130227,886,495,1381,+
chr11,35809176,2.8330210563882936,976,933,1909,+
chr11,35809177,2.8330210563882936,976,933,1909,+
chr11,35809178,2.8330210563882936,976,933,1909,+
chr11,36648025,3.977832699213406,691,349,1040,+
chr11,36648105,2.1030405405405412,746,517,1263,+
chr11,43318658,2.7810625331593264,598,423,1021,+
chr11,43318683,4.250172366084859,677,458,1135,+
chr11,43322008,2.5550589483985573,789,559,1348,+
chr11,43323554,1.2041192517916082,593,510,1103,+
chr11,43327793,0.827229503187589,626,493,1119,+
chr11,43330001,1.5766535151920889,590,437,1027,+
chr11,43330027,1.6577379243853219,656,470,1126,+
chr11,43342555,0.978102189781022,535,547,1082,+
chr11,43342556,0.978102189781022,535,547,1082,+
chr11,43342563,2.235371226592605,760,477,1237,+
chr11,43342688,2.800224674984605,747,489,1236,+
chr11,43343340,3.5514221753351647,708,500,1208,+
chr11,43344049,2.2062203665943554,1097,807,1904,+
chr11,43344160,2.773338904403261,738,474,1212,+
chr11,43344410,5.038037276531,882,477,1359,+
chr11,43396754,4.649107508079383,722,543,1265,+
chr11,43399893,3.953878041817327,663,491,1154,+
chr11,43399966,0.37736917413022175,876,737,1613,+
chr11,43399973,2.0789670014347204,1227,1024,2251,+
chr11,43399974,2.0789670014347204,1227,1024,2251,+
chr11,43407563,4.643265227358216,595,457,1052,+
chr11,43443420,1.6484395838890369,617,488,1105,+
chr11,43856049,0.9083286672734444,695,519,1214,+
chr11,43856481,0.9755732284790956,788,686,1474,+
chr11,44108091,1.216840664059935,737,492,1229,+
chr11,44126821,1.005268975623846,830,639,1469,+
chr11,44126822,1.005268975623846,830,639,1469,+
chr11,44126911,2.6645088732582303,563,442,1005,+
chr11,44171671,1.5244830219329226,688,507,1195,+
chr11,44234119,1.656236501631326,813,621,1434,+
chr11,46669467,3.3108575349058693,687,479,1166,+
chr11,46672513,1.561927577129724,719,582,1301,+
chr11,46672520,2.6778147901399065,692,394,1086,+
chr11,47565932,0.9365088228724592,540,483,1023,+
chr11,47565933,1.498694075401283,1162,897,2059,+
chr11,47565934,0.9365088228724592,540,483,1023,+
chr11,47569864,2.187357161746726,765,576,1341,+
chr11,47571473,1.124646781789639,795,636,1431,+
chr11,47571474,1.124646781789639,795,636,1431,+
chr11,47579084,1.1371203839891404,566,463,1029,+
chr11,47579134,2.4510659693535506,684,352,1036,+
chr11,47579289,3.541893912712927,773,507,1280,+
chr11,47579310,2.2460518402813796,679,557,1236,+
chr11,47580850,0.5566990100950701,709,536,1245,+
chr11,47580927,0.4434108527131783,747,509,1256,+
chr11,47582088,2.303554198798119,955,752,1707,+
chr11,47582357,0.6140704584040748,642,495,1137,+
chr11,47582407,0.5500443506820415,955,706,1661,+
chr11,47584379,0.5204123994821654,1027,687,1714,+
chr11,47584461,1.5580192165558016,619,450,1069,+
chr11,47584475,1.9745159453302965,602,438,1040,+
chr11,57700504,4.33653067979635,417,656,1073,+
chr11,57700508,4.017374993942152,456,931,1387,+
chr11,57739148,4.40805086990975,674,390,1064,+
chr11,57740463,2.656902356902357,606,494,1100,+
chr11,57740546,2.421875,619,383,1002,+
chr11,57740658,0.5281306715063521,581,463,1044,+
chr11,57741618,0.2941291585127201,834,510,1344,+
chr11,57741619,1.358812734539159,775,466,1241,+
chr11,57741692,7.774825707484959,932,586,1518,+
chr11,57741695,4.798889449771813,1163,803,1966,+
chr11,57742200,1.0162727577868864,1274,985,2259,+
chr11,57742229,1.615451263537906,677,553,1230,+
chr11,57742920,1.58898847631242,1021,780,1801,+
chr11,57809333,0.7464313378915627,618,387,1005,+
chr11,58620269,2.9709890109890114,750,454,1204,+
chr11,58620271,2.8890768115133603,968,608,1576,+
chr11,60850608,1.1581935483870966,611,464,1075,+
chr11,60850610,1.1581935483870966,611,464,1075,+
chr11,60850979,1.818841359839483,800,667,1467,+
chr11,60850980,1.2110655737704918,590,487,1077,+
chr11,60919778,2.864230263530082,589,504,1093,+
chr11,60921775,3.8393154269858223,819,501,1320,+
chr11,60922252,0.3317270709339869,601,444,1045,+
chr11,60922267,3.2255765736584148,553,459,1012,+
chr11,60922319,2.6271663663213682,619,537,1156,+
chr11,60922703,21.063545626042366,1072,356,1428,+
chr11,60922710,3.892387059683209,847,309,1156,+
chr11,60922724,6.729198399168265,2711,1932,4643,+
chr11,60922725,6.840789948678779,3673,3225,6898,+
chr11,60922726,6.84078994867878,3673,3225,6898,+
chr11,60922727,7.093188127738387,2805,2896,5701,+
chr11,60922762,3.6099519331771464,1879,3349,5228,+
chr11,60922763,3.6099519331771464,1879,3349,5228,+
chr11,60922770,1.179976165783584,601,923,1524,+
chr11,60922777,0.19649694684752778,568,1195,1763,+
chr11,60932087,0.5075467012538022,594,448,1042,+
chr11,60936338,8.296572823112843,488,641,1129,+
chr11,61342620,0.1672195093315104,612,468,1080,+
chr11,61345917,2.8702575228860456,831,516,1347,+
chr11,61446232,0.7057513914656772,633,538,1171,+
chr11,61446233,1.1665484848420657,1228,976,2204,+
chr11,61795340,1.9047454403242408,822,533,1355,+
chr11,61795353,2.3016252390057357,962,522,1484,+
chr11,61795355,2.3016252390057357,962,522,1484,+
chr11,61795533,6.235365103419852,1724,1438,3162,+
chr11,61795534,7.583326709791458,2887,2270,5157,+
chr11,61795580,0.5732075471698113,650,529,1179,+
chr11,61795637,2.6818214377282974,910,679,1589,+
chr11,61795732,2.318623130575148,810,631,1441,+
chr11,61795760,0.5954202446005725,672,426,1098,+
chr11,61795819,2.0726600985221677,560,503,1063,+
chr11,61795949,3.133712285216184,863,516,1379,+
chr11,61795962,2.2064544650751547,712,376,1088,+
chr11,61796038,1.6384848261094291,633,466,1099,+
chr11,61796069,2.070325048753052,1714,1151,2865,+
chr11,61796120,2.1308203991130816,650,450,1100,+
chr11,61796156,1.4760344659190692,903,777,1680,+
chr11,61796173,1.2084921423998805,2382,1984,4366,+
chr11,61796174,0.9738977196534377,2965,2492,5457,+
chr11,61796176,1.2664212635027143,1882,1510,3392,+
chr11,61796263,0.5085560329134202,581,442,1023,+
chr11,61796345,2.7222222222222223,587,431,1018,+
chr11,61796514,0.5210399831549992,7855,4461,12316,+
chr11,61796515,0.5560564701833595,8933,4992,13925,+
chr11,61796516,0.5807669449599965,6373,3408,9781,+
chr11,61796517,0.6549189824822315,3155,1501,4656,+
chr11,61796534,2.0152830188679247,970,635,1605,+
chr11,61796538,1.6189633519808195,2153,1382,3535,+
chr11,61796539,1.6488644138127218,4504,2847,7351,+
chr11,61796599,2.011417432470064,698,512,1210,+
chr11,61796705,1.2516541845415547,1358,808,2166,+
chr11,61796706,1.2516541845415547,1358,808,2166,+
chr11,61796816,5.189882436765228,606,400,1006,+
chr11,61796831,1.7901346281174133,1422,984,2406,+
chr11,61796832,1.7901346281174133,1422,984,2406,+
chr11,61796985,0.6117162914548536,531,485,1016,+
chr11,61796998,1.1567327137893395,1553,1102,2655,+
chr11,62129781,0.2452106517733343,881,537,1418,+
chr11,62148483,1.2298833141960415,1138,981,2119,+
chr11,62148484,1.0438416422287389,790,774,1564,+
chr11,62148492,1.6620563674321502,1157,957,2114,+
chr11,62148494,1.6620563674321502,1157,957,2114,+
chr11,62148504,1.994061757719715,656,420,1076,+
chr11,62148510,2.149261992619926,1411,1354,2765,+
chr11,62148512,2.149261992619926,1411,1354,2765,+
chr11,62152190,1.9790210068872274,1592,4316,5908,+
chr11,62152191,1.9790210068872274,1592,4316,5908,+
chr11,62152192,1.6584406457120533,1703,4369,6072,+
chr11,62152194,0.299882493681957,820,2322,3142,+
chr11,62372414,1.217659366603221,824,343,1167,+
chr11,62372415,1.4900921658986177,994,427,1421,+
chr11,62738343,2.1917112962634966,643,460,1103,+
chr11,62761579,0.7936907548796643,864,425,1289,+
chr11,62761593,1.7823985822007362,1049,632,1681,+
chr11,62762874,2.2071505849445465,852,716,1568,+
chr11,62762875,2.2328738293170582,642,558,1200,+
chr11,62762894,1.252201915765571,572,480,1052,+
chr11,62762943,1.2405334648023745,1385,997,2382,+
chr11,62762944,0.9179969982262246,927,697,1624,+
chr11,62762980,4.242463617463618,652,480,1132,+
chr11,62765195,0.6800075372149991,693,434,1127,+
chr11,62856120,1.2869438803131772,743,474,1217,+
chr11,62856243,2.2188449848024314,729,657,1386,+
chr11,62856334,2.472869193000126,853,610,1463,+
chr11,62870768,0.28022150245533384,595,562,1157,+
chr11,62870819,1.5675175730669626,1114,764,1878,+
chr11,62871591,1.2305552792895436,1461,1296,2757,+
chr11,62880899,1.3160867407965628,837,565,1402,+
chr11,62880903,3.6341853035143767,727,312,1039,+
chr11,62880908,1.8678170167166037,2004,1310,3314,+
chr11,62880910,2.0068553737284387,1154,930,2084,+
chr11,62880937,1.5760969521807673,1296,691,1987,+
chr11,62880969,3.5609065155807365,2094,1764,3858,+
chr11,62880970,2.3626725919069713,5227,4040,9267,+
chr11,62880971,1.5080254339233543,3133,2276,5409,+
chr11,62880977,1.7051161330822346,1024,884,1908,+
chr11,62881023,1.5304636437908494,1896,1529,3425,+
chr11,62881081,1.5937770987322957,1905,1587,3492,+
chr11,62881137,2.033240011388441,3620,3083,6703,+
chr11,62881138,2.033240011388441,3620,3083,6703,+
chr11,62881153,1.465766319591194,1753,1530,3283,+
chr11,62881198,1.3940199044889048,2503,2056,4559,+
chr11,62881326,1.5126324923014105,1433,1108,2541,+
chr11,62881327,1.3249234122776008,2533,1967,4500,+
chr11,62881435,1.5336912132393141,3973,2495,6468,+
chr11,62881891,0.5109889079274783,956,914,1870,+
chr11,62881896,1.2807875150060022,2150,1665,3815,+
chr11,62881902,1.5600688775452392,10124,7889,18013,+
chr11,62881904,1.5600688775452392,10124,7889,18013,+
chr11,62881908,1.269974524253253,2750,1635,4385,+
chr11,62881911,1.334585754100325,3351,2036,5387,+
chr11,62881952,1.5380518035396646,12512,10970,23482,+
chr11,62881953,1.318330601169716,18744,15441,34185,+
chr11,62881960,1.4586246500748339,30551,24291,54842,+
chr11,62881961,1.3938023125632575,39855,31003,70858,+
chr11,62884512,0.7646870440878198,3069,2505,5574,+
chr11,62884659,0.9602280769153002,7914,5053,12967,+
chr11,62884660,1.1201165683614394,16418,11463,27881,+
chr11,62885177,1.0675898414344827,16472,12740,29212,+
chr11,62885178,1.0675898414344827,16472,12740,29212,+
chr11,62885179,0.8561706683540345,14624,11097,25721,+
chr11,62885181,1.2537568372849466,15310,11303,26613,+
chr11,62885209,0.8198204626196399,4978,3612,8590,+
chr11,62885214,1.372768130082924,3873,2488,6361,+
chr11,62885226,1.3783509271477183,3284,2855,6139,+
chr11,62885464,1.4685512731392087,3099,1814,4913,+
chr11,62888137,2.1831978319783203,2013,1475,3488,+
chr11,62888336,0.6619811453496552,2001,1235,3236,+
chr11,62888417,1.36444430287545,5887,4293,10180,+
chr11,62888456,1.867956423741548,2209,1693,3902,+
chr11,62888475,0.8072244719481358,3567,2669,6236,+
chr11,62888501,1.4226865890631062,6240,4402,10642,+
chr11,62888548,1.0155745115011718,4368,3361,7729,+
chr11,62888641,1.4876897852544024,2625,1530,4155,+
chr11,62888713,1.3388175985334556,2675,2181,4856,+
chr11,63681510,2.4211820330969265,691,422,1113,+
chr11,63681570,1.157447901653235,1070,761,1831,+
chr11,63756119,1.8835880880580653,611,461,1072,+
chr11,63758157,2.304058146577832,950,507,1457,+
chr11,63758158,2.304058146577832,950,507,1457,+
chr11,63758160,2.1855509355509364,840,443,1283,+
chr11,63758162,2.1855509355509364,840,443,1283,+
chr11,63758166,1.1336324077351634,1118,877,1995,+
chr11,63758174,1.7109913147648994,590,476,1066,+
chr11,63758185,2.1091418774905013,3054,1979,5033,+
chr11,63758186,1.8749364811745686,5322,3618,8940,+
chr11,63758187,1.6583418564596144,5641,3796,9437,+
chr11,63758194,1.7985111662531017,905,774,1679,+
chr11,63758195,2.065205627705628,897,615,1512,+
chr11,63758199,1.993684210526316,946,683,1629,+
chr11,63758320,1.6661737158631569,1351,965,2316,+
chr11,63758351,0.5295950155763239,1359,855,2214,+
chr11,63758352,0.5230234443197406,1156,890,2046,+
chr11,63758355,0.487312030075188,1036,759,1795,+
chr11,63758693,1.862339297406429,3577,2759,6336,+
chr11,63758930,1.921470342522974,689,566,1255,+
chr11,63758958,0.5947678400219149,943,744,1687,+
chr11,63759178,0.6154353896928155,712,504,1216,+
chr11,63759430,1.6796875,515,511,1026,+
chr11,63759734,1.911007025761124,611,426,1037,+
chr11,63759735,1.2365462807940684,1033,790,1823,+
chr11,63759736,1.2365462807940684,1033,790,1823,+
chr11,63759737,1.2365462807940684,1033,790,1823,+
chr11,63827169,9.119224335346466,375,672,1047,+
chr11,63827191,0.24739950221571352,495,1090,1585,+
chr11,63827192,0.24739950221571352,495,1090,1585,+
chr11,63827193,0.22628120893561104,286,760,1046,+
chr11,63900640,2.088767170926795,774,638,1412,+
chr11,63900642,2.088767170926795,774,638,1412,+
chr11,63974596,1.2042305949804075,942,642,1584,+
chr11,63974597,1.2042305949804075,942,642,1584,+
chr11,63974598,1.5847081849683393,1350,946,2296,+
chr11,63974618,0.8502417538502542,7824,5399,13223,+
chr11,63974619,0.8902962994532615,6834,4791,11625,+
chr11,63974739,1.5726237423064164,1254,630,1884,+
chr11,63974752,1.3761068697760894,3596,2259,5855,+
chr11,63974753,1.6215033864965207,5054,3246,8300,+
chr11,63974780,1.5107841831979765,1512,1035,2547,+
chr11,63976224,1.5416786295339269,904,644,1548,+
chr11,63976242,1.1166009490512883,2508,1966,4474,+
chr11,63976379,1.6985070647298963,2391,2021,4412,+
chr11,63976389,1.4022401200889123,1942,1282,3224,+
chr11,63988358,2.571794727264785,984,578,1562,+
chr11,63988728,2.0466306115321444,1118,716,1834,+
chr11,63988735,1.9358646468620893,614,390,1004,+
chr11,63996541,1.811557788944724,617,397,1014,+
chr11,63996925,2.2508597682510723,844,611,1455,+
chr11,63997110,0.8579487179487181,716,674,1390,+
chr11,63997112,0.8579487179487181,716,674,1390,+
chr11,63997188,1.348936297263153,632,533,1165,+
chr11,63997625,3.6667462119578675,566,435,1001,+
chr11,64186180,0.5822083923670616,1589,971,2560,+
chr11,64186203,1.1150797258453875,1329,791,2120,+
chr11,64186224,1.1994979076684344,1397,835,2232,+
chr11,64193078,2.032495692957421,1902,1344,3246,+
chr11,64193080,2.2643160127253448,875,655,1530,+
chr11,64193092,1.8337104887404265,1126,916,2042,+
chr11,64193093,1.6464646464646464,814,494,1308,+
chr11,64193104,1.0776307613336678,1285,1046,2331,+
chr11,64193129,1.5503167664810011,1752,1229,2981,+
chr11,64193157,2.007593735168486,704,601,1305,+
chr11,64193210,2.2505910165484626,594,422,1016,+
chr11,64193267,1.8860616341532368,952,654,1606,+
chr11,64194191,1.4403973509933774,869,603,1472,+
chr11,64194196,3.3360323886639685,823,664,1487,+
chr11,64194222,1.9029007633587791,778,654,1432,+
chr11,64194560,1.8257399401396743,914,678,1592,+
chr11,64194593,2.6456844420010994,824,641,1465,+
chr11,64197277,1.5370370370370372,1127,845,1972,+
chr11,64197278,1.6374341220313569,1767,1346,3113,+
chr11,64197280,1.6910052910052908,1221,944,2165,+
chr11,64197306,1.7935933697296589,801,660,1461,+
chr11,64197495,1.6081775367489657,726,538,1264,+
chr11,64197503,1.8101524060962442,837,640,1477,+
chr11,64197516,1.8432260681449435,1434,1031,2465,+
chr11,64197517,1.8432260681449435,1434,1031,2465,+
chr11,64197562,0.6955103262496259,1222,1027,2249,+
chr11,64199946,2.016662258661729,609,397,1006,+
chr11,64199976,2.4400871459694997,735,620,1355,+
chr11,64199978,1.5522060838585914,943,622,1565,+
chr11,64200171,2.321845794392523,635,427,1062,+
chr11,64200223,1.6365249537892792,713,540,1253,+
chr11,64200233,0.29465326340326337,808,623,1431,+
chr11,64203132,1.4788936867182847,696,583,1279,+
chr11,64203134,2.4210743801652894,650,483,1133,+
chr11,64203139,1.8555555555555556,667,539,1206,+
chr11,64203511,1.7412244897959184,789,489,1278,+
chr11,64203577,0.8103585435105621,1762,1367,3129,+
chr11,64203579,1.1552260310592435,2080,1406,3486,+
chr11,64203597,2.144011976047904,692,500,1192,+
chr11,64204055,1.710143678541098,1380,966,2346,+
chr11,64204061,0.5727203948553519,756,676,1432,+
chr11,64204242,1.937639198218263,569,448,1017,+
chr11,64204361,2.0221307083129543,1137,720,1857,+
chr11,64204435,3.6529080675422136,1061,368,1429,+
chr11,64204436,3.428294925300913,1416,500,1916,+
chr11,64204437,3.897364875798855,2765,975,3740,+
chr11,64204438,3.5950960043628246,1721,611,2332,+
chr11,64204439,3.7474747474747474,1059,395,1454,+
chr11,64204445,7.3301244627301365,945,307,1252,+
chr11,64204448,16.952273267644202,3584,1435,5019,+
chr11,64204449,15.641763971269196,4157,1630,5787,+
chr11,64204450,11.327404528402196,3359,1258,4617,+
chr11,64204453,14.557909989483862,2974,2877,5851,+
chr11,64204454,9.597933293208394,5985,7328,13313,+
chr11,64204455,9.597933293208394,5985,7328,13313,+
chr11,64204456,9.224303440389013,5019,6884,11903,+
chr11,64204493,0.4584795321637427,440,569,1009,+
chr11,64238713,3.229346123209934,948,616,1564,+
chr11,64238725,2.376672104404568,856,612,1468,+
chr11,64238727,1.8645856325629326,1153,829,1982,+
chr11,64242410,0.7690167462858942,770,442,1212,+
chr11,64242411,1.4348200733307472,1039,622,1661,+
chr11,64242415,1.8693328302835943,928,557,1485,+
chr11,64242416,1.8693328302835943,928,557,1485,+
chr11,64242418,2.144352924752199,639,376,1015,+
chr11,64242420,1.12673343605547,1169,707,1876,+
chr11,64242421,1.1222898370192533,927,584,1511,+
chr11,64242422,1.12673343605547,1169,707,1876,+
chr11,64242433,2.6890756302521006,639,492,1131,+
chr11,64242436,2.0373514431239386,1049,588,1637,+
chr11,64243451,4.472437764020167,999,478,1477,+
chr11,64243462,5.09674041646512,3288,2799,6087,+
chr11,64243463,4.530831856653313,3328,2977,6305,+
chr11,64243464,4.530831856653314,3328,2977,6305,+
chr11,64243465,3.5475865925692918,724,866,1590,+
chr11,64307378,7.01012285012285,742,406,1148,+
chr11,64307379,10.435198223144722,1287,927,2214,+
chr11,64307380,10.713791565596699,1199,971,2170,+
chr11,64313959,1.986212577470699,659,460,1119,+
chr11,64314788,0.8812157180109701,699,336,1035,+
chr11,64314790,0.8812157180109701,699,336,1035,+
chr11,64315175,7.452045536008717,812,595,1407,+
chr11,64315176,9.845899725906296,1027,819,1846,+
chr11,64315240,0.33406172293994857,853,763,1616,+
chr11,64315829,6.597537136066547,861,414,1275,+
chr11,64315830,6.170547762955713,1193,684,1877,+
chr11,64316288,7.270373445646414,751,406,1157,+
chr11,64316292,7.0785011739361465,1456,796,2252,+
chr11,64316293,9.044706642888592,2222,1282,3504,+
chr11,64316294,7.5360444989162,1567,832,2399,+
chr11,64316298,3.4431783299743244,1117,774,1891,+
chr11,64316318,5.159086792464758,1727,1494,3221,+
chr11,64316319,4.9226238489672784,2073,1821,3894,+
chr11,64316536,3.2443182627845966,886,619,1505,+
chr11,64316538,3.413685457255346,754,592,1346,+
chr11,64316654,0.48968636911942104,1058,828,1886,+
chr11,64316656,0.48968636911942104,1058,828,1886,+
chr11,64316667,1.5381331035584163,644,505,1149,+
chr11,64318182,0.40126575724565816,768,324,1092,+
chr11,64318194,1.8797684891277857,1662,1003,2665,+
chr11,64318195,1.7655076377753396,972,696,1668,+
chr11,64318197,1.907590759075908,866,403,1269,+
chr11,64318200,1.7334061731767278,667,522,1189,+
chr11,64318213,5.746436816537755,6941,5170,12111,+
chr11,64318214,5.746436816537753,6941,5170,12111,+
chr11,64318219,4.227916039219228,8490,9800,18290,+
chr11,64318220,4.227916039219228,8490,9800,18290,+
chr11,64318223,0.5187502413779785,1103,1917,3020,+
chr11,64318241,0.7000301038692129,2460,4120,6580,+
chr11,64318256,0.6541980818910267,5169,8167,13336,+
chr11,64318257,0.6480977973676626,13516,17811,31327,+
chr11,64318258,0.640343826624665,12082,15557,27639,+
chr11,64318259,0.511645465344414,7155,10108,17263,+
chr11,64318314,0.5361294072065089,1106,1067,2173,+
chr11,64318347,0.7358918217833226,1569,1170,2739,+
chr11,64319738,1.7045186274306783,1808,1122,2930,+
chr11,64319781,1.4263286234425627,1399,1173,2572,+
chr11,64319782,2.251988815374921,1284,1103,2387,+
chr11,64319803,1.5309218765051535,1629,1482,3111,+
chr11,64320739,1.3901840490797546,3089,1955,5044,+
chr11,64320878,1.6074967486164315,10098,7605,17703,+
chr11,64320884,0.6500505541284527,4894,3986,8880,+
chr11,64321008,1.507024534496153,3805,2829,6634,+
chr11,64321009,1.4120474012776292,7299,5077,12376,+
chr11,64321016,0.7386809985433723,7115,5159,12274,+
chr11,64321017,0.7386809985433723,7115,5159,12274,+
chr11,64321020,1.3005915560314805,2501,1962,4463,+
chr11,64321023,1.5081274440900327,2574,2093,4667,+
chr11,64321046,1.447816610814862,2625,2253,4878,+
chr11,64321669,0.651912416618299,2499,1886,4385,+
chr11,64321680,0.6663378058405682,3376,2099,5475,+
chr11,64321702,1.3527304289480213,5127,3700,8827,+
chr11,64321730,1.4075521027002755,4865,3295,8160,+
chr11,65014189,2.1945388941445345,721,590,1311,+
chr11,65014194,2.869100173657286,1510,1051,2561,+
chr11,65014202,2.1176507150026525,1415,1023,2438,+
chr11,65014204,2.1835685173771395,1700,1139,2839,+
chr11,65014211,6.3758064516129025,1406,1084,2490,+
chr11,65014212,10.4098045480616,2563,2021,4584,+
chr11,65014213,10.100714408190418,2700,2328,5028,+
chr11,65018619,3.2227512155591573,908,616,1524,+
chr11,65018620,3.2227512155591573,908,616,1524,+
chr11,65020451,0.5350515463917526,691,387,1078,+
chr11,65020482,2.9058874709976803,690,430,1120,+
chr11,65021824,0.4111137273369437,872,684,1556,+
chr11,65021825,0.4111137273369437,872,684,1556,+
chr11,65022105,2.7203268032778274,957,781,1738,+
chr11,65022106,2.8244631185807654,604,503,1107,+
chr11,65022109,4.782743186373121,1573,1213,2786,+
chr11,65108896,2.5739628040057227,691,465,1156,+
chr11,65108898,2.5739628040057227,691,465,1156,+
chr11,65110728,1.2237944943766905,751,498,1249,+
chr11,65111434,0.9810887588081424,614,488,1102,+
chr11,65111435,1.060245918364899,544,486,1030,+
chr11,65125591,0.8713463751438434,630,394,1024,+
chr11,65125592,1.334126390195052,860,547,1407,+
chr11,65125947,5.572189477363046,982,719,1701,+
chr11,65125985,3.161939296990201,859,888,1747,+
chr11,65126074,3.489362017532511,649,502,1151,+
chr11,65126594,2.644995725503925,625,431,1056,+
chr11,65261981,2.363368428509558,712,452,1164,+
chr11,65267491,1.2487570763780442,632,499,1131,+
chr11,65275971,0.8817763036752698,1020,829,1849,+
chr11,65352517,6.847372859493874,748,324,1072,+
chr11,65352547,11.381121502476715,701,501,1202,+
chr11,65352548,11.381121502476715,701,501,1202,+
chr11,65422833,1.5955174983770632,885,572,1457,+
chr11,65422843,3.3994342132440036,3292,2238,5530,+
chr11,65422844,3.4978108949350237,3009,2056,5065,+
chr11,65422847,12.064631205877832,1921,1949,3870,+
chr11,65422923,13.732887893123506,4294,2576,6870,+
chr11,65422924,14.715409893609898,3796,2371,6167,+
chr11,65422925,13.732887893123506,4294,2576,6870,+
chr11,65422929,1.7451657966326002,1375,811,2186,+
chr11,65422931,1.4612372214915368,1724,1077,2801,+
chr11,65422949,2.2147219823218642,1119,802,1921,+
chr11,65422965,3.2066451012396375,2046,1838,3884,+
chr11,65423062,3.0733863837312114,868,753,1621,+
chr11,65423064,2.740924121551272,2121,1792,3913,+
chr11,65423152,2.6661814619865134,1359,818,2177,+
chr11,65423164,13.132515166849892,1749,1404,3153,+
chr11,65423167,6.009669247569521,1839,1750,3589,+
chr11,65423174,1.907665505226481,729,573,1302,+
chr11,65423176,2.9470006858609583,1195,1283,2478,+
chr11,65423177,2.978642169493231,2259,2559,4818,+
chr11,65423198,0.5905820295495864,960,796,1756,+
chr11,65423200,0.3379524886877828,716,543,1259,+
chr11,65423201,0.4898212579884029,1276,1307,2583,+
chr11,65423247,2.8718558554729614,1831,1407,3238,+
chr11,65423250,6.754011319530394,2894,2561,5455,+
chr11,65423251,6.919488177735504,3710,3308,7018,+
chr11,65423344,0.6758353525382154,1290,1012,2302,+
chr11,65423456,2.797433628318584,770,564,1334,+
chr11,65423457,2.797433628318584,770,564,1334,+
chr11,65423458,2.385010937341268,1186,805,1991,+
chr11,65423499,2.9123630598599006,608,411,1019,+
chr11,65423602,1.5808823529411764,564,451,1015,+
chr11,65423603,2.823821339950372,568,526,1094,+
chr11,65423616,0.621429237512045,713,606,1319,+
chr11,65423617,1.2496508972624871,1629,1276,2905,+
chr11,65423851,2.048040201005025,885,397,1282,+
chr11,65423875,8.097789116457413,6452,5346,11798,+
chr11,65423876,8.097789116457413,6452,5346,11798,+
chr11,65423877,7.076106816516048,6903,5932,12835,+
chr11,65423879,1.5053416149068322,875,1149,2024,+
chr11,65423881,0.5497969991173874,1073,1029,2102,+
chr11,65423900,12.251087751220238,2914,4194,7108,+
chr11,65423901,13.02821020839427,4125,5811,9936,+
chr11,65423914,0.40729164794023476,2371,3240,5611,+
chr11,65423925,0.6990903924866189,5434,6200,11634,+
chr11,65423926,0.7063374119623316,7441,8414,15855,+
chr11,65423927,0.6872670779273808,9552,10695,20247,+
chr11,65423928,0.6594673012758596,10002,11582,21584,+
chr11,65423929,0.7165828625572793,6039,6644,12683,+
chr11,65424078,1.5058846865908488,910,795,1705,+
chr11,65424175,1.6332090923408051,1173,885,2058,+
chr11,65424182,2.2620070436162387,1123,890,2013,+
chr11,65424206,1.1364375298851526,3062,2390,5452,+
chr11,65424309,2.1588377723970944,742,412,1154,+
chr11,65424389,1.5756302521008403,1499,1189,2688,+
chr11,65424461,2.0094251720183487,1192,871,2063,+
chr11,65424578,1.53748932822204,1412,1270,2682,+
chr11,65424694,1.6938281901584653,882,544,1426,+
chr11,65424759,2.527381822716405,2509,1966,4475,+
chr11,65424884,6.2151870510578116,4960,1212,6172,+
chr11,65424885,5.901970788541352,7199,1670,8869,+
chr11,65424886,5.769340617846343,8299,1900,10199,+
chr11,65424888,4.111511123419182,2226,470,2696,+
chr11,65424892,16.112361475264773,4124,1226,5350,+
chr11,65424893,17.09626243173276,6583,2413,8996,+
chr11,65424894,17.09626243173276,6583,2413,8996,+
chr11,65424939,3.6502512037564863,4530,2966,7496,+
chr11,65424940,3.937472419161912,5029,3167,8196,+
chr11,65424941,3.6502512037564863,4530,2966,7496,+
chr11,65424970,5.243469959069102,1389,757,2146,+
chr11,65424987,4.670647846543613,889,306,1195,+
chr11,65424988,3.7019011854462773,1377,502,1879,+
chr11,65425003,2.1086807063250834,1332,360,1692,+
chr11,65425019,6.1871921182266005,941,202,1143,+
chr11,65425022,15.197022720098651,6885,2232,9117,+
chr11,65425023,16.380090213203445,9153,3589,12742,+
chr11,65425024,10.974302597116436,11199,4981,16180,+
chr11,65425025,11.428317803219969,8999,4385,13384,+
chr11,65425026,13.610856014025513,9095,5778,14873,+
chr11,65425028,5.115347067250988,7339,6152,13491,+
chr11,65425029,5.48383635880459,5036,4705,9741,+
chr11,65425030,3.4477792061284984,1162,810,1972,+
chr11,65425032,1.8834080717488793,608,445,1053,+
chr11,65425049,2.2960757818940345,2443,2502,4945,+
chr11,65425060,2.647265123109061,2633,2885,5518,+
chr11,65425068,3.042753021174828,9111,11858,20969,+
chr11,65425069,3.042753021174828,9111,11858,20969,+
chr11,65425084,1.9328317469450622,5212,7061,12273,+
chr11,65425111,0.5761954949000554,3359,3144,6503,+
chr11,65425283,0.7251304666150191,1637,1162,2799,+
chr11,65425333,1.6187290969899666,791,597,1388,+
chr11,65425344,2.3061978892187973,3272,2807,6079,+
chr11,65425345,2.3208727476417805,5394,4486,9880,+
chr11,65425538,1.3818993506493504,3404,2407,5811,+
chr11,65425578,1.428616136919315,5075,4089,9164,+
chr11,65425579,1.2214582442690411,10661,8531,19192,+
chr11,65425580,1.2214582442690411,10661,8531,19192,+
chr11,65425581,1.6060414539679453,5215,4297,9512,+
chr11,65425679,0.5977671709408624,820,525,1345,+
chr11,65425958,1.7392261717521234,1163,866,2029,+
chr11,65426035,3.307378896517494,8035,2003,10038,+
chr11,65426036,3.2973263993537123,6794,1715,8509,+
chr11,65426044,17.33331793610192,15464,9073,24537,+
chr11,65426045,17.33331793610192,15464,9073,24537,+
chr11,65426046,17.33331793610192,15464,9073,24537,+
chr11,65426055,10.920778995186788,10305,9828,20133,+
chr11,65426056,10.920778995186788,10305,9828,20133,+
chr11,65426061,10.119440206663569,4673,5250,9923,+
chr11,65426084,0.5408487537138509,5380,6518,11898,+
chr11,65426218,0.5526860629835458,633,436,1069,+
chr11,65426270,1.871641791044776,683,401,1084,+
chr11,65499051,2.7200245797653038,605,446,1051,+
chr11,65499098,1.8335827876357553,783,656,1439,+
chr11,65499101,1.0458433590170935,1262,1107,2369,+
chr11,65499242,1.6173399014778325,1151,1014,2165,+
chr11,65499350,1.451279505217814,5898,4147,10045,+
chr11,65499382,1.9828125,2537,2039,4576,+
chr11,65499383,1.9828125,2537,2039,4576,+
chr11,65500110,1.7975385496046652,1068,846,1914,+
chr11,65500142,1.948362235067437,789,518,1307,+
chr11,65500144,1.0758636361536267,2981,2014,4995,+
chr11,65500225,1.3390010626992563,2645,1881,4526,+
chr11,65500446,2.0631578947368423,727,519,1246,+
chr11,65500517,2.0560640833987676,3051,2420,5471,+
chr11,65500521,1.6180438618960544,8078,6916,14994,+
chr11,65500522,1.612174870747855,9543,8298,17841,+
chr11,65500523,1.612174870747855,9543,8298,17841,+
chr11,65500524,1.6391357369601849,9891,8804,18695,+
chr11,65500526,1.7408089815938976,7812,7194,15006,+
chr11,65500527,1.8211307764315745,7394,6513,13907,+
chr11,65500604,2.395165987186954,704,605,1309,+
chr11,65500708,2.430473884469042,610,412,1022,+
chr11,65500848,1.9419496166484118,590,497,1087,+
chr11,65500874,1.7326467231499156,1012,822,1834,+
chr11,65500983,1.937866927592955,931,583,1514,+
chr11,65501227,2.4124362934022705,4060,1391,5451,+
chr11,65501228,2.4056915143862025,5144,1735,6879,+
chr11,65501229,2.7575464171713966,5515,1876,7391,+
chr11,65501238,11.66446904703124,2097,769,2866,+
chr11,65501243,9.047999595364786,6605,6390,12995,+
chr11,65501244,7.801633105326334,9036,10119,19155,+
chr11,65501245,7.801633105326334,9036,10119,19155,+
chr11,65501246,6.263315014132844,6952,8867,15819,+
chr11,65501285,0.6687468979142289,2812,3876,6688,+
chr11,65501462,0.433624295326423,752,422,1174,+
chr11,65501463,0.5715345111508229,1468,898,2366,+
chr11,65501475,0.4886211512717537,1240,746,1986,+
chr11,65501487,1.948328599519336,614,397,1011,+
chr11,65501559,15.07551919205524,7723,5091,12814,+
chr11,65501560,8.114005576771536,5364,3509,8873,+
chr11,65501889,3.3837441059094964,3385,1046,4431,+
chr11,65501894,3.672553127806047,817,256,1073,+
chr11,65501899,11.537893483308975,1889,457,2346,+
chr11,65501903,24.97387467145788,11777,6827,18604,+
chr11,65501904,25.95941446452771,13359,8415,21774,+
chr11,65501905,25.95941446452771,13359,8415,21774,+
chr11,65501926,0.5359426546367116,1843,2129,3972,+
chr11,65501933,0.7722620053464825,3303,3357,6660,+
chr11,65502202,2.090531561461794,838,687,1525,+
chr11,65502595,3.4832160102011622,7770,1688,9458,+
chr11,65502597,3.4066438996377943,10362,2376,12738,+
chr11,65502598,3.722869446351365,4438,1189,5627,+
chr11,65502600,4.4844124700239805,1495,416,1911,+
chr11,65502601,4.453613892365457,5789,1127,6916,+
chr11,65502603,4.453613892365457,5789,1127,6916,+
chr11,65502613,22.32784378530887,9492,2485,11977,+
chr11,65502614,22.32784378530887,9492,2485,11977,+
chr11,65502624,1.8605738944779542,7787,2732,10519,+
chr11,65502625,1.8605738944779542,7787,2732,10519,+
chr11,65502626,1.8605738944779542,7787,2732,10519,+
chr11,65502635,3.0832130832130833,640,377,1017,+
chr11,65502663,1.663716814159292,704,564,1268,+
chr11,65503032,1.7215563878485227,1008,800,1808,+
chr11,65503150,1.5779297765617877,843,644,1487,+
chr11,65503263,1.6517121860605495,1319,905,2224,+
chr11,65503344,2.105592347314201,775,603,1378,+
chr11,65503427,2.256363219445081,819,622,1441,+
chr11,65503662,1.9441260744985671,1120,697,1817,+
chr11,65503679,2.101707262693272,1748,1300,3048,+
chr11,65503700,1.7589959060547296,562,545,1107,+
chr11,65503723,1.403815446676191,3653,2281,5934,+
chr11,65503725,1.403815446676191,3653,2281,5934,+
chr11,65503813,1.3851186798008073,2627,1803,4430,+
chr11,65504107,17.25143408293715,7787,6523,14310,+
chr11,65504108,16.999365001567817,7960,6768,14728,+
chr11,65504109,16.999365001567813,7960,6768,14728,+
chr11,65504279,7.786445689542549,1853,320,2173,+
chr11,65504280,12.44891304347826,880,183,1063,+
chr11,65504285,6.570348738379543,1752,236,1988,+
chr11,65504287,16.935483870967744,1224,216,1440,+
chr11,65504288,50.13222912642312,2146,347,2493,+
chr11,65504290,27.84444171175602,1628,1069,2697,+
chr11,65504291,15.484422344578576,5055,4948,10003,+
chr11,65504292,15.484422344578576,5055,4948,10003,+
chr11,65504293,14.836359411671937,4657,4874,9531,+
chr11,65504315,0.44603401684946753,1011,1397,2408,+
chr11,65504318,0.339867871463239,1526,2449,3975,+
chr11,65504325,0.2816917079426295,553,1303,1856,+
chr11,65504334,0.5211747682500221,1834,2471,4305,+
chr11,65504377,0.691853348023014,1738,1555,3293,+
chr11,65504448,1.9538720538720535,828,539,1367,+
chr11,65504605,1.373439236874079,2236,1531,3767,+
chr11,65504668,2.106201550387597,857,644,1501,+
chr11,65505147,9.123266666028213,2768,730,3498,+
chr11,65505148,9.139292063590494,2915,784,3699,+
chr11,65505151,2.40921875,906,319,1225,+
chr11,65505154,6.832544070394047,1547,525,2072,+
chr11,65505157,18.189425602848694,3198,2046,5244,+
chr11,65505158,18.189425602848694,3198,2046,5244,+
chr11,65505170,0.63625,1017,959,1976,+
chr11,65505477,19.63364105575405,2406,1110,3516,+
chr11,65505478,14.294692144373672,1051,470,1521,+
chr11,65505485,14.266509384881491,3601,2641,6242,+
chr11,65505486,14.266509384881491,3601,2641,6242,+
chr11,65505583,0.5122189638318669,654,464,1118,+
chr11,65505705,0.8974686232635735,1278,851,2129,+
chr11,65505918,15.285513094243974,5612,5083,10695,+
chr11,65505919,15.440815768369841,5511,4924,10435,+
chr11,65506000,0.45855410080133113,747,556,1303,+
chr11,65506077,0.6522642694891501,963,626,1589,+
chr11,65525922,0.48524582235674996,994,753,1747,+
chr11,65525946,3.4643196232576257,794,432,1226,+
chr11,65526163,2.2455386647201574,769,448,1217,+
chr11,65526982,1.891486617828211,661,465,1126,+
chr11,65527037,1.807127882599581,861,476,1337,+
chr11,65527042,0.5898366606170601,874,664,1538,+
chr11,65527043,1.8853250331666496,1578,1194,2772,+
chr11,65527045,1.5996496610482034,3799,2682,6481,+
chr11,65527067,1.4753544592521273,4405,3840,8245,+
chr11,65527068,1.4753544592521273,4405,3840,8245,+
chr11,65527069,1.4759385066415687,6623,5266,11889,+
chr11,65527072,1.6403606021706152,1729,1671,3400,+
chr11,65527080,1.6220517737296258,3075,2085,5160,+
chr11,65532707,2.812582641089586,526,520,1046,+
chr11,65532730,0.27371183779838393,672,505,1177,+
chr11,65535279,1.7016831871830536,805,449,1254,+
chr11,65535280,1.454243430987617,962,472,1434,+
chr11,65535282,2.3858622032288697,828,472,1300,+
chr11,65536062,1.1541143654114363,661,477,1138,+
chr11,65536064,1.5657452875142397,972,696,1668,+
chr11,65536120,0.45257452574525747,834,655,1489,+
chr11,65536121,1.002636783124588,818,573,1391,+
chr11,65536122,0.7182469563058993,1652,1228,2880,+
chr11,65616888,0.7546909083596618,796,571,1367,+
chr11,65891588,4.843090939181686,676,342,1018,+
chr11,65919499,0.8476843822843823,555,485,1040,+
chr11,65919510,2.084145591851071,682,875,1557,+
chr11,65919511,1.3521852760083843,1828,2180,4008,+
chr11,65919512,0.4794520547945205,748,748,1496,+
chr11,65919513,1.9800117913314692,748,1030,1778,+
chr11,65919516,1.4980075942735604,1930,2564,4494,+
chr11,65919517,1.5047268907563025,1049,1665,2714,+
chr11,65919520,1.5455840455840455,650,1079,1729,+
chr11,65919969,1.5360063872318777,771,606,1377,+
chr11,65921453,1.872011202647605,2445,2040,4485,+
chr11,65921454,1.851134572206564,2226,1902,4128,+
chr11,65921455,2.108659573881533,4028,3887,7915,+
chr11,65921456,2.1309199450434457,2700,2794,5494,+
chr11,65966096,9.10387867951687,577,475,1052,+
chr11,65977788,1.6066886252562644,616,399,1015,+
chr11,65977792,0.4539095055452212,1272,773,2045,+
chr11,65977793,0.376054082903398,812,510,1322,+
chr11,65977809,3.165217391304348,671,459,1130,+
chr11,65977813,1.9779699060603542,720,522,1242,+
chr11,65977880,1.788960113960114,609,457,1066,+
chr11,66002490,0.8409684481629154,3072,2374,5446,+
chr11,66002491,0.9967937323062744,1005,914,1919,+
chr11,66002492,0.8150396167218669,3579,2740,6319,+
chr11,66002496,0.5871544308026393,702,613,1315,+
chr11,66002502,0.5479488078541375,986,551,1537,+
chr11,66003330,2.338740458015267,773,392,1165,+
chr11,66003331,2.338740458015267,773,392,1165,+
chr11,66003629,1.7531206657420253,631,411,1042,+
chr11,66003645,2.4486373165618454,802,582,1384,+
chr11,66003662,1.0178657668928728,2369,1975,4344,+
chr11,66003790,1.6740761598882474,2301,1724,4025,+
chr11,66003791,1.7374840085287846,925,669,1594,+
chr11,66003857,1.4508226691042048,1407,1093,2500,+
chr11,66003858,0.9745480294126987,2933,1986,4919,+
chr11,66004051,1.7560224521483083,1395,1014,2409,+
chr11,66004052,1.9438632410754715,1238,986,2224,+
chr11,66004055,2.0586025399131884,914,673,1587,+
chr11,66052432,0.6484176700802954,646,379,1025,+
chr11,66052436,0.6371560008103854,1307,680,1987,+
chr11,66052437,0.612808126376014,1086,610,1696,+
chr11,66052445,1.6974338226794587,1365,843,2208,+
chr11,66052446,1.7823509209551178,2131,1365,3496,+
chr11,66052448,1.7923213685070394,1491,990,2481,+
chr11,66052451,1.8161094224924013,716,328,1044,+
chr11,66052454,1.8568360342626415,1646,1027,2673,+
chr11,66056910,1.5700433915230902,699,490,1189,+
chr11,66058322,2.034407173116981,736,532,1268,+
chr11,66058861,2.2653207343237067,651,438,1089,+
chr11,66058959,1.896945646945647,630,461,1091,+
chr11,66058984,1.8630560928433268,687,469,1156,+
chr11,66059892,2.2676150627615064,796,477,1273,+
chr11,66059893,2.2676150627615064,796,477,1273,+
chr11,66060586,3.8077919380400886,724,515,1239,+
chr11,66060639,1.9515267990604315,702,445,1147,+
chr11,66060651,3.3858816081038308,763,485,1248,+
chr11,66061964,0.472690666793307,1539,1032,2571,+
chr11,66061965,0.40963003691775984,744,438,1182,+
chr11,66061966,0.5263534922165588,795,594,1389,+
chr11,66063044,0.9499188969991889,936,547,1483,+
chr11,66063045,0.9499188969991889,936,547,1483,+
chr11,66063487,1.9393571861734382,614,484,1098,+
chr11,66063525,1.4761817905456758,990,730,1720,+
chr11,66063630,2.1593006313744536,740,425,1165,+
chr11,66063632,2.739379817171536,1053,796,1849,+
chr11,66063637,1.022430917267617,1826,1297,3123,+
chr11,66063652,1.4831141803046068,1205,960,2165,+
chr11,66068147,2.445026332504207,634,440,1074,+
chr11,66068243,0.9739934983745937,778,515,1293,+
chr11,66068244,1.5214004895779245,1171,792,1963,+
chr11,66068246,3.331437508886677,780,540,1320,+
chr11,66068736,1.3190797023643073,832,583,1415,+
chr11,66068802,1.4709725784701773,763,633,1396,+
chr11,66272162,3.5538461538461537,692,419,1111,+
chr11,66272170,1.8680407928756104,1688,1179,2867,+
chr11,66272171,1.8680407928756104,1688,1179,2867,+
chr11,66272197,0.5927019241028559,3029,1813,4842,+
chr11,66272198,0.5927019241028559,3029,1813,4842,+
chr11,66272204,1.7062560986066249,7430,5044,12474,+
chr11,66272205,1.7376183686533797,5727,4012,9739,+
chr11,66276107,0.3812152005357748,649,451,1100,+
chr11,66276134,0.8562016249730676,1963,1196,3159,+
chr11,66276135,1.054927514329003,3844,2234,6078,+
chr11,66276136,1.0325468776395068,1666,902,2568,+
chr11,66276137,0.8757341124908694,1523,924,2447,+
chr11,66276139,0.9074358610571944,2366,1288,3654,+
chr11,66276140,1.2190488384226377,5312,3207,8519,+
chr11,66276141,1.0248447204968945,1907,1218,3125,+
chr11,66276145,1.6955204699834772,1178,837,2015,+
chr11,66276266,15.286534413047802,1265,855,2120,+
chr11,66276267,6.483694180125629,1121,757,1878,+
chr11,66276268,18.295775667035457,975,628,1603,+
chr11,66276832,0.22374406581151296,1220,292,1512,+
chr11,66276833,0.2294158344611636,1054,244,1298,+
chr11,66276856,30.182185901283848,1633,633,2266,+
chr11,66276857,20.749229524641866,2489,1815,4304,+
chr11,66276858,20.749229524641866,2489,1815,4304,+
chr11,66276859,18.063277218483517,1276,1125,2401,+
chr11,66626717,17.05171389248383,819,777,1596,+
chr11,66626718,17.05171389248383,819,777,1596,+
chr11,66626722,6.05931873048816,1020,1518,2538,+
chr11,66626723,6.05931873048816,1020,1518,2538,+
chr11,66626740,0.2522553603365864,598,814,1412,+
chr11,66626741,0.2450322580645161,421,619,1040,+
chr11,66638705,0.7829498637545006,832,425,1257,+
chr11,66638706,0.7829498637545006,832,425,1257,+
chr11,66639883,2.5143287931099616,655,481,1136,+
chr11,66643943,0.3286873447005398,604,457,1061,+
chr11,66646043,2.366352201257861,687,423,1110,+
chr11,66646044,3.056036468667973,960,621,1581,+
chr11,66646148,2.073099415204678,708,647,1355,+
chr11,66646150,1.4932957691848667,1064,896,1960,+
chr11,66976486,2.8494134871734116,771,559,1330,+
chr11,66976487,2.963250568101178,636,522,1158,+
chr11,66976616,1.5546826569163639,890,581,1471,+
chr11,66976705,2.5700532195956,740,579,1319,+
chr11,66976810,0.6347103697704113,720,447,1167,+
chr11,66976817,1.385890610480755,582,434,1016,+
chr11,66976841,3.144827741817149,621,471,1092,+
chr11,67049659,36.4264148489368,710,421,1131,+
chr11,67282525,1.0933808059556562,562,500,1062,+
chr11,67282526,1.0933808059556562,562,500,1062,+
chr11,67483165,2.1471691200063843,1999,1657,3656,+
chr11,67483167,1.7518199678768571,1319,1140,2459,+
chr11,67483177,3.456485120718697,683,410,1093,+
chr11,67490957,2.871900826446281,694,362,1056,+
chr11,67490959,2.871900826446281,694,362,1056,+
chr11,67585229,1.9306101068692114,1373,1047,2420,+
chr11,67585230,1.8820826026486064,1003,718,1721,+
chr11,67586187,1.2063500167332537,1024,857,1881,+
chr11,67586401,2.145519077196096,557,482,1039,+
chr11,67586522,2.9547158873630175,700,546,1246,+
chr11,67606963,1.9866713607426345,753,543,1296,+
chr11,67608397,1.2406804491352745,897,715,1612,+
chr11,67608406,2.3235608512461203,1106,867,1973,+
chr11,67608407,0.4924769201436065,1393,950,2343,+
chr11,67608566,2.0651982378854625,585,453,1038,+
chr11,67608699,1.9649422862624055,920,698,1618,+
chr11,67609591,1.9417558576085905,859,627,1486,+
chr11,67610399,1.9299695519791211,611,483,1094,+
chr11,67610411,1.8311512692851435,960,560,1520,+
chr11,67610419,1.6148694951504672,3283,2231,5514,+
chr11,67610420,1.5478981090795436,1980,1214,3194,+
chr11,67610486,0.5349761526232114,672,475,1147,+
chr11,67611050,0.9591871552328776,1264,742,2006,+
chr11,67611052,0.7677315862888138,2212,1501,3713,+
chr11,67611115,1.7812605610003376,726,537,1263,+
chr11,67611463,2.537707023071143,1987,1330,3317,+
chr11,67611465,2.537707023071143,1987,1330,3317,+
chr11,67611905,2.6274078150798017,867,631,1498,+
chr11,67611906,2.6274078150798017,867,631,1498,+
chr11,67612131,5.201646090534981,631,485,1116,+
chr11,67612140,1.5920826161790018,824,580,1404,+
chr11,67612209,1.325928401232598,1020,750,1770,+
chr11,68032160,2.7824786274285818,796,460,1256,+
chr11,68032928,2.1546835839598995,670,531,1201,+
chr11,68032952,1.7358870967741935,860,526,1386,+
chr11,68032954,1.7091346153846152,710,623,1333,+
chr11,68032955,1.6847780126849896,612,429,1041,+
chr11,68033151,0.6087065173930428,640,487,1127,+
chr11,68036469,0.5830191684808579,609,508,1117,+
chr11,68036579,1.9097222222222219,549,467,1016,+
chr11,68551121,2.0744007670182167,1201,744,1945,+
chr11,68551122,2.0744007670182167,1201,744,1945,+
chr11,68551123,0.6657922860196249,978,563,1541,+
chr11,68551126,1.8017057569296373,714,468,1182,+
chr11,68551133,2.968460111317255,799,615,1414,+
chr11,68551137,0.5993000874890638,2054,1142,3196,+
chr11,68551138,1.3978058072349948,3328,2544,5872,+
chr11,68551139,1.2703446512307952,3902,2824,6726,+
chr11,68591575,4.16656914720179,571,445,1016,+
chr11,68591661,0.5495067452544914,1500,1313,2813,+
chr11,68591663,3.5726795096322244,747,570,1317,+
chr11,68690947,0.9447384425724914,1159,756,1915,+
chr11,69651551,8.88090527683832,1301,1009,2310,+
chr11,69651552,8.88090527683832,1301,1009,2310,+
chr11,70206132,2.9379295979416336,763,359,1122,+
chr11,70206140,2.21673025446874,1088,585,1673,+
chr11,70206142,2.0369365116827947,841,445,1286,+
chr11,70206143,2.4469548133595285,582,508,1090,+
chr11,70206145,2.4469548133595285,582,508,1090,+
chr11,70206161,1.1776356607645682,1049,910,1959,+
chr11,70206163,1.76527786262457,1841,1416,3257,+
chr11,70206171,2.398927701056052,1261,1230,2491,+
chr11,70206172,2.398927701056052,1261,1230,2491,+
chr11,70206175,1.5299495586380831,1476,1585,3061,+
chr11,70206176,1.5299495586380831,1476,1585,3061,+
chr11,70206181,1.7250605745932848,816,962,1778,+
chr11,70206182,2.12216404886562,797,572,1369,+
chr11,70206239,1.886422479439537,1100,937,2037,+
chr11,70206240,1.7670343319529513,1791,1433,3224,+
chr11,70207054,2.2006256216891322,258,981,1239,+
chr11,70207055,2.0599691248070298,208,801,1009,+
chr11,70207059,0.1976876173752121,437,653,1090,+
chr11,70207060,0.1976876173752121,437,653,1090,+
chr11,70207219,0.7731693363844393,794,459,1253,+
chr11,70207220,0.7731693363844393,794,459,1253,+
chr11,70375031,0.3830146963194173,588,465,1053,+
chr11,70375033,1.3713722200122482,1454,1119,2573,+
chr11,70375034,2.757362155388471,606,455,1061,+
chr11,70398540,0.523356514532574,634,404,1038,+
chr11,70409859,0.8018778888692556,1053,727,1780,+
chr11,70409860,1.0587989119062566,659,530,1189,+
chr11,70414619,1.4418238993710693,654,423,1077,+
chr11,70414632,1.6063432835820897,776,535,1311,+
chr11,70415676,1.9018023840298721,1080,843,1923,+
chr11,70415689,2.152525951557094,647,424,1071,+
chr11,70415695,0.5653116531165311,744,449,1193,+
chr11,70417014,1.2841501056442193,2942,2147,5089,+
chr11,70417015,2.653648915187377,867,506,1373,+
chr11,70417024,1.3734651550431984,1740,1172,2912,+
chr11,70417035,1.3876819868683985,1408,903,2311,+
chr11,70417036,0.9701831023217949,5459,3969,9428,+
chr11,70417058,1.730833943469073,12254,8819,21073,+
chr11,70417060,1.694815699743647,7167,4601,11768,+
chr11,70417061,1.6911548695221548,4854,3155,8009,+
chr11,70429060,2.5743243069979744,739,499,1238,+
chr11,70435322,0.8588272785213512,538,522,1060,+
chr11,70435324,0.8588272785213512,538,522,1060,+
chr11,70435644,1.369065958394182,664,540,1204,+
chr11,70436279,1.3928435196120916,639,511,1150,+
chr11,71482954,1.671418572362307,731,563,1294,+
chr11,71482955,2.056421677802524,553,448,1001,+
chr11,71482961,2.04959324155194,793,798,1591,+
chr11,71482962,1.9576387071752843,1874,1565,3439,+
chr11,71482964,1.8784722222222219,1081,767,1848,+
chr11,71482971,2.341894736842105,617,474,1091,+
chr11,72192139,0.6227732197819101,1350,858,2208,+
chr11,72192166,1.473519934913079,3187,2305,5492,+
chr11,72192167,1.4377986984929227,2240,1748,3988,+
chr11,72195285,1.5109890109890112,1143,727,1870,+
chr11,72195303,1.7728440744166925,615,422,1037,+
chr11,72195318,1.9135531135531139,652,454,1106,+
chr11,72195354,1.9862376237623762,742,504,1246,+
chr11,72195629,1.0008704356530442,1585,1331,2916,+
chr11,72195631,1.4325823639538642,2616,2067,4683,+
chr11,72195640,0.5865650969529086,846,721,1567,+
chr11,72195687,1.9057894736842105,851,607,1458,+
chr11,72195710,1.8618499404525608,937,686,1623,+
chr11,72195711,1.8618499404525608,937,686,1623,+
chr11,72195898,1.5568685376661744,1053,676,1729,+
chr11,72196003,0.4701923076923077,1140,1039,2179,+
chr11,72196085,1.1768083929460393,951,676,1627,+
chr11,72196181,0.640129434438126,1120,688,1808,+
chr11,72196182,1.7798521904582922,1110,895,2005,+
chr11,72196202,2.05000744942452,1897,1353,3250,+
chr11,72196238,1.7663451232583065,1338,932,2270,+
chr11,72230002,2.0368709516691585,559,668,1227,+
chr11,72230003,1.7477987522547618,1881,1946,3827,+
chr11,72230004,0.9711028986152545,726,606,1332,+
chr11,72230005,2.201767753733617,601,771,1372,+
chr11,72230374,0.9100934746366779,825,507,1332,+
chr11,72238863,3.233471313235856,759,305,1064,+
chr11,72238899,21.474366521345896,1844,1383,3227,+
chr11,72238900,21.474366521345896,1844,1383,3227,+
chr11,72238901,18.950312825215992,1596,1152,2748,+
chr11,73844927,1.4964030023948083,753,543,1296,+
chr11,73859932,2.751524794817773,732,566,1298,+
chr11,73900381,0.8578332588115856,745,453,1198,+
chr11,73916552,0.4987384356602187,592,492,1084,+
chr11,73916554,0.5920957105105381,1008,710,1718,+
chr11,73916555,0.7237242011537414,748,468,1216,+
chr11,73916621,1.0041927932342398,2584,1733,4317,+
chr11,73916623,1.1116438356164384,2163,1459,3622,+
chr11,73916624,1.0568104156430231,1245,755,2000,+
chr11,73916628,0.5031716251228446,1023,545,1568,+
chr11,73916629,1.3755220307164917,1486,1006,2492,+
chr11,73916633,1.6346199980807985,1724,1225,2949,+
chr11,74225207,1.1179698216735254,651,431,1082,+
chr11,74225208,1.1179698216735254,651,431,1082,+
chr11,74254101,2.160277589398983,833,580,1413,+
chr11,74641649,0.49502291930713993,574,461,1035,+
chr11,74977129,4.38774241183104,664,530,1194,+
chr11,74977138,0.4447848785550975,597,477,1074,+
chr11,75009101,3.458434110318116,1001,734,1735,+
chr11,75009113,1.2933414915893826,570,435,1005,+
chr11,75399513,0.8456534594914252,999,474,1473,+
chr11,75399514,0.856117933571785,2531,1190,3721,+
chr11,75399515,1.2855533889187736,2299,1407,3706,+
chr11,75399516,0.9814738099583367,5952,3203,9155,+
chr11,75399517,1.1718926877550107,18074,11617,29691,+
chr11,75399518,1.15630205782257,14606,9436,24042,+
chr11,75399519,1.186385032456945,14713,9432,24145,+
chr11,75399522,1.221040081494676,9033,5297,14330,+
chr11,75399524,1.2296053551725743,14648,8701,23349,+
chr11,75399526,1.2400330709543679,23021,15133,38154,+
chr11,75399528,1.2281623448195846,9113,6083,15196,+
chr11,75399531,1.2797931232590751,5154,3512,8666,+
chr11,75399533,1.3002123104450507,4019,3386,7405,+
chr11,75399544,1.1928932904779779,22835,16087,38922,+
chr11,75399545,1.196191468073567,24048,17022,41070,+
chr11,75399556,1.2041910915749912,24464,16443,40907,+
chr11,75399557,1.0840639868540114,64760,44228,108988,+
chr11,75399558,0.8953204049452073,34493,25312,59805,+
chr11,75399559,1.1984736695778502,35931,26293,62224,+
chr11,75400691,1.0037563600560269,2602,2205,4807,+
chr11,75400692,0.8792660420842568,1843,1262,3105,+
chr11,75400694,1.1877387154359442,22169,19116,41285,+
chr11,75400712,1.1212335506610942,56513,42745,99258,+
chr11,75402351,1.2215313723014771,12900,8543,21443,+
chr11,75402352,1.0167587895911883,34497,27053,61550,+
chr11,75402360,1.320055678492935,13745,10536,24281,+
chr11,75402361,0.841078010014163,51873,38465,90338,+
chr11,75404039,1.3475380331018285,17441,11058,28499,+
chr11,75404042,1.5077730771131241,27513,18992,46505,+
chr11,75404051,1.0378509915986316,20574,15436,36010,+
chr11,75404109,1.0662361259985598,69282,52186,121468,+
chr11,75404110,1.1233042697753544,73752,53391,127143,+
chr11,75404119,1.232646392076533,34469,24083,58552,+
chr11,75404721,1.349929687880624,44637,27004,71641,+
chr11,75404722,1.255762838170587,53312,34566,87878,+
chr11,75404733,1.2376530993203982,84264,62252,146516,+
chr11,75404734,1.3094467101338743,72429,53298,125727,+
chr11,75404803,1.1538484427339484,31087,23481,54568,+
chr11,75404804,1.2669591907565294,44502,32090,76592,+
chr11,75404809,1.2700913151519737,11419,8654,20073,+
chr11,75405610,0.8898767301088277,950,718,1668,+
chr11,75405611,0.8898767301088277,950,718,1668,+
chr11,75405612,1.1793327678823864,10029,7073,17102,+
chr11,75405614,1.0983996819014796,31049,22586,53635,+
chr11,75405629,0.8543568936469074,16465,12451,28916,+
chr11,75562180,0.13155479987186453,955,319,1274,+
chr11,75562181,0.23703703703703705,815,254,1069,+
chr11,75562182,0.15185983755309063,1719,503,2222,+
chr11,75562183,0.19234429058922164,1650,437,2087,+
chr11,75562209,30.3608265696427,1071,120,1191,+
chr11,75562211,32.515395754950575,1833,445,2278,+
chr11,75562212,14.612605464303728,3745,1919,5664,+
chr11,75562213,13.97547060429155,3494,1894,5388,+
chr11,75562214,10.373017449378006,2407,1648,4055,+
chr11,75562226,0.5135962711165964,781,816,1597,+
chr11,75562250,2.461544095132303,2747,3004,5751,+
chr11,75562251,1.4347826086956519,619,619,1238,+
chr11,75562252,2.280587921479905,1744,1909,3653,+
chr11,75562258,0.4671581010513887,1583,1493,3076,+
chr11,75566331,1.9718820993391153,825,519,1344,+
chr11,75566412,0.5443023561422264,789,700,1489,+
chr11,75566509,1.5825588511230613,1022,678,1700,+
chr11,75566725,0.3859375,569,479,1048,+
chr11,75566746,0.4437012263099221,596,467,1063,+
chr11,75566747,2.641210374639769,704,346,1050,+
chr11,75566796,2.3821772319946897,989,523,1512,+
chr11,75566826,1.3467781760254878,1320,774,2094,+
chr11,75566945,2.075308386026744,1482,876,2358,+
chr11,75566947,2.2372257307605903,2268,1357,3625,+
chr11,75566948,0.5887149686006187,570,453,1023,+
chr11,75566949,2.078169542385597,1538,929,2467,+
chr11,75568742,0.5494715626410168,1287,929,2216,+
chr11,75568756,1.7821067821067822,873,505,1378,+
chr11,75568757,2.1205359884285016,1354,997,2351,+
chr11,75568795,1.0630683238525525,1798,1319,3117,+
chr11,75568946,0.38638373121131736,873,753,1626,+
chr11,75569072,1.9272038712392172,915,678,1593,+
chr11,75569075,0.5943536404160474,799,672,1471,+
chr11,75569076,1.6558289770070975,973,712,1685,+
chr11,75569102,1.4823953054147772,1234,814,2048,+
chr11,75571781,2.3677604051970933,671,477,1148,+
chr11,75571877,1.852721746338768,744,657,1401,+
chr11,75571908,1.651176062874702,1960,1350,3310,+
chr11,75571915,2.0276160620988213,798,637,1435,+
chr11,75571998,0.3132467532467533,669,549,1218,+
chr11,75572026,0.4669748024452065,1295,1058,2353,+
chr11,75572027,1.4143221172895974,4694,3335,8029,+
chr11,75572028,1.807047316695667,3399,2277,5676,+
chr11,75572076,0.5764925373134329,720,535,1255,+
chr11,75572161,6.009142367142893,1444,524,1968,+
chr11,75572165,4.70807453416149,757,321,1078,+
chr11,75572166,2.6906744217938603,2101,808,2909,+
chr11,75572167,3.236136503843598,2858,1129,3987,+
chr11,75572178,2.4833596783084046,1310,721,2031,+
chr11,75572180,2.7301939058171745,879,474,1353,+
chr11,75572182,1.8163979663497716,1138,610,1748,+
chr11,75572197,13.369419967967952,3152,2267,5419,+
chr11,75572198,9.900382495761066,3412,2669,6081,+
chr11,75572200,4.8320574042652735,2809,2080,4889,+
chr11,75572202,2.1480730223123734,1411,1070,2481,+
chr11,75572203,2.7925015663409125,2887,2765,5652,+
chr11,75572206,0.5637551909592212,636,793,1429,+
chr11,75572217,5.659251352258929,5174,5703,10877,+
chr11,75572218,6.096395874583062,4520,4739,9259,+
chr11,75572249,0.5450900152815256,3152,3537,6689,+
chr11,75572250,0.5778348194579658,5011,5355,10366,+
chr11,75572278,0.4942097745128048,774,890,1664,+
chr11,75572350,1.0207234825260576,2080,1630,3710,+
chr11,75572351,1.0207234825260576,2080,1630,3710,+
chr11,75572460,1.4810629675810474,1266,801,2067,+
chr11,75572549,1.6427893918079643,2860,1726,4586,+
chr11,75572551,1.627076220482814,2147,1182,3329,+
chr11,75572578,1.839714413208389,936,746,1682,+
chr11,75572620,1.4910407239819006,1372,883,2255,+
chr11,75572687,1.4261133603238865,1408,968,2376,+
chr11,75572698,3.5407209612817088,815,748,1563,+
chr11,75572705,3.441918327811516,6728,5705,12433,+
chr11,75572707,3.5316756846781194,7987,6734,14721,+
chr11,76451907,0.8914972402710822,637,366,1003,+
chr11,76451909,0.8914972402710822,637,366,1003,+
chr11,76451913,0.8397498074585611,1422,860,2282,+
chr11,76451915,1.0447855874143621,914,562,1476,+
chr11,76451920,1.5588828811260511,1273,817,2090,+
chr11,76451927,2.2362262760272706,655,401,1056,+
chr11,76551266,7.191945136168314,355,745,1100,+
chr11,76796953,1.608713866778383,639,433,1072,+
chr11,76797020,34.22110049706921,1539,1147,2686,+
chr11,76797021,34.22110049706921,1539,1147,2686,+
chr11,76797037,6.153605157284744,787,1017,1804,+
chr11,76797060,0.3418940609951846,567,711,1278,+
chr11,76797062,0.3418940609951846,567,711,1278,+
chr11,76797771,3.061929510320962,601,540,1141,+
chr11,82689560,0.42828685258964144,859,501,1360,+
chr11,82689561,0.8083236259663242,1346,797,2143,+
chr11,82689562,1.9263249854397204,944,403,1347,+
chr11,82689563,1.2343710471666758,1790,1189,2979,+
chr11,82689564,1.9263249854397204,944,403,1347,+
chr11,82689565,2.183366782515052,1061,658,1719,+
chr11,82689572,1.8439839301713925,1275,606,1881,+
chr11,82689573,0.9835586408476433,1345,832,2177,+
chr11,82689574,1.1553697264626968,3358,1787,5145,+
chr11,82689576,1.7474435286935286,2233,1091,3324,+
chr11,82689578,1.7291142137788966,1562,770,2332,+
chr11,82689582,1.415424327262358,2103,1352,3455,+
chr11,82689585,1.5917530745116952,2575,1855,4430,+
chr11,82689586,1.5917530745116952,2575,1855,4430,+
chr11,82689615,1.3490353892252012,4099,2683,6782,+
chr11,82689691,1.5567825494205865,600,488,1088,+
chr11,82689695,0.4806201550387597,1022,515,1537,+
chr11,82689723,2.1462406015037594,1556,531,2087,+
chr11,82689724,2.1462406015037594,1556,531,2087,+
chr11,82689727,2.2298201278430207,2499,960,3459,+
chr11,82689728,2.126882400064676,3364,1320,4684,+
chr11,82689729,2.126882400064676,3364,1320,4684,+
chr11,82689730,2.0424206119246517,3446,1408,4854,+
chr11,82689732,1.9312868632707774,1756,745,2501,+
chr11,82689735,3.0071206052514463,931,427,1358,+
chr11,82689736,1.4948275862068965,730,579,1309,+
chr11,82689746,1.4508888108147533,5307,2851,8158,+
chr11,82689747,1.5533184591901146,4892,2755,7647,+
chr11,82689748,1.4543591917479155,4024,2021,6045,+
chr11,82689765,1.8270133721409154,1937,1382,3319,+
chr11,83165774,2.3590733590733586,610,517,1127,+
chr11,85628601,0.3772690563717402,1231,794,2025,+
chr11,85628604,0.6836204539239814,624,476,1100,+
chr11,85631733,1.2448492643159719,1721,1240,2961,+
chr11,85634112,2.861439842209073,828,506,1334,+
chr11,85635757,1.6830396475770923,1131,907,2038,+
chr11,85636072,0.5622837370242215,649,373,1022,+
chr11,85636121,1.7825688073394497,1942,1089,3031,+
chr11,85636142,2.2572258755161343,1639,1005,2644,+
chr11,85636145,2.125789508676285,1751,1156,2907,+
chr11,85636147,1.5445187649961518,2872,1591,4463,+
chr11,85648005,1.2356222492052646,733,512,1245,+
chr11,85648008,2.222601464955816,935,794,1729,+
chr11,85654068,0.9634167848767468,1687,1296,2983,+
chr11,85656456,3.41397533763946,645,392,1037,+
chr11,86264184,4.462251813101892,852,646,1498,+
chr11,86264185,3.8898658655681717,1324,921,2245,+
chr11,86306298,0.806125265905759,1087,785,1872,+
chr11,86337467,2.4043392504930967,582,428,1010,+
chr11,86800542,1.0888298958546048,687,663,1350,+
chr11,86800543,1.0888298958546048,687,663,1350,+
chr11,86800563,0.3147372766409153,592,546,1138,+
chr11,86800567,0.3259911894273128,813,453,1266,+
chr11,86800594,1.703545086842731,894,466,1360,+
chr11,86800603,1.6030736618971908,1209,628,1837,+
chr11,86807630,1.673378263626319,1909,1281,3190,+
chr11,86807631,1.374940319265979,1018,718,1736,+
chr11,86807633,1.7980909794479318,983,801,1784,+
chr11,86807643,1.5348421608136629,1752,1157,2909,+
chr11,86807650,1.2987417099838314,5289,3799,9088,+
chr11,86807651,1.2597892518440466,4231,2919,7150,+
chr11,86807671,1.5950032987256502,2438,1857,4295,+
chr11,86807726,1.271212909942738,2441,1920,4361,+
chr11,86807953,1.0743057640697453,10020,6702,16722,+
chr11,86807983,1.5748646593223963,12038,9339,21377,+
chr11,86808005,1.4644629974001317,5303,3316,8619,+
chr11,86808399,1.2894445096581495,4534,3650,8184,+
chr11,86808649,1.1939747294270522,4987,3574,8561,+
chr11,86808659,1.2727332555218114,3735,3056,6791,+
chr11,86808684,1.4597126257127766,4962,3198,8160,+
chr11,86808925,1.1300869996317982,9619,6888,16507,+
chr11,86808948,1.251120562848658,6604,5259,11863,+
chr11,86809436,1.892494426554372,1145,733,1878,+
chr11,86809486,2.1796174536760318,560,477,1037,+
chr11,86809546,2.278463280022023,1150,872,2022,+
chr11,86809756,1.9942348008385742,760,476,1236,+
chr11,86809830,1.9950048732943468,654,431,1085,+
chr11,86809853,2.2764668367346936,648,391,1039,+
chr11,86809954,0.43197057552455376,1284,1026,2310,+
chr11,86810072,1.7697216710462806,749,642,1391,+
chr11,86810517,2.028050883663354,1125,778,1903,+
chr11,86810773,1.4416075214305466,1563,1141,2704,+
chr11,86810805,1.4908951210142143,923,684,1607,+
chr11,86810992,1.8313953488372092,629,429,1058,+
chr11,86811001,2.3732712765957444,660,469,1129,+
chr11,90282873,1.0050445891062407,827,584,1411,+
chr11,90282874,1.268007636796041,619,564,1183,+
chr11,90282944,1.5749751737835154,792,423,1215,+
chr11,90282954,1.8592411260709922,867,515,1382,+
chr11,90282955,0.5335101596172973,511,490,1001,+
chr11,90282957,1.7253756260434057,974,598,1572,+
chr11,90282970,2.020098778982028,1201,787,1988,+
chr11,90282973,1.857619699042408,737,730,1467,+
chr11,90282981,1.0539733403070255,1540,1185,2725,+
chr11,90282987,1.836950146627566,782,619,1401,+
chr11,90282991,2.563038793103448,870,753,1623,+
chr11,90282994,2.2823226230946374,924,828,1752,+
chr11,93721761,13.052696985417331,623,398,1021,+
chr11,93721780,2.3784844837833248,590,450,1040,+
chr11,93721798,3.368317683241896,1230,1039,2269,+
chr11,93721806,1.7609702182572542,633,515,1148,+
chr11,93721828,0.7338429338429339,1982,1484,3466,+
chr11,93762085,1.4625517021510999,608,399,1007,+
chr11,93811972,0.8847671534662259,659,401,1060,+
chr11,94830139,1.3579055361732526,1076,774,1850,+
chr11,94830140,0.7653217686569864,1048,721,1769,+
chr11,94870925,2.2432323070415636,1061,892,1953,+
chr11,94870926,1.650285602855839,1062,889,1951,+
chr11,95068160,2.466656698564593,610,417,1027,+
chr11,95068162,1.8408741619294742,858,592,1450,+
chr11,95068844,1.9856245391174687,583,444,1027,+
chr11,95068876,1.9540278444281864,557,462,1019,+
chr11,95799246,1.1129032258064515,782,521,1303,+
chr11,95799248,1.1129032258064515,782,521,1303,+
chr11,95799322,0.5934358367829686,668,444,1112,+
chr11,95799347,2.0636627906976748,686,429,1115,+
chr11,95812933,2.59245283018868,686,476,1162,+
chr11,95812959,1.8442591890867757,627,376,1003,+
chr11,95812964,0.4623741388447271,697,407,1104,+
chr11,95818827,2.2379182156133828,687,537,1224,+
chr11,95818829,2.2379182156133828,687,537,1224,+
chr11,95822537,1.8107983387171207,653,393,1046,+
chr11,95827790,2.2309420765973185,785,611,1396,+
chr11,95827929,2.267961165048544,875,617,1492,+
chr11,95829186,1.8905908096280089,620,456,1076,+
chr11,95831029,2.006578947368421,609,417,1026,+
chr11,95831044,1.8168781025923881,731,517,1248,+
chr11,95831438,1.7160286046677353,1217,868,2085,+
chr11,95831655,1.579197312793189,801,556,1357,+
chr11,102227500,2.5352838635592225,749,534,1283,+
chr11,102229969,3.4284263959390864,613,393,1006,+
chr11,102230472,1.7989536621823616,663,445,1108,+
chr11,102230714,5.1876027466238614,439,649,1088,+
chr11,102230747,0.15975259062396222,455,619,1074,+
chr11,102232053,3.171530369867662,602,420,1022,+
chr11,102232054,2.590738077553961,1161,817,1978,+
chr11,102232303,8.941379562148484,1066,1066,2132,+
chr11,102232304,11.379296862277544,2456,3272,5728,+
chr11,102232305,9.951263184426589,3042,4447,7489,+
chr11,102232306,9.939837574813163,2691,4158,6849,+
chr11,102232307,11.659898572714406,1736,2870,4606,+
chr11,102233105,1.3738007170769653,1543,873,2416,+
chr11,102233107,0.47994208329784505,804,397,1201,+
chr11,102233183,2.134567901234568,1000,659,1659,+
chr11,102233197,1.3753327791437098,2016,1393,3409,+
chr11,102233234,1.9163364156759135,1087,756,1843,+
chr11,102233241,1.8050202839756593,1694,1159,2853,+
chr11,102233244,1.5187572843822843,1812,1286,3098,+
chr11,102233246,1.8211781805745553,1468,1087,2555,+
chr11,106091456,3.9877045340074186,708,471,1179,+
chr11,107176945,2.7375406962183826,642,362,1004,+
chr11,107176947,3.1294656162802736,900,545,1445,+
chr11,107176958,4.272808256382401,619,433,1052,+
chr11,107177021,1.4522124389268098,1137,880,2017,+
chr11,108121568,0.7156662871667241,794,210,1004,+
chr11,108121585,2.720550529668909,1240,596,1836,+
chr11,108131907,2.0618577982548625,1105,765,1870,+
chr11,108131909,2.940793278050962,1108,772,1880,+
chr11,108133829,1.2604425011265585,804,664,1468,+
chr11,108134229,1.8786071565986917,650,451,1101,+
chr11,108134291,0.5696058327637274,624,398,1022,+
chr11,108134302,2.185690653432589,603,402,1005,+
chr11,108135171,0.5772565017848036,565,476,1041,+
chr11,108135178,0.47066521264994543,663,523,1186,+
chr11,108135193,0.2625052924454122,619,500,1119,+
chr11,108135195,0.5607675906183369,788,535,1323,+
chr11,108138947,0.406208724818101,1084,797,1881,+
chr11,108140096,2.512,1255,749,2004,+
chr11,108140098,2.512,1255,749,2004,+
chr11,108141650,1.7914653784219,889,620,1509,+
chr11,108146310,0.5533745504125626,1069,720,1789,+
chr11,110462542,3.1959892231867233,685,473,1158,+
chr11,112086898,0.5424423919462567,778,464,1242,+
chr11,112094937,3.5324349788983334,729,425,1154,+
chr11,112181070,4.919616538196516,763,467,1230,+
chr11,112230217,1.72264631043257,676,392,1068,+
chr11,112230645,1.8574879227053138,768,413,1181,+
chr11,112230649,0.5222595078299777,666,446,1112,+
chr11,112230650,0.4619154584439453,1130,663,1793,+
chr11,112230651,1.5518962075848302,932,500,1432,+
chr11,112230660,1.5336750729626583,1050,580,1630,+
chr11,112230664,1.6395826205952788,1064,473,1537,+
chr11,112230666,0.547382459788359,3089,1531,4620,+
chr11,112233167,0.653672694316171,1730,798,2528,+
chr11,112233168,1.471530784030784,1578,755,2333,+
chr11,112233171,1.6394900803410395,1738,855,2593,+
chr11,112233175,1.661383181863864,1896,980,2876,+
chr11,112233182,1.3941961842208148,2128,1175,3303,+
chr11,112233566,2.401985743380856,628,490,1118,+
chr11,113790528,0.6434928904808422,667,497,1164,+
chr11,114296417,1.0791689955961015,1376,1051,2427,+
chr11,114296424,1.6303066037735852,710,635,1345,+
chr11,114296559,1.9758172861621142,1102,846,1948,+
chr11,114296591,1.0338199536956572,3206,2341,5547,+
chr11,114296600,0.7395111624326406,1739,1298,3037,+
chr11,114296662,0.7253694581280788,2374,1623,3997,+
chr11,114297977,1.7886043058648848,1256,897,2153,+
chr11,114298001,1.747269116186693,1376,1025,2401,+
chr11,114298101,0.6613863675781927,879,705,1584,+
chr11,114312067,2.672643778701071,678,537,1215,+
chr11,114312140,1.827956989247312,594,433,1027,+
chr11,114312165,2.238209432454037,599,416,1015,+
chr11,114312292,2.010944395410415,711,514,1225,+
chr11,114312310,2.7092161016949152,824,589,1413,+
chr11,114312355,1.8647690655209452,642,489,1131,+
chr11,114312357,0.5213337757133378,826,684,1510,+
chr11,114312358,0.4430894308943089,544,491,1035,+
chr11,114312378,0.6697871339527226,1016,772,1788,+
chr11,114312397,0.5456296962301715,1061,676,1737,+
chr11,114401712,2.8114877487649705,713,395,1108,+
chr11,114401724,3.1338161559888578,1147,717,1864,+
chr11,114401725,3.1338161559888578,1147,717,1864,+
chr11,114401729,1.7466396487673084,1360,986,2346,+
chr11,114401730,1.7466396487673084,1360,986,2346,+
chr11,114401734,1.7363950927964769,735,577,1312,+
chr11,114401752,2.3497688851076814,1347,754,2101,+
chr11,114401765,0.6202215541931971,1114,1017,2131,+
chr11,114401767,1.7503522907405378,1712,1053,2765,+
chr11,114401773,1.9565888014424944,1969,1293,3262,+
chr11,114440655,2.083608699908807,1407,937,2344,+
chr11,114440657,1.0134615384615384,898,579,1477,+
chr11,114440670,2.653968253968254,835,569,1404,+
chr11,114440683,1.6739164696611502,816,422,1238,+
chr11,114440692,2.3811023622047243,895,507,1402,+
chr11,114440717,2.090675791274594,1247,667,1914,+
chr11,114440723,0.6263374845220315,3541,2104,5645,+
chr11,114443866,0.9453039499528887,6512,4000,10512,+
chr11,114443868,1.543756754355036,8007,4202,12209,+
chr11,114443869,1.653893790058911,12481,7289,19770,+
chr11,114443870,1.653893790058911,12481,7289,19770,+
chr11,114443905,0.9693535610301074,2407,2484,4891,+
chr11,114446053,0.5884548144163528,760,675,1435,+
chr11,114449874,1.6663349917081263,784,602,1386,+
chr11,114449951,0.4857842214272265,644,564,1208,+
chr11,114449953,2.13470471934675,3258,2415,5673,+
chr11,114449954,2.13470471934675,3258,2415,5673,+
chr11,114449955,2.13470471934675,3258,2415,5673,+
chr11,114449970,0.3126876876876877,832,665,1497,+
chr11,114450015,0.6913317137809187,1526,1131,2657,+
chr11,114450030,1.5824404761904762,1226,959,2185,+
chr11,114450034,1.980072231025081,1429,1228,2657,+
chr11,114450038,2.558383182939606,1513,1408,2921,+
chr11,114450043,1.4214330082921236,5776,4493,10269,+
chr11,114450144,2.304481082027689,1217,860,2077,+
chr11,114450157,3.0370902129696105,667,596,1263,+
chr11,118384663,2.131765749778173,619,391,1010,+
chr11,118384664,2.131765749778173,619,391,1010,+
chr11,118401671,1.5285981308411214,695,534,1229,+
chr11,118401673,2.004264705882353,1297,799,2096,+
chr11,118406944,2.3207361963190185,1157,814,1971,+
chr11,118406947,1.418685965197593,1911,1117,3028,+
chr11,118406968,1.0002807048731823,7320,5723,13043,+
chr11,118406969,0.6318595303575206,4191,3259,7450,+
chr11,118406970,1.492690769058212,4790,3820,8610,+
chr11,118406971,1.4417314645138923,3279,2647,5926,+
chr11,118409000,5.214357429718875,798,497,1295,+
chr11,118409009,1.6198433420365532,1409,1148,2557,+
chr11,118409044,1.5789227713517933,1164,950,2114,+
chr11,118583186,2.653199494932311,764,515,1279,+
chr11,118583201,2.182661246735314,628,474,1102,+
chr11,118583206,2.3593350383631715,614,390,1004,+
chr11,118583251,2.5322245322245323,608,406,1014,+
chr11,118584558,1.9628134418779493,1013,638,1651,+
chr11,118584605,2.4341875364006995,642,403,1045,+
chr11,118584608,2.449365449365449,1350,890,2240,+
chr11,118584609,2.449365449365449,1350,890,2240,+
chr11,118584612,1.6160696624076014,2298,1668,3966,+
chr11,118584613,1.6089767892497582,1558,1157,2715,+
chr11,118590486,1.6112805045751795,932,625,1557,+
chr11,118592839,0.44437491308580174,580,422,1002,+
chr11,118593614,2.2209749031854806,675,526,1201,+
chr11,118597770,0.4332153202446089,672,477,1149,+
chr11,118597771,0.4332153202446089,672,477,1149,+
chr11,118602064,1.8771619594920759,604,422,1026,+
chr11,118602546,0.8743071696763811,814,657,1471,+
chr11,118602547,1.147958578715879,1003,809,1812,+
chr11,119090046,2.1400568114961103,701,474,1175,+
chr11,120229677,1.9219780219780225,900,454,1354,+
chr11,120229678,1.9219780219780225,900,454,1354,+
chr11,120442114,1.724144860336839,888,503,1391,+
chr11,120442117,0.15779588348397686,670,416,1086,+
chr11,120442146,3.1408573928258967,717,380,1097,+
chr11,123594811,4.730056143415025,1019,792,1811,+
chr11,124118236,1.566628564266786,601,466,1067,+
chr11,124122970,1.9833695175438595,777,663,1440,+
chr11,124122971,1.9833695175438595,777,663,1440,+
chr11,124124432,1.1793409817368463,776,563,1339,+
chr11,125572490,1.5732947174738838,728,503,1231,+
chr11,125575263,1.6600694444444444,682,575,1257,+
chr11,125575264,1.4605263157894737,1664,1034,2698,+
chr11,125575265,1.4605263157894737,1664,1034,2698,+
chr11,125575266,1.4605263157894737,1664,1034,2698,+
chr11,125575281,1.8795287187039769,708,484,1192,+
chr11,125575345,1.6897186689305868,3436,2172,5608,+
chr11,125575346,1.927890378723971,2778,1783,4561,+
chr11,125583563,3.158079972743523,635,456,1091,+
chr11,125584475,25.75641025641026,573,467,1040,+
chr11,125584476,30.222483974721644,1489,1128,2617,+
chr11,125584481,2.617578624330992,597,481,1078,+
chr11,125595962,1.2492406051413003,580,470,1050,+
chr11,125606394,1.3444511650964717,558,461,1019,+
chr11,125609551,0.3997848601591034,760,868,1628,+
chr11,125609552,0.3997848601591034,760,868,1628,+
chr11,125609553,1.1330297036257024,971,1050,2021,+
chr11,125614093,2.382598485301696,880,595,1475,+
chr11,125614122,0.3777403035413153,943,592,1535,+
chr11,125614124,0.3777403035413153,943,592,1535,+
chr11,125614172,0.5446009389671361,1217,851,2068,+
chr11,125614410,2.0853546910755147,700,436,1136,+
chr11,125614411,0.5599347014925373,1028,602,1630,+
chr11,125614413,1.623818850858974,1558,974,2532,+
chr11,126068218,1.0887497400586892,991,765,1756,+
chr11,126068220,1.1766103115830655,1603,1262,2865,+
chr11,126068222,1.2008764808467136,1794,1445,3239,+
chr11,126068224,1.582550726624623,1264,1041,2305,+
chr11,126068228,1.1699772825988457,1326,851,2177,+
chr11,126068229,1.1051203474690305,1336,1089,2425,+
chr11,126068230,0.3121827411167512,614,393,1007,+
chr11,126068234,0.8898934272486161,3260,2139,5399,+
chr11,126068235,1.0194661458333334,2236,1279,3515,+
chr11,126068244,1.5167987521460846,2867,2071,4938,+
chr11,126068564,0.7609995598952735,1364,970,2334,+
chr11,126068566,1.082021820502533,1120,832,1952,+
chr11,126345557,0.3775337837837838,446,1109,1555,+
chr11,126345558,0.38657868525896416,620,1505,2125,+
chr11,126345559,0.394170579029734,805,1916,2721,+
chr11,126345560,0.3980836644075719,667,1555,2222,+
chr11,126345561,0.4373423044575273,519,1188,1707,+
chr11,126345568,2.9984649824991867,761,1254,2015,+
chr11,126345663,25.22052448788538,664,984,1648,+
chr11,126408172,2.029720997899259,847,663,1510,+
chr11,126408385,0.9807955421531387,815,613,1428,+
chr11,126409283,2.8138613861386146,881,504,1385,+
chr11,126409284,2.8138613861386146,881,504,1385,+
chr11,126414399,0.20574066639903651,819,423,1242,+
chr11,126414400,0.20574066639903651,819,423,1242,+
chr11,126414419,0.3612232332215913,879,310,1189,+
chr11,126414421,0.3495095948827292,1365,468,1833,+
chr11,126414422,0.39875015022232896,947,313,1260,+
chr11,126414484,3.9508881922675023,1193,197,1390,+
chr11,126414485,4.385710798757085,5626,832,6458,+
chr11,126414486,3.7514856086628954,10303,1736,12039,+
chr11,126414487,3.8536287199115224,12200,2213,14413,+
chr11,126414488,3.5882103103855574,11873,2351,14224,+
chr11,126414489,3.622973953212459,9385,2003,11388,+
chr11,126414490,3.731843255435093,7426,1938,9364,+
chr11,126414491,3.7975497251108905,10135,2716,12851,+
chr11,126414492,2.9177922125563205,14070,4054,18124,+
chr11,126414493,2.827339812387514,14987,4583,19570,+
chr11,126414494,2.897252956713464,10095,3331,13426,+
chr11,126414495,2.6333793067147253,7772,2668,10440,+
chr11,126414497,2.5748420763526503,1124,330,1454,+
chr11,126414500,6.6240851630073205,1571,500,2071,+
chr11,126414501,4.320155735250076,1153,370,1523,+
chr11,126414503,31.537764350453173,948,330,1278,+
chr11,126414504,56.890965374681386,4915,2044,6959,+
chr11,130069893,0.6867245147573088,1303,690,1993,+
chr11,130069894,0.7630219339480244,911,430,1341,+
chr11,130070018,3.619795758051846,1023,401,1424,+
chr11,130070023,2.462324207929403,913,461,1374,+
chr11,130109437,2.3935754189944136,626,536,1162,+
chr11,130109438,1.5110325286175736,1406,1091,2497,+
chr11,130109440,0.7749520644935044,900,770,1670,+
chr11,130109474,1.5073734083506072,706,613,1319,+
chr11,130120750,0.6749607832530967,1467,972,2439,+
chr11,130120783,1.8296424452133797,546,509,1055,+
chr11,130121621,1.6869409660107335,965,601,1566,+
chr11,130121671,1.9043949214090483,3376,2044,5420,+
chr11,130121691,1.4690990320178705,1972,1206,3178,+
chr11,130121752,1.5218225419664266,2170,1389,3559,+
chr11,130121776,1.4377293985078934,11555,7373,18928,+
chr11,130121777,1.572533862222553,6543,4568,11111,+
chr11,130121782,1.872126456500556,7525,5947,13472,+
chr11,130121783,1.872126456500556,7525,5947,13472,+
chr11,130122387,3.3914199786567436,3222,2090,5312,+
chr11,130122396,5.416268681961524,3101,2336,5437,+
chr11,130122399,6.726728434478345,3116,2586,5702,+
chr11,130122414,1.623164186778931,1097,840,1937,+
chr11,130127781,0.5525716694772344,770,592,1362,+
chr11,130129137,2.006617903169627,822,637,1459,+
chr11,130129185,1.652207441681126,856,664,1520,+
chr11,130129186,2.5376498800959237,1220,694,1914,+
chr11,130130044,0.6346394685746629,5152,3746,8898,+
chr11,130130045,0.6411696869370751,5871,4494,10365,+
chr11,130130047,0.5738547120418849,4046,3055,7101,+
chr11,130130138,1.4277905638665132,1417,868,2285,+
chr11,130130139,2.6020689655172418,685,579,1264,+
chr11,130130152,2.3218457943925235,1324,855,2179,+
chr11,130133647,1.4358534040518218,1200,867,2067,+
chr11,130133707,2.598425196850393,659,507,1166,+
chr11,130140424,2.4779810833550733,2052,1575,3627,+
chr11,130140425,2.3113296616837133,1012,819,1831,+
chr11,130140441,0.5151144504630438,803,581,1384,+
chr11,130141525,2.3636363636363638,558,472,1030,+
chr11,130141943,2.311118334115142,1043,747,1790,+
chr11,130141954,1.3545162738093723,1273,1006,2279,+
chr11,130143348,2.107975176377427,865,716,1581,+
chr11,130143386,2.4355053191489358,593,563,1156,+
chr11,130143392,2.446136042663062,1296,994,2290,+
chr11,130143422,2.03083182132868,1678,1126,2804,+
chr11,130143495,2.02098801976642,1749,1154,2903,+
chr11,130143522,0.6120600414078675,859,482,1341,+
chr11,130143551,1.7324688404884805,833,610,1443,+
chr11,130143552,1.996378879420621,1748,1036,2784,+
chr11,130143553,1.996378879420621,1748,1036,2784,+
chr11,130143561,2.36036036036036,785,554,1339,+
chr11,130143585,0.7119582926034541,1494,1022,2516,+
chr11,130143620,2.0707855973813416,722,563,1285,+
chr11,130143621,1.4833519818261962,1482,1016,2498,+
chr11,130143994,0.4633642930856553,897,569,1466,+
chr11,130144084,1.8756137479541726,763,610,1373,+
chr11,130144094,1.469606413994169,857,685,1542,+
chr11,130144113,2.024605250411702,1099,665,1764,+
chr11,130144441,2.3261196044305446,888,675,1563,+
chr12,431933,2.7688625736987276,648,449,1097,+
chr12,438337,0.41403785383446395,766,434,1200,+
chr12,442441,0.4830999517141478,666,435,1101,+
chr12,442451,0.6025581753737094,781,514,1295,+
chr12,442452,3.2512179374302987,1350,1261,2611,+
chr12,442453,3.2512179374302987,1350,1261,2611,+
chr12,442456,2.026834936348573,1630,1343,2973,+
chr12,908902,0.18676336336650085,541,782,1323,+
chr12,908904,0.16558171689145504,467,637,1104,+
chr12,1786605,22.973768288920283,1417,162,1579,+
chr12,1786606,29.40016652195,1147,125,1272,+
chr12,1786614,11.328141969831412,1127,98,1225,+
chr12,1786615,17.318681318681318,1181,116,1297,+
chr12,1786616,36.50029086678301,1487,381,1868,+
chr12,1786617,28.560471628810493,2024,898,2922,+
chr12,1786618,24.406320109105287,1881,1116,2997,+
chr12,1787535,0.7187622983077528,768,483,1251,+
chr12,1787536,0.7187622983077528,768,483,1251,+
chr12,1787537,1.0565780934901587,950,652,1602,+
chr12,1787929,2.647058823529412,749,449,1198,+
chr12,1787930,3.0726591486202417,981,670,1651,+
chr12,1787957,1.6385594323753374,1302,974,2276,+
chr12,1787958,0.6264264264264264,744,554,1298,+
chr12,1787959,0.6264264264264264,744,554,1298,+
chr12,1788356,1.1692066891141073,656,510,1166,+
chr12,2797173,1.9017788403095748,1513,850,2363,+
chr12,2797174,1.9017788403095748,1513,850,2363,+
chr12,2797198,0.5146546642684259,968,767,1735,+
chr12,2797227,1.6403940886699506,887,615,1502,+
chr12,2797757,2.2794612794612794,676,362,1038,+
chr12,2797788,1.7994967719448856,968,576,1544,+
chr12,2797791,1.8021154979148961,952,651,1603,+
chr12,2797805,1.7026737967914438,795,439,1234,+
chr12,2797807,2.778688524590164,677,487,1164,+
chr12,2797808,2.5418592706728305,706,530,1236,+
chr12,2797815,0.6286090390522159,753,529,1282,+
chr12,2797832,0.7380692167577414,1012,731,1743,+
chr12,2797836,0.6139798488664987,1124,793,1917,+
chr12,2797839,1.4549811708319071,1189,888,2077,+
chr12,2797841,0.6270640967126591,2935,1877,4812,+
chr12,2797843,0.6270640967126591,2935,1877,4812,+
chr12,2797844,1.3048010656164937,1501,1113,2614,+
chr12,2798798,2.4465290806754223,977,614,1591,+
chr12,2799104,1.3486758391787876,1014,795,1809,+
chr12,2799159,1.6176136363636366,802,483,1285,+
chr12,2799214,1.0175504066547958,1588,1180,2768,+
chr12,2799216,0.4151454762853727,991,771,1762,+
chr12,2799217,1.7015993265993266,621,431,1052,+
chr12,2799872,1.51504021961015,1700,1183,2883,+
chr12,2799884,0.49558707643814015,661,539,1200,+
chr12,2799906,0.6683356585175823,1716,1270,2986,+
chr12,2800059,2.5823436262866197,592,420,1012,+
chr12,2800079,0.4552110249784668,1056,687,1743,+
chr12,2800397,1.6480258024241794,1407,817,2224,+
chr12,2801206,2.1538568257491675,674,423,1097,+
chr12,2801267,2.966333333333333,808,499,1307,+
chr12,2801279,1.8259354365370504,904,563,1467,+
chr12,2801286,1.8525311812179015,1009,469,1478,+
chr12,2801303,1.7145067980242412,3783,2063,5846,+
chr12,2801304,1.0119832893579594,1051,757,1808,+
chr12,2801305,1.8445208743929615,2556,1373,3929,+
chr12,2801306,1.0119832893579594,1051,757,1808,+
chr12,2801311,1.6277531177340945,1452,829,2281,+
chr12,2803151,2.3317137267181396,5180,3049,8229,+
chr12,2803153,2.632668144863267,3535,2090,5625,+
chr12,2803158,2.0388459486249197,3836,2492,6328,+
chr12,2803402,4.109217359583338,1291,331,1622,+
chr12,2803403,4.804655017751815,1922,476,2398,+
chr12,2803409,4.670619260953243,1071,253,1324,+
chr12,2803412,5.062552408581965,1027,232,1259,+
chr12,2803419,7.341087177204501,2977,659,3636,+
chr12,2803420,8.570851136725693,6368,1862,8230,+
chr12,2803421,8.570851136725693,6368,1862,8230,+
chr12,2803422,8.951221620262642,5396,1691,7087,+
chr12,2803430,6.764956011730206,1182,439,1621,+
chr12,2803432,12.942469818685677,6112,9121,15233,+
chr12,2803433,12.60124764866446,5533,8937,14470,+
chr12,2803434,11.148764171161144,6002,9785,15787,+
chr12,2803436,1.3662706388175136,1917,3417,5334,+
chr12,2803437,0.3796845378963411,2015,3508,5523,+
chr12,2803438,0.42480340926963744,2700,4681,7381,+
chr12,2803439,0.4088688462983841,1546,2660,4206,+
chr12,4099097,1.2139368773300165,739,495,1234,+
chr12,4099098,1.3970719901113506,864,609,1473,+
chr12,4553131,0.41462534556186176,604,419,1023,+
chr12,4654306,2.8658146964856233,896,625,1521,+
chr12,4654308,2.597433818578237,1249,947,2196,+
chr12,4654865,0.545898898884369,1234,999,2233,+
chr12,4654866,0.5243801652892562,845,659,1504,+
chr12,4657768,1.824436090225564,632,419,1051,+
chr12,4657788,2.0594425868999404,1716,1421,3137,+
chr12,4659134,0.9320516492606736,1252,959,2211,+
chr12,4662542,2.0088828573191044,856,558,1414,+
chr12,4662574,2.1239951768488745,812,621,1433,+
chr12,4669765,0.5451820515345738,1114,910,2024,+
chr12,4682235,1.0256752359258057,1465,877,2342,+
chr12,4682236,1.0256752359258057,1465,877,2342,+
chr12,4682260,2.5211212388513182,886,536,1422,+
chr12,4685264,3.051876379690949,552,452,1004,+
chr12,4685288,2.2384737678855333,703,480,1183,+
chr12,4686955,2.1925233644859814,827,534,1361,+
chr12,4687101,1.7463657759933546,741,465,1206,+
chr12,4687106,1.9054435483870968,726,495,1221,+
chr12,6200529,1.13126697502564,1178,817,1995,+
chr12,6200545,1.6271250951535137,854,562,1416,+
chr12,6200550,0.5758582502768549,649,515,1164,+
chr12,6225492,1.8008677573894967,686,480,1166,+
chr12,6232643,2.4702214452214455,1015,670,1685,+
chr12,6235547,1.8354123178959885,1267,934,2201,+
chr12,6237778,0.43197497373683563,1363,986,2349,+
chr12,6237924,1.7475822050290135,833,516,1349,+
chr12,6238035,1.7138818207520496,865,654,1519,+
chr12,6238087,1.4587440157702056,1294,937,2231,+
chr12,6238088,1.849894291754757,594,472,1066,+
chr12,6238095,1.6712194055944054,804,703,1507,+
chr12,6384642,1.4641568384620587,723,530,1253,+
chr12,6385040,2.0923178092631605,700,423,1123,+
chr12,6385321,1.9489263309640352,1411,1100,2511,+
chr12,6385323,1.9489263309640352,1411,1100,2511,+
chr12,6385327,2.057599380085498,818,701,1519,+
chr12,6386349,1.6111224860390654,721,513,1234,+
chr12,6391489,4.771756183297704,1459,921,2380,+
chr12,6391490,4.03628268027098,1956,1191,3147,+
chr12,6391506,17.70597146392618,1398,969,2367,+
chr12,6391507,15.433696292706014,2088,1634,3722,+
chr12,6391510,10.055053239325272,1408,1462,2870,+
chr12,6495111,1.4178421559008483,613,403,1016,+
chr12,6510667,2.4018592230774702,831,533,1364,+
chr12,6510669,2.1461912095723257,646,366,1012,+
chr12,6510671,4.0226465794968265,704,523,1227,+
chr12,6511179,2.8457200379509664,633,435,1068,+
chr12,6514367,2.410179445350734,971,612,1583,+
chr12,6514368,2.410179445350734,971,612,1583,+
chr12,6514495,2.6176545128345228,1144,730,1874,+
chr12,6514515,1.905287501313991,724,452,1176,+
chr12,6514535,2.701054339010544,723,410,1133,+
chr12,6514539,1.8785046728971964,736,427,1163,+
chr12,6514782,1.9255001717802804,692,557,1249,+
chr12,6517826,1.132587624614173,557,452,1009,+
chr12,6521821,3.0371522045127426,737,533,1270,+
chr12,6522952,0.7879245283018868,695,529,1224,+
chr12,6522953,0.7879245283018868,695,529,1224,+
chr12,6522954,0.7879245283018868,695,529,1224,+
chr12,6526543,0.7693222354340071,1293,840,2133,+
chr12,6526544,1.551270295470331,2196,1414,3610,+
chr12,6526923,2.8894472361809043,649,397,1046,+
chr12,6526924,2.8894472361809043,649,397,1046,+
chr12,6526991,2.173795442991652,789,636,1425,+
chr12,6529548,0.798563261495276,710,570,1280,+
chr12,6531369,1.452848834628191,766,559,1325,+
chr12,6534515,0.9969112827651587,13264,9279,22543,+
chr12,6534516,0.9807402073848729,30770,21712,52482,+
chr12,6534517,0.9357963681917135,53446,37071,90517,+
chr12,6534519,0.6456996058615255,36215,24031,60246,+
chr12,6534531,1.1715195351137488,5435,4043,9478,+
chr12,6534536,0.6575423754602722,5024,3865,8889,+
chr12,6534546,1.0398640335697125,14899,11079,25978,+
chr12,6534547,1.1501605289170544,56716,39078,95794,+
chr12,6534549,1.18832446699881,117438,76775,194213,+
chr12,6534550,1.1507041676426295,113638,73495,187133,+
chr12,6534552,1.0531024021923718,62793,41001,103794,+
chr12,6534553,1.0557382079789188,81329,53023,134352,+
chr12,6534807,0.746189933586801,814,551,1365,+
chr12,6536492,1.0309028530615891,684,486,1170,+
chr12,6536493,1.2431534208928512,5871,4103,9974,+
chr12,6536501,1.0313785248646397,28310,20139,48449,+
chr12,6536922,1.2146086122913586,26209,17921,44130,+
chr12,6536932,1.1203324892290174,73652,51659,125311,+
chr12,6536933,0.962154745116688,56515,38369,94884,+
chr12,6536934,0.8585592294880398,26301,20602,46903,+
chr12,6536938,1.3837790574272764,24391,15142,39533,+
chr12,6537121,1.0647464651382168,19201,12405,31606,+
chr12,6537128,1.3079016536679342,25481,13733,39214,+
chr12,6537130,1.342763858616422,38923,21108,60031,+
chr12,6537131,1.3105469493751507,26426,14387,40813,+
chr12,6537137,1.1930473979685208,22363,13327,35690,+
chr12,6537161,1.6131025723349308,8797,7094,15891,+
chr12,6537306,1.110418877605788,2465,1784,4249,+
chr12,6537307,1.1152093026710088,1946,1366,3312,+
chr12,6537668,1.1601670509217672,29503,23105,52608,+
chr12,6537671,1.188036339969593,11068,8442,19510,+
chr12,6537736,0.8138757916795301,10204,7991,18195,+
chr12,6537737,1.1656546360748798,21855,17837,39692,+
chr12,6537803,1.4152482515833738,7906,6300,14206,+
chr12,6537886,1.1346632866051594,38463,25483,63946,+
chr12,6537910,1.293328456269884,7960,6007,13967,+
chr12,6538107,1.309043177480368,5756,3852,9608,+
chr12,6538257,1.2937742160122967,9823,5400,15223,+
chr12,6538262,1.2684317837442032,21731,12520,34251,+
chr12,6538264,1.3531321718559288,33119,19290,52409,+
chr12,6538265,1.4186712460702542,22497,13259,35756,+
chr12,6538282,0.8354552726024013,7443,5753,13196,+
chr12,6538289,1.1100234586930118,26513,19702,46215,+
chr12,6729313,5.589004622509667,882,592,1474,+
chr12,6729315,0.917260636343596,656,438,1094,+
chr12,6731134,2.63116974317817,806,711,1517,+
chr12,6731135,2.251565167899829,551,501,1052,+
chr12,6731771,19.0876956915513,810,500,1310,+
chr12,6731772,16.526646548876442,1151,738,1889,+
chr12,6769921,3.103936577364681,678,330,1008,+
chr12,6769924,3.374363126103659,1308,655,1963,+
chr12,6769925,4.603500522466041,1240,659,1899,+
chr12,6769926,4.603500522466041,1240,659,1899,+
chr12,6769927,3.574388489150812,1712,950,2662,+
chr12,6769942,3.1503563844250864,1626,1129,2755,+
chr12,6769945,7.861877165010043,1726,1638,3364,+
chr12,6770498,16.744153967901358,1727,1059,2786,+
chr12,6770499,18.938229370947564,2159,1382,3541,+
chr12,6770500,18.938229370947564,2159,1382,3541,+
chr12,6770501,16.819420061814164,1298,883,2181,+
chr12,6770549,0.45250591415585756,595,451,1046,+
chr12,6770634,1.091694737086354,1124,717,1841,+
chr12,6770780,1.9186046511627908,604,429,1033,+
chr12,6856072,0.6028285345145811,900,601,1501,+
chr12,6856075,0.5573893473368342,742,402,1144,+
chr12,6856080,0.6409965382214404,1254,788,2042,+
chr12,6856089,0.6677194148936171,1544,939,2483,+
chr12,6856090,0.4579256360078278,1169,559,1728,+
chr12,6856091,1.765704584040747,935,683,1618,+
chr12,6856100,1.1582437294918448,3055,1988,5043,+
chr12,6867537,1.9611578185242526,1008,717,1725,+
chr12,6867560,1.878247549019608,1056,639,1695,+
chr12,6867564,1.6612070117540425,2507,1578,4085,+
chr12,6867566,1.6612070117540425,2507,1578,4085,+
chr12,6867570,1.92405399659864,882,783,1665,+
chr12,6867579,1.5965909090909092,842,791,1633,+
chr12,6867581,0.6384212149244527,1293,1080,2373,+
chr12,6867582,1.3617747440273036,2184,1464,3648,+
chr12,6867599,1.6383346425765908,1737,1272,3009,+
chr12,6867606,1.5930452132397477,1943,1650,3593,+
chr12,6867662,1.3586943610107078,2026,1510,3536,+
chr12,6869105,1.5570755464048147,2912,1803,4715,+
chr12,6869106,1.352103453920445,2064,1638,3702,+
chr12,6869258,1.4065178682347097,1331,778,2109,+
chr12,6869266,1.677696292534281,2808,1968,4776,+
chr12,6869267,1.2403656906688645,3825,2670,6495,+
chr12,6869268,1.2403656906688645,3825,2670,6495,+
chr12,6869269,1.1253952843273232,2923,2059,4982,+
chr12,6869708,2.379833105360874,2009,1167,3176,+
chr12,6869711,1.7593085106382975,881,422,1303,+
chr12,6869743,1.4878674948240167,2763,1609,4372,+
chr12,6869745,1.556946106643556,3449,2099,5548,+
chr12,6869754,1.7778294213339532,849,661,1510,+
chr12,6869760,1.4366024509213222,2284,1456,3740,+
chr12,6870052,1.463491549815736,4038,2881,6919,+
chr12,6870056,1.3533893851812928,3332,2177,5509,+
chr12,6870121,0.7022066916134713,1628,1238,2866,+
chr12,6870272,1.7439408195710715,1249,832,2081,+
chr12,6870287,1.7691312176457348,2733,1480,4213,+
chr12,6870421,1.5546815878887519,10497,6680,17177,+
chr12,6870422,1.5540376289925488,8581,5019,13600,+
chr12,6870434,2.1127471169686984,1733,1213,2946,+
chr12,6870442,1.2095965458006408,3157,2379,5536,+
chr12,6870690,1.4052614052614052,4219,2969,7188,+
chr12,6870691,1.4052614052614052,4219,2969,7188,+
chr12,6944021,0.6651073492094409,1404,536,1940,+
chr12,6944044,1.7298744342034629,5395,2733,8128,+
chr12,6944045,1.7298744342034629,5395,2733,8128,+
chr12,6944049,2.165478312537136,984,560,1544,+
chr12,6944076,1.9072970195272352,1030,694,1724,+
chr12,6944077,0.4864660168598525,868,583,1451,+
chr12,6944085,1.475625277123931,2753,1687,4440,+
chr12,6944490,1.8920370370370367,600,449,1049,+
chr12,6944521,1.799586776859504,870,483,1353,+
chr12,6944546,2.1947314049586777,606,483,1089,+
chr12,6944567,1.1288721058958564,2026,1302,3328,+
chr12,6944568,1.1288721058958564,2026,1302,3328,+
chr12,6944569,2.486792452830189,658,529,1187,+
chr12,6944601,0.5881767515923568,787,627,1414,+
chr12,6944616,1.436856496327049,2306,1601,3907,+
chr12,6945868,1.7589928057553956,977,555,1532,+
chr12,6945922,2.1773541776519223,1144,756,1900,+
chr12,6945943,0.4642159563279411,712,486,1198,+
chr12,6970911,1.4720374707259951,581,426,1007,+
chr12,6970913,1.0374046018372236,1085,720,1805,+
chr12,6970915,0.9587208092268866,913,601,1514,+
chr12,6970917,2.9510489510489517,843,168,1011,+
chr12,6970919,2.311016120748215,1437,340,1777,+
chr12,6970920,1.73648146894978,1805,890,2695,+
chr12,6970937,2.1978647691078392,1679,705,2384,+
chr12,6970940,1.8823696790348283,2133,763,2896,+
chr12,6970941,1.8710450756836616,3355,1236,4591,+
chr12,6970942,0.7622447953334003,1165,977,2142,+
chr12,6970943,1.7504368241336552,3288,1429,4717,+
chr12,6970955,1.3726849424250689,1576,685,2261,+
chr12,6970957,1.5201378809869377,1196,741,1937,+
chr12,6970958,0.5917505196257195,1833,1432,3265,+
chr12,6970984,1.7482245568728725,1832,1216,3048,+
chr12,6974605,0.4721787822226706,623,460,1083,+
chr12,6974630,1.848913043478261,692,505,1197,+
chr12,6975235,1.360871294861516,1738,1374,3112,+
chr12,6975236,1.5584299036083982,2071,1530,3601,+
chr12,6975705,2.176205496446836,869,620,1489,+
chr12,6975828,2.150735294117647,584,479,1063,+
chr12,7065172,3.3828936850519584,735,416,1151,+
chr12,7065174,3.3828936850519584,735,416,1151,+
chr12,7065243,0.5215992647058824,907,511,1418,+
chr12,7065258,2.023236994219653,945,691,1636,+
chr12,7065270,0.49248311141802803,2305,1216,3521,+
chr12,7067075,0.44096480351034634,723,530,1253,+
chr12,7069883,0.7415925112677685,557,508,1065,+
chr12,7069885,0.7461799660441425,585,531,1116,+
chr12,7070486,8.946345628903927,931,702,1633,+
chr12,7210916,4.595793755775886,1311,128,1439,+
chr12,7210946,93.80062615524288,1763,98,1861,+
chr12,7210947,122.23728813559323,1201,58,1259,+
chr12,7210951,202.49115113539958,4217,618,4835,+
chr12,7210952,202.49115113539958,4217,618,4835,+
chr12,8090281,0.6077797202797204,817,519,1336,+
chr12,8090287,2.1073008849557517,634,451,1085,+
chr12,9695896,1.0762886597938144,840,434,1274,+
chr12,9695897,0.8430698709918871,1892,955,2847,+
chr12,9695899,0.8382963849983964,2312,1444,3756,+
chr12,9695900,1.3258170447661823,2492,1379,3871,+
chr12,9695903,1.4768323870588467,1759,1428,3187,+
chr12,9695904,0.7108185931715344,863,428,1291,+
chr12,9695909,1.3619755426053548,9241,7101,16342,+
chr12,9695910,0.9815795471768844,3945,3982,7927,+
chr12,9695911,1.6848116570100649,5737,2989,8726,+
chr12,9695912,1.563256971832956,3991,2102,6093,+
chr12,9695917,1.718241653309689,2255,1238,3493,+
chr12,9695918,0.8183924619667049,2686,2673,5359,+
chr12,9695921,0.9047696881746351,20191,16055,36246,+
chr12,9695922,0.8967316692971976,30932,23889,54821,+
chr12,9695923,0.8632589730641401,28019,22159,50178,+
chr12,9695924,0.9183030061731454,21789,17183,38972,+
chr12,10213021,3.166144050433265,732,504,1236,+
chr12,10213109,0.8142241197797473,1619,1031,2650,+
chr12,10213111,1.2420934604247629,2255,1330,3585,+
chr12,10213112,2.1823444283646887,1130,690,1820,+
chr12,10213126,2.830497382198953,691,381,1072,+
chr12,10213130,2.022779043280182,776,438,1214,+
chr12,10213139,0.6390257252326218,933,608,1541,+
chr12,10218063,1.9272622771688774,1045,709,1754,+
chr12,10218082,2.6413662239089177,695,495,1190,+
chr12,10218114,1.6095971563981042,740,632,1372,+
chr12,10220496,1.6855721393034826,846,669,1515,+
chr12,10220510,1.747993704938538,2278,1738,4016,+
chr12,10221899,12.63008130081301,955,122,1077,+
chr12,10221900,8.242534187765914,2214,379,2593,+
chr12,10221903,18.50451029882669,3019,677,3696,+
chr12,10221904,16.904361036336454,4019,956,4975,+
chr12,10221905,15.892110345692068,2804,618,3422,+
chr12,10221906,17.752521183634883,1942,480,2422,+
chr12,10221909,3.9163280720608733,1772,574,2346,+
chr12,10221914,5.942997685185184,892,287,1179,+
chr12,10221916,3.773605552135787,2339,879,3218,+
chr12,10221917,3.438366941008458,1795,720,2515,+
chr12,10221920,6.661127167630057,877,345,1222,+
chr12,10221922,9.710496894409939,1796,965,2761,+
chr12,10221923,7.440782035280779,4900,5335,10235,+
chr12,10221924,6.569200209787676,5385,6049,11434,+
chr12,10221925,6.366501476127736,4945,5872,10817,+
chr12,10221926,3.3424714383361,1344,1861,3205,+
chr12,10221933,6.749761853024612,1705,3003,4708,+
chr12,10221971,0.5339633692759181,1560,2173,3733,+
chr12,10222129,0.455524861878453,1066,723,1789,+
chr12,10222252,1.8141354369160068,1591,1080,2671,+
chr12,10222394,0.5962419209861747,994,765,1759,+
chr12,10222435,0.6588552330880699,1347,1036,2383,+
chr12,10222820,5.15241379310345,963,579,1542,+
chr12,10222822,2.264897579143389,694,536,1230,+
chr12,10222858,2.2463768115942027,929,557,1486,+
chr12,10222874,0.6281182710992069,1039,576,1615,+
chr12,10222955,12.603483451780006,2106,450,2556,+
chr12,10222956,6.97189422316506,2865,598,3463,+
chr12,10222961,29.352775222662995,8046,5127,13173,+
chr12,10222962,29.352775222662995,8046,5127,13173,+
chr12,10222963,29.352775222662995,8046,5127,13173,+
chr12,10222969,8.210810810810809,619,924,1543,+
chr12,10223034,1.9867102151143148,489,682,1171,+
chr12,10505962,1.5609165596810655,894,742,1636,+
chr12,10506153,0.4132149394299783,636,405,1041,+
chr12,10506373,1.862995198079232,954,713,1667,+
chr12,10506625,2.742448685110254,995,728,1723,+
chr12,10506626,0.6691667610098494,638,483,1121,+
chr12,10506643,1.2058435738619324,1626,1196,2822,+
chr12,10506646,0.6191751038421598,1230,855,2085,+
chr12,10506657,1.6490228013029316,764,613,1377,+
chr12,10506758,2.019794091903829,1149,833,1982,+
chr12,10506885,1.035419344944269,1768,1206,2974,+
chr12,10506886,1.1231063287554863,1502,1008,2510,+
chr12,10506887,1.1231063287554863,1502,1008,2510,+
chr12,10507047,0.48944218997179995,592,468,1060,+
chr12,10507183,2.139091176280904,1269,756,2025,+
chr12,10507184,2.1893275425407293,1374,776,2150,+
chr12,10507185,2.254071302816901,963,567,1530,+
chr12,10507186,2.0039232396335773,1131,879,2010,+
chr12,10507213,0.44314801302200274,1288,1047,2335,+
chr12,10507214,0.44314801302200274,1288,1047,2335,+
chr12,10507215,0.44314801302200274,1288,1047,2335,+
chr12,10507218,0.6409342870396321,2203,1524,3727,+
chr12,10507243,1.9355726872246692,1294,907,2201,+
chr12,11171842,2.0936828672926264,614,388,1002,+
chr12,12718831,0.6769216555801922,861,450,1311,+
chr12,12718832,1.6760816644410224,834,487,1321,+
chr12,12718860,0.46133776091081596,777,526,1303,+
chr12,12718862,0.46133776091081596,777,526,1303,+
chr12,12721336,37.76142096896814,1054,59,1113,+
chr12,12721337,98.04938271604937,1082,80,1162,+
chr12,12721338,115.71724137931037,1070,173,1243,+
chr12,12721339,45.17223431023775,2105,1143,3248,+
chr12,12721340,39.98507342301308,2097,1437,3534,+
chr12,12721341,31.32890251013498,2054,1660,3714,+
chr12,12721364,2.9181720968111713,847,1249,2096,+
chr12,12721365,2.2317806739779167,817,1373,2190,+
chr12,12721366,0.6080009872951578,877,1767,2644,+
chr12,12721367,0.49671997235423426,869,1607,2476,+
chr12,12721368,0.15460380699424525,507,1003,1510,+
chr12,12721397,0.2212671600898282,742,726,1468,+
chr12,12721442,2.7086349099478197,595,456,1051,+
chr12,12722159,1.726218097447796,619,430,1049,+
chr12,12813360,1.1535467445969878,677,568,1245,+
chr12,12814187,0.5682703298487757,1071,711,1782,+
chr12,12821300,1.0118346150004995,880,645,1525,+
chr12,12821302,1.0118346150004995,880,645,1525,+
chr12,12821357,2.6521602503225714,1076,877,1953,+
chr12,12821359,3.2080318913332344,678,520,1198,+
chr12,12821979,1.6578947368421053,818,493,1311,+
chr12,12821987,1.966405972271596,896,581,1477,+
chr12,12821992,0.4667440061871616,1206,861,2067,+
chr12,12821993,0.4667440061871616,1206,861,2067,+
chr12,12821995,1.7132037364301946,1043,698,1741,+
chr12,12822026,2.551608832807571,1036,633,1669,+
chr12,12822053,0.6308161708619374,2480,1424,3904,+
chr12,12822060,2.04237949912835,3637,2392,6029,+
chr12,12822061,2.04237949912835,3637,2392,6029,+
chr12,12822067,2.194644115574348,4061,3009,7070,+
chr12,12822069,2.194644115574348,4061,3009,7070,+
chr12,12823259,0.5494553376906318,678,509,1187,+
chr12,12823941,1.7458946367377797,907,779,1686,+
chr12,12829423,1.6831996134151612,600,417,1017,+
chr12,12829556,0.5841866711431929,695,482,1177,+
chr12,12829785,2.1468926553672314,607,471,1078,+
chr12,12829813,1.9224588188027318,579,523,1102,+
chr12,12891562,1.4402164328474065,1641,1012,2653,+
chr12,12891563,1.4402164328474065,1641,1012,2653,+
chr12,12908686,2.214728727403586,1032,836,1868,+
chr12,12908698,0.5416785206258891,713,569,1282,+
chr12,12912533,2.3686621150467597,1232,755,1987,+
chr12,12912583,1.5659904263012574,777,605,1382,+
chr12,12913171,2.3281347473487206,621,457,1078,+
chr12,12913231,3.1936086728908544,944,704,1648,+
chr12,12913413,1.2040821516619218,1116,899,2015,+
chr12,12913499,2.2655122655122657,784,461,1245,+
chr12,12914279,7.067737761220101,813,601,1414,+
chr12,12914299,1.8842479818500926,1111,954,2065,+
chr12,12914373,0.5322665464653293,544,458,1002,+
chr12,12914474,2.5877192982456143,589,436,1025,+
chr12,12914876,1.05294629267232,744,377,1121,+
chr12,12914877,0.7991111963295847,1050,630,1680,+
chr12,12914878,1.05294629267232,744,377,1121,+
chr12,12915239,3.8766207552805034,1061,821,1882,+
chr12,12915807,0.4651936326918508,711,551,1262,+
chr12,12915808,0.4651936326918508,711,551,1262,+
chr12,12915809,0.5058548009367682,575,426,1001,+
chr12,12916117,2.07587890625,732,511,1243,+
chr12,12916181,0.488637105670454,878,603,1481,+
chr12,12916261,3.378339052252096,601,400,1001,+
chr12,12916642,1.6294411076046016,905,626,1531,+
chr12,12916693,2.5170981839553037,804,594,1398,+
chr12,12917001,0.4750490196078432,880,679,1559,+
chr12,12917003,0.4750490196078432,880,679,1559,+
chr12,12917708,0.41634178037686814,698,485,1183,+
chr12,12917851,1.6464665299272794,882,691,1573,+
chr12,14774692,1.9920373434097491,901,537,1438,+
chr12,14774701,2.671881035533753,960,602,1562,+
chr12,14774747,1.7372929430451556,874,677,1551,+
chr12,14774750,1.7840375586854462,778,425,1203,+
chr12,14774765,1.9745604190048633,811,485,1296,+
chr12,14774768,1.5558954393770856,1864,1146,3010,+
chr12,14774769,1.5558954393770856,1864,1146,3010,+
chr12,14774773,2.4111210762331843,1033,668,1701,+
chr12,14774783,1.789528055676381,1218,835,2053,+
chr12,14774800,1.3130557264180938,6543,4335,10878,+
chr12,14774801,1.625136915505777,2827,2107,4934,+
chr12,15882480,0.3992063948494066,904,683,1587,+
chr12,15882481,0.37524269750183376,668,472,1140,+
chr12,15882536,0.7776767013367525,811,556,1367,+
chr12,15882548,3.49670510708402,848,606,1454,+
chr12,15882716,0.5042355788624445,624,401,1025,+
chr12,15894081,1.981072907199024,4030,2993,7023,+
chr12,15897893,3.2901656314699794,858,643,1501,+
chr12,15897935,1.8487311739220138,973,654,1627,+
chr12,15897947,0.4735136692028898,1095,682,1777,+
chr12,15899989,2.209951923076923,1068,831,1899,+
chr12,15900946,0.6118458884416331,759,554,1313,+
chr12,15900947,2.076859065486367,1640,1078,2718,+
chr12,15900950,1.8646064643473974,816,578,1394,+
chr12,15900991,2.105405512907203,1202,810,2012,+
chr12,15902917,2.058651026392962,1061,648,1709,+
chr12,15903208,1.4438063986874488,1759,1218,2977,+
chr12,16036891,2.5711846800732054,957,642,1599,+
chr12,16036892,3.1474747474747478,778,494,1272,+
chr12,16347651,0.7680038875727835,850,358,1208,+
chr12,16347652,0.7297598147799559,1378,651,2029,+
chr12,16347653,0.740110459317498,1985,998,2983,+
chr12,16347674,1.855134898324267,940,558,1498,+
chr12,16347675,1.797169350265538,1366,899,2265,+
chr12,16347676,1.8490311078365715,1834,1125,2959,+
chr12,16347677,1.9756838905775083,724,328,1052,+
chr12,16347679,1.4623017001194063,634,408,1042,+
chr12,16347680,2.328743010975357,1763,877,2640,+
chr12,16347681,2.328743010975357,1763,877,2640,+
chr12,16354230,0.5065146138635318,812,550,1362,+
chr12,16354238,2.406105457909343,866,610,1476,+
chr12,16354241,1.4741478852157548,1148,697,1845,+
chr12,16354245,1.782464117947537,2597,1677,4274,+
chr12,16354247,1.6436123711402142,4014,2701,6715,+
chr12,16354249,1.2663200613661845,1771,1200,2971,+
chr12,16354250,1.268351658285519,3210,2310,5520,+
chr12,16354328,1.4428708391485083,11207,8378,19585,+
chr12,16363919,1.2612450298210736,1817,1508,3325,+
chr12,16364026,1.0697340481697262,4924,4053,8977,+
chr12,16364044,1.3691759722757026,2585,2119,4704,+
chr12,16989415,0.6766697649714513,636,442,1078,+
chr12,16989420,1.7049386599559608,812,560,1372,+
chr12,16989421,1.7283963280168215,821,526,1347,+
chr12,16989424,0.5762580818281452,1620,1184,2804,+
chr12,16989427,1.5487223289913874,988,668,1656,+
chr12,19283603,2.4833025261860757,915,540,1455,+
chr12,19283604,2.4833025261860757,915,540,1455,+
chr12,19283610,2.0974057520404195,1052,663,1715,+
chr12,19283612,2.0974057520404195,1052,663,1715,+
chr12,19283623,3.11001386001386,618,443,1061,+
chr12,20637210,1.7713043570436284,678,500,1178,+
chr12,20654058,0.38020253886749394,832,778,1610,+
chr12,20654059,0.8765119900342572,1302,1234,2536,+
chr12,20654061,1.0602125147579693,897,846,1743,+
chr12,20654069,1.913967611336032,548,493,1041,+
chr12,20654070,0.5415384615384615,659,624,1283,+
chr12,20654082,1.7035895679963475,877,648,1525,+
chr12,20654091,1.5730427018872568,1731,1603,3334,+
chr12,20654093,1.5636512780386829,2781,2376,5157,+
chr12,20654103,2.8260504201680665,1120,849,1969,+
chr12,20680261,1.7299742024881186,766,570,1336,+
chr12,20680559,2.399365354060772,687,478,1165,+
chr12,20680686,3.162779338136524,739,430,1169,+
chr12,20680687,3.162779338136524,739,430,1169,+
chr12,20681114,9.190396880087654,710,438,1148,+
chr12,20681560,4.363636363636363,671,384,1055,+
chr12,20681570,3.4835680751173714,688,425,1113,+
chr12,20681608,3.710762331838565,661,445,1106,+
chr12,20681646,2.399676315886269,1164,876,2040,+
chr12,20681651,2.8327181018935983,2544,2217,4761,+
chr12,20681653,2.8327181018935983,2544,2217,4761,+
chr12,20682750,3.686143572621035,1034,598,1632,+
chr12,20682751,3.686143572621035,1034,598,1632,+
chr12,20683093,2.342647058823529,589,424,1013,+
chr12,20683276,1.5456749712068858,592,422,1014,+
chr12,20683329,1.7735294117647058,602,458,1060,+
chr12,20683946,1.8054889421795897,615,416,1031,+
chr12,21508545,0.5486862442040186,922,646,1568,+
chr12,21512324,2.419565217391304,741,643,1384,+
chr12,21515901,1.9113175675675675,802,591,1393,+
chr12,21516084,1.4603563970200901,990,675,1665,+
chr12,21517175,2.688469601677149,686,476,1162,+
chr12,21517176,2.688469601677149,686,476,1162,+
chr12,21517185,2.5257755603327956,814,575,1389,+
chr12,21517429,1.4682967000908538,848,531,1379,+
chr12,21517704,2.2461556073029407,1386,984,2370,+
chr12,22055228,3.2848266841072595,573,555,1128,+
chr12,22055229,3.2848266841072595,573,555,1128,+
chr12,22065545,1.1238095238095238,648,524,1172,+
chr12,22065547,1.1238095238095238,648,524,1172,+
chr12,22687626,2.7434524665834545,845,496,1341,+
chr12,25203956,1.5073962824247502,719,368,1087,+
chr12,25203957,1.4625736258273638,1020,518,1538,+
chr12,25204145,2.3229832572298323,586,437,1023,+
chr12,25204148,2.3186015831134563,702,378,1080,+
chr12,26064982,2.985931919236096,930,806,1736,+
chr12,26064984,2.324397325892132,1245,1024,2269,+
chr12,26065232,3.8161177644710578,873,667,1540,+
chr12,27028310,0.985747652414319,1033,665,1698,+
chr12,27028311,0.985747652414319,1033,665,1698,+
chr12,27028483,1.0553772618641175,671,504,1175,+
chr12,27028485,1.0553772618641175,671,504,1175,+
chr12,27028510,2.1276829697396202,1124,783,1907,+
chr12,27028511,2.1234820928499776,1439,1000,2439,+
chr12,27029453,2.373968855218856,704,451,1155,+
chr12,27029587,3.078323782543394,775,528,1303,+
chr12,27714796,0.37055655310840413,575,481,1056,+
chr12,27716362,2.3470134091832593,759,534,1293,+
chr12,27716364,2.3470134091832593,759,534,1293,+
chr12,27716365,0.43848022707661294,1120,837,1957,+
chr12,27719843,0.4141515761234071,740,503,1243,+
chr12,27724126,1.8778600823045262,735,449,1184,+
chr12,27724155,1.9748908296943233,602,457,1059,+
chr12,27737544,1.5846858094049106,671,533,1204,+
chr12,27737555,1.1160625866508218,1839,1223,3062,+
chr12,27737557,1.1160625866508218,1839,1223,3062,+
chr12,27737564,2.194407456724368,1029,750,1779,+
chr12,27737580,1.1752308465869437,3334,2762,6096,+
chr12,27755239,1.521501403871731,1000,706,1706,+
chr12,27756087,1.947114577433006,1127,816,1943,+
chr12,27756109,1.7823971693940734,619,475,1094,+
chr12,27756113,0.47604422604422597,619,406,1025,+
chr12,27756161,1.9148514851485148,966,706,1672,+
chr12,27756162,1.9148514851485148,966,706,1672,+
chr12,32710930,2.2579880467113016,612,469,1081,+
chr12,32731122,2.943611939265837,568,446,1014,+
chr12,32745299,0.8078946143462271,804,582,1386,+
chr12,32745300,0.3009092041350106,603,433,1036,+
chr12,42335900,1.0940372997110586,594,422,1016,+
chr12,42335901,1.0940372997110586,594,422,1016,+
chr12,42335902,2.2860338901710033,717,577,1294,+
chr12,42393673,1.3493704840919203,883,599,1482,+
chr12,42441432,1.9488839343712319,1444,984,2428,+
chr12,42441438,2.2423025435073627,1875,1511,3386,+
chr12,42441439,2.1729840595209984,2536,2096,4632,+
chr12,42441440,2.1729840595209984,2536,2096,4632,+
chr12,42441441,2.0818196236356967,3420,2777,6197,+
chr12,42441443,1.8597432659932664,2120,1979,4099,+
chr12,42441445,1.8981598733676293,2230,2165,4395,+
chr12,42441447,1.8504273882379887,2433,2116,4549,+
chr12,45429393,1.8427350970084382,3572,2276,5848,+
chr12,45429457,3.7387692010433775,1547,940,2487,+
chr12,47964219,2.6376005509354457,642,469,1111,+
chr12,47964246,1.6351918335568147,1453,757,2210,+
chr12,47964248,1.6511876205238754,1928,1158,3086,+
chr12,47964288,1.5000000000000002,689,574,1263,+
chr12,47964291,1.7250879688552818,1123,702,1825,+
chr12,47964330,2.050011125945705,856,748,1604,+
chr12,47965305,2.2215988779803646,1187,712,1899,+
chr12,47965311,1.624134195581525,1177,742,1919,+
chr12,47965841,1.6248447204968943,1198,769,1967,+
chr12,47966112,1.3854867728393416,1807,1046,2853,+
chr12,47966135,1.399902763557371,3255,2208,5463,+
chr12,47967227,1.9098605577689245,766,501,1267,+
chr12,47968138,1.7923695367361228,1661,1054,2715,+
chr12,47968143,1.4356595836479342,1209,761,1970,+
chr12,47968144,1.9373827392120075,750,532,1282,+
chr12,47968343,1.7354852232236428,1241,733,1974,+
chr12,47968347,1.5313353454824619,2096,1337,3433,+
chr12,47968354,1.6146782727427889,1411,836,2247,+
chr12,47968415,2.9875269848884622,939,757,1696,+
chr12,47968455,1.4812587023113335,1307,1196,2503,+
chr12,47968649,0.6779188948306595,1216,917,2133,+
chr12,48119358,1.1914927261227073,684,526,1210,+
chr12,48119360,1.1914927261227073,684,526,1210,+
chr12,48119368,2.082960143304971,609,637,1246,+
chr12,48119370,2.082960143304971,609,637,1246,+
chr12,48131351,1.6688,893,749,1642,+
chr12,48131352,1.8935992001525461,1857,1479,3336,+
chr12,48131353,2.790983606557377,680,731,1411,+
chr12,48131355,2.790983606557377,680,731,1411,+
chr12,48132996,1.7573770491803282,669,487,1156,+
chr12,48133020,1.0965382748487271,1625,1165,2790,+
chr12,48133350,1.7390893470790376,652,484,1136,+
chr12,48133355,3.89894419306184,704,458,1162,+
chr12,48134255,0.2733990147783251,702,405,1107,+
chr12,48134742,2.3772481103389254,917,574,1491,+
chr12,48134767,0.5083348825680114,630,488,1118,+
chr12,48134945,2.4074575611086337,979,640,1619,+
chr12,48139287,0.7711552929249473,1077,922,1999,+
chr12,48139288,1.0463536161860183,629,536,1165,+
chr12,48139316,0.6198616600790514,696,505,1201,+
chr12,48141364,0.2888617489008305,656,444,1100,+
chr12,48141752,1.7129411764705884,727,526,1253,+
chr12,48141791,1.7709852709852714,798,517,1315,+
chr12,48142908,2.1957228033846263,1229,756,1985,+
chr12,48142909,2.0596659316365296,1782,1156,2938,+
chr12,48143760,2.3380007366455957,653,633,1286,+
chr12,48143776,1.4134615384615383,636,519,1155,+
chr12,48143777,1.4134615384615383,636,519,1155,+
chr12,48143783,1.6763309804815227,1398,1282,2680,+
chr12,48143784,1.5758426966292134,764,533,1297,+
chr12,48143785,1.060081466395112,1040,981,2021,+
chr12,48144082,1.847034896167844,594,518,1112,+
chr12,48145049,2.193277277484294,794,580,1374,+
chr12,48145055,1.0805416386192126,717,594,1311,+
chr12,48145070,2.114659174897175,1006,742,1748,+
chr12,48145224,2.680050987890376,840,522,1362,+
chr12,48145231,0.6295348077132584,888,547,1435,+
chr12,48145259,0.3927045336112559,627,504,1131,+
chr12,48145568,2.474754836981728,781,606,1387,+
chr12,48145569,2.1541030534351147,644,392,1036,+
chr12,48145611,2.1342857142857143,746,574,1320,+
chr12,48145613,2.0522276356950755,1373,1020,2393,+
chr12,48145695,2.4148061938061938,723,564,1287,+
chr12,48145729,0.4390415785764623,622,472,1094,+
chr12,48145761,0.555282590701975,1756,1181,2937,+
chr12,48145795,1.640457733480989,1009,644,1653,+
chr12,48145812,1.52075725542956,1054,725,1779,+
chr12,48145878,6.750608363265376,4369,3256,7625,+
chr12,48145879,6.750608363265376,4369,3256,7625,+
chr12,48145894,1.6659556313993171,780,585,1365,+
chr12,48145921,1.1543402733098285,1294,1002,2296,+
chr12,48146022,1.5646630236794177,858,548,1406,+
chr12,49265080,0.921894186175427,5177,2240,7417,+
chr12,49265081,0.9108178321032665,6684,2801,9485,+
chr12,49265084,3.4483933787731256,1573,631,2204,+
chr12,49265100,2.4891774891774894,1724,769,2493,+
chr12,49265106,2.227832512315271,1875,927,2802,+
chr12,49265121,2.4695097056567485,9777,5576,15353,+
chr12,49269557,2.172753995928091,1527,958,2485,+
chr12,49269563,2.4336218277834822,789,400,1189,+
chr12,49269564,2.068046560476107,800,393,1193,+
chr12,49269571,1.7609162491052257,1919,1015,2934,+
chr12,49269573,1.7609162491052257,1919,1015,2934,+
chr12,49269575,1.4122575806278794,1116,914,2030,+
chr12,49269576,1.9164441477525591,1377,748,2125,+
chr12,49269578,1.8790948578627669,2391,1723,4114,+
chr12,49269594,1.5623929391598894,3656,2505,6161,+
chr12,49269595,1.9404511320969395,1532,1033,2565,+
chr12,49269597,1.3203376855815159,2354,1353,3707,+
chr12,49269599,1.371657754010695,1804,1253,3057,+
chr12,49269672,1.6616721228909594,2225,1462,3687,+
chr12,49269830,1.5415057691863019,4277,2931,7208,+
chr12,49269831,1.4698671971904504,7705,4958,12663,+
chr12,49269872,1.2572668230690496,3558,2082,5640,+
chr12,49272261,2.841616646658663,865,734,1599,+
chr12,49272350,1.4822771213748658,1379,930,2309,+
chr12,49272363,1.4309105825334139,4449,3048,7497,+
chr12,49272727,1.146816465239727,1515,766,2281,+
chr12,49272728,1.5547138773488236,1931,913,2844,+
chr12,49272730,1.5083844011085419,1680,902,2582,+
chr12,49272743,0.5013795386822646,648,441,1089,+
chr12,49272786,1.6204369224232555,1867,925,2792,+
chr12,49272807,1.700808913308913,2370,1247,3617,+
chr12,49272829,2.102518936057777,2237,1621,3858,+
chr12,49272939,2.171511207519884,1876,1382,3258,+
chr12,49272941,0.7258551307847082,2404,2029,4433,+
chr12,49273014,1.4688405584989606,2894,1613,4507,+
chr12,49273117,1.950418286791564,1426,942,2368,+
chr12,49273120,1.7480438618387408,7138,5310,12448,+
chr12,49273187,1.6332233437814527,5731,4941,10672,+
chr12,49273221,1.0103172551798891,8327,5779,14106,+
chr12,49273222,1.1042040629930665,11638,8842,20480,+
chr12,49323271,0.7231033166627525,1029,729,1758,+
chr12,49323304,0.8063268987193525,1773,973,2746,+
chr12,49323305,0.8899660461304297,1225,656,1881,+
chr12,49323670,2.083726421751116,897,749,1646,+
chr12,49323854,1.944710695539568,913,670,1583,+
chr12,49324249,2.564271907837655,716,596,1312,+
chr12,49460925,1.7719665271966527,1088,716,1804,+
chr12,49460928,0.6062301483229886,1485,836,2321,+
chr12,49460929,1.441949217498183,3216,2283,5499,+
chr12,49460945,1.6217317487266558,1591,1177,2768,+
chr12,49460949,1.341543053545586,3573,2763,6336,+
chr12,49460950,1.3612094347567316,5934,4234,10168,+
chr12,49741554,1.0674333889694327,1183,1038,2221,+
chr12,49741555,0.8643436227897675,2060,1004,3064,+
chr12,49741556,0.9743361922789305,2771,1768,4539,+
chr12,49741561,1.9828501338090991,1601,759,2360,+
chr12,49741569,1.7403225806451614,1078,619,1697,+
chr12,49741570,1.4717526536086765,2052,1041,3093,+
chr12,49741572,1.6775714706749187,1422,1130,2552,+
chr12,49741573,1.3083644702397688,4167,2354,6521,+
chr12,49752487,1.3297266610597138,2900,2049,4949,+
chr12,49752512,0.8112965340179717,3791,2621,6412,+
chr12,49755687,1.3975111126337154,2887,2202,5089,+
chr12,49758414,1.4203533211638393,6374,4294,10668,+
chr12,49758420,0.8648847926267281,3263,2479,5742,+
chr12,49758682,1.5893807193019789,2297,1523,3820,+
chr12,49758688,1.3572263478447808,9878,7290,17168,+
chr12,49758733,0.8222960339821301,4683,3516,8199,+
chr12,49759221,1.4250020419831742,2956,2331,5287,+
chr12,49759287,1.398227978669573,6896,4467,11363,+
chr12,49763133,1.4787797588374727,1938,1564,3502,+
chr12,49763247,1.537548742258582,1595,1188,2783,+
chr12,49763346,1.6266997815824702,2337,1493,3830,+
chr12,49763497,1.498468973123585,2128,1497,3625,+
chr12,49763591,0.791367224642328,3111,2205,5316,+
chr12,49763727,1.4223338348839014,7597,5777,13374,+
chr12,49763728,1.4134498062999634,11069,7849,18918,+
chr12,49763731,1.399616146800443,4230,3372,7602,+
chr12,49763860,1.7003835582373388,5398,4162,9560,+
chr12,49764223,1.3681494190344674,1581,1038,2619,+
chr12,49764255,2.097718969092525,1685,1234,2919,+
chr12,49764266,1.7087994989609134,1714,1300,3014,+
chr12,49764527,1.6980108831531728,2029,1510,3539,+
chr12,49764556,1.3188864296302312,3006,2034,5040,+
chr12,49764734,1.7937927478015416,2462,1463,3925,+
chr12,49764735,1.7937927478015416,2462,1463,3925,+
chr12,49764736,1.0568583482193759,1208,950,2158,+
chr12,49764737,0.6796965178153866,3340,2553,5893,+
chr12,49764738,0.8620136814542003,2424,2030,4454,+
chr12,49764760,1.6570664037743816,1960,1290,3250,+
chr12,49764788,1.2929936305732483,3002,2040,5042,+
chr12,49764812,1.5830977533105193,2431,2067,4498,+
chr12,50090288,3.9196587338487756,684,454,1138,+
chr12,50098800,2.932031544775323,673,446,1119,+
chr12,50100265,7.313840961510843,1124,770,1894,+
chr12,50100266,5.231458832277085,863,572,1435,+
chr12,50100267,7.778938315918396,868,600,1468,+
chr12,50112233,0.5394748313868436,1088,518,1606,+
chr12,50112235,0.7197016320539272,1535,896,2431,+
chr12,50112264,1.5914512156823852,744,546,1290,+
chr12,50120049,1.6852173913043476,645,413,1058,+
chr12,50120067,1.9278752436647175,687,431,1118,+
chr12,50120068,1.7353617060391582,650,472,1122,+
chr12,50120076,1.883952744277628,566,477,1043,+
chr12,50120079,1.9336612284069097,596,520,1116,+
chr12,50120149,1.7775219298245617,558,455,1013,+
chr12,50120151,0.6256288842852914,905,653,1558,+
chr12,50120186,2.25342743571023,816,586,1402,+
chr12,50120284,1.9188326493388053,2103,1461,3564,+
chr12,50120285,1.9188326493388053,2103,1461,3564,+
chr12,50120335,2.9400837257980115,660,587,1247,+
chr12,50437812,2.5095929866010107,616,422,1038,+
chr12,50456661,0.5150399520030543,993,718,1711,+
chr12,50467001,2.8455356963579357,746,531,1277,+
chr12,50474001,2.8420139277150347,669,415,1084,+
chr12,50474002,2.0159570204809953,663,413,1076,+
chr12,50475862,0.5798728694937161,709,525,1234,+
chr12,50475863,0.4926016926016927,693,494,1187,+
chr12,50475864,0.4926016926016927,693,494,1187,+
chr12,50476865,3.0102836879432617,652,469,1121,+
chr12,50476866,3.0102836879432617,652,469,1121,+
chr12,50477139,3.9412345788218404,610,441,1051,+
chr12,50477882,2.672854785478548,626,403,1029,+
chr12,50477883,2.672854785478548,626,403,1029,+
chr12,50478259,3.0923415756263712,899,644,1543,+
chr12,50764139,0.22986111111111115,992,479,1471,+
chr12,50764140,0.9679442444981003,976,490,1466,+
chr12,50764195,1.273365231259968,997,284,1281,+
chr12,50764196,1.273365231259968,997,284,1281,+
chr12,50764224,2.2469969828471537,4331,1298,5629,+
chr12,50764226,2.2046963923247507,3212,936,4148,+
chr12,50764230,2.311886174767061,2134,721,2855,+
chr12,50764231,2.6026314483720414,3526,1100,4626,+
chr12,50764233,2.1912682309179576,6952,2310,9262,+
chr12,50764234,2.1912349048609796,10802,3820,14622,+
chr12,50764235,2.0035417395579604,14478,5282,19760,+
chr12,50764236,1.7846368514179054,12591,4802,17393,+
chr12,50764237,1.8163813053868447,15191,6004,21195,+
chr12,50764238,1.6924634336021627,10814,4274,15088,+
chr12,50764239,1.8622902270483712,2743,1012,3755,+
chr12,50764243,1.7852620355370787,3248,1453,4701,+
chr12,50764246,2.158708762041738,3317,1546,4863,+
chr12,50764249,1.6665760505304803,3931,1967,5898,+
chr12,50764260,6.1058307019417155,20645,14802,35447,+
chr12,50764261,5.692505214362871,28248,23656,51904,+
chr12,50764262,5.113136018994678,33290,29584,62874,+
chr12,50764263,4.674967768791747,26724,25884,52608,+
chr12,50764264,3.8825419565904276,16640,17421,34061,+
chr12,50764266,3.62114557960189,16148,22530,38678,+
chr12,50764267,3.165992678971195,22341,47296,69637,+
chr12,50764268,3.040108980495587,31855,61095,92950,+
chr12,50764269,3.195594582262142,26761,55615,82376,+
chr12,50780150,0.5630252100840336,535,679,1214,+
chr12,50780160,1.6768429771624658,765,625,1390,+
chr12,50780163,1.6289049090284933,729,970,1699,+
chr12,50780201,1.7003300330033004,643,605,1248,+
chr12,50809455,0.5078933747412008,784,551,1335,+
chr12,50809456,2.613636363636364,584,428,1012,+
chr12,50809459,2.9214037063351075,1295,904,2199,+
chr12,50809477,1.551939207111621,1055,753,1808,+
chr12,50809495,1.6175384615384616,750,649,1399,+
chr12,50814116,1.5893869479235334,1025,819,1844,+
chr12,50814301,0.5686306962374489,936,683,1619,+
chr12,50814306,1.6907020872865277,890,679,1569,+
chr12,50814362,1.8243626062322944,783,705,1488,+
chr12,50819666,1.6160535117056856,754,597,1351,+
chr12,50819757,2.0127551020408165,1051,783,1834,+
chr12,50819923,2.458864795918368,700,587,1287,+
chr12,50820065,0.7123287671232876,1143,802,1945,+
chr12,50820648,2.2900485436893203,628,411,1039,+
chr12,50820788,1.81234096692112,813,654,1467,+
chr12,51049051,2.130471792205737,661,504,1165,+
chr12,51049063,2.0858200722117166,795,567,1362,+
chr12,51049143,0.6028963414634146,790,607,1397,+
chr12,51056376,1.9156463166639248,896,681,1577,+
chr12,51058071,1.0945332211942809,963,579,1542,+
chr12,51058072,1.0945332211942809,963,579,1542,+
chr12,51058107,2.216507921131158,834,574,1408,+
chr12,51059432,1.9454218256149878,1201,814,2015,+
chr12,51059621,1.1535845466874823,1012,885,1897,+
chr12,51059676,1.955851522999137,609,476,1085,+
chr12,51059683,1.5332482993197276,948,734,1682,+
chr12,51059710,0.492439184746877,534,506,1040,+
chr12,51060012,0.6437869822485207,1155,883,2038,+
chr12,51060161,0.6044083237234775,1568,1177,2745,+
chr12,51060191,0.4864700516874431,639,428,1067,+
chr12,51060196,0.5896030559707691,709,445,1154,+
chr12,51060234,1.9176515908042506,5125,2885,8010,+
chr12,51238828,0.752349174343168,726,505,1231,+
chr12,51238833,2.739792097352554,724,442,1166,+
chr12,51238860,2.0484934288094467,1177,876,2053,+
chr12,51238863,0.3225991949396205,1121,939,2060,+
chr12,51238864,0.3225991949396205,1121,939,2060,+
chr12,51240344,1.2869370888851408,1326,846,2172,+
chr12,51240345,1.2869370888851408,1326,846,2172,+
chr12,51240346,1.2869370888851408,1326,846,2172,+
chr12,51240355,1.9054054054054053,563,443,1006,+
chr12,51240385,1.7992217254512337,700,548,1248,+
chr12,51240391,1.5572128702322607,1217,721,1938,+
chr12,51240394,1.7641497482441093,1749,1383,3132,+
chr12,51240874,1.8198988195615515,709,592,1301,+
chr12,51240953,1.4230194319880418,1002,668,1670,+
chr12,51240957,1.7380007217610969,671,488,1159,+
chr12,51240994,1.8487003922090008,1544,1227,2771,+
chr12,51240995,1.8487003922090008,1544,1227,2771,+
chr12,51242481,2.3994017068632827,1315,1019,2334,+
chr12,51242551,0.6222127890386406,1551,1046,2597,+
chr12,51242948,1.6371729161046669,1155,673,1828,+
chr12,51243005,1.6002140754616,909,706,1615,+
chr12,51243044,2.2200038767202948,880,736,1616,+
chr12,51243062,1.8152812762384551,919,793,1712,+
chr12,51243110,1.823996221067548,897,729,1626,+
chr12,51243115,0.7290759554910498,1506,1130,2636,+
chr12,51243180,2.3802024746906643,1103,888,1991,+
chr12,51243231,1.9853407723443828,1046,830,1876,+
chr12,51243438,1.8098415346121766,929,762,1691,+
chr12,51243610,1.5964276273554625,1690,1260,2950,+
chr12,51243611,1.5639187987028897,3103,2143,5246,+
chr12,52051440,1.0073099097611735,1017,1833,2850,+
chr12,52054952,3.9749822797329597,642,461,1103,+
chr12,52054998,1.7030902426693633,578,454,1032,+
chr12,52058864,1.9151382243487503,1252,1367,2619,+
chr12,52058866,2.100819671999563,2499,2655,5154,+
chr12,52058867,2.214003726335813,1353,1632,2985,+
chr12,52058870,1.4061393152302244,793,725,1518,+
chr12,52058921,1.2392803718476033,738,623,1361,+
chr12,52059292,5.115315934065934,918,538,1456,+
chr12,52059296,13.501903367317777,1227,895,2122,+
chr12,52070075,12.139199242678536,1596,1237,2833,+
chr12,52070076,12.139199242678536,1596,1237,2833,+
chr12,52070081,0.5628114953365367,1062,1123,2185,+
chr12,52070362,3.5122144504799473,853,506,1359,+
chr12,52070432,4.435872307983602,1024,843,1867,+
chr12,52073702,5.233618859255828,1047,533,1580,+
chr12,52073705,10.627916047386513,767,533,1300,+
chr12,52073708,7.908766963483749,769,679,1448,+
chr12,52077198,1.6363425850603184,591,431,1022,+
chr12,52077361,1.8163268610190353,1225,899,2124,+
chr12,52233242,0.7601746532850253,926,481,1407,+
chr12,52233256,2.069380166923777,1188,476,1664,+
chr12,52233258,2.477116476772664,1471,698,2169,+
chr12,52233273,2.0129154795821464,756,350,1106,+
chr12,52233296,2.1644374366343824,1387,869,2256,+
chr12,52233306,0.5610128400826075,780,517,1297,+
chr12,52233319,1.7241632413388135,782,523,1305,+
chr12,52233451,2.017568827599745,1141,496,1637,+
chr12,52233452,2.017568827599745,1141,496,1637,+
chr12,52233455,1.856319588205673,1251,585,1836,+
chr12,52233456,1.856319588205673,1251,585,1836,+
chr12,52233491,1.6652303612860455,784,430,1214,+
chr12,52233492,1.551066847296897,1450,1026,2476,+
chr12,52233494,1.5396611310009165,2101,1439,3540,+
chr12,52233497,1.2276492000211017,1030,766,1796,+
chr12,52233504,1.036132721873251,2377,1812,4189,+
chr12,52233506,1.051578384162654,3169,1601,4770,+
chr12,52233507,1.051578384162654,3169,1601,4770,+
chr12,52233590,0.6082019401900083,1276,972,2248,+
chr12,52233593,0.6907390084190832,1419,1068,2487,+
chr12,52235173,1.3602214054432484,1573,1171,2744,+
chr12,52235175,1.4634146341463417,1903,1147,3050,+
chr12,52235193,1.5743015317074744,1598,1168,2766,+
chr12,52235251,1.6700448190514414,2037,1207,3244,+
chr12,52235331,1.5147859101455388,1527,861,2388,+
chr12,52237510,1.8678876187567022,1453,1164,2617,+
chr12,52237517,1.0930820995234027,5098,3600,8698,+
chr12,52237518,1.1854691144924734,4834,3152,7986,+
chr12,52237519,0.9126356444189757,3163,2595,5758,+
chr12,52237549,1.717920426849351,1556,1291,2847,+
chr12,52238700,1.8553050014455048,1509,1152,2661,+
chr12,52238734,1.7205386872843245,3599,2646,6245,+
chr12,52238737,1.4192660731422044,4302,2993,7295,+
chr12,52241499,1.3421846205394536,2288,1396,3684,+
chr12,52243074,2.0973658185741257,1706,1361,3067,+
chr12,52243081,1.505893028951281,2118,1235,3353,+
chr12,52245523,1.6393677133252271,1145,901,2046,+
chr12,52245524,1.4135401333896742,3939,2524,6463,+
chr12,52245525,1.6914332671368897,2963,1717,4680,+
chr12,52245526,1.6367358556664913,1266,1037,2303,+
chr12,52245543,0.6614902339040271,2666,2029,4695,+
chr12,52245545,0.6614902339040271,2666,2029,4695,+
chr12,52245556,1.573054345532844,1863,1278,3141,+
chr12,52248597,0.5288630012104835,1966,1523,3489,+
chr12,52248613,1.5093872229465448,907,766,1673,+
chr12,52248652,1.5735263268302917,1153,680,1833,+
chr12,52248661,1.4949494949494953,1183,719,1902,+
chr12,52248712,1.6633585646201288,1140,869,2009,+
chr12,52248790,1.8418937805730258,810,635,1445,+
chr12,52248794,2.8303495311167945,1244,764,2008,+
chr12,52248803,1.5473799275807882,780,713,1493,+
chr12,52248810,1.5667538192775323,1908,1272,3180,+
chr12,52949120,0.48783390883167604,4050,2844,6894,+
chr12,52949134,1.111872146118721,973,656,1629,+
chr12,52949135,1.111872146118721,973,656,1629,+
chr12,52949158,1.7778685570106936,1297,1014,2311,+
chr12,52949259,3.442127965492452,854,534,1388,+
chr12,52949275,2.1650874946649594,2237,1064,3301,+
chr12,52949277,1.6616326453128205,3800,1918,5718,+
chr12,52949279,1.675813815724124,4293,2598,6891,+
chr12,52949306,1.858499234303216,1311,652,1963,+
chr12,52949329,0.5828810020876826,1395,957,2352,+
chr12,52949356,4.554103539886551,1474,732,2206,+
chr12,52949370,1.8508090614886732,930,720,1650,+
chr12,52949380,10.29754037409815,6019,4952,10971,+
chr12,52949381,9.877314942766127,7593,5927,13520,+
chr12,52949405,0.9069449832202523,2138,2061,4199,+
chr12,52950331,0.7988464800678541,3087,2357,5444,+
chr12,52950335,0.6538559899448332,6143,4168,10311,+
chr12,52950784,1.5264392897710288,2490,1555,4045,+
chr12,52950804,2.1857791791363828,3436,2338,5774,+
chr12,52951482,1.3888422418643602,3514,1903,5417,+
chr12,52951487,2.334486934460788,2908,1431,4339,+
chr12,52951501,1.5274158248383107,6219,2882,9101,+
chr12,52951502,1.4410372780781078,10090,5368,15458,+
chr12,52951503,1.5274158248383107,6219,2882,9101,+
chr12,52951529,0.4529505582137161,709,626,1335,+
chr12,52951549,1.297986901959929,6526,4778,11304,+
chr12,52951561,1.013017182083352,28877,18277,47154,+
chr12,52951562,1.0704495855911966,33482,20970,54452,+
chr12,52951586,0.8757104942397673,10630,5799,16429,+
chr12,52951606,1.4293173246580757,30054,17255,47309,+
chr12,52951607,1.5057668413057819,57305,35069,92374,+
chr12,52951729,0.7234841823797875,941,714,1655,+
chr12,52951737,1.8142626913779207,2393,1532,3925,+
chr12,52952124,1.295394393954237,1843,1094,2937,+
chr12,52952129,1.935725703324808,2221,1471,3692,+
chr12,52952131,1.8907789771189163,5096,3264,8360,+
chr12,52952133,1.5338352261185,2979,2081,5060,+
chr12,52952254,1.524175140070554,1694,1421,3115,+
chr12,52952295,1.6392295592163013,2200,1338,3538,+
chr12,52952304,1.1156083922048334,2645,1573,4218,+
chr12,52952323,1.309347268664356,7385,5206,12591,+
chr12,52952324,1.2924505834722553,4049,2469,6518,+
chr12,53016545,1.8323543123543125,577,428,1005,+
chr12,53016547,1.8839285714285712,632,383,1015,+
chr12,53016549,1.894007828967179,849,404,1253,+
chr12,53016552,1.7622153861751781,2513,1474,3987,+
chr12,53016553,1.641115564462258,1584,997,2581,+
chr12,53016557,0.6578343481320564,859,666,1525,+
chr12,53016561,1.6580157687253616,2841,1521,4362,+
chr12,53016563,1.693287591875545,3826,2322,6148,+
chr12,53016564,0.6640546630362866,2623,2088,4711,+
chr12,53016565,0.6640546630362866,2623,2088,4711,+
chr12,53018814,0.8058052397624013,2849,2310,5159,+
chr12,53021809,1.2461300309597525,804,458,1262,+
chr12,53021811,1.2461300309597525,804,458,1262,+
chr12,53021812,1.1665395511004577,930,705,1635,+
chr12,53021814,1.1665395511004577,930,705,1635,+
chr12,53021821,0.7523380465973803,1099,845,1944,+
chr12,53021823,1.6164541252225841,1633,1048,2681,+
chr12,53022544,1.3869738751814225,3684,2755,6439,+
chr12,53027781,1.722245719504307,1191,570,1761,+
chr12,53027787,1.6170481452249408,787,361,1148,+
chr12,53027796,1.35180412371134,1048,581,1629,+
chr12,53027802,2.2652894491129785,1492,713,2205,+
chr12,53028016,2.1753694581280794,1055,637,1692,+
chr12,53028017,2.0657190794263824,1651,1018,2669,+
chr12,53028018,1.0522248345524208,1380,695,2075,+
chr12,53028019,1.5755280498400412,3833,2205,6038,+
chr12,53028026,0.5600773943889068,667,442,1109,+
chr12,53028040,1.1276209677419355,2022,1239,3261,+
chr12,53028041,1.0432176981445178,4673,2702,7375,+
chr12,53028043,0.9763146689376198,2651,1463,4114,+
chr12,53028045,1.614800759013283,965,713,1678,+
chr12,53028047,0.6842246888664648,1452,990,2442,+
chr12,53028048,1.431725915556967,3051,1857,4908,+
chr12,53028071,1.7533829381459873,7997,5589,13586,+
chr12,53028077,1.8530023160559455,6744,4834,11578,+
chr12,53028101,1.2931696974186142,2428,2076,4504,+
chr12,53033833,1.2372887448721597,8817,6091,14908,+
chr12,53033941,1.8595591542959962,1878,974,2852,+
chr12,53033947,1.5159763313609467,3527,2365,5892,+
chr12,53033949,1.5101371894697817,5358,3624,8982,+
chr12,53033950,1.491976907473865,3621,2464,6085,+
chr12,53033953,1.3255444864707127,6196,4446,10642,+
chr12,53033955,1.3368673023121205,3982,2826,6808,+
chr12,53033956,1.8666375100225965,1753,1344,3097,+
chr12,53033967,1.4449380406827217,2279,1785,4064,+
chr12,53033976,1.5433942691407947,2557,2196,4753,+
chr12,53033981,1.7134495938843763,2868,2547,5415,+
chr12,53034635,1.613974383488125,4761,2787,7548,+
chr12,53034662,1.5581582548498751,2977,1615,4592,+
chr12,53034672,1.436892550160493,6167,4020,10187,+
chr12,53037517,2.5073280885780886,1032,528,1560,+
chr12,53037542,1.2676896845694798,1486,712,2198,+
chr12,53037543,1.5940105826829276,2164,1144,3308,+
chr12,53037547,1.683534549190855,903,457,1360,+
chr12,53037555,2.148476782017154,2042,1126,3168,+
chr12,53037556,2.148476782017154,2042,1126,3168,+
chr12,53037561,1.4868512684463604,1018,814,1832,+
chr12,53037562,1.5123124118989806,2007,1332,3339,+
chr12,53037566,1.8239456354210453,1269,792,2061,+
chr12,53037569,1.8649513052498128,1725,1035,2760,+
chr12,53037587,1.0449373565110305,3261,2339,5600,+
chr12,53038363,1.703930393039304,1831,1211,3042,+
chr12,53039235,1.372757980863805,1540,1185,2725,+
chr12,53039237,1.4644805930196645,2288,1765,4053,+
chr12,53039238,1.4837694994605073,2153,1656,3809,+
chr12,53039239,0.5327213772288608,4055,2936,6991,+
chr12,53039241,0.6143403623028042,4892,3364,8256,+
chr12,53039243,1.037819142068935,7456,4820,12276,+
chr12,53039245,1.232453267526568,5274,3454,8728,+
chr12,53039246,1.4851945420889834,3040,2493,5533,+
chr12,53039247,1.4851945420889834,3040,2493,5533,+
chr12,53039250,1.0191268584123796,4017,3010,7027,+
chr12,53040208,1.5510841836734692,736,391,1127,+
chr12,53040226,3.4887285164427704,680,392,1072,+
chr12,53040267,1.465109431740112,1243,885,2128,+
chr12,53040268,1.6861515766181083,761,560,1321,+
chr12,53040275,1.5828402366863905,855,506,1361,+
chr12,53040279,1.7362586143756034,1967,1225,3192,+
chr12,53040280,1.5292364691801503,4794,3348,8142,+
chr12,53040284,1.424505928853755,1155,781,1936,+
chr12,53040291,2.022360444059523,1426,976,2402,+
chr12,53040298,1.4566099523029827,2211,1276,3487,+
chr12,53040308,1.4247206243759132,8177,5044,13221,+
chr12,53040310,1.4045862952680233,6189,3591,9780,+
chr12,53040311,1.327096670934699,2240,1703,3943,+
chr12,53040423,1.604319627998042,2016,1361,3377,+
chr12,53040532,0.5099820744437805,1706,1236,2942,+
chr12,53040588,5.590160777315824,11242,7775,19017,+
chr12,53040591,5.151793255713467,11320,8792,20112,+
chr12,53040796,1.4385007517261608,7290,4850,12140,+
chr12,53040797,1.4385007517261608,7290,4850,12140,+
chr12,53040877,1.4890756302521009,885,594,1479,+
chr12,53040893,1.5075406831869538,2674,1639,4313,+
chr12,53040975,1.6898020798389797,1736,1083,2819,+
chr12,53041010,1.4929464805119257,2932,1718,4650,+
chr12,53041011,0.8515601558091199,4686,3394,8080,+
chr12,53041178,1.4249358253440718,3294,2388,5682,+
chr12,53041256,1.4959173908344219,6738,4647,11385,+
chr12,53041383,1.6189891549007567,4084,2564,6648,+
chr12,53041582,1.6931009253281688,2137,1548,3685,+
chr12,53041769,1.7603911980440101,719,408,1127,+
chr12,53041793,1.4126274107208332,1375,1048,2423,+
chr12,53041812,1.4933644777427042,2684,1527,4211,+
chr12,53041824,1.6355585186959856,3274,1977,5251,+
chr12,53041831,1.5979993281009335,3016,2215,5231,+
chr12,53041834,1.5139283230139455,1561,1270,2831,+
chr12,53041838,1.4344505454009433,2638,1695,4333,+
chr12,53041841,1.6203161592505857,2024,1463,3487,+
chr12,53153257,0.5169645805394966,6010,5256,11266,+
chr12,53180763,4.587090935642042,693,399,1092,+
chr12,53180764,4.587090935642042,693,399,1092,+
chr12,53180773,4.083203899682339,847,614,1461,+
chr12,53180774,4.083203899682339,847,614,1461,+
chr12,53180782,7.310568631959478,1432,1124,2556,+
chr12,53180783,8.449806326386083,1920,1640,3560,+
chr12,53180784,8.449806326386083,1920,1640,3560,+
chr12,53180792,4.037510432494666,1098,1219,2317,+
chr12,53186474,1.7779634607607584,1768,1323,3091,+
chr12,53186475,1.7457130401972312,2418,1856,4274,+
chr12,53186476,1.2448012403695743,4360,2798,7158,+
chr12,53186477,1.2100688250024392,3515,2263,5778,+
chr12,53190042,8.237441672220486,369,810,1179,+
chr12,53295541,0.8226455368077114,3606,2136,5742,+
chr12,53295543,0.8072598145590847,1022,739,1761,+
chr12,53295547,0.7345241300900578,1472,856,2328,+
chr12,53295550,1.4313987147109963,3940,2239,6179,+
chr12,53295557,1.4443465013212164,5845,3819,9664,+
chr12,53295564,1.3686355438401776,2132,1087,3219,+
chr12,53295567,1.521098433373332,4796,2828,7624,+
chr12,53295576,1.2838009255614171,2934,1953,4887,+
chr12,53295578,1.3329150136291257,2883,1610,4493,+
chr12,53295582,1.2399585098870056,3304,1887,5191,+
chr12,53295583,1.617323128616763,2127,1947,4074,+
chr12,53296247,1.2644872722488982,3203,1982,5185,+
chr12,53297849,1.5867225096101731,6445,4744,11189,+
chr12,53297850,1.7430224129291514,4239,2978,7217,+
chr12,53297853,1.7035590277777781,2354,1727,4081,+
chr12,53297910,1.3641521753818031,5696,4204,9900,+
chr12,53298043,0.643172252862051,802,532,1334,+
chr12,53298108,1.2579216710144128,7261,5179,12440,+
chr12,53299355,1.4342683503191578,4450,3281,7731,+
chr12,53414529,13.789941941475346,726,542,1268,+
chr12,53441738,1.174370756434818,1292,735,2027,+
chr12,53441739,1.2599192549869154,1426,819,2245,+
chr12,53441740,1.3889090870206804,737,436,1173,+
chr12,53446188,2.9192982456140357,639,474,1113,+
chr12,53446215,1.8787733843537415,666,447,1113,+
chr12,53446222,2.292834890965732,735,534,1269,+
chr12,53446249,1.1119627271873722,1663,1239,2902,+
chr12,53446374,2.4023419203747074,668,426,1094,+
chr12,53446376,2.886067708333333,681,383,1064,+
chr12,53452344,1.3034060069859013,767,510,1277,+
chr12,53452350,0.9797453321897472,899,658,1557,+
chr12,53452352,0.9797453321897472,899,658,1557,+
chr12,53454725,1.673980664144599,1047,609,1656,+
chr12,53454732,1.7976954732510289,1466,1214,2680,+
chr12,53454733,2.671608168011046,1312,833,2145,+
chr12,53454734,1.9209535276560366,2268,1802,4070,+
chr12,53454743,1.4622454048683555,1623,1055,2678,+
chr12,53454785,1.526180527921475,2217,1435,3652,+
chr12,53455460,0.4884331546740487,645,506,1151,+
chr12,53455465,0.7703287880155957,1148,841,1989,+
chr12,53455466,1.3109879032258065,1733,1983,3716,+
chr12,53455467,1.3109879032258065,1733,1983,3716,+
chr12,53455468,1.8752833101853448,1550,1247,2797,+
chr12,53455470,1.4283360790774302,1019,1213,2232,+
chr12,53455475,0.6617740471869329,940,759,1699,+
chr12,53455478,1.1731621158823005,3260,2576,5836,+
chr12,53455479,1.0279603883460853,2175,1728,3903,+
chr12,53455895,0.529946452731673,1853,2163,4016,+
chr12,53455906,0.7655549827497323,2429,2717,5146,+
chr12,53455925,1.3348740027858679,3634,3179,6813,+
chr12,53455926,0.9326518080471545,12328,11329,23657,+
chr12,53455927,0.7892578562409167,8407,8229,16636,+
chr12,53455929,1.2950911473847253,4466,3596,8062,+
chr12,53455930,1.0390027096151953,9379,8616,17995,+
chr12,53459345,1.7598845733168882,3150,1771,4921,+
chr12,53459392,0.6777081237262338,1419,1061,2480,+
chr12,53461126,0.6524985730258889,1668,1436,3104,+
chr12,53462547,1.728185078617357,3279,2124,5403,+
chr12,53462553,1.2579314961746608,3464,2358,5822,+
chr12,53464762,1.6658855038500169,932,617,1549,+
chr12,53464820,0.963890958768008,1773,1341,3114,+
chr12,53464822,1.2975550472490347,2985,2036,5021,+
chr12,53465940,0.7375261395772161,1972,1512,3484,+
chr12,53467222,1.6550401116149287,1824,1174,2998,+
chr12,53467257,1.0245317716441942,4347,3376,7723,+
chr12,53471638,1.5598667450519297,1591,1052,2643,+
chr12,53471649,1.5204887519089372,6486,4338,10824,+
chr12,53471650,1.5559509687623567,3934,2809,6743,+
chr12,53471766,0.4620058776921863,1363,916,2279,+
chr12,53471787,0.48784210526315785,712,499,1211,+
chr12,53471789,0.512697323266987,829,619,1448,+
chr12,53471794,1.7255082730845748,826,556,1382,+
chr12,53479406,2.054491413748812,2314,1447,3761,+
chr12,53479433,1.6365615173583552,3406,2305,5711,+
chr12,53479440,1.507836559741964,2784,1992,4776,+
chr12,53479442,2.045591397849462,1311,929,2240,+
chr12,53479450,1.2665462995469516,2211,1523,3734,+
chr12,53479454,1.3087427125483506,2497,1758,4255,+
chr12,53479490,1.4861928439838301,5894,4321,10215,+
chr12,53479491,1.4762562657769442,11702,9009,20711,+
chr12,53479676,1.6165276329509906,1695,1095,2790,+
chr12,53479677,1.6795917285339759,3151,2128,5279,+
chr12,53479678,1.7834428945540053,2981,2078,5059,+
chr12,53479679,1.4983038429308349,3608,2518,6126,+
chr12,53479680,1.4977869567194417,3046,2160,5206,+
chr12,53479688,1.132736518039307,1315,1086,2401,+
chr12,53479700,2.0800320586214798,981,793,1774,+
chr12,53479702,1.4837712519319937,1279,1293,2572,+
chr12,53479709,0.7004558558302683,1297,1050,2347,+
chr12,53479714,1.450982425389088,6929,6782,13711,+
chr12,53479716,1.3539349609248852,4917,5160,10077,+
chr12,53479717,1.3448616153477044,3375,3562,6937,+
chr12,53479718,0.7609584916011235,2526,2502,5028,+
chr12,53479724,0.5680451977401129,3141,2949,6090,+
chr12,53479728,0.7298071702155761,3649,3283,6932,+
chr12,53479746,1.6849585087484489,2884,3160,6044,+
chr12,53989171,1.0945367219558098,1391,906,2297,+
chr12,53989172,0.8960015635289325,1729,1182,2911,+
chr12,53989245,0.4898060358183056,607,488,1095,+
chr12,53989270,0.5265423242467718,733,577,1310,+
chr12,53989271,2.507790143084261,716,554,1270,+
chr12,53989577,2.3187327438953993,708,473,1181,+
chr12,53989627,0.5071827436388184,1112,651,1763,+
chr12,53989666,13.993041515454022,820,375,1195,+
chr12,53989674,3.2280159036571243,1254,632,1886,+
chr12,53989675,2.9081748331024064,887,466,1353,+
chr12,53989691,9.264078279634123,1977,1283,3260,+
chr12,53989692,8.62793038986332,2791,1885,4676,+
chr12,53989722,1.5113670039371745,1699,1494,3193,+
chr12,53989723,1.1746348726325115,2756,2241,4997,+
chr12,53989725,0.4030168034388433,1356,852,2208,+
chr12,53989726,0.4030168034388433,1356,852,2208,+
chr12,53989829,1.8116407554927405,1409,1085,2494,+
chr12,53989831,1.8116407554927405,1409,1085,2494,+
chr12,53989849,2.133720485978452,715,568,1283,+
chr12,54280738,1.3386574373546385,2036,1665,3701,+
chr12,54282845,2.9475104112518298,2471,3638,6109,+
chr12,54282846,2.9475104112518298,2471,3638,6109,+
chr12,54282847,2.376862708320026,3022,4704,7726,+
chr12,54282849,2.0364702627645803,1662,3588,5250,+
chr12,54282850,1.0249590305330345,1005,1363,2368,+
chr12,54282851,1.0755174689506888,4170,7619,11789,+
chr12,54282852,0.9957878221099987,4992,8896,13888,+
chr12,54282853,0.8583374134213045,2861,5363,8224,+
chr12,54282854,0.4217892029852615,3860,7198,11058,+
chr12,54282855,0.45832555244319956,1193,1376,2569,+
chr12,54282856,0.40561376477852834,3867,6429,10296,+
chr12,54282858,0.4756641432904637,4601,7348,11949,+
chr12,54282859,0.5116221788349367,3485,5362,8847,+
chr12,54282860,0.5355002669936515,1640,2570,4210,+
chr12,54282863,0.3848692561563849,757,1211,1968,+
chr12,54283176,3.299280339693872,1018,733,1751,+
chr12,54283811,0.8417303882819999,7183,6291,13474,+
chr12,54283812,1.0446388294342253,5573,4625,10198,+
chr12,54283813,0.6990381819595064,4259,4396,8655,+
chr12,54283814,0.658151957053137,4906,4888,9794,+
chr12,54283815,0.6592475716635964,9382,7760,17142,+
chr12,54283816,0.6639707901460067,17013,14705,31718,+
chr12,54283818,0.6422135659843441,7837,6733,14570,+
chr12,54283830,1.8182285879703433,6761,6801,13562,+
chr12,54283832,2.3285602585487912,8673,9591,18264,+
chr12,54283833,2.6362360331770294,14829,14768,29597,+
chr12,54283834,2.5468086547167306,6636,7522,14158,+
chr12,54284283,1.6569296987087518,801,696,1497,+
chr12,54284700,1.0020325203252034,679,491,1170,+
chr12,54284701,0.6013636363636363,587,439,1026,+
chr12,54284702,1.4201704880337271,1063,684,1747,+
chr12,54284708,1.7929292929292926,709,557,1266,+
chr12,54284712,2.3175665399239542,1603,1314,2917,+
chr12,54284713,2.3175665399239542,1603,1314,2917,+
chr12,54284723,1.2277131782945736,1266,863,2129,+
chr12,54284724,1.2277131782945736,1266,863,2129,+
chr12,54284728,1.7002692429521695,1262,1147,2409,+
chr12,54284743,1.5665465390828883,1145,618,1763,+
chr12,54284747,1.430470914127424,1290,721,2011,+
chr12,54284753,1.4807230606122843,3514,2966,6480,+
chr12,54284767,1.3040262582056892,2153,1370,3523,+
chr12,54284789,0.7575124187831594,3585,2470,6055,+
chr12,54285084,1.7913193446392643,759,496,1255,+
chr12,54285085,1.7913193446392643,759,496,1255,+
chr12,54285097,1.599120903738351,1076,697,1773,+
chr12,54285103,2.467462456680786,711,370,1081,+
chr12,54285105,1.7720847823145043,1082,594,1676,+
chr12,54285108,2.9605097545626182,606,453,1059,+
chr12,54285110,0.8780555555555556,1307,719,2026,+
chr12,54285111,0.8780555555555556,1307,719,2026,+
chr12,54285112,0.8780555555555556,1307,719,2026,+
chr12,54285113,2.180499325236167,1404,1139,2543,+
chr12,54285114,2.180499325236167,1404,1139,2543,+
chr12,54285116,0.4389156056834898,1179,754,1933,+
chr12,54285120,2.1450617283950617,694,512,1206,+
chr12,54285124,1.874577337422348,768,470,1238,+
chr12,54285151,0.9781346990984038,2631,2017,4648,+
chr12,54285905,2.0791252603214434,394,1933,2327,+
chr12,54285906,2.0711035556677864,267,1126,1393,+
chr12,54285907,1.7449844806505088,355,1764,2119,+
chr12,54285908,0.06174316756808501,214,1228,1442,+
chr12,54285915,0.974356194579475,387,2092,2479,+
chr12,54285916,0.8197833126968559,481,2596,3077,+
chr12,54285917,0.7002780260152914,216,1118,1334,+
chr12,54285918,0.26675064877614174,378,1754,2132,+
chr12,54285919,0.24066797642436147,195,1017,1212,+
chr12,54285925,0.17066074863941205,533,1610,2143,+
chr12,54285961,0.16655201137409048,608,1267,1875,+
chr12,54285963,0.17766003559163993,896,2035,2931,+
chr12,54285964,0.1711003093239063,483,1094,1577,+
chr12,54286579,12.59051644907945,850,313,1163,+
chr12,54286590,9.095591590488008,780,544,1324,+
chr12,54286599,8.025765287966474,1304,1658,2962,+
chr12,54286600,7.739073194462035,2328,3100,5428,+
chr12,54286601,7.739073194462036,2328,3100,5428,+
chr12,54286602,7.381306574390943,1904,2707,4611,+
chr12,54286626,0.2933450899475945,726,1399,2125,+
chr12,54286627,0.34179898758274563,394,796,1190,+
chr12,54286705,1.7389352948510164,633,616,1249,+
chr12,54325134,1.3121686861037487,622,555,1177,+
chr12,54325138,1.0541163888343297,2106,1644,3750,+
chr12,54325160,0.9620253814897414,2952,2654,5606,+
chr12,54342206,1.755158388219205,3049,2085,5134,+
chr12,54343225,2.0270259850412526,1420,1178,2598,+
chr12,54343227,1.5056110118734896,1768,1534,3302,+
chr12,54347769,1.7352098642421223,1160,867,2027,+
chr12,54349621,1.807704160246533,837,648,1485,+
chr12,54349624,1.6042615188490257,1148,866,2014,+
chr12,54349637,1.4252336178273606,2635,2189,4824,+
chr12,54350522,1.7607884127221145,1071,904,1975,+
chr12,54350578,0.6876396396396397,1420,1294,2714,+
chr12,54350640,1.5712107349801767,1287,1092,2379,+
chr12,54350986,6.230189732142858,1653,447,2100,+
chr12,54350987,7.5055176037835,2483,691,3174,+
chr12,54350988,7.545998669917978,1479,346,1825,+
chr12,54350989,8.825668216861006,5181,1426,6607,+
chr12,54350990,4.560059317844785,2049,577,2626,+
chr12,54350992,17.92491014429005,5391,4582,9973,+
chr12,54350993,15.533802852277427,7750,8073,15823,+
chr12,54350994,13.556256467440102,8603,9409,18012,+
chr12,54350996,7.691727272727272,1658,2624,4282,+
chr12,54351007,0.5296478755808022,3727,7170,10897,+
chr12,54351157,1.4121979286536248,1039,789,1828,+
chr12,54351534,0.34981818181818186,1035,699,1734,+
chr12,54351553,1.5591721427255418,1153,856,2009,+
chr12,54351621,2.2221140322406145,892,710,1602,+
chr12,55719113,1.0900905374315175,1779,1322,3101,+
chr12,55719114,1.8922904720760347,1160,877,2037,+
chr12,55719115,1.4081289311393574,2939,2199,5138,+
chr12,55719613,4.142838898011312,644,427,1071,+
chr12,55819429,2.292955908289242,620,430,1050,+
chr12,55820284,1.3903658177628222,1079,876,1955,+
chr12,55820285,0.9373236379422618,750,541,1291,+
chr12,55820428,10.09437944041027,927,566,1493,+
chr12,55820430,9.213474156426082,1291,858,2149,+
chr12,55966819,6.1233901863850395,640,531,1171,+
chr12,55966838,0.304681514519025,2253,1636,3889,+
chr12,55966846,0.6416874587742694,894,590,1484,+
chr12,55966899,1.9523732251521297,1233,724,1957,+
chr12,55966911,1.5345465496472208,1345,893,2238,+
chr12,55966934,2.037135278514589,1223,492,1715,+
chr12,55966940,1.6881053226075895,3152,1867,5019,+
chr12,55966949,1.5992825490609832,1572,676,2248,+
chr12,55966956,1.3973100585682543,3944,1964,5908,+
chr12,55966985,1.7976170963412894,20000,12703,32703,+
chr12,55966986,1.9407633962897628,14256,8607,22863,+
chr12,55966992,1.6069780830620184,4678,2569,7247,+
chr12,55967063,2.5801282051282053,629,431,1060,+
chr12,55967104,1.54311986863711,690,434,1124,+
chr12,55967875,1.7577092511013217,664,453,1117,+
chr12,55967912,2.051565557729941,722,510,1232,+
chr12,55968114,0.4848963310757469,777,586,1363,+
chr12,55968116,0.5773286467486819,656,568,1224,+
chr12,55968785,2.125391359252684,1038,738,1776,+
chr12,55968853,1.241356810780532,1321,1026,2347,+
chr12,55968860,1.7776095531853913,1400,947,2347,+
chr12,55968863,1.7565913370998116,573,471,1044,+
chr12,55969522,1.682432432432433,580,443,1023,+
chr12,55971056,0.2362309851455484,976,748,1724,+
chr12,55971057,0.4833038017666375,2832,2071,4903,+
chr12,55971059,1.08426103646833,1344,1041,2385,+
chr12,55971060,1.8782058881643946,913,722,1635,+
chr12,55971077,1.7737003058103975,753,435,1188,+
chr12,55971101,0.6236451048951049,750,519,1269,+
chr12,55971138,0.6207346229080635,679,534,1213,+
chr12,55971144,0.5554928305295247,614,520,1134,+
chr12,55971173,1.4192378350369776,912,597,1509,+
chr12,55971540,3.003448275862069,870,579,1449,+
chr12,55971542,3.003448275862069,870,579,1449,+
chr12,55971763,1.9281376518218627,634,493,1127,+
chr12,55972011,2.666770186335404,830,482,1312,+
chr12,55972031,2.00964884530212,1088,653,1741,+
chr12,55972061,2.216800804828974,677,496,1173,+
chr12,55972182,1.9450418160095584,791,557,1348,+
chr12,55972210,0.36990196078431375,685,509,1194,+
chr12,55972235,2.382292047253684,630,482,1112,+
chr12,55972302,2.200306689668392,882,563,1445,+
chr12,55972358,1.4539978094194959,1124,829,1953,+
chr12,55972395,3.2740422984836397,886,715,1601,+
chr12,55972617,1.0582467532467534,757,559,1316,+
chr12,55972618,1.0582467532467534,757,559,1316,+
chr12,55972634,2.990766391267946,720,573,1293,+
chr12,55991369,0.7135802469135802,645,569,1214,+
chr12,55992639,0.9583213749639062,1103,814,1917,+
chr12,55992947,2.625329556290705,639,406,1045,+
chr12,55993045,2.273324027423474,613,472,1085,+
chr12,55993205,2.5703474161813444,577,509,1086,+
chr12,55993593,0.48863250763488303,599,420,1019,+
chr12,56104604,1.0837894736842106,584,474,1058,+
chr12,56104606,1.0837894736842106,584,474,1058,+
chr12,56104706,3.237670968617419,3878,3233,7111,+
chr12,56104707,3.281560986383689,3535,2965,6500,+
chr12,56104708,2.830403187998125,1557,1421,2978,+
chr12,56104727,1.9021463189476118,633,618,1251,+
chr12,56104734,1.6812920875420874,840,647,1487,+
chr12,56104767,1.7403098106712565,765,580,1345,+
chr12,56104795,0.6484852571017621,994,823,1817,+
chr12,56104801,1.5986394557823134,999,839,1838,+
chr12,56106633,1.868574884095948,617,450,1067,+
chr12,56106648,2.5936454849498327,704,597,1301,+
chr12,56107186,2.9600161550888533,1046,618,1664,+
chr12,56109242,2.663915094339623,752,476,1228,+
chr12,56109243,0.6388051879994759,635,448,1083,+
chr12,56109270,1.5736810187992722,1037,775,1812,+
chr12,56110574,1.5626660178031917,1242,966,2208,+
chr12,56110576,1.3505175841502708,1575,1005,2580,+
chr12,56110584,1.943633952254642,976,753,1729,+
chr12,56111182,1.3503203217153583,1358,870,2228,+
chr12,56111189,2.061865189289012,2001,1082,3083,+
chr12,56111190,2.061865189289012,2001,1082,3083,+
chr12,56111196,1.5530973451327434,740,564,1304,+
chr12,56111202,2.1572106261859583,1286,929,2215,+
chr12,56111203,2.1572106261859583,1286,929,2215,+
chr12,56111502,1.9460550250113688,834,732,1566,+
chr12,56112902,1.888535031847134,592,470,1062,+
chr12,56112939,0.6196783546543839,1614,1271,2885,+
chr12,56113042,1.399273104880581,685,427,1112,+
chr12,56113045,0.6988836662749706,609,459,1068,+
chr12,56113046,2.592882205513785,975,664,1639,+
chr12,56113048,2.592882205513785,975,664,1639,+
chr12,56113052,1.9538237956508888,1480,1066,2546,+
chr12,56113058,1.5328262245395226,1278,1014,2292,+
chr12,56113272,0.4421113190236251,1191,751,1942,+
chr12,56113274,0.48870421668205605,933,569,1502,+
chr12,56116632,1.157687987121765,1829,1244,3073,+
chr12,56116634,1.1778516503345084,1220,883,2103,+
chr12,56116666,1.0151168542460056,1319,829,2148,+
chr12,56116667,0.8757066189624331,843,429,1272,+
chr12,56117018,9.119096544789526,805,1069,1874,+
chr12,56117019,9.119096544789526,805,1069,1874,+
chr12,56154050,1.8192075940309052,570,447,1017,+
chr12,56158361,0.9053564315890134,1660,1168,2828,+
chr12,56158369,1.013777933600051,10623,8007,18630,+
chr12,56158370,1.0427544078299147,14448,10617,25065,+
chr12,56158371,1.0427544078299147,14448,10617,25065,+
chr12,56158372,1.0649599726928964,5425,4517,9942,+
chr12,56159630,1.08833352759802,4538,3618,8156,+
chr12,56159631,1.4274764150943395,2420,1801,4221,+
chr12,56159676,1.3685743188534787,6093,4644,10737,+
chr12,56159977,2.327935222672065,724,493,1217,+
chr12,56159978,0.5523461203753793,3216,2500,5716,+
chr12,56159979,0.795741131845733,8201,5356,13557,+
chr12,56159980,1.2054260213017813,4719,2662,7381,+
chr12,56160001,2.039450672995846,2692,1561,4253,+
chr12,56160004,1.183313700803844,4073,2594,6667,+
chr12,56160015,1.2600019255043753,3489,2173,5662,+
chr12,56160033,1.5881866350538358,5817,4701,10518,+
chr12,56160034,1.6454034577368832,8239,6165,14404,+
chr12,56160036,1.7774783780259902,2903,2421,5324,+
chr12,56160098,1.3892497659737701,6520,4376,10896,+
chr12,56160119,1.8601394354342922,5276,4389,9665,+
chr12,56161404,1.7210568777732955,1218,937,2155,+
chr12,56225474,3.5842105263157897,680,569,1249,+
chr12,56225475,3.5842105263157897,680,569,1249,+
chr12,56229186,3.514745638639444,566,446,1012,+
chr12,56229437,4.036536760160954,630,494,1124,+
chr12,56229641,0.4399369185942635,1211,815,2026,+
chr12,56511584,0.5510643386749582,575,451,1026,+
chr12,56511585,0.42501205938699715,842,626,1468,+
chr12,56511595,1.857518776331289,741,533,1274,+
chr12,56511599,2.2523637212559824,1151,658,1809,+
chr12,56511600,2.2165503134865943,535,522,1057,+
chr12,56511601,2.1508982472406433,2156,1297,3453,+
chr12,56511652,1.5852442671984048,847,543,1390,+
chr12,56511657,2.0604416167664668,1000,667,1667,+
chr12,56511659,3.2942326490713585,673,464,1137,+
chr12,56512209,0.9634282327434214,650,489,1139,+
chr12,57229718,1.2977095417831355,710,579,1289,+
chr12,57229719,1.1185428408914628,835,663,1498,+
chr12,57229721,1.1185428408914628,835,663,1498,+
chr12,57229734,0.5772457533331269,1873,1246,3119,+
chr12,57229740,1.531694985935049,1998,1554,3552,+
chr12,57229787,1.3915492957746478,1367,1064,2431,+
chr12,57230924,1.6350436830436186,3788,2743,6531,+
chr12,57231528,1.6774663269020749,1343,937,2280,+
chr12,57231738,1.417931631072138,1809,1535,3344,+
chr12,57231849,1.514800675887102,1544,840,2384,+
chr12,57232211,3.1186718589874975,1267,696,1963,+
chr12,57232244,2.260596686161177,4347,3195,7542,+
chr12,57232245,2.2871894510152924,2671,2196,4867,+
chr12,57232263,1.334446022290664,1920,1260,3180,+
chr12,57232476,1.8354841987602883,2229,1513,3742,+
chr12,57232713,1.5220188902007086,1310,923,2233,+
chr12,57232746,1.858874915279765,1451,812,2263,+
chr12,57232774,1.579731373668661,1413,856,2269,+
chr12,57232821,1.5257407407407408,1497,1199,2696,+
chr12,57233193,1.4781564150474829,3096,2245,5341,+
chr12,57233267,1.4769387654241792,2915,2179,5094,+
chr12,57233575,1.9002717609360091,2533,1594,4127,+
chr12,57233604,1.0505982176079276,5363,3882,9245,+
chr12,57233605,1.4298549165388723,2677,2110,4787,+
chr12,57233606,1.5223396588998317,1949,1447,3396,+
chr12,57233750,1.6985349597585515,2000,993,2993,+
chr12,57233752,1.6985349597585515,2000,993,2993,+
chr12,57233797,0.5362211327570635,874,673,1547,+
chr12,57233803,2.7240544376722053,1482,825,2307,+
chr12,57233812,1.9286541092286649,1263,883,2146,+
chr12,57233849,0.7074364385488896,1716,1069,2785,+
chr12,57234012,0.718775847808106,1579,1208,2787,+
chr12,57234013,1.4491224367767581,3295,1943,5238,+
chr12,57234015,1.5387194396976154,4669,2944,7613,+
chr12,57234026,1.3847749038534047,1932,1191,3123,+
chr12,57234317,1.5257479938353617,1594,1213,2807,+
chr12,57234372,1.5577471290899645,1900,1332,3232,+
chr12,57234429,1.3883139983666897,1824,1258,3082,+
chr12,57234430,1.4710503068070575,1687,1213,2900,+
chr12,57234471,1.4495339975736201,4249,3026,7275,+
chr12,57234480,1.3771384825631423,2072,1717,3789,+
chr12,57457154,33.24422677207242,450,664,1114,+
chr12,57457355,0.24243637692449596,497,529,1026,+
chr12,57488094,0.28478415810768754,589,503,1092,+
chr12,57488175,1.3547648261758691,636,488,1124,+
chr12,57488177,1.9109469869143407,1059,700,1759,+
chr12,57489295,1.42874871097689,969,724,1693,+
chr12,57489442,1.9820342783359135,1077,680,1757,+
chr12,57489448,2.256975772765246,613,398,1011,+
chr12,57489479,1.7795807978363758,563,521,1084,+
chr12,57489900,2.179972482755904,1445,1040,2485,+
chr12,57489901,2.29817605075337,881,678,1559,+
chr12,57489935,0.5600907029478458,740,440,1180,+
chr12,57489951,2.160294117647059,790,475,1265,+
chr12,57490273,2.850331674958541,624,401,1025,+
chr12,57490561,0.571570348651686,648,572,1220,+
chr12,57490604,2.0206269789783837,973,744,1717,+
chr12,57498439,0.8152920962199313,1021,775,1796,+
chr12,57498441,0.8152920962199313,1021,775,1796,+
chr12,57498512,1.8160427807486632,565,439,1004,+
chr12,57498531,1.6943231441048037,775,457,1232,+
chr12,57498534,1.6844833171363782,599,440,1039,+
chr12,57498541,3.030922614736455,1547,1023,2570,+
chr12,57500321,2.2071278825995813,563,476,1039,+
chr12,57500333,0.5391572720648121,661,568,1229,+
chr12,57511701,0.5138374055645688,919,611,1530,+
chr12,57511730,10.291115713640906,1791,1926,3717,+
chr12,57511757,0.4637608028214291,916,1138,2054,+
chr12,57511764,0.4673096018420856,910,1179,2089,+
chr12,57511811,0.6336140276075254,766,646,1412,+
chr12,57511826,1.851989842240114,1292,1014,2306,+
chr12,57512059,2.652019386106624,911,618,1529,+
chr12,57512248,1.8457573354480565,734,581,1315,+
chr12,57512266,1.666319237641453,721,583,1304,+
chr12,57512316,2.140510948905109,689,547,1236,+
chr12,57512864,2.056819468024901,648,464,1112,+
chr12,57512916,3.306912442396313,623,433,1056,+
chr12,57514754,1.9623287671232876,572,437,1009,+
chr12,57514826,1.9525899912203688,555,468,1023,+
chr12,57514972,1.7216797900262468,712,380,1092,+
chr12,57514984,1.9696568577537927,623,426,1049,+
chr12,57515007,1.8988535031847131,770,470,1240,+
chr12,57515325,1.6488100364596792,726,682,1408,+
chr12,57515961,1.1389930634930767,1552,1181,2733,+
chr12,57516246,1.8052489575668385,735,452,1187,+
chr12,57516279,1.9541569541569541,1005,571,1576,+
chr12,57516438,1.816707398355921,883,642,1525,+
chr12,57694252,1.4871836274473478,888,616,1504,+
chr12,57694279,1.7897260273972602,602,437,1039,+
chr12,57696024,1.7055214723926384,833,488,1321,+
chr12,57715926,2.085605740818911,771,514,1285,+
chr12,57715928,2.085605740818911,771,514,1285,+
chr12,57716112,1.631529388246976,1009,709,1718,+
chr12,57716137,0.5637006270013322,1422,1017,2439,+
chr12,57716697,0.3457544289590888,602,442,1044,+
chr12,57718281,4.741672434665525,1224,965,2189,+
chr12,57718282,5.4000733406674,795,605,1400,+
chr12,57719097,2.7309315157416423,600,473,1073,+
chr12,57719150,2.1554928642548954,837,523,1360,+
chr12,57720168,1.4629147164051075,727,517,1244,+
chr12,57720208,0.45758614361793226,1168,714,1882,+
chr12,57720248,10.463144938518813,2239,1428,3667,+
chr12,57720421,0.9740271612119955,1484,1215,2699,+
chr12,57720877,7.062026006974725,1521,969,2490,+
chr12,57720884,11.377852097673852,2079,1559,3638,+
chr12,57720885,10.773577825277405,3306,2622,5928,+
chr12,57720886,10.773577825277405,3306,2622,5928,+
chr12,57720894,0.44837737598516464,840,718,1558,+
chr12,57720895,0.44837737598516464,840,718,1558,+
chr12,57721003,0.5368139443014844,645,506,1151,+
chr12,57721132,1.8690191387559811,624,439,1063,+
chr12,57721144,4.167548500881834,555,503,1058,+
chr12,57721321,2.791381400181478,857,676,1533,+
chr12,57721399,0.5544217687074829,651,503,1154,+
chr12,57721400,1.7928202968733549,654,412,1066,+
chr12,57721446,1.761527829277656,1094,802,1896,+
chr12,57783148,2.0279456890269243,785,617,1402,+
chr12,57786231,3.279662770243091,684,510,1194,+
chr12,62389656,1.2877777777777777,609,449,1058,+
chr12,62389657,1.2877777777777777,609,449,1058,+
chr12,62389863,0.5106329747310483,627,570,1197,+
chr12,62389864,0.5106329747310483,627,570,1197,+
chr12,62389865,0.5106329747310483,627,570,1197,+
chr12,62965319,1.1945297529989238,1239,917,2156,+
chr12,62965321,1.1839045832505135,2194,1676,3870,+
chr12,62965322,1.1802404970375677,2771,2236,5007,+
chr12,62965324,0.7142040205868121,1187,761,1948,+
chr12,62965370,1.4146689376197572,1925,1341,3266,+
chr12,62965377,1.390595899597624,2185,1534,3719,+
chr12,62965387,0.7830520208153663,2751,1925,4676,+
chr12,62965388,0.6166240879863171,3037,2716,5753,+
chr12,62965390,1.200051177603489,6919,5337,12256,+
chr12,62965414,0.8456071110007111,14441,10192,24633,+
chr12,62965545,2.014645644380933,9173,4838,14011,+
chr12,62965546,1.9943698841282067,7958,4168,12126,+
chr12,62965547,1.9943698841282067,7958,4168,12126,+
chr12,62965555,1.630014086788245,5743,3670,9413,+
chr12,62965556,1.6070511731928243,8018,4978,12996,+
chr12,62965558,1.2496666505072833,3273,2118,5391,+
chr12,62965575,1.0698649888583038,3497,2542,6039,+
chr12,62965576,1.0698649888583038,3497,2542,6039,+
chr12,62965600,1.2776699893617518,6945,4515,11460,+
chr12,62965601,1.2605686885308462,14348,9643,23991,+
chr12,62965603,1.307171964140179,7459,4907,12366,+
chr12,62965616,1.2900871889894758,11677,9162,20839,+
chr12,62965617,1.2329810200328095,25076,18495,43571,+
chr12,62965669,1.1935355399903909,10468,8235,18703,+
chr12,62965670,1.1935355399903909,10468,8235,18703,+
chr12,63802169,1.917103540050507,569,461,1030,+
chr12,63823246,1.4886705136954625,923,708,1631,+
chr12,63823247,1.8983306283329469,654,453,1107,+
chr12,63823668,0.32299014789737635,1043,769,1812,+
chr12,64404565,3.7146570315510217,663,460,1123,+
chr12,64404697,2.1249206005706918,1484,982,2466,+
chr12,64404699,2.3137545510890716,1493,988,2481,+
chr12,64404733,1.7762779652543432,645,380,1025,+
chr12,64404735,0.45920941968040363,662,492,1154,+
chr12,64404739,1.4017800672551615,1251,844,2095,+
chr12,64404753,2.1170870060834397,1752,1234,2986,+
chr12,64410019,1.9129208754208755,1056,719,1775,+
chr12,64410032,2.3902406417112303,940,679,1619,+
chr12,64410067,2.3888221153846154,1049,727,1776,+
chr12,64414962,1.601294903926483,1121,683,1804,+
chr12,64418068,2.218694885361552,815,647,1462,+
chr12,64418880,2.5179594689028653,562,476,1038,+
chr12,64418911,1.5760731020731709,1851,1308,3159,+
chr12,64419027,0.6639260833019558,3166,2500,5666,+
chr12,64420091,3.5695455439700963,671,390,1061,+
chr12,64420131,2.4134031814258483,2278,1578,3856,+
chr12,64420132,2.1513238388880733,1417,972,2389,+
chr12,64420428,2.254658385093168,593,413,1006,+
chr12,64420430,1.7239915074309973,811,470,1281,+
chr12,64420437,2.6326884920634916,964,575,1539,+
chr12,64421275,1.5923899275472462,1185,917,2102,+
chr12,64421384,1.7283437283437282,1159,779,1938,+
chr12,64424640,1.0128638160258714,2087,1451,3538,+
chr12,64424641,1.0128638160258714,2087,1451,3538,+
chr12,64424665,2.330576910653143,974,672,1646,+
chr12,64425112,1.5144564690680018,1171,905,2076,+
chr12,64425355,0.6610565684899485,1211,929,2140,+
chr12,64425824,1.658053725231097,2757,1696,4453,+
chr12,64425825,1.6914090936153412,4248,2753,7001,+
chr12,64425855,0.6683206791415077,1596,1166,2762,+
chr12,64430049,1.6146501082879232,1914,1382,3296,+
chr12,64430097,2.4490238611713666,1128,921,2049,+
chr12,64431559,0.7214816433566436,1673,1247,2920,+
chr12,64431697,1.6793480116060762,1612,1084,2696,+
chr12,64431756,1.6358055961143059,1167,906,2073,+
chr12,64431803,1.6623850169884808,1699,1096,2795,+
chr12,64433493,1.5750360750360746,1710,1275,2985,+
chr12,64433496,1.7078422144637344,2950,2160,5110,+
chr12,64433587,1.5844949992226767,1273,838,2111,+
chr12,64434512,0.606343925262268,2400,1817,4217,+
chr12,64434539,1.4331494325346783,1540,1039,2579,+
chr12,64434830,2.352117557357732,892,686,1578,+
chr12,64448118,1.6790390677153622,1760,1286,3046,+
chr12,64448137,0.6543084401237296,870,729,1599,+
chr12,64448509,1.93455890854434,1067,836,1903,+
chr12,67297439,1.0842902521050304,603,444,1047,+
chr12,67297520,2.0113952844215515,741,490,1231,+
chr12,67302364,1.401064510636299,671,520,1191,+
chr12,67304641,2.7377491259955495,709,508,1217,+
chr12,67305140,1.5277868350404058,632,401,1033,+
chr12,67305279,1.4779256739381645,712,555,1267,+
chr12,67305796,0.4685779202493509,816,562,1378,+
chr12,67306102,1.0949026226985905,702,452,1154,+
chr12,67306276,3.545629707479418,697,518,1215,+
chr12,67306277,3.545629707479418,697,518,1215,+
chr12,67307443,1.1153137433133218,925,697,1622,+
chr12,67312649,1.8051639783613866,800,587,1387,+
chr12,68659752,2.197290255341324,726,504,1230,+
chr12,68659772,1.8278008298755188,880,481,1361,+
chr12,68659800,2.0880899821297167,2291,1358,3649,+
chr12,68659801,2.066894818123167,3909,2563,6472,+
chr12,68659802,2.0394980227069777,1618,1205,2823,+
chr12,68687033,2.8806913786382773,610,397,1007,+
chr12,68688973,0.29989348012378997,578,449,1027,+
chr12,68688976,0.9019213457779871,897,612,1509,+
chr12,68702770,1.9924269577079563,975,594,1569,+
chr12,68719387,3.3210164000809885,728,448,1176,+
chr12,68719402,3.586153846153847,881,699,1580,+
chr12,68719581,1.0407666958302175,4438,3130,7568,+
chr12,68719582,1.6336171096345515,1048,601,1649,+
chr12,68719583,1.3213371111592118,5477,3758,9235,+
chr12,68719585,1.7416757371858305,4266,2607,6873,+
chr12,68719586,1.6924962819059983,5705,3539,9244,+
chr12,68719587,1.6924962819059983,5705,3539,9244,+
chr12,68719623,2.0035453300465624,4395,3650,8045,+
chr12,68719625,1.9235040169310422,7794,6305,14099,+
chr12,68719626,2.1208009969976773,4537,3891,8428,+
chr12,68719629,1.6226830805498418,7899,6411,14310,+
chr12,68719630,1.7462144434187947,4961,4560,9521,+
chr12,68726544,2.5317943606449957,598,474,1072,+
chr12,68733455,3.7886761003472946,946,688,1634,+
chr12,68741843,2.4852531007061898,624,472,1096,+
chr12,69239670,0.9657856520476328,977,625,1602,+
chr12,69239671,0.7421099290780142,760,479,1239,+
chr12,69239672,0.637042038423882,1085,759,1844,+
chr12,69253136,1.8273870027569956,870,632,1502,+
chr12,69260089,2.5541572398190038,668,441,1109,+
chr12,69260104,2.132937414344449,1333,795,2128,+
chr12,69260111,2.2840520516717326,1393,895,2288,+
chr12,69260127,2.5755813953488373,885,515,1400,+
chr12,69260135,1.8560606060606062,1014,637,1651,+
chr12,69260137,1.4530442035029192,1685,1198,2883,+
chr12,69260148,1.4540596679900162,1422,890,2312,+
chr12,69260149,1.0449785083104546,3469,2321,5790,+
chr12,69269538,1.7028291590258013,935,682,1617,+
chr12,69269539,2.251065300011517,673,456,1129,+
chr12,69269587,0.457327397002571,662,430,1092,+
chr12,69269593,0.6830796512487071,855,504,1359,+
chr12,69269595,1.830686441790261,633,400,1033,+
chr12,69269601,0.7111675924955455,2489,1315,3804,+
chr12,69269602,0.8422575759323965,4064,2276,6340,+
chr12,69269603,1.2310731438578768,2302,1640,3942,+
chr12,69269663,0.4467455621301776,754,519,1273,+
chr12,69359981,2.4589295177530466,927,628,1555,+
chr12,69359982,2.450140889304054,1119,753,1872,+
chr12,69365794,2.3433821285042216,665,445,1110,+
chr12,69365873,3.1686206621844932,612,488,1100,+
chr12,69390190,1.3923546000725904,1518,1163,2681,+
chr12,69390422,1.2813449965878776,897,596,1493,+
chr12,69390423,1.2813449965878776,897,596,1493,+
chr12,69585458,1.1858236825177164,776,383,1159,+
chr12,69585490,1.8330526180347388,1984,1361,3345,+
chr12,69585505,1.049664392197582,1918,1111,3029,+
chr12,69585507,1.049664392197582,1918,1111,3029,+
chr12,69586274,1.7580536912751679,1013,595,1608,+
chr12,69586291,0.6209153451273919,2229,1513,3742,+
chr12,69586298,2.1654749744637387,1483,978,2461,+
chr12,69586299,1.760251338647797,2048,1531,3579,+
chr12,69586300,1.5250959079283888,657,543,1200,+
chr12,69587572,1.66201362986007,3697,2550,6247,+
chr12,69588227,1.7414372633280857,1948,1236,3184,+
chr12,69589556,2.3451943379995304,832,672,1504,+
chr12,69589595,1.5860062893081763,916,794,1710,+
chr12,69589645,1.7133655394524958,895,735,1630,+
chr12,69593019,1.7536515388628064,790,638,1428,+
chr12,69593021,1.4580020973580057,2154,1441,3595,+
chr12,69593521,1.4664345991561183,1957,1199,3156,+
chr12,69597172,1.8501386138613862,686,504,1190,+
chr12,69598026,0.5829959514170041,1457,987,2444,+
chr12,69598028,2.631878557874763,656,526,1182,+
chr12,69598340,2.407935955447268,1152,675,1827,+
chr12,69598393,1.7480083857442346,757,635,1392,+
chr12,69599908,1.5187954141772968,1492,1125,2617,+
chr12,69599985,4.036004645760744,694,573,1267,+
chr12,69601306,1.9402856126442043,1045,936,1981,+
chr12,69601319,1.3389946223988776,1745,1174,2919,+
chr12,69601320,0.6327579715601378,1180,945,2125,+
chr12,71703723,1.9907373208385228,628,485,1113,+
chr12,71896754,1.0682710301782106,1079,579,1658,+
chr12,71896766,2.359634517766497,1708,984,2692,+
chr12,71896767,2.359634517766497,1708,984,2692,+
chr12,71897859,1.8795233040625303,794,481,1275,+
chr12,71897864,2.897797356828194,758,453,1211,+
chr12,71897877,1.9528550512445095,1025,682,1707,+
chr12,71897890,1.5992528661599898,1527,1108,2635,+
chr12,71897904,1.65526535923413,1618,1217,2835,+
chr12,71907040,2.090909090909091,599,439,1038,+
chr12,71923028,1.0365249452701926,691,525,1216,+
chr12,71923029,1.0365249452701926,691,525,1216,+
chr12,71923284,2.1724451102483826,837,631,1468,+
chr12,74538909,1.2323108577475665,611,561,1172,+
chr12,74540100,0.9883720930232558,747,515,1262,+
chr12,74540101,0.9883720930232558,747,515,1262,+
chr12,88042853,1.6918697614665354,747,548,1295,+
chr12,93469303,1.3809924428134202,1420,970,2390,+
chr12,93476976,0.5424369747899159,1290,839,2129,+
chr12,93477002,1.4210804438843951,1839,1010,2849,+
chr12,93479405,1.679280629449232,2429,1412,3841,+
chr12,93479434,1.91530836864272,2061,1172,3233,+
chr12,93479449,1.2852036034946643,3301,1740,5041,+
chr12,93479455,1.5765496426639332,7909,4580,12489,+
chr12,93479456,1.4798045990706539,5999,3849,9848,+
chr12,93479457,1.4564644309703818,16617,9759,26376,+
chr12,93479458,1.46401619571722,22009,13542,35551,+
chr12,93479459,1.3571228636561135,20987,13153,34140,+
chr12,93487497,1.3111948084697722,18126,11515,29641,+
chr12,93487498,1.2516640985566512,16699,10727,27426,+
chr12,93487499,1.3290338220788125,14703,9201,23904,+
chr12,93487503,1.0014767685285682,10253,7563,17816,+
chr12,93501199,1.6794258373205742,597,417,1014,+
chr12,93501272,0.5542986425339367,1175,815,1990,+
chr12,93502009,2.8411764705882354,692,373,1065,+
chr12,93502010,2.8411764705882354,692,373,1065,+
chr12,93502042,5.855556685749092,675,411,1086,+
chr12,95474220,1.8578733982880953,709,559,1268,+
chr12,95474238,0.5803762916747904,566,445,1011,+
chr12,95474249,1.6445358474897962,1072,793,1865,+
chr12,95476087,0.3890977443609023,643,391,1034,+
chr12,95476091,1.6423773091994776,606,465,1071,+
chr12,95483255,2.077023014105419,721,448,1169,+
chr12,95483261,2.046783625730994,741,476,1217,+
chr12,95485903,1.8376623376623376,848,538,1386,+
chr12,95485959,0.7135102533172497,1182,828,2010,+
chr12,95494058,2.3407697227342843,1829,1398,3227,+
chr12,95494059,2.194604504976428,2792,2161,4953,+
chr12,95494061,2.0004803535402056,1892,1486,3378,+
chr12,95495059,1.9895652173913043,967,758,1725,+
chr12,95495061,1.6751768155942728,746,560,1306,+
chr12,95496008,1.708382995629718,1099,838,1937,+
chr12,95496037,1.7117060532307449,990,541,1531,+
chr12,95496058,1.6459364528240947,2342,1456,3798,+
chr12,95496073,1.8625089121543021,1908,986,2894,+
chr12,95504071,1.4431067198848393,4811,2696,7507,+
chr12,95504073,1.6674850365868745,9760,5502,15262,+
chr12,95504074,1.8323205866946048,4996,2874,7870,+
chr12,95504077,0.981468632186727,6911,4269,11180,+
chr12,95504090,1.9268828222592551,7001,4792,11793,+
chr12,95504092,1.9268828222592551,7001,4792,11793,+
chr12,95504106,1.960183298765976,4178,3428,7606,+
chr12,95511913,1.6172361917042768,601,563,1164,+
chr12,95511938,1.9171116196287823,779,512,1291,+
chr12,95513907,2.839177219822853,901,718,1619,+
chr12,95514072,2.047292586567511,838,661,1499,+
chr12,95514270,1.6465939110475942,4905,3611,8516,+
chr12,95514271,1.6465939110475942,4905,3611,8516,+
chr12,95858964,0.8546049267693606,1527,902,2429,+
chr12,95858966,0.8190977297086621,887,494,1381,+
chr12,95859002,1.883561643835616,626,437,1063,+
chr12,95859006,2.32032225362607,2409,1632,4041,+
chr12,95859050,2.4973630831643003,683,492,1175,+
chr12,95859053,1.0021482277121374,1865,1101,2966,+
chr12,95859054,1.0021482277121374,1865,1101,2966,+
chr12,95865328,0.5830308529945554,770,569,1339,+
chr12,95865336,1.8609279391671123,894,542,1436,+
chr12,95865337,2.589351696338596,570,457,1027,+
chr12,98515903,0.4002060776729407,727,547,1274,+
chr12,98515933,1.5649967256057635,868,508,1376,+
chr12,98515934,2.7535211267605635,611,425,1036,+
chr12,98516011,1.9564446459749691,1026,613,1639,+
chr12,98516127,2.88570280048238,672,438,1110,+
chr12,98516129,2.88570280048238,672,438,1110,+
chr12,98527891,2.206841288125407,1087,973,2060,+
chr12,98527892,2.206841288125407,1087,973,2060,+
chr12,98527896,2.356243538942363,2516,2050,4566,+
chr12,98527897,1.9153379198704976,2243,1764,4007,+
chr12,98527899,2.15121515905825,2207,1938,4145,+
chr12,98527935,1.4276363129918062,991,642,1633,+
chr12,98533250,2.1720841300191203,1135,522,1657,+
chr12,98533252,2.076926476300755,2227,1033,3260,+
chr12,98533262,1.6651027703306522,770,372,1142,+
chr12,98533269,2.1839480813970606,1852,892,2744,+
chr12,98533597,0.4410087070835613,655,426,1081,+
chr12,98544970,0.3747642991829038,1324,859,2183,+
chr12,98544971,0.3747642991829038,1324,859,2183,+
chr12,98548010,1.1089627088115594,1115,814,1929,+
chr12,98549137,0.22407614781634935,666,469,1135,+
chr12,98549138,0.22407614781634935,666,469,1135,+
chr12,98549697,0.5370585202371745,640,430,1070,+
chr12,98549789,0.5506393490264458,688,371,1059,+
chr12,98549885,2.2483316577222707,1032,710,1742,+
chr12,98593704,0.549079754601227,536,488,1024,+
chr12,98593722,1.3943530764033838,1800,1531,3331,+
chr12,98594018,1.6765046690750462,945,862,1807,+
chr12,98594071,1.6180371352785146,1219,637,1856,+
chr12,98594111,0.6700685962857621,889,833,1722,+
chr12,98595726,1.5052635623175044,1350,722,2072,+
chr12,98595730,1.8317694090960825,2783,1773,4556,+
chr12,98595752,1.092055026937064,4561,2919,7480,+
chr12,98595753,1.5175837222631618,1665,1356,3021,+
chr12,98595756,1.3109717257647528,6528,4849,11377,+
chr12,98595832,1.4627771271134409,2892,1918,4810,+
chr12,98597867,1.4847899565427332,2049,1743,3792,+
chr12,98598535,1.5351075115586799,3204,2215,5419,+
chr12,98599989,1.3105820105820103,2476,1889,4365,+
chr12,98601230,0.7371843798190003,4044,2985,7029,+
chr12,98601231,1.2464189553042542,2933,2475,5408,+
chr12,98601436,1.2412527809306084,7045,5006,12051,+
chr12,98601484,1.243192074350997,3547,2312,5859,+
chr12,100200891,1.8093792692834307,777,589,1366,+
chr12,100210106,3.1342575581414662,813,583,1396,+
chr12,100218548,1.8902955433639246,618,438,1056,+
chr12,101723787,2.1278399877911527,773,498,1271,+
chr12,101728929,1.9833835334531067,695,463,1158,+
chr12,101921539,2.3073754694853474,641,440,1081,+
chr12,101921617,2.0181272822117893,618,425,1043,+
chr12,101921626,0.5801910507792861,576,467,1043,+
chr12,101921709,2.2889610389610393,854,797,1651,+
chr12,101921711,2.259782608695652,692,459,1151,+
chr12,101922037,4.543022677779713,829,674,1503,+
chr12,101923333,3.0594405594405587,699,439,1138,+
chr12,101923334,3.0594405594405587,699,439,1138,+
chr12,101923337,2.7234347551430393,1457,996,2453,+
chr12,101923338,2.8840653357531765,763,550,1313,+
chr12,101923343,1.9866297833102808,833,722,1555,+
chr12,101923344,1.9866297833102808,833,722,1555,+
chr12,102165746,1.8488831618194401,1014,643,1657,+
chr12,103930439,2.293190234669179,740,377,1117,+
chr12,103930461,2.6110074626865667,932,535,1467,+
chr12,103930462,2.6110074626865667,932,535,1467,+
chr12,103930463,3.7438247199229955,2280,1340,3620,+
chr12,103930466,3.308339268990716,1309,871,2180,+
chr12,103930470,3.5332967032967035,868,699,1567,+
chr12,103930472,3.400978897872738,1606,1243,2849,+
chr12,103930474,2.8276175022963606,1328,960,2288,+
chr12,103930483,0.5211010265917938,1015,774,1789,+
chr12,103930489,2.9770723894463753,4825,5007,9832,+
chr12,103930490,2.9770723894463753,4825,5007,9832,+
chr12,103930515,0.5714036510181856,2660,2698,5358,+
chr12,103930539,0.5876186360653639,1048,1058,2106,+
chr12,103931541,1.0103956566496797,5445,4491,9936,+
chr12,103931568,1.4546484457976352,3209,2434,5643,+
chr12,103931575,0.6607742340226417,6141,4395,10536,+
chr12,103931577,0.6667729969985311,10681,7959,18640,+
chr12,103932282,1.5228136882129275,2240,1577,3817,+
chr12,103934110,1.4971090746483615,4002,2608,6610,+
chr12,103934111,1.4971090746483615,4002,2608,6610,+
chr12,103934124,1.7363452128086803,4967,3976,8943,+
chr12,103937705,1.5162484923641426,2176,1590,3766,+
chr12,103937706,1.818618345401013,2569,1953,4522,+
chr12,103937719,1.465277035878402,5738,4094,9832,+
chr12,103939511,1.3561707952661584,8105,5715,13820,+
chr12,103939512,1.6559380472428686,5511,3670,9181,+
chr12,103942549,1.3382128725451046,5361,4237,9598,+
chr12,103942550,1.3234385396404231,8776,6448,15224,+
chr12,103943082,1.4693631931748934,2242,1640,3882,+
chr12,103943735,1.1313605441754417,689,557,1246,+
chr12,103943783,0.9838389445861171,5586,3973,9559,+
chr12,103943830,1.5160547737143133,2365,1452,3817,+
chr12,103946618,1.7840031505744034,2350,1530,3880,+
chr12,103946650,1.2731721896050572,6810,4918,11728,+
chr12,103947638,1.4852296016395539,2612,1687,4299,+
chr12,104031186,1.387853359928468,707,433,1140,+
chr12,104265272,1.0325183403197657,8094,3608,11702,+
chr12,104265273,1.1762230333531527,11379,6027,17406,+
chr12,104265274,1.1359344689227473,13946,7095,21041,+
chr12,104265275,1.5724710879728556,5922,3676,9598,+
chr12,104265276,1.8339441503033163,8620,4583,13203,+
chr12,104265277,1.5718214887765058,3783,2430,6213,+
chr12,104265280,1.7314660305299383,4361,1950,6311,+
chr12,104265282,1.699315268978645,5443,2877,8320,+
chr12,104265289,1.2719123927870382,10786,6891,17677,+
chr12,104265291,1.4122783127115424,13777,8863,22640,+
chr12,104265292,1.38632562038872,9645,6284,15929,+
chr12,104265296,1.3079015976321875,5923,4108,10031,+
chr12,104265297,1.3079015976321875,5923,4108,10031,+
chr12,104265298,1.3970479969806566,13378,7623,21001,+
chr12,104265299,1.3970479969806566,13378,7623,21001,+
chr12,104265300,1.3342099248592154,19901,12773,32674,+
chr12,104265306,1.380108925817068,18572,13325,31897,+
chr12,104265308,1.3710243059764236,22547,17276,39823,+
chr12,104265405,1.5932096507712292,1913,1686,3599,+
chr12,104265412,1.5588584708368192,4207,3479,7686,+
chr12,104265417,1.890156823490157,2715,1294,4009,+
chr12,104265441,1.3368119366412885,6621,3808,10429,+
chr12,104265443,1.3368119366412885,6621,3808,10429,+
chr12,104265455,1.553246756673343,7367,4844,12211,+
chr12,104265492,1.308731688172929,14246,9924,24170,+
chr12,104265495,1.2438099412996593,5467,4486,9953,+
chr12,104265549,1.9000799817184642,1262,1093,2355,+
chr12,104265579,1.7378472222222219,1979,1279,3258,+
chr12,104265584,1.3068483949561525,8942,6086,15028,+
chr12,104265585,1.4889994674477434,4708,3247,7955,+
chr12,104265592,1.3771392563309588,9764,7418,17182,+
chr12,104265593,1.2645675452795253,13624,10454,24078,+
chr12,104265594,1.1329112564588613,24008,17731,41739,+
chr12,104265595,1.0847538017251939,16840,13234,30074,+
chr12,104265603,0.8405707196029777,4064,3099,7163,+
chr12,104265605,1.413102687159549,5938,3347,9285,+
chr12,104265607,0.658976157378425,10612,8163,18775,+
chr12,104265632,1.3695837747100352,10235,7941,18176,+
chr12,104265806,1.596078431372549,702,509,1211,+
chr12,104265830,2.1467928776872496,1735,819,2554,+
chr12,104265831,2.174428754813864,1597,778,2375,+
chr12,104265833,2.1170025435335558,1081,537,1618,+
chr12,104287021,0.9869476231439174,6093,3557,9650,+
chr12,104287031,1.3336383601756956,2428,1365,3793,+
chr12,104311318,1.9156597259682813,1893,1425,3318,+
chr12,104318949,1.386689812919321,2373,2012,4385,+
chr12,104318999,0.8411390077876041,6429,4687,11116,+
chr12,104321093,1.5282883055808818,2653,1602,4255,+
chr12,104325338,1.3211492270739669,3404,2497,5901,+
chr12,104325343,1.354882459312839,2108,1595,3703,+
chr12,104325403,1.6359681855982262,3364,2038,5402,+
chr12,104327628,1.4486483295950892,1943,1575,3518,+
chr12,104334263,1.9121912350597612,1845,1505,3350,+
chr12,104339170,1.5692673494983276,1652,1471,3123,+
chr12,104339225,0.7195263263916201,4658,3417,8075,+
chr12,104348419,1.5771535672889592,1141,988,2129,+
chr12,104348445,0.5788374903856719,2633,1915,4548,+
chr12,104348452,0.7145336141007643,2818,2136,4954,+
chr12,104348566,1.7960927960927962,1470,1196,2666,+
chr12,104348587,1.6836579847698927,1584,1393,2977,+
chr12,104349206,1.3418338185821528,2820,2306,5126,+
chr12,104349483,1.3305008944543828,3624,2235,5859,+
chr12,104349679,1.2728932124392462,8458,6193,14651,+
chr12,104349864,1.3231078174363111,2668,2051,4719,+
chr12,104349916,1.5495723788406717,1222,1000,2222,+
chr12,104349922,0.6975771808236441,1281,1026,2307,+
chr12,104349937,1.4024992490918258,5523,3514,9037,+
chr12,104349939,1.4095289583303765,7157,4870,12027,+
chr12,104350017,0.7250070801472671,1535,1176,2711,+
chr12,104350041,1.3803757828810022,1826,1436,3262,+
chr12,106971504,1.7838443167520825,1428,1034,2462,+
chr12,106971506,1.882995204298245,1895,1317,3212,+
chr12,106971507,2.1608656627106813,921,541,1462,+
chr12,106972788,2.9028067901388437,640,402,1042,+
chr12,106972902,5.550932199490255,580,721,1301,+
chr12,106972917,0.49668843265453405,750,863,1613,+
chr12,106972918,0.49668843265453405,750,863,1613,+
chr12,106973839,2.090721649484536,675,484,1159,+
chr12,106973853,0.6052287581699346,925,764,1689,+
chr12,106973864,1.5319865319865318,909,725,1634,+
chr12,106973868,1.9440474522441733,967,792,1759,+
chr12,106973880,2.162896566064638,2406,2103,4509,+
chr12,106973882,2.162896566064638,2406,2103,4509,+
chr12,106973886,1.2774404253272622,4258,4037,8295,+
chr12,106973887,1.6864348590340432,2698,2696,5394,+
chr12,107702938,1.2940311912190519,845,721,1566,+
chr12,107703015,3.6605957710115824,619,486,1105,+
chr12,108564293,0.9137594710762692,1049,777,1826,+
chr12,108564294,0.4170980295508522,956,717,1673,+
chr12,108565331,0.3659169550173009,610,441,1051,+
chr12,108565332,0.9838300886568422,896,680,1576,+
chr12,108568865,0.13972687005476406,557,500,1057,+
chr12,109098520,1.6784882847125204,1322,825,2147,+
chr12,109098522,1.0568711990460877,1087,667,1754,+
chr12,109099207,2.3477194064221814,745,582,1327,+
chr12,109101911,2.370537931138162,592,500,1092,+
chr12,109103533,2.396061269146609,1094,913,2007,+
chr12,109103534,2.396061269146609,1094,913,2007,+
chr12,109103535,2.396061269146609,1094,913,2007,+
chr12,109109893,3.8271396396396393,970,591,1561,+
chr12,109109894,3.8271396396396393,970,591,1561,+
chr12,109110684,4.437622483017565,1920,1452,3372,+
chr12,109110685,4.007392285496423,2889,2138,5027,+
chr12,109110686,2.9552495718838108,2421,1803,4224,+
chr12,109110718,3.162506984953217,1399,1308,2707,+
chr12,109530007,2.193389423076923,868,639,1507,+
chr12,109530009,2.1124864171442064,1426,1075,2501,+
chr12,109530017,1.7443267548390424,1185,813,1998,+
chr12,110281629,3.6221984291808353,409,744,1153,+
chr12,110281795,1.8412928697619202,633,382,1015,+
chr12,110281876,1.545380755608028,536,483,1019,+
chr12,110282712,1.7174943386885684,1141,814,1955,+
chr12,110282714,0.6077756931415469,685,491,1176,+
chr12,110292045,1.7441240739753772,934,646,1580,+
chr12,110296647,1.6306371074248251,2460,1779,4239,+
chr12,110323038,1.418657356364082,1310,906,2216,+
chr12,110327552,2.707430340557276,1748,1063,2811,+
chr12,110327554,1.9522466780539223,2624,1821,4445,+
chr12,110327596,1.6631299438810236,1795,1298,3093,+
chr12,110327601,1.6258959406669309,3933,3116,7049,+
chr12,110327602,1.6569844375863458,6832,5119,11951,+
chr12,110327603,1.701689214164264,2899,2003,4902,+
chr12,110327606,2.2737843551797043,2150,1891,4041,+
chr12,110327634,1.7441470722665178,953,678,1631,+
chr12,110327647,1.7931896282411748,655,581,1236,+
chr12,110327657,1.6610729386892178,966,687,1653,+
chr12,110327715,1.5235978112175097,890,687,1577,+
chr12,110327811,1.5582608695652174,895,712,1607,+
chr12,110327864,2.826954850848341,1384,939,2323,+
chr12,110327903,1.570642605633803,792,567,1359,+
chr12,110327906,1.5444255319148936,788,499,1287,+
chr12,110327907,1.8911290322580645,937,703,1640,+
chr12,110328000,3.092197986577182,898,744,1642,+
chr12,110333181,3.065934065934066,755,545,1300,+
chr12,110333185,1.5873015873015874,859,644,1503,+
chr12,110339677,0.5640089267599919,555,476,1031,+
chr12,110340703,1.5854706098907845,759,561,1320,+
chr12,110340704,2.5341409691629955,648,453,1101,+
chr12,110340761,0.6075942644715878,672,537,1209,+
chr12,110340775,1.6853636734078912,1109,868,1977,+
chr12,110340800,1.5357545680126323,735,402,1137,+
chr12,110340818,1.668965517241379,725,434,1159,+
chr12,110340916,1.70864200224058,1743,1280,3023,+
chr12,110340917,0.9874907109239534,937,733,1670,+
chr12,110340930,1.6559216566007644,1530,1164,2694,+
chr12,110342260,2.2964569775849597,793,460,1253,+
chr12,110342261,2.1009150326797386,573,449,1022,+
chr12,110342334,2.628105590062112,676,551,1227,+
chr12,110342402,2.0461930978917686,801,676,1477,+
chr12,110343233,2.6426159339297457,1185,911,2096,+
chr12,110343351,0.5066643882433356,592,461,1053,+
chr12,110343359,0.6201400627867666,641,504,1145,+
chr12,110343360,1.568590704647676,836,666,1502,+
chr12,110343390,0.5745341614906831,554,482,1036,+
chr12,110343409,1.4553093964858672,761,594,1355,+
chr12,110344960,2.0082159624413145,648,425,1073,+
chr12,110345249,2.2666666666666666,611,485,1096,+
chr12,110345263,0.5880462473055066,681,566,1247,+
chr12,110345273,2.166296570441648,877,771,1648,+
chr12,110346007,0.5893297925761294,1346,1001,2347,+
chr12,110346041,2.235759493670886,627,473,1100,+
chr12,110346313,0.45322793148880103,859,659,1518,+
chr12,110346378,2.0372250423011837,687,393,1080,+
chr12,110346402,1.9211463776866753,2316,1791,4107,+
chr12,110346403,0.7950041558774296,2064,1588,3652,+
chr12,110346404,1.8978185993111365,797,468,1265,+
chr12,110346417,2.04368597320725,964,751,1715,+
chr12,110346429,1.3775863421701728,2080,1507,3587,+
chr12,110346443,0.6268512361723992,1219,931,2150,+
chr12,110346769,1.5278450363196123,1261,825,2086,+
chr12,110346855,1.5675190329797477,2821,1931,4752,+
chr12,110347111,2.549090909090909,700,439,1139,+
chr12,110347126,2.3438208955223883,912,669,1581,+
chr12,110347150,0.4917953041899079,1010,592,1602,+
chr12,110347156,1.4426877470355732,1167,919,2086,+
chr12,110347172,3.154522235576924,856,831,1687,+
chr12,110348490,19.642730080349793,1017,707,1724,+
chr12,110348808,6.7085415757498605,594,533,1127,+
chr12,110350893,1.9690433900025373,775,562,1337,+
chr12,110490185,8.497806536463472,763,607,1370,+
chr12,111890060,2.180784388012957,814,425,1239,+
chr12,111890087,0.3592703490662674,828,517,1345,+
chr12,111890105,1.8394850912912124,777,330,1107,+
chr12,111890113,1.8115034867503488,2193,1194,3387,+
chr12,111890115,1.675577771953335,3701,2034,5735,+
chr12,111890128,2.08070404487319,1323,810,2133,+
chr12,111892985,8.626382697705134,1374,672,2046,+
chr12,112013439,1.2653869320709148,841,560,1401,+
chr12,112013451,0.6650998933738785,1746,1212,2958,+
chr12,112013491,2.1423215068430737,1465,950,2415,+
chr12,112019771,1.5790439024390244,940,624,1564,+
chr12,112019785,1.5776542523624235,616,513,1129,+
chr12,112022185,0.4872447914492088,777,556,1333,+
chr12,112022245,1.6476756004921629,879,602,1481,+
chr12,112022314,1.9382362655510288,1005,585,1590,+
chr12,112022317,1.7388026647694912,1726,1214,2940,+
chr12,112022342,2.246232838486438,1117,866,1983,+
chr12,112022344,2.028047823193381,1803,1458,3261,+
chr12,112022365,1.4875283446712018,927,521,1448,+
chr12,112022368,1.6699633699633698,872,701,1573,+
chr12,112022407,2.1602909482758617,593,463,1056,+
chr12,112022419,0.6277056277056278,2029,1616,3645,+
chr12,112022420,1.452987334801762,1110,680,1790,+
chr12,112022421,0.8971831786870083,2727,2183,4910,+
chr12,112022590,0.6992103374012922,1460,994,2454,+
chr12,112022650,0.49436383259383626,969,537,1506,+
chr12,112022651,0.4053938660784174,1265,610,1875,+
chr12,112022692,6.2039867608487,2936,852,3788,+
chr12,112022693,7.841127236592483,3735,1069,4804,+
chr12,112022696,12.207066273563191,9754,7143,16897,+
chr12,112022697,12.207066273563191,9754,7143,16897,+
chr12,112022698,12.207066273563191,9754,7143,16897,+
chr12,112022741,5.622170455388837,3479,3435,6914,+
chr12,112022749,3.915986791735065,6233,6776,13009,+
chr12,112022750,4.019376535484123,3854,4088,7942,+
chr12,112022759,0.49787127473077886,993,1451,2444,+
chr12,112022875,1.6552509105625248,838,705,1543,+
chr12,112130512,4.577038805657156,626,460,1086,+
chr12,112140874,1.739674497159527,730,500,1230,+
chr12,112140878,1.7999372844151773,1721,1062,2783,+
chr12,112140880,1.7999372844151773,1721,1062,2783,+
chr12,112140881,0.3631123919308358,959,693,1652,+
chr12,112140888,1.4593272171253824,1192,871,2063,+
chr12,112140892,1.7596438215250096,2545,1615,4160,+
chr12,112140894,1.7596438215250096,2545,1615,4160,+
chr12,112141007,1.9201974432668059,716,445,1161,+
chr12,112454569,2.74327928449019,666,455,1121,+
chr12,112477926,0.9138477060637813,803,564,1367,+
chr12,112504695,3.072310405643738,803,566,1369,+
chr12,112504696,2.233859934737127,1117,859,1976,+
chr12,112506558,2.2827557907331535,1018,818,1836,+
chr12,112506873,2.9658793224952005,603,429,1032,+
chr12,112508391,2.3179223121470014,864,603,1467,+
chr12,112508815,1.4762773506499307,674,547,1221,+
chr12,112509469,2.7030129124820665,784,409,1193,+
chr12,112509471,2.7030129124820665,784,409,1193,+
chr12,118019073,2.5615200713135495,667,458,1125,+
chr12,118019075,2.522291344125679,844,555,1399,+
chr12,118024959,0.5777972027972028,660,441,1101,+
chr12,118027963,1.213556311972769,655,465,1120,+
chr12,118027964,1.1314343253172188,1267,838,2105,+
chr12,118031562,2.389309576837417,595,448,1043,+
chr12,118031563,4.219639278557114,657,498,1155,+
chr12,118031565,4.219639278557114,657,498,1155,+
chr12,118031934,1.4407894736842104,729,399,1128,+
chr12,118031935,1.4407894736842104,729,399,1128,+
chr12,118031936,1.4407894736842104,729,399,1128,+
chr12,118136123,0.5001564177790521,982,504,1486,+
chr12,118136125,1.0256410256410255,699,384,1083,+
chr12,118136196,2.1095700416088765,701,411,1112,+
chr12,118136224,2.6414414414414416,732,443,1175,+
chr12,118136286,2.035377358490566,862,476,1338,+
chr12,118138057,0.9769711635410364,756,550,1306,+
chr12,118138058,1.4705748693478755,808,488,1296,+
chr12,118138059,0.9769711635410364,756,550,1306,+
chr12,118139461,1.5428800427464597,659,393,1052,+
chr12,118139470,1.8076533711277587,743,448,1191,+
chr12,118139487,1.4332751968712014,1153,713,1866,+
chr12,118144606,2.1535265700483093,718,574,1292,+
chr12,118144607,2.708926875593542,1140,728,1868,+
chr12,118144665,1.2250088308018368,866,645,1511,+
chr12,118144680,0.9098183126252656,3603,2683,6286,+
chr12,118144704,0.6990292589554279,1246,1059,2305,+
chr12,118144847,1.60726133824484,1787,1364,3151,+
chr12,118144855,1.6888591003872506,985,745,1730,+
chr12,118144877,1.4429230004627167,1357,988,2345,+
chr12,118145000,2.1902912621359225,939,720,1659,+
chr12,118145070,1.9231154938993813,1045,964,2009,+
chr12,118145186,0.49333253984765374,729,504,1233,+
chr12,118145201,1.1104838709677418,971,743,1714,+
chr12,118145203,1.4585526315789474,1477,1139,2616,+
chr12,118145204,1.10893387109048,1004,772,1776,+
chr12,118145217,1.539839218479699,775,633,1408,+
chr12,118145223,1.4257871064467764,950,781,1731,+
chr12,118145224,1.7375193651395868,1248,810,2058,+
chr12,118145333,1.4902797534376482,897,665,1562,+
chr12,118145407,3.262125377324527,4792,3580,8372,+
chr12,118145453,3.669154228855721,1474,1339,2813,+
chr12,118145454,2.841210815154464,4200,3538,7738,+
chr12,118145501,1.624142661179698,739,728,1467,+
chr12,118246216,3.646012454912463,866,804,1670,+
chr12,118246217,2.1370585127963886,1511,1593,3104,+
chr12,118246219,1.2414047886555972,1172,1188,2360,+
chr12,118246220,0.4538332703009347,599,445,1044,+
chr12,118246221,0.6208695652173913,849,624,1473,+
chr12,118246223,0.6853380844776638,750,522,1272,+
chr12,118246225,0.6555735733661552,1161,951,2112,+
chr12,118246229,0.9178216958982995,1088,808,1896,+
chr12,118246230,0.7438370648143253,1739,1330,3069,+
chr12,118246233,1.7813097099183604,585,605,1190,+
chr12,118246237,0.9072564281178286,2114,1836,3950,+
chr12,118246239,1.2147833474936278,2382,2353,4735,+
chr12,118246240,1.3900636294785256,2674,2726,5400,+
chr12,118246242,1.3082306228803045,1864,1924,3788,+
chr12,118246255,1.5024347959105626,1659,1285,2944,+
chr12,118246258,1.3100679793717769,5259,3167,8426,+
chr12,118246260,1.3100679793717769,5259,3167,8426,+
chr12,118246261,1.3170880564466307,4479,3566,8045,+
chr12,118246262,1.3170880564466307,4479,3566,8045,+
chr12,118246263,1.5474494115991033,8811,6443,15254,+
chr12,118246275,1.109344915416089,13539,10003,23542,+
chr12,118246276,1.2297755735723601,13576,9224,22800,+
chr12,118246302,1.3325071896697906,7472,4623,12095,+
chr12,118246308,1.2167615418099123,18286,11774,30060,+
chr12,118246309,1.2167615418099123,18286,11774,30060,+
chr12,118246321,1.1165318637774821,21243,15149,36392,+
chr12,118246327,0.9193549493400248,37221,29435,66656,+
chr12,118246583,0.5743515046003895,1418,1022,2440,+
chr12,118246584,0.5608579088471851,1045,745,1790,+
chr12,118246585,0.5608579088471851,1045,745,1790,+
chr12,118246593,1.7052280311457175,583,463,1046,+
chr12,118246596,1.1138400381264213,3681,2296,5977,+
chr12,118246597,1.107993129175712,4800,2790,7590,+
chr12,118246599,1.2385231455581092,5538,3302,8840,+
chr12,118246600,1.2721299418189553,5453,3638,9091,+
chr12,118246676,1.827489711934156,853,449,1302,+
chr12,118246678,1.5231047643556765,1630,1076,2706,+
chr12,118246683,2.518153978065292,1115,715,1830,+
chr12,118246692,1.5415911835748797,1570,1241,2811,+
chr12,118246693,1.606390713938152,2565,1674,4239,+
chr12,120282453,2.1093482216532164,580,545,1125,+
chr12,120282478,0.5479511019283747,1234,967,2201,+
chr12,120282479,1.953926398145465,612,713,1325,+
chr12,120282480,0.954123539608419,2500,2071,4571,+
chr12,120282557,1.860252004581901,579,484,1063,+
chr12,120282559,2.610598782196917,715,580,1295,+
chr12,120282580,2.0884703991717144,1693,1467,3160,+
chr12,120282581,2.4586466165413534,653,512,1165,+
chr12,120282582,1.784641638225256,503,585,1088,+
chr12,120282584,1.2642201131733235,907,646,1553,+
chr12,120282588,1.32963620230701,665,538,1203,+
chr12,120282590,0.4743729552889859,1304,916,2220,+
chr12,120282591,1.6244968998150768,785,633,1418,+
chr12,120282592,0.4505515587529976,670,694,1364,+
chr12,120282808,0.9286366533450774,1722,1167,2889,+
chr12,120282810,0.9286366533450774,1722,1167,2889,+
chr12,120282818,0.6467136150234742,1253,780,2033,+
chr12,120282826,2.4552711257913566,668,518,1186,+
chr12,120438112,0.7002873695777371,872,530,1402,+
chr12,120438117,0.771510843474826,2206,1290,3496,+
chr12,120438120,1.6076019256720955,4160,2199,6359,+
chr12,120438121,1.5475425818661468,3721,1854,5575,+
chr12,120438122,1.6239972608100175,5269,2689,7958,+
chr12,120438124,1.606962481962482,2868,1511,4379,+
chr12,120438134,1.7956748695003728,687,595,1282,+
chr12,120438200,2.134920634920635,1075,521,1596,+
chr12,120438383,0.5843612021079617,788,594,1382,+
chr12,120440505,2.6882102272727275,756,351,1107,+
chr12,120440506,2.6882102272727275,756,351,1107,+
chr12,120440530,1.0816505706760318,1363,1053,2416,+
chr12,120440531,0.9489013281745627,1811,1343,3154,+
chr12,120440532,1.616789739603575,1791,867,2658,+
chr12,120440534,1.616789739603575,1791,867,2658,+
chr12,120440539,0.639327731092437,950,713,1663,+
chr12,120440551,1.4267317172608387,2127,1577,3704,+
chr12,120496112,0.8612974420460328,3484,1245,4729,+
chr12,120496115,2.965845724907063,850,268,1118,+
chr12,120496122,3.5681475903614457,1052,331,1383,+
chr12,120496123,1.9686760152977607,939,322,1261,+
chr12,120496167,2.7884615384615383,1246,515,1761,+
chr12,120496179,2.221007236930383,3723,1882,5605,+
chr12,120496200,1.3544963359076232,5253,2785,8038,+
chr12,120496407,3.6804907648361143,991,728,1719,+
chr12,120496444,1.7307420494699648,789,565,1354,+
chr12,120496509,0.5039634392946696,732,633,1365,+
chr12,120496511,1.7194660873561298,1582,976,2558,+
chr12,120496512,1.5596659233022867,963,692,1655,+
chr12,120498073,0.4815371605750258,1024,733,1757,+
chr12,120498197,0.5288559204653882,780,612,1392,+
chr12,120498236,1.8295279959030384,2065,1615,3680,+
chr12,120498273,1.4268760907504363,1240,954,2194,+
chr12,120696583,44.28101858784045,690,435,1125,+
chr12,120696584,40.0037230923163,782,544,1326,+
chr12,121888911,2.3908671753762603,1067,669,1736,+
chr12,121888950,3.052631578947368,749,474,1223,+
chr12,121888952,3.052631578947368,749,474,1223,+
chr12,121915863,2.1289671749599273,668,468,1136,+
chr12,121915865,3.0101401362443285,671,478,1149,+
chr12,121916290,1.0,629,413,1042,+
chr12,121916291,2.309873949579832,732,475,1207,+
chr12,121916292,1.7029870418598743,1361,888,2249,+
chr12,122604909,2.05406195207481,638,471,1109,+
chr12,122604910,2.0637578742163507,899,634,1533,+
chr12,122604917,2.984313360739443,1091,840,1931,+
chr12,122604919,2.805928237129485,781,640,1421,+
chr12,122604944,1.9442025043184554,993,812,1805,+
chr12,122620571,1.4794633974608609,919,685,1604,+
chr12,122620585,0.9812903225806453,1520,1249,2769,+
chr12,122620586,0.9812903225806453,1520,1249,2769,+
chr12,122770252,1.2359439417682865,663,510,1173,+
chr12,122981620,1.7907699972693618,970,703,1673,+
chr12,122981626,1.5892913788790597,1178,870,2048,+
chr12,122982058,0.4510192883974171,821,550,1371,+
chr12,122982469,1.8356709744594844,696,562,1258,+
chr12,122982470,1.1027272727272726,1212,714,1926,+
chr12,122982471,1.1027272727272726,1212,714,1926,+
chr12,122982475,2.389065718030332,869,762,1631,+
chr12,122982479,2.302133411153946,1933,1833,3766,+
chr12,122982480,2.044298790075641,2968,2876,5844,+
chr12,122982482,2.0785008879179285,2020,2006,4026,+
chr12,122982620,1.7226385350519393,1223,941,2164,+
chr12,122982837,7.072369889234373,2013,1444,3457,+
chr12,122982838,6.327411709605602,2410,1729,4139,+
chr12,123584637,0.33592406650272877,648,600,1248,+
chr12,123584652,0.37931403415888804,1196,992,2188,+
chr12,123584653,1.397220212074305,1078,938,2016,+
chr12,123586751,2.591981730525247,680,562,1242,+
chr12,123586761,1.667879890809827,563,470,1033,+
chr12,123586848,1.6044672727730538,2249,1504,3753,+
chr12,123590344,1.9708846584546476,1023,751,1774,+
chr12,123590347,1.6892483643295038,1092,825,1917,+
chr12,123590357,1.7352688690619722,2810,1884,4694,+
chr12,123590359,1.716914058661639,4171,2977,7148,+
chr12,123590362,0.6857762719923919,1845,1401,3246,+
chr12,123596617,0.6451980871320143,1367,990,2357,+
chr12,123597539,1.4215239282317054,698,708,1406,+
chr12,123597652,1.671163475699558,787,678,1465,+
chr12,123597858,1.5616612989801395,949,647,1596,+
chr12,123597863,1.577060931899642,799,557,1356,+
chr12,123597869,0.7455617945663887,955,652,1607,+
chr12,124011738,2.8138581168232912,691,479,1170,+
chr12,124011740,2.8138581168232912,691,479,1170,+
chr12,124012375,1.4129740383308413,605,446,1051,+
chr12,124014194,1.1241396933248593,337,1145,1482,+
chr12,124014195,1.064509048664496,418,1366,1784,+
chr12,124014196,0.4933507226545796,354,1062,1416,+
chr12,124014197,0.24571674096353185,304,865,1169,+
chr12,124014356,9.929298722999695,748,631,1379,+
chr12,124014357,7.438481464811012,1413,1172,2585,+
chr12,124014358,6.0009788309598004,1065,950,2015,+
chr12,124014610,1.9749542814934746,972,809,1781,+
chr12,124014672,0.5963963963963964,661,479,1140,+
chr12,124014699,1.7424242424242427,804,615,1419,+
chr12,124014706,2.469725343320849,964,800,1764,+
chr12,124014731,1.759797541277038,3762,3688,7450,+
chr12,124014732,1.759797541277038,3762,3688,7450,+
chr12,124014733,1.759797541277038,3762,3688,7450,+
chr12,124014842,27.592844372760425,1358,1099,2457,+
chr12,124014843,18.605678597900344,3406,2763,6169,+
chr12,124014844,18.605678597900344,3406,2763,6169,+
chr12,124014845,16.05062868231751,2417,2134,4551,+
chr12,125086361,2.775448536355052,667,352,1019,+
chr12,125086363,2.775448536355052,667,352,1019,+
chr12,130165254,0.41445973485997195,570,439,1009,+
chr12,130165385,0.37118101839509465,1070,604,1674,+
chr12,130165387,0.37118101839509465,1070,604,1674,+
chr12,130165392,2.7895545314900154,907,619,1526,+
chr12,130165393,2.7895545314900154,907,619,1526,+
chr12,130165410,0.9401222307104659,1662,849,2511,+
chr12,130165411,0.9401222307104659,1662,849,2511,+
chr12,130165427,0.5302871148459384,698,475,1173,+
chr12,130165449,2.1794839731566005,1375,726,2101,+
chr12,130165506,2.1373756481952033,7616,5228,12844,+
chr12,130165507,2.1835910636919995,8541,5739,14280,+
chr12,130165511,1.4471762097300118,1706,901,2607,+
chr12,130165514,2.0896618625277164,1773,983,2756,+
chr12,130165520,0.6486463871698771,2583,1924,4507,+
chr12,130872082,1.53236519193966,995,566,1561,+
chr12,130872085,1.148556170118315,4859,3715,8574,+
chr12,130872607,1.3390557939914165,1871,1630,3501,+
chr12,130872836,1.5267383618149677,2255,1696,3951,+
chr12,130872838,1.5267383618149677,2255,1696,3951,+
chr12,130873054,1.5130023640661938,4184,2510,6694,+
chr12,130873058,1.3013463682360005,2427,1689,4116,+
chr12,130873059,1.2833746795899499,3910,3012,6922,+
chr12,130874559,0.9708218131791142,9551,7196,16747,+
chr12,130874593,1.5028213893380822,4028,2990,7018,+
chr12,130875609,1.199273722075066,5429,4428,9857,+
chr12,130875610,1.2631266417584055,10910,8910,19820,+
chr12,130875611,1.3183023079289091,10293,8483,18776,+
chr12,130875612,1.4103324508856878,9943,8171,18114,+
chr12,130875631,1.311816784774372,2316,1656,3972,+
chr12,130875730,2.1143137495400466,1013,525,1538,+
chr12,130875761,1.6662301522344083,1304,744,2048,+
chr12,130875885,1.4575577066269545,1739,1105,2844,+
chr12,130875951,1.4506255616230042,2357,1701,4058,+
chr12,130875958,1.2078258424472037,7591,5515,13106,+
chr12,130875959,1.2078258424472037,7591,5515,13106,+
chr12,130876062,1.5550909908931536,2202,1498,3700,+
chr12,131941314,3.429597289310491,885,665,1550,+
chr12,132721871,0.36301567490123604,1085,608,1693,+
chr12,132721872,0.36301567490123604,1085,608,1693,+
chr12,132722517,1.4357376306033938,1254,676,1930,+
chr12,132825696,0.8362630220636105,2248,1738,3986,+
chr12,132825698,1.0385703918722786,1391,1039,2430,+
chr12,132825699,0.6157507522969371,960,746,1706,+
chr12,132825704,0.7606859466194505,3177,2391,5568,+
chr12,132825705,0.5875293929093639,4607,4218,8825,+
chr12,132825706,0.7050023044494641,11316,9097,20413,+
chr12,132825707,0.9562648205955844,6030,4280,10310,+
chr12,132825709,1.178272656611727,4410,3160,7570,+
chr12,132825837,1.5458911477814865,1230,946,2176,+
chr12,132825839,1.8156093160775548,792,606,1398,+
chr12,132825869,0.5146853146853146,767,527,1294,+
chr12,132825871,0.7745611889244999,1320,1004,2324,+
chr12,132825873,1.1010460251046026,553,477,1030,+
chr12,132825915,0.46480862224069736,2498,1993,4491,+
chr12,132825916,0.7467799831081079,986,887,1873,+
chr12,132826013,1.2268487288340506,6442,4025,10467,+
chr12,132826014,1.0259569657436296,14413,9489,23902,+
chr12,132826015,1.0386542646251635,40821,34867,75688,+
chr12,132826016,1.0600908477977278,61157,46610,107767,+
chr12,132826017,1.064327001744463,65251,57093,122344,+
chr12,132826018,1.1341036808211893,32278,19638,51916,+
chr12,132826019,1.024149064817498,152698,113084,265782,+
chr12,132826020,1.1019219362334072,114931,96935,211866,+
chr12,132826021,1.0930838563898124,168356,107991,276347,+
chr12,132826022,1.1444657225608024,234834,189861,424695,+
chr12,132826023,1.1878138469283062,140311,121449,261760,+
chr12,132826024,1.2127240913040584,249203,205775,454978,+
chr12,132826026,1.2493362381556257,145068,121332,266400,+
chr12,132826209,1.464424286381832,729,454,1183,+
chr13,18297944,1.707320289711488,886,607,1493,+
chr13,18297945,1.2099509762978695,1187,822,2009,+
chr13,18297947,1.2496081423615226,799,614,1413,+
chr13,21140959,1.168143413977176,1876,1107,2983,+
chr13,21140960,0.8428411264261689,1277,770,2047,+
chr13,21140975,0.6368055555555555,785,479,1264,+
chr13,21140976,1.4145488292404338,1320,823,2143,+
chr13,21146814,1.496008569385677,2579,1673,4252,+
chr13,21146817,2.2406667191745755,2126,1515,3641,+
chr13,21146819,1.9638504472819018,3271,2377,5648,+
chr13,21146820,1.8314581097252551,3492,2635,6127,+
chr13,21146822,1.7749255803006219,6180,4505,10685,+
chr13,21146824,1.839045898119568,5035,3643,8678,+
chr13,21147269,1.8642305407011295,752,458,1210,+
chr13,21147289,4.62202166064982,825,553,1378,+
chr13,21147299,1.6659366576819403,637,423,1060,+
chr13,21177136,2.5274111714587133,966,591,1557,+
chr13,21177138,2.6995416680726576,1293,855,2148,+
chr13,21177209,2.4405648837985097,707,528,1235,+
chr13,21177211,2.2392344497607657,1091,835,1926,+
chr13,21177213,2.2651051370774558,739,577,1316,+
chr13,25097067,0.9030384202099271,774,476,1250,+
chr13,25097100,3.8444891125563654,632,396,1028,+
chr13,25097161,1.0435311648382968,879,632,1511,+
chr13,25097974,1.0141501274560298,1128,836,1964,+
chr13,25097975,0.5259345117357288,824,594,1418,+
chr13,25312932,1.2340292979631373,601,497,1098,+
chr13,25341686,1.647729520766025,562,455,1017,+
chr13,27424901,1.6875987434854003,755,495,1250,+
chr13,27427150,1.5579876054169879,675,593,1268,+
chr13,27434142,2.369920369790863,639,430,1069,+
chr13,27434835,2.010393466963623,676,448,1124,+
chr13,27435436,0.5426356589147286,643,413,1056,+
chr13,27623029,2.5062565781779904,738,502,1240,+
chr13,27623218,0.46837753902884716,1540,964,2504,+
chr13,27945260,1.8743545611015489,604,414,1018,+
chr13,27945266,1.6452014956377232,719,497,1216,+
chr13,27945278,0.6722675568440525,2340,1770,4110,+
chr13,27945282,1.4822612543726505,2957,2041,4998,+
chr13,27945384,0.8293871177471965,1093,702,1795,+
chr13,27945386,1.166678153208772,2264,1435,3699,+
chr13,27945388,1.308160733651562,1535,954,2489,+
chr13,27945403,1.7389298892988927,714,541,1255,+
chr13,27945410,0.7595644698648991,2548,1630,4178,+
chr13,27945411,0.7595644698648991,2548,1630,4178,+
chr13,27945412,1.4525031405211637,4850,4494,9344,+
chr13,27945413,1.4069647478491993,3317,2522,5839,+
chr13,27945414,1.5283658152177686,1533,1972,3505,+
chr13,28659171,2.0474967907573807,637,409,1046,+
chr13,28662420,1.8968572031217041,781,430,1211,+
chr13,28662424,2.767080745341614,593,459,1052,+
chr13,28662430,0.6308595173871838,640,472,1112,+
chr13,28662495,0.6104844394728249,2178,1504,3682,+
chr13,28668548,1.760276073619632,997,814,1811,+
chr13,28672350,1.790967869794634,1290,1090,2380,+
chr13,28672373,1.5382653061224492,1223,1087,2310,+
chr13,28672393,1.8246483401025575,1530,1482,3012,+
chr13,28672397,1.934429708222812,1695,1739,3434,+
chr13,28672404,1.550930300765107,5613,5976,11589,+
chr13,28672405,1.31300074636921,8923,10216,19139,+
chr13,28672407,1.6514749698105593,3935,4816,8751,+
chr13,28672409,0.6125373519358513,3652,3619,7271,+
chr13,28672410,1.6103368176538908,2067,1847,3914,+
chr13,33821185,1.09506983701715,692,584,1276,+
chr13,33823932,1.713147028786195,724,529,1253,+
chr13,33831291,0.41424110481948345,649,460,1109,+
chr13,33836200,1.0120156046814044,1215,768,1983,+
chr13,33836202,0.8262171801251073,1675,1054,2729,+
chr13,33836235,1.9626390942315843,1245,872,2117,+
chr13,37005977,1.124811578694799,622,487,1109,+
chr13,37008059,2.9219092203613464,631,530,1161,+
chr13,38361564,1.4856100199026578,6309,4488,10797,+
chr13,38361565,1.4786630278819777,8095,5602,13697,+
chr13,38362014,2.4075039082855656,659,504,1163,+
chr13,38362016,2.9638323679293115,805,626,1431,+
chr13,39719758,1.6465608465608466,777,440,1217,+
chr13,39719766,0.3865217391304348,888,574,1462,+
chr13,39719767,2.1819787985865724,987,565,1552,+
chr13,39719773,1.7096296296296296,1153,674,1827,+
chr13,39719778,1.6325522594302178,1261,790,2051,+
chr13,39719787,1.6372507268895324,6016,3946,9962,+
chr13,39719788,1.6372507268895324,6016,3946,9962,+
chr13,41466878,3.2214765100671134,899,595,1494,+
chr13,41466880,2.850911332453223,760,557,1317,+
chr13,41468794,2.8765652951699465,669,429,1098,+
chr13,41468796,2.8765652951699465,669,429,1098,+
chr13,45151761,2.82168965754647,733,550,1283,+
chr13,45252878,5.628612716763007,819,691,1510,+
chr13,45252892,0.6274975699319582,829,590,1419,+
chr13,45252911,1.4995753715498938,1008,784,1792,+
chr13,45252930,1.639069365207507,3816,3282,7098,+
chr13,45252931,1.6862803840130731,2691,2318,5009,+
chr13,45252938,1.3897251585623678,1428,1289,2717,+
chr13,45252948,2.3270516717325225,1913,1819,3732,+
chr13,45283465,0.37270128695412885,694,445,1139,+
chr13,45283635,4.224579053741281,887,609,1496,+
chr13,45283672,1.6273904532449932,654,457,1111,+
chr13,45283824,11.30438299188822,1672,1174,2846,+
chr13,46491114,0.6245283018867925,661,439,1100,+
chr13,46491117,1.659318897958585,1704,1195,2899,+
chr13,46491119,1.9862026236412331,1308,998,2306,+
chr13,47763413,2.4586069418386494,722,327,1049,+
chr13,47763428,1.5810660779776866,655,599,1254,+
chr13,47763430,1.1703904322632008,981,620,1601,+
chr13,47763447,2.1285475824307967,1258,1000,2258,+
chr13,47763548,0.5411567017038642,914,746,1660,+
chr13,47763549,0.5243225895117399,1287,959,2246,+
chr13,48253835,0.4801907816323411,670,560,1230,+
chr13,48253876,1.9659442724458205,634,492,1126,+
chr13,48256244,2.2832783363647287,1631,1238,2869,+
chr13,48256313,3.1087719298245613,885,550,1435,+
chr13,48258147,1.6985038274182322,750,478,1228,+
chr13,48258203,2.6897893772893773,757,545,1302,+
chr13,48258805,1.8688888888888888,782,485,1267,+
chr13,48258825,1.5022976316719692,849,551,1400,+
chr13,48261185,2.1803229665071773,633,417,1050,+
chr13,48261191,0.6512329347020849,1190,858,2048,+
chr13,49145805,0.34079989222160834,679,506,1185,+
chr13,49145806,0.9885880255480893,648,511,1159,+
chr13,49175389,1.444937291331981,676,513,1189,+
chr13,49524166,0.6320736434108527,592,429,1021,+
chr13,49524171,1.2127976190476188,814,575,1389,+
chr13,49524173,1.2127976190476188,814,575,1389,+
chr13,49524180,1.8860220097007412,2212,1783,3995,+
chr13,49524181,1.8298171275994495,3269,2663,5932,+
chr13,49524182,1.938536190861302,3008,2472,5480,+
chr13,49524183,1.906442765362532,2304,1931,4235,+
chr13,50172422,1.2055739488902333,1207,765,1972,+
chr13,50172423,1.2822711844354782,1475,893,2368,+
chr13,50172424,1.2822711844354782,1475,893,2368,+
chr13,50172425,1.0361305200012878,884,607,1491,+
chr13,50172440,2.2464340952053616,816,505,1321,+
chr13,50172442,1.7440314716539174,1152,731,1883,+
chr13,50927447,4.065050305528034,604,400,1004,+
chr13,52456539,0.9206400742115028,862,538,1400,+
chr13,52456540,1.2271521226415094,1331,847,2178,+
chr13,52456542,1.943637250121892,905,585,1490,+
chr13,52456561,0.47091204443243684,1040,618,1658,+
chr13,52461785,0.8564397841665707,631,477,1108,+
chr13,52474899,3.299909003034003,746,502,1248,+
chr13,52657554,1.6491892146693536,733,586,1319,+
chr13,52666876,0.4176349906150421,2813,1477,4290,+
chr13,52666878,0.4176349906150421,2813,1477,4290,+
chr13,52666885,1.5233139348995448,2347,1219,3566,+
chr13,52666890,0.5990469422731263,842,508,1350,+
chr13,52676301,1.5220468154599889,931,500,1431,+
chr13,52676306,1.8895951823352288,705,426,1131,+
chr13,52676308,1.7297918055864268,630,408,1038,+
chr13,52679975,1.1497777436480756,3789,1987,5776,+
chr13,52679977,1.0151831392095023,3245,1668,4913,+
chr13,52679979,2.050243427458617,657,394,1051,+
chr13,73059103,4.037872953745117,976,2503,3479,+
chr13,73059104,3.4051091258369968,1116,3029,4145,+
chr13,73059105,2.8649536101966575,996,3230,4226,+
chr13,73059106,2.2395286917819113,537,2096,2633,+
chr13,73059107,0.3148944359775306,598,1887,2485,+
chr13,73063839,2.7845444426776917,795,330,1125,+
chr13,73063840,2.7845444426776917,795,330,1125,+
chr13,73063851,1.1369341955116012,853,477,1330,+
chr13,73063852,1.1369341955116012,853,477,1330,+
chr13,73075710,0.5625570776255707,727,437,1164,+
chr13,73075982,2.2721960385594326,672,441,1113,+
chr13,75760974,2.617450057220929,599,426,1025,+
chr13,75796684,0.4570877531340405,631,487,1118,+
chr13,75800706,3.754437869822485,563,506,1069,+
chr13,75800707,3.754437869822485,563,506,1069,+
chr13,75817160,2.6380926422136537,1179,740,1919,+
chr13,75817164,1.7433537832310844,714,488,1202,+
chr13,75817187,1.7414907367514005,845,632,1477,+
chr13,75817189,1.7831287128712872,803,504,1307,+
chr13,75817193,2.3400000000000003,647,399,1046,+
chr13,75817266,1.8454460093896716,633,425,1058,+
chr13,75823753,1.1227468981564466,755,598,1353,+
chr13,75823810,0.6034285714285714,626,474,1100,+
chr13,75835242,0.6242654969792271,793,561,1354,+
chr13,75835312,1.7888888888888888,643,395,1038,+
chr13,75841641,2.4545882352941177,651,424,1075,+
chr13,75841642,2.4545882352941177,651,424,1075,+
chr13,75841811,2.9528023598820057,571,451,1022,+
chr13,75849099,3.094165830843648,988,612,1600,+
chr13,75849127,2.6758569299552906,531,487,1018,+
chr13,75858187,2.238457340382323,1067,793,1860,+
chr13,75858412,2.036136698869424,917,700,1617,+
chr13,75858418,0.6068281938325991,550,453,1003,+
chr13,78909221,1.4953840454310376,667,509,1176,+
chr13,78909222,1.695262190423277,894,552,1446,+
chr13,78909425,2.8253571067811944,729,534,1263,+
chr13,78909602,1.5035581167588479,798,660,1458,+
chr13,78909603,1.8583324743507812,728,640,1368,+
chr13,78909633,1.5818892229800818,1013,925,1938,+
chr13,79533326,0.9722222222222224,566,485,1051,+
chr13,79533328,0.9722222222222224,566,485,1051,+
chr13,79551052,0.9684473601999375,774,581,1355,+
chr13,79551053,0.9684473601999375,774,581,1355,+
chr13,79552570,2.0544918998527244,809,581,1390,+
chr13,79553070,0.4981542518127884,686,409,1095,+
chr13,79553229,1.9215344915679442,2144,948,3092,+
chr13,79553230,1.9695678636640288,1617,681,2298,+
chr13,79553284,0.4665548242784015,1495,755,2250,+
chr13,79553285,0.4554451634711426,2706,1206,3912,+
chr13,79553286,0.4665548242784015,1495,755,2250,+
chr13,79553349,1.7169702780441036,2419,1399,3818,+
chr13,79553351,1.2932958980836355,4395,2222,6617,+
chr13,79553354,0.9514157679107066,7857,3672,11529,+
chr13,79553355,1.3664832767191741,2365,1600,3965,+
chr13,81690235,1.115731567918488,876,487,1363,+
chr13,81690237,1.115731567918488,876,487,1363,+
chr13,81690260,3.565464838404365,585,556,1141,+
chr13,81690263,4.539461425069904,1625,1570,3195,+
chr13,97222372,1.7024068072336507,593,419,1012,+
chr13,97275700,2.039820675105485,594,473,1067,+
chr13,97275731,0.5262807717897539,677,500,1177,+
chr13,97275753,3.7356636135643653,608,531,1139,+
chr13,97276204,2.1430940461094923,909,642,1551,+
chr13,97357501,2.9391486820392276,626,430,1056,+
chr13,97357530,1.5441764056424558,664,512,1176,+
chr13,97391329,1.1164541994316253,834,591,1425,+
chr13,97391978,0.5241218151665913,817,602,1419,+
chr13,97392020,2.6453263087843837,641,486,1127,+
chr13,97392204,1.3221764203702486,1251,928,2179,+
chr13,97392490,1.457253480517341,1381,994,2375,+
chr13,97392948,1.4355047885075816,1085,715,1800,+
chr13,97392978,0.4873027157685199,1070,540,1610,+
chr13,97392988,0.5537854428529669,1262,621,1883,+
chr13,97393042,1.3640549963818174,1884,1125,3009,+
chr13,97393129,0.4168550873586845,675,416,1091,+
chr13,97393677,2.1864551967921577,997,660,1657,+
chr13,97393813,4.007900207900208,713,480,1193,+
chr13,97393865,2.6153846153846154,713,454,1167,+
chr13,97976720,1.072733167621312,708,486,1194,+
chr13,97976721,1.072733167621312,708,486,1194,+
chr13,97976723,1.940990480986608,803,609,1412,+
chr13,97982513,2.4329464285714284,878,559,1437,+
chr13,97982515,1.5324494949494951,686,593,1279,+
chr13,97982532,1.4752066115702478,1104,714,1818,+
chr13,97982533,1.698328690807799,870,717,1587,+
chr13,97985427,1.4932403074393064,2411,1799,4210,+
chr13,97989071,0.6722939488784561,2677,1439,4116,+
chr13,97989072,0.6722939488784561,2677,1439,4116,+
chr13,97989073,1.714761706431844,1047,685,1732,+
chr13,97990127,1.6722135194640548,10581,5878,16459,+
chr13,97990128,1.9627925828351405,4903,2779,7682,+
chr13,97990136,1.3252064688064018,6309,3896,10205,+
chr13,97990138,1.3252064688064018,6309,3896,10205,+
chr13,97990148,1.224275672142194,4844,2448,7292,+
chr13,97990160,1.3345040420691634,15628,9954,25582,+
chr13,97990162,1.2438349872386123,18598,11637,30235,+
chr13,97990163,0.7413088224551272,5788,3314,9102,+
chr13,97990166,1.8017736322968296,11749,8397,20146,+
chr13,97990167,1.483707486493826,30993,18615,49608,+
chr13,97990505,1.538064516129032,1191,867,2058,+
chr13,97992895,1.764385550916682,1079,786,1865,+
chr13,97992946,1.837860064308455,2219,1467,3686,+
chr13,97992998,1.6876797954327518,1079,760,1839,+
chr13,97993129,2.2440585895819187,1075,792,1867,+
chr13,97997564,0.7191268812917373,1442,1142,2584,+
chr13,97997600,2.186169248890097,1989,1697,3686,+
chr13,98000565,1.4465714455046526,903,717,1620,+
chr13,98000609,1.95846394984326,1070,695,1765,+
chr13,98002472,1.806650417827298,978,717,1695,+
chr13,98002473,0.6790068523627302,1089,660,1749,+
chr13,98002488,1.5141557703240478,2315,1758,4073,+
chr13,98002489,1.5040451049986838,3642,2562,6204,+
chr13,98002891,1.8020186335403725,843,551,1394,+
chr13,98002939,0.9907208116421786,2756,1975,4731,+
chr13,98002947,2.5379310344827597,965,724,1689,+
chr13,98003006,0.6773896117201106,1391,907,2298,+
chr13,98008072,1.7967155004150497,1404,840,2244,+
chr13,98008075,2.657342657342657,1101,753,1854,+
chr13,98009884,0.6265262184461109,1354,1002,2356,+
chr13,98009984,1.427007299270073,1172,821,1993,+
chr13,98012329,1.6255131362889983,1347,811,2158,+
chr13,98014119,1.6793806327285647,2559,1883,4442,+
chr13,98014121,1.963815789473684,1193,831,2024,+
chr13,98014129,0.6622933044185415,1526,1053,2579,+
chr13,98014165,1.0291050149954957,4733,2998,7731,+
chr13,98014171,0.7265786344577256,3009,1652,4661,+
chr13,98015536,1.8365602454029784,9831,5504,15335,+
chr13,98015537,1.8365602454029784,9831,5504,15335,+
chr13,98015564,1.6154318048426233,9060,5702,14762,+
chr13,98015589,1.5204632005567702,15055,8862,23917,+
chr13,98015590,1.5204632005567702,15055,8862,23917,+
chr13,98015593,1.7975327981202271,8234,5106,13340,+
chr13,98015626,1.9475033425629868,26433,21828,48261,+
chr13,98015627,1.9475033425629868,26433,21828,48261,+
chr13,98016795,1.5090830156804518,5875,3700,9575,+
chr13,98016796,1.465168082299603,4571,2897,7468,+
chr13,98016797,1.5728123280132087,2597,1816,4413,+
chr13,98018530,1.5226643966801447,944,888,1832,+
chr13,98019631,1.6413158825610188,1043,770,1813,+
chr13,98019632,1.3643730820763276,1829,1360,3189,+
chr13,98019764,1.6524073742616792,1153,905,2058,+
chr13,98021016,1.9636670891423744,995,788,1783,+
chr13,98021038,2.5243664717348926,2071,1880,3951,+
chr13,98021040,2.5243664717348926,2071,1880,3951,+
chr13,98021806,1.8265755297334243,1712,1044,2756,+
chr13,98021807,0.30980392156862746,789,509,1298,+
chr13,98021808,1.8265755297334243,1712,1044,2756,+
chr13,98021810,2.254681346942056,904,540,1444,+
chr13,98021819,1.5439831773583421,2074,1357,3431,+
chr13,98021827,0.6508556967100151,1038,752,1790,+
chr13,98021828,1.7959228771891056,1203,786,1989,+
chr13,98021851,0.7233185185185186,2153,1124,3277,+
chr13,98021857,0.6156265657184212,2601,1632,4233,+
chr13,98021866,1.1818121264728674,11344,7113,18457,+
chr13,98021867,1.1818121264728674,11344,7113,18457,+
chr13,98021871,0.5033747850715274,7709,4266,11975,+
chr13,98021872,0.5033747850715274,7709,4266,11975,+
chr13,98021911,1.9670225706176512,1531,1207,2738,+
chr13,98022020,2.0762628394540594,867,617,1484,+
chr13,98022057,0.6368526622902991,1269,913,2182,+
chr13,98022248,1.5978676872607982,834,707,1541,+
chr13,98022396,2.6526315789473687,755,569,1324,+
chr13,98022595,1.8487858719646797,669,452,1121,+
chr13,98022667,0.5022920759659463,766,508,1274,+
chr13,98022705,2.0493683639463693,852,560,1412,+
chr13,98343847,1.3721932702824422,687,470,1157,+
chr13,98343848,1.181003312598773,839,577,1416,+
chr13,98343852,1.9502661104718062,842,868,1710,+
chr13,98343853,1.9502661104718062,842,868,1710,+
chr13,98343854,1.9502661104718062,842,868,1710,+
chr13,99238516,2.0267446729662475,695,504,1199,+
chr13,99314127,1.7455727725511898,813,555,1368,+
chr13,99340319,2.3079694323144104,782,457,1239,+
chr13,99340320,2.3079694323144104,782,457,1239,+
chr13,99340340,1.7597508492421134,1035,633,1668,+
chr13,99340432,2.1371651958384907,1031,740,1771,+
chr13,99367790,2.245642701525054,664,509,1173,+
chr13,99367792,1.550404449810797,1136,876,2012,+
chr13,99367798,0.34545331894225584,568,435,1003,+
chr13,99385288,0.9637057086614174,745,507,1252,+
chr13,99385289,0.9637057086614174,745,507,1252,+
chr13,99385430,1.5724196990488608,1327,795,2122,+
chr13,99385431,0.9022843599886945,1030,609,1639,+
chr13,99385477,1.8979591836734693,712,489,1201,+
chr13,99385488,1.6385137163095027,852,616,1468,+
chr13,99385489,2.7678385416666664,732,511,1243,+
chr13,99385510,0.6799557032115172,1227,902,2129,+
chr13,99385769,1.7971887550200802,536,497,1033,+
chr13,99385820,0.5186915887850467,628,427,1055,+
chr13,99386283,6.721211505774483,1235,889,2124,+
chr13,99386284,6.280330392503469,1907,1305,3212,+
chr13,99386285,6.233529819694867,764,411,1175,+
chr13,99386287,4.653697998850445,1328,994,2322,+
chr13,99386303,0.5240706886045094,644,546,1190,+
chr13,99386304,1.9584905660377356,864,529,1393,+
chr13,99386305,1.3994595387205837,1325,940,2265,+
chr13,99501753,0.6841483851310176,780,546,1326,+
chr13,99501754,0.9212166540409978,1676,1074,2750,+
chr13,99501755,0.8505578776364426,2533,1603,4136,+
chr13,99501757,1.3944192156860553,1576,993,2569,+
chr13,99520075,1.727297325819853,1107,856,1963,+
chr13,99520083,0.5131235876933774,737,522,1259,+
chr13,99529479,2.3994252873563218,667,521,1188,+
chr13,99536700,0.5792945952803857,760,562,1322,+
chr13,99539503,1.5992647058823528,674,407,1081,+
chr13,99539522,0.476844583987441,809,489,1298,+
chr13,99540722,0.47050512186506543,665,446,1111,+
chr13,99540739,2.606326422115896,794,593,1387,+
chr13,99540740,2.606326422115896,794,593,1387,+
chr13,99541558,2.4200656352555088,711,473,1184,+
chr13,99541560,2.4200656352555088,711,473,1184,+
chr13,99541595,1.7753232758620687,658,463,1121,+
chr13,99541648,2.7009394572025047,574,478,1052,+
chr13,99543875,2.1604215456674467,614,426,1040,+
chr13,99552192,1.797129186602871,625,417,1042,+
chr13,99554399,3.5682373117690807,890,741,1631,+
chr13,99554421,1.9413919413919412,635,454,1089,+
chr13,99555592,2.662721893491124,593,428,1021,+
chr13,99555593,0.5455238095238095,715,524,1239,+
chr13,99559384,2.138377999649676,762,518,1280,+
chr13,99559387,2.986015672091621,798,552,1350,+
chr13,99562729,1.8651270207852193,672,432,1104,+
chr13,99562870,1.8764302059496565,614,436,1050,+
chr13,102853846,2.88494756468774,831,587,1418,+
chr13,109265594,2.063130491376505,633,438,1071,+
chr13,109265595,3.554252674831656,1023,724,1747,+
chr13,109265599,1.544210287194696,685,406,1091,+
chr13,110506536,1.4814957915930937,878,568,1446,+
chr13,110512695,0.9927953890489912,953,693,1646,+
chr13,110512696,0.9927953890489912,953,693,1646,+
chr13,110512930,1.2541576811379276,633,507,1140,+
chr13,110939139,0.5958877945637102,588,515,1103,+
chr13,113076095,2.066285128555565,589,508,1097,+
chr13,113076097,2.066285128555565,589,508,1097,+
chr13,113209750,2.117221245771981,795,484,1279,+
chr13,113209972,1.7908815821734252,859,597,1456,+
chr13,113218949,1.7528735632183907,731,431,1162,+
chr13,113218958,1.6543513957307063,991,671,1662,+
chr13,113218966,2.2295817162570075,1123,772,1895,+
chr13,113218987,1.4085203477133723,2516,1836,4352,+
chr13,113219011,1.5672999887231283,2696,1842,4538,+
chr13,113229494,1.7466666666666666,916,794,1710,+
chr13,113230080,0.4707140666133726,684,535,1219,+
chr13,113230098,0.4100435180943656,650,471,1121,+
chr13,113230113,1.7005300353356891,769,565,1334,+
chr13,113235076,1.8165268478885634,1658,1166,2824,+
chr13,113236830,1.5395755852111137,950,652,1602,+
chr13,113242973,2.2249636955639676,1018,669,1687,+
chr13,113243075,1.6211453744493394,574,453,1027,+
chr13,113244441,2.144960912706854,1474,1197,2671,+
chr13,113244445,1.6432997987927564,995,709,1704,+
chr13,113245179,2.4577836411609497,1034,757,1791,+
chr13,113245181,2.4577836411609497,1034,757,1791,+
chr13,113245962,0.599791738979521,767,535,1302,+
chr13,113254701,0.6455140546784751,761,489,1250,+
chr13,113254717,2.7480170835875533,562,446,1008,+
chr13,113254775,1.7944578313253012,676,414,1090,+
chr13,113254956,3.143149284253578,688,488,1176,+
chr13,113254959,1.9465926948902332,1602,912,2514,+
chr13,113254961,1.9465926948902332,1602,912,2514,+
chr13,113254979,1.729319291819292,730,503,1233,+
chr13,113255013,1.6447784810126584,1007,631,1638,+
chr13,113255016,1.7378552227342547,882,671,1553,+
chr13,113263588,2.2439024390243905,735,491,1226,+
chr13,113263589,1.7752087347463068,690,518,1208,+
chr13,113263762,1.4491802013394457,1882,1301,3183,+
chr13,113263944,2.3900466562986,903,642,1545,+
chr13,113263969,1.50657309337237,1614,1105,2719,+
chr13,113264092,2.089028776978417,605,416,1021,+
chr13,113264463,0.3974473341110272,1085,740,1825,+
chr13,113277319,1.5607258437355525,630,419,1049,+
chr13,113277320,1.4379362018411792,1181,827,2008,+
chr13,113306522,1.9960552268244576,1103,623,1726,+
chr13,113306524,1.9960552268244576,1103,623,1726,+
chr13,113306580,0.3129411764705883,702,424,1126,+
chr13,113309704,1.6406035665294925,597,404,1001,+
chr13,113310708,1.6084425417705321,1451,1006,2457,+
chr13,113310758,2.1010101010101008,636,538,1174,+
chr13,113322419,1.5693795737643588,781,561,1342,+
chr13,113322876,5.693396226415095,441,688,1129,+
chr13,113322877,5.631835021088496,2039,2697,4736,+
chr13,113322878,5.4965557303614245,2304,2966,5270,+
chr13,113322879,6.351620377416332,1013,1663,2676,+
chr13,113322880,5.528528528528528,525,517,1042,+
chr13,113322886,0.45859388203481505,602,969,1571,+
chr13,113322887,0.40970814239112047,1389,2053,3442,+
chr13,113322888,0.45859388203481505,602,969,1571,+
chr13,113322889,0.3053391465942392,533,822,1355,+
chr13,113322899,0.47908752884576905,906,823,1729,+
chr13,113322908,0.3931150476699627,1189,960,2149,+
chr13,113322910,0.16612021857923498,455,548,1003,+
chr13,113323004,0.6090225563909775,737,531,1268,+
chr13,113323108,2.416326530612245,591,419,1010,+
chr13,113323184,2.3924391603195243,1197,768,1965,+
chr13,113323185,0.5111810872588354,1065,856,1921,+
chr13,113323186,2.3924391603195243,1197,768,1965,+
chr13,113323187,0.5111810872588354,1065,856,1921,+
chr13,113323253,1.6419927055702916,638,415,1053,+
chr13,113323261,1.6322528822528821,986,571,1557,+
chr13,113498343,3.059310471663842,773,645,1418,+
chr13,113510244,0.9577138547726785,772,545,1317,+
chr13,113510245,0.9577138547726785,772,545,1317,+
chr13,113585817,1.8224581380996776,642,444,1086,+
chr13,113585835,5.516379614882735,599,436,1035,+
chr13,113633129,3.0455920280618054,604,475,1079,+
chr13,113633139,2.321208279822553,534,478,1012,+
chr13,113633930,0.42767929089444,578,437,1015,+
chr13,113633950,2.0829417293233083,590,447,1037,+
chr13,113640736,1.3639147847245388,1092,737,1829,+
chr13,113640740,2.2344374643061107,625,411,1036,+
chr13,113640903,1.0124610108185605,1100,944,2044,+
chr13,113641289,1.0832696715049657,708,461,1169,+
chr13,113641291,1.0832696715049657,708,461,1169,+
chr13,113641328,0.2286568539411433,3230,2109,5339,+
chr14,19097274,2.106311274509804,824,407,1231,+
chr14,19097275,2.471565827536399,1130,637,1767,+
chr14,20354180,1.6027399268057632,678,446,1124,+
chr14,20354915,2.6655448477165873,957,725,1682,+
chr14,20455243,0.7742549116254079,1124,887,2011,+
chr14,20455246,2.581071428571428,802,559,1361,+
chr14,20455247,2.581071428571428,802,559,1361,+
chr14,20455274,1.0177455884878834,906,769,1675,+
chr14,20455299,0.5479543930248156,816,567,1383,+
chr14,20455354,1.6406124093473005,1017,656,1673,+
chr14,20455589,1.615503875968992,1041,659,1700,+
chr14,20455679,2.1093906448326525,1279,816,2095,+
chr14,20455686,5.733931309782658,5295,4424,9719,+
chr14,20455687,5.377113565413906,6784,5413,12197,+
chr14,20455688,5.377113565413906,6784,5413,12197,+
chr14,20455924,0.6616784037558686,614,638,1252,+
chr14,20455928,0.8876888142955872,1473,1446,2919,+
chr14,20455930,0.8876888142955872,1473,1446,2919,+
chr14,20455933,0.6016304347826087,819,799,1618,+
chr14,20455945,1.1611104063955815,3311,2419,5730,+
chr14,20455946,0.92544,2409,1624,4033,+
chr14,20455947,0.92544,2409,1624,4033,+
chr14,20455948,1.79186320754717,1012,900,1912,+
chr14,20456005,2.1506493506493505,735,559,1294,+
chr14,20456006,1.3625470925470924,2278,1849,4127,+
chr14,20456007,1.4803902000863034,3393,2514,5907,+
chr14,20456037,1.0553447510241911,2872,2019,4891,+
chr14,20456041,1.0022318036705604,3163,2172,5335,+
chr14,20456048,0.6492426223865131,3476,2339,5815,+
chr14,20456837,2.934978928356412,584,452,1036,+
chr14,20456840,2.8622448979591835,611,503,1114,+
chr14,20457003,2.0681352459016398,1100,731,1831,+
chr14,20457031,0.6808205358143706,948,810,1758,+
chr14,20457131,0.6535761715044582,1059,752,1811,+
chr14,20457198,1.2256959704407622,3564,2648,6212,+
chr14,20457199,1.4539444435727251,2481,1892,4373,+
chr14,20457325,1.587375899872959,1322,801,2123,+
chr14,20457376,2.622863247863248,981,719,1700,+
chr14,20457484,1.5864642305712815,684,535,1219,+
chr14,20457517,0.652020202020202,1290,989,2279,+
chr14,20457537,1.7554480214193178,2341,1703,4044,+
chr14,20457568,0.7286036235870318,2160,1550,3710,+
chr14,20469406,0.40399996003878713,10919,4654,15573,+
chr14,20469409,1.494889536678917,7199,3253,10452,+
chr14,20469429,2.6263054985931613,3164,1612,4776,+
chr14,20469432,1.7914288288967446,16950,8104,25054,+
chr14,20469433,1.7914288288967446,16950,8104,25054,+
chr14,20469436,1.5607672147909235,35587,19224,54811,+
chr14,20469437,1.5607672147909235,35587,19224,54811,+
chr14,20469475,0.7184185992035752,3535,2248,5783,+
chr14,20469480,1.939371179944059,3434,1969,5403,+
chr14,20469482,1.939371179944059,3434,1969,5403,+
chr14,20469485,2.160436051313109,1634,885,2519,+
chr14,20472413,3.2183441558441555,792,527,1319,+
chr14,20474888,0.4035550668865677,846,534,1380,+
chr14,20474889,1.8127452306859693,637,388,1025,+
chr14,20474893,0.6266601407492985,2942,1788,4730,+
chr14,20474896,0.6453826355621681,3798,2058,5856,+
chr14,20474897,0.7099921024529624,2705,1482,4187,+
chr14,20475065,0.6164942621625991,802,537,1339,+
chr14,20475066,0.5907193210594758,958,768,1726,+
chr14,20475081,1.5518272425249169,1037,687,1724,+
chr14,20475085,1.5829810298102982,858,614,1472,+
chr14,20475089,1.781886634595273,925,682,1607,+
chr14,20475095,0.6658287131099556,1288,817,2105,+
chr14,20475096,1.0787673570463394,2679,2029,4708,+
chr14,20475138,0.6014240506329114,904,631,1535,+
chr14,20476476,0.5051846004807865,639,592,1231,+
chr14,20476626,1.7431153367196628,1809,1247,3056,+
chr14,20476712,1.575510204081633,771,489,1260,+
chr14,20476713,1.6033970276008491,589,470,1059,+
chr14,20476957,2.432065217391304,894,551,1445,+
chr14,20476962,0.6325837320574164,1016,759,1775,+
chr14,20476996,1.150237932736511,1746,1476,3222,+
chr14,20625407,0.27627684335717995,696,690,1386,+
chr14,20633062,1.034776980164751,1167,855,2022,+
chr14,20990239,0.44677651016835435,892,605,1497,+
chr14,20990241,0.7164060954263421,730,507,1237,+
chr14,20990579,0.4474466107110824,814,498,1312,+
chr14,21488732,2.9213709677419355,566,495,1061,+
chr14,21489185,1.6078051800345874,622,495,1117,+
chr14,22610907,2.348495297111925,585,454,1039,+
chr14,22612249,6.236178861788619,666,409,1075,+
chr14,22612250,6.236178861788619,666,409,1075,+
chr14,22612251,6.236178861788619,666,409,1075,+
chr14,22767305,1.4823078793774318,566,513,1079,+
chr14,22767306,1.4823078793774318,566,513,1079,+
chr14,22767390,2.570788922957123,1077,760,1837,+
chr14,22767391,2.570788922957123,1077,760,1837,+
chr14,22768119,1.8514008076728927,792,565,1357,+
chr14,22768125,0.3971332586786113,805,474,1279,+
chr14,22769792,2.5547492132811,1104,676,1780,+
chr14,22769793,2.5547492132811,1104,676,1780,+
chr14,22769811,2.3531746031746037,592,440,1032,+
chr14,22769852,2.673633715949974,577,448,1025,+
chr14,22769859,0.5745922489899746,639,488,1127,+
chr14,22769874,1.982543772094686,2345,1896,4241,+
chr14,22769910,2.1462673611111107,919,767,1686,+
chr14,22770195,1.7478991596638658,887,713,1600,+
chr14,22770558,1.991517610178868,674,560,1234,+
chr14,22770827,1.599878567091682,934,548,1482,+
chr14,22771022,1.9290330220585727,1474,1153,2627,+
chr14,22771063,0.5254725736335661,977,693,1670,+
chr14,22771135,1.6673618352450466,819,684,1503,+
chr14,22771272,1.9906542056074765,709,534,1243,+
chr14,22771457,1.817645774186504,573,481,1054,+
chr14,22771470,2.193390452876377,703,472,1175,+
chr14,22771481,2.599633027522936,643,544,1187,+
chr14,22771495,1.6295819935691318,1447,1243,2690,+
chr14,22771496,1.6295819935691318,1447,1243,2690,+
chr14,22771529,1.572329619921363,1046,653,1699,+
chr14,22771650,2.168330341113106,973,556,1529,+
chr14,22771680,2.1784332688588006,794,516,1310,+
chr14,22830224,1.8635715790360634,810,570,1380,+
chr14,22833455,2.0044191919191916,634,527,1161,+
chr14,22833457,2.0922319506259046,1206,917,2123,+
chr14,22875524,0.35433131101448456,620,451,1071,+
chr14,22876805,1.662308376400057,644,448,1092,+
chr14,22877205,22.13647818784403,711,296,1007,+
chr14,22877206,22.13647818784403,711,296,1007,+
chr14,22877687,1.9650383430116853,716,522,1238,+
chr14,22877999,3.7168082322856466,713,493,1206,+
chr14,23097843,2.2155463946652363,664,434,1098,+
chr14,23097858,1.1122159090909092,782,623,1405,+
chr14,23097860,0.8704445433417396,1213,962,2175,+
chr14,23097862,1.0332438571133595,833,667,1500,+
chr14,23098271,2.620894160583941,765,547,1312,+
chr14,23321602,4.128754593427292,542,577,1119,+
chr14,23321789,2.119434484426475,935,569,1504,+
chr14,23321807,0.5867533103830632,1467,752,2219,+
chr14,23321808,0.6028189461004452,1810,980,2790,+
chr14,23323007,2.323255813953488,665,386,1051,+
chr14,23323055,0.5902398676592225,668,584,1252,+
chr14,23323432,1.7171215880893298,691,433,1124,+
chr14,23324145,3.3854656236981313,1240,971,2211,+
chr14,23324175,1.970997375328084,652,380,1032,+
chr14,23325262,1.7806637806637808,616,428,1044,+
chr14,23325482,4.008830418779072,1420,497,1917,+
chr14,23325498,9.132795890737427,1332,475,1807,+
chr14,23325499,14.746176156659512,1843,599,2442,+
chr14,23325500,14.612831837694188,1435,488,1923,+
chr14,23325505,33.16248666339594,3010,1872,4882,+
chr14,23325506,29.503059965990264,3261,2003,5264,+
chr14,23325507,24.82065977795408,3570,2237,5807,+
chr14,23325508,12.158441558441556,754,349,1103,+
chr14,23325509,6.832923832923832,617,443,1060,+
chr14,23325525,3.1329097813416142,1232,1171,2403,+
chr14,23325580,0.4223899289293683,908,679,1587,+
chr14,23325581,0.4506566315951156,651,448,1099,+
chr14,23325624,8.606723832874321,788,605,1393,+
chr14,23325882,0.40300245352618963,720,555,1275,+
chr14,23326028,0.22121593200010944,739,290,1029,+
chr14,23326055,12.822644129201327,1267,456,1723,+
chr14,23326056,11.809254500857115,2078,772,2850,+
chr14,23326063,6.04695594994957,1416,633,2049,+
chr14,23326068,15.252737226277372,686,547,1233,+
chr14,23326069,14.26112941585885,1797,1139,2936,+
chr14,23326070,18.096270210237847,2393,1728,4121,+
chr14,23477218,0.579611908559277,622,417,1039,+
chr14,23477264,1.7449070883560698,3129,2256,5385,+
chr14,23477265,1.9986968473207318,2605,1864,4469,+
chr14,23477271,1.8007404829030376,2175,1489,3664,+
chr14,23477340,1.4195693275978023,2431,1445,3876,+
chr14,23477506,2.115049226441632,2919,1895,4814,+
chr14,24096928,3.8027397260273967,693,364,1057,+
chr14,24096929,3.8027397260273967,693,364,1057,+
chr14,24096936,1.9555112678215547,1080,592,1672,+
chr14,24096937,1.9555112678215547,1080,592,1672,+
chr14,24096953,1.3521292984308613,2155,1218,3373,+
chr14,24096954,2.1434372969460687,2029,1196,3225,+
chr14,24096956,2.655139802631579,2082,1279,3361,+
chr14,24096957,2.7567089828057205,1409,888,2297,+
chr14,24096959,1.9453681710213773,1637,841,2478,+
chr14,24096960,1.9453681710213773,1637,841,2478,+
chr14,24096961,3.4770642201834865,757,544,1301,+
chr14,24097124,0.6396459344200226,686,483,1169,+
chr14,24099644,1.6321083110361285,575,434,1009,+
chr14,24117032,1.3250327207087853,1389,839,2228,+
chr14,24117265,2.545267489711934,1236,809,2045,+
chr14,24117266,2.086699830306803,2741,1834,4575,+
chr14,24117268,2.0456865127582016,1241,822,2063,+
chr14,24136989,2.8470287851055134,1161,758,1919,+
chr14,24136990,2.635842472582253,704,471,1175,+
chr14,24137333,2.4121621621621623,662,480,1142,+
chr14,24137355,1.5937421304457315,829,721,1550,+
chr14,24137417,2.080718132854578,877,556,1433,+
chr14,24137534,1.7394230769230767,736,439,1175,+
chr14,24137540,1.70990064488529,1852,1256,3108,+
chr14,24137726,1.6933343039630218,1797,1203,3000,+
chr14,24138236,1.8085106382978722,629,563,1192,+
chr14,24138344,0.5240899144917065,1041,794,1835,+
chr14,24138477,1.8065804688321243,660,452,1112,+
chr14,24138512,0.6001931900507125,730,504,1234,+
chr14,24138758,2.116258631512869,601,530,1131,+
chr14,24138811,0.7602215152586307,1612,1106,2718,+
chr14,24236066,2.2377490321971485,789,622,1411,+
chr14,24236067,2.0354327981271383,1292,931,2223,+
chr14,24236097,0.3560595221061668,552,481,1033,+
chr14,24238635,1.2317158454186712,1578,989,2567,+
chr14,24238636,2.1691043698085952,774,425,1199,+
chr14,24238995,1.3101523237000474,1245,855,2100,+
chr14,24238996,1.0012184315463004,785,487,1272,+
chr14,28264951,0.3131485276669183,763,634,1397,+
chr14,28264952,0.36976802824004046,837,660,1497,+
chr14,28264953,0.3862434538714355,1030,807,1837,+
chr14,28264954,0.3442095401034665,649,500,1149,+
chr14,28265049,2.9264817629179327,1026,375,1401,+
chr14,28265050,2.9264817629179327,1026,375,1401,+
chr14,28265068,6.445154419595313,711,312,1023,+
chr14,30618085,0.14876337999332928,795,396,1191,+
chr14,30638204,1.5179715227362462,944,590,1534,+
chr14,30638205,1.1658227848101266,613,394,1007,+
chr14,30638206,1.1658227848101266,613,394,1007,+
chr14,30821496,0.9453095612498129,2760,2535,5295,+
chr14,30821497,0.7537273127493532,2723,1555,4278,+
chr14,30821498,1.006614931562106,1168,1717,2885,+
chr14,30821504,1.6190836850214765,2404,1580,3984,+
chr14,30821506,1.99400537895726,2085,1142,3227,+
chr14,31266270,1.1742185113532229,960,643,1603,+
chr14,31266271,1.1742185113532229,960,643,1603,+
chr14,31266272,1.1742185113532229,960,643,1603,+
chr14,34996706,3.3779735682819387,638,453,1091,+
chr14,34996707,3.3779735682819387,638,453,1091,+
chr14,34996730,1.7529691211401424,614,420,1034,+
chr14,35013350,3.070727078828345,673,482,1155,+
chr14,35018728,2.0771929824561393,591,417,1008,+
chr14,35018739,1.7725638773595465,903,705,1608,+
chr14,35019058,1.9372913686218407,649,465,1114,+
chr14,35022955,2.6458203368683715,584,457,1041,+
chr14,35081070,1.4506055109845544,1209,914,2123,+
chr14,35266729,2.1565217391304348,767,479,1246,+
chr14,35266730,2.1565217391304348,767,479,1246,+
chr14,35292403,1.073603506776968,1618,902,2520,+
chr14,35292404,1.2863466522305622,1249,690,1939,+
chr14,35292405,1.0344473219057015,718,458,1176,+
chr14,35292446,1.3911451147623228,710,594,1304,+
chr14,35292451,0.6081830790568655,876,617,1493,+
chr14,35292452,0.5769255642501455,810,657,1467,+
chr14,35292456,0.5992957746478873,1257,679,1936,+
chr14,35292470,1.5724954206002535,1394,754,2148,+
chr14,35292473,2.190320078962211,1444,787,2231,+
chr14,35307999,1.8084795321637424,1236,683,1919,+
chr14,35308004,1.9810855263157896,802,607,1409,+
chr14,35308009,1.6809532391247617,3101,2456,5557,+
chr14,35308010,1.738516664565965,1787,1405,3192,+
chr14,35308013,1.5855169971671388,1790,1058,2848,+
chr14,35308033,1.374835069839392,2294,1417,3711,+
chr14,35310747,2.228817028243962,725,348,1073,+
chr14,35310754,3.2850678733031677,725,356,1081,+
chr14,35310760,1.7752326413743735,743,380,1123,+
chr14,35310771,2.6731129132875857,856,457,1313,+
chr14,35310783,1.3210062220864984,2011,1138,3149,+
chr14,35310787,0.8739144576353878,3705,2144,5849,+
chr14,35310788,0.8739144576353878,3705,2144,5849,+
chr14,35310795,1.3391297112904568,2219,1427,3646,+
chr14,35310796,1.415131987831605,2675,1608,4283,+
chr14,35312884,1.4232650209594782,1437,903,2340,+
chr14,35312887,3.5509138381201044,1699,765,2464,+
chr14,35312899,1.6758350492012843,4854,3076,7930,+
chr14,35312957,3.0026747503566336,1870,1401,3271,+
chr14,35314412,1.5349902296042992,930,711,1641,+
chr14,35314416,1.5633809604125002,2048,1616,3664,+
chr14,35314418,1.5633809604125002,2048,1616,3664,+
chr14,35314427,2.1446043165467623,812,416,1228,+
chr14,35317251,1.8623646646916243,3171,1974,5145,+
chr14,35317252,2.118387845429988,4282,2718,7000,+
chr14,35317253,1.9756589405263685,5634,3548,9182,+
chr14,35317254,2.031593154659732,4499,2973,7472,+
chr14,35317256,1.333501657825616,5333,3564,8897,+
chr14,35317257,1.4301464273445554,4036,2910,6946,+
chr14,35317259,1.4642313574175343,6160,4302,10462,+
chr14,35317260,1.5633216118653013,2910,2162,5072,+
chr14,39175335,2.143977191732003,751,487,1238,+
chr14,39175336,2.143977191732003,751,487,1238,+
chr14,39180730,2.0424856065118124,642,437,1079,+
chr14,39180904,0.6187805872756933,866,612,1478,+
chr14,39181094,2.3492023928215358,724,471,1195,+
chr14,39181371,1.8118463723517577,983,767,1750,+
chr14,39181440,1.8559835995558214,775,508,1283,+
chr14,39181458,0.5946408860807674,918,558,1476,+
chr14,39181487,0.49046612784490395,1913,1105,3018,+
chr14,39181509,0.6212310843099328,909,516,1425,+
chr14,39181523,1.5625465229577853,4292,2411,6703,+
chr14,39181524,1.7142374901625725,4507,2419,6926,+
chr14,39181530,1.6098691931190428,1307,712,2019,+
chr14,39181536,1.6259750253594039,2065,1242,3307,+
chr14,39181547,1.6769244492016768,1174,605,1779,+
chr14,39181569,1.6074702886247878,2103,1177,3280,+
chr14,39181575,1.7625668449197858,1647,934,2581,+
chr14,39181578,2.4040833333333333,1696,999,2695,+
chr14,39181707,2.9907918968692453,839,542,1381,+
chr14,39181731,1.8795721925133693,908,560,1468,+
chr14,39181767,1.7011016621569384,606,397,1003,+
chr14,39181769,2.4380952380952383,703,538,1241,+
chr14,39181851,0.497453310696095,585,417,1002,+
chr14,39181867,2.052994555353902,605,434,1039,+
chr14,39181939,2.0598529411764708,608,399,1007,+
chr14,39276976,2.7011764705882357,1343,599,1942,+
chr14,39276977,2.451054679337715,2020,960,2980,+
chr14,39276980,2.209033613445378,700,335,1035,+
chr14,39276993,1.94446557626474,851,477,1328,+
chr14,39277000,0.6288135593220339,1112,479,1591,+
chr14,39277010,2.2472189349112424,1116,649,1765,+
chr14,39308483,2.268303485841698,648,384,1032,+
chr14,39345910,2.0839414394270412,641,490,1131,+
chr14,49586578,0.9443617645669521,1131,718,1849,+
chr14,49586600,0.7874484677355198,100352,71130,171482,+
chr14,49586601,0.8520363385840636,103884,70765,174649,+
chr14,49586603,1.1463844090153987,58724,36465,95189,+
chr14,49586706,1.1673750510959813,10034,8384,18418,+
chr14,49586707,0.9082140164706518,20639,12004,32643,+
chr14,49586708,0.5726619647497858,10605,3620,14225,+
chr14,49586733,1.6701208383161863,17317,7392,24709,+
chr14,49586735,1.5895900583313063,25991,10212,36203,+
chr14,49586736,1.5041062157809808,23422,11226,34648,+
chr14,49586737,1.9376565959025935,21865,7311,29176,+
chr14,49586738,1.872949323032043,20032,7345,27377,+
chr14,49586739,1.957675676557694,18386,6450,24836,+
chr14,49586741,1.8024388767838806,19470,8597,28067,+
chr14,49586742,1.2861980885905608,41340,26842,68182,+
chr14,49586744,1.1325906209603644,52752,36368,89120,+
chr14,49586746,1.238939223590127,60974,37487,98461,+
chr14,49586747,1.2089444773987035,45171,22319,67490,+
chr14,49586748,1.25297528422981,33256,14039,47295,+
chr14,49586749,0.9657391115437021,95269,58381,153650,+
chr14,49586750,0.9739368252099951,90763,58605,149368,+
chr14,49586751,0.9466913164645343,73109,49771,122880,+
chr14,49586759,0.9969769167637129,85691,55342,141033,+
chr14,49586760,0.9399894034018961,81997,51814,133811,+
chr14,49586770,1.2003299589020855,26745,19773,46518,+
chr14,49586776,1.3764877999866383,44208,31146,75354,+
chr14,49586779,1.3685152321983,71340,48552,119892,+
chr14,49586786,1.3479665425355485,171736,119597,291333,+
chr14,49586787,1.5244373020881339,83251,41616,124867,+
chr14,49586788,1.2822218089241573,309574,227529,537103,+
chr14,49586789,1.2387932997127544,333601,249808,583409,+
chr14,49586790,1.2128589493085662,364702,277464,642166,+
chr14,49586791,1.1502051774372875,419359,320531,739890,+
chr14,49586793,1.1397241004151275,270519,202148,472667,+
chr14,49586794,1.3035177500080677,57558,32423,89981,+
chr14,49586804,1.2426096322770073,152533,117513,270046,+
chr14,49586809,1.437022960838917,28188,20237,48425,+
chr14,49586828,1.1070300758541398,562498,443369,1005867,+
chr14,49586829,1.106658819181632,543817,426168,969985,+
chr14,49586833,1.8389783611658346,45611,40029,85640,+
chr14,49614490,2.8802504594169203,829,774,1603,+
chr14,49622014,1.062011011301072,732,475,1207,+
chr14,49622015,1.062011011301072,732,475,1207,+
chr14,49768597,2.0489376560965207,660,493,1153,+
chr14,49777885,1.7696304849884528,612,432,1044,+
chr14,49780725,1.96127562642369,573,438,1011,+
chr14,49782872,1.6901798063623792,657,481,1138,+
chr14,49894217,3.3158498963809535,746,443,1189,+
chr14,49894514,2.249055354530757,755,502,1257,+
chr14,51240308,1.532897472215813,569,434,1003,+
chr14,51243856,3.0971180720078473,765,556,1321,+
chr14,51247103,2.003580173247464,1431,916,2347,+
chr14,51247105,2.003580173247464,1431,916,2347,+
chr14,51247115,2.69263698630137,764,583,1347,+
chr14,51247117,1.6565088588513504,1216,1195,2411,+
chr14,51254422,3.4748427672955966,764,476,1240,+
chr14,51254432,0.3832923832923832,623,406,1029,+
chr14,51254448,2.2532894736842106,821,575,1396,+
chr14,51254945,2.8443160444271594,941,673,1614,+
chr14,51254972,0.7507936507936507,945,779,1724,+
chr14,51254974,0.7507936507936507,945,779,1724,+
chr14,51255146,2.134495279593319,667,404,1071,+
chr14,51255640,2.5995145631067964,764,514,1278,+
chr14,51255807,2.6617022615814596,1245,825,2070,+
chr14,51255857,1.5260511882998171,741,546,1287,+
chr14,51989626,1.3503248204035334,872,618,1490,+
chr14,51989627,0.9107761563401656,1073,804,1877,+
chr14,51989628,1.0914776542020608,1404,1000,2404,+
chr14,51989651,1.5844897959183677,646,419,1065,+
chr14,51989667,1.9129660087719302,820,607,1427,+
chr14,51989670,2.5963235294117646,748,559,1307,+
chr14,51989673,1.6024679967708455,793,597,1390,+
chr14,51991329,0.6505798933655802,1075,790,1865,+
chr14,51991330,2.014974740927554,2643,1652,4295,+
chr14,51991331,2.014974740927554,2643,1652,4295,+
chr14,51991337,1.7262524050655608,4994,3401,8395,+
chr14,51991398,1.3607377158923548,2572,1539,4111,+
chr14,51999711,2.4386596510661867,951,627,1578,+
chr14,52004364,2.225525905002601,1995,1222,3217,+
chr14,52004365,2.225525905002601,1995,1222,3217,+
chr14,52004371,1.7643525356967011,873,676,1549,+
chr14,52004431,0.5573743576272022,1655,1242,2897,+
chr14,52004590,1.8204775053433304,3591,2591,6182,+
chr14,52707208,1.0812250283947396,802,479,1281,+
chr14,52707226,1.7080927625116789,1804,937,2741,+
chr14,52707227,1.7080927625116789,1804,937,2741,+
chr14,52707230,1.9249718963939053,3488,2468,5956,+
chr14,52707231,1.6442571711646705,4063,3173,7236,+
chr14,52707232,1.6777671988939595,4583,3833,8416,+
chr14,52707233,1.4539092473210318,7036,5102,12138,+
chr14,52707234,1.5551945008592407,4248,3884,8132,+
chr14,52707236,1.581845417330452,7019,4857,11876,+
chr14,52707237,1.3605465709590936,1862,1118,2980,+
chr14,52707238,1.6742060126284044,4674,2619,7293,+
chr14,52708343,1.7134615384615384,626,379,1005,+
chr14,52708344,0.5112359550561798,584,444,1028,+
chr14,52711106,0.824448764079873,1063,793,1856,+
chr14,52711108,1.278497615262321,1692,1359,3051,+
chr14,52711109,1.5938098767849402,1372,1125,2497,+
chr14,52711110,1.6503427563524484,1638,1305,2943,+
chr14,52711115,1.8559252413226532,582,540,1122,+
chr14,52711118,0.39671102822751547,779,501,1280,+
chr14,52711119,0.39671102822751547,779,501,1280,+
chr14,52711147,1.8858007105032262,1575,1027,2602,+
chr14,52711150,1.7190426183600245,2310,1464,3774,+
chr14,52711152,1.2383181904397762,3963,3111,7074,+
chr14,52711409,1.9594499806501546,4378,3263,7641,+
chr14,52711410,1.9594499806501546,4378,3263,7641,+
chr14,52711411,1.9594499806501546,4378,3263,7641,+
chr14,52711432,1.3032522062572862,4719,3765,8484,+
chr14,52711433,1.0261554408544016,8832,7132,15964,+
chr14,52711437,1.0253164175541731,8419,5698,14117,+
chr14,52711439,1.1167151603252758,7051,4693,11744,+
chr14,52718236,1.9001426533523536,1007,700,1707,+
chr14,52718237,1.9001426533523536,1007,700,1707,+
chr14,52718252,1.35021000667854,1087,922,2009,+
chr14,52720906,2.9327110777959606,977,572,1549,+
chr14,52727579,2.53446631405532,789,606,1395,+
chr14,54401530,1.9239012490258278,614,412,1026,+
chr14,54408766,1.740094957432875,732,508,1240,+
chr14,54411680,0.47324396695498977,1045,824,1869,+
chr14,54420019,1.794764909746579,1116,794,1910,+
chr14,54420021,1.57911172796669,737,523,1260,+
chr14,55063261,0.32157749977819183,658,441,1099,+
chr14,55063262,0.32157749977819183,658,441,1099,+
chr14,55063264,2.086296065831969,728,535,1263,+
chr14,55064698,1.1946683900034452,1638,1125,2763,+
chr14,55065903,2.089908469470513,621,410,1031,+
chr14,55129281,2.8395316804407718,664,483,1147,+
chr14,55129282,2.8395316804407718,664,483,1147,+
chr14,55137370,0.48352697766587355,875,674,1549,+
chr14,55138048,2.0974789915966388,545,489,1034,+
chr14,55138056,2.0191029900332227,662,515,1177,+
chr14,55138140,16.293117973011434,784,546,1330,+
chr14,55138155,3.912287931863452,720,632,1352,+
chr14,55138156,10.857146756901535,1859,1485,3344,+
chr14,55138310,1.4140856174405692,1049,768,1817,+
chr14,55138345,1.8245373469922241,1275,900,2175,+
chr14,55140280,2.077596996245307,663,469,1132,+
chr14,55140286,0.4906159609962616,1655,1295,2950,+
chr14,55140323,1.8738703458247985,1130,771,1901,+
chr14,55140346,1.8285714285714285,879,824,1703,+
chr14,55142592,0.6111111111111112,1264,1034,2298,+
chr14,55145117,1.4299885906443286,1750,1280,3030,+
chr14,55145119,1.7220353238015138,1364,860,2224,+
chr14,55229234,2.4685029627414496,924,676,1600,+
chr14,55229235,2.211530516785681,1034,812,1846,+
chr14,55229237,2.1067662474942055,765,610,1375,+
chr14,55229330,1.5586127488050427,1000,814,1814,+
chr14,55229332,1.6273546632129137,1310,1060,2370,+
chr14,55543778,1.205667050424231,981,715,1696,+
chr14,55543780,1.2435484725298762,1256,922,2178,+
chr14,55612042,1.9347878787878787,693,499,1192,+
chr14,55612250,1.6049654497645691,1192,710,1902,+
chr14,55616526,1.9310344827586208,639,399,1038,+
chr14,55616536,1.880184331797235,679,433,1112,+
chr14,55616557,1.163563925100446,1205,831,2036,+
chr14,55616639,2.030864197530864,986,611,1597,+
chr14,55618077,1.8888724474696656,1034,653,1687,+
chr14,55627939,1.641217273512857,1463,910,2373,+
chr14,55627951,1.658203768062923,1562,993,2555,+
chr14,55627953,0.6421227197346601,967,669,1636,+
chr14,55629957,2.22113981708836,2170,1652,3822,+
chr14,55634534,0.5292244286249532,564,470,1034,+
chr14,55634594,1.5822550831792976,855,540,1395,+
chr14,55634614,1.629520295202952,735,541,1276,+
chr14,55634622,0.6178098116717043,1021,781,1802,+
chr14,55634625,2.0013921610623258,1698,1333,3031,+
chr14,55634626,1.9438190165895135,2753,2040,4793,+
chr14,55634635,2.5355981416957025,928,819,1747,+
chr14,55634645,2.663577496610311,2137,1721,3858,+
chr14,55636505,2.109569502074689,560,481,1041,+
chr14,55637223,1.6345057034220531,723,525,1248,+
chr14,55637247,1.7506573181419804,939,651,1590,+
chr14,55637336,0.4803303629645729,779,641,1420,+
chr14,55637821,1.8819355410666745,1882,1291,3173,+
chr14,55639932,0.6153952070067973,2734,1958,4692,+
chr14,55639933,0.9480526281079961,3583,2574,6157,+
chr14,55640395,1.6357376257531964,5496,3241,8737,+
chr14,55640398,2.140196193905538,3740,2307,6047,+
chr14,55640399,1.9446022727272725,2330,1343,3673,+
chr14,55640413,1.4134985150213577,7026,3431,10457,+
chr14,55640415,1.5062615283267458,10916,5399,16315,+
chr14,55640417,1.5446436293645711,7607,3810,11417,+
chr14,55640940,1.5185694532456655,5662,3320,8982,+
chr14,55640943,1.6520814897102294,8862,6139,15001,+
chr14,55640945,1.5656323735186668,20200,13636,33836,+
chr14,55640947,1.6389485398891264,9416,6834,16250,+
chr14,55640954,1.6984675437463521,27990,22167,50157,+
chr14,55640956,1.5150893045918785,63135,47777,110912,+
chr14,55640957,1.5086463926876084,46247,34971,81218,+
chr14,55648030,1.6818027210884354,898,629,1527,+
chr14,55648847,1.442763133435008,2362,1664,4026,+
chr14,55649786,0.6500057650178716,1649,1238,2887,+
chr14,55650390,1.8552886948083456,804,686,1490,+
chr14,55651895,1.5703292770221904,1169,761,1930,+
chr14,55652869,0.6009705113848451,979,657,1636,+
chr14,55658571,2.2875816993464047,724,492,1216,+
chr14,55670759,0.3729298107255521,872,633,1505,+
chr14,55671577,1.5668202764976955,729,510,1239,+
chr14,55671595,1.8259831025788469,859,610,1469,+
chr14,55671628,1.9037859562378556,2430,1726,4156,+
chr14,55671630,1.8711256117455142,867,612,1479,+
chr14,55671631,1.6314895874784456,1381,1076,2457,+
chr14,55672953,1.7977080219232684,901,668,1569,+
chr14,55672965,1.7282320717955273,2747,2027,4774,+
chr14,55679599,2.5143209116107177,627,381,1008,+
chr14,55679670,1.7445317006078354,982,682,1664,+
chr14,55684103,1.513588850174216,1085,699,1784,+
chr14,58223640,2.612338205409732,703,490,1193,+
chr14,58223799,1.5241971730080919,1546,1124,2670,+
chr14,58223814,3.3390068081698034,574,453,1027,+
chr14,58223821,1.5708204334365323,737,607,1344,+
chr14,58223824,0.6476767676767676,1602,1199,2801,+
chr14,58223844,0.9292146185963324,2966,2365,5331,+
chr14,58223845,0.4685086872586872,705,447,1152,+
chr14,58232125,1.6451168939352785,830,568,1398,+
chr14,58244870,1.6530975137941746,1078,603,1681,+
chr14,58244888,1.434284206688874,1273,729,2002,+
chr14,58244894,1.4269615347565094,1317,1040,2357,+
chr14,58244914,2.0283218125960056,1141,671,1812,+
chr14,58247767,3.0518505884359546,616,450,1066,+
chr14,58247795,0.6503020751247702,1302,939,2241,+
chr14,58252134,1.8401975683890577,1190,986,2176,+
chr14,58257819,1.2904969938146114,1835,1515,3350,+
chr14,58257970,1.5098751968980977,1465,916,2381,+
chr14,58263753,2.3475736663380435,738,536,1274,+
chr14,58267478,1.6990760206331463,4872,2884,7756,+
chr14,58267479,1.6990760206331463,4872,2884,7756,+
chr14,58267480,1.6990760206331463,4872,2884,7756,+
chr14,58794726,1.0850019019269848,1022,726,1748,+
chr14,58794729,1.4307367719726836,705,580,1285,+
chr14,58794749,1.1893695248820781,1056,1060,2116,+
chr14,58794789,0.7282608695652174,736,351,1087,+
chr14,58794790,0.7282608695652174,736,351,1087,+
chr14,58794794,1.767367827208253,912,592,1504,+
chr14,58794801,1.5476814516129036,1180,743,1923,+
chr14,58794802,1.4912762883065591,1091,822,1913,+
chr14,58794803,1.5476814516129036,1180,743,1923,+
chr14,58794817,0.6541426679721306,1434,1053,2487,+
chr14,58794825,2.139455782312925,1109,734,1843,+
chr14,58794832,1.8248456790123455,824,719,1543,+
chr14,58794912,2.008332552346374,671,357,1028,+
chr14,58794914,1.025974025974026,552,461,1013,+
chr14,58794915,0.9834286702517522,842,735,1577,+
chr14,58794919,1.3200995807127882,649,423,1072,+
chr14,58794921,1.0011875202217095,878,613,1491,+
chr14,58794925,0.6261831533271345,1406,1022,2428,+
chr14,58794927,0.6170381342795135,2238,1594,3832,+
chr14,58794928,0.6442114842332769,1605,1120,2725,+
chr14,58794931,0.7275341480948957,965,641,1606,+
chr14,58794932,1.8389497653893994,824,641,1465,+
chr14,58794988,1.4796003746275996,3464,2346,5810,+
chr14,58794989,1.4946811045511108,2662,1764,4426,+
chr14,58794991,1.5042160737812909,931,689,1620,+
chr14,58794993,0.6304799082938315,1649,1112,2761,+
chr14,59484569,0.737810211935625,705,577,1282,+
chr14,59487704,1.130360206642307,743,556,1299,+
chr14,59495053,2.3948179122337714,1004,702,1706,+
chr14,59495092,3.9345293544654854,563,493,1056,+
chr14,60397775,2.269151630262741,540,467,1007,+
chr14,60397776,1.7569777323624507,1736,1842,3578,+
chr14,60397778,2.463633189805656,729,660,1389,+
chr14,60397794,0.8771882035751637,2304,3210,5514,+
chr14,60397795,0.5980777103189017,1885,2752,4637,+
chr14,60397796,0.5980777103189017,1885,2752,4637,+
chr14,60398202,1.9248243176989703,603,421,1024,+
chr14,60398204,1.7900732987207804,1513,981,2494,+
chr14,60398205,1.727303845528887,1220,781,2001,+
chr14,60398217,0.8372616442638325,743,456,1199,+
chr14,60398218,1.1141098484848484,904,639,1543,+
chr14,60398219,0.8372616442638325,743,456,1199,+
chr14,60398220,1.1141098484848484,904,639,1543,+
chr14,60796259,2.082852224097852,895,707,1602,+
chr14,60796277,1.9220565167771646,721,691,1412,+
chr14,60796296,5.115410052910052,498,503,1001,+
chr14,60796305,0.5417645262855444,1049,998,2047,+
chr14,60798089,2.8931685365446596,708,493,1201,+
chr14,60818724,1.2920090040149204,649,500,1149,+
chr14,60879750,3.0561718240942226,810,617,1427,+
chr14,60879751,3.077389277389277,573,428,1001,+
chr14,60968232,2.3816277006575506,647,484,1131,+
chr14,60968482,1.1439011402791035,671,414,1085,+
chr14,61695533,4.484848924247843,764,372,1136,+
chr14,61695544,1.8514833786745781,1014,677,1691,+
chr14,61695595,0.4668227946916472,597,426,1023,+
chr14,61695655,2.6041666666666665,584,431,1015,+
chr14,61695658,1.0507981220657276,1443,1135,2578,+
chr14,61695659,1.0507981220657276,1443,1135,2578,+
chr14,61695690,3.450584728273332,911,622,1533,+
chr14,61695779,0.5463514519731943,586,473,1059,+
chr14,61695782,2.067902590908075,923,693,1616,+
chr14,61695796,2.3463379736727226,2159,1439,3598,+
chr14,61695797,0.5108359133126935,659,493,1152,+
chr14,61695798,2.192626953125,1282,767,2049,+
chr14,61695801,1.681009076977484,619,498,1117,+
chr14,61695804,1.9252282445394657,616,508,1124,+
chr14,61695825,0.5687732342007434,645,537,1182,+
chr14,61720397,0.6733672334339743,1129,811,1940,+
chr14,61720398,1.0310509554140128,1049,784,1833,+
chr14,61720399,1.0310509554140128,1049,784,1833,+
chr14,61720406,1.1336921107315878,2987,2193,5180,+
chr14,61720529,1.4119748446396008,2107,1395,3502,+
chr14,61727494,1.3527966469142938,1679,1308,2987,+
chr14,61727518,1.3827694971859732,3193,2552,5745,+
chr14,61727519,1.3827694971859732,3193,2552,5745,+
chr14,61736891,1.9718544017837931,1550,1188,2738,+
chr14,61736892,0.5817065145865321,1767,1221,2988,+
chr14,61736923,1.3596577283627642,1918,1667,3585,+
chr14,61738192,1.57232790041866,3621,2528,6149,+
chr14,61740509,1.4900857273738632,989,825,1814,+
chr14,61740607,1.4661635220125786,1315,1112,2427,+
chr14,61740843,1.633273819128187,3557,2386,5943,+
chr14,61741024,1.726033714256164,3124,2624,5748,+
chr14,61745696,1.3466252234551397,5225,4005,9230,+
chr14,61745697,1.4304647909608317,7969,5595,13564,+
chr14,61747382,1.4536477806538202,1541,1158,2699,+
chr14,61747765,1.370848943599154,1581,1188,2769,+
chr14,61776163,2.2081729083170205,660,437,1097,+
chr14,63601595,2.4735543093480117,774,544,1318,+
chr14,63601597,3.0059513515497795,635,428,1063,+
chr14,63601606,2.039354430746376,891,723,1614,+
chr14,63601621,0.5590391099092319,1342,1033,2375,+
chr14,63601625,0.6029029029029028,633,554,1187,+
chr14,64388440,1.8797671737452495,724,528,1252,+
chr14,64400794,0.9617918313570487,583,505,1088,+
chr14,64400795,0.9617918313570487,583,505,1088,+
chr14,64419816,1.2580418663447912,805,541,1346,+
chr14,64426143,1.8468823993685868,701,361,1062,+
chr14,64426165,2.2652714932126696,889,441,1330,+
chr14,64426170,2.4366753528410254,1862,968,2830,+
chr14,64427373,6.289271241433776,621,390,1011,+
chr14,64440187,1.5369996704812605,1509,1102,2611,+
chr14,64440189,2.2720340883606185,920,636,1556,+
chr14,64440234,1.787474490309381,887,603,1490,+
chr14,64441407,2.0038340684676026,811,517,1328,+
chr14,64442066,2.148683685680096,742,435,1177,+
chr14,64448232,0.9817802874933111,601,521,1122,+
chr14,64453765,0.2743169038665363,615,473,1088,+
chr14,64458253,0.8913978494623657,828,464,1292,+
chr14,64458255,0.8913978494623657,828,464,1292,+
chr14,64459821,2.579651162790698,611,429,1040,+
chr14,64542352,1.687734382145797,658,376,1034,+
chr14,64542353,0.5250903251706143,653,469,1122,+
chr14,64542398,1.619774119347862,2170,1349,3519,+
chr14,64542538,3.08151200092585,620,555,1175,+
chr14,64542860,1.8865306487015356,754,561,1315,+
chr14,64542865,0.4146684645600047,642,460,1102,+
chr14,64542866,1.0510657451431935,891,647,1538,+
chr14,64727888,2.1283657894450454,972,467,1439,+
chr14,64727890,2.0796979865771807,736,297,1033,+
chr14,64727950,3.5589179487921996,751,356,1107,+
chr14,64727959,2.9639935910185153,1105,644,1749,+
chr14,64914473,2.4695362529349127,606,450,1056,+
chr14,64914518,0.49650189772546094,708,509,1217,+
chr14,64923993,0.5269632714256621,944,713,1657,+
chr14,64924006,1.1517094932181668,1133,807,1940,+
chr14,64924026,1.5856873822975517,841,530,1371,+
chr14,64924050,1.705232129697863,1611,1356,2967,+
chr14,64924052,1.705232129697863,1611,1356,2967,+
chr14,64932368,3.6149641524794407,695,403,1098,+
chr14,64932993,2.2509689190028253,546,458,1004,+
chr14,64933619,3.1986719351526314,621,513,1134,+
chr14,65742667,2.6932662900840527,811,537,1348,+
chr14,65742669,2.887808197618928,898,560,1458,+
chr14,65742737,0.9669278996865204,1193,869,2062,+
chr14,65742738,0.9669278996865204,1193,869,2062,+
chr14,65742754,1.5688073394495414,611,435,1046,+
chr14,65742757,2.0015716226037883,1692,1053,2745,+
chr14,67360408,1.285863848239556,948,701,1649,+
chr14,67364831,2.7175500588928148,720,565,1285,+
chr14,67364852,1.6275771002354273,1553,1113,2666,+
chr14,67364887,2.3190258751902593,585,437,1022,+
chr14,67364965,1.917420814479638,564,441,1005,+
chr14,67376484,2.651398026315789,976,607,1583,+
chr14,67376538,1.5814492753623188,991,689,1680,+
chr14,67380725,1.5783335890747276,1111,685,1796,+
chr14,67382472,1.9900000000000002,596,449,1045,+
chr14,67383318,1.6501637879690292,714,583,1297,+
chr14,67383378,0.6258796257968374,839,513,1352,+
chr14,67383414,1.7948170731707318,840,655,1495,+
chr14,67383632,1.7288438971327116,1559,1179,2738,+
chr14,67383692,1.8964757709251099,573,453,1026,+
chr14,67383984,1.9463726691166456,1099,929,2028,+
chr14,67383985,1.7614575069029603,1742,1375,3117,+
chr14,67384002,3.346846846846847,742,406,1148,+
chr14,67384029,0.5745686713336952,2371,1485,3856,+
chr14,67384035,1.6958548479632818,1390,995,2385,+
chr14,67384038,1.9451001380242807,3122,2438,5560,+
chr14,67384040,1.7146872810946623,5664,4488,10152,+
chr14,67384041,1.7646175622542593,3312,2724,6036,+
chr14,67384087,3.0944821130830196,597,472,1069,+
chr14,69460269,2.0951233180749265,617,529,1146,+
chr14,69461258,1.0412603054446647,600,427,1027,+
chr14,69768215,2.1582097319802243,637,426,1063,+
chr14,69768219,0.4703636363636363,596,499,1095,+
chr14,69768809,2.5217181467181473,626,443,1069,+
chr14,69768884,1.0949360452167878,2539,1945,4484,+
chr14,69769205,1.7909482758620692,830,719,1549,+
chr14,69769891,1.2271057056269807,613,468,1081,+
chr14,69770498,1.7821237585943468,728,594,1322,+
chr14,69771200,2.269206145966709,833,780,1613,+
chr14,69771202,2.269206145966709,833,780,1613,+
chr14,69771218,1.839501128350416,983,789,1772,+
chr14,69771466,0.6511118070779831,923,617,1540,+
chr14,69771573,3.502960531517363,1286,350,1636,+
chr14,69771577,4.0139864705159845,1374,353,1727,+
chr14,69771585,10.043508770194435,3137,903,4040,+
chr14,69771586,14.979500891265594,1028,373,1401,+
chr14,69771587,11.808108460295662,1967,631,2598,+
chr14,69771591,22.868605463813765,3515,1386,4901,+
chr14,69771592,43.91033949736321,3155,1323,4478,+
chr14,69771596,17.861074349092082,3574,2422,5996,+
chr14,69771597,13.376174285342648,3934,2594,6528,+
chr14,69771598,12.148816234498307,1346,886,2232,+
chr14,69771599,7.7840845854201435,1075,598,1673,+
chr14,69771601,7.503974367127385,2090,2212,4302,+
chr14,69771607,0.5318285817305275,1124,1375,2499,+
chr14,69771631,3.056367057952093,2028,2813,4841,+
chr14,69879715,1.110204081632653,647,566,1213,+
chr14,69879717,1.110204081632653,647,566,1213,+
chr14,69952139,1.9966268590181524,626,509,1135,+
chr14,69952262,2.0737999794429025,775,422,1197,+
chr14,69953428,0.5596742381948114,1079,832,1911,+
chr14,69953482,2.8899986128450554,946,800,1746,+
chr14,69953486,2.8647416413373863,753,563,1316,+
chr14,69975795,0.492929292929293,853,538,1391,+
chr14,69992439,2.0683464734711268,946,721,1667,+
chr14,69994399,1.457556935817805,959,758,1717,+
chr14,69994412,0.4965925925925926,837,539,1376,+
chr14,69994422,1.4812856887937187,1252,933,2185,+
chr14,70010828,1.7965056526207606,683,416,1099,+
chr14,70010856,1.761290322580645,818,619,1437,+
chr14,70011497,1.7598496349309618,715,476,1191,+
chr14,70011521,1.9983716007164958,766,533,1299,+
chr14,70011537,2.1675621890547268,777,602,1379,+
chr14,70013399,1.7572423909057573,598,403,1001,+
chr14,70013403,0.5820830876746963,1423,1033,2456,+
chr14,70013412,1.4766164068489647,1069,909,1978,+
chr14,70023207,2.2717700978570545,785,620,1405,+
chr14,70023208,1.9094396651941408,656,373,1029,+
chr14,70023234,1.7408312958435208,711,408,1119,+
chr14,70023255,1.925691699604743,869,505,1374,+
chr14,70023293,1.524503582395087,1283,976,2259,+
chr14,70023348,1.472836190869655,1084,720,1804,+
chr14,70030263,1.706794258373206,1028,824,1852,+
chr14,70030264,2.403638814016172,614,529,1143,+
chr14,70030348,1.8239908787693146,1260,995,2255,+
chr14,70030401,1.6353236223718564,1160,765,1925,+
chr14,70030428,0.7231012658227849,1827,1263,3090,+
chr14,70030447,1.3246354430155052,1695,1390,3085,+
chr14,70030551,45.24356235105333,5772,638,6410,+
chr14,70030552,38.43344642772974,8889,1157,10046,+
chr14,70030553,38.43344642772974,8889,1157,10046,+
chr14,70030554,37.39343626744588,5843,904,6747,+
chr14,70030558,14.424419787216275,5214,2349,7563,+
chr14,70030559,13.27514974236515,5803,2610,8413,+
chr14,70030561,9.879413176115719,1190,502,1692,+
chr14,70030568,24.73288894477207,7888,8026,15914,+
chr14,70030569,24.73288894477207,7888,8026,15914,+
chr14,70030570,24.73288894477207,7888,8026,15914,+
chr14,70030658,0.46461640211640204,561,566,1127,+
chr14,70030741,3.107292707292708,647,454,1101,+
chr14,70030803,2.6800046282586854,813,630,1443,+
chr14,70031004,1.4983198808477642,655,406,1061,+
chr14,70031118,1.4694953335637748,894,788,1682,+
chr14,70031304,0.4579114120043173,764,544,1308,+
chr14,70031413,7.240802226267343,1393,161,1554,+
chr14,70031414,6.922446010278435,1676,205,1881,+
chr14,70031417,6.974632972397388,2895,357,3252,+
chr14,70031418,8.109433645434654,5052,641,5693,+
chr14,70031419,7.701039691736344,4984,617,5601,+
chr14,70031420,9.652662378144337,5051,680,5731,+
chr14,70031421,12.371230701075284,2889,422,3311,+
chr14,70031423,45.551111111111105,1107,359,1466,+
chr14,70031424,27.940669571956033,4655,2788,7443,+
chr14,70031425,20.292519933447537,6122,4489,10611,+
chr14,70031426,19.981940800653863,5758,4445,10203,+
chr14,70031427,18.739997400813973,4340,4192,8532,+
chr14,70031721,2.5489365526276906,651,433,1084,+
chr14,70031828,1.044747081712062,536,513,1049,+
chr14,70031830,1.044747081712062,536,513,1049,+
chr14,70032046,1.1034403041545724,1125,775,1900,+
chr14,70032168,2.0224489705627886,652,522,1174,+
chr14,73099412,1.0958823529411763,647,424,1071,+
chr14,73099413,1.0958823529411763,647,424,1071,+
chr14,73099671,2.204330927262632,2381,1800,4181,+
chr14,73099672,2.1150255759453755,3233,2493,5726,+
chr14,73099673,2.1150255759453755,3233,2493,5726,+
chr14,73099674,2.072085492227979,2460,1929,4389,+
chr14,73099685,2.6818474412616675,1009,955,1964,+
chr14,73103339,2.4070750095376323,811,352,1163,+
chr14,73103376,2.900313971742543,738,363,1101,+
chr14,73103400,1.9348958333333333,742,479,1221,+
chr14,73103448,1.9523967884460072,933,678,1611,+
chr14,73103455,2.207006456876515,1580,1141,2721,+
chr14,73105954,2.388320251177394,1740,1185,2925,+
chr14,73105956,2.327149041434756,1419,979,2398,+
chr14,73106058,1.6534766480913923,832,527,1359,+
chr14,73107830,1.8598574821852727,755,420,1175,+
chr14,73107836,4.393349840820658,827,513,1340,+
chr14,73107856,2.8068416865552903,766,418,1184,+
chr14,73107857,3.7948096112229917,1343,920,2263,+
chr14,73109341,1.6362905387295634,1220,818,2038,+
chr14,73109355,2.0097591346865693,4432,3380,7812,+
chr14,73109356,2.265040650406504,2785,2159,4944,+
chr14,73148061,1.7474541751527493,623,490,1113,+
chr14,73148074,1.9499002608562224,1172,930,2102,+
chr14,73148076,1.9499002608562224,1172,930,2102,+
chr14,74735173,9.57459397077039,986,1080,2066,+
chr14,74735174,8.004241962184853,1578,2477,4055,+
chr14,74735175,8.004241962184853,1578,2477,4055,+
chr14,74735176,4.5326876513317185,485,825,1310,+
chr14,74735186,0.24285093588975692,446,584,1030,+
chr14,74798321,2.131824611032532,627,504,1131,+
chr14,74798323,2.131824611032532,627,504,1131,+
chr14,74798325,1.7303412462908012,932,673,1605,+
chr14,74798326,1.7303412462908012,932,673,1605,+
chr14,74798335,2.508960573476702,559,464,1023,+
chr14,74902954,22.30881183212942,1429,1047,2476,+
chr14,74902955,22.30881183212942,1429,1047,2476,+
chr14,75009332,1.6645933014354068,1490,835,2325,+
chr14,75009333,1.6645933014354068,1490,835,2325,+
chr14,75009336,2.120480838756327,808,460,1268,+
chr14,75009348,1.6032954419736696,1854,1103,2957,+
chr14,75009349,1.683885593901308,2623,1816,4439,+
chr14,75009385,2.6601399014778324,598,417,1015,+
chr14,75279066,1.4240389412166794,663,432,1095,+
chr14,75280689,0.2790310644506254,703,474,1177,+
chr14,75280825,1.0341114215187468,1626,1115,2741,+
chr14,75280887,0.4478935698447894,706,384,1090,+
chr14,75280949,0.6073867163252638,720,357,1077,+
chr14,75281109,2.9539365045286328,1166,828,1994,+
chr14,75281554,2.321718328420652,1128,780,1908,+
chr14,75281608,0.850993973384914,1638,1014,2652,+
chr14,75281610,1.0084161869876156,924,587,1511,+
chr14,75281624,1.6300778485491862,742,470,1212,+
chr14,75281763,1.0444238773372438,1506,1320,2826,+
chr14,75281809,2.073434125269978,575,462,1037,+
chr14,75988930,1.688654203900527,695,494,1189,+
chr14,76022339,0.3603927070096956,675,457,1132,+
chr14,76083589,3.9044099531904415,565,450,1015,+
chr14,76083591,4.557121319869151,758,577,1335,+
chr14,77329160,1.9361458651205368,618,451,1069,+
chr14,77329162,1.9361458651205368,618,451,1069,+
chr14,77458057,1.7571430776980974,1282,1068,2350,+
chr14,77458058,1.757143077698097,1282,1068,2350,+
chr14,77458095,0.8983820122818189,1230,989,2219,+
chr14,77458122,2.2682370820668694,596,469,1065,+
chr14,77458123,1.4519560857890619,805,466,1271,+
chr14,77458256,1.9762014609765477,1048,577,1625,+
chr14,77458258,1.9762014609765477,1048,577,1625,+
chr14,77459717,1.2702463918559739,2895,1843,4738,+
chr14,77459718,1.114693064102845,1995,1185,3180,+
chr14,77462175,4.331285444234404,610,528,1138,+
chr14,77462676,1.6069469835466177,878,546,1424,+
chr14,77465538,3.4230205278592383,666,340,1006,+
chr14,77465554,1.556126748693747,2461,1395,3856,+
chr14,77465555,1.5950457457462621,2984,1819,4803,+
chr14,77465556,1.556126748693747,2461,1395,3856,+
chr14,77468112,2.004048582995952,692,545,1237,+
chr14,77468114,1.9099037917374078,648,464,1112,+
chr14,77468133,0.5026881720430108,747,557,1304,+
chr14,77468150,1.6961278765330026,1255,884,2139,+
chr14,77468171,1.9355604667858377,3713,2407,6120,+
chr14,77468462,2.0460090053213262,1135,697,1832,+
chr14,77468463,0.6387445887445887,907,615,1522,+
chr14,77468466,1.7990813739932705,2813,1736,4549,+
chr14,77468473,0.6524932753983033,2260,1610,3870,+
chr14,77468474,1.7500377358490564,1495,999,2494,+
chr14,77468488,0.6869736924775385,3788,2590,6378,+
chr14,77468489,0.76516290255336,11219,7459,18678,+
chr14,77468491,1.0900203927099066,4000,2757,6757,+
chr14,77469213,0.5193234908620935,1233,867,2100,+
chr14,77469241,0.5853018372703411,668,507,1175,+
chr14,77469388,3.6683168316831694,740,403,1143,+
chr14,77469420,32.02319138148124,1635,1489,3124,+
chr14,77469421,27.165543281355315,2962,2555,5517,+
chr14,77708091,1.12433890331666,823,726,1549,+
chr14,77708092,1.12433890331666,823,726,1549,+
chr14,77708097,0.3933445180278649,905,605,1510,+
chr14,77708105,0.9184144982630924,1098,802,1900,+
chr14,77708107,1.234653972392281,1738,1291,3029,+
chr14,77708108,1.1253016663474429,1223,907,2130,+
chr14,77708149,1.6402462385659289,3462,2377,5839,+
chr14,77708150,1.6333196981593328,4058,2839,6897,+
chr14,77708152,1.5807252856433185,1160,890,2050,+
chr14,77708153,1.3807807807807808,1044,739,1783,+
chr14,77708156,1.410843847171093,730,570,1300,+
chr14,77708185,0.6976253323153951,4084,2810,6894,+
chr14,77715772,1.8063101862480204,3098,2373,5471,+
chr14,88572863,0.38160225197684816,649,464,1113,+
chr14,88609788,1.286426592797784,1031,721,1752,+
chr14,88609789,1.286426592797784,1031,721,1752,+
chr14,88824803,0.7681230747401472,1192,760,1952,+
chr14,88824805,1.0416374474053294,698,367,1065,+
chr14,88839464,1.2500069762555297,2279,1740,4019,+
chr14,88839465,1.6852671325325912,1341,1093,2434,+
chr14,88839472,2.881081081081081,778,702,1480,+
chr14,88872380,1.7210969602050024,1505,1071,2576,+
chr14,88872381,1.6317995367600129,2435,1608,4043,+
chr14,88872383,1.5534942639111649,1369,808,2177,+
chr14,88872384,1.727065127485885,1381,1195,2576,+
chr14,88872386,1.614326652628045,2295,1741,4036,+
chr14,88877306,1.7799955755740648,677,591,1268,+
chr14,90397066,1.4244674543385332,689,438,1127,+
chr14,90397191,1.5946059000167618,919,619,1538,+
chr14,90401311,2.515822039548911,1432,1244,2676,+
chr14,90401348,1.7389304197814837,1175,986,2161,+
chr14,90401358,0.4937283570604079,801,564,1365,+
chr14,90403862,1.6504677754677757,656,480,1136,+
chr14,90404735,2.0328310010764263,1258,928,2186,+
chr14,90404842,1.8400375939849627,1003,607,1610,+
chr14,90404848,1.6189157524763018,1139,686,1825,+
chr14,90405110,0.5317207341524857,984,733,1717,+
chr14,90766685,1.0874198941209252,931,775,1706,+
chr14,90766687,1.0874198941209252,931,775,1706,+
chr14,90766689,1.2266634970218147,5934,4816,10750,+
chr14,90766690,1.3177075507867606,5816,5392,11208,+
chr14,90766692,1.5283978174603174,1699,2303,4002,+
chr14,90766699,1.458212087682755,3381,2217,5598,+
chr14,90766700,1.638317805833504,8381,6805,15186,+
chr14,90766707,0.9905723880005616,4610,3000,7610,+
chr14,90766708,1.3638898570930638,1719,1509,3228,+
chr14,90766709,1.1737942311077214,11325,7887,19212,+
chr14,90766711,1.2939733576415506,6715,4887,11602,+
chr14,90766972,0.5654131355932204,609,471,1080,+
chr14,90766975,1.2116840738577455,743,510,1253,+
chr14,90766977,0.9188719746157983,2889,2145,5034,+
chr14,90766978,0.8298053186442975,2661,1948,4609,+
chr14,90766979,0.43795372050816694,857,550,1407,+
chr14,92026596,1.610943816516789,634,781,1415,+
chr14,92026598,1.610943816516789,634,781,1415,+
chr14,92122114,16.387700357196994,1311,982,2293,+
chr14,92122115,17.359815242494232,647,432,1079,+
chr14,92122116,15.343031477789319,1184,879,2063,+
chr14,92134023,0.9301948051948052,572,475,1047,+
chr14,92134024,0.9301948051948052,572,475,1047,+
chr14,92155131,0.48939648512298084,618,435,1053,+
chr14,92162213,1.4083964517916372,650,396,1046,+
chr14,92806893,2.045122261832034,1101,801,1902,+
chr14,92806894,2.2807775377969763,626,462,1088,+
chr14,92809497,2.14082149212313,574,499,1073,+
chr14,92824570,2.8365097159940214,798,668,1466,+
chr14,92824571,2.428997086074488,1291,935,2226,+
chr14,92835586,0.7310746760432895,688,371,1059,+
chr14,96502411,0.7853380684241096,710,330,1040,+
chr14,96502412,1.2180470755185708,840,406,1246,+
chr14,96502559,4.452862556089925,1813,1553,3366,+
chr14,96502560,3.965807635102408,1975,1766,3741,+
chr14,96502561,3.965807635102408,1975,1766,3741,+
chr14,96502562,2.2139037433155084,458,577,1035,+
chr14,96520056,0.5707932715234938,1170,1417,2587,+
chr14,96520057,0.3379743269960275,683,925,1608,+
chr14,96520058,0.6516422639704639,893,1014,1907,+
chr14,96520080,0.5465160805956549,844,713,1557,+
chr14,96520095,1.78349082823791,620,513,1133,+
chr14,96520170,0.4884432117203613,807,653,1460,+
chr14,96521026,1.982327636321358,1239,731,1970,+
chr14,96521027,2.018927187168933,2658,1722,4380,+
chr14,96521029,2.6097857142857137,1281,799,2080,+
chr14,96525324,0.3844782721831903,1018,731,1749,+
chr14,96525325,1.4936102775061535,790,630,1420,+
chr14,96525328,0.6188786243483033,1252,840,2092,+
chr14,96525329,1.578411751345093,3300,2549,5849,+
chr14,96525330,1.7397281921618204,1817,1581,3398,+
chr14,96525333,0.627003131331737,1701,1097,2798,+
chr14,96525369,1.7124324324324327,863,739,1602,+
chr14,96531492,2.0310688615812658,583,453,1036,+
chr14,96532355,5.176381757777106,590,472,1062,+
chr14,96532522,0.5503731343283582,589,535,1124,+
chr14,96534539,1.1107613013094297,824,618,1442,+
chr14,96544150,1.5942857142857143,728,524,1252,+
chr14,96547890,2.4355670103092786,629,387,1016,+
chr14,96556197,2.1400674602790155,592,486,1078,+
chr14,96556226,2.1016600317814405,680,486,1166,+
chr14,96556273,2.207473342227744,633,446,1079,+
chr14,96565130,3.1565946691176467,784,543,1327,+
chr14,96565132,3.1565946691176467,784,543,1327,+
chr14,96566052,2.5677912862904346,965,666,1631,+
chr14,96566155,0.5130057803468208,638,518,1156,+
chr14,96566354,0.5782615026208503,610,403,1013,+
chr14,96566571,2.770656718007352,877,665,1542,+
chr14,96566572,2.928181619733683,705,508,1213,+
chr14,96566787,0.49970544153531327,927,643,1570,+
chr14,96833500,2.6365246918426486,599,450,1049,+
chr14,96856171,4.070242061339318,909,628,1537,+
chr14,96860584,0.8668582375478928,904,666,1570,+
chr14,96860585,0.8668582375478928,904,666,1570,+
chr14,96860671,2.5349926398977223,722,497,1219,+
chr14,98973300,1.0138303651588019,1278,916,2194,+
chr14,98973301,1.0500815539739028,2178,1685,3863,+
chr14,98973302,1.0863907382814262,3927,2392,6319,+
chr14,98973303,1.146079144046069,7427,4898,12325,+
chr14,98973304,1.0156285565384349,7489,5027,12516,+
chr14,98973305,1.0604411990252385,6537,4066,10603,+
chr14,98973307,1.050283984243883,3664,2290,5954,+
chr14,98973311,1.185585652054777,8750,7185,15935,+
chr14,98973312,1.0514316040362113,4546,4178,8724,+
chr14,98973313,1.1371867528672306,6070,5417,11487,+
chr14,100239256,0.7871993880642078,839,543,1382,+
chr14,100239263,2.6549111697197634,1078,660,1738,+
chr14,100239265,3.3189249099473543,677,400,1077,+
chr14,100239863,2.43998417927178,610,396,1006,+
chr14,100239900,1.2926829268292683,688,532,1220,+
chr14,100239902,2.004390616899555,1418,1138,2556,+
chr14,100239904,2.0261904761904757,739,599,1338,+
chr14,100262302,1.4962439362439357,700,924,1624,+
chr14,100262303,1.2430946313377782,1089,838,1927,+
chr14,100262304,1.1215115967646905,624,761,1385,+
chr14,100262305,0.5587513935340023,715,597,1312,+
chr14,100262308,1.824409208413516,3103,2984,6087,+
chr14,100262309,1.824409208413516,3103,2984,6087,+
chr14,100262396,2.4104124408384044,712,434,1146,+
chr14,100277493,3.36893199023254,768,523,1291,+
chr14,100277545,1.8910614811926723,840,652,1492,+
chr14,100277585,2.302199371608112,619,388,1007,+
chr14,100277588,2.455357142857143,649,415,1064,+
chr14,100277810,2.3376054686391297,902,604,1506,+
chr14,100277816,1.3517801704695893,723,549,1272,+
chr14,100278173,2.3189834593055094,729,536,1265,+
chr14,100278283,2.119298245614035,603,417,1020,+
chr14,100278316,1.4785714285714286,1241,755,1996,+
chr14,100278361,0.441948455854678,969,638,1607,+
chr14,100278367,0.4685437856611263,1110,694,1804,+
chr14,100278384,1.5061079545454543,1382,879,2261,+
chr14,100278391,1.4275320632127508,1533,1018,2551,+
chr14,100278396,1.5370151974863306,6701,4448,11149,+
chr14,100278402,0.6974911190053286,2162,1688,3850,+
chr14,100278406,1.5612932095312675,1885,1276,3161,+
chr14,100278417,1.5857763675243153,2606,1462,4068,+
chr14,100278434,1.668559597752144,2946,2253,5199,+
chr14,101678239,0.8982323466820716,1558,1147,2705,+
chr14,101678240,1.0096716480564776,1543,1172,2715,+
chr14,101678241,1.1293513166345537,727,518,1245,+
chr14,101678242,1.3577569796954312,1235,984,2219,+
chr14,101678243,1.3973045822102426,971,794,1765,+
chr14,101678244,0.7243511367344719,2067,1449,3516,+
chr14,101678245,0.9939610219717671,3551,2770,6321,+
chr14,101678246,1.3319105251783014,1484,1321,2805,+
chr14,101882213,0.38803680981595096,689,488,1177,+
chr14,101882215,0.38803680981595096,689,488,1177,+
chr14,101893019,2.5446974478439612,625,411,1036,+
chr14,101894532,1.3895710317282672,938,622,1560,+
chr14,101909606,0.542849344978166,662,457,1119,+
chr14,101909623,2.3466666666666667,663,414,1077,+
chr14,101909635,2.183126110124334,722,562,1284,+
chr14,101909641,2.261707172495554,586,481,1067,+
chr14,101983113,2.8307692307692314,643,363,1006,+
chr14,101983115,2.8307692307692314,643,363,1006,+
chr14,102029609,2.962069491801947,692,390,1082,+
chr14,102036501,3.0747767857142856,550,511,1061,+
chr14,102903262,3.303741093663899,757,472,1229,+
chr14,102903279,1.9547044425616888,651,413,1064,+
chr14,103334538,1.4104844655550022,850,530,1380,+
chr14,103334539,1.0359042553191489,655,375,1030,+
chr14,103335687,0.4841829122326813,712,541,1253,+
chr14,103335704,2.5774932795736807,829,603,1432,+
chr14,103338328,4.8299886782874815,651,444,1095,+
chr14,103339650,2.2924391421632744,1237,858,2095,+
chr14,103339653,2.878969957081545,558,465,1023,+
chr14,103340434,1.1310469980652529,1005,717,1722,+
chr14,103341576,2.4738290556552096,885,644,1529,+
chr14,103342332,2.869021803344331,638,429,1067,+
chr14,103342364,2.262822960835489,577,459,1036,+
chr14,103405089,3.19345049325419,661,426,1087,+
chr14,103466006,0.37016884739467976,601,468,1069,+
chr14,103480454,2.9843994072271944,799,555,1354,+
chr14,103571771,1.6256722475900558,865,656,1521,+
chr14,103587279,0.5335802053526342,633,456,1089,+
chr14,103587297,1.6683335795897667,1321,1190,2511,+
chr14,103587300,1.611358758461284,609,672,1281,+
chr14,103587314,2.5362426035502956,1396,1689,3085,+
chr14,103587315,2.5362426035502956,1396,1689,3085,+
chr14,103669585,1.487467593097385,567,442,1009,+
chr14,103673108,3.6018237082066857,868,516,1384,+
chr14,103673110,3.6018237082066857,868,516,1384,+
chr14,103673173,3.3282629288491816,643,431,1074,+
chr14,103675556,1.5477910889110889,654,471,1125,+
chr14,103675557,0.2904977375565611,641,454,1095,+
chr14,103675559,0.2904977375565611,641,454,1095,+
chr14,103675733,4.130533852168232,617,488,1105,+
chr14,103677424,0.942058763098418,654,470,1124,+
chr14,103677426,0.942058763098418,654,470,1124,+
chr14,103728950,2.599734535437015,611,599,1210,+
chr14,104701409,1.1414648473762,727,431,1158,+
chr14,104715306,0.924031519551044,780,554,1334,+
chr14,104715316,2.7876899813467846,727,477,1204,+
chr14,104755634,1.3740674847654253,861,450,1311,+
chr14,104755686,2.0816436874831035,879,410,1289,+
chr14,104755687,2.1222526580738905,1192,657,1849,+
chr14,104759431,1.136393878908849,853,500,1353,+
chr14,104759433,1.136393878908849,853,500,1353,+
chr14,104759557,2.0257982504230028,856,636,1492,+
chr15,22866257,2.1482729036463515,824,647,1471,+
chr15,22866436,5.101382488479263,655,433,1088,+
chr15,22866437,5.101382488479263,655,433,1088,+
chr15,22866459,2.069983165951069,717,526,1243,+
chr15,22866471,1.0862734600715434,961,682,1643,+
chr15,22866565,2.445565960080233,1014,598,1612,+
chr15,22866785,2.0394736842105257,619,398,1017,+
chr15,24955017,3.942056789120835,621,424,1045,+
chr15,24962163,2.3662695694559326,1084,717,1801,+
chr15,24962170,2.093410178338408,712,417,1129,+
chr15,24967939,1.94179167089317,1303,875,2178,+
chr15,24967963,1.781805507145347,638,452,1090,+
chr15,24967967,1.315707022772528,1337,920,2257,+
chr15,24967979,2.2838606821390206,1551,1011,2562,+
chr15,24968032,2.7894958869436826,574,430,1004,+
chr15,24968063,1.7966272189349108,1046,649,1695,+
chr15,24974319,1.5699099774385783,1528,1075,2603,+
chr15,24975376,1.8833052276559863,697,592,1289,+
chr15,24975399,1.4767783218687789,2127,1470,3597,+
chr15,24976371,2.589186631833822,717,613,1330,+
chr15,24977899,3.576027397260274,680,364,1044,+
chr15,24977901,1.9496269122720111,1162,866,2028,+
chr15,24978434,1.8355955035963247,1212,972,2184,+
chr15,24978452,1.9485747046883213,1230,1036,2266,+
chr15,24978462,1.6613026819923369,541,521,1062,+
chr15,24978469,1.5788732394366198,892,709,1601,+
chr15,25106521,0.7818166525457771,1036,702,1738,+
chr15,25106522,0.8851334050289342,595,413,1008,+
chr15,25106540,1.463183839986401,1053,750,1803,+
chr15,25107542,3.152109676876412,722,627,1349,+
chr15,25107550,4.087444934238167,547,545,1092,+
chr15,26645467,0.7103950360485818,1549,1206,2755,+
chr15,26645497,1.3547936177592783,2850,2324,5174,+
chr15,26645506,1.2671733985395714,13422,8818,22240,+
chr15,26645507,1.2671733985395714,13422,8818,22240,+
chr15,26645510,1.2073468286099864,4683,3799,8482,+
chr15,26645512,1.4959725770957741,8405,6099,14504,+
chr15,26645516,1.2257714824600285,9078,6101,15179,+
chr15,26645931,1.0279075600995586,1218,777,1995,+
chr15,32605179,1.745005875440658,809,551,1360,+
chr15,32606769,0.5812590732470182,1435,980,2415,+
chr15,32615888,0.3769682856509204,522,500,1022,+
chr15,32615889,0.3769682856509204,522,500,1022,+
chr15,32615907,1.246424198750173,671,513,1184,+
chr15,32638451,3.235576923076924,672,350,1022,+
chr15,32638452,3.235576923076924,672,350,1022,+
chr15,34227774,1.288826622567169,2046,1621,3667,+
chr15,34228437,1.8330787390640189,659,378,1037,+
chr15,35237348,2.4740689439698995,662,505,1167,+
chr15,38465312,1.7115522536643222,857,623,1480,+
chr15,38465313,1.7115522536643222,857,623,1480,+
chr15,38465319,2.6864037670915657,753,568,1321,+
chr15,40176571,1.2136445344487954,585,431,1016,+
chr15,40183834,1.6093968650584425,721,574,1295,+
chr15,40196754,1.7795880149812735,730,444,1174,+
chr15,40199617,4.231396534148828,592,435,1027,+
chr15,40200301,0.7263912373860072,682,546,1228,+
chr15,40202621,0.9761306770470259,556,526,1082,+
chr15,40217632,0.8261455525606468,612,423,1035,+
chr15,40217634,1.2529273155382732,801,570,1371,+
chr15,40221012,1.9822953711166444,655,575,1230,+
chr15,40386427,2.411308203991131,608,450,1058,+
chr15,40387160,1.8021342933699325,3080,2332,5412,+
chr15,40387161,0.9527346938775508,1060,749,1809,+
chr15,40387162,2.709200524246396,890,762,1652,+
chr15,40389900,0.37805232558139534,577,429,1006,+
chr15,40389901,2.3923611111111107,688,447,1135,+
chr15,40391496,1.8918918918918919,559,443,1002,+
chr15,40391535,1.9285884881776933,949,631,1580,+
chr15,40391951,2.2895063145809416,2373,1674,4047,+
chr15,40391953,1.8763710287443267,3691,2643,6334,+
chr15,40391955,1.9230524642289348,5375,4069,9444,+
chr15,40391956,1.733341511023882,4148,3177,7325,+
chr15,40391957,1.733341511023882,4148,3177,7325,+
chr15,40393656,2.5,699,503,1202,+
chr15,40393668,2.022652232254727,1043,857,1900,+
chr15,40393680,1.734916682627849,646,453,1099,+
chr15,40393745,1.9156118143459915,680,473,1153,+
chr15,40393764,4.858719646799117,638,452,1090,+
chr15,40393834,2.2873800582075763,1142,882,2024,+
chr15,40393848,2.5699300699300696,503,527,1030,+
chr15,40393911,2.599279571381036,861,792,1653,+
chr15,40394126,1.8491071428571424,762,559,1321,+
chr15,40651493,2.243716931216931,689,431,1120,+
chr15,40651495,2.1976744186046506,755,515,1270,+
chr15,41231387,2.1443665448800235,711,493,1204,+
chr15,41231388,1.8197559186505414,1525,826,2351,+
chr15,41231389,2.0191835098619375,960,475,1435,+
chr15,41298943,6.361732851985559,800,553,1353,+
chr15,41298944,5.926408425485305,1105,832,1937,+
chr15,41298945,5.373568392391923,908,707,1615,+
chr15,41299371,2.8411575196023326,637,494,1131,+
chr15,41304625,2.7735851292802214,896,610,1506,+
chr15,41304627,2.7735851292802214,896,610,1506,+
chr15,41342433,0.6123646209386282,707,553,1260,+
chr15,41349102,2.1685705135048576,548,492,1040,+
chr15,41351013,1.8647272727272728,640,384,1024,+
chr15,41351029,1.9219512195121948,787,491,1278,+
chr15,41351030,1.9219512195121948,787,491,1278,+
chr15,41351037,1.8937856455077398,798,586,1384,+
chr15,41351102,2.070091915997765,2060,1419,3479,+
chr15,41356072,2.2714566725333887,1096,742,1838,+
chr15,41358150,0.5808214103810715,1343,938,2281,+
chr15,41365522,1.0143776824034334,977,698,1675,+
chr15,41365524,1.0143776824034334,977,698,1675,+
chr15,41365574,1.951270358306189,935,613,1548,+
chr15,41371648,0.5894481503941783,647,484,1131,+
chr15,41371652,0.5374266494919135,750,547,1297,+
chr15,41375721,2.043010752688172,1114,668,1782,+
chr15,41375765,1.395659429297959,4814,2795,7609,+
chr15,41375766,1.3473403881310646,3955,2187,6142,+
chr15,41375778,1.589157470660361,954,691,1645,+
chr15,41375810,2.4338359797972458,3100,2116,5216,+
chr15,41375814,2.6520339363232126,3294,2405,5699,+
chr15,41377198,1.4164081688123293,6619,4013,10632,+
chr15,41377201,1.347110475801511,3191,1769,4960,+
chr15,41377202,1.2821360966375894,2601,1652,4253,+
chr15,41377232,1.684827717494765,3403,2294,5697,+
chr15,41377237,1.3006439121037463,7841,5551,13392,+
chr15,41377238,1.2345202830154622,13734,9478,23212,+
chr15,41380118,1.959519572953737,880,561,1441,+
chr15,41380250,2.27027027027027,783,517,1300,+
chr15,41380496,2.4766949152542366,667,471,1138,+
chr15,41479154,6.475936450225265,643,574,1217,+
chr15,41479173,2.3351627953376877,573,526,1099,+
chr15,41557023,0.7713243082218986,619,460,1079,+
chr15,42529786,0.2723502304147465,590,419,1009,+
chr15,42529787,0.2723502304147465,590,419,1009,+
chr15,43194449,1.0339285714285713,578,475,1053,+
chr15,43194450,1.0339285714285713,578,475,1053,+
chr15,43385866,2.705801036698196,627,425,1052,+
chr15,43746554,0.9231556725435295,1083,492,1575,+
chr15,43746560,2.510607180784326,840,423,1263,+
chr15,43746622,1.695652173913043,935,551,1486,+
chr15,43753824,1.9929702697746954,993,690,1683,+
chr15,43753826,2.047647409172126,763,510,1273,+
chr15,43753841,0.5308747855917667,618,529,1147,+
chr15,43753844,1.6385918351416753,655,556,1211,+
chr15,43756649,1.8852035749751734,677,529,1206,+
chr15,43756657,1.596092796092796,816,545,1361,+
chr15,43756669,0.6748145330036143,945,750,1695,+
chr15,43756674,1.6533870170233806,2103,1583,3686,+
chr15,43756675,1.0377233854399852,4551,3510,8061,+
chr15,43756676,0.5234884287974765,3713,2624,6337,+
chr15,43756679,1.289148763727438,7068,5264,12332,+
chr15,43756680,1.289148763727438,7068,5264,12332,+
chr15,43756681,1.7979630467192658,5336,4421,9757,+
chr15,43756683,1.5330532970768262,7220,5346,12566,+
chr15,43756685,1.3484869832026174,4379,2888,7267,+
chr15,43761427,0.622502628811777,1294,950,2244,+
chr15,43763077,2.3147163394338084,2103,1478,3581,+
chr15,43763078,1.9713365444753463,1645,1049,2694,+
chr15,43763083,1.677134733098537,2291,1761,4052,+
chr15,43763085,1.565429581116471,2203,1778,3981,+
chr15,43763086,1.463505816399134,2395,1919,4314,+
chr15,43763090,3.2852047146401984,920,805,1725,+
chr15,43763091,1.0695820827690952,2254,1719,3973,+
chr15,43765460,1.3545675498690308,1748,1417,3165,+
chr15,43765921,1.8196142970246114,1537,1020,2557,+
chr15,43765922,1.9839777081156391,889,434,1323,+
chr15,43765928,1.7606177606177609,911,517,1428,+
chr15,43765931,3.185725871857259,981,547,1528,+
chr15,43765947,1.5206978119455945,1111,711,1822,+
chr15,43765948,1.8133993932140173,1302,970,2272,+
chr15,43766861,1.989225393127548,620,403,1023,+
chr15,43766866,0.5120107962213225,812,493,1305,+
chr15,43766884,1.5488175675675675,2594,1599,4193,+
chr15,43766885,1.5488175675675675,2594,1599,4193,+
chr15,43769579,2.088402115541505,857,575,1432,+
chr15,43769580,2.1498092918523963,1016,462,1478,+
chr15,43769581,2.1498092918523963,1016,462,1478,+
chr15,43769604,2.4496855345911945,778,423,1201,+
chr15,43769622,2.1072280941016026,1051,837,1888,+
chr15,43769626,0.9294671599115839,3962,2498,6460,+
chr15,43769628,1.2479382164653312,4242,2436,6678,+
chr15,43769630,1.2085061997089621,4300,2641,6941,+
chr15,43770553,1.58004158004158,1519,961,2480,+
chr15,43770554,1.5166822993434277,1385,877,2262,+
chr15,43771139,1.6306884163158661,1852,1327,3179,+
chr15,43771450,2.2767292302453206,3218,838,4056,+
chr15,43771451,2.510331636755727,6811,1846,8657,+
chr15,43771467,9.554421768707485,3444,545,3989,+
chr15,43771468,6.254854130827101,14065,2693,16758,+
chr15,43771469,6.254854130827101,14065,2693,16758,+
chr15,43771470,5.207583273087459,17195,3487,20682,+
chr15,43771472,3.861564610729639,10775,2395,13170,+
chr15,43771473,3.5234186129176606,4297,1013,5310,+
chr15,43771479,48.76729843561975,2197,1107,3304,+
chr15,43771480,38.02968302222246,13000,6601,19601,+
chr15,43771481,38.02968302222246,13000,6601,19601,+
chr15,43771482,36.85159016228872,12266,6358,18624,+
chr15,43792324,0.9349999999999999,730,429,1159,+
chr15,43792325,0.9999079273792537,1289,832,2121,+
chr15,43792327,1.3934097817076538,876,657,1533,+
chr15,43792328,2.534790009013229,1090,771,1861,+
chr15,43792329,1.0267654231503922,2135,1322,3457,+
chr15,43792353,0.7099398845101083,11016,7984,19000,+
chr15,43793009,1.2800291952489296,8417,4771,13188,+
chr15,43793011,1.2800291952489296,8417,4771,13188,+
chr15,43793012,0.7298944485317296,7509,5481,12990,+
chr15,43793729,1.3180379746835444,2890,2211,5101,+
chr15,43793735,1.3508936825885978,3602,2199,5801,+
chr15,43793736,0.9215457704658426,6445,4825,11270,+
chr15,43793738,0.9215457704658426,6445,4825,11270,+
chr15,43793958,1.304668861626519,5318,3717,9035,+
chr15,43793975,3.337682562397407,1219,1032,2251,+
chr15,43793976,1.8716220034392184,6433,4297,10730,+
chr15,43793977,1.8716220034392184,6433,4297,10730,+
chr15,43800618,0.8673867032047028,1105,714,1819,+
chr15,43800620,0.9084249084249085,839,545,1384,+
chr15,43800752,0.5594197138314786,562,443,1005,+
chr15,43800758,1.849984132799867,1658,1107,2765,+
chr15,43801134,1.0116152715477693,1774,1265,3039,+
chr15,43801141,1.6487318087318088,861,649,1510,+
chr15,43801152,1.7755856966707768,1055,810,1865,+
chr15,43801155,1.3948599089305491,1942,1282,3224,+
chr15,43801168,1.318477193422345,1417,1112,2529,+
chr15,43801171,2.266203703703704,1512,1223,2735,+
chr15,43801786,2.10996835443038,634,394,1028,+
chr15,43835112,0.3362595138890364,613,460,1073,+
chr15,44289217,2.0939435968562186,675,514,1189,+
chr15,44289218,2.098175639343641,921,657,1578,+
chr15,44289219,2.099441097110057,654,494,1148,+
chr15,44415318,5.68806865445406,932,590,1522,+
chr15,44524271,1.8234295964823168,1297,931,2228,+
chr15,44524297,3.296751968503937,608,507,1115,+
chr15,44527416,1.7329669555667344,799,682,1481,+
chr15,44557513,1.9259259259259256,909,539,1448,+
chr15,44561062,2.0196353436185133,1007,643,1650,+
chr15,44561063,2.0196353436185133,1007,643,1650,+
chr15,44561081,2.1262555905858203,724,592,1316,+
chr15,44561082,2.1262555905858203,724,592,1316,+
chr15,44561188,2.0565987833906374,647,397,1044,+
chr15,44561590,1.2793682306536713,1175,856,2031,+
chr15,44711513,0.9981953692440879,5132,3876,9008,+
chr15,44711514,0.9405543287122234,3919,3431,7350,+
chr15,44711515,0.9514000382875786,10179,7274,17453,+
chr15,44711516,0.9472075171506881,8534,6460,14994,+
chr15,44711521,1.2202943234768922,7902,5992,13894,+
chr15,44711522,1.0840675957383152,11515,9123,20638,+
chr15,44711531,0.8414025527032841,4427,3669,8096,+
chr15,44711544,0.8682581329817506,6516,5572,12088,+
chr15,44715423,1.4741803533656836,10554,8036,18590,+
chr15,44715431,0.8648620551574019,20840,15377,36217,+
chr15,44716327,0.6208062472213739,713,416,1129,+
chr15,44717634,1.1942023884595268,18619,12397,31016,+
chr15,44717785,1.3004874983948782,20400,16151,36551,+
chr15,44717852,1.2790904797678748,25054,16488,41542,+
chr15,44717871,1.195956755919498,75042,57474,132516,+
chr15,45073631,2.231501436781609,709,383,1092,+
chr15,45073632,2.231501436781609,709,383,1092,+
chr15,45418644,1.1390051139005113,734,477,1211,+
chr15,45418645,1.4718151002492472,1026,648,1674,+
chr15,45606762,1.5247863247863251,668,404,1072,+
chr15,48332159,0.5303843431945091,2264,1618,3882,+
chr15,48332160,0.5267037004256068,1697,1148,2845,+
chr15,48332161,0.5167159954654764,2354,1730,4084,+
chr15,48332166,0.5078221437779273,1373,1034,2407,+
chr15,48332392,1.011732887881319,1105,866,1971,+
chr15,48332393,1.011732887881319,1105,866,1971,+
chr15,48334417,1.1950099817430717,1302,821,2123,+
chr15,48334421,1.6700737978010558,3667,2146,5813,+
chr15,48334422,1.6225093421857453,3616,2011,5627,+
chr15,48334423,1.639055371679041,3011,1596,4607,+
chr15,48334429,1.554993970572309,2106,1362,3468,+
chr15,48334430,2.468933823529412,725,543,1268,+
chr15,48334434,1.9983633387888704,998,845,1843,+
chr15,48341328,1.4068299925760948,1515,1346,2861,+
chr15,48341517,1.3626577126577128,2308,1619,3927,+
chr15,48342138,1.6155206602711834,1255,793,2048,+
chr15,48342143,1.6739459844905964,1251,862,2113,+
chr15,48342146,1.7662337662337664,713,587,1300,+
chr15,48342152,1.9809437386569877,1516,1101,2617,+
chr15,48342280,1.5229343978308352,1010,780,1790,+
chr15,48878137,1.4912731658058196,722,575,1297,+
chr15,48878291,2.324701490302932,588,475,1063,+
chr15,48878400,2.54556625826905,611,495,1106,+
chr15,48878449,2.1800214822771213,707,664,1371,+
chr15,48878450,2.1800214822771213,707,664,1371,+
chr15,48878544,0.5324438202247191,668,533,1201,+
chr15,48878561,1.5324041811846691,732,594,1326,+
chr15,48878572,1.911686334221545,1115,709,1824,+
chr15,48878618,1.6065531475748194,957,815,1772,+
chr15,48878655,0.6949029030606216,1856,1436,3292,+
chr15,49625332,2.485188968335036,810,444,1254,+
chr15,49625333,1.5408296878274974,1447,904,2351,+
chr15,49632208,1.941217512646084,717,545,1262,+
chr15,49634755,2.7993564697770625,839,457,1296,+
chr15,49634757,2.7993564697770625,839,457,1296,+
chr15,49634760,2.73126925651697,1007,721,1728,+
chr15,49643355,0.5742281879194631,1022,744,1766,+
chr15,49643410,3.0677200902934536,603,442,1045,+
chr15,49643527,2.3772876489984696,1163,817,1980,+
chr15,50449433,1.5402951976009895,855,519,1374,+
chr15,50449434,1.5679459263492017,811,460,1271,+
chr15,50471715,1.5325323245761853,1115,760,1875,+
chr15,50929042,1.0215394361735826,859,573,1432,+
chr15,50929043,0.7086409091283178,1607,1066,2673,+
chr15,50929045,1.0023701750733063,1156,789,1945,+
chr15,50929056,2.400630945044559,850,641,1491,+
chr15,51909436,0.26201067615658363,588,561,1149,+
chr15,52050034,0.9754959113116024,740,470,1210,+
chr15,52050118,2.563131313131313,1014,461,1475,+
chr15,52050120,2.397845006216329,1051,507,1558,+
chr15,52050121,2.2823020240603125,1159,641,1800,+
chr15,52058639,2.330976430976431,988,593,1581,+
chr15,52058641,2.6960996749729147,1500,922,2422,+
chr15,52058642,2.6142319749216303,1016,637,1653,+
chr15,52061378,6.506818469888055,565,453,1018,+
chr15,52063993,1.8003622750875494,1552,1273,2825,+
chr15,52063995,1.8003622750875494,1552,1273,2825,+
chr15,52063998,1.9778784229540811,1756,1613,3369,+
chr15,52064000,2.075840309250372,2589,2108,4697,+
chr15,52064003,1.592358975624367,6499,4959,11458,+
chr15,52064005,1.5532261575867354,7865,5916,13781,+
chr15,52064006,1.4524545749035545,2665,1847,4512,+
chr15,52095670,0.8922640534023206,605,443,1048,+
chr15,52095685,0.6533647058823531,711,624,1335,+
chr15,52095688,1.95118722594523,535,710,1245,+
chr15,57289375,3.5660654438403663,792,414,1206,+
chr15,57289377,3.168315410569129,606,399,1005,+
chr15,59105171,2.5929103593118965,902,483,1385,+
chr15,59105173,2.4591251885369534,1018,509,1527,+
chr15,59105175,2.9363138329094114,1034,537,1571,+
chr15,59105176,3.404176458225865,900,534,1434,+
chr15,59105265,0.3432692307692307,764,389,1153,+
chr15,59105267,0.6878211080202868,1437,745,2182,+
chr15,59105268,1.0641967422548706,783,403,1186,+
chr15,59107365,2.2120237237440104,1142,775,1917,+
chr15,59107607,2.2074603985692387,799,514,1313,+
chr15,59114473,2.2474820143884893,780,555,1335,+
chr15,59114476,1.9224211423699915,819,611,1430,+
chr15,59114477,1.954718285516765,779,525,1304,+
chr15,59114481,1.347782595022387,2351,1752,4103,+
chr15,59114495,1.1522576539157232,4046,2713,6759,+
chr15,59114496,1.2771428960267166,6443,4890,11333,+
chr15,59114497,1.3050618968446717,7782,6174,13956,+
chr15,59114498,0.7468688200395517,2265,1516,3781,+
chr15,59114499,1.5233088253077611,3998,3823,7821,+
chr15,59114501,1.4641210120868584,4299,4234,8533,+
chr15,59114503,1.5050830227041685,2960,2950,5910,+
chr15,59114505,1.3766709393883902,1968,1396,3364,+
chr15,59114540,1.1469778074379418,6652,4942,11594,+
chr15,59116800,2.6038888888888887,871,575,1446,+
chr15,59116812,2.7374749498997994,682,498,1180,+
chr15,59117248,0.49403596225743274,739,547,1286,+
chr15,59117286,1.8020214984758545,701,541,1242,+
chr15,59124773,1.8856652205350686,672,460,1132,+
chr15,59124774,1.9831730769230769,749,415,1164,+
chr15,59124940,1.281315123980921,1433,1028,2461,+
chr15,59768367,0.5498802481933298,742,548,1290,+
chr15,59768378,1.6070430622009566,1311,1374,2685,+
chr15,59768379,1.2557216127157758,3407,2808,6215,+
chr15,59768380,1.5203565539154569,1950,2161,4111,+
chr15,59768381,1.0011801592764757,3404,2362,5766,+
chr15,59768382,1.3143554135640358,2494,2234,4728,+
chr15,59768387,1.072507417063742,2168,1588,3756,+
chr15,59768388,1.5249354005167959,1072,859,1931,+
chr15,59768389,1.072507417063742,2168,1588,3756,+
chr15,59768390,1.0240269654010112,3567,2881,6448,+
chr15,59768391,0.9894722820907096,6969,7276,14245,+
chr15,59768393,1.1723182957753129,5429,6072,11501,+
chr15,59768396,1.4581953663308276,1922,2568,4490,+
chr15,59768508,0.5152374265728965,1909,1356,3265,+
chr15,59768509,0.6381128950968392,1312,730,2042,+
chr15,59768558,0.6316509358569337,1547,764,2311,+
chr15,59768559,0.8870166992628252,736,288,1024,+
chr15,59768561,1.186184898229875,2242,1282,3524,+
chr15,59768562,1.0411705527520434,1880,1026,2906,+
chr15,59768565,1.6377403437127789,1399,652,2051,+
chr15,59768567,1.6377403437127789,1399,652,2051,+
chr15,59768568,1.5430942053706322,2281,1206,3487,+
chr15,59768570,1.259153126469207,4645,2446,7091,+
chr15,59768572,0.8733855230487704,4107,2158,6265,+
chr15,59768573,0.6731712728466273,9744,4998,14742,+
chr15,59768575,0.7380130156715161,15532,7760,23292,+
chr15,59768576,0.7530936163423086,17410,9009,26419,+
chr15,59768577,0.78376333935571,12536,6211,18747,+
chr15,59768581,1.5097983804366517,8546,4326,12872,+
chr15,59768597,1.2717577472211243,3526,1813,5339,+
chr15,59768641,1.4376273225460188,7179,4093,11272,+
chr15,59768876,0.8905160260616829,2239,1746,3985,+
chr15,59768877,0.8742403034248682,1614,1313,2927,+
chr15,59768878,0.8935249069826248,1600,1456,3056,+
chr15,59768880,0.7570830173229608,3399,2390,5789,+
chr15,59768881,0.7563282122527417,1652,1042,2694,+
chr15,59768882,1.2416632358995472,1715,1154,2869,+
chr15,59768884,1.0885358292409564,5949,5250,11199,+
chr15,59768885,0.9083730266972164,12654,9439,22093,+
chr15,59768886,1.0885358292409564,5949,5250,11199,+
chr15,59768888,0.6320290998880981,4523,2540,7063,+
chr15,59768892,1.1114720092049395,13150,10057,23207,+
chr15,59768894,0.9997253176900256,13067,10290,23357,+
chr15,59768895,1.2078067774813914,5218,3776,8994,+
chr15,59768896,1.0988279146734354,13848,10087,23935,+
chr15,59768898,1.2802720641306422,6998,4177,11175,+
chr15,59768905,1.381516963954904,4855,2698,7553,+
chr15,63057006,1.6463157894736842,551,474,1025,+
chr15,63141752,1.2775878843277098,562,445,1007,+
chr15,64096141,5.031355154481493,764,466,1230,+
chr15,64096142,4.953721810744775,1402,945,2347,+
chr15,64096143,4.719429061819322,1612,1099,2711,+
chr15,64112572,0.3958176224041698,552,496,1048,+
chr15,64112575,0.503913614519884,739,572,1311,+
chr15,64112589,0.45883540975215886,1773,1324,3097,+
chr15,64112590,0.4431903686982694,1215,885,2100,+
chr15,64112591,0.4431903686982694,1215,885,2100,+
chr15,64112598,0.616039219313662,739,568,1307,+
chr15,64118793,1.025940337224384,903,513,1416,+
chr15,64118794,1.025940337224384,903,513,1416,+
chr15,64118795,1.0284222737819024,590,430,1020,+
chr15,64118797,1.0284222737819024,590,430,1020,+
chr15,64118812,3.3059222934741612,625,481,1106,+
chr15,64118813,3.3059222934741612,625,481,1106,+
chr15,64127182,3.8525760715443003,957,658,1615,+
chr15,64131826,2.7667926052477756,584,450,1034,+
chr15,64136353,1.1331442059711891,685,528,1213,+
chr15,64678210,3.3640744388874593,739,489,1228,+
chr15,65554904,4.193232388898558,732,501,1233,+
chr15,65558691,0.3898476368159205,1002,803,1805,+
chr15,65558693,0.46328886738865355,1600,1210,2810,+
chr15,65558694,1.8173026899654192,1141,796,1937,+
chr15,65558696,2.1299019607843137,1737,1247,2984,+
chr15,65558698,2.088719153936545,1184,873,2057,+
chr15,65562787,2.159119822685696,1304,919,2223,+
chr15,65562792,2.7140888208269525,957,652,1609,+
chr15,65562794,2.7140888208269525,957,652,1609,+
chr15,65562810,2.401181525241676,788,587,1375,+
chr15,65562816,1.6630326460694802,1618,1257,2875,+
chr15,65562845,1.084168401305745,1577,1269,2846,+
chr15,65570124,1.7319660537482318,631,403,1034,+
chr15,65570138,0.6844062327850791,808,523,1331,+
chr15,65570166,1.7703962703962703,650,494,1144,+
chr15,65570170,0.5407473352421741,2643,1806,4449,+
chr15,65570171,0.5407473352421741,2643,1806,4449,+
chr15,65570174,0.6039625676268461,1501,976,2477,+
chr15,65576374,2.9599999999999995,665,449,1114,+
chr15,65576571,4.064039408866996,604,405,1009,+
chr15,65576697,2.0934358367829686,707,444,1151,+
chr15,65576759,0.396649591582445,572,465,1037,+
chr15,65576763,0.4092795171633346,619,481,1100,+
chr15,65577530,2.3698959178451102,646,560,1206,+
chr15,65577615,1.7931308634123069,1252,661,1913,+
chr15,65577617,1.7931308634123069,1252,661,1913,+
chr15,65577782,2.7016064257028107,650,497,1147,+
chr15,65577783,2.7016064257028107,650,497,1147,+
chr15,65577962,2.3890763052208834,675,414,1089,+
chr15,65869542,0.7723936591982697,1007,615,1622,+
chr15,65877822,0.5474363658506881,898,713,1611,+
chr15,65879722,1.6056670602125147,1087,846,1933,+
chr15,65887829,2.4197530864197527,657,422,1079,+
chr15,65887838,1.5253097030411307,1282,993,2275,+
chr15,65887859,2.274169921875,689,511,1200,+
chr15,65888353,0.3710245405524376,612,465,1077,+
chr15,65888945,4.330668743740959,868,462,1330,+
chr15,66326190,1.0409387257539884,705,575,1280,+
chr15,66326208,1.3509024612589977,586,450,1036,+
chr15,66435046,2.742986379256153,639,515,1154,+
chr15,66435095,2.1479089790897907,634,541,1175,+
chr15,66435104,3.344980752146876,705,613,1318,+
chr15,66435178,2.3048030249753277,693,454,1147,+
chr15,66443306,1.9110313611843621,1015,732,1747,+
chr15,66490733,1.978700425567191,812,659,1471,+
chr15,66491248,1.6436212633721092,1012,712,1724,+
chr15,66505349,13.613043187510256,1412,1264,2676,+
chr15,66505350,13.613043187510256,1412,1264,2676,+
chr15,66515570,1.2071656898231853,848,521,1369,+
chr15,66549367,2.67549200994812,839,625,1464,+
chr15,67190890,0.699849288120604,565,470,1035,+
chr15,67232507,0.9217713616855248,755,703,1458,+
chr15,67232509,0.9542893028361074,840,815,1655,+
chr15,68187800,1.0322912291536526,764,525,1289,+
chr15,68187819,2.9097744360902253,872,678,1550,+
chr15,68187820,2.6441566001422148,1358,912,2270,+
chr15,68293230,1.0275684779718108,643,388,1031,+
chr15,68293232,2.2991735041664567,608,409,1017,+
chr15,69270366,3.375773809113108,577,465,1042,+
chr15,69270709,2.23373561184633,624,497,1121,+
chr15,69271409,1.5585840809753853,638,402,1040,+
chr15,69426338,1.6678747628614372,650,465,1115,+
chr15,69426414,2.1971787306873316,677,568,1245,+
chr15,69429120,1.4327784159341836,865,616,1481,+
chr15,69436571,4.245242557277297,673,536,1209,+
chr15,69440362,2.665165048543689,797,514,1311,+
chr15,69440363,1.8147097629890567,1277,854,2131,+
chr15,69440402,2.5554650373387644,648,490,1138,+
chr15,69440403,1.8796331197386609,679,378,1057,+
chr15,69452816,0.9571710380300074,4855,3664,8519,+
chr15,69452817,0.7173464959695164,41800,25003,66803,+
chr15,69452818,0.669720703962141,31511,18019,49530,+
chr15,69452819,0.6875097827178911,42427,22759,65186,+
chr15,69452821,0.9417405362949062,32580,12520,45100,+
chr15,69452823,1.7539036664270309,17153,5849,23002,+
chr15,69452828,1.4922826682645876,32257,18072,50329,+
chr15,69453647,1.3607701944622033,25645,16186,41831,+
chr15,69453648,1.4057262403797013,19352,12682,32034,+
chr15,69453649,1.4057262403797013,19352,12682,32034,+
chr15,69453650,0.7215692778988664,5482,4412,9894,+
chr15,69453652,1.2636489820814387,34355,22232,56587,+
chr15,69453653,1.2636489820814387,34355,22232,56587,+
chr15,69453658,1.1139328063200302,29464,20594,50058,+
chr15,69453667,1.066506628887536,23505,15808,39313,+
chr15,69455168,0.5240705316833483,651,391,1042,+
chr15,69455175,1.4380660489427417,4765,2299,7064,+
chr15,69455178,1.2323199600745591,27816,15702,43518,+
chr15,69455179,1.2962257026267436,29806,15501,45307,+
chr15,69455181,1.2207082233207036,18398,9282,27680,+
chr15,69455182,1.405209010551194,34372,18737,53109,+
chr15,69455184,1.3973589781985989,35603,19513,55116,+
chr15,69455185,1.2279342538575453,22570,11882,34452,+
chr15,69455187,1.3226903966930883,23656,13382,37038,+
chr15,69455197,1.4923590823857007,9922,5431,15353,+
chr15,69455203,1.2291576198358756,32754,22348,55102,+
chr15,69455255,1.858374130921731,8416,6822,15238,+
chr15,69455433,1.1745675528490644,73228,53142,126370,+
chr15,69455435,1.2134315449876665,100948,70594,171542,+
chr15,69455436,1.218190098272501,82066,60462,142528,+
chr15,69455439,1.4261626919347232,12933,10020,22953,+
chr15,69455446,1.349598834469952,31633,22928,54561,+
chr15,69455450,1.065276373428638,105473,83372,188845,+
chr15,69455451,1.0652763734286381,105473,83372,188845,+
chr15,69455454,1.1774022743659383,103267,80118,183385,+
chr15,69455455,1.1731169398495713,107637,79793,187430,+
chr15,71660665,2.368477078109476,1124,918,2042,+
chr15,71660666,2.368477078109476,1124,918,2042,+
chr15,71781138,1.129255376634605,773,486,1259,+
chr15,71781139,1.129255376634605,773,486,1259,+
chr15,71781158,1.821331595525144,817,593,1410,+
chr15,71781179,1.8386982526454396,3336,2728,6064,+
chr15,71781180,1.8386982526454396,3336,2728,6064,+
chr15,71781183,2.831033912324235,1336,1208,2544,+
chr15,72555885,0.953034923068289,808,567,1375,+
chr15,72580959,2.8901259559154298,828,467,1295,+
chr15,72580960,2.8901259559154298,828,467,1295,+
chr15,72582165,2.5548329458768415,868,642,1510,+
chr15,72583834,7.490730686048924,871,693,1564,+
chr15,72583835,6.502087494176556,1081,896,1977,+
chr15,72716782,1.3957773295049156,985,714,1699,+
chr15,72716783,0.7204408291786932,623,514,1137,+
chr15,72716784,1.1527409560130073,838,713,1551,+
chr15,72716789,1.2787314422057263,820,735,1555,+
chr15,72716791,1.7027008993099808,1579,1418,2997,+
chr15,72716793,1.6256961942856218,1657,1405,3062,+
chr15,72731635,3.0253370831031576,617,408,1025,+
chr15,73708396,2.5608667941363925,587,522,1109,+
chr15,73708398,2.2688718336756386,925,840,1765,+
chr15,73708400,2.0331542771327906,639,596,1235,+
chr15,73713108,0.4439042498871628,517,485,1002,+
chr15,73713827,0.8620026525198939,618,519,1137,+
chr15,73713828,0.8620026525198939,618,519,1137,+
chr15,74620106,2.602814260717882,767,684,1451,+
chr15,74890579,0.9290951327709371,918,504,1422,+
chr15,74890586,8.844936708860759,558,473,1031,+
chr15,74890587,8.844936708860759,558,473,1031,+
chr15,75336061,0.8130387892726422,659,420,1079,+
chr15,75338110,2.4365478257460045,1071,660,1731,+
chr15,75338389,2.2040856627285415,837,440,1277,+
chr15,75339043,0.3498834753943698,699,451,1150,+
chr15,75914154,1.2617375095456116,904,597,1501,+
chr15,75917326,3.898734177215191,615,394,1009,+
chr15,75932695,2.2186277732704514,815,607,1422,+
chr15,75932740,2.498673561786139,675,458,1133,+
chr15,75932884,1.876440756108806,659,481,1140,+
chr15,75932949,1.7124901806755697,544,468,1012,+
chr15,76932361,1.641904414668976,771,620,1391,+
chr15,76932362,1.8652210612015363,1054,858,1912,+
chr15,76932371,0.3737466195132099,690,436,1126,+
chr15,76932380,1.758945054945055,975,649,1624,+
chr15,76932395,0.6153872574274429,778,646,1424,+
chr15,76932400,1.8680167520974988,2206,1710,3916,+
chr15,76948413,2.037305699481865,982,771,1753,+
chr15,76948425,0.6052354445614563,1340,1155,2495,+
chr15,76948525,2.219735302113731,2216,1497,3713,+
chr15,76949079,0.44593596059113305,1064,724,1788,+
chr15,76949087,1.8150441297436697,1920,1450,3370,+
chr15,76949088,1.8150441297436697,1920,1450,3370,+
chr15,76949219,1.7549627791563274,1721,1301,3022,+
chr15,78155243,1.1854563155757525,682,421,1103,+
chr15,78157562,0.39816933638443935,782,413,1195,+
chr15,78157570,1.8151571164510167,981,540,1521,+
chr15,78157573,1.368429811471224,2792,1656,4448,+
chr15,78157576,1.5814208554870357,5320,3185,8505,+
chr15,78157577,1.3192458102931761,4273,2630,6903,+
chr15,78157578,1.5508211843972046,4659,2902,7561,+
chr15,78157580,1.5782519528110521,3231,2025,5256,+
chr15,78157590,1.6744286271003828,2745,1964,4709,+
chr15,78157592,1.6744286271003828,2745,1964,4709,+
chr15,78157597,2.372734493465232,1549,1258,2807,+
chr15,78157603,1.7211307565438092,2314,1602,3916,+
chr15,78161687,2.5450532724505326,726,437,1163,+
chr15,78165044,2.0777094937802834,603,502,1105,+
chr15,78166240,0.9943621791671559,1500,1207,2707,+
chr15,78166241,1.6429571984435796,753,513,1266,+
chr15,78166243,4.080817610062893,682,529,1211,+
chr15,78166249,1.8680848700288823,908,642,1550,+
chr15,78169464,1.8137474821461268,1298,1015,2313,+
chr15,78169465,1.8137474821461268,1298,1015,2313,+
chr15,78169693,2.8308351177730184,660,466,1126,+
chr15,78540442,0.5592389344114832,1955,1314,3269,+
chr15,78540443,0.5942174490558603,3950,2267,6217,+
chr15,78540444,0.5862274228331426,2377,1100,3477,+
chr15,78540445,0.7798039662639618,621,409,1030,+
chr15,78540448,1.285100061011935,1218,614,1832,+
chr15,78540457,1.2464199397134788,2096,1212,3308,+
chr15,78540492,1.7646053293112114,762,509,1271,+
chr15,78540493,1.5640686922060767,1183,756,1939,+
chr15,78540509,1.59693627698956,2419,1809,4228,+
chr15,78541914,1.943908221149776,976,761,1737,+
chr15,78542181,1.8356344135098128,824,625,1449,+
chr15,78542182,0.6921194159076908,1731,1101,2832,+
chr15,78542194,1.6851886615355736,954,760,1714,+
chr15,78542488,1.5889561910128187,1691,1373,3064,+
chr15,78542494,1.5118917925666984,3315,2275,5590,+
chr15,78544872,1.7223396226000378,3616,2640,6256,+
chr15,78544874,1.9286676923443895,1816,1470,3286,+
chr15,78545751,1.6545745920745922,2769,1759,4528,+
chr15,78548792,1.529832066627224,1244,1021,2265,+
chr15,78872957,5.594540995995714,2088,147,2235,+
chr15,78872958,5.61779469565991,2323,175,2498,+
chr15,78872959,4.859840232389251,955,80,1035,+
chr15,78872962,8.508196254339968,1586,110,1696,+
chr15,78872967,7.099179031908271,1156,116,1272,+
chr15,78872968,5.747405739671548,1548,154,1702,+
chr15,78872969,8.443447377406027,3316,341,3657,+
chr15,78872970,9.698765432098766,1472,134,1606,+
chr15,78872971,6.936434799289298,3539,403,3942,+
chr15,78872972,9.182914443105526,2234,266,2500,+
chr15,78872974,6.964208196466426,1095,140,1235,+
chr15,78872977,19.189867948105345,3570,760,4330,+
chr15,78872978,19.853432237566274,4787,1233,6020,+
chr15,78872979,16.06356425639018,6720,1947,8667,+
chr15,78872980,16.268773387786247,5918,1903,7821,+
chr15,78872981,17.543847829218404,3660,1371,5031,+
chr15,78872982,5.500621118012424,1106,384,1490,+
chr15,78872984,5.055196389143668,3680,1648,5328,+
chr15,78872985,4.2832975525976815,1608,684,2292,+
chr15,78872986,8.755567995946034,5631,3872,9503,+
chr15,78872987,8.1467677498501,5371,3950,9321,+
chr15,78872988,8.290309874047276,4981,3798,8779,+
chr15,78872994,2.201623248416711,1607,1909,3516,+
chr15,78873003,2.133783327963778,3702,5019,8721,+
chr15,78873004,1.935890735997063,2450,3826,6276,+
chr15,78886148,0.43188012698439077,665,517,1182,+
chr15,78891483,0.7737015182436238,1073,789,1862,+
chr15,78891484,0.7623698154974631,1328,1047,2375,+
chr15,78891489,0.7131595273000928,814,503,1317,+
chr15,78891491,0.5844660194174757,773,411,1184,+
chr15,78891492,0.8599488351407539,2429,2133,4562,+
chr15,78891493,1.076845143067665,1402,1436,2838,+
chr15,78891494,0.5029002725557342,1027,697,1724,+
chr15,78891496,0.7541369304368285,1201,621,1822,+
chr15,78891497,0.6321619113894689,990,957,1947,+
chr15,78891499,2.0172802404207366,715,483,1198,+
chr15,78891505,1.3290860083312912,1355,1377,2732,+
chr15,78891509,2.0114653945936896,3343,1706,5049,+
chr15,78891511,2.0114653945936896,3343,1706,5049,+
chr15,78891515,1.5744466256447107,4329,2418,6747,+
chr15,78891516,1.5744466256447107,4329,2418,6747,+
chr15,78891526,1.6828849456210646,2939,1746,4685,+
chr15,78891529,1.5839964121408523,3188,1937,5125,+
chr15,78893610,1.7918367346938773,877,489,1366,+
chr15,78893611,1.794766712092804,1094,649,1743,+
chr15,78894058,2.014589800092962,1448,884,2332,+
chr15,78894059,2.020992208222812,1174,753,1927,+
chr15,78894070,2.3416879795396417,762,574,1336,+
chr15,78894072,0.5167582417582418,626,415,1041,+
chr15,78894075,1.5556768558951966,899,686,1585,+
chr15,78894087,0.6107121119902617,2594,1859,4453,+
chr15,78894089,0.7341851893546384,6740,4595,11335,+
chr15,78894090,0.8064507329469813,5851,4009,9860,+
chr15,78894094,1.0768348823625986,3330,2236,5566,+
chr15,78894097,1.4027116938043822,3099,2366,5465,+
chr15,78894098,1.4060237326949099,4806,3694,8500,+
chr15,78894100,1.4797631593858007,5080,3974,9054,+
chr15,78894101,1.4228077040557483,5223,3756,8979,+
chr15,78894115,1.3875,2774,2224,4998,+
chr15,78894118,1.7205109732000283,3081,2593,5674,+
chr15,78894216,1.9526877063822883,1001,636,1637,+
chr15,78894832,0.6835497116274655,1799,1388,3187,+
chr15,78894833,1.3986172737591578,1505,880,2385,+
chr15,78896987,1.827014619378252,664,390,1054,+
chr15,78896991,0.6367704563274902,1589,1237,2826,+
chr15,78896993,0.8977237278957643,2276,1693,3969,+
chr15,78896994,0.7201847704367301,1364,987,2351,+
chr15,78897003,1.4334577378175497,1072,645,1717,+
chr15,78897008,1.5482810920121337,1224,1031,2255,+
chr15,78897084,0.7399065420560748,1637,1283,2920,+
chr15,78897087,0.7156144286058729,1847,1410,3257,+
chr15,78897098,0.7613590809884961,2292,1726,4018,+
chr15,78897263,1.4073293393618322,3448,2485,5933,+
chr15,78897457,1.8108963409152206,1706,1134,2840,+
chr15,79311143,1.0818447929382802,695,439,1134,+
chr15,79311144,0.5242350451348433,917,600,1517,+
chr15,79311152,1.359597279125152,844,586,1430,+
chr15,79311173,2.2685185185185186,741,476,1217,+
chr15,79311360,1.6203459485984173,1600,958,2558,+
chr15,79311361,1.6203459485984173,1600,958,2558,+
chr15,79311394,3.3904971059397937,1228,1046,2274,+
chr15,79313757,1.8429513089795428,1907,1429,3336,+
chr15,79313769,5.508196721311474,944,609,1553,+
chr15,79313778,2.3338879645036053,788,600,1388,+
chr15,79313831,1.724722177484297,1163,886,2049,+
chr15,79322011,2.016122347480106,1034,753,1787,+
chr15,79322012,0.7587109672505711,1517,1211,2728,+
chr15,79322020,2.1230923966654416,1545,1260,2805,+
chr15,79322025,1.4884135472370768,1168,934,2102,+
chr15,79322083,1.5183789838102026,1397,853,2250,+
chr15,79322098,1.505072716519313,3335,2161,5496,+
chr15,79322100,1.505072716519313,3335,2161,5496,+
chr15,79322231,1.7195121951219514,704,614,1318,+
chr15,79322294,1.9871794871794872,664,545,1209,+
chr15,79322357,1.3147153203014603,1962,1543,3505,+
chr15,79322485,2.12252608852105,1003,793,1796,+
chr15,79322566,1.6290275761973876,1097,688,1785,+
chr15,79322583,2.1853377544438795,2222,1504,3726,+
chr15,79322630,1.4909872082804412,1293,1044,2337,+
chr15,79322745,1.4728935698447891,1041,879,1920,+
chr15,80120351,0.842124542124542,604,454,1058,+
chr15,80120352,0.842124542124542,604,454,1058,+
chr15,80121740,2.0152905198776763,658,544,1202,+
chr15,80122720,2.9790476190476185,781,489,1270,+
chr15,80122721,2.9790476190476185,781,489,1270,+
chr15,80122742,2.773502931348152,903,687,1590,+
chr15,80137484,1.1447790515046752,697,516,1213,+
chr15,80137536,2.2255172413793103,921,579,1500,+
chr15,80137537,2.2255172413793103,921,579,1500,+
chr15,80137606,2.443991021905935,1767,1450,3217,+
chr15,80137607,2.587723928094632,1243,1038,2281,+
chr15,80137787,0.537468982630273,911,619,1530,+
chr15,80137789,1.9743589743589745,615,389,1004,+
chr15,80581238,3.3866943866943866,542,480,1022,+
chr15,80581239,3.3866943866943866,542,480,1022,+
chr15,80581240,3.3866943866943866,542,480,1022,+
chr15,88467961,1.5983562040624206,1089,777,1866,+
chr15,88467963,1.5983562040624206,1089,777,1866,+
chr15,88467980,1.7763634169884166,754,591,1345,+
chr15,88467984,1.9405375552282769,888,775,1663,+
chr15,88467985,1.7346938775510203,679,391,1070,+
chr15,88467988,2.967391304347826,727,511,1238,+
chr15,88468004,0.7841486820344242,1312,1138,2450,+
chr15,88472626,1.4308110367892977,1368,896,2264,+
chr15,88472632,0.7274339116194884,2531,2021,4552,+
chr15,88472633,0.6373517335766423,1926,1279,3205,+
chr15,88472637,1.576774102346621,1570,1178,2748,+
chr15,88472703,2.168734835355286,947,576,1523,+
chr15,88472705,2.168734835355286,947,576,1523,+
chr15,88476998,1.095065710394822,563,466,1029,+
chr15,88478033,2.4632098828144855,1011,697,1708,+
chr15,89244010,2.1126733681697334,638,476,1114,+
chr15,89263942,0.9544149808638599,664,471,1135,+
chr15,89263944,0.9544149808638599,664,471,1135,+
chr15,89285153,3.9127006084088656,677,544,1221,+
chr15,89292729,2.548051919704231,627,510,1137,+
chr15,89293961,0.958041958041958,684,494,1178,+
chr15,89293962,0.958041958041958,684,494,1178,+
chr15,89295050,0.4537578818018103,816,507,1323,+
chr15,89295082,2.145180448203304,885,652,1537,+
chr15,89299800,0.9621212438001809,1639,1009,2648,+
chr15,89299802,1.1614607614607615,1211,701,1912,+
chr15,89299806,1.7153846153846155,1114,919,2033,+
chr15,89299808,1.7025614518722718,1714,1450,3164,+
chr15,89299810,1.8845720883244332,1796,1598,3394,+
chr15,89299812,1.7139361810582119,1867,1730,3597,+
chr15,89299813,1.8853944562899787,1943,1875,3818,+
chr15,89299815,1.9166968717989123,1321,1294,2615,+
chr15,89299818,1.563981013620731,2738,2442,5180,+
chr15,89299819,0.5495920996135679,639,410,1049,+
chr15,89299820,1.6051639770952628,1583,1694,3277,+
chr15,89307511,0.6513852736460717,1006,742,1748,+
chr15,89315309,3.286278938452852,581,482,1063,+
chr15,89315311,3.286278938452852,581,482,1063,+
chr15,89315326,1.6216176777152387,726,737,1463,+
chr15,89315327,1.2709912740343343,1085,1053,2138,+
chr15,89315335,2.644645327364221,788,948,1736,+
chr15,89315336,1.82635342185904,893,889,1782,+
chr15,89315337,1.82635342185904,893,889,1782,+
chr15,90266044,2.4889228418640186,723,615,1338,+
chr15,90266046,2.4889228418640186,723,615,1338,+
chr15,90266153,0.5579237349572278,591,417,1008,+
chr15,90266325,0.8225238481899508,1920,1206,3126,+
chr15,90266326,0.955050505050505,1402,827,2229,+
chr15,90271208,0.4569096209912537,652,489,1141,+
chr15,90271335,1.9230507088331512,854,523,1377,+
chr15,90271458,1.7307426636601126,1331,1008,2339,+
chr15,90271547,2.0884160393301583,876,565,1441,+
chr15,90271548,2.11087420042644,714,468,1182,+
chr15,90271725,1.7233263598326358,658,477,1135,+
chr15,90271925,2.0820860248936506,880,576,1456,+
chr15,90271940,1.5106085526315791,941,607,1548,+
chr15,90388300,1.197976620829372,648,412,1060,+
chr15,90426183,1.203985659874991,713,521,1234,+
chr15,90426251,1.762317643820534,984,864,1848,+
chr15,90426252,1.762317643820534,984,864,1848,+
chr15,90429596,2.0963855421686746,695,414,1109,+
chr15,90429601,1.8912368222891565,704,663,1367,+
chr15,90429605,1.6891508286247263,780,786,1566,+
chr15,90429609,0.7330309901738474,1118,809,1927,+
chr15,90429614,2.090578434823419,905,946,1851,+
chr15,90441596,2.145890203215044,565,470,1035,+
chr15,90441605,1.5887439945092656,642,469,1111,+
chr15,90467537,2.7375797623676403,604,488,1092,+
chr15,90472893,1.0014903129657229,767,487,1254,+
chr15,90472894,1.0014903129657229,767,487,1254,+
chr15,90472931,2.426747902318248,1809,1208,3017,+
chr15,90472932,2.2136562624367504,1255,901,2156,+
chr15,90472935,1.5170162247724577,696,531,1227,+
chr15,90472939,0.9424011711505226,1434,842,2276,+
chr15,90472948,1.6926087887220571,1106,616,1722,+
chr15,90472962,2.107643814026793,1243,704,1947,+
chr15,90472964,0.6473854229759742,2540,1777,4317,+
chr15,90472966,0.9051680310040632,3944,2607,6551,+
chr15,90472975,1.5471941079025826,4927,3274,8201,+
chr15,90472976,0.4454561094715668,1529,778,2307,+
chr15,90472977,1.5108317366345796,5080,3417,8497,+
chr15,90472978,1.3718568247308436,5681,3858,9539,+
chr15,90472981,1.4123923061510717,2168,1126,3294,+
chr15,90472982,1.5609560507519689,2229,1616,3845,+
chr15,90472984,1.6785238369171844,2589,1437,4026,+
chr15,90472991,0.7571949242446913,6338,3859,10197,+
chr15,90477201,1.9136794149382568,693,438,1131,+
chr15,90482035,1.7768379621349348,659,507,1166,+
chr15,90482057,0.5168734866828086,890,707,1597,+
chr15,90482059,0.5168734866828086,890,707,1597,+
chr15,90483378,2.3358507598168945,828,541,1369,+
chr15,90487028,1.8115597783056212,623,420,1043,+
chr15,90487030,1.7142857142857142,599,405,1004,+
chr15,90487059,0.5218949286365017,660,444,1104,+
chr15,90491398,0.5142065142065142,635,443,1078,+
chr15,90491401,1.7511898718669623,1123,872,1995,+
chr15,90491405,2.2130286314683483,673,422,1095,+
chr15,90492602,1.146058386226027,757,594,1351,+
chr15,90492663,0.5306386651323359,650,473,1123,+
chr15,90497311,1.8614958448753458,643,436,1079,+
chr15,90500880,2.7536305302262747,708,422,1130,+
chr15,90501186,2.840080233406273,622,456,1078,+
chr15,90501187,2.840080233406273,622,456,1078,+
chr15,90501405,0.43220925205361016,768,513,1281,+
chr15,90501660,1.4202175046895116,618,399,1017,+
chr15,90530110,2.4083623693379788,863,368,1231,+
chr15,90530111,2.4083623693379788,863,368,1231,+
chr15,90643425,13.499057540778812,662,599,1261,+
chr15,90643732,17.55687428850153,2184,620,2804,+
chr15,90643733,15.410007454481445,2977,1551,4528,+
chr15,90643734,12.640550156331997,3448,2017,5465,+
chr15,90643735,9.335526959305374,2968,2076,5044,+
chr15,90643736,6.61847028086637,1838,1412,3250,+
chr15,90643737,4.419361936193619,663,504,1167,+
chr15,90643739,1.6654841374465248,616,796,1412,+
chr15,90643742,2.996520398435975,562,609,1171,+
chr15,90643769,5.004959969730923,1209,1876,3085,+
chr15,90644182,2.946428571428572,659,447,1106,+
chr15,90644184,2.946428571428572,659,447,1106,+
chr15,90644539,2.2143047597445094,1081,854,1935,+
chr15,90644850,1.0,645,493,1138,+
chr15,90644851,1.0,645,493,1138,+
chr15,90645190,2.9773764407875127,792,559,1351,+
chr15,90919801,3.4399480529012965,599,449,1048,+
chr15,90919803,2.442183657634107,921,758,1679,+
chr15,90961686,0.4265536723163842,1056,825,1881,+
chr15,90961688,0.4265536723163842,1056,825,1881,+
chr15,90961701,1.9344342934167145,1476,937,2413,+
chr15,92286024,1.224074074074074,660,404,1064,+
chr15,92286026,1.174097882357155,790,521,1311,+
chr15,92711813,1.4342443632488342,1596,649,2245,+
chr15,92711815,1.1066505936405402,1314,493,1807,+
chr15,92711816,1.8327439024390244,698,409,1107,+
chr15,92711817,2.0479748964803317,1072,643,1715,+
chr15,92711819,2.3779971791255283,1123,708,1831,+
chr15,92711820,2.323943661971831,769,496,1265,+
chr15,92885524,0.6318310222945335,606,416,1022,+
chr15,92981379,2.4190815641028585,805,531,1336,+
chr15,92981432,1.6069788797061524,599,483,1082,+
chr15,93009218,2.6101971696996666,767,486,1253,+
chr15,93014856,4.17548670139841,845,520,1365,+
chr15,93014858,4.17548670139841,845,520,1365,+
chr15,93014861,2.4286423226696745,638,446,1084,+
chr15,93014864,2.2519995950187304,1533,1161,2694,+
chr15,93014865,2.2519995950187304,1533,1161,2694,+
chr15,93014866,2.2519995950187304,1533,1161,2694,+
chr15,94487302,1.561195003728561,816,595,1411,+
chr15,94487316,1.4922879177377892,1052,777,1829,+
chr15,96337657,0.3315787755175832,597,451,1048,+
chr15,96337850,1.3568277318180033,846,767,1613,+
chr15,96337851,0.8964905203711175,925,924,1849,+
chr15,96337853,0.3936765127616863,645,633,1278,+
chr15,96337885,1.0850028273010857,1285,840,2125,+
chr15,98922172,2.0078280502209673,632,402,1034,+
chr15,98934889,6.056051153239331,894,671,1565,+
chr15,98934890,6.056051153239331,894,671,1565,+
chr15,98934891,6.164094368676405,648,515,1163,+
chr15,98934900,5.382546912931956,548,456,1004,+
chr15,98939200,1.3004596623443214,640,462,1102,+
chr15,98939288,2.3964505510233294,597,410,1007,+
chr15,98939290,2.91061320754717,902,635,1537,+
chr15,98939291,2.903783431180692,613,437,1050,+
chr15,98939319,3.456703910614525,674,536,1210,+
chr15,98939321,3.456703910614525,674,536,1210,+
chr15,98957089,2.194802420605221,670,579,1249,+
chr15,99133771,1.8363740959894803,1089,675,1764,+
chr15,99133772,1.8363740959894803,1089,675,1764,+
chr15,99259674,2.9289537985190157,685,491,1176,+
chr15,99259692,0.48986005875006194,1232,1042,2274,+
chr15,99259704,1.799599644128114,782,561,1343,+
chr15,99259712,0.5115224471286639,2067,1718,3785,+
chr15,99259713,0.5115224471286639,2067,1718,3785,+
chr15,99259714,0.5115224471286639,2067,1718,3785,+
chr16,85451,8.102865344510427,556,447,1003,+
chr16,85562,3.02141536622614,632,484,1116,+
chr16,263719,1.3006735763148898,876,691,1567,+
chr16,399638,2.897419341206464,909,695,1604,+
chr16,400400,3.0628569795794727,646,491,1137,+
chr16,400407,3.2723037604049914,883,643,1526,+
chr16,400481,2.1835848391676786,732,494,1226,+
chr16,681496,3.5576416872073313,650,365,1015,+
chr16,682026,2.5941477107056263,611,440,1051,+
chr16,682179,0.4559585492227979,725,578,1303,+
chr16,682180,0.4559585492227979,725,578,1303,+
chr16,682198,1.427750319119614,1641,990,2631,+
chr16,682200,1.427750319119614,1641,990,2631,+
chr16,682442,2.3107282066983115,605,453,1058,+
chr16,682557,3.276191762607803,921,571,1492,+
chr16,682697,22.925002988024097,1922,954,2876,+
chr16,682698,24.0229293318565,3215,1583,4798,+
chr16,682700,12.828090553586701,1091,579,1670,+
chr16,767393,0.499434644957033,630,535,1165,+
chr16,1314330,0.3343576052883817,635,434,1069,+
chr16,1320175,0.7655776597303307,1054,962,2016,+
chr16,1320176,0.9417301658449123,572,581,1153,+
chr16,1320456,2.6361185983827493,651,476,1127,+
chr16,1320457,2.6361185983827493,651,476,1127,+
chr16,1320473,1.4444246863828898,2815,2232,5047,+
chr16,1320474,1.6575945587312024,1561,1360,2921,+
chr16,1324776,1.9402749715938004,863,649,1512,+
chr16,1324912,287.07909604519773,832,353,1185,+
chr16,1324913,162.36523444847344,2934,1558,4492,+
chr16,1324914,162.36523444847344,2934,1558,4492,+
chr16,1324957,0.32859633366791696,621,822,1443,+
chr16,1324958,0.45304153497181987,1162,1436,2598,+
chr16,1502049,2.128507409182165,672,418,1090,+
chr16,1685571,2.20717981001635,554,457,1011,+
chr16,1698993,2.6167158709151987,611,516,1127,+
chr16,1698995,2.4226169064748198,1252,1111,2363,+
chr16,1698996,2.518788280086078,950,862,1812,+
chr16,1698997,2.518788280086078,950,862,1812,+
chr16,1699287,13.215720746378214,958,1143,2101,+
chr16,1699288,11.290955605705886,1059,1297,2356,+
chr16,1699395,0.3782058730369561,582,480,1062,+
chr16,1699459,2.0454061758642723,634,555,1189,+
chr16,1699722,1.9512081730094335,566,493,1059,+
chr16,1699829,1.0258064516129033,688,519,1207,+
chr16,1699830,0.8384948783010544,1036,816,1852,+
chr16,1700159,0.463464352764944,740,569,1309,+
chr16,1701187,0.9946044047677439,750,550,1300,+
chr16,1701188,0.9946044047677439,750,550,1300,+
chr16,1827752,1.3382539442136367,815,515,1330,+
chr16,1827794,1.2004668998071606,1065,646,1711,+
chr16,1959705,3.687529861442905,680,482,1162,+
chr16,1959715,2.5606295851674004,584,487,1071,+
chr16,1961152,1.9699174721498542,961,562,1523,+
chr16,1961221,3.6434977578475336,584,445,1029,+
chr16,1961223,3.6434977578475336,584,445,1029,+
chr16,1975883,3.989590632584875,596,446,1042,+
chr16,2050403,2.3697985460634405,594,448,1042,+
chr16,2172207,2.241249706365985,657,472,1129,+
chr16,2172209,0.1622520353170508,848,512,1360,+
chr16,2172210,1.7988282454517421,1822,1080,2902,+
chr16,2172212,1.575663036242504,5396,3521,8917,+
chr16,2172213,0.9968172318338494,4509,2691,7200,+
chr16,2172214,1.5806042383441339,4507,3000,7507,+
chr16,2173285,1.17557618058938,815,539,1354,+
chr16,2173306,3.056490997886144,952,806,1758,+
chr16,2173308,3.056490997886144,952,806,1758,+
chr16,2173321,1.6651323461504939,1204,919,2123,+
chr16,2173802,3.5625241425087695,666,449,1115,+
chr16,2177537,6.781600500872262,831,530,1361,+
chr16,2177796,2.0695842225177588,694,498,1192,+
chr16,2206612,2.010884966937975,631,400,1031,+
chr16,2208596,0.4707692307692308,773,558,1331,+
chr16,2208597,0.5857220570011061,1414,902,2316,+
chr16,2234988,0.35567567567567565,563,443,1006,+
chr16,2234990,0.35567567567567565,563,443,1006,+
chr16,2235458,1.359653047135839,848,649,1497,+
chr16,2519249,1.6244364449725648,1119,922,2041,+
chr16,2519250,1.6244364449725648,1119,922,2041,+
chr16,2519739,2.2387991195451056,635,572,1207,+
chr16,2756537,3.100591227213151,872,469,1341,+
chr16,2756549,3.651811513669705,1216,817,2033,+
chr16,2756550,3.651811513669705,1216,817,2033,+
chr16,2758469,1.4167572856556998,554,461,1015,+
chr16,2758485,1.409594190088757,1439,1188,2627,+
chr16,2758488,2.1703209648025115,1739,1486,3225,+
chr16,2758490,1.9033496683200861,1340,1153,2493,+
chr16,2758990,1.8552729131635917,1621,1313,2934,+
chr16,2758992,1.8552729131635917,1621,1313,2934,+
chr16,2759704,6.345630814315971,587,536,1123,+
chr16,2759705,5.739309413923134,724,632,1356,+
chr16,2764576,4.305555555555555,774,395,1169,+
chr16,2764578,4.305555555555555,774,395,1169,+
chr16,2764728,8.39790017647147,691,504,1195,+
chr16,2766773,3.297764877383526,605,412,1017,+
chr16,2767149,1.5516462422187736,567,499,1066,+
chr16,2767662,0.9699573695240391,600,423,1023,+
chr16,2771123,11.373734646856033,565,513,1078,+
chr16,2771126,4.361388849144654,574,985,1559,+
chr16,2771128,1.183921302578019,276,736,1012,+
chr16,2817257,2.1524735411563887,717,512,1229,+
chr16,2817894,1.7517278262300475,1105,823,1928,+
chr16,2817895,1.7517278262300475,1105,823,1928,+
chr16,2817906,0.623885918003565,699,458,1157,+
chr16,2817936,2.5479082321187585,589,493,1082,+
chr16,2818678,0.48588942047972083,852,786,1638,+
chr16,2818688,1.5140014626229,1688,1338,3026,+
chr16,2818762,1.7608556682691994,2173,1890,4063,+
chr16,2818873,2.794177897574124,1363,1112,2475,+
chr16,2820955,2.6981103552532124,775,440,1215,+
chr16,2820962,2.9629205767910283,862,513,1375,+
chr16,2820965,1.6527652664868901,1529,1205,2734,+
chr16,2820999,1.4565859030837005,1406,907,2313,+
chr16,2821001,1.4564069601946652,1243,946,2189,+
chr16,2821004,1.496365838885524,1295,1015,2310,+
chr16,2821016,1.5192872329654754,1475,1161,2636,+
chr16,2821031,0.611055077266669,1577,1206,2783,+
chr16,2821369,0.9899098661323708,2931,2026,4957,+
chr16,2821396,1.4256673316234445,1607,956,2563,+
chr16,2821489,1.682323651452282,723,481,1204,+
chr16,2821640,2.4186704384724185,569,504,1073,+
chr16,2896561,2.7266031601828398,651,540,1191,+
chr16,2899104,2.4007655502392344,895,474,1369,+
chr16,2899105,2.463640831945364,1187,683,1870,+
chr16,2899179,2.7189595296969995,918,718,1636,+
chr16,3021259,2.2302025782688766,691,361,1052,+
chr16,3021261,1.4288801495021048,1462,1005,2467,+
chr16,3021619,0.43461791831357055,608,505,1113,+
chr16,3021646,2.0809847198641758,720,588,1308,+
chr16,3021815,2.2953878085141532,1020,693,1713,+
chr16,3021870,1.9392094861660079,662,549,1211,+
chr16,3021950,2.3387658037686845,655,406,1061,+
chr16,3021986,2.970452337872981,2299,1518,3817,+
chr16,3021987,2.7425883641675175,2500,1714,4214,+
chr16,3022026,1.3860407276647484,1738,1465,3203,+
chr16,3022028,1.990507484483388,939,829,1768,+
chr16,3022123,2.8227215980024964,645,533,1178,+
chr16,3022154,5.253922130825702,1395,1172,2567,+
chr16,3022155,4.229082847900574,1435,1149,2584,+
chr16,3022156,4.142401392111369,620,430,1050,+
chr16,3022192,0.6237396426075671,780,566,1346,+
chr16,3022274,0.7851899323389913,3019,2057,5076,+
chr16,3519931,1.7860308918699797,1308,748,2056,+
chr16,3519932,1.6488634675382556,905,507,1412,+
chr16,3519933,1.8728266269249882,753,548,1301,+
chr16,3519934,3.1659475524475527,646,394,1040,+
chr16,3519945,1.5515904440867003,1521,1097,2618,+
chr16,4434387,0.3861062408188409,678,448,1126,+
chr16,4434388,0.3861062408188409,678,448,1126,+
chr16,4434389,0.722250523575027,637,452,1089,+
chr16,4434391,1.5764744778472957,1027,780,1807,+
chr16,4434433,0.49741887905604726,851,677,1528,+
chr16,4437436,2.756334752511815,834,586,1420,+
chr16,4441506,1.7920189554800952,1030,763,1793,+
chr16,4441507,2.432369478785865,1118,731,1849,+
chr16,4456086,0.9797818689677955,662,480,1142,+
chr16,4870901,1.2450401013085692,693,411,1104,+
chr16,4870902,0.8085288808664259,942,553,1495,+
chr16,4870903,0.8085288808664259,942,553,1495,+
chr16,4870904,1.3943879124267655,713,422,1135,+
chr16,4870927,2.2061342912406743,997,538,1535,+
chr16,4870928,2.2721221448002726,2340,1447,3787,+
chr16,4870929,2.3369867504938857,1908,1115,3023,+
chr16,8804782,3.4647630724010665,631,412,1043,+
chr16,9118744,0.3446401983223711,603,461,1064,+
chr16,14644277,2.681349397590361,842,414,1256,+
chr16,14644278,3.0968985394062796,1081,584,1665,+
chr16,14644311,2.1275440976933515,783,468,1251,+
chr16,14644312,2.1275440976933515,783,468,1251,+
chr16,14644522,2.090091614833584,562,453,1015,+
chr16,14668319,1.7941872574079334,823,502,1325,+
chr16,14857609,2.4063268892794376,651,568,1219,+
chr16,14857611,1.732501383706699,986,844,1830,+
chr16,14878756,0.5988406763756775,1585,1024,2609,+
chr16,14878758,1.3029243119266056,1465,871,2336,+
chr16,14878759,2.078096977169724,1866,1203,3069,+
chr16,14878760,2.011806375442739,1135,692,1827,+
chr16,14878761,2.175611413043478,731,511,1242,+
chr16,14998352,2.4777881857034125,840,552,1392,+
chr16,14998354,1.8758877164802374,846,577,1423,+
chr16,14998359,0.20987654320987653,628,404,1032,+
chr16,14998361,0.20987654320987653,628,404,1032,+
chr16,15006564,0.373213545981773,960,567,1527,+
chr16,15006565,0.373213545981773,960,567,1527,+
chr16,15006566,0.7431387216002966,1530,1000,2530,+
chr16,15008807,1.7080335777608817,915,590,1505,+
chr16,15008816,0.5183450429352069,663,365,1028,+
chr16,15030021,0.8066124704520374,585,433,1018,+
chr16,15030022,1.4434391050506095,654,457,1111,+
chr16,15031738,2.2506472898530827,690,521,1211,+
chr16,15031827,1.9085230980067533,981,724,1705,+
chr16,15032882,2.3218698238643323,725,565,1290,+
chr16,15036025,2.5436387085984777,963,742,1705,+
chr16,15036249,2.499357532926437,818,565,1383,+
chr16,15036250,2.4717666021530476,1055,780,1835,+
chr16,15036365,1.7523644251626898,747,460,1207,+
chr16,15036731,2.5343369960243476,791,587,1378,+
chr16,15036831,1.5033679402890345,698,455,1153,+
chr16,15036890,8.144672005778919,587,417,1004,+
chr16,15037109,2.384808053729297,781,506,1287,+
chr16,15037239,2.8828660425820827,1074,793,1867,+
chr16,15037497,2.033896520590559,1151,752,1903,+
chr16,19121146,7.608343489248612,830,544,1374,+
chr16,19121147,5.959313413858869,653,428,1081,+
chr16,20915574,2.2201821023006514,754,483,1237,+
chr16,21612709,1.420001772458853,683,559,1242,+
chr16,21617980,2.836049608512546,750,513,1263,+
chr16,21953347,1.4905219044479494,1815,1044,2859,+
chr16,21953348,1.2420795892169447,1436,614,2050,+
chr16,21953350,1.071113863576042,1025,444,1469,+
chr16,21953357,2.3410903102790783,1213,640,1853,+
chr16,21953359,2.3410903102790783,1213,640,1853,+
chr16,21953367,0.8479471057729535,1927,1294,3221,+
chr16,21953370,0.6379142300194932,1077,683,1760,+
chr16,21953374,1.2906337918530901,4691,3447,8138,+
chr16,21953381,0.6522750609677833,1729,1271,3000,+
chr16,21953417,1.4720531267293857,2127,1389,3516,+
chr16,21957237,1.4482556702104128,1612,1146,2758,+
chr16,21957423,2.157391304347826,826,599,1425,+
chr16,21957430,1.997727272727273,878,692,1570,+
chr16,21957554,1.5329018338727076,1217,926,2143,+
chr16,21962760,2.0461150474360514,1216,756,1972,+
chr16,21962774,1.9961320055962468,1077,837,1914,+
chr16,21962802,1.033630820631373,3807,2730,6537,+
chr16,21962803,1.033630820631373,3807,2730,6537,+
chr16,21962870,1.827856025039124,1679,1064,2743,+
chr16,21962871,1.603970223325062,1211,929,2140,+
chr16,21971589,1.5140387055837563,908,787,1695,+
chr16,21971923,1.5509564643799472,835,757,1592,+
chr16,21971924,1.7042518553223627,2153,1677,3830,+
chr16,21972104,1.4746815286624204,1322,784,2106,+
chr16,21973904,1.495118898623279,1085,798,1883,+
chr16,21973906,1.7050618672665916,1429,888,2317,+
chr16,21973921,1.3869760479041915,1852,1335,3187,+
chr16,21980569,2.7335942203491874,1008,754,1762,+
chr16,22302960,0.17164451561627392,1307,686,1993,+
chr16,22302961,0.17164451561627392,1307,686,1993,+
chr16,23562662,3.2270120162627154,604,476,1080,+
chr16,23572070,1.1335941178879265,728,478,1206,+
chr16,23572071,0.8962874464790879,803,554,1357,+
chr16,23573522,2.18511070501652,686,488,1174,+
chr16,23668250,4.0621565396291865,808,607,1415,+
chr16,23679218,0.996470588235294,846,499,1345,+
chr16,23679220,1.4730723993896968,1051,657,1708,+
chr16,23679231,2.7574502474997478,852,520,1372,+
chr16,23679233,2.7574502474997478,852,520,1372,+
chr16,23680099,1.2758679373723625,764,564,1328,+
chr16,23680101,1.5840451022613564,1128,787,1915,+
chr16,23680181,0.4302283247516514,751,492,1243,+
chr16,23680186,2.05363091272485,1232,1184,2416,+
chr16,23680187,1.401575816375435,2394,1994,4388,+
chr16,23681009,0.37526822605867827,1020,681,1701,+
chr16,23682063,2.8385051462532394,921,725,1646,+
chr16,23682065,2.2884141218272376,1021,754,1775,+
chr16,23682071,1.232684800343842,924,578,1502,+
chr16,23682081,2.565047021943573,1090,637,1727,+
chr16,23682083,2.565047021943573,1090,637,1727,+
chr16,23688667,1.6562564631380052,646,451,1097,+
chr16,23689341,2.1141863129110927,1045,888,1933,+
chr16,23689351,2.716143497757848,672,445,1117,+
chr16,28723224,2.241499719953614,1359,547,1906,+
chr16,28826335,2.51104987004221,709,500,1209,+
chr16,28826946,6.431353312665098,1381,954,2335,+
chr16,28826966,1.083226266952177,541,466,1007,+
chr16,28826967,1.083226266952177,541,466,1007,+
chr16,28829404,4.1360965783139285,738,483,1221,+
chr16,28829406,4.921231207920655,657,416,1073,+
chr16,28829422,1.2575426503931375,701,497,1198,+
chr16,28830625,1.1526231130908189,600,448,1048,+
chr16,28832495,0.4697882910222225,692,467,1159,+
chr16,28832867,2.2694726448758944,734,593,1327,+
chr16,28836968,3.8857888056063716,1609,1241,2850,+
chr16,28836969,3.7398213674048466,1559,1146,2705,+
chr16,28836970,4.034922749358519,782,627,1409,+
chr16,28836989,0.3984903022233498,633,493,1126,+
chr16,29679179,1.6409127091650662,570,505,1075,+
chr16,29679194,1.2365935277708116,662,527,1189,+
chr16,29694805,2.9604922279792745,652,385,1037,+
chr16,29694834,3.3643410852713185,619,515,1134,+
chr16,29694837,1.8173521934684833,819,528,1347,+
chr16,29694846,1.1988575931962484,1355,1151,2506,+
chr16,29694963,4.936765033791985,839,682,1521,+
chr16,29695094,1.0822062902648533,726,484,1210,+
chr16,29697078,2.59169728417177,823,604,1427,+
chr16,29697225,2.253650473804827,894,615,1509,+
chr16,29697267,2.044193216855087,701,555,1256,+
chr16,29697354,2.4078260869565216,922,549,1471,+
chr16,29697370,1.8432835820895523,1000,736,1736,+
chr16,29697483,1.3683559950556243,1025,808,1833,+
chr16,29697593,0.6685689413357837,1023,712,1735,+
chr16,29697965,4.138248348472337,624,414,1038,+
chr16,29698040,6.002674676469316,785,524,1309,+
chr16,29698053,25.481601665080177,645,802,1447,+
chr16,29790803,0.9991474850809887,585,458,1043,+
chr16,29790804,0.8364776831785344,1249,911,2160,+
chr16,29790805,0.9308605527902708,1169,630,1799,+
chr16,29790806,0.8672369364012016,963,693,1656,+
chr16,29790807,1.091974431818182,983,511,1494,+
chr16,29790810,1.5831360120457056,1515,848,2363,+
chr16,29790812,1.6204742206985274,2036,1370,3406,+
chr16,29798410,0.40655775308874886,976,800,1776,+
chr16,29798415,1.7353502576827637,835,675,1510,+
chr16,29798417,1.3105100895845014,1486,1266,2752,+
chr16,29798447,2.6856090502499343,637,542,1179,+
chr16,29799936,1.395836886931278,641,477,1118,+
chr16,29803541,1.6506203055256514,1141,783,1924,+
chr16,29803543,0.3902882811167339,623,408,1031,+
chr16,29803575,0.6982683780630105,821,856,1677,+
chr16,29803576,0.6474643061947684,1438,1446,2884,+
chr16,29803577,1.8710261841309188,985,672,1657,+
chr16,29803578,0.6140286726020739,1442,1315,2757,+
chr16,29803597,2.7211729622266403,656,502,1158,+
chr16,29807336,0.43307895047555195,1151,793,1944,+
chr16,29807337,0.4836843323304792,879,595,1474,+
chr16,29807377,1.2084505159631214,700,548,1248,+
chr16,29807600,2.3608476873844,1331,1031,2362,+
chr16,29807601,2.3608476873844,1331,1031,2362,+
chr16,29807628,0.3942530323875209,513,565,1078,+
chr16,29807770,3.006041136913093,759,447,1206,+
chr16,29807785,2.2386363636363638,590,439,1029,+
chr16,29807787,2.2386363636363638,590,439,1029,+
chr16,29808616,1.2519692040807653,1080,729,1809,+
chr16,29808657,1.7351945269850042,809,498,1307,+
chr16,29808689,1.2100764453787398,1256,793,2049,+
chr16,29810201,3.2512720156555766,638,364,1002,+
chr16,29810203,3.2543703842198743,966,562,1528,+
chr16,29810204,3.4496780085594527,809,546,1355,+
chr16,29810259,2.3680331352812978,718,553,1271,+
chr16,29810696,4.239742715773243,989,455,1444,+
chr16,29810703,4.265289917231181,2419,1281,3700,+
chr16,29810704,8.140253958317933,3315,2109,5424,+
chr16,29810705,7.480269356966871,2815,1699,4514,+
chr16,29810706,8.732852667811116,2467,1703,4170,+
chr16,29810721,0.290972061053353,580,524,1104,+
chr16,29810728,3.7360295120268625,529,504,1033,+
chr16,29810752,2.6789076518406034,2148,1849,3997,+
chr16,29810753,2.559094146239109,2418,2153,4571,+
chr16,29810778,2.270171149144254,618,408,1026,+
chr16,29810805,7.941881854133385,5950,5722,11672,+
chr16,29810806,7.941881854133385,5950,5722,11672,+
chr16,29810807,7.941881854133386,5950,5722,11672,+
chr16,29810813,1.6367149758454105,461,620,1081,+
chr16,29810814,0.5847768781773678,605,903,1508,+
chr16,29810817,1.8827433628318584,758,677,1435,+
chr16,29810818,0.4475350907223553,746,1015,1761,+
chr16,29810966,8.912242746234734,2005,1773,3778,+
chr16,29810967,12.664913847855239,1031,1044,2075,+
chr16,29810968,10.157696341194079,1356,1205,2561,+
chr16,29810994,0.3192219679633867,464,574,1038,+
chr16,29810995,0.3192219679633867,464,574,1038,+
chr16,29972952,0.5673274473874174,600,413,1013,+
chr16,29972953,0.9667954696003659,826,611,1437,+
chr16,29972956,0.5778894472361811,804,596,1400,+
chr16,30064183,0.672183702364173,617,385,1002,+
chr16,30064429,1.742693360230155,2609,1647,4256,+
chr16,30064431,1.776250641649983,3226,2036,5262,+
chr16,30064434,1.202087924834706,1523,1164,2687,+
chr16,30064436,1.2817827388239929,2278,1692,3970,+
chr16,30064441,1.8992550242550248,876,623,1499,+
chr16,30064451,2.232147905241137,986,768,1754,+
chr16,30065809,2.830641606546941,951,680,1631,+
chr16,30065859,2.065366843232278,538,466,1004,+
chr16,30067235,1.4823904981572875,4628,3272,7900,+
chr16,30067241,1.757666304479054,1838,1505,3343,+
chr16,30067353,0.6498176718092566,890,774,1664,+
chr16,30067451,0.5357377049180329,687,609,1296,+
chr16,30067485,1.30125110605389,4182,3003,7185,+
chr16,30067578,1.642004379345182,3349,2313,5662,+
chr16,30067593,1.6842380325430408,1763,1362,3125,+
chr16,30067623,1.2868866570133177,2951,2270,5221,+
chr16,30068675,1.3906182769321611,8196,6619,14815,+
chr16,30068677,1.3906182769321611,8196,6619,14815,+
chr16,30068833,1.5462680237489397,2526,1833,4359,+
chr16,30068847,0.7272107982463206,2723,2020,4743,+
chr16,30068850,1.2788558741382772,13051,8789,21840,+
chr16,30068852,1.4070274416888386,6661,4680,11341,+
chr16,30068895,1.3162169036354487,4597,3141,7738,+
chr16,30068963,1.6450892857142858,2210,1727,3937,+
chr16,30069332,1.366664514416489,2473,1436,3909,+
chr16,30069333,1.8282570422535211,1977,1599,3576,+
chr16,30069372,1.3351766513056835,2172,1749,3921,+
chr16,30069514,1.3131109216425096,2230,1764,3994,+
chr16,30069541,1.3269244830728522,4332,3801,8133,+
chr16,30069829,1.6672552220191181,2224,1793,4017,+
chr16,30069887,1.5430796529968456,1422,1267,2689,+
chr16,30069978,1.697484841268387,2105,1381,3486,+
chr16,30069979,1.5858178887993553,1727,1313,3040,+
chr16,30069985,1.2154107755372185,4795,3896,8691,+
chr16,30070009,1.4888888888888892,2076,1673,3749,+
chr16,30070136,1.5512458279633854,1822,1440,3262,+
chr16,30070141,1.5891664791057094,2491,1480,3971,+
chr16,30070266,1.915193341604632,2554,1983,4537,+
chr16,30070267,1.8487489688153136,3704,2958,6662,+
chr16,30070315,0.5043478260869565,1072,850,1922,+
chr16,30070361,1.4546116529311313,3599,2583,6182,+
chr16,30070374,0.7226181913293664,1541,1118,2659,+
chr16,30076356,0.828756050896813,1071,544,1615,+
chr16,30076358,1.0246971595655805,784,398,1182,+
chr16,30076375,5.261753130590339,726,392,1118,+
chr16,30076383,1.888507326007326,1016,701,1717,+
chr16,30076384,1.8989712657855413,1767,1084,2851,+
chr16,30076386,1.914814814814815,751,383,1134,+
chr16,30076397,0.4694192222031866,684,448,1132,+
chr16,30076405,0.6414185433334153,1131,698,1829,+
chr16,30076414,0.5760089130973013,1033,576,1609,+
chr16,30076425,1.7166666666666668,1132,659,1791,+
chr16,30076441,1.5876906318082789,1854,944,2798,+
chr16,30082503,1.9397905759162304,740,381,1121,+
chr16,30082504,1.9397905759162304,740,381,1121,+
chr16,30082519,1.20147418667457,750,552,1302,+
chr16,30083486,0.9304347826086956,748,574,1322,+
chr16,30083487,1.354628509782304,1177,845,2022,+
chr16,30084704,0.8569711538461539,650,447,1097,+
chr16,30084705,0.8569711538461539,650,447,1097,+
chr16,30084764,1.0382139338482086,1052,813,1865,+
chr16,31117807,1.9520673544634248,1643,837,2480,+
chr16,31117808,2.2891788014940726,880,376,1256,+
chr16,31117809,2.2891788014940726,880,376,1256,+
chr16,31127321,2.42091285168649,648,497,1145,+
chr16,31127324,0.9813499999999998,1032,799,1831,+
chr16,31127325,0.8310749974351406,1528,1152,2680,+
chr16,31127333,3.2095606800201986,680,456,1136,+
chr16,31127341,1.073554678206947,1580,1192,2772,+
chr16,31162030,1.8280743220775175,1162,1066,2228,+
chr16,31180195,2.9569797369639033,584,465,1049,+
chr16,31182556,1.9485514485514484,663,615,1278,+
chr16,31182637,1.7855971896955505,662,426,1088,+
chr16,31182645,2.0887489264242767,575,498,1073,+
chr16,31183877,2.6875901875901875,595,461,1056,+
chr16,31183965,0.5062062270300256,729,626,1355,+
chr16,31184300,0.2374645222327341,752,603,1355,+
chr16,31184937,2.83204057257503,1187,3247,4434,+
chr16,31184938,4.038542265376568,2196,4542,6738,+
chr16,31184939,3.302370608188844,2764,5614,8378,+
chr16,31184940,1.9218597744884232,707,936,1643,+
chr16,31184941,1.3232064079502315,1466,2600,4066,+
chr16,31184944,0.3754783328162168,694,1440,2134,+
chr16,31184950,0.48704825664945406,1565,3131,4696,+
chr16,31184951,0.4898176583916946,1948,3590,5538,+
chr16,31185101,3.931241725284999,1366,949,2315,+
chr16,31185102,4.907118835644983,1591,1225,2816,+
chr16,31185103,4.339520156341768,1856,1489,3345,+
chr16,31185104,4.009526351315415,2482,2135,4617,+
chr16,31185105,4.807594617908986,2506,2498,5004,+
chr16,31185106,3.96251286384405,3379,3896,7275,+
chr16,31185107,3.0929606903432245,3106,4003,7109,+
chr16,31185108,2.7560033517529257,2425,3321,5746,+
chr16,31185109,2.9628190899001114,911,1695,2606,+
chr16,31185130,0.34513860576377786,1034,1351,2385,+
chr16,31185131,0.3138117283950617,580,647,1227,+
chr16,31186804,2.972852253829815,1729,1619,3348,+
chr16,31189122,0.5716010868471371,1135,1045,2180,+
chr16,31189125,0.4579081632653062,717,587,1304,+
chr16,31189127,0.584898122253296,2927,2502,5429,+
chr16,31189129,0.5779378575038573,3735,3094,6829,+
chr16,31189152,1.3612816159505463,1179,987,2166,+
chr16,31189158,1.8785999113867966,1271,1097,2368,+
chr16,31189670,1.4658436457071975,1055,690,1745,+
chr16,31190323,11.938293049589385,1075,663,1738,+
chr16,31190329,1.8511316949011816,674,512,1186,+
chr16,31190332,3.071636830458894,1439,1124,2563,+
chr16,31190359,3.2931938979501227,1402,1508,2910,+
chr16,31190362,5.174724808383425,1490,1790,3280,+
chr16,31190751,0.11003093239063191,497,729,1226,+
chr16,31190752,0.410095953274927,982,939,1921,+
chr16,31190754,0.410095953274927,982,939,1921,+
chr16,31190755,0.22827868852459016,556,731,1287,+
chr16,31190977,3.971022160727994,1102,905,2007,+
chr16,31191063,10.464446760498918,1343,424,1767,+
chr16,31191064,12.070561091859517,1892,654,2546,+
chr16,31191065,11.719134779733873,2067,699,2766,+
chr16,31191066,5.133333333333334,832,209,1041,+
chr16,31191068,4.998223404788501,1051,412,1463,+
chr16,31191071,8.252721887957431,2790,4533,7323,+
chr16,31191072,8.252721887957431,2790,4533,7323,+
chr16,31191073,6.37814567708803,3146,5714,8860,+
chr16,31191075,2.2439214023183487,1059,3536,4595,+
chr16,31191077,0.3348434700716177,1229,3586,4815,+
chr16,31191081,0.8256038804036859,1168,3123,4291,+
chr16,31191083,1.1759207416667898,1973,5587,7560,+
chr16,31191085,1.001428385923906,963,2868,3831,+
chr16,31191096,0.39493154502773387,1644,3647,5291,+
chr16,31191412,0.28802961744138217,388,934,1322,+
chr16,31191430,0.4577869406516155,1160,1137,2297,+
chr16,31191431,0.7353513717689383,2047,1933,3980,+
chr16,31191432,0.7789092040396306,1384,1228,2612,+
chr16,31191434,0.9609772650152696,943,841,1784,+
chr16,31191436,0.6642377756471716,865,744,1609,+
chr16,31191460,2.3040488922841864,1130,1070,2200,+
chr16,31191462,2.3040488922841864,1130,1070,2200,+
chr16,31191477,1.6001749781277341,1053,1142,2195,+
chr16,46697509,1.23157111985237,629,427,1056,+
chr16,46929272,0.7539723602010443,1032,533,1565,+
chr16,47689121,2.7450726079172467,852,519,1371,+
chr16,47689122,2.692648208273208,1123,713,1836,+
chr16,47689124,2.0310070257611237,656,426,1082,+
chr16,47696429,2.5291375291375293,588,428,1016,+
chr16,47696430,2.5291375291375293,588,428,1016,+
chr16,51646440,2.8946757466905706,1701,841,2542,+
chr16,51646441,2.214683050714528,1254,549,1803,+
chr16,51646442,2.6860382326804766,2625,1206,3831,+
chr16,51646451,6.425418091677112,6785,8244,15029,+
chr16,51646452,4.316427426497995,8976,11918,20894,+
chr16,51646453,4.0758817787792,9581,12802,22383,+
chr16,51646454,3.623201937750724,7422,11489,18911,+
chr16,51646455,1.2892024979222303,2349,3498,5847,+
chr16,51646456,0.35152884454269795,1831,2661,4492,+
chr16,51646457,0.3334420508471812,888,1156,2044,+
chr16,51646459,0.46866763920839083,4210,5702,9912,+
chr16,51646460,0.5086501422116547,4455,6351,10806,+
chr16,51646473,0.6034286407693858,6369,8071,14440,+
chr16,51646474,0.5623978201634877,687,733,1420,+
chr16,51646475,0.5745889541556974,9652,11623,21275,+
chr16,51646476,0.5744815243709863,5456,5496,10952,+
chr16,51646477,0.5916610967107865,10548,12231,22779,+
chr16,51646478,0.5891033292188022,9278,10567,19845,+
chr16,51646682,1.316818827396505,606,471,1077,+
chr16,51646683,1.1327411327411328,619,428,1047,+
chr16,51646684,1.1327411327411328,619,428,1047,+
chr16,51646691,0.5969672785315243,611,536,1147,+
chr16,51646693,1.6342701014832162,710,426,1136,+
chr16,51646696,1.6418202920002694,1790,1423,3213,+
chr16,51646697,1.5178933843619353,2918,2102,5020,+
chr16,52655741,2.196163395779973,2105,835,2940,+
chr16,52655742,2.201846004372116,1553,536,2089,+
chr16,52655744,1.8789586094482207,905,527,1432,+
chr16,52655745,1.696051408706614,1219,526,1745,+
chr16,52655746,2.2103475415268634,1159,618,1777,+
chr16,52655747,2.335727477939668,812,442,1254,+
chr16,52655753,1.5308011490584104,2397,963,3360,+
chr16,52655754,1.6244298863906594,2829,1254,4083,+
chr16,52655822,2.2839449541284407,1148,435,1583,+
chr16,53324682,0.9045751633986928,691,407,1098,+
chr16,53324684,0.9045751633986928,691,407,1098,+
chr16,53324689,0.6743206935711713,1622,1370,2992,+
chr16,53324690,0.6743206935711713,1622,1370,2992,+
chr16,53324691,0.6743206935711713,1622,1370,2992,+
chr16,53324708,2.138699063528221,649,438,1087,+
chr16,53490437,1.5540451283544297,771,523,1294,+
chr16,56608583,1.0152228893056305,5885,4361,10246,+
chr16,56608597,0.9776751986936063,7649,5513,13162,+
chr16,56609315,1.4450508963097732,2769,1548,4317,+
chr16,56609316,1.4194346162177771,6691,5035,11726,+
chr16,56609319,1.5861060513428171,7189,5470,12659,+
chr16,56609378,1.302353023811196,4850,3094,7944,+
chr16,56609418,1.5908303816454772,13059,11793,24852,+
chr16,56625807,1.6231155778894473,645,397,1042,+
chr16,56626908,3.935454545454546,665,399,1064,+
chr16,56626975,1.464357941549887,2752,2102,4854,+
chr16,56626995,1.5788086594056745,1128,1004,2132,+
chr16,56626998,1.5818419905263994,2935,2207,5142,+
chr16,56684021,1.7131419049360885,1381,1046,2427,+
chr16,56684023,1.5827648040892883,2147,1672,3819,+
chr16,56684024,1.6655294591118206,2425,2032,4457,+
chr16,56684026,1.34400161184264,3711,3338,7049,+
chr16,56684027,0.9716756014644352,1340,767,2107,+
chr16,56684028,1.2040580629241326,4285,3479,7764,+
chr16,56830561,1.289400034077955,772,515,1287,+
chr16,56830562,1.0476386959775088,845,553,1398,+
chr16,56833247,0.9157727324309345,560,441,1001,+
chr16,56834377,1.9099229292812168,777,448,1225,+
chr16,56839005,1.7801508586870591,590,433,1023,+
chr16,56935449,2.3756521007908136,1395,940,2335,+
chr16,56935450,1.7410017251061396,992,604,1596,+
chr16,56940232,1.081408702309557,677,460,1137,+
chr16,56940233,1.081408702309557,677,460,1137,+
chr16,56942222,1.398363815084658,604,424,1028,+
chr16,57252823,2.551874829323808,660,450,1110,+
chr16,57451093,0.8113070228091237,660,428,1088,+
chr16,57459614,0.7027003522851017,978,747,1725,+
chr16,57459672,0.3416427546628408,634,407,1041,+
chr16,57459673,0.3416427546628408,634,407,1041,+
chr16,57460588,1.858916816277678,2484,1113,3597,+
chr16,57460589,1.8643653141336904,3396,1557,4953,+
chr16,57460590,1.8526692655480022,3844,1849,5693,+
chr16,57460591,1.7404442456815923,5591,3155,8746,+
chr16,57460592,1.835449402891264,2825,1719,4544,+
chr16,57460594,1.4655458543264235,5452,3306,8758,+
chr16,57460595,1.4639714313343555,2184,1148,3332,+
chr16,57460602,2.0621901449491995,2570,1577,4147,+
chr16,57460607,0.9983492954062154,3184,2250,5434,+
chr16,57460608,0.6882312273984258,2352,1566,3918,+
chr16,57460609,0.9983492954062154,3184,2250,5434,+
chr16,57460625,1.877985335037297,2071,1598,3669,+
chr16,57460632,1.4625059428620826,4833,4082,8915,+
chr16,57460633,1.1569255386025945,11187,8153,19340,+
chr16,57460634,1.8022354938787977,5446,3330,8776,+
chr16,57471334,0.4465421607042898,584,456,1040,+
chr16,57471336,0.4465421607042898,584,456,1040,+
chr16,66386982,4.050452714143549,611,394,1005,+
chr16,66389362,2.008832908163265,912,783,1695,+
chr16,66389363,2.246453175010937,1598,1365,2963,+
chr16,66389365,1.8410526315789475,953,854,1807,+
chr16,66389368,2.0993065187239943,515,514,1029,+
chr16,66404540,3.3634616868292064,613,446,1059,+
chr16,66552598,0.34308689697286665,581,428,1009,+
chr16,66565886,2.245647969052224,644,516,1160,+
chr16,66565905,2.054025974025974,658,384,1042,+
chr16,66565932,0.5408698815215132,770,565,1335,+
chr16,66565973,1.7958931105192528,1024,868,1892,+
chr16,67192794,0.4485738980121001,691,355,1046,+
chr16,67192796,0.4485738980121001,691,355,1046,+
chr16,67192840,1.10718954248366,725,458,1183,+
chr16,67192841,1.10718954248366,725,458,1183,+
chr16,67192844,1.0961436948223007,976,526,1502,+
chr16,67193028,1.3203473047364949,1656,983,2639,+
chr16,67195985,2.6571184270365227,899,688,1587,+
chr16,67195992,3.2950909093483096,658,470,1128,+
chr16,67539036,3.1831578947368424,647,474,1121,+
chr16,67539037,2.4889552662342274,858,609,1467,+
chr16,67539738,2.0535439511300204,871,633,1504,+
chr16,67539846,1.9062921348314603,1496,1049,2545,+
chr16,67539847,1.474199855956932,2270,1610,3880,+
chr16,67539851,1.7270069112174373,889,683,1572,+
chr16,67539857,1.8401380103507765,2047,1738,3785,+
chr16,67539859,1.8401380103507765,2047,1738,3785,+
chr16,67843826,4.356793726898814,814,612,1426,+
chr16,67868513,1.0107573149741824,647,580,1227,+
chr16,67868514,1.0107573149741824,647,580,1227,+
chr16,67871193,3.1810195852534564,596,495,1091,+
chr16,67871195,2.4571162669534967,643,551,1194,+
chr16,67882047,4.010118550174106,832,518,1350,+
chr16,67884317,0.7926315789473684,752,379,1131,+
chr16,67884318,0.7926315789473684,752,379,1131,+
chr16,67884319,0.7154107284978346,950,515,1465,+
chr16,67884325,2.1907108173424192,1164,716,1880,+
chr16,67884327,1.8618977825418603,1122,609,1731,+
chr16,67884344,1.9467277932734526,1049,677,1726,+
chr16,68191674,2.215756265614354,896,584,1480,+
chr16,68297558,6.855185071798276,244,772,1016,+
chr16,68297991,5.140708205503187,733,471,1204,+
chr16,68298031,1.0374720357941836,794,595,1389,+
chr16,68298033,1.0374720357941836,794,595,1389,+
chr16,68329127,0.7949483219655005,596,421,1017,+
chr16,68339828,2.3154379185321856,750,425,1175,+
chr16,68339875,2.536109574243699,759,410,1169,+
chr16,69137863,1.4427364000892955,809,781,1590,+
chr16,69137864,1.1138984573910438,594,606,1200,+
chr16,69160431,0.7235901831449852,779,527,1306,+
chr16,69160448,1.1097728234774542,739,563,1302,+
chr16,69165436,1.4239370078740157,821,507,1328,+
chr16,69165437,2.1204088551178994,992,639,1631,+
chr16,69165438,1.4239370078740157,821,507,1328,+
chr16,69424642,3.203317260096931,769,622,1391,+
chr16,69424643,0.4204301075268817,781,557,1338,+
chr16,69424645,0.5145063885165254,2303,1711,4014,+
chr16,69424661,1.2721880800641823,2324,1908,4232,+
chr16,69424662,0.9254497082564924,1832,1454,3286,+
chr16,69424680,1.64279989313385,1418,787,2205,+
chr16,69424738,2.1008155339805827,643,514,1157,+
chr16,69424759,1.645201193334789,645,508,1153,+
chr16,69424788,0.6339622641509434,888,634,1522,+
chr16,69424813,1.4446389293339523,2074,1698,3772,+
chr16,69424831,0.6267863077434364,1065,662,1727,+
chr16,69447160,1.9202714164546224,1131,916,2047,+
chr16,69447161,1.7323860272350504,692,562,1254,+
chr16,69447162,1.7721265389544636,2092,1540,3632,+
chr16,69447165,1.937427127866304,996,663,1659,+
chr16,69447190,1.5873706004140784,696,551,1247,+
chr16,69447196,0.6673220170021875,830,736,1566,+
chr16,69462443,1.518722727733992,1068,798,1866,+
chr16,69462448,1.88146740719088,1225,932,2157,+
chr16,69462531,3.2610993657505287,616,472,1088,+
chr16,69462537,1.5042326210781385,1194,738,1932,+
chr16,69462561,2.1998001998002,733,571,1304,+
chr16,69462564,1.6571428571428573,869,599,1468,+
chr16,69462606,1.5483652666751258,831,638,1469,+
chr16,69462688,0.6134393063583814,848,691,1539,+
chr16,69462692,1.5778419705743096,1938,1360,3298,+
chr16,69462710,1.483957219251337,1109,781,1890,+
chr16,69462734,1.6187997724687146,1210,878,2088,+
chr16,69462833,0.7054881963559616,1911,1396,3307,+
chr16,69462996,1.985351273988547,1884,1240,3124,+
chr16,69463018,1.9978181306306304,810,591,1401,+
chr16,69463038,1.0940021883265074,1690,1290,2980,+
chr16,69463057,1.8109017496635265,896,742,1638,+
chr16,69463064,0.5063599908048325,1278,832,2110,+
chr16,69463116,3.6666666666666665,614,409,1023,+
chr16,69463302,0.9991518955135272,1121,906,2027,+
chr16,69463303,0.9991518955135272,1121,906,2027,+
chr16,69463311,0.5410312273057372,744,458,1202,+
chr16,69463348,7.50062892312574,4810,3016,7826,+
chr16,69463349,5.945546319936357,6336,4085,10421,+
chr16,69463351,1.814965986394558,1449,1124,2573,+
chr16,69463359,9.081110985182299,6623,5139,11762,+
chr16,69463360,9.081110985182299,6623,5139,11762,+
chr16,70346956,2.2128416818819296,956,591,1547,+
chr16,70346958,2.445785249838908,1227,793,2020,+
chr16,70346960,2.581260945709281,866,570,1436,+
chr16,70346970,2.8182584607973014,974,436,1410,+
chr16,70346972,2.8182584607973014,974,436,1410,+
chr16,70347020,2.109647887323944,2065,1703,3768,+
chr16,70347022,2.1890819544130458,3261,2367,5628,+
chr16,70347025,2.3034014362856983,2585,1561,4146,+
chr16,70347026,2.3034014362856983,2585,1561,4146,+
chr16,70365099,1.0180851063829788,1319,751,2070,+
chr16,70365101,1.0180851063829788,1319,751,2070,+
chr16,70365102,1.4801864801864804,634,527,1161,+
chr16,70365109,1.7573969631236444,778,460,1238,+
chr16,70372549,0.48986978408287224,784,558,1342,+
chr16,70372563,1.7400968910211183,1636,1118,2754,+
chr16,70372564,1.7400968910211183,1636,1118,2754,+
chr16,70372576,1.568907933908435,2170,1471,3641,+
chr16,70528946,0.238865005890146,977,605,1582,+
chr16,70554569,1.8171511273613656,1548,1092,2640,+
chr16,70554570,1.1553930530164536,631,546,1177,+
chr16,70554571,2.3495429616087757,917,546,1463,+
chr16,70555116,0.4213817748659917,1131,919,2050,+
chr16,70555117,0.4213817748659917,1131,919,2050,+
chr16,70555118,0.4213817748659917,1131,919,2050,+
chr16,70561714,2.281761181513505,852,601,1453,+
chr16,70565200,0.4021993420405065,632,387,1019,+
chr16,70565205,2.5645765047559235,635,457,1092,+
chr16,70567474,8.74197101659493,2260,1925,4185,+
chr16,70567475,8.74197101659493,2260,1925,4185,+
chr16,70568301,2.354892418032787,680,487,1167,+
chr16,70572217,3.8776890173995926,971,378,1349,+
chr16,70572228,25.034105951135633,1609,1527,3136,+
chr16,70572229,25.03410595113564,1609,1527,3136,+
chr16,74296816,0.6004033817091072,688,507,1195,+
chr16,74296824,2.7090604645579086,765,552,1317,+
chr16,74300115,2.004209268294963,905,601,1506,+
chr16,74300130,0.46931856167327246,818,486,1304,+
chr16,74300173,1.7304526748971194,608,485,1093,+
chr16,74300176,1.009517533208715,1649,1396,3045,+
chr16,74302258,1.5681297084834591,1148,851,1999,+
chr16,74304343,1.828742203742204,680,480,1160,+
chr16,74304379,1.706951871657754,1063,714,1777,+
chr16,74305296,1.7125541125541128,988,692,1680,+
chr16,74305350,2.758785942492013,784,625,1409,+
chr16,74305375,1.660478329809725,612,472,1084,+
chr16,74305377,5.646630236794171,929,548,1477,+
chr16,74305395,1.9050033806626099,979,815,1794,+
chr16,74305440,1.839090909090909,577,439,1016,+
chr16,74305471,1.5811889973380655,1133,685,1818,+
chr16,74305551,2.5881273511331315,655,518,1173,+
chr16,74305592,1.6066016793745777,1217,796,2013,+
chr16,74305910,0.5681818181818181,759,417,1176,+
chr16,74305916,3.193040293040293,757,419,1176,+
chr16,74306007,2.1390374331550803,699,560,1259,+
chr16,74306028,2.1077127659574466,633,375,1008,+
chr16,74306035,0.5987951807228915,851,663,1514,+
chr16,74306064,0.6433540634552546,938,715,1653,+
chr16,74306100,1.9032665181885668,826,448,1274,+
chr16,75568141,0.6265232974910395,735,557,1292,+
chr16,75577412,1.985164051355207,851,700,1551,+
chr16,75577414,1.985164051355207,851,700,1551,+
chr16,75577743,2.3809395158074036,719,475,1194,+
chr16,75656391,5.317552620748449,718,506,1224,+
chr16,75656504,0.584152481419324,1328,872,2200,+
chr16,75656505,1.7573269909467544,1017,685,1702,+
chr16,75656507,2.0048192771084343,831,414,1245,+
chr16,75656514,1.8066131887169057,978,500,1478,+
chr16,75656522,0.7096564722279417,1210,612,1822,+
chr16,75656525,0.7543440140283754,2365,1393,3758,+
chr16,75656633,0.5234646411117,634,458,1092,+
chr16,81007248,2.940990270457697,877,486,1363,+
chr16,81011982,0.6263460597161038,705,453,1158,+
chr16,81011992,1.7403443031881247,1484,987,2471,+
chr16,81703868,12.761745125246678,1252,545,1797,+
chr16,81703869,11.33149927137268,1410,699,2109,+
chr16,81703870,11.33149927137268,1410,699,2109,+
chr16,81703871,9.861457529625845,1052,575,1627,+
chr16,81704013,2.709885731483219,575,448,1023,+
chr16,81705528,0.6353702344556175,1411,1144,2555,+
chr16,81705530,0.6928103139499989,1289,1002,2291,+
chr16,81705541,1.7156111929307805,705,484,1189,+
chr16,81705576,1.2529684731557782,1400,960,2360,+
chr16,81707015,1.2926696625504999,9096,5767,14863,+
chr16,81707016,1.1544615159007514,4405,2526,6931,+
chr16,81707017,1.234709893659584,6759,4159,10918,+
chr16,81707022,1.6758478617479875,3253,2382,5635,+
chr16,81707025,1.8567450479553254,3513,2753,6266,+
chr16,81707030,1.6455460680625607,18010,14577,32587,+
chr16,81707031,1.6455460680625607,18010,14577,32587,+
chr16,81707032,1.7405040651956591,21971,19128,41099,+
chr16,81707034,1.7636350851628602,21009,18443,39452,+
chr16,81707036,1.737418796791347,17591,14871,32462,+
chr16,81707039,2.38150652927723,5243,5494,10737,+
chr16,81709782,2.394557823129252,593,440,1033,+
chr16,81709798,1.8851224105461397,636,530,1166,+
chr16,81709864,1.9595084922472075,722,718,1440,+
chr16,81709958,28.63693695239245,1009,1054,2063,+
chr16,81709959,28.63693695239245,1009,1054,2063,+
chr16,81709960,28.435872772971855,853,995,1848,+
chr16,81709965,0.3682366603093876,499,887,1386,+
chr16,81709986,0.3734466004583651,799,1076,1875,+
chr16,81709988,0.43303571428571425,581,703,1284,+
chr16,81709989,0.21219931271477663,493,775,1268,+
chr16,81709991,0.3510708857097767,853,1182,2035,+
chr16,81710002,0.4128390240467531,699,815,1514,+
chr16,81710026,0.2638858399283399,692,535,1227,+
chr16,81710081,23.059901960784313,1049,76,1125,+
chr16,81710082,22.693347790994654,1459,112,1571,+
chr16,81710084,14.328308653216403,1246,109,1355,+
chr16,81710086,12.411582282747926,1045,96,1141,+
chr16,81710092,18.14135085523216,1281,217,1498,+
chr16,81710093,17.750141407691213,1709,316,2025,+
chr16,81710094,17.750141407691213,1709,316,2025,+
chr16,81710095,33.03860834164844,1283,263,1546,+
chr16,81710098,19.98051928751201,1842,1579,3421,+
chr16,81710099,16.805217277081127,2722,3004,5726,+
chr16,81710100,16.805217277081127,2722,3004,5726,+
chr16,81710101,16.658689960901928,2122,2782,4904,+
chr16,81710109,0.2319639249752538,707,926,1633,+
chr16,81710110,0.2345679012345679,607,719,1326,+
chr16,81710111,0.4560753102452442,475,747,1222,+
chr16,81710149,0.495757841059596,833,836,1669,+
chr16,81711505,1.869565217391304,601,419,1020,+
chr16,81711632,1.1103396828383891,1008,675,1683,+
chr16,81711634,0.8001270508777453,1299,960,2259,+
chr16,81711635,0.7586901916463652,689,572,1261,+
chr16,83808008,2.319473345852577,761,398,1159,+
chr16,83808016,1.141725328186212,1268,814,2082,+
chr16,83808017,1.7875547869226616,1558,1001,2559,+
chr16,83808019,1.740518962075848,871,500,1371,+
chr16,83808025,1.067807047553883,1155,739,1894,+
chr16,83808027,1.067807047553883,1155,739,1894,+
chr16,83808032,0.5353105627810867,733,432,1165,+
chr16,83808044,1.7602154823646186,1476,1012,2488,+
chr16,83808104,0.6179635458604787,937,718,1655,+
chr16,83808698,0.6383647798742138,927,635,1562,+
chr16,83809317,1.831694706567338,2873,1895,4768,+
chr16,83809337,1.5480179457725567,1983,1246,3229,+
chr16,83809339,0.9233766233766234,2474,1749,4223,+
chr16,83809340,1.147685137645724,3442,2335,5777,+
chr16,83809341,0.9233766233766234,2474,1749,4223,+
chr16,83809342,1.5342488327382586,1642,992,2634,+
chr16,83809353,0.5396030245746692,1556,1057,2613,+
chr16,83809397,1.3708779322938616,2836,1574,4410,+
chr16,83811433,1.7876402899755097,8204,5243,13447,+
chr16,83811551,1.8519546949214467,1055,781,1836,+
chr16,83811894,0.29565810813369825,1059,718,1777,+
chr16,84294865,2.3014006876986106,633,445,1078,+
chr16,84329566,1.2187840670859538,558,476,1034,+
chr16,84329568,1.2187840670859538,558,476,1034,+
chr16,84329762,2.4249201277955272,689,625,1314,+
chr16,84744636,2.58452320902652,772,449,1221,+
chr16,84745603,2.7463176147109185,744,493,1237,+
chr16,84758772,5.064997983290699,595,444,1039,+
chr16,84764189,1.873629061381718,708,388,1096,+
chr16,84778937,1.0732265446224256,937,474,1411,+
chr16,84778938,1.0732265446224256,937,474,1411,+
chr16,84779397,1.7172619047619049,576,431,1007,+
chr16,84779398,2.412678653757492,1216,722,1938,+
chr16,84779399,2.412678653757492,1216,722,1938,+
chr16,85672990,3.10075350160965,593,467,1060,+
chr16,85673048,1.461775409561694,639,504,1143,+
chr16,85799699,0.924214647813253,1311,914,2225,+
chr16,85799700,0.400930769767546,711,566,1277,+
chr16,85799721,1.8374948709076897,1627,1254,2881,+
chr16,85799723,1.8126869520371327,1043,830,1873,+
chr16,85801201,0.8957490854429124,1913,2788,4701,+
chr16,85801202,1.0307061538748779,3747,4179,7926,+
chr16,85801203,1.0918313497162384,3516,3848,7364,+
chr16,85801204,0.9580785142893279,3597,3041,6638,+
chr16,85801205,0.9108155880692598,2219,1790,4009,+
chr16,85801213,0.7003316749585407,1029,1004,2033,+
chr16,85801214,0.7477774788749603,2562,2284,4846,+
chr16,85801219,0.6578978551961132,2775,2812,5587,+
chr16,85801220,0.65314626675205,7388,6919,14307,+
chr16,85801222,0.6452574386177239,3107,3075,6182,+
chr16,85801245,0.7728362975749465,2779,2193,4972,+
chr16,85801246,0.7934819459607411,2629,2312,4941,+
chr16,85801247,1.4239092617076057,2871,2052,4923,+
chr16,85805014,1.4483992279020237,2122,1251,3373,+
chr16,85805019,1.976523078557391,2214,1404,3618,+
chr16,85805038,1.4793900405051228,1773,1398,3171,+
chr16,85805059,1.462193119189445,1892,1561,3453,+
chr16,85805091,1.6109687610057721,3957,3362,7319,+
chr16,85805092,1.3073434080679396,8750,6985,15735,+
chr16,85805732,1.6149194308353039,4046,3144,7190,+
chr16,85805813,1.6853002070393377,2441,1448,3889,+
chr16,85805819,1.5563864869777466,2605,1555,4160,+
chr16,85805852,1.7198630136986306,1808,1459,3267,+
chr16,87403029,2.1398348813209487,714,509,1223,+
chr16,87403030,2.5358600022446494,881,627,1508,+
chr16,87403101,1.935337016547148,1404,1076,2480,+
chr16,89557232,2.6025465239356746,716,457,1173,+
chr16,89560665,0.7269543111383496,1985,799,2784,+
chr16,89560666,0.7734801223241591,1215,374,1589,+
chr16,89560667,0.7734801223241591,1215,374,1589,+
chr16,89560675,1.6877835868933793,1289,566,1855,+
chr16,89560676,1.2436920457155727,3620,2277,5897,+
chr16,89560677,0.8468796827302074,2585,2017,4602,+
chr16,89560679,0.5953084745762712,3527,1592,5119,+
chr16,89560680,0.7551260891475846,2885,2076,4961,+
chr16,89560681,0.6739647430175694,6412,3668,10080,+
chr16,89560682,1.359350263215476,1353,1008,2361,+
chr16,89560693,1.3338718280053485,9013,4843,13856,+
chr16,89560694,1.309085834821243,19475,11520,30995,+
chr16,89560695,1.275787444596728,5349,4090,9439,+
chr16,89560696,1.3081937202452736,8305,4068,12373,+
chr16,89560948,1.603469757905528,3630,2817,6447,+
chr16,89560951,1.4803734767962442,3945,3148,7093,+
chr16,89561052,1.462977978105055,828,536,1364,+
chr16,89561225,1.2518141414141413,823,374,1197,+
chr16,89561226,1.2518141414141413,823,374,1197,+
chr16,89561227,1.1516756881262236,999,913,1912,+
chr16,89561228,1.452735344039692,577,443,1020,+
chr16,89561229,1.1516756881262236,999,913,1912,+
chr16,89561231,1.3113101903695408,1170,563,1733,+
chr16,89561237,1.5008071293402097,2469,1713,4182,+
chr16,89561238,1.5008071293402097,2469,1713,4182,+
chr16,89561240,0.7506208676019996,1368,1112,2480,+
chr16,89561243,1.487036764213487,3750,2724,6474,+
chr16,89561245,1.487036764213487,3750,2724,6474,+
chr16,89561255,1.400340572975249,4536,3559,8095,+
chr16,89561315,1.3310839717731398,13368,8933,22301,+
chr16,89561318,1.59949756843965,10237,6314,16551,+
chr16,89561323,1.37024535676285,4746,3581,8327,+
chr16,89561438,2.42023346303502,621,513,1134,+
chr16,89561439,2.42023346303502,621,513,1134,+
chr16,89561448,0.6804766309854191,834,657,1491,+
chr16,89561615,1.3336983774579687,11916,6116,18032,+
chr16,89561616,1.3513772793240673,16749,9269,26018,+
chr16,89561624,1.54760518900696,12301,7568,19869,+
chr16,89561630,0.7753598198494319,9989,8144,18133,+
chr16,89561640,1.2791269736110682,12554,9926,22480,+
chr16,89561643,1.1339075422454865,7469,5758,13227,+
chr16,89561733,1.2729914065019665,6701,4330,11031,+
chr16,89562334,1.6223840688750657,7421,4057,11478,+
chr16,89562335,1.3457640304868406,3421,1682,5103,+
chr16,89562336,1.4830121721849603,16072,9089,25161,+
chr16,89562337,1.4084918963334574,17476,10228,27704,+
chr16,89562338,1.3523101003038835,26672,15009,41681,+
chr16,89562339,1.3067966597779335,28302,16255,44557,+
chr16,89562341,1.3019368968469789,31918,21926,53844,+
chr16,89562342,1.3016457415713272,56676,37174,93850,+
chr16,89562343,1.2880011247608603,48453,28303,76756,+
chr16,89562344,1.318596894246335,59791,38707,98498,+
chr16,89562345,1.2239906973595902,18977,10201,29178,+
chr16,89562359,1.3930445819955075,8651,6141,14792,+
chr16,89562887,0.9024815215358084,14400,10976,25376,+
chr16,89562889,1.2116233137489851,27341,19408,46749,+
chr16,89562993,1.8841567674586035,3026,1388,4414,+
chr16,89563007,1.5201323582634871,3226,1596,4822,+
chr16,89563014,1.3546869514335869,3185,1708,4893,+
chr16,89563026,1.2833633432435827,3830,2170,6000,+
chr16,89563027,1.0930233241010017,7167,5232,12399,+
chr16,89563030,1.1939920699080009,25448,17174,42622,+
chr16,89563031,1.1125433330056669,16349,11850,28199,+
chr16,89563032,1.2954856333751903,14145,8436,22581,+
chr16,89563034,1.288124447266378,15147,9283,24430,+
chr16,89563036,1.277445183445326,16050,10070,26120,+
chr16,89563037,1.30933563251425,11004,6958,17962,+
chr16,89563108,1.4026142746851955,2532,1976,4508,+
chr16,89563111,1.35540502995671,8854,6126,14980,+
chr16,89563129,4.7438672281226,11675,8971,20646,+
chr16,89563171,0.8063832542588385,3604,2928,6532,+
chr17,1001266,1.7597432857739517,616,462,1078,+
chr17,1001268,2.973765432098766,563,485,1048,+
chr17,1830073,8.22396210128455,1135,833,1968,+
chr17,1830074,2.816112859011749,853,758,1611,+
chr17,1830076,1.1406008398401708,580,524,1104,+
chr17,1844598,2.446380953524637,1572,1185,2757,+
chr17,1844613,2.720819378743923,802,555,1357,+
chr17,1844623,2.2858690605169483,546,496,1042,+
chr17,1844639,0.5252365930599369,776,633,1409,+
chr17,1844641,3.493506493506493,537,503,1040,+
chr17,1853114,0.45447781697764167,875,671,1546,+
chr17,1875665,2.391450343106507,1369,895,2264,+
chr17,1875667,2.326826196473552,738,396,1134,+
chr17,1875742,2.223820376724487,750,519,1269,+
chr17,1879271,0.5580472658271519,646,526,1172,+
chr17,1879365,1.669785022442712,598,414,1012,+
chr17,1879368,0.867686170212766,2549,1503,4052,+
chr17,1879369,0.867686170212766,2549,1503,4052,+
chr17,1879370,0.8198109904035078,3790,2282,6072,+
chr17,1888780,2.1090407177363697,763,440,1203,+
chr17,1895023,0.4824038597984958,522,485,1007,+
chr17,1895056,0.7393906529148572,1317,1062,2379,+
chr17,1897254,0.5030534417228629,919,791,1710,+
chr17,1897298,2.231746031746032,702,503,1205,+
chr17,1897299,2.231746031746032,702,503,1205,+
chr17,2040310,2.4019237982454773,931,668,1599,+
chr17,2040312,2.671734495225735,654,468,1122,+
chr17,2043234,1.2038909830825573,651,520,1171,+
chr17,2665401,1.9672510382102388,705,557,1262,+
chr17,3669225,0.2525378915868148,576,425,1001,+
chr17,3669366,1.856488768064101,864,481,1345,+
chr17,3669379,1.0766004009604473,4894,3088,7982,+
chr17,3669380,1.4885693897507732,2610,1686,4296,+
chr17,3669381,0.5916583249916583,1611,998,2609,+
chr17,3669448,2.4310506566604126,2200,1270,3470,+
chr17,3669450,1.2956730769230769,3002,2079,5081,+
chr17,3669456,1.4400242523812317,2073,1310,3383,+
chr17,3669461,1.5923200122025627,2244,1489,3733,+
chr17,3669474,1.2498531208557322,10624,6599,17223,+
chr17,3669476,1.2498531208557322,10624,6599,17223,+
chr17,3669511,0.5247252747252747,763,493,1256,+
chr17,3669534,0.3557636887608069,822,693,1515,+
chr17,3669535,3.0252100840336134,839,538,1377,+
chr17,3669538,2.3784507181382106,1529,1115,2644,+
chr17,3669549,1.8155251141552509,993,656,1649,+
chr17,4572531,1.3243985725773648,1452,1088,2540,+
chr17,4572533,0.8310384088563071,2054,1519,3573,+
chr17,4572534,0.7145128975707488,1326,967,2293,+
chr17,4796183,1.641154912184147,1697,839,2536,+
chr17,4796184,1.5920878132044105,3279,1858,5137,+
chr17,4796185,1.5460906601764526,967,691,1658,+
chr17,4796186,1.4896363112945017,1178,612,1790,+
chr17,4796187,1.939189189189189,804,459,1263,+
chr17,4796188,1.939189189189189,804,459,1263,+
chr17,4796191,1.0022346151604065,1257,970,2227,+
chr17,4796192,1.4158464180815722,1734,1264,2998,+
chr17,4796279,2.665898345153664,1048,704,1752,+
chr17,4796280,3.042883069743324,1585,1101,2686,+
chr17,4796282,2.549679626323084,1710,1269,2979,+
chr17,4796283,0.550275482093664,845,483,1328,+
chr17,4796731,2.037536103232279,1017,742,1759,+
chr17,4796746,1.8717391304347828,629,459,1088,+
chr17,4796781,1.2026537135304836,2233,1415,3648,+
chr17,4796783,1.3988190291057965,3199,1999,5198,+
chr17,4796784,1.1891711229946524,1778,1019,2797,+
chr17,4797530,2.960960960960961,985,628,1613,+
chr17,4797682,1.1048256091734352,983,804,1787,+
chr17,4797684,1.6094023934155184,1874,1373,3247,+
chr17,4797691,1.7181964573268917,1066,689,1755,+
chr17,4797714,1.2891822532035495,1520,1321,2841,+
chr17,4798012,2.144573488185823,611,453,1064,+
chr17,4798032,0.3270517787953505,618,500,1118,+
chr17,4798045,1.6099721947311372,898,642,1540,+
chr17,4798084,1.4910544345280714,1946,1529,3475,+
chr17,4798138,0.5208546833367493,1069,696,1765,+
chr17,4798321,2.108532200065381,859,531,1390,+
chr17,4798363,1.7690135358847017,585,488,1073,+
chr17,4798364,0.6246402877697841,754,555,1309,+
chr17,4798381,1.5734649122807016,839,575,1414,+
chr17,4887663,2.9507686676427527,700,682,1382,+
chr17,4887665,2.931920720400297,736,652,1388,+
chr17,4940668,3.0045921955132293,702,507,1209,+
chr17,4942579,1.1147602979200668,1389,1182,2571,+
chr17,4942580,0.7149470899470899,1080,944,2024,+
chr17,4942581,0.7149470899470899,1080,944,2024,+
chr17,4942592,0.4031007751937984,571,472,1043,+
chr17,4942881,0.8069545929018791,650,478,1128,+
chr17,4942883,1.165311653116531,999,737,1736,+
chr17,4942884,0.7838860605829973,958,738,1696,+
chr17,4943201,2.215909090909091,689,505,1194,+
chr17,4943203,1.4392122543872816,1523,1159,2682,+
chr17,4945160,55.94477309915127,1419,821,2240,+
chr17,4945161,45.18080067088804,1752,1483,3235,+
chr17,4945162,37.12431252312287,1917,1674,3591,+
chr17,4945173,7.749819368801357,832,1202,2034,+
chr17,4955442,1.1830951657038613,1023,597,1620,+
chr17,4955443,1.4258497585370813,1350,899,2249,+
chr17,4955472,2.4878048780487805,679,409,1088,+
chr17,4955487,1.4030304074257915,895,726,1621,+
chr17,4955493,1.9838748075536965,1064,809,1873,+
chr17,4955503,1.0418118466898956,2069,1434,3503,+
chr17,4955504,1.0418118466898956,2069,1434,3503,+
chr17,4955512,2.285968028419183,701,562,1263,+
chr17,4955514,1.9242823204484547,1110,938,2048,+
chr17,4955515,1.9725356610602511,764,670,1434,+
chr17,4955517,1.4808772604848017,1697,1129,2826,+
chr17,4955520,1.7053258368652362,5839,3963,9802,+
chr17,4955522,1.7986730941822904,3845,2653,6498,+
chr17,4955525,1.7791895314478685,2237,1544,3781,+
chr17,4956075,1.6333371864524333,627,421,1048,+
chr17,4956875,0.5329616867883632,713,548,1261,+
chr17,5308739,2.1141692142051585,863,677,1540,+
chr17,5308741,2.1141692142051585,863,677,1540,+
chr17,5308768,2.3321161103677395,603,443,1046,+
chr17,5350555,1.733488507419261,661,490,1151,+
chr17,5350580,1.5547754984564668,1976,1735,3711,+
chr17,5350581,1.6773747841105353,1213,1157,2370,+
chr17,5361272,2.0170905800743943,911,685,1596,+
chr17,5361384,3.155130241522201,936,563,1499,+
chr17,5361388,2.7864413814299236,1220,817,2037,+
chr17,5361406,1.7307839388145316,729,522,1251,+
chr17,5361422,1.9311135330151457,1194,648,1842,+
chr17,5361423,1.9311135330151457,1194,648,1842,+
chr17,5361440,1.6406618928839372,2748,1881,4629,+
chr17,5361446,1.0520676726505538,2135,1595,3730,+
chr17,5361466,1.1227857673293027,4371,3116,7487,+
chr17,5361467,1.4731812577065353,2510,1621,4131,+
chr17,5361471,3.84307263277982,1466,1028,2494,+
chr17,5377282,1.662669098759998,1057,551,1608,+
chr17,5377286,5.6000000000000005,815,407,1222,+
chr17,5378192,2.2816674137158226,908,484,1392,+
chr17,5378209,1.9155510932619368,1560,829,2389,+
chr17,5378211,1.8331348193522767,2423,1305,3728,+
chr17,5378213,1.7633494118642634,1666,908,2574,+
chr17,5380373,2.3704781144781144,1795,1349,3144,+
chr17,5380374,2.3704781144781144,1795,1349,3144,+
chr17,5380380,2.339156079854809,1472,927,2399,+
chr17,5383257,0.7536432245512408,690,450,1140,+
chr17,5383518,1.5070254093487783,1190,808,1998,+
chr17,5420249,1.077202586417373,686,470,1156,+
chr17,5488328,2.976502205071665,1324,906,2230,+
chr17,5488329,3.4667219062630052,2856,1904,4760,+
chr17,5488330,3.3296736070969586,2248,1523,3771,+
chr17,5488343,2.3469785575048734,644,512,1156,+
chr17,5488351,8.169368821567367,4592,4609,9201,+
chr17,5488352,8.169368821567367,4592,4609,9201,+
chr17,5488370,3.6664127951256655,829,1009,1838,+
chr17,5489318,0.29097222222222224,837,575,1412,+
chr17,5489320,0.29097222222222224,837,575,1412,+
chr17,5489833,0.8386153547781666,597,474,1071,+
chr17,6641170,2.5407608695652173,604,505,1109,+
chr17,6641171,2.5407608695652173,604,505,1109,+
chr17,6641792,2.7979476803006214,716,406,1122,+
chr17,6641809,1.7730705687986783,600,445,1045,+
chr17,6642253,1.697159090909091,720,439,1159,+
chr17,6642273,1.9721779195463405,717,593,1310,+
chr17,6642953,2.238003410839843,1741,1284,3025,+
chr17,7012623,0.4467232078083783,870,662,1532,+
chr17,7012655,1.3311146912904288,1026,680,1706,+
chr17,7012710,2.156320683588841,857,518,1375,+
chr17,7012711,0.46790159756934246,681,536,1217,+
chr17,7013666,0.4336734693877552,939,751,1690,+
chr17,7013667,2.118449389806174,907,596,1503,+
chr17,7014322,1.5634448785459487,766,608,1374,+
chr17,7014392,2.4836601307189543,759,458,1217,+
chr17,7014411,1.8211618257261408,626,481,1107,+
chr17,7219914,0.9440211600309439,885,498,1383,+
chr17,7219916,0.9440211600309439,885,498,1383,+
chr17,7219924,3.6280133000831265,601,400,1001,+
chr17,7219925,3.6280133000831265,601,400,1001,+
chr17,7219982,1.090603489217385,1562,929,2491,+
chr17,7219983,1.090603489217385,1562,929,2491,+
chr17,7220126,1.6853777481668826,731,331,1062,+
chr17,7220471,1.7003142649737508,1518,926,2444,+
chr17,7220473,2.0903225806451613,971,494,1465,+
chr17,7220502,0.46385186932421274,854,694,1548,+
chr17,7220504,0.5263847023594381,1495,1075,2570,+
chr17,7220509,1.530598290598291,813,599,1412,+
chr17,7220510,1.0792845547309833,1200,923,2123,+
chr17,7220511,1.4220611025617165,1974,1415,3389,+
chr17,7220603,1.5852941176470592,923,713,1636,+
chr17,7220608,1.1932868672046957,1548,1174,2722,+
chr17,7220609,1.2499393329057527,2641,1871,4512,+
chr17,7220650,0.6711698764012647,1400,1064,2464,+
chr17,7220786,0.6023702868357333,2042,1431,3473,+
chr17,7220789,0.9407423556104609,1909,1528,3437,+
chr17,7220791,0.9407423556104609,1909,1528,3437,+
chr17,7220794,0.8481536057566521,3716,2527,6243,+
chr17,7220796,0.9966995293159454,2364,1730,4094,+
chr17,7220937,1.9122791597081832,1035,733,1768,+
chr17,7220942,2.255231689088192,1206,668,1874,+
chr17,7220985,2.7791383219954646,765,489,1254,+
chr17,7221019,2.135011441647597,621,455,1076,+
chr17,7221022,1.5354727036296452,2592,2085,4677,+
chr17,7221024,1.5741184460048177,1648,1431,3079,+
chr17,7221565,2.0505952380952377,688,503,1191,+
chr17,7221584,1.8736263736263732,1462,930,2392,+
chr17,7221585,1.8736263736263732,1462,930,2392,+
chr17,7221606,1.2981624262175337,1854,1277,3131,+
chr17,7221652,0.8595309566811933,3161,2048,5209,+
chr17,7221654,1.1825850340136057,3115,1861,4976,+
chr17,7221655,1.1752597183641356,3326,2008,5334,+
chr17,7221657,1.53384476534296,2265,1384,3649,+
chr17,7221658,0.39830508474576276,704,589,1293,+
chr17,7221997,1.5540172668585206,998,597,1595,+
chr17,7222176,1.694736842105263,781,645,1426,+
chr17,7222188,2.3328178362007863,882,738,1620,+
chr17,7222221,1.5610376629866884,858,758,1616,+
chr17,7222263,2.784466019417476,955,514,1469,+
chr17,7222678,2.4020624810433726,1522,941,2463,+
chr17,7222680,2.151606024256964,2333,1475,3808,+
chr17,7222682,2.0812343353604796,2189,1502,3691,+
chr17,7222701,2.024668798538145,830,596,1426,+
chr17,7222774,2.8763882312396993,1915,1375,3290,+
chr17,7222800,0.5035315561631352,679,461,1140,+
chr17,7222853,2.0015323992994745,891,570,1461,+
chr17,7223134,2.0526371983771092,768,445,1213,+
chr17,7223165,2.3949660318521,1452,1094,2546,+
chr17,7223166,2.3949660318521,1452,1094,2546,+
chr17,7223170,0.6845575535913848,1566,1157,2723,+
chr17,7223667,1.9543222734712098,709,516,1225,+
chr17,7223695,1.7687385740402197,644,546,1190,+
chr17,7223836,0.5618716527294935,1039,733,1772,+
chr17,7223967,0.3859037920407343,575,438,1013,+
chr17,7223993,1.6832329317269077,957,663,1620,+
chr17,7224016,1.6346496030659732,712,561,1273,+
chr17,7224026,1.5641581649932688,1971,1539,3510,+
chr17,7224150,1.2025270026405355,1907,1383,3290,+
chr17,7224183,0.6245095355415641,1179,842,2021,+
chr17,7224184,0.6690995593760981,951,648,1599,+
chr17,7224346,1.2233502538071066,722,590,1312,+
chr17,7224347,1.2233502538071066,722,590,1312,+
chr17,7224369,2.336451207594583,1045,740,1785,+
chr17,7224370,1.817697963399385,1445,1048,2493,+
chr17,7224498,1.1537245091401098,988,739,1727,+
chr17,7224537,1.7423975578255253,529,500,1029,+
chr17,7224641,0.5033129141142643,670,420,1090,+
chr17,7224811,2.0653357531760435,1137,550,1687,+
chr17,7224812,1.8725948893995181,1779,880,2659,+
chr17,7224814,1.8387969676313238,1893,977,2870,+
chr17,7224815,1.8002368002368,1314,692,2006,+
chr17,7224851,1.5773786897435664,2298,1690,3988,+
chr17,7224853,1.5773786897435664,2298,1690,3988,+
chr17,7224993,1.9663461538461542,817,623,1440,+
chr17,7225095,0.491001328662882,541,486,1027,+
chr17,7225098,1.9915775834143186,635,440,1075,+
chr17,7225121,0.6111601019008426,997,755,1752,+
chr17,7225195,1.678157988078377,1627,1273,2900,+
chr17,7252788,10.028246914054586,553,569,1122,+
chr17,7259678,2.0346814703403666,779,619,1398,+
chr17,7307559,2.983065813550261,616,481,1097,+
chr17,7307660,0.5296124031007752,853,429,1282,+
chr17,7307692,4.122007722007722,627,517,1144,+
chr17,7307695,1.7386268364326258,925,789,1714,+
chr17,7307698,4.907340808206647,2345,1898,4243,+
chr17,7307699,1.0951371115173676,575,546,1121,+
chr17,7307723,1.9276635222814589,1151,1081,2232,+
chr17,7307729,1.6263149752475248,840,807,1647,+
chr17,7307731,1.661867501304121,936,638,1574,+
chr17,7307735,1.1739447731755424,2245,1559,3804,+
chr17,7307736,1.1739447731755424,2245,1559,3804,+
chr17,7308045,3.497241433308075,1064,679,1743,+
chr17,7308046,3.7187168141487366,755,585,1340,+
chr17,7308047,3.4923053940701094,1308,915,2223,+
chr17,7308069,2.0189874789837474,813,653,1466,+
chr17,7308071,3.5717222989257715,1121,905,2026,+
chr17,7309616,0.6492064146998955,2389,1991,4380,+
chr17,7309617,0.6492064146998955,2389,1991,4380,+
chr17,7309622,0.640791923943938,933,894,1827,+
chr17,7309631,0.7101737854747998,4714,4035,8749,+
chr17,7309632,0.7101737854747998,4714,4035,8749,+
chr17,7309633,0.8062703743949421,1450,1271,2721,+
chr17,7309689,0.7702110438533801,3577,2470,6047,+
chr17,7309696,1.6527523414629581,6181,3670,9851,+
chr17,7309706,1.7615528943040468,2715,1876,4591,+
chr17,7309710,1.6709624881596397,7600,4731,12331,+
chr17,7309713,1.3462098680895742,27395,18137,45532,+
chr17,7309714,1.3462098680895742,27395,18137,45532,+
chr17,7309715,1.3239730361810145,34806,22937,57743,+
chr17,7309750,1.4811398451655409,2247,1867,4114,+
chr17,7311076,2.046280276816609,746,288,1034,+
chr17,7311098,1.912087912087912,869,311,1180,+
chr17,7311102,2.161790549806558,2124,903,3027,+
chr17,7311103,2.3527509652509653,1188,559,1747,+
chr17,7311351,1.7299834760402582,1485,950,2435,+
chr17,7311356,2.6514578888721734,2270,1100,3370,+
chr17,7311362,0.6505055742805289,964,550,1514,+
chr17,7311371,1.7507447132500835,5242,2685,7927,+
chr17,7311372,1.757300813388365,4098,1988,6086,+
chr17,7311597,2.8903803131991053,1025,446,1471,+
chr17,7311598,2.8903803131991053,1025,446,1471,+
chr17,7311602,1.25254614479657,900,476,1376,+
chr17,7311612,1.7472887553616059,1904,1458,3362,+
chr17,7311613,1.6962319426204664,1157,1041,2198,+
chr17,7311616,0.8243400621118011,2739,1609,4348,+
chr17,7311617,0.8243400621118011,2739,1609,4348,+
chr17,7311618,0.7894182652394254,3464,2244,5708,+
chr17,7311622,2.076864111299509,1751,1133,2884,+
chr17,7311632,1.545678459471563,1533,923,2456,+
chr17,7311849,1.5914505409410105,2690,1734,4424,+
chr17,7311966,1.6337521222410865,1781,1424,3205,+
chr17,7312121,1.0133521072052825,772,541,1313,+
chr17,7312122,1.0133521072052825,772,541,1313,+
chr17,7312126,1.1087888446215142,1350,1003,2353,+
chr17,7312127,1.1087888446215142,1350,1003,2353,+
chr17,7312128,0.5126220802499493,882,664,1546,+
chr17,7312189,1.6549606601420073,783,578,1361,+
chr17,7312217,1.8613773122353467,869,640,1509,+
chr17,7312225,1.5770436460091637,980,753,1733,+
chr17,7312310,1.780713502983076,1124,381,1505,+
chr17,7312319,2.5339550046031496,3555,1915,5470,+
chr17,7312329,16.921928535482188,6608,3955,10563,+
chr17,7312330,9.494413407821225,1544,1073,2617,+
chr17,7312331,9.979468987891417,4060,2064,6124,+
chr17,7312354,1.6299959355100937,1588,846,2434,+
chr17,7312360,3.2326530612244904,863,629,1492,+
chr17,7501068,2.1133004926108367,725,615,1340,+
chr17,7501069,2.1133004926108367,725,615,1340,+
chr17,7501312,1.6457142857142857,611,475,1086,+
chr17,7501322,2.162396589945741,1346,1061,2407,+
chr17,7501329,1.7590949631507298,913,788,1701,+
chr17,7501339,1.986734693877551,1061,1049,2110,+
chr17,7509064,0.5580712788259958,725,476,1201,+
chr17,7565487,0.9736523319200484,642,380,1022,+
chr17,7565489,0.9736523319200484,642,380,1022,+
chr17,7565518,1.7484468497942824,1089,739,1828,+
chr17,7565519,2.25,683,431,1114,+
chr17,7571801,6.121875043235149,746,658,1404,+
chr17,7572825,0.4893415298039576,2047,1037,3084,+
chr17,7572826,0.6606832052800704,3221,1603,4824,+
chr17,7572827,0.5595492512977887,5120,2453,7573,+
chr17,7572831,2.258009271562288,1737,638,2375,+
chr17,7572834,1.683183977272332,9762,4564,14326,+
chr17,7572835,1.683183977272332,9762,4564,14326,+
chr17,7572841,2.0210369475175476,5621,2870,8491,+
chr17,7574545,1.4935506285995224,3981,2259,6240,+
chr17,7574548,1.459641358963721,1978,1032,3010,+
chr17,7574549,1.8129211989243057,3200,1593,4793,+
chr17,7574552,1.4772416790859417,970,731,1701,+
chr17,7574554,1.5415241057542768,1179,642,1821,+
chr17,7574558,1.49748322147651,1784,871,2655,+
chr17,7574561,1.6153273809523812,3172,1823,4995,+
chr17,7574562,1.5726613522042177,5653,3454,9107,+
chr17,7574564,1.633625895804815,2218,1128,3346,+
chr17,7574569,1.503946471495713,2841,1955,4796,+
chr17,7574582,1.515972362829962,12485,8516,21001,+
chr17,7574615,1.2734008017510636,3161,2227,5388,+
chr17,7575119,1.5700284682174632,6228,4306,10534,+
chr17,7575121,1.4702939711543295,10521,6679,17200,+
chr17,7575155,1.4778849620437418,8434,6609,15043,+
chr17,7575156,1.4778849620437418,8434,6609,15043,+
chr17,7575206,0.7510727084750666,2920,2362,5282,+
chr17,7575243,1.3615414017864327,2218,1155,3373,+
chr17,7576527,0.9592777186100214,5891,4295,10186,+
chr17,7576543,0.7459822125136527,3414,1884,5298,+
chr17,7576611,0.8826838912390242,8214,4733,12947,+
chr17,7576613,0.7660717197363138,10770,6805,17575,+
chr17,7576635,1.453273923303057,4082,2446,6528,+
chr17,7577135,1.4672481855744943,6903,3770,10673,+
chr17,7577136,1.4672481855744943,6903,3770,10673,+
chr17,7577342,1.136103896103896,4373,2547,6920,+
chr17,7577344,1.3263164652652566,14706,9073,23779,+
chr17,7577345,1.3149151202376421,19067,12553,31620,+
chr17,7577427,1.689687019535744,6520,4514,11034,+
chr17,7577428,1.689687019535744,6520,4514,11034,+
chr17,7577596,1.3243491663926115,5519,3259,8778,+
chr17,7577601,1.491835724888669,2411,1633,4044,+
chr17,7577684,1.4066578602792832,5670,4238,9908,+
chr17,7577842,0.7321445600734304,4128,3106,7234,+
chr17,7578188,0.6696969696969697,1767,879,2646,+
chr17,7578191,1.4552855870754355,1429,1122,2551,+
chr17,7578195,1.6201674554058971,2022,1024,3046,+
chr17,7578198,1.4233446656953213,2197,1135,3332,+
chr17,7578201,2.2095516569200777,2266,1234,3500,+
chr17,7578207,1.455516076218344,2353,1366,3719,+
chr17,7578490,2.7003585239459555,2155,1358,3513,+
chr17,7578563,47.8749648714626,11358,3521,14879,+
chr17,7578564,35.11051477647662,8240,2292,10532,+
chr17,7578572,33.184626575087826,6954,3132,10086,+
chr17,7578573,30.445816130410794,9700,4416,14116,+
chr17,7578592,1.8644840447575632,1226,761,1987,+
chr17,7578625,0.3751662971175167,798,934,1732,+
chr17,7578705,0.43502501127027887,829,800,1629,+
chr17,7578708,1.4726984621778887,1245,801,2046,+
chr17,7578709,1.1128682914898904,1791,1310,3101,+
chr17,7578710,1.4726984621778887,1245,801,2046,+
chr17,7578712,0.6132563011872261,946,828,1774,+
chr17,7578713,0.5708705357142857,1484,1279,2763,+
chr17,7578714,1.74964534060125,823,682,1505,+
chr17,7578715,0.5020446681346336,1025,866,1891,+
chr17,7578720,0.5763825163004105,662,504,1166,+
chr17,7578723,0.4833572224876573,606,482,1088,+
chr17,7578792,1.507391530267602,1506,1282,2788,+
chr17,7578910,4.649104717933625,4274,3087,7361,+
chr17,7581561,12.021483566194712,1158,2184,3342,+
chr17,7581562,13.364941918041785,1387,2846,4233,+
chr17,7581563,13.364941918041785,1387,2846,4233,+
chr17,7581568,0.27550838387653137,591,1473,2064,+
chr17,7581569,0.27550838387653137,591,1473,2064,+
chr17,7581570,0.3181216931216931,480,965,1445,+
chr17,7581585,0.27010603044472525,403,880,1283,+
chr17,7583885,3.9467320261437906,928,407,1335,+
chr17,7583887,4.263045061008861,1268,591,1859,+
chr17,7587696,3.5002917796689426,857,588,1445,+
chr17,7588071,2.7858823529411763,665,449,1114,+
chr17,7588123,1.769660560013065,581,448,1029,+
chr17,7588124,2.405392156862745,700,509,1209,+
chr17,7588126,8.19557731340794,723,618,1341,+
chr17,8221556,0.950161224762279,1294,1101,2395,+
chr17,16004246,1.4809662044438667,686,448,1134,+
chr17,16006475,4.013123310325794,675,426,1101,+
chr17,16026609,1.8974948028527474,729,528,1257,+
chr17,16026640,0.5065666015725767,930,714,1644,+
chr17,16026657,2.4130702617537425,1289,998,2287,+
chr17,16026673,1.9033831628638869,863,614,1477,+
chr17,16026679,2.256932005445296,999,820,1819,+
chr17,16026686,2.4539281335471093,1061,921,1982,+
chr17,16028709,20.514611889547666,1252,1150,2402,+
chr17,16028710,20.514611889547666,1252,1150,2402,+
chr17,16381089,1.0124453007625176,3934,2392,6326,+
chr17,16381090,0.9449999890119031,5543,3302,8845,+
chr17,16381094,1.7369102957173759,5768,3675,9443,+
chr17,16381153,1.6575081156329043,7652,5943,13595,+
chr17,16381154,1.4438888888888892,3163,2249,5412,+
chr17,16381991,1.386321631507951,10914,8224,19138,+
chr17,16381992,1.425540281659338,6778,4868,11646,+
chr17,16382145,1.1702405132202705,3336,2230,5566,+
chr17,16382181,1.4043381542943425,7327,5216,12543,+
chr17,16382219,1.399477940050602,2801,2046,4847,+
chr17,16382226,1.5380609797875986,3127,2362,5489,+
chr17,16382232,1.3057828606380375,13150,9914,23064,+
chr17,16382373,1.2013819725115449,5569,3526,9095,+
chr17,16382378,1.2684479652691527,2764,1921,4685,+
chr17,16382379,1.3267477203647415,3491,2255,5746,+
chr17,16382394,1.3291212421539478,4388,3026,7414,+
chr17,16382496,1.4616626311541565,1810,1061,2871,+
chr17,16382534,1.638922065857726,4086,2645,6731,+
chr17,16382535,1.638922065857726,4086,2645,6731,+
chr17,16382538,1.3442784521215894,2129,1427,3556,+
chr17,16382540,1.229962738586368,5968,4138,10106,+
chr17,16382593,0.7892114987186079,3314,2616,5930,+
chr17,16382594,1.4310589230931983,2794,2054,4848,+
chr17,16439035,1.1717456194933673,1650,1368,3018,+
chr17,16439036,1.1274755551509492,4234,3379,7613,+
chr17,16439037,0.9061009749975868,1770,1150,2920,+
chr17,16439040,1.4351435143514355,1147,791,1938,+
chr17,16439042,0.615986088358519,2612,2462,5074,+
chr17,16439043,1.4814888667331338,1437,1019,2456,+
chr17,16439336,0.7142544997678419,2273,1557,3830,+
chr17,16439539,2.0901648795111267,823,412,1235,+
chr17,16439543,1.5656222948982175,4628,2869,7497,+
chr17,16439544,1.3744660654959657,2895,1504,4399,+
chr17,16439545,1.3744660654959657,2895,1504,4399,+
chr17,16439561,0.6751359044352676,1522,1098,2620,+
chr17,16439601,1.5858150470219436,2697,1759,4456,+
chr17,16439611,1.2706962719298245,2700,2108,4808,+
chr17,16439630,0.70222442431972,2799,2136,4935,+
chr17,16439631,0.7330434925449956,3149,2017,5166,+
chr17,16440183,1.0385402228325884,561,456,1017,+
chr17,16440189,0.6553024496008586,4312,3148,7460,+
chr17,16440199,1.206114116553095,4662,3808,8470,+
chr17,16440200,1.3201560637834762,6285,3876,10161,+
chr17,16440211,1.3745242461593965,6823,4291,11114,+
chr17,16440225,1.1993328785688744,7445,4794,12239,+
chr17,16441079,1.4017207968374543,5117,4073,9190,+
chr17,16441224,0.5884710377930006,1352,932,2284,+
chr17,16441362,2.462665581835201,639,583,1222,+
chr17,16441369,0.9395124290095643,22729,17280,40009,+
chr17,16441370,0.9395124290095643,22729,17280,40009,+
chr17,16441371,1.09800813896091,42005,31728,73733,+
chr17,16441433,1.3035576348260645,7736,5617,13353,+
chr17,16441587,1.7513246202755213,1808,1340,3148,+
chr17,16441588,1.2414414414414414,2649,1849,4498,+
chr17,16441591,1.2897261200673067,4525,3598,8123,+
chr17,16441593,1.3753493894160689,4390,3079,7469,+
chr17,16441594,0.7472929292929292,2083,1649,3732,+
chr17,16441599,1.3516738353111883,2065,1677,3742,+
chr17,16441658,1.3369834350479508,3965,3440,7405,+
chr17,16441699,1.5540398497003758,8260,6910,15170,+
chr17,16441733,1.1455741751720865,5585,4212,9797,+
chr17,16441828,0.8552992518703242,7262,5399,12661,+
chr17,16684079,1.962051566828005,884,652,1536,+
chr17,16684081,1.7074268567141786,568,433,1001,+
chr17,18088021,2.35803296261557,837,438,1275,+
chr17,18088023,2.35803296261557,837,438,1275,+
chr17,18106465,3.614557485525227,759,371,1130,+
chr17,18106466,3.614557485525227,759,371,1130,+
chr17,18107153,1.6192722410671874,772,530,1302,+
chr17,18107165,1.2409368243320729,775,580,1355,+
chr17,18107187,9.221451104100947,811,633,1444,+
chr17,18209532,1.4535629346683112,707,510,1217,+
chr17,18650767,1.2972156566588968,624,421,1045,+
chr17,18650790,2.2104978354978355,644,395,1039,+
chr17,18650791,0.5571517621673461,1416,1074,2490,+
chr17,18650792,0.5571517621673461,1416,1074,2490,+
chr17,18650928,0.9751219825372368,820,527,1347,+
chr17,18650929,0.850707783124829,1213,825,2038,+
chr17,18651131,0.45515959095134795,611,460,1071,+
chr17,18651169,0.5692978246960972,618,520,1138,+
chr17,18651245,2.6861737718242984,856,568,1424,+
chr17,18651262,2.696103896103896,691,439,1130,+
chr17,18651277,1.6278311878768126,998,645,1643,+
chr17,18651346,1.4328905176362805,1609,1294,2903,+
chr17,18651415,2.2833434581670953,1958,1317,3275,+
chr17,18651424,0.6641548805935544,1347,907,2254,+
chr17,18651442,2.024551173853,1465,1028,2493,+
chr17,18651566,0.5977737323169112,1086,798,1884,+
chr17,18651574,1.6111111111111112,847,476,1323,+
chr17,18651589,1.923370834217788,1104,672,1776,+
chr17,18651596,2.0786185352308233,1238,803,2041,+
chr17,18677405,1.3987104513420303,703,701,1404,+
chr17,18677424,1.8685047193243913,1296,914,2210,+
chr17,18677425,1.46648811890543,1724,1342,3066,+
chr17,18790897,0.21264553251806748,674,376,1050,+
chr17,18790908,2.13107822410148,983,472,1455,+
chr17,18790910,1.2762336925694842,1529,730,2259,+
chr17,18790911,1.1702577124588345,1384,729,2113,+
chr17,18790921,1.3072012354970566,816,460,1276,+
chr17,18790971,0.5410714285714285,605,419,1024,+
chr17,18790974,0.2482373987161949,673,441,1114,+
chr17,18790977,0.5855543113101903,746,469,1215,+
chr17,18790981,0.522539715287807,920,523,1443,+
chr17,18798899,1.091293668122271,726,457,1183,+
chr17,18798900,1.091293668122271,726,457,1183,+
chr17,18805715,0.9642625081221572,741,569,1310,+
chr17,18805716,0.9642625081221572,741,569,1310,+
chr17,18806039,1.7385874246339363,733,515,1248,+
chr17,19188074,1.2721514660060638,1396,1179,2575,+
chr17,19188075,1.0258154555521894,1252,1065,2317,+
chr17,19671736,5.418748767481453,757,793,1550,+
chr17,19671900,2.367383515069706,779,499,1278,+
chr17,20205144,0.5890791913127924,784,481,1265,+
chr17,20205791,0.7400947980608031,749,469,1218,+
chr17,20227452,1.6054124563221221,3079,1860,4939,+
chr17,20227455,1.995489169751905,1850,1118,2968,+
chr17,20227492,1.7649750415973378,4242,2403,6645,+
chr17,20227493,1.7649750415973378,4242,2403,6645,+
chr17,20227518,2.31513020227854,1502,1011,2513,+
chr17,20231775,1.9208964183285537,1349,956,2305,+
chr17,20231779,2.1932193219321934,2923,2221,5144,+
chr17,20231781,1.650646628764676,4655,3438,8093,+
chr17,20232329,1.4440365167741385,623,447,1070,+
chr17,20232330,0.8732511572268163,729,492,1221,+
chr17,20314209,1.0972488701285987,711,574,1285,+
chr17,20314368,1.0581546134663342,623,400,1023,+
chr17,20314369,1.0581546134663342,623,400,1023,+
chr17,20314424,0.9728523616717033,962,705,1667,+
chr17,20314426,0.3776785248075983,1008,780,1788,+
chr17,27294364,1.008888727642129,868,640,1508,+
chr17,27294365,1.008888727642129,868,640,1508,+
chr17,27294375,0.5735812370883462,589,421,1010,+
chr17,27294383,3.229391371340524,620,471,1091,+
chr17,27294391,1.9780892222660882,910,595,1505,+
chr17,27294392,2.3190239170114197,1864,1646,3510,+
chr17,27294393,2.267414295447801,2400,1967,4367,+
chr17,27312402,0.9723407173460499,643,418,1061,+
chr17,28325552,2.3401544401544396,626,517,1143,+
chr17,28325554,2.3401544401544396,626,517,1143,+
chr17,28326786,1.4355419277429675,672,576,1248,+
chr17,28327041,0.45053437391873796,761,534,1295,+
chr17,28327042,0.5103665082594459,627,430,1057,+
chr17,28327326,9.066227396684209,1302,316,1618,+
chr17,28327327,7.890113119454107,1558,383,1941,+
chr17,28327329,5.779131167225388,936,260,1196,+
chr17,28327334,11.523917652545869,1701,557,2258,+
chr17,28327335,12.065517784479871,1635,532,2167,+
chr17,28327339,22.078300110938947,1209,848,2057,+
chr17,28327340,19.421445838898354,2207,1690,3897,+
chr17,28327341,14.552228730983739,2683,2144,4827,+
chr17,28327343,6.958537289946545,953,874,1827,+
chr17,28328006,3.3764713122927494,839,643,1482,+
chr17,28467780,0.7102554541275359,4886,2922,7808,+
chr17,28467781,0.8124906933506917,3957,2255,6212,+
chr17,28467782,0.770992569457485,20110,10234,30344,+
chr17,28467783,0.8157801955031263,26224,12430,38654,+
chr17,28467784,0.8279197250417355,30777,14331,45108,+
chr17,28467785,0.8381622893845844,15265,6507,21772,+
chr17,28467786,0.8203502736101176,8357,3776,12133,+
chr17,28467789,0.9543938231934141,9568,4270,13838,+
chr17,28467792,1.663305901905187,50504,23713,74217,+
chr17,28467793,1.6823283346109148,61576,29519,91095,+
chr17,28467794,1.618096842897633,75108,36956,112064,+
chr17,28467795,1.7735307841854275,37097,19662,56759,+
chr17,28467796,1.6804879863892912,30578,16938,47516,+
chr17,28467840,1.4257457368912476,1054,797,1851,+
chr17,28467845,0.5515296159687567,1147,837,1984,+
chr17,28467846,1.4619553157001746,2419,1350,3769,+
chr17,28467852,1.332226762002043,1738,1334,3072,+
chr17,28467873,1.3065330382233715,2945,1526,4471,+
chr17,28467887,2.1878070734726025,2681,2050,4731,+
chr17,28467891,1.4292265707715999,9299,6177,15476,+
chr17,28467912,1.4376690595089472,3715,2135,5850,+
chr17,28467915,1.3503514666679555,13565,8809,22374,+
chr17,28467917,1.3250261051320118,17441,11766,29207,+
chr17,28468028,0.6328237843042851,700,535,1235,+
chr17,28468031,0.5269903032837862,1363,895,2258,+
chr17,28468034,0.7316046908931787,1598,1165,2763,+
chr17,28468037,0.6111578568276403,2819,1863,4682,+
chr17,28468039,0.584247015430979,2610,1466,4076,+
chr17,28468041,0.5576664747649204,1452,771,2223,+
chr17,28468053,1.8802576733611214,826,405,1231,+
chr17,28468056,1.766563295134561,3398,2140,5538,+
chr17,28468057,1.8128369004025744,2516,1712,4228,+
chr17,28468063,1.5784951330863983,1382,987,2369,+
chr17,28468064,1.4006581653640482,1134,560,1694,+
chr17,28468070,1.635718789407314,1152,609,1761,+
chr17,28468071,1.3812989163154723,4033,3019,7052,+
chr17,28468073,1.1605356881494853,6324,4737,11061,+
chr17,28468074,1.180999742776301,6886,5242,12128,+
chr17,28468076,1.1005421935882516,6740,5119,11859,+
chr17,28468077,1.3594789356984476,2179,1055,3234,+
chr17,28468082,1.7240575141533712,1948,1071,3019,+
chr17,28468089,1.4620776020272284,5123,2747,7870,+
chr17,28468098,1.3659759993093326,3228,1715,4943,+
chr17,28468101,1.4135268021875367,10200,6781,16981,+
chr17,28468132,2.078484410658873,3642,2485,6127,+
chr17,28468137,1.4374235104669888,3984,2874,6858,+
chr17,28468153,0.7701485062540641,8079,6038,14117,+
chr17,28468294,1.0061809939224404,1343,971,2314,+
chr17,28468296,0.9265753490302892,1229,1013,2242,+
chr17,28468298,0.7004427202671517,1220,992,2212,+
chr17,28468309,1.0543900543900544,1632,922,2554,+
chr17,28468310,1.4135513356956049,2846,2395,5241,+
chr17,28468311,1.66760709079795,1902,2362,4264,+
chr17,28468312,1.617744127353912,1281,807,2088,+
chr17,28468313,1.726341558257919,1310,1663,2973,+
chr17,28468318,1.4598132493330334,1834,1173,3007,+
chr17,28684897,2.2322514573559182,836,512,1348,+
chr17,28719985,1.184030100334448,594,519,1113,+
chr17,28719989,1.086984536082474,2168,1754,3922,+
chr17,28719990,1.0543904235828658,5825,6843,12668,+
chr17,28719992,0.8146756373063391,5321,2858,8179,+
chr17,28719993,0.7814710277315706,32875,22284,55159,+
chr17,28719994,0.8146756373063391,5321,2858,8179,+
chr17,28722726,0.40014498359726514,1027,622,1649,+
chr17,28722728,0.3670007528703181,820,482,1302,+
chr17,28722735,1.548891396707382,914,537,1451,+
chr17,28722738,1.4182796258397214,2416,1523,3939,+
chr17,28722739,1.3130545538267862,3852,2178,6030,+
chr17,28722740,1.1148328614982577,1436,655,2091,+
chr17,28722744,0.9281353643861348,1389,1107,2496,+
chr17,28722746,1.2478799940736058,3433,2471,5904,+
chr17,28722775,1.3772970971779177,4585,3174,7759,+
chr17,28722778,1.221949834267617,2906,1476,4382,+
chr17,28722780,0.6957042541440427,2486,2005,4491,+
chr17,28722782,1.295943368607153,7294,3782,11076,+
chr17,28722784,1.295943368607153,7294,3782,11076,+
chr17,28722789,1.335178899554072,18634,12519,31153,+
chr17,28722802,1.2544400710411363,6209,4015,10224,+
chr17,28722814,1.1966958134605192,16306,11099,27405,+
chr17,28722815,1.1966958134605192,16306,11099,27405,+
chr17,28722816,1.2281171030009639,27321,18009,45330,+
chr17,28722817,1.262642443854462,19546,11828,31374,+
chr17,28722825,1.35760953044147,22892,15263,38155,+
chr17,28722835,0.871805620956852,12736,9592,22328,+
chr17,28724033,1.9944664031620554,695,439,1134,+
chr17,28724065,1.761967501097936,707,620,1327,+
chr17,28724114,1.6704980842911876,653,463,1116,+
chr17,28744200,1.7314427588686057,880,609,1489,+
chr17,28744202,1.716357889274556,1053,760,1813,+
chr17,28747846,0.9760493665935515,854,588,1442,+
chr17,28749071,1.5088019237295578,594,410,1004,+
chr17,28749416,1.123331725324186,710,501,1211,+
chr17,28749611,3.5712900853070466,944,636,1580,+
chr17,28749915,6.348821302696524,1056,177,1233,+
chr17,28749916,4.734201222570304,2388,397,2785,+
chr17,28749917,4.483659662659305,3916,658,4574,+
chr17,28749918,4.695641720879731,4999,829,5828,+
chr17,28749919,5.311980683340504,3791,642,4433,+
chr17,28749920,5.974243721192927,2539,417,2956,+
chr17,28749921,7.168470383597,1305,230,1535,+
chr17,28749927,11.907616295272264,1245,255,1500,+
chr17,28749930,19.21410572944648,2944,3515,6459,+
chr17,28749931,19.214105729446484,2944,3515,6459,+
chr17,28749939,1.4888901591516692,2400,5253,7653,+
chr17,28749940,1.170375374802045,1604,3484,5088,+
chr17,28749966,0.16475046567098106,848,1973,2821,+
chr17,28750003,0.5993340732519423,539,582,1121,+
chr17,28856559,1.8293973948167868,1395,885,2280,+
chr17,28856561,1.723791448029474,964,506,1470,+
chr17,28857939,0.3486238532110092,683,544,1227,+
chr17,28857947,0.44138117075802535,908,673,1581,+
chr17,28857960,0.6669717624148004,1180,789,1969,+
chr17,28857964,2.1990386716189643,914,596,1510,+
chr17,28857967,0.6261457426071088,1460,892,2352,+
chr17,28859073,2.666745683773419,839,635,1474,+
chr17,28859075,2.51693911395404,663,468,1131,+
chr17,28860603,3.5589557559903358,742,502,1244,+
chr17,28860730,0.9964836680948109,838,558,1396,+
chr17,29534253,3.092009192394505,573,550,1123,+
chr17,29534255,2.8368638212008297,704,659,1363,+
chr17,29534258,1.1021614310496948,668,525,1193,+
chr17,29545007,2.6353790613718413,656,553,1209,+
chr17,29545008,2.6353790613718413,656,553,1209,+
chr17,29545012,2.274195934025057,664,569,1233,+
chr17,30185190,2.8874992650221465,998,722,1720,+
chr17,30427475,6.962497784315861,566,469,1035,+
chr17,30442373,3.084841628959276,706,441,1147,+
chr17,30442375,3.084841628959276,706,441,1147,+
chr17,30442388,3.9701938901998566,809,580,1389,+
chr17,30464969,3.059296958219908,717,496,1213,+
chr17,30464986,2.6737001353610954,818,660,1478,+
chr17,30465637,0.3913214990138067,743,389,1132,+
chr17,30481178,2.093205823579789,837,451,1288,+
chr17,30481179,2.093205823579789,837,451,1288,+
chr17,30481196,1.7933618843683083,602,466,1068,+
chr17,30481201,1.9670867887334273,1346,999,2345,+
chr17,30492717,2.2511142398826984,868,592,1460,+
chr17,30631758,1.592488847390808,613,611,1224,+
chr17,30631759,1.592488847390808,613,611,1224,+
chr17,32193196,0.47787077676572226,559,450,1009,+
chr17,32350209,3.5423728813559316,835,471,1306,+
chr17,32350210,4.5015948244770785,1790,1026,2816,+
chr17,32350219,6.586744639376218,774,674,1448,+
chr17,32350220,15.21309371757802,1533,1589,3122,+
chr17,32350221,11.87429950854157,2657,2600,5257,+
chr17,32350274,0.34472728929216373,1031,1190,2221,+
chr17,32350281,0.3989361702127659,524,704,1228,+
chr17,32360895,3.166253805276031,701,466,1167,+
chr17,32367817,2.1527884938825737,983,709,1692,+
chr17,32367818,2.2257495590828924,630,431,1061,+
chr17,32367870,1.7981829980532125,651,535,1186,+
chr17,32367941,1.5898785425101214,692,569,1261,+
chr17,32369838,2.7616060834587453,923,679,1602,+
chr17,32444545,4.150505133816004,614,527,1141,+
chr17,32446961,1.3460185793049433,653,460,1113,+
chr17,32469052,1.3228188457739467,579,467,1046,+
chr17,32469065,0.9602774677210253,928,753,1681,+
chr17,32473803,2.022370902574866,906,669,1575,+
chr17,32473854,1.8507972665148065,624,438,1062,+
chr17,32474801,1.9438669438669438,747,480,1227,+
chr17,32477521,2.0828203643983882,1714,1170,2884,+
chr17,32477522,2.132116528999023,1170,833,2003,+
chr17,32477523,2.132116528999023,1170,833,2003,+
chr17,32477550,2.349,782,499,1281,+
chr17,32479287,2.36607294317218,633,392,1025,+
chr17,32479360,1.9199999999999997,819,614,1433,+
chr17,32480794,2.59230347203092,678,493,1171,+
chr17,32480810,2.675320286243946,2764,1926,4690,+
chr17,32480811,2.259992613205855,3755,2649,6404,+
chr17,32480812,2.7563162184189083,1067,817,1884,+
chr17,32480813,1.12353591160221,991,723,1714,+
chr17,32480840,0.5332397332397333,632,406,1038,+
chr17,32481006,4.227025012390866,807,525,1332,+
chr17,32481008,3.703769401330377,695,409,1104,+
chr17,32482085,2.6793355855855854,613,443,1056,+
chr17,32482086,2.6793355855855854,613,443,1056,+
chr17,34255351,2.169117647058824,589,479,1068,+
chr17,34255400,1.331760640176564,1184,956,2140,+
chr17,34256230,1.4166427551004348,1469,972,2441,+
chr17,34256262,0.4791176470588235,723,679,1402,+
chr17,34256265,1.9893084622383983,794,627,1421,+
chr17,34256750,0.5023559811521507,660,386,1046,+
chr17,34256811,0.5833655705996131,753,516,1269,+
chr17,34256824,2.4432890429424217,792,576,1368,+
chr17,34256838,1.505007743933919,910,744,1654,+
chr17,34256846,1.6565953038674033,1009,723,1732,+
chr17,34256980,1.3662889398183515,1629,1070,2699,+
chr17,34257047,1.935190886699508,966,671,1637,+
chr17,34257055,2.0080226521944318,924,814,1738,+
chr17,34983196,1.6856022877709491,828,478,1306,+
chr17,34983285,2.1503006012024053,628,498,1126,+
chr17,35004648,0.21581980094290204,823,414,1237,+
chr17,35004654,1.7410624613809045,1524,808,2332,+
chr17,35004656,2.110203391252359,1693,941,2634,+
chr17,35004658,2.5521108877367475,1205,726,1931,+
chr17,35004659,2.5996424440004207,823,513,1336,+
chr17,35268091,6.026474589835934,652,398,1050,+
chr17,35624457,1.434556251168746,611,424,1035,+
chr17,35624482,2.534822866344605,770,620,1390,+
chr17,35624483,2.534822866344605,770,620,1390,+
chr17,35624513,2.5626204238921004,531,518,1049,+
chr17,35624529,2.152839683680805,482,534,1016,+
chr17,35723939,4.825780085004619,677,489,1166,+
chr17,35809483,0.8903072204400755,777,243,1020,+
chr17,35809488,2.095244040690586,1298,430,1728,+
chr17,35820199,1.9660922734852695,785,513,1298,+
chr17,35820358,1.85662100456621,748,510,1258,+
chr17,35820363,0.6175892564690468,837,567,1404,+
chr17,35820395,1.4864562416331994,3363,2655,6018,+
chr17,35820396,1.4864562416331994,3363,2655,6018,+
chr17,35822683,2.632339381251125,696,462,1158,+
chr17,35822719,2.1654487920559573,711,435,1146,+
chr17,35824156,14.073120866855831,1799,1890,3689,+
chr17,35824157,9.817710994130996,2833,3346,6179,+
chr17,35824158,9.485152734431518,2669,3279,5948,+
chr17,35824159,8.05216545923042,2141,2961,5102,+
chr17,35836142,0.41385166354378944,670,472,1142,+
chr17,35836151,1.7383929542242036,570,540,1110,+
chr17,35836193,1.7247813411078716,695,489,1184,+
chr17,35836211,4.243054589479152,8035,9085,17120,+
chr17,35836212,4.243054589479152,8035,9085,17120,+
chr17,35844077,9.692052681961128,816,498,1314,+
chr17,35844083,6.416873245093234,1123,707,1830,+
chr17,35844086,5.289523406779817,1198,919,2117,+
chr17,35844145,3.7517699307279755,537,527,1064,+
chr17,35844527,22.265532924415364,744,522,1266,+
chr17,35844528,22.265532924415364,744,522,1266,+
chr17,35844671,5.39266987122359,935,517,1452,+
chr17,35844693,7.7362573069449185,1492,1357,2849,+
chr17,35844694,7.7362573069449185,1492,1357,2849,+
chr17,35844695,7.7362573069449185,1492,1357,2849,+
chr17,35844740,1.599200196065858,1858,1778,3636,+
chr17,35844741,1.5078895241082566,2406,2317,4723,+
chr17,35844743,1.7808219178082187,779,815,1594,+
chr17,35844754,0.2622622622622623,654,539,1193,+
chr17,35844761,1.3835237973464627,2617,1853,4470,+
chr17,35844762,1.8314756740190121,3293,2529,5822,+
chr17,35844765,0.46039090201504795,1013,745,1758,+
chr17,35844807,3.214617958539354,2364,1472,3836,+
chr17,35844849,8.332083158205482,592,532,1124,+
chr17,35844991,13.339013450766435,582,573,1155,+
chr17,35844992,13.339013450766435,582,573,1155,+
chr17,35847073,12.327107722103639,1344,139,1483,+
chr17,35847074,11.898412200462085,1907,182,2089,+
chr17,35847075,11.857869045290588,2974,269,3243,+
chr17,35847077,16.789940038731373,2967,273,3240,+
chr17,35847079,17.700673188435655,2113,185,2298,+
chr17,35847080,27.66254285878929,1378,131,1509,+
chr17,35847083,72.61493152355729,2115,417,2532,+
chr17,35847085,70.54621936471564,3920,1888,5808,+
chr17,35847086,74.34396987612129,2857,1797,4654,+
chr17,36486747,3.1562938878982347,705,446,1151,+
chr17,36492852,1.2628282824688117,795,547,1342,+
chr17,36493928,2.0198559670781893,676,485,1161,+
chr17,36495348,2.4551707275149313,1008,775,1783,+
chr17,36578054,1.622626475310176,661,458,1119,+
chr17,36579285,2.0616625443062526,1013,655,1668,+
chr17,36953058,1.3922269548680217,659,529,1188,+
chr17,36953161,4.430465107827525,668,410,1078,+
chr17,36953227,2.061350407881895,2739,1917,4656,+
chr17,36953228,2.0062350657108725,1953,1487,3440,+
chr17,36953229,2.0062350657108725,1953,1487,3440,+
chr17,36990782,1.2182116488925347,1439,735,2174,+
chr17,36990783,1.3738273348086398,1945,1008,2953,+
chr17,36990784,1.3738273348086398,1945,1008,2953,+
chr17,36990785,2.0687096636653237,2663,1366,4029,+
chr17,36990786,2.048564189189189,1187,591,1778,+
chr17,36990793,2.9201570680628275,678,381,1059,+
chr17,36990795,2.283760683760684,667,389,1056,+
chr17,36990797,0.7866271443784608,2555,1655,4210,+
chr17,36990802,1.8879813879813883,886,545,1431,+
chr17,36990804,1.3127770123337923,908,562,1470,+
chr17,36990823,1.4478933109118086,1318,891,2209,+
chr17,36990831,1.8375605585636934,1611,1209,2820,+
chr17,37019050,1.6097945789025274,910,736,1646,+
chr17,37512971,0.23992380136071836,1140,646,1786,+
chr17,37512972,0.24082901212255917,1400,805,2205,+
chr17,37512973,0.2999712671200077,695,393,1088,+
chr17,37513029,7.869433304936157,1566,460,2026,+
chr17,37513030,6.773058642834424,1427,399,1826,+
chr17,37513038,41.121856508875744,758,675,1433,+
chr17,37513039,38.34361062968544,1967,2529,4496,+
chr17,37513040,38.34361062968544,1967,2529,4496,+
chr17,38306575,0.9688195991091314,579,448,1027,+
chr17,38306605,1.7566332259402215,628,476,1104,+
chr17,38320738,1.93175334838742,619,467,1086,+
chr17,38322199,2.6133006935944514,955,816,1771,+
chr17,38322201,2.3492063492063493,1463,1280,2743,+
chr17,38322202,2.2133940574501363,995,888,1883,+
chr17,38322209,2.3086592178770955,550,536,1086,+
chr17,38323049,1.3594582846716539,775,564,1339,+
chr17,38728359,24.1984682007795,555,575,1130,+
chr17,38752760,0.6270037015140479,2128,1205,3333,+
chr17,38752761,0.6480652006008473,1790,950,2740,+
chr17,38752769,1.9824637450352978,886,585,1471,+
chr17,38752776,2.076555023923445,712,505,1217,+
chr17,38752778,1.9058365758754865,631,513,1144,+
chr17,38752814,2.714538495617067,1684,1399,3083,+
chr17,38753149,3.0326821938392183,597,483,1080,+
chr17,38753161,0.5845751300296755,1144,813,1957,+
chr17,38753194,1.5081902998361942,1032,738,1770,+
chr17,38753237,1.2387148598132414,2735,2137,4872,+
chr17,38753264,0.6319045514803359,1429,960,2389,+
chr17,38753267,1.579591836734694,1160,839,1999,+
chr17,38753294,1.7271331609566904,949,727,1676,+
chr17,38753317,1.3890291262135923,1756,1029,2785,+
chr17,38755905,1.9424313628493692,848,621,1469,+
chr17,38755935,1.452723791538805,1815,1073,2888,+
chr17,38755946,1.5277218868768163,2075,1277,3352,+
chr17,38760505,1.9152235884780668,1428,1236,2664,+
chr17,38760567,0.7342354165723856,1725,1162,2887,+
chr17,38762426,1.6510888351192532,1675,1051,2726,+
chr17,38764123,2.427455357142857,674,503,1177,+
chr17,38764127,1.868227424749164,734,574,1308,+
chr17,38764129,1.3929355994912709,1524,929,2453,+
chr17,38878136,3.869637150919168,590,523,1113,+
chr17,38898438,0.6062717770034843,695,419,1114,+
chr17,38898450,1.6841919548341566,773,653,1426,+
chr17,38918777,2.1034561988343174,901,569,1470,+
chr17,38918914,0.4116964665815241,538,506,1044,+
chr17,38919939,7.595539712874392,2004,1763,3767,+
chr17,38919940,7.595539712874394,2004,1763,3767,+
chr17,38919941,7.53750499546662,1699,1539,3238,+
chr17,38919951,2.250298850574713,436,724,1160,+
chr17,38919952,2.43866664175352,1279,1814,3093,+
chr17,38919953,2.1065387045401693,791,1322,2113,+
chr17,38920798,3.086256961406937,760,515,1275,+
chr17,38921049,0.4304182509505703,565,525,1090,+
chr17,38921050,0.4814394553412223,879,795,1674,+
chr17,38921052,1.0229753340035659,836,727,1563,+
chr17,38921201,19.79223976535341,1229,935,2164,+
chr17,38921202,15.944839431640343,1758,1457,3215,+
chr17,38921475,1.8740973893723387,722,490,1212,+
chr17,39200311,1.1027570078962143,2523,2027,4550,+
chr17,39200312,0.8452845040613312,5694,4249,9943,+
chr17,39200313,0.8429495006243193,7429,4423,11852,+
chr17,39200314,0.7784762924604581,29123,18855,47978,+
chr17,39200315,0.7840403089333337,28494,18404,46898,+
chr17,39200316,0.7390798513209121,28145,16131,44276,+
chr17,39200318,0.7412921284815359,46809,25836,72645,+
chr17,39200319,0.7731683580048011,37971,18733,56704,+
chr17,39200320,0.7487327844869796,60503,33133,93636,+
chr17,39200321,0.7955663593382917,33208,16064,49272,+
chr17,39201210,1.2811649747323195,12618,5968,18586,+
chr17,39201211,1.182192244034929,19946,11148,31094,+
chr17,39201212,1.2304173650852943,26831,15788,42619,+
chr17,39201261,1.2312029640049467,42137,29091,71228,+
chr17,39202322,1.3145144909770352,13951,7522,21473,+
chr17,39202334,1.4191250223449259,8253,4377,12630,+
chr17,39202394,1.0713614748044822,59419,38230,97649,+
chr17,39202395,1.3710139758420627,41943,23549,65492,+
chr17,39202396,1.242804170698127,164751,103312,268063,+
chr17,39202397,1.3825799155127223,199943,128482,328425,+
chr17,39202398,1.5581657246652783,147486,96396,243882,+
chr17,39202399,1.5578996372560459,184401,121680,306081,+
chr17,39202400,1.726315203047172,135871,90811,226682,+
chr17,39202986,1.0979632031092563,7076,5066,12142,+
chr17,39202987,1.2885282824472024,26617,17310,43927,+
chr17,39202989,1.4915214097861706,38919,22586,61505,+
chr17,39202990,1.6891225217722938,58104,35162,93266,+
chr17,39203008,1.0212040028354026,84539,49942,134481,+
chr17,39203009,1.2404116080118843,50976,27539,78515,+
chr17,39203014,0.9729016501552027,143882,88686,232568,+
chr17,39203015,1.0196933082720492,226642,141459,368101,+
chr17,39203017,1.1680317787415753,64604,36560,101164,+
chr17,39203022,1.2421434694992053,318162,218726,536888,+
chr17,39203023,1.2421434694992053,318162,218726,536888,+
chr17,39203024,1.2165953743894855,540016,362970,902986,+
chr17,39203026,1.252327019949079,520375,350165,870540,+
chr17,39203027,1.24184931202369,383019,259984,643003,+
chr17,39203032,1.1447546467892873,123170,86955,210125,+
chr17,39203044,1.1791061740246935,234110,171306,405416,+
chr17,39203050,1.6796245921720032,91896,89015,180911,+
chr17,39204076,1.2148816459515126,8943,5128,14071,+
chr17,39204087,1.5215214573337223,20260,12347,32607,+
chr17,39204116,1.3783606319126065,26963,18385,45348,+
chr17,39204549,1.3485596387086052,25274,15247,40521,+
chr17,39204555,1.3653978786877086,26476,18848,45324,+
chr17,39204556,1.2821700383602739,53724,38793,92517,+
chr17,39462339,2.0998677248677247,634,629,1263,+
chr17,39462340,1.9048301544867101,1070,900,1970,+
chr17,39471270,4.193535631561234,1242,750,1992,+
chr17,39471271,2.6329501915708806,858,494,1352,+
chr17,39980828,1.6865146291552324,841,465,1306,+
chr17,39980863,3.030765504891378,634,458,1092,+
chr17,39981118,3.829079041127257,848,476,1324,+
chr17,39981169,1.5913278974024636,788,578,1366,+
chr17,39984382,3.417646589828225,594,486,1080,+
chr17,39986616,1.2890772128060264,1368,1061,2429,+
chr17,39986617,1.2890772128060264,1368,1061,2429,+
chr17,39986618,1.2890772128060264,1368,1061,2429,+
chr17,39986685,0.5230787392279542,632,590,1222,+
chr17,39988705,0.6066108028789949,1250,925,2175,+
chr17,39994960,2.3108751358833812,652,567,1219,+
chr17,39995011,1.80958820095616,859,508,1367,+
chr17,39995185,2.1922781733211103,923,624,1547,+
chr17,39995202,3.5105519480519485,691,447,1138,+
chr17,39995242,2.3501560995492996,1338,991,2329,+
chr17,39995445,2.6357947434292868,1481,892,2373,+
chr17,39995446,2.6357947434292868,1481,892,2373,+
chr17,39995501,2.162330247587344,1057,945,2002,+
chr17,39996259,0.7691668172781493,1037,1005,2042,+
chr17,39996261,0.7691668172781493,1037,1005,2042,+
chr17,39997347,1.9775749240363913,1897,1411,3308,+
chr17,39997598,14.831920353113295,1186,138,1324,+
chr17,39997599,15.327593566668442,986,106,1092,+
chr17,39997605,17.932396118883645,1369,245,1614,+
chr17,39997606,17.404003576721834,1549,323,1872,+
chr17,39997607,26.52471617996767,2090,648,2738,+
chr17,39997608,34.49894333315655,1086,507,1593,+
chr17,39997614,20.189038699187485,1336,923,2259,+
chr17,39997615,20.189038699187485,1336,923,2259,+
chr17,39997620,6.561587456042277,791,770,1561,+
chr17,39997637,6.543611488359044,459,644,1103,+
chr17,39997659,0.3023274435282875,2962,2755,5717,+
chr17,39997660,0.32040041353471865,3249,3029,6278,+
chr17,39997661,0.3173928373167489,3516,3262,6778,+
chr17,39997662,0.42148019201350423,798,800,1598,+
chr17,39997717,4.182539500285275,1067,739,1806,+
chr17,39997761,0.7539088530921663,1048,676,1724,+
chr17,39997762,0.8670771459616081,797,501,1298,+
chr17,39997840,3.822463615510195,1153,957,2110,+
chr17,39997841,3.7210813698544105,995,795,1790,+
chr17,39997877,2.081346870709734,2169,1837,4006,+
chr17,39997878,2.3197718020727986,2114,1776,3890,+
chr17,39997890,4.105769230769232,548,467,1015,+
chr17,40088441,1.824370631951319,635,393,1028,+
chr17,40088442,0.3727448676297781,718,628,1346,+
chr17,40088443,0.41968001682329875,1065,827,1892,+
chr17,40088480,4.4967490247074124,1234,768,2002,+
chr17,40088481,4.4967490247074124,1234,768,2002,+
chr17,40088485,1.89986420769567,2524,1611,4135,+
chr17,40088486,2.7355615628427667,2168,1606,3774,+
chr17,40123020,0.6107220755366777,759,280,1039,+
chr17,40123021,0.6107220755366777,759,280,1039,+
chr17,40123168,5.75980272380662,637,440,1077,+
chr17,40123276,0.7960005063111165,1615,1101,2716,+
chr17,40123277,1.0754871235863197,876,536,1412,+
chr17,40123278,0.493366224414961,739,565,1304,+
chr17,40123282,2.2886280408005146,1167,734,1901,+
chr17,40126194,3.07283950617284,916,566,1482,+
chr17,40126196,3.07283950617284,916,566,1482,+
chr17,40126240,2.3179102106748903,754,519,1273,+
chr17,40126244,2.3169523251085185,604,503,1107,+
chr17,40130065,8.335027100271002,765,285,1050,+
chr17,40130066,9.399430395870718,1061,407,1468,+
chr17,40130083,8.450296694548546,2107,3864,5971,+
chr17,40130084,5.935423400681533,2741,5250,7991,+
chr17,40130085,5.935423400681533,2741,5250,7991,+
chr17,40130086,4.250377985150879,1794,3894,5688,+
chr17,40130131,0.3704536804470406,397,739,1136,+
chr17,40130139,0.46165684353309233,980,1454,2434,+
chr17,40134281,0.41022218732825627,949,541,1490,+
chr17,40134282,0.41022218732825627,949,541,1490,+
chr17,40135245,17.70873176998932,1512,1196,2708,+
chr17,40135246,16.338639458513917,1709,1424,3133,+
chr17,40135247,16.338639458513917,1709,1424,3133,+
chr17,40135256,2.831044426529989,924,960,1884,+
chr17,40161830,2.1646860491082798,971,539,1510,+
chr17,40161852,2.7201281362575087,2459,1573,4032,+
chr17,40161854,3.3010831879585534,2157,1385,3542,+
chr17,40162001,1.7106525911708252,1704,1041,2745,+
chr17,40162002,1.6714458711195315,4448,3011,7459,+
chr17,40162020,1.9734193765834858,6091,4641,10732,+
chr17,40162022,1.6654063208551069,10397,7442,17839,+
chr17,40162023,1.5632256287237398,9986,7369,17355,+
chr17,40162025,1.4990829120618083,7554,5934,13488,+
chr17,40162026,2.007801864835985,1878,1288,3166,+
chr17,40287981,1.174948180084258,660,487,1147,+
chr17,40289464,2.2121417966107493,902,718,1620,+
chr17,40293956,2.7044582494331553,858,606,1464,+
chr17,40294370,1.2334311249043755,967,742,1709,+
chr17,40294418,2.1833246346555324,576,478,1054,+
chr17,40294419,0.9214924419842454,1790,1341,3131,+
chr17,40294421,1.1415877187205836,2637,1874,4511,+
chr17,40300968,0.9841744232667687,835,654,1489,+
chr17,40301468,2.2938777644167927,1124,616,1740,+
chr17,40301470,2.2938777644167927,1124,616,1740,+
chr17,40301538,2.357142857142857,659,384,1043,+
chr17,40301571,2.055797353760446,1242,717,1959,+
chr17,40301572,2.236158192090396,1978,1454,3432,+
chr17,40301574,2.150046900770417,3060,2318,5378,+
chr17,40301576,2.0886164319461424,3274,2597,5871,+
chr17,40301578,2.3396186764481124,3498,2907,6405,+
chr17,40301579,1.5204484469313508,9854,6301,16155,+
chr17,40301580,1.6420290669755484,10265,7433,17698,+
chr17,40301581,1.6207267058214607,14186,9727,23913,+
chr17,40301582,1.6807077792391254,3493,2280,5773,+
chr17,40443801,2.7133052166641654,683,531,1214,+
chr17,40443830,0.5491141034727144,595,414,1009,+
chr17,40443973,1.4080524777543117,1190,778,1968,+
chr17,40443977,0.6076056338028171,718,567,1285,+
chr17,40443993,0.5606481481481481,864,404,1268,+
chr17,40443994,2.1301587301587297,792,584,1376,+
chr17,40444006,1.76941354453673,2205,1434,3639,+
chr17,40444010,1.7318980291345332,702,388,1090,+
chr17,40452987,2.781647318960752,951,602,1553,+
chr17,40453006,0.48865026162591085,1828,1059,2887,+
chr17,40453008,1.5655371199821917,3043,1958,5001,+
chr17,40453010,1.5655371199821917,3043,1958,5001,+
chr17,40453028,2.1816106268161057,1827,1313,3140,+
chr17,40453035,1.5063252538834209,8452,5541,13993,+
chr17,40453036,1.5177341109741156,9622,6286,15908,+
chr17,40453943,2.3034205231388327,635,496,1131,+
chr17,40454009,1.4721340107970784,882,535,1417,+
chr17,40454012,2.327350167325829,764,691,1455,+
chr17,40454026,1.9043043435630944,995,657,1652,+
chr17,40456541,5.176154844782401,1660,1149,2809,+
chr17,40456542,5.0649350649350655,1169,769,1938,+
chr17,40456548,2.2393410397394105,963,763,1726,+
chr17,40456642,1.1156343593850775,2080,1557,3637,+
chr17,40456665,1.4726676494479376,978,772,1750,+
chr17,40456671,1.3488531490133993,1862,1362,3224,+
chr17,40456874,1.3748601167603716,1377,1106,2483,+
chr17,40456933,1.669577127204246,1695,1297,2992,+
chr17,40456964,0.9719848867147083,6691,5146,11837,+
chr17,40457003,0.4672445820433436,1028,849,1877,+
chr17,40457035,1.5612412810688674,2704,2105,4809,+
chr17,40457186,1.57949473501755,1349,981,2330,+
chr17,40457207,1.601135135135135,1558,1109,2667,+
chr17,40457359,8.757958412098299,911,574,1485,+
chr17,40457360,7.755673508197389,10216,7200,17416,+
chr17,40457361,12.189459798451624,2853,2568,5421,+
chr17,40457362,7.88762613828972,9765,6966,16731,+
chr17,40457389,3.8072940522392775,8483,10258,18741,+
chr17,40457390,2.9867895983561388,7509,8434,15943,+
chr17,40457394,0.6582077769642927,1945,2257,4202,+
chr17,40457598,1.445103062075539,1564,1198,2762,+
chr17,40457617,1.3968520872030503,1133,964,2097,+
chr17,41688884,0.896502106823231,1070,846,1916,+
chr17,41688886,0.896502106823231,1070,846,1916,+
chr17,41688889,0.5343620288297967,724,736,1460,+
chr17,41688989,0.46439294787897456,695,418,1113,+
chr17,41689008,1.6025157232704403,1182,688,1870,+
chr17,41689011,2.0507855224255573,3378,2193,5571,+
chr17,41689012,2.2594559353936425,2557,1558,4115,+
chr17,41689014,1.6413662239089184,864,681,1545,+
chr17,41689018,1.5048567870485678,911,729,1640,+
chr17,41689817,3.6769759450171815,1283,678,1961,+
chr17,41689824,1.6142133082747643,2186,1461,3647,+
chr17,41689830,1.4184376931201705,4170,2525,6695,+
chr17,41689832,1.6881406637239518,3257,1842,5099,+
chr17,41689833,1.5661000944287065,3316,2117,5433,+
chr17,41689834,1.5661000944287065,3316,2117,5433,+
chr17,41689841,1.0056679199340275,5458,3795,9253,+
chr17,41689844,1.475564292242167,4153,2973,7126,+
chr17,41689845,1.475564292242167,4153,2973,7126,+
chr17,41689869,2.402943182414354,1969,1555,3524,+
chr17,41691113,0.6870582530157,1770,1268,3038,+
chr17,41691120,2.3062157221206583,695,546,1241,+
chr17,41691276,1.3131085407562326,3650,2886,6536,+
chr17,41691366,1.8258766211487,1457,1120,2577,+
chr17,41691472,1.6402810178853942,1825,1202,3027,+
chr17,41812969,5.648654322957217,2188,1138,3326,+
chr17,41812970,6.8892683245663,4256,2223,6479,+
chr17,41812971,5.811700680272108,1085,734,1819,+
chr17,41812972,6.948031961288453,2625,1295,3920,+
chr17,41812976,1.9331209932647695,1219,851,2070,+
chr17,41812986,3.0056053866942536,1698,1067,2765,+
chr17,41812987,2.1892803598200903,1286,666,1952,+
chr17,41813006,0.48777588958866475,823,735,1558,+
chr17,41813219,2.0301783264746227,591,566,1157,+
chr17,41813220,1.6890879986877732,2584,1729,4313,+
chr17,41813221,1.5918633976929757,2047,1272,3319,+
chr17,41817099,2.5505285412262158,623,472,1095,+
chr17,41817104,2.361381849685944,622,485,1107,+
chr17,41818115,1.9670781893004117,955,755,1710,+
chr17,41818118,1.5293278150421008,683,636,1319,+
chr17,41818219,1.8393665158371038,812,424,1236,+
chr17,41818238,1.4583333333333337,839,575,1414,+
chr17,41818383,1.8423913043478262,790,482,1272,+
chr17,41818385,1.4870780399274046,772,550,1322,+
chr17,41818428,1.7472815580965566,1711,1368,3079,+
chr17,41818482,1.6029637661516218,886,650,1536,+
chr17,41818484,0.6772486772486772,1227,920,2147,+
chr17,41819215,2.287272727272727,628,494,1122,+
chr17,41819370,2.18716020821284,651,454,1105,+
chr17,41819530,1.8249119900600541,704,438,1142,+
chr17,41819651,5.364770459081837,826,500,1326,+
chr17,41820269,1.0175520491356738,5016,3648,8664,+
chr17,41820270,1.4058744993324432,2807,1903,4710,+
chr17,41820271,1.0096487212446497,6765,5025,11790,+
chr17,41820273,0.987743912272214,1749,1377,3126,+
chr17,41820301,1.4112615281766108,1428,926,2354,+
chr17,41820346,1.5297228246338497,1225,820,2045,+
chr17,41820993,1.9893428063943162,643,562,1205,+
chr17,41821710,0.5785540022460597,746,526,1272,+
chr17,41821734,1.4985727888322506,2249,1445,3694,+
chr17,41821735,1.2122867114788003,1630,966,2596,+
chr17,41821745,1.7488846398980245,685,522,1207,+
chr17,41821748,4.127457948353471,561,468,1029,+
chr17,41821767,1.6428543980325094,1335,981,2316,+
chr17,41821791,1.583232141914366,832,610,1442,+
chr17,41821800,2.601540023692672,714,621,1335,+
chr17,41822232,1.6177357456140349,956,683,1639,+
chr17,41822245,1.784174624829468,1005,732,1737,+
chr17,41822280,1.5454074835665366,4620,3586,8206,+
chr17,41822281,1.589342758367615,3201,2614,5815,+
chr17,41822289,1.4078524240623582,1988,1707,3695,+
chr17,41822340,1.4464912280701754,775,607,1382,+
chr17,41822459,2.579606440071556,720,558,1278,+
chr17,41822460,2.579606440071556,720,558,1278,+
chr17,41822473,2.8009038946953577,2983,2202,5185,+
chr17,41822474,3.3920319401970778,1093,871,1964,+
chr17,41822477,3.052631578947368,579,455,1034,+
chr17,41822485,1.9187101108498488,815,457,1272,+
chr17,41822525,1.7056688405583262,1155,720,1875,+
chr17,41822526,1.2525754528566473,3264,2679,5943,+
chr17,41822527,0.5448807557080527,676,548,1224,+
chr17,41822528,1.6810253217548117,1820,1578,3398,+
chr17,41822571,1.9226263580538496,865,729,1594,+
chr17,41822577,1.3546328033160162,5376,3931,9307,+
chr17,41822723,2.0331325301204823,863,663,1526,+
chr17,41822747,2.22003388394748,952,786,1738,+
chr17,41822832,2.346153846153846,1158,702,1860,+
chr17,41822955,2.218057702215353,1012,646,1658,+
chr17,41822989,0.7450798305637015,1576,1115,2691,+
chr17,41822999,1.5971124359409288,2462,2060,4522,+
chr17,41823088,2.4863671274961603,1125,335,1460,+
chr17,41823107,0.1314906760149747,3623,668,4291,+
chr17,41823124,18.308352049972527,5723,391,6114,+
chr17,41823125,28.133858267716537,1190,126,1316,+
chr17,41823126,12.471308134742188,7249,376,7625,+
chr17,41823127,13.918188779784105,8095,399,8494,+
chr17,41823128,16.86492787910097,6918,324,7242,+
chr17,41823129,13.876491054791321,11019,585,11604,+
chr17,41823130,13.707957234373097,12374,718,13092,+
chr17,41823131,13.811412934098195,11988,716,12704,+
chr17,41823132,23.17369822015185,12647,1103,13750,+
chr17,41823133,26.799120955004057,11384,1161,12545,+
chr17,41823134,22.37889897804941,10729,1368,12097,+
chr17,41823136,36.358785506178464,7309,3078,10387,+
chr17,41823137,33.55944900408918,8214,4654,12868,+
chr17,41823138,33.559449004089174,8214,4654,12868,+
chr17,41975043,3.0577659556333088,635,453,1088,+
chr17,42562886,1.0403103298611112,766,575,1341,+
chr17,42562887,1.3456400468553789,1142,923,2065,+
chr17,42562925,1.7233130218912212,663,421,1084,+
chr17,42562998,1.80460358056266,587,459,1046,+
chr17,42563038,1.19376026272578,726,629,1355,+
chr17,42563040,1.19376026272578,726,629,1355,+
chr17,42563240,1.8390370370370368,1220,749,1969,+
chr17,42563241,1.8390370370370368,1220,749,1969,+
chr17,42563244,2.644001307616868,673,436,1109,+
chr17,42563247,1.8583171013323496,1637,1012,2649,+
chr17,42563962,1.7706515127306401,1225,868,2093,+
chr17,42564456,2.111771700356718,739,434,1173,+
chr17,42564462,0.30094043887147337,527,483,1010,+
chr17,42564463,2.7174947145877377,790,515,1305,+
chr17,42564470,1.7881609577652142,848,581,1429,+
chr17,42564728,2.712992798341582,968,667,1635,+
chr17,42564737,2.014851485148515,665,403,1068,+
chr17,42564990,1.9837930180227585,660,599,1259,+
chr17,42564995,2.111647058823529,578,424,1002,+
chr17,42565011,0.5475868844406238,636,478,1114,+
chr17,42565239,1.1407194897023152,1178,903,2081,+
chr17,42565262,1.6094700260642918,1709,1150,2859,+
chr17,42565263,1.6094700260642918,1709,1150,2859,+
chr17,42565944,1.801581595974119,715,427,1142,+
chr17,42565946,0.4504923413566739,548,456,1004,+
chr17,42566079,1.6863727454909818,692,498,1190,+
chr17,42567630,3.672682900937112,660,403,1063,+
chr17,42568920,1.2467811158798283,580,465,1045,+
chr17,42568922,1.2467811158798283,580,465,1045,+
chr17,42569246,3.0019230769230765,891,399,1290,+
chr17,42569268,1.4716327726131435,1963,932,2895,+
chr17,42569269,0.4016303807535541,807,478,1285,+
chr17,42569280,2.5419642857142857,1532,734,2266,+
chr17,42569283,1.6212588028169013,3335,1703,5038,+
chr17,42569284,1.6212588028169013,3335,1703,5038,+
chr17,42569515,1.8067654109951528,4443,2557,7000,+
chr17,42569538,1.409348774617472,9141,4975,14116,+
chr17,42569539,1.2741185296324082,6947,3740,10687,+
chr17,42569540,1.2741185296324082,6947,3740,10687,+
chr17,42569541,1.1809055242264808,10881,6656,17537,+
chr17,42569542,1.594936100829662,5533,3416,8949,+
chr17,42569575,1.5149969394001224,4784,3363,8147,+
chr17,42569578,1.253203517190299,5623,3360,8983,+
chr17,42570054,1.840681818181818,622,399,1021,+
chr17,42570055,1.6777029422190712,815,454,1269,+
chr17,42570103,2.188907284768212,1016,754,1770,+
chr17,42570109,1.5482106222931389,1131,855,1986,+
chr17,42570115,1.531429724971963,2106,1574,3680,+
chr17,42571579,1.51506865400188,1383,1007,2390,+
chr17,42571580,1.0350566326176085,960,701,1661,+
chr17,42571750,0.4922267400143506,685,451,1136,+
chr17,42572272,1.8595518044722177,621,517,1138,+
chr17,42572372,1.0103440507342236,861,645,1506,+
chr17,42572597,0.5066851083448594,627,481,1108,+
chr17,42609731,3.0823613086770982,698,369,1067,+
chr17,42610528,2.7247826604739793,879,310,1189,+
chr17,42610530,2.251119153515358,1069,404,1473,+
chr17,42610535,1.9685356397256193,1227,478,1705,+
chr17,42610536,1.9685356397256193,1227,478,1705,+
chr17,42610541,1.7991258463127282,2964,1404,4368,+
chr17,42610543,1.7855035058520985,4704,2420,7124,+
chr17,42610544,1.7656995803478948,2467,1318,3785,+
chr17,42610546,1.8124795714894464,2576,1356,3932,+
chr17,42610563,2.0349480203494803,1149,684,1833,+
chr17,42610564,1.512605042016807,1407,747,2154,+
chr17,42610566,1.6315789473684212,1239,759,1998,+
chr17,42610567,1.8222917800762117,1556,834,2390,+
chr17,42613941,3.0534433770802325,727,388,1115,+
chr17,42613943,3.0534433770802325,727,388,1115,+
chr17,42615067,2.091613455424994,2978,1950,4928,+
chr17,42615068,2.39157829384838,2811,1755,4566,+
chr17,42615069,2.143680716107282,3834,2563,6397,+
chr17,42615070,2.07455619752483,2812,1941,4753,+
chr17,42615071,2.009186375344489,2291,1616,3907,+
chr17,42615072,2.057681894586949,2095,1492,3587,+
chr17,42615142,1.5224735083875136,758,617,1375,+
chr17,42615148,1.0953567047102122,1015,726,1741,+
chr17,42615150,1.6416472270121534,1388,1052,2440,+
chr17,42773456,1.759785666052199,1080,590,1670,+
chr17,42773465,1.630941058006194,673,433,1106,+
chr17,42773484,1.8333754969116003,1241,758,1999,+
chr17,42773797,2.280353541181596,1341,1043,2384,+
chr17,42775397,1.0698917170580788,633,546,1179,+
chr17,42775399,1.0698917170580788,633,546,1179,+
chr17,42778972,3.0227887601528907,662,488,1150,+
chr17,42779370,1.8442367601246104,591,427,1018,+
chr17,42779523,0.8193954190035106,1264,786,2050,+
chr17,42838157,0.46140950315137236,964,699,1663,+
chr17,42838765,0.4429472477064221,617,435,1052,+
chr17,42839335,0.4861205375322383,954,555,1509,+
chr17,42839336,2.0329561246773875,639,437,1076,+
chr17,42839351,1.5891330891330893,684,454,1138,+
chr17,42839354,2.5455729166666665,1172,703,1875,+
chr17,42839356,1.6273646022285566,627,453,1080,+
chr17,42839363,2.3834719072814314,859,566,1425,+
chr17,42841617,2.398078342875612,789,571,1360,+
chr17,42841641,2.0113225056463735,625,529,1154,+
chr17,42842002,6.048412014378747,757,559,1316,+
chr17,42842115,0.3460118761033541,587,602,1189,+
chr17,42842116,0.3460118761033541,587,602,1189,+
chr17,42842130,0.3530591149360329,536,486,1022,+
chr17,42998401,0.39881610939262574,800,547,1347,+
chr17,42998402,0.8239326373057478,728,506,1234,+
chr17,42998413,0.4329921427734214,640,444,1084,+
chr17,42998422,1.6883914063910448,667,381,1048,+
chr17,42998434,0.5112242588821,778,490,1268,+
chr17,42998437,0.5535552004184805,3886,1848,5734,+
chr17,42998438,0.5161444821587438,6184,3072,9256,+
chr17,42998439,0.5451756963134432,5584,2679,8263,+
chr17,42998447,1.5044737989523267,3615,1466,5081,+
chr17,42998449,1.5818867252340252,6956,3103,10059,+
chr17,42998450,1.6954525836701066,4431,1985,6416,+
chr17,42998454,1.4420020473034858,1514,806,2320,+
chr17,42998457,1.5114656407935432,1144,490,1634,+
chr17,42998459,1.2795893719806763,1955,1103,3058,+
chr17,42998460,1.2521313338871158,3400,1690,5090,+
chr17,42998743,0.3736278237927629,863,502,1365,+
chr17,42998747,1.0321822198971882,22336,12588,34924,+
chr17,42998748,1.0941493284204116,35807,19718,55525,+
chr17,42998749,1.0579799587310212,37786,21227,59013,+
chr17,42998750,1.2805283059757129,20990,12113,33103,+
chr17,42998753,1.6615054296213716,4526,3158,7684,+
chr17,42998756,1.1753884008759627,2955,2324,5279,+
chr17,42998757,1.2329108396170352,15501,7772,23273,+
chr17,42998759,1.021697452405027,7710,6040,13750,+
chr17,42998760,1.1234201129141332,85164,49644,134808,+
chr17,42998761,1.1645364356140824,98928,54720,153648,+
chr17,42998762,1.1643946364499613,122387,67045,189432,+
chr17,42998763,1.0896936002918307,104613,56708,161321,+
chr17,42998764,1.1963805563258718,74640,38535,113175,+
chr17,42998765,1.0243041872933103,38060,22508,60568,+
chr17,42998781,1.1651657701922542,35813,19172,54985,+
chr17,42998784,1.3708482939224758,54594,32863,87457,+
chr17,42998801,1.4411113549368133,119812,79798,199610,+
chr17,42998802,1.4411113549368133,119812,79798,199610,+
chr17,42999931,0.8756999302267013,17238,12563,29801,+
chr17,42999933,0.9999250713487268,12960,9831,22791,+
chr17,42999947,0.8256669976880469,75874,47493,123367,+
chr17,42999952,0.9636365387385255,122726,80516,203242,+
chr17,42999955,1.3084413672434647,140135,95498,235633,+
chr17,42999960,1.2596078382765554,134939,85658,220597,+
chr17,42999962,1.1296650809811692,85435,46844,132279,+
chr17,42999965,1.250291747545974,49571,27860,77431,+
chr17,42999970,1.228617458764876,128786,93269,222055,+
chr17,42999984,1.122528394840276,112335,93318,205653,+
chr17,42999990,1.7512408580926342,89178,81163,170341,+
chr17,43002869,0.9487841364364568,1732,1289,3021,+
chr17,43171213,0.90837582877787,993,401,1394,+
chr17,43190661,1.3943049839236512,601,433,1034,+
chr17,43191376,1.8502465789731046,621,471,1092,+
chr17,43193584,2.318240619014277,996,707,1703,+
chr17,43194486,0.458747747274659,852,592,1444,+
chr17,43196558,1.968169982000932,780,583,1363,+
chr17,43196573,2.3372549019607844,595,492,1087,+
chr17,43196575,2.3372549019607844,595,492,1087,+
chr17,43197035,1.3955949434961052,855,629,1484,+
chr17,43200268,5.434190184576546,855,296,1151,+
chr17,43200277,10.072940058363129,822,536,1358,+
chr17,43200280,7.3986307223709895,835,761,1596,+
chr17,43200283,8.564651759047315,884,1174,2058,+
chr17,43201703,2.2533632286995515,669,445,1114,+
chr17,43201724,1.7509547190398251,785,610,1395,+
chr17,43201725,0.4998472094896797,946,506,1452,+
chr17,43201728,2.2531438721136765,1022,562,1584,+
chr17,43201733,1.6991891163859603,2143,1483,3626,+
chr17,43201768,1.5555555555555556,833,694,1527,+
chr17,43210000,1.685557424953511,704,490,1194,+
chr17,43210559,1.9085106382978723,965,704,1669,+
chr17,43211004,3.548774746549105,705,667,1372,+
chr17,43211045,0.6186991869918699,760,569,1329,+
chr17,43211269,2.566998892580288,1036,730,1766,+
chr17,43211306,0.44867485455720746,630,441,1071,+
chr17,43492687,3.2913885293847476,646,360,1006,+
chr17,44071149,2.36746245918944,598,445,1043,+
chr17,44076137,2.4096145124716557,717,440,1157,+
chr17,44076138,2.4096145124716557,717,440,1157,+
chr17,44349167,2.091025800189533,963,665,1628,+
chr17,44349196,2.057742782152231,559,507,1066,+
chr17,44349425,1.6414117647058823,653,509,1162,+
chr17,44349476,1.857570317175344,581,556,1137,+
chr17,44349510,1.320175438596491,930,721,1651,+
chr17,44349719,1.7293851075173272,864,661,1525,+
chr17,44350228,1.1975977961432507,1108,824,1932,+
chr17,44350229,1.5767158481274461,2467,1867,4334,+
chr17,44350230,1.8816517667092387,1359,1043,2402,+
chr17,44350251,1.8611706271912742,1032,603,1635,+
chr17,44350542,0.8386568077181404,1665,1186,2851,+
chr17,44350544,1.0195906432748538,950,809,1759,+
chr17,44350561,0.6385212888377445,771,631,1402,+
chr17,44350739,2.0720376359894153,728,536,1264,+
chr17,44350773,2.0871276722793457,1762,1205,2967,+
chr17,44351052,0.6077519379844961,783,569,1352,+
chr17,44351141,1.6875934230194318,1128,668,1796,+
chr17,44351371,0.5139949109414759,1009,785,1794,+
chr17,44351399,1.6454193548387095,796,619,1415,+
chr17,44351406,1.571266968325792,925,571,1496,+
chr17,44351607,1.7720430107526883,823,464,1287,+
chr17,44351645,2.72,679,499,1178,+
chr17,44351652,2.4236902050113898,797,438,1235,+
chr17,44351662,4.259074733096085,747,561,1308,+
chr17,44351686,1.528048780487805,1073,614,1687,+
chr17,44351754,1.963372967063004,1305,812,2117,+
chr17,44352030,1.7929334569007407,1590,1113,2703,+
chr17,44352114,1.8643578643578649,683,593,1276,+
chr17,44352116,1.0883376773212055,1445,1193,2638,+
chr17,44352382,1.9002152220700446,606,537,1143,+
chr17,44352383,2.0493432423090217,764,525,1289,+
chr17,44352395,2.4488888888888893,569,449,1018,+
chr17,44352509,0.5874560491259347,948,761,1709,+
chr17,44352511,1.1202949138656613,1781,1463,3244,+
chr17,44352556,3.2578397212543546,849,614,1463,+
chr17,44352674,1.7974553646348417,1675,1018,2693,+
chr17,44352720,2.5585284280936453,611,459,1070,+
chr17,44352726,1.9470539571651806,622,472,1094,+
chr17,44352763,1.7841563786008232,753,404,1157,+
chr17,44352884,0.6210236716914083,984,716,1700,+
chr17,44352944,1.5734818121063134,1613,1115,2728,+
chr17,44352975,1.5856983655274886,1835,1345,3180,+
chr17,44352977,1.5856983655274886,1835,1345,3180,+
chr17,44352982,1.5605843371512753,3174,2442,5616,+
chr17,44352984,1.6120168987638865,3007,2323,5330,+
chr17,44352986,1.624401913875598,2057,1616,3673,+
chr17,44353047,0.6971916746623368,1144,796,1940,+
chr17,44353053,3.762637362637362,855,839,1694,+
chr17,44749309,1.292570029572517,579,482,1061,+
chr17,44749314,1.8156549848455397,990,739,1729,+
chr17,44749315,0.9502483227324215,573,498,1071,+
chr17,44749319,2.1690910635602876,664,457,1121,+
chr17,45061324,2.0700467253131007,725,399,1124,+
chr17,45061381,2.9229960619812805,614,389,1003,+
chr17,45061408,3.291354439543996,857,532,1389,+
chr17,45093728,1.8747271608856773,1252,757,2009,+
chr17,45096197,2.6252764089182263,1219,873,2092,+
chr17,45097189,1.1740448273111592,717,596,1313,+
chr17,45097191,1.6254010187742718,1147,861,2008,+
chr17,45107977,6.115522739043533,621,403,1024,+
chr17,45150302,6.299716177040452,1115,894,2009,+
chr17,47612573,1.6329414037622134,736,508,1244,+
chr17,47622016,0.39951611312849084,605,443,1048,+
chr17,47650233,0.40717543418524127,853,541,1394,+
chr17,47650265,1.555066242135947,627,481,1108,+
chr17,47652736,2.6299740214437834,728,496,1224,+
chr17,47656894,2.391128672917242,961,768,1729,+
chr17,47658524,1.8646616541353385,650,398,1048,+
chr17,47658553,1.8417761100687933,759,532,1291,+
chr17,47658582,1.8838533735253618,1168,899,2067,+
chr17,47668240,5.542653376726151,727,426,1153,+
chr17,47668392,0.464625850340136,682,489,1171,+
chr17,47669753,1.5736931435326584,1140,922,2062,+
chr17,47670701,2.2065004202857947,1624,1078,2702,+
chr17,47670702,2.2065004202857947,1624,1078,2702,+
chr17,47670703,2.2065004202857947,1624,1078,2702,+
chr17,47670732,0.26170908677349447,961,741,1702,+
chr17,47670760,1.9235970250169032,568,434,1002,+
chr17,47676429,4.0033367023909285,742,532,1274,+
chr17,47676441,0.45496963499772,1388,1042,2430,+
chr17,47676442,0.4485321868351653,1714,1222,2936,+
chr17,47676472,1.0577748622977252,1024,754,1778,+
chr17,47678143,2.03859649122807,746,539,1285,+
chr17,47680034,1.9987105093488076,1239,845,2084,+
chr17,47680035,1.9987105093488076,1239,845,2084,+
chr17,47680039,0.2462006079027356,917,475,1392,+
chr17,47680057,1.9910567192280533,1259,606,1865,+
chr17,47680104,0.3681767955801105,1567,904,2471,+
chr17,47680508,1.5859082647278946,4731,2443,7174,+
chr17,47680510,1.5859082647278946,4731,2443,7174,+
chr17,47680513,1.9248000661279991,5478,3121,8599,+
chr17,47680514,1.9819004332898773,7696,4414,12110,+
chr17,47680530,1.2601126472094215,2995,1952,4947,+
chr17,47680539,1.5365577221559692,9249,5770,15019,+
chr17,47680542,1.6152988492016087,4269,3043,7312,+
chr17,47680545,1.7198425370258217,9179,7087,16266,+
chr17,47680546,1.703152515706691,14105,11026,25131,+
chr17,47680548,1.848677271832126,14735,11921,26656,+
chr17,47680549,1.582268535038631,22899,16557,39456,+
chr17,47682543,2.0954713391251536,717,410,1127,+
chr17,47682604,1.1979372110777642,1049,749,1798,+
chr17,47682790,24.33987874697183,2118,970,3088,+
chr17,47682791,21.19479108989038,1882,872,2754,+
chr17,47683190,0.39924056585973416,867,575,1442,+
chr17,47683202,0.41690324246074045,785,510,1295,+
chr17,47683303,15.64876518149049,4881,2338,7219,+
chr17,47683304,19.204882134086393,6630,6496,13126,+
chr17,47683305,15.512399527821724,7166,7693,14859,+
chr17,47683306,12.993962133385471,5580,7221,12801,+
chr17,47683307,4.604478822281829,2096,3909,6005,+
chr17,47683309,0.3843652033016709,1759,3702,5461,+
chr17,47683311,0.3233939830982677,2584,4902,7486,+
chr17,47683312,0.3612889898781243,1324,2574,3898,+
chr17,47683439,0.9866310160427808,1106,945,2051,+
chr17,47683440,0.9866310160427808,1106,945,2051,+
chr17,47683780,2.1714358470356374,639,444,1083,+
chr17,47683932,2.4457135393098555,608,409,1017,+
chr17,47684533,10.432189552244749,923,164,1087,+
chr17,47684535,5.043902439024389,1033,163,1196,+
chr17,47684537,6.005865102639296,1023,154,1177,+
chr17,47684539,6.0511982570806095,1009,152,1161,+
chr17,47684541,16.739335345877194,1738,332,2070,+
chr17,47684542,17.736896074784184,1403,284,1687,+
chr17,47684545,31.89664461262374,2054,918,2972,+
chr17,47684546,29.072446830526744,2536,1218,3754,+
chr17,47684547,29.072446830526744,2536,1218,3754,+
chr17,47684548,27.52444866844482,1459,832,2291,+
chr17,47684561,7.364037302036969,678,562,1240,+
chr17,47973952,0.9127155172413792,604,434,1038,+
chr17,47973953,1.4617900399000003,883,669,1552,+
chr17,47976752,3.4538184945991937,535,476,1011,+
chr17,47978871,1.3800347725297015,761,405,1166,+
chr17,47978872,1.3800347725297015,761,405,1166,+
chr17,47978873,1.1296417640204317,966,587,1553,+
chr17,48050659,1.7552956017640542,565,461,1026,+
chr17,48051006,5.697567782268098,1419,898,2317,+
chr17,48051007,5.4273399630850845,1112,698,1810,+
chr17,48051022,11.447698744769877,623,716,1339,+
chr17,48051023,8.383266713785465,1584,1876,3460,+
chr17,48051024,8.383266713785465,1584,1876,3460,+
chr17,48058304,3.9055624411655065,763,597,1360,+
chr17,48058608,3.9467592592592586,619,383,1002,+
chr17,48058610,3.9467592592592586,619,383,1002,+
chr17,48059107,5.426789933445711,593,434,1027,+
chr17,48060890,2.7441359082689343,1195,936,2131,+
chr17,48061310,24.17830421289447,960,1048,2008,+
chr17,48061311,25.23368817374369,823,984,1807,+
chr17,48061312,25.23368817374369,823,984,1807,+
chr17,48061331,3.4484058374870536,929,1369,2298,+
chr17,48061332,3.4484058374870536,929,1369,2298,+
chr17,48852558,2.4752947733244506,590,418,1008,+
chr17,48852962,1.6358817237840841,975,621,1596,+
chr17,48852989,2.638498226733521,862,480,1342,+
chr17,48852992,0.5185936443542934,589,434,1023,+
chr17,48856093,1.6377952755905512,1039,634,1673,+
chr17,48856097,1.7874982282069454,2033,1244,3277,+
chr17,48856099,1.7874982282069454,2033,1244,3277,+
chr17,48856102,1.6418018018018017,1138,739,1877,+
chr17,48856112,1.4520860215053764,1377,929,2306,+
chr17,48862871,2.936165327210104,672,334,1006,+
chr17,48862901,1.861942675159236,1062,627,1689,+
chr17,48862910,1.910299003322259,1149,601,1750,+
chr17,48862918,1.084150859755726,2913,1665,4578,+
chr17,48862923,1.740504501666798,3287,2240,5527,+
chr17,48862925,1.740504501666798,3287,2240,5527,+
chr17,48862931,2.1607784693609187,1895,1036,2931,+
chr17,48892802,1.5243952872637836,1042,741,1783,+
chr17,48892803,1.5865922453201577,838,631,1469,+
chr17,48892816,0.789269496057017,1525,847,2372,+
chr17,48892818,0.899551625358077,962,433,1395,+
chr17,48893410,3.025352490036505,1456,806,2262,+
chr17,48893412,2.558392235728802,2331,1473,3804,+
chr17,48893413,1.873396065012832,875,667,1542,+
chr17,48893414,1.4072869439516396,658,533,1191,+
chr17,48893435,0.9996207195491982,1941,1537,3478,+
chr17,48893436,0.9996207195491982,1941,1537,3478,+
chr17,48894393,1.718036529680365,601,437,1038,+
chr17,48894395,2.6839430894308944,1111,655,1766,+
chr17,48894423,2.3355509355509363,1095,739,1834,+
chr17,48894433,1.593196342048551,1826,1458,3284,+
chr17,48895239,1.750448833034112,974,556,1530,+
chr17,48895240,1.5721599557215993,873,656,1529,+
chr17,48895278,2.4769731578703964,1910,1267,3177,+
chr17,48895296,2.18641975308642,758,539,1297,+
chr17,48895315,1.5271552026979556,835,661,1496,+
chr17,48895654,0.5520372261945296,607,533,1140,+
chr17,48895662,2.2139037433155084,689,494,1183,+
chr17,48895729,1.8541329011345218,714,616,1330,+
chr17,48927545,41.99953259387283,924,509,1433,+
chr17,48927546,28.620433453987477,1498,882,2380,+
chr17,48927548,11.28584591289168,887,576,1463,+
chr17,48928677,12.020304470515239,3392,2818,6210,+
chr17,48928678,12.020304470515239,3392,2818,6210,+
chr17,48928679,10.14768131336591,3020,2494,5514,+
chr17,48928694,0.3535248298159626,898,763,1661,+
chr17,50736968,1.0148698884758365,727,537,1264,+
chr17,50736970,1.0148698884758365,727,537,1264,+
chr17,50736976,2.180408673850578,721,602,1323,+
chr17,50736999,1.852601156069364,640,518,1158,+
chr17,50737004,1.8398441975025777,729,601,1330,+
chr17,50744711,0.43582717256892983,1219,906,2125,+
chr17,50744715,2.1582733812949644,599,416,1015,+
chr17,50745742,1.5775491113189897,1359,1068,2427,+
chr17,50745914,2.1046096538879406,677,378,1055,+
chr17,50745941,1.5545415959252973,2929,1766,4695,+
chr17,50745943,1.5642978181250344,5385,3241,8626,+
chr17,50745944,1.485872113997114,3022,1847,4869,+
chr17,50745966,1.9147950607706237,3772,2577,6349,+
chr17,50745968,1.9147950607706237,3772,2577,6349,+
chr17,50746542,2.109451219512195,628,409,1037,+
chr17,50746571,2.526867030965392,715,487,1202,+
chr17,50750598,1.6383888789877028,950,542,1492,+
chr17,50750667,1.6417034186353547,2540,1467,4007,+
chr17,50750669,1.4996532045222846,3997,2390,6387,+
chr17,50750670,0.9337944664031621,874,505,1379,+
chr17,50751043,3.8516743832247884,691,355,1046,+
chr17,50751044,3.13015873015873,815,419,1234,+
chr17,50751055,1.6318465669839353,862,610,1472,+
chr17,50751056,1.3679589486088068,1897,1320,3217,+
chr17,50751058,1.8058811638971026,1932,1277,3209,+
chr17,50751065,2.1482617586912065,572,488,1060,+
chr17,50752185,1.817154315923799,622,476,1098,+
chr17,50752192,2.3450063478628858,714,555,1269,+
chr17,50752193,1.6681034482758617,902,559,1461,+
chr17,50752197,1.7980530635617484,2354,2014,4368,+
chr17,50752199,1.8173905512814088,4881,3916,8797,+
chr17,50752200,1.9109250398724085,3091,2659,5750,+
chr17,50752205,1.9767592592592595,1730,1619,3349,+
chr17,50752408,2.598350803379909,999,633,1632,+
chr17,51153590,1.2080042595921576,718,485,1203,+
chr17,51153593,1.775603993203567,775,556,1331,+
chr17,51153608,0.5218006464896295,2586,1677,4263,+
chr17,51153636,1.4638086831853614,4383,2691,7074,+
chr17,51153637,1.4711339923441902,3397,1862,5259,+
chr17,51153639,1.522837642735267,1104,801,1905,+
chr17,51153642,0.6514624901666308,1230,884,2114,+
chr17,51155650,1.808755760368664,1883,1301,3184,+
chr17,51155651,1.808755760368664,1883,1301,3184,+
chr17,51155660,1.5691955775829205,1091,792,1883,+
chr17,51155721,0.6333658796378484,4472,3667,8139,+
chr17,51155722,0.6333658796378484,4472,3667,8139,+
chr17,51155724,1.5155043876652454,3862,2963,6825,+
chr17,51160048,1.4240520633907678,2580,1566,4146,+
chr17,51160070,1.6791604197901049,2099,1494,3593,+
chr17,51161172,1.633509239943125,3144,2060,5204,+
chr17,51161207,2.2435075093867334,1977,1087,3064,+
chr17,51161215,1.4836036671368125,2039,1417,3456,+
chr17,51161238,0.7106528962299229,2787,1883,4670,+
chr17,51161242,1.4947389927469608,1828,1254,3082,+
chr17,51161250,0.7227195554869578,3745,2355,6100,+
chr17,51161726,1.8358295774443427,3324,2403,5727,+
chr17,51161728,1.7524824419786869,5420,4046,9466,+
chr17,51161730,1.1424762316982098,23774,14861,38635,+
chr17,51161731,1.3363258396969384,22529,14297,36826,+
chr17,51161733,1.4846136319963263,23081,14416,37497,+
chr17,51161736,1.82090351220786,3133,2552,5685,+
chr17,51161805,1.2432221638855283,2572,1850,4422,+
chr17,51161807,1.5824155440654781,1795,1461,3256,+
chr17,51161947,1.421468714874485,3448,2354,5802,+
chr17,51166406,1.44908198559066,802,378,1180,+
chr17,51166407,1.4598182470293963,1273,672,1945,+
chr17,51166408,1.304154603577348,1912,1231,3143,+
chr17,51166409,1.2915059930865769,1687,1137,2824,+
chr17,51166410,1.3493852167732763,860,748,1608,+
chr17,51166435,1.9283541073706936,613,442,1055,+
chr17,51166438,1.156674781210942,1365,1094,2459,+
chr17,51166445,0.4659640750314841,702,641,1343,+
chr17,51166454,1.5231555964146173,1622,915,2537,+
chr17,51166461,0.6849829928776803,971,837,1808,+
chr17,51166824,1.239965772764067,1179,787,1966,+
chr17,51166825,1.1221342494481452,2604,1753,4357,+
chr17,51166827,1.207746944897869,1710,1192,2902,+
chr17,51166830,1.7174320524835986,1465,1066,2531,+
chr17,51166860,1.3825606209906154,8611,6817,15428,+
chr17,51166861,1.3825606209906154,8611,6817,15428,+
chr17,51166863,1.3391207629882838,3392,2016,5408,+
chr17,51166897,1.2472834496302627,5929,4053,9982,+
chr17,51166918,1.2986684712298229,2756,2137,4893,+
chr17,51168248,1.4187780307707565,9979,7221,17200,+
chr17,51168249,1.2716472392450502,11466,9314,20780,+
chr17,51168251,1.5916140001981627,5784,4557,10341,+
chr17,51169998,1.2048921923842,3048,2345,5393,+
chr17,51171490,1.2663483575248282,3854,2379,6233,+
chr17,51171510,1.4085968893562848,3698,2580,6278,+
chr17,51171512,0.8293004060587954,4408,3845,8253,+
chr17,51171523,0.7157919297682762,5258,4376,9634,+
chr17,51171527,1.2904877630544174,9995,7352,17347,+
chr17,51171528,1.2904877630544174,9995,7352,17347,+
chr17,51266221,0.8435799234025398,557,450,1007,+
chr17,51266222,0.8435799234025398,557,450,1007,+
chr17,51275926,2.041107446212674,728,486,1214,+
chr17,51277166,1.7849739831235716,983,771,1754,+
chr17,51280411,2.1201010663631448,778,610,1388,+
chr17,51288075,0.9457331347095127,807,507,1314,+
chr17,51288076,0.9457331347095127,807,507,1314,+
chr17,53106287,0.5934461669998784,1359,944,2303,+
chr17,54912745,1.3377316036514786,931,751,1682,+
chr17,54912746,0.9399608610567514,631,510,1141,+
chr17,54914689,2.6467852714501876,1309,901,2210,+
chr17,54914692,2.270783298870134,1403,1021,2424,+
chr17,54914695,2.053768358103948,2382,2054,4436,+
chr17,54914696,2.053768358103948,2382,2054,4436,+
chr17,54914697,1.9604455772680072,3278,2888,6166,+
chr17,54914699,1.8370328511365142,2218,1915,4133,+
chr17,54915828,2.100951611455248,1264,947,2211,+
chr17,54915829,2.4205224999559,1725,1365,3090,+
chr17,54915830,1.8400920852456684,2871,2084,4955,+
chr17,54915831,2.422120363296834,1316,1070,2386,+
chr17,54915832,0.878413811007269,1146,719,1865,+
chr17,54915836,2.1307302785392026,2089,1577,3666,+
chr17,54915839,2.01809674366354,1410,1236,2646,+
chr17,59608209,0.8801980198019802,634,504,1138,+
chr17,59608211,0.7782544102350394,771,607,1378,+
chr17,59644406,0.2982615334167477,683,558,1241,+
chr17,59644409,1.806660499537465,650,375,1025,+
chr17,59647572,1.7301392301392302,675,406,1081,+
chr17,59661453,5.432294762294763,723,447,1170,+
chr17,59664824,2.099341238471673,770,494,1264,+
chr17,59664827,2.1695895522388056,801,535,1336,+
chr17,59666549,0.4675863191873679,1025,687,1712,+
chr17,59668879,2.553034665438213,651,456,1107,+
chr17,59673653,1.9034344335414808,568,471,1039,+
chr17,59674708,2.9265452373842935,890,590,1480,+
chr17,59674709,2.9265452373842935,890,590,1480,+
chr17,59674723,2.1446194517603634,795,588,1383,+
chr17,59677039,1.7617848146815402,611,396,1007,+
chr17,59677077,2.0477326968973744,626,418,1044,+
chr17,59681300,2.2939947376567096,722,496,1218,+
chr17,59681302,2.201908007337966,1161,859,2020,+
chr17,59681359,2.0166666666666666,747,407,1154,+
chr17,59682367,2.2830901511203754,700,403,1103,+
chr17,59683874,2.7731914893617025,685,469,1154,+
chr17,59683876,2.7731914893617025,685,469,1154,+
chr17,59685206,2.5051948051948054,642,439,1081,+
chr17,59685613,0.4551440329218107,1105,674,1779,+
chr17,59685615,0.4551440329218107,1105,674,1779,+
chr17,59685632,2.5039427692794667,1414,917,2331,+
chr17,59685633,2.8544494720965305,756,545,1301,+
chr17,59685708,1.6014272970562,747,569,1316,+
chr17,59693945,0.5566860465116279,765,511,1276,+
chr17,59693957,1.8620996441281135,804,561,1365,+
chr17,59694342,2.356538822926454,835,508,1343,+
chr17,59694542,0.6123787402650636,746,562,1308,+
chr17,59694649,1.5819963614780421,1342,959,2301,+
chr17,59707712,2.7633843301366494,636,385,1021,+
chr17,59731441,2.251191827553148,1260,823,2083,+
chr17,59735349,2.2780401683846097,632,433,1065,+
chr17,59737506,2.4821875,610,399,1009,+
chr17,59765017,0.9802296882426238,1335,899,2234,+
chr17,59765021,1.932853717026379,650,416,1066,+
chr17,59765022,1.8916840721063204,1364,1101,2465,+
chr17,59765049,1.7261904761904765,695,479,1174,+
chr17,59765109,1.858500043332254,1078,848,1926,+
chr17,59773762,2.0610221205186883,578,436,1014,+
chr17,59773785,2.2340311598563654,903,868,1771,+
chr17,59773786,2.0785968028419184,603,562,1165,+
chr17,59837930,0.8779880081250789,2739,1712,4451,+
chr17,59837931,0.9715198649045764,2203,1345,3548,+
chr17,59837932,0.9715198649045764,2203,1345,3548,+
chr17,59837992,1.738637174646307,745,571,1316,+
chr17,59838160,1.4835365739757524,824,570,1394,+
chr17,59838185,2.252,562,449,1011,+
chr17,59838186,2.252,562,449,1011,+
chr17,59838223,1.8300653594771243,874,611,1485,+
chr17,59838371,2.098639455782313,616,440,1056,+
chr17,59838380,1.803934387899137,1936,1439,3375,+
chr17,59839769,0.7070736167121708,1376,961,2337,+
chr17,59839794,2.0427089688834656,743,446,1189,+
chr17,59839853,3.877562561854941,652,642,1294,+
chr17,59839960,1.2571889578137492,1438,1118,2556,+
chr17,59840026,1.4530712319339298,2034,1452,3486,+
chr17,59840164,0.5779067332715145,1655,992,2647,+
chr17,59840192,0.5526451901773239,1626,1166,2792,+
chr17,59840201,1.3917443408788284,2612,1501,4113,+
chr17,59840217,0.7766019790745158,2701,1750,4451,+
chr17,59840264,1.2894217827704813,4523,2944,7467,+
chr17,59840281,1.7526947167382108,11844,8297,20141,+
chr17,59840283,1.7526947167382108,11844,8297,20141,+
chr17,59840286,1.9580496049080487,6452,4878,11330,+
chr17,59841332,0.9515753856484758,1094,606,1700,+
chr17,59841386,2.4993297587131367,677,372,1049,+
chr17,59841469,2.288484848484848,825,549,1374,+
chr17,59841492,0.4217642425833552,1070,585,1655,+
chr17,59841529,1.553670350844328,1967,868,2835,+
chr17,59841564,1.4418721335894322,2113,1314,3427,+
chr17,59841588,0.7184873949579832,2089,1189,3278,+
chr17,59841616,1.7836011583669298,3420,1600,5020,+
chr17,59841617,1.7836011583669298,3420,1600,5020,+
chr17,59841618,1.876688750241204,4645,2220,6865,+
chr17,59841620,1.9609599540141789,3665,1841,5506,+
chr17,59841621,1.8917557294945841,5730,3251,8981,+
chr17,59841630,1.4568058968058968,1646,924,2570,+
chr17,59841633,1.4366931489603483,5897,3785,9682,+
chr17,59841634,1.388682129956067,10825,6761,17586,+
chr17,59841716,2.9268313782483815,860,492,1352,+
chr17,59841720,1.5805038672219596,1770,1233,3003,+
chr17,62447716,2.811326673874371,715,520,1235,+
chr17,63424946,2.2993197278911564,623,503,1126,+
chr17,63424947,2.291984121870068,832,646,1478,+
chr17,63424948,2.2993197278911564,623,503,1126,+
chr17,63424950,1.0691882412259168,806,465,1271,+
chr17,63424952,1.6223102412255983,820,536,1356,+
chr17,63787240,1.9754532221781134,817,686,1503,+
chr17,63787241,1.8768267223382047,557,478,1035,+
chr17,63816874,0.3502519298516858,793,477,1270,+
chr17,63816895,2.2112512459116265,1705,1141,2846,+
chr17,63828153,2.9858106299856346,619,489,1108,+
chr17,63829928,1.7390243902439024,712,409,1121,+
chr17,63829931,1.6785714285714284,751,447,1198,+
chr17,63830319,1.7007042253521123,965,567,1532,+
chr17,63830321,0.5562342488573748,765,570,1335,+
chr17,63830333,1.518620710423103,2430,1710,4140,+
chr17,63830369,1.848387096774193,2291,2079,4370,+
chr17,63830370,1.848387096774193,2291,2079,4370,+
chr17,63830374,3.383755760368664,1276,1239,2515,+
chr17,63830439,1.9213075060532687,620,412,1032,+
chr17,63830844,2.7614297589359933,603,400,1003,+
chr17,63831052,5.015016653165706,1822,1300,3122,+
chr17,63831095,1.953919491525424,650,471,1121,+
chr17,63831103,2.5298081907724206,731,642,1373,+
chr17,63831104,2.5298081907724206,731,642,1373,+
chr17,63831152,2.2111324376199617,695,520,1215,+
chr17,63831154,2.2111324376199617,695,520,1215,+
chr17,63831350,2.2270742358078603,747,457,1204,+
chr17,63831568,2.561669829222012,701,402,1103,+
chr17,63831572,1.7394926679089353,1183,808,1991,+
chr17,63831746,2.375497093912512,1502,933,2435,+
chr17,63831747,2.375497093912512,1502,933,2435,+
chr17,63831748,2.375497093912512,1502,933,2435,+
chr17,64146080,0.8494702462038636,1500,967,2467,+
chr17,64146265,0.5752280082377169,610,514,1124,+
chr17,67692726,3.1773618538324424,712,527,1239,+
chr17,67692727,3.1773618538324424,712,527,1239,+
chr17,67717935,0.272090488311038,600,494,1094,+
chr17,67719932,3.978397839783977,679,403,1082,+
chr17,67719933,3.978397839783977,679,403,1082,+
chr17,67721399,1.5516441655180047,647,441,1088,+
chr17,67721489,0.5388495003134407,1012,694,1706,+
chr17,67722597,0.2984280910299523,953,672,1625,+
chr17,67722598,0.2984280910299523,953,672,1625,+
chr17,67724054,0.4196340743655321,710,390,1100,+
chr17,67724058,2.6467847157502327,1703,1043,2746,+
chr17,67724064,3.267295597484277,1038,529,1567,+
chr17,67724071,1.4034917443488761,4391,2834,7225,+
chr17,67724072,1.0017072035119616,1254,850,2104,+
chr17,67724076,1.662262592898431,2378,1383,3761,+
chr17,67724077,1.662262592898431,2378,1383,3761,+
chr17,67724081,1.4083133646216592,7425,4732,12157,+
chr17,67724082,1.4525554626395791,3473,2102,5575,+
chr17,67724094,1.5441843585556159,1701,1168,2869,+
chr17,67724099,1.3625049128782916,2799,1795,4594,+
chr17,67724112,1.792100479259626,5421,4033,9454,+
chr17,67724113,1.792100479259626,5421,4033,9454,+
chr17,67726533,1.4991574461950523,657,425,1082,+
chr17,67737638,3.3871571722294216,566,468,1034,+
chr17,67737899,2.4233766233766234,932,615,1547,+
chr17,67737917,1.7242063492063493,1184,839,2023,+
chr17,67738121,2.701111111111111,1000,674,1674,+
chr17,67738140,0.44194896571056025,3018,2111,5129,+
chr17,67738141,0.7269997269997269,2662,2219,4881,+
chr17,67738147,1.301467057882102,1595,1140,2735,+
chr17,67738148,1.5878395425111431,2150,1550,3700,+
chr17,67738152,1.6898605764228485,1829,1372,3201,+
chr17,67738155,1.4120365637248933,3085,2235,5320,+
chr17,68035742,3.9340466866448636,583,491,1074,+
chr17,68035773,3.127450980392157,637,611,1248,+
chr17,68035775,3.127450980392157,637,611,1248,+
chr17,68035819,2.2517647058823527,637,424,1061,+
chr17,68035830,2.75625,685,479,1164,+
chr17,68037111,2.0710112359550563,575,444,1019,+
chr17,68037119,3.510884459439644,1067,856,1923,+
chr17,68037132,1.9232217573221757,633,477,1110,+
chr17,68037436,2.1367994100294987,1219,677,1896,+
chr17,68037437,2.1367994100294987,1219,677,1896,+
chr17,68040685,1.414141414141414,979,629,1608,+
chr17,68042090,1.7801988576264014,934,814,1748,+
chr17,68042121,1.5206443408223824,943,673,1616,+
chr17,68042122,1.8363071100297377,1234,821,2055,+
chr17,68042125,1.4531081398076469,1317,869,2186,+
chr17,68042196,2.8984634551495017,845,601,1446,+
chr17,68042202,2.0011911852293034,863,656,1519,+
chr17,68042936,1.642209072978304,1085,675,1760,+
chr17,68043113,1.5834594049420068,784,660,1444,+
chr17,68043119,1.7819619809745497,1966,1488,3454,+
chr17,68043140,0.5535889872173059,1125,1016,2141,+
chr17,68043199,1.5063728813559325,1306,884,2190,+
chr17,68043200,0.6195431695916748,842,666,1508,+
chr17,68043239,0.6824469121371517,903,707,1610,+
chr17,68043348,1.8385960334029228,670,478,1148,+
chr17,68043848,1.4593497808319136,1625,1124,2749,+
chr17,68043954,1.4032850085764401,942,807,1749,+
chr17,68043961,1.9785223367697595,1033,775,1808,+
chr17,68043963,1.9785223367697595,1033,775,1808,+
chr17,68043986,2.325520833333333,949,599,1548,+
chr17,68044035,1.8583108715184185,961,741,1702,+
chr17,68044039,1.5562724014336915,1168,867,2035,+
chr17,68044403,2.3285583663517215,763,578,1341,+
chr17,68044421,2.848227474150665,856,676,1532,+
chr17,68045811,1.6208733998897533,826,562,1388,+
chr17,68046585,0.625784298297644,2385,1808,4193,+
chr17,68046587,0.625784298297644,2385,1808,4193,+
chr17,68250455,1.304716450273577,828,607,1435,+
chr17,68254409,1.9414519906323189,828,365,1193,+
chr17,68254435,1.7940392940392937,2154,1000,3154,+
chr17,68254437,1.7940392940392937,2154,1000,3154,+
chr17,68254457,1.6150885880450778,2371,1264,3635,+
chr17,68254472,1.4601181683899558,1317,676,1993,+
chr17,68254492,1.6114260066181207,3527,1960,5487,+
chr17,68254523,1.346986858142393,2870,1798,4668,+
chr17,68254530,1.6839900451894807,5311,3386,8697,+
chr17,68254543,1.6817913568773235,4730,2689,7419,+
chr17,68256942,3.170713959529748,650,520,1170,+
chr17,68515501,1.6890554436227663,719,466,1185,+
chr17,68525798,7.499654904924789,742,663,1405,+
chr17,68532263,0.5750267316145894,604,442,1046,+
chr17,69516864,0.3601004780811928,807,573,1380,+
chr17,69517571,1.9065103363159521,667,462,1129,+
chr17,69517572,1.6203990324562352,1191,862,2053,+
chr17,69520285,1.853570634733723,903,659,1562,+
chr17,69524917,1.7945172246482288,568,457,1025,+
chr17,69526664,2.1637898684896757,906,597,1503,+
chr17,69536131,1.854935847080388,615,401,1016,+
chr17,69541711,1.718676470588235,753,543,1296,+
chr17,69541766,1.8197743467933487,680,420,1100,+
chr17,74203677,1.020180594535157,23403,10981,34384,+
chr17,74203678,1.020180594535157,23403,10981,34384,+
chr17,74203679,1.0381692274476388,12898,6184,19082,+
chr17,74203681,1.3237605686867682,5338,3251,8589,+
chr17,74203682,1.8687796537526578,11007,5284,16291,+
chr17,74203686,1.306437024519284,28036,13142,41178,+
chr17,74203687,1.1869637692059212,21780,8597,30377,+
chr17,74203688,1.3208537628380779,40993,19628,60621,+
chr17,74203689,1.2099869943081163,30782,14653,45435,+
chr17,74203916,0.6609162772705437,954,578,1532,+
chr17,74203932,1.2360555088890706,17812,10719,28531,+
chr17,74204133,0.9115399827922553,23485,13738,37223,+
chr17,74204134,0.9998501719995403,42947,26762,69709,+
chr17,74204136,1.1253212045081067,41592,25454,67046,+
chr17,74204143,1.1197254513536774,30155,20236,50391,+
chr17,74204144,0.9903119484718986,66317,44029,110346,+
chr17,74204145,1.2348518745785722,53044,36088,89132,+
chr17,74204146,1.1417283797976208,75773,49656,125429,+
chr17,74204147,1.2652947438495827,67095,42158,109253,+
chr17,74209188,1.3621848330692463,6030,4567,10597,+
chr17,74209191,1.2101275009515449,19991,15447,35438,+
chr17,74209192,1.4025249616585844,13158,10357,23515,+
chr17,74209197,0.8644217316304341,7929,5740,13669,+
chr17,74209200,0.8031648107896678,9011,6404,15415,+
chr17,75209822,0.5027000491180386,589,491,1080,+
chr17,75225133,4.081124860685578,651,453,1104,+
chr17,75231855,1.1363472292656764,623,406,1029,+
chr17,75231859,0.8612984732726892,828,491,1319,+
chr17,75234757,0.4759717628368661,609,482,1091,+
chr17,75263446,1.9037282199671945,1187,828,2015,+
chr17,75265957,0.3255274750753536,623,453,1076,+
chr17,75265959,0.3255274750753536,623,453,1076,+
chr17,76270602,12.59754271857045,817,1001,1818,+
chr17,76270603,12.59754271857045,817,1001,1818,+
chr17,76270611,0.2700915581979269,394,643,1037,+
chr17,76558794,0.9228358478815516,967,1000,1967,+
chr17,76561355,0.49964362081254443,700,459,1159,+
chr17,76561356,1.1158641861929626,999,658,1657,+
chr17,76561375,1.9109692591545362,1046,607,1653,+
chr17,76561380,1.8125450471752733,1919,1129,3048,+
chr17,76561381,1.8561736770692,1367,736,2103,+
chr17,76563183,1.0229938271604941,1893,1295,3188,+
chr17,76563184,1.6618319276658966,3118,2126,5244,+
chr17,76563186,2.6524038461538457,1225,831,2056,+
chr17,76563480,2.0395658263305316,698,407,1105,+
chr17,76564641,2.5138196048137913,601,474,1075,+
chr17,76733179,2.276361997049041,754,556,1310,+
chr17,76733603,2.317722772277228,866,504,1370,+
chr17,76733604,2.317722772277228,866,504,1370,+
chr17,77487450,3.278425084178955,1278,893,2171,+
chr17,77487474,2.143443584330284,730,405,1135,+
chr17,77500394,14.038891782796371,1103,281,1384,+
chr17,77500398,36.69083765370446,1340,1105,2445,+
chr17,77500399,34.75324218625942,1952,2049,4001,+
chr17,77500400,34.00277981622636,1796,2000,3796,+
chr17,77500405,0.29361139620151583,432,902,1334,+
chr17,77500407,0.31593026324244,987,1586,2573,+
chr17,77500409,0.4139817629179331,453,657,1110,+
chr17,77500417,0.35777206755756275,1142,1870,3012,+
chr17,77500418,0.37928165658464374,1262,1915,3177,+
chr17,77500419,0.39019363382366473,2084,3064,5148,+
chr17,77500454,0.5443297280608321,1208,1098,2306,+
chr17,78214273,3.7222008229908394,755,397,1152,+
chr17,78214358,2.14282468626805,745,420,1165,+
chr17,78214716,1.3349165546936648,1017,742,1759,+
chr17,78216674,1.968103448275862,760,479,1239,+
chr17,78216709,1.513207722701944,2620,1897,4517,+
chr17,78216710,0.9833663366336632,1336,1009,2345,+
chr17,78223510,1.7191950464396286,616,509,1125,+
chr17,78223607,1.6555801921655582,559,450,1009,+
chr17,78223805,0.3864142538975501,693,448,1141,+
chr17,78224073,0.5006944452736464,907,711,1618,+
chr17,78224106,2.5771294433266267,529,496,1025,+
chr17,78224392,1.485748267466546,843,588,1431,+
chr17,78224531,3.0456228962048404,967,573,1540,+
chr17,78224572,1.6591444514703722,967,626,1593,+
chr17,78398288,1.1989529275592794,1294,810,2104,+
chr17,78398302,1.947302504816956,1188,864,2052,+
chr17,78398304,1.7687651246294949,1935,1359,3294,+
chr17,78398310,1.7830913538637492,1602,1227,2829,+
chr17,78398311,2.1272389151468656,1019,677,1696,+
chr17,79034503,2.6842105263157894,611,443,1054,+
chr17,79034504,2.723095929988006,953,669,1622,+
chr17,79044092,2.2606454782119836,565,506,1071,+
chr17,79048437,2.2063903281519863,583,578,1161,+
chr17,79048439,3.3215496551666095,809,728,1537,+
chr17,79048459,1.6301482088329486,683,462,1145,+
chr17,79048526,2.6394833266606437,672,602,1274,+
chr17,79048605,33.2029273055111,1560,681,2241,+
chr17,79048606,28.572474820967216,2351,1087,3438,+
chr17,79048607,28.572474820967216,2351,1087,3438,+
chr17,79048608,24.15691233523819,1371,653,2024,+
chr17,79049047,2.0607816647947885,931,708,1639,+
chr17,79049594,0.9349395135890033,588,423,1011,+
chr17,79049656,0.7969002756535272,1003,665,1668,+
chr17,80118277,3.5391843055069234,615,453,1068,+
chr17,80119629,4.35447179367095,882,578,1460,+
chr17,80893840,1.5829290801333682,862,637,1499,+
chr17,80923647,3.127295871976723,592,422,1014,+
chr17,80923649,3.127295871976723,592,422,1014,+
chr17,80925400,1.389076782449726,1841,1093,2934,+
chr17,80925401,1.389076782449726,1841,1093,2934,+
chr17,80925402,1.2492927227365245,2194,1272,3466,+
chr17,80925405,1.8603882563709726,1170,763,1933,+
chr17,80925424,1.0428211586901763,2460,1587,4047,+
chr17,80925425,0.9231553464082379,3287,2137,5424,+
chr17,80925433,1.603960396039604,1439,1009,2448,+
chr17,80925436,2.36305942470947,1508,1102,2610,+
chr17,80940558,1.5777261903299395,603,455,1058,+
chr17,80962483,1.5401974612129756,1039,708,1747,+
chr17,80962484,1.6050430604322954,1455,932,2387,+
chr17,81241021,1.4356756756756757,663,480,1143,+
chr17,81241022,1.4356756756756757,663,480,1143,+
chr17,81241023,1.1889534079007764,846,617,1463,+
chr17,81241064,0.9888222206998298,896,620,1516,+
chr17,81241070,2.653138927298003,600,428,1028,+
chr17,81241160,1.6613159434829865,640,442,1082,+
chr17,81688737,1.4981289896544132,663,412,1075,+
chr17,81688743,1.5776897689768976,628,504,1132,+
chr17,81703378,2.992679264596128,709,425,1134,+
chr17,81703447,1.1655223757134583,1408,784,2192,+
chr17,81703448,1.0454584780074325,1726,977,2703,+
chr17,81703449,1.1655223757134583,1408,784,2192,+
chr17,81703536,2.2758620689655173,863,463,1326,+
chr17,81703538,2.2758620689655173,863,463,1326,+
chr17,81704399,2.547921071176885,1032,945,1977,+
chr17,81704401,2.547921071176885,1032,945,1977,+
chr17,81706915,1.2847455982737395,1127,929,2056,+
chr17,81706916,1.5878521923867241,1111,562,1673,+
chr17,81706918,1.3378729427781553,1235,993,2228,+
chr17,81706933,1.5428703703703703,876,674,1550,+
chr17,81706943,2.33668533604888,632,490,1122,+
chr17,81707007,1.9951061483319548,1653,1208,2861,+
chr17,81707008,1.9951061483319548,1653,1208,2861,+
chr17,81707125,0.9354066985645932,2345,1671,4016,+
chr17,81707126,0.9354066985645932,2345,1671,4016,+
chr17,81707154,1.7489878542510122,863,588,1451,+
chr17,81707189,1.854972167895291,821,577,1398,+
chr17,81707195,2.350250976017847,515,488,1003,+
chr17,81707417,57.757606061347154,2387,795,3182,+
chr17,81707418,57.757606061347154,2387,795,3182,+
chr17,81893557,2.1392716607748317,677,489,1166,+
chr17,81900043,2.174907595297307,1028,657,1685,+
chr17,81900147,2.0101010101010104,596,461,1057,+
chr17,81900155,1.3973632202396553,1745,1384,3129,+
chr17,81900163,0.5073593073593075,878,538,1416,+
chr17,81900167,0.5526138442283623,860,662,1522,+
chr17,82053312,3.324095440375009,602,406,1008,+
chr17,82053922,2.6238067406974483,669,393,1062,+
chr17,82054024,1.863610818511658,661,517,1178,+
chr17,82054595,2.1307040724504525,918,585,1503,+
chr17,82054906,1.7484166705428847,1498,952,2450,+
chr17,82054907,1.3443304589376068,1590,981,2571,+
chr17,82054914,1.7743282498184458,673,407,1080,+
chr17,82055762,2.1544672634720032,721,421,1142,+
chr17,82055763,2.1103719117551463,927,569,1496,+
chr17,82055781,0.4430787353337999,610,433,1043,+
chr17,82056679,1.3549576617760288,706,556,1262,+
chr17,82056719,1.0062667628021378,1339,995,2334,+
chr17,82056720,0.49973307708733716,850,668,1518,+
chr17,82056844,1.0776712198055798,573,476,1049,+
chr17,82056923,1.975669099756691,608,547,1155,+
chr17,82056959,1.589104768987636,813,693,1506,+
chr17,82057061,2.35357833655706,623,516,1139,+
chr17,82057339,4.848216917182435,657,376,1033,+
chr17,82057340,4.848216917182435,657,376,1033,+
chr17,82229051,0.49231355129255183,1751,1330,3081,+
chr17,82229083,5.167464114832536,639,417,1056,+
chr17,82235991,1.7130664183736808,580,536,1116,+
chr17,82236038,1.5052777079668258,1330,691,2021,+
chr17,82236048,1.7056697108066967,1629,875,2504,+
chr17,82236081,1.5128871079449886,1972,1122,3094,+
chr17,82236084,1.5771489395158262,3014,1981,4995,+
chr17,82236090,1.6265078742858319,3257,2288,5545,+
chr17,82236091,1.5574534161490683,1120,965,2085,+
chr17,82236096,1.476114922813036,1186,1059,2245,+
chr17,82236107,1.7000223418656428,7358,6004,13362,+
chr17,82236141,1.7577201051248357,1721,1521,3242,+
chr17,82236198,0.7183910014845266,2676,2084,4760,+
chr17,82236749,1.5392251028975328,4015,2744,6759,+
chr17,82236790,1.5774995789591866,1404,1136,2540,+
chr17,82236842,2.0844064472113253,1376,1065,2441,+
chr17,82237154,1.4147044099576753,2268,1504,3772,+
chr17,82237179,1.8184281842818428,1319,1079,2398,+
chr17,82237188,1.4678450226244346,1313,1087,2400,+
chr17,82237311,1.685810810810811,1496,813,2309,+
chr17,82237428,2.4977994447829914,1084,546,1630,+
chr17,82237449,2.3043731778425656,607,489,1096,+
chr17,82237457,2.139015728056824,1239,656,1895,+
chr17,82237458,0.5684594594594594,1106,924,2030,+
chr17,82237494,1.6048475945648182,1310,777,2087,+
chr17,82237497,1.5792993589921382,2109,1378,3487,+
chr17,82237524,0.6404736871230148,1285,1062,2347,+
chr17,82237550,1.7293148087371917,1008,830,1838,+
chr17,82237596,1.6289038579301898,1424,1064,2488,+
chr17,82237646,1.620279547525778,4459,2816,7275,+
chr17,82237647,1.620279547525778,4459,2816,7275,+
chr17,82237746,1.701870187018702,1104,908,2012,+
chr17,82237749,1.2508487654320988,1246,971,2217,+
chr17,82237752,1.5347355003186745,1289,1045,2334,+
chr17,82237761,1.3201948627103632,1354,1128,2482,+
chr17,82237785,1.403872053872054,1344,1079,2423,+
chr17,82237820,1.7615384615384615,1144,870,2014,+
chr17,82237829,1.4445545956663364,1223,920,2143,+
chr17,82238703,0.4966926212502136,968,772,1740,+
chr17,82238704,1.70355466130114,761,496,1257,+
chr17,82238722,2.9688004846526654,890,618,1508,+
chr17,82238724,0.6397144711226476,1271,919,2190,+
chr17,82238725,1.4182306028396583,2528,1540,4068,+
chr17,82238730,1.4841745600024276,3442,2206,5648,+
chr17,82238731,1.6375739644970413,1106,844,1950,+
chr17,82238737,1.6178571428571429,1207,951,2158,+
chr17,82238740,1.3926945968024274,1988,1462,3450,+
chr17,82238866,1.4514103887168903,4821,2906,7727,+
chr17,82238868,1.4514103887168903,4821,2906,7727,+
chr17,82238893,2.3928193366266757,1084,871,1955,+
chr17,82238905,3.3207169411242496,4193,3240,7433,+
chr17,82238908,1.5954290737281616,2177,1436,3613,+
chr17,82238932,0.7322843822843823,2059,1429,3488,+
chr17,82238933,1.002138984130136,2247,2064,4311,+
chr17,82238963,0.5880962431405657,1160,1029,2189,+
chr17,82239005,2.7867416714695343,6600,4414,11014,+
chr17,82239008,1.8753977028600084,6761,4717,11478,+
chr17,82239014,1.5791728525980913,1261,1024,2285,+
chr17,82239038,0.7809945512911859,3172,2230,5402,+
chr17,82239129,2.708343628640635,3577,1248,4825,+
chr17,82239142,13.158770343580473,3789,2099,5888,+
chr17,82239143,17.38856721007323,15247,9634,24881,+
chr17,82239144,18.164989672387595,18605,11734,30339,+
chr17,82239145,19.129845070414532,17360,11220,28580,+
chr17,82239153,0.5880350194552529,1859,1284,3143,+
chr17,82239170,0.7191899442653813,5519,5093,10612,+
chr17,82239225,1.4733322103476891,2745,1586,4331,+
chr17,82239310,6.912366912366912,3375,329,3704,+
chr17,82239311,12.29917808219178,7481,437,7918,+
chr17,82239312,10.500488694483916,16548,1274,17822,+
chr17,82239313,63.889103826251336,19058,2865,21923,+
chr17,82239315,42.46315167700937,19164,6892,26056,+
chr17,82239316,40.23230727062076,13649,6504,20153,+
chr17,82239381,1.431627906976744,1025,1099,2124,+
chr17,82363374,5.519958745070451,1175,1132,2307,+
chr17,82363375,4.519063554204307,988,985,1973,+
chr17,82363504,2.2127777218303475,922,644,1566,+
chr17,82363529,5.156105684380896,580,481,1061,+
chr17,82458710,0.6690097908074737,1046,403,1449,+
chr17,82468782,1.5965728374849073,604,480,1084,+
chr17,82478899,0.45011252813203295,599,433,1032,+
chr17,82478900,0.44082577479588647,742,592,1334,+
chr17,82481093,5.442161191541018,689,523,1212,+
chr17,82483729,1.3156097367860402,758,552,1310,+
chr17,82483730,0.8779011936339522,622,415,1037,+
chr17,82603734,2.514705882352941,1052,611,1663,+
chr17,82603736,2.514705882352941,1052,611,1663,+
chr17,83079957,0.42136710511487135,617,424,1041,+
chr17,83084952,1.6081663017633783,858,649,1507,+
chr17,83084979,0.6031678386249023,771,493,1264,+
chr17,83085031,0.4726640159045726,633,502,1135,+
chr17,83085206,2.936332987551868,646,481,1127,+
chr17,83085239,0.5968516244278218,890,688,1578,+
chr17,83085245,2.125075895567699,699,548,1247,+
chr17,83085272,1.5960937165374567,1095,630,1725,+
chr17,83093186,2.192309356718788,1458,886,2344,+
chr17,83094273,2.022512708787219,556,458,1014,+
chr17,83094276,1.837290732027574,578,480,1058,+
chr17,83094277,1.891238380243638,1640,1112,2752,+
chr17,83094300,2.0921666944733315,1705,1263,2968,+
chr17,83094315,0.4610115911485774,699,583,1282,+
chr17,83094435,1.8316645310682613,827,786,1613,+
chr17,83094459,2.024149731558262,945,801,1746,+
chr17,83094461,0.45115922857341784,863,541,1404,+
chr17,83094573,1.5908109447453187,976,656,1632,+
chr17,83094606,1.5747958533619044,823,556,1379,+
chr17,83094694,1.6516732637639442,679,396,1075,+
chr17,83094733,0.5881349126681389,650,585,1235,+
chr17,83094735,0.3331121951219512,775,624,1399,+
chr17,83094857,2.01913357400722,986,830,1816,+
chr17,83094858,2.01913357400722,986,830,1816,+
chr17,83094859,0.46367287331142754,634,497,1131,+
chr18,659640,2.3539587465963674,614,439,1053,+
chr18,662246,1.8503184713375795,580,470,1050,+
chr18,662264,0.5618774404335006,640,533,1173,+
chr18,669095,1.7636234961075723,622,470,1092,+
chr18,669120,0.9424034869240348,2017,1240,3257,+
chr18,669122,0.9424034869240348,2017,1240,3257,+
chr18,669127,2.0378192672692967,1764,1245,3009,+
chr18,669142,1.7089201877934272,2001,1490,3491,+
chr18,670695,1.4101944923571048,1601,730,2331,+
chr18,670699,1.9645856662933927,2004,1033,3037,+
chr18,670720,1.5216489895683296,5577,3272,8849,+
chr18,670721,1.5216489895683296,5577,3272,8849,+
chr18,670726,1.664745795634871,11470,7594,19064,+
chr18,670727,1.6962681472499248,10283,6756,17039,+
chr18,670728,1.5012011827222127,19126,13015,32141,+
chr18,670730,1.5987939915709088,11472,8164,19636,+
chr18,670732,1.4610686422371018,17901,13034,30935,+
chr18,670733,1.474998658759752,16269,12125,28394,+
chr18,670735,1.2490575785761466,31426,21116,52542,+
chr18,670736,1.2240699227322591,14290,8491,22781,+
chr18,670739,1.462219551918924,18923,13547,32470,+
chr18,671390,1.9274251208842406,1098,757,1855,+
chr18,672861,5.814814814814816,627,431,1058,+
chr18,672892,1.9430651241388277,1211,1098,2309,+
chr18,672893,1.9430651241388277,1211,1098,2309,+
chr18,673310,2.0236943907156677,774,516,1290,+
chr18,673397,6.19087879165308,1576,1130,2706,+
chr18,2587896,2.2205554216187475,804,654,1458,+
chr18,2589226,0.5859504132231405,708,604,1312,+
chr18,3247823,1.9370557116878826,918,525,1443,+
chr18,3247825,1.9370557116878826,918,525,1443,+
chr18,3247856,1.857013574660633,607,519,1126,+
chr18,3253232,2.1263786764705883,660,511,1171,+
chr18,3253235,2.2918533266965317,726,573,1299,+
chr18,3253258,0.6687711327134404,872,727,1599,+
chr18,3253259,1.4127868228125298,1005,777,1782,+
chr18,3253265,2.037139423076923,996,831,1827,+
chr18,3253277,1.9298115079365084,1254,1007,2261,+
chr18,3253278,1.7333972668424842,1204,969,2173,+
chr18,3253892,1.6605975648024427,3283,2360,5643,+
chr18,3253913,1.6671580188679245,1391,1023,2414,+
chr18,3253946,0.5227272727272727,1448,971,2419,+
chr18,3253980,1.6095795043163466,1444,1025,2469,+
chr18,3254008,2.1758816167267905,1284,1155,2439,+
chr18,3254011,1.501442015786278,1354,1219,2573,+
chr18,3254012,1.8236194923734725,1414,1345,2759,+
chr18,3255758,0.27185787038836834,998,886,1884,+
chr18,3255823,2.1105990783410142,1144,769,1913,+
chr18,3255828,1.3210338903916656,3280,2393,5673,+
chr18,3255830,1.7164551825318788,2074,1581,3655,+
chr18,3256115,1.0609579106849296,3091,2376,5467,+
chr18,3256121,1.97340930674264,1038,896,1934,+
chr18,3262137,1.5801133741030156,1020,796,1816,+
chr18,3262138,1.115017274874174,1744,1083,2827,+
chr18,3262139,1.115017274874174,1744,1083,2827,+
chr18,3262190,1.7432547571712582,989,502,1491,+
chr18,3272888,1.8095744680851065,692,516,1208,+
chr18,3272908,0.6952838717432662,2740,1948,4688,+
chr18,3272916,2.5705705705705704,855,665,1520,+
chr18,3272931,1.4511281291172593,1854,1103,2957,+
chr18,3273000,1.8153988332466935,897,596,1493,+
chr18,3273012,0.7303465765004226,1655,1182,2837,+
chr18,3273016,1.7860116527538896,2859,2069,4928,+
chr18,3273020,1.619631901840491,1099,814,1913,+
chr18,3277254,1.5401635401635396,1600,1133,2733,+
chr18,3277256,1.5401635401635396,1600,1133,2733,+
chr18,3277349,1.3244444444444443,2383,1799,4182,+
chr18,3277372,1.703428853122594,2969,2530,5499,+
chr18,3277375,1.5916922801468176,3603,3242,6845,+
chr18,3277376,1.5916922801468176,3603,3242,6845,+
chr18,3277377,1.5043412165491408,6030,4798,10828,+
chr18,3277777,1.569267220839731,3619,2221,5840,+
chr18,3277779,1.569267220839731,3619,2221,5840,+
chr18,3277847,1.6983635559486956,959,713,1672,+
chr18,3277984,1.5131591067108836,4866,3580,8446,+
chr18,3278079,1.2514912425036064,8542,6244,14786,+
chr18,3278101,1.84838685842328,6586,6240,12826,+
chr18,8638605,1.126271186440678,885,589,1474,+
chr18,8638606,1.126271186440678,885,589,1474,+
chr18,9102730,0.4541987366410991,895,715,1610,+
chr18,9122514,3.179536952314407,664,461,1125,+
chr18,9124873,0.5398410434073773,882,700,1582,+
chr18,9124875,0.5398410434073773,882,700,1582,+
chr18,9134215,4.982078853046595,694,402,1096,+
chr18,9775290,2.299091544374563,657,476,1133,+
chr18,9775292,1.9985966599458624,1209,920,2129,+
chr18,9815135,2.2667524266167702,1490,1005,2495,+
chr18,9815136,2.2667524266167702,1490,1005,2495,+
chr18,9815168,1.5680880330123796,1272,726,1998,+
chr18,9815169,0.6676525358746851,1059,536,1595,+
chr18,9845583,0.6863746872907932,1947,842,2789,+
chr18,9845595,1.5620549818694145,3924,1937,5861,+
chr18,9845604,1.4060985214025046,2880,1430,4310,+
chr18,9845614,1.27483475401378,9977,5406,15383,+
chr18,9845615,1.5392558159455336,6868,3601,10469,+
chr18,9845623,1.932066046183789,7300,4228,11528,+
chr18,9859258,1.5130466958449018,714,537,1251,+
chr18,9859352,2.620592743995912,788,411,1199,+
chr18,9859353,2.620592743995912,788,411,1199,+
chr18,9859501,4.451134613245271,862,700,1562,+
chr18,9859711,0.4920512820512821,807,599,1406,+
chr18,9859817,0.39717978848413626,675,459,1134,+
chr18,9860050,2.133426602990083,890,605,1495,+
chr18,9860208,0.5753153417424464,522,486,1008,+
chr18,9860740,1.9793702158522606,961,649,1610,+
chr18,9861190,1.6604593091669702,1582,1194,2776,+
chr18,9861218,2.315086782376502,1019,748,1767,+
chr18,9861220,2.315086782376502,1019,748,1767,+
chr18,9861321,1.768816067653277,576,472,1048,+
chr18,9861350,0.5574162679425837,698,527,1225,+
chr18,9861366,0.5661337209302326,930,687,1617,+
chr18,9861375,0.648,1052,649,1701,+
chr18,9861381,1.3077410242690763,2087,1353,3440,+
chr18,9861396,2.073411765682112,2735,1890,4625,+
chr18,9861407,1.4705381632460042,1689,1089,2778,+
chr18,9861417,0.9293100538988157,3669,2619,6288,+
chr18,9861429,1.5312166804880938,2349,1467,3816,+
chr18,9861456,1.4601971576456827,8776,6290,15066,+
chr18,9861899,2.2585290827740487,556,446,1002,+
chr18,9861966,1.6487404248598279,802,468,1270,+
chr18,9931878,2.509273335360292,785,597,1382,+
chr18,9936126,2.0886359395409597,860,465,1325,+
chr18,9936130,1.5821462488129152,832,539,1371,+
chr18,9950425,2.4947375345349294,1024,690,1714,+
chr18,9950436,1.4860553668827832,1082,737,1819,+
chr18,9950440,1.4921230307576896,1104,774,1878,+
chr18,9950552,1.5176124513073996,2396,1908,4304,+
chr18,9954206,1.7446033081020462,888,737,1625,+
chr18,9954245,1.8850646209136772,1090,741,1831,+
chr18,9954252,1.7469135802469136,565,467,1032,+
chr18,9954292,1.7256617807919492,985,652,1637,+
chr18,9954322,2.0365644171779143,1157,814,1971,+
chr18,9954366,1.4728192423690054,6164,5147,11311,+
chr18,9954367,1.4339345592481971,10342,8349,18691,+
chr18,9954368,1.4528259454184056,8466,7154,15620,+
chr18,9954369,1.4957762834769714,9021,7847,16868,+
chr18,9954371,1.7166962579685148,7268,6570,13838,+
chr18,9954372,1.9193649908373838,4966,4563,9529,+
chr18,9954378,1.3801445712958702,7993,6959,14952,+
chr18,9954379,1.3544569055834257,8627,7374,16001,+
chr18,9954627,2.4337807606263984,945,744,1689,+
chr18,9954651,1.5010002500625157,979,743,1722,+
chr18,11851557,1.7992075774232215,1255,841,2096,+
chr18,11851558,2.25326264274062,974,612,1586,+
chr18,11851859,0.5771071034228928,587,417,1004,+
chr18,11852154,2.1572673137601526,727,594,1321,+
chr18,11999077,1.8192026951151041,647,410,1057,+
chr18,11999093,2.09061262520382,717,476,1193,+
chr18,12028068,0.3185393258426966,566,444,1010,+
chr18,12028070,0.3185393258426966,566,444,1010,+
chr18,12028856,0.7517791449166612,821,632,1453,+
chr18,12028905,0.4090214412338807,629,469,1098,+
chr18,12030582,1.9631718184349762,610,419,1029,+
chr18,12308298,2.226163663663664,817,332,1149,+
chr18,12308299,2.226163663663664,817,332,1149,+
chr18,12326252,1.1498541366757271,708,519,1227,+
chr18,12326261,1.8684355997788835,844,736,1580,+
chr18,12326263,1.8684355997788835,844,736,1580,+
chr18,12326289,0.5081947162426614,553,510,1063,+
chr18,12326307,1.8567080592831267,1470,1244,2714,+
chr18,12326483,0.44120458891013387,638,522,1160,+
chr18,12326484,0.44120458891013387,638,522,1160,+
chr18,12725479,0.896864111498258,701,491,1192,+
chr18,12725480,0.896864111498258,701,491,1192,+
chr18,12985598,3.9251527843900686,692,510,1202,+
chr18,21612353,0.5630579079880981,614,513,1127,+
chr18,21612368,1.362146634458445,2047,1801,3848,+
chr18,21612370,1.4202392022984058,3145,2810,5955,+
chr18,21612371,1.5378376155888582,3157,2606,5763,+
chr18,21612383,1.5585553659604245,2446,2166,4612,+
chr18,21612384,1.577190542420028,1007,718,1725,+
chr18,21622723,1.409130369811643,1950,1578,3528,+
chr18,21622724,0.770179425273911,9476,6717,16193,+
chr18,21622726,0.5913173041596931,6437,4453,10890,+
chr18,21622728,1.5400026520527015,3274,2439,5713,+
chr18,21623775,1.6092610145127126,1899,1291,3190,+
chr18,21623783,1.596328444577472,1199,770,1969,+
chr18,21629069,2.6858453473132373,620,544,1164,+
chr18,21629111,2.634639696586599,1041,790,1831,+
chr18,21629113,2.634639696586599,1041,790,1831,+
chr18,21629114,3.8115530303030303,643,383,1026,+
chr18,21629116,2.6809523809523808,562,447,1009,+
chr18,21629133,2.5847887896019497,1696,1230,2926,+
chr18,21629135,2.5847887896019497,1696,1230,2926,+
chr18,22946449,2.158742012736132,1246,704,1950,+
chr18,22946451,4.463789463232105,733,386,1119,+
chr18,22946465,2.5563829787234043,622,469,1091,+
chr18,22949628,2.6027077497665734,1337,755,2092,+
chr18,22949629,2.5005355608479474,1816,1047,2863,+
chr18,22949640,2.222488611843682,926,581,1507,+
chr18,22949645,1.5534748481369411,2326,1655,3981,+
chr18,22949646,1.9861848455598454,1352,1035,2387,+
chr18,22949647,1.0395067117756194,761,538,1299,+
chr18,22949648,1.65256170508624,2113,1573,3686,+
chr18,22949653,1.4774256576958134,3078,2244,5322,+
chr18,22993799,2.2194485626651974,704,482,1186,+
chr18,26600025,3.1120943952802365,632,564,1196,+
chr18,26600027,3.1120943952802365,632,564,1196,+
chr18,28652644,0.4126555705503074,687,350,1037,+
chr18,28652665,2.672964810002107,884,618,1502,+
chr18,31520865,3.0024968290274674,593,473,1066,+
chr18,31520896,3.322993288945255,793,784,1577,+
chr18,31531136,3.0167825159347,1146,736,1882,+
chr18,31531139,2.5843942505133466,650,486,1136,+
chr18,31542627,1.9795841209829868,615,528,1143,+
chr18,31542628,2.2453879184048486,1805,1298,3103,+
chr18,31542630,2.5294346978557503,810,512,1322,+
chr18,31547240,0.31443123862391187,1515,993,2508,+
chr18,31547241,0.42490757440634497,2765,1618,4383,+
chr18,31547242,0.2938067092822881,1329,793,2122,+
chr18,31547243,0.6078406208366856,1034,565,1599,+
chr18,35291202,0.8542706964520368,1181,760,1941,+
chr18,35291203,0.8542706964520368,1181,760,1941,+
chr18,35291210,2.7613186191284664,672,588,1260,+
chr18,35291211,2.7613186191284664,672,588,1260,+
chr18,35306071,0.4291641967990515,723,481,1204,+
chr18,35306073,0.4291641967990515,723,481,1204,+
chr18,35683447,3.21948467180741,633,408,1041,+
chr18,35683448,3.21948467180741,633,408,1041,+
chr18,35691066,0.956043956043956,637,428,1065,+
chr18,35691067,1.7461789103441863,839,573,1412,+
chr18,35709799,0.9706521739130436,610,459,1069,+
chr18,35709800,0.9706521739130436,610,459,1069,+
chr18,35710523,3.0201759771098464,748,459,1207,+
chr18,35710583,2.6363636363636367,608,461,1069,+
chr18,35710585,2.8974888747616023,926,725,1651,+
chr18,35710586,2.487128712871287,627,504,1131,+
chr18,35710611,2.561024056499669,966,984,1950,+
chr18,35710613,1.7328417910645197,1722,1639,3361,+
chr18,35710802,3.119395618134054,625,448,1073,+
chr18,35979020,2.2429378531073447,793,353,1146,+
chr18,36133280,2.2183930100888754,835,592,1427,+
chr18,36138307,1.9592530922763067,1169,755,1924,+
chr18,36138359,1.7159942212114387,891,585,1476,+
chr18,36145973,2.1300675675675675,581,443,1024,+
chr18,36164568,2.9748459034775996,1672,1206,2878,+
chr18,36171078,0.5961476725521669,618,444,1062,+
chr18,36171088,0.5378749578699024,750,551,1301,+
chr18,36199796,0.7177803361027095,717,491,1208,+
chr18,36199798,2.716752349999562,610,444,1054,+
chr18,36213371,0.6887697463908851,755,594,1349,+
chr18,36213372,1.5102261330532072,700,497,1197,+
chr18,36213387,3.5397196261682247,605,427,1032,+
chr18,36213389,2.0125892211673118,1124,842,1966,+
chr18,36213390,0.9647597254004576,619,436,1055,+
chr18,36248950,1.0059523809523812,545,503,1048,+
chr18,36248952,1.497829921018327,971,754,1725,+
chr18,36251267,2.283969465648855,611,392,1003,+
chr18,36260059,2.4655093788261406,848,592,1440,+
chr18,36266791,2.157702481420834,570,466,1036,+
chr18,36268544,2.287620954287621,856,554,1410,+
chr18,36268545,2.287620954287621,856,554,1410,+
chr18,41970351,1.1820175438596492,685,455,1140,+
chr18,41970352,1.1820175438596492,685,455,1140,+
chr18,41970393,2.3718548393478533,1165,861,2026,+
chr18,41970396,1.717719680464778,762,458,1220,+
chr18,59902889,2.1989094357515406,874,702,1576,+
chr18,59902890,2.1989094357515406,874,702,1576,+
chr18,70325960,1.9647818270959307,686,421,1107,+
chr18,70325962,1.847405727194207,1424,964,2388,+
chr18,70325964,2.5509931245225363,721,475,1196,+
chr18,79715243,4.369719985458235,527,1219,1746,+
chr18,79715245,2.96402650671448,552,1023,1575,+
chr18,79715258,0.13661249423697555,430,963,1393,+
chr18,79970684,6.8233568093997405,763,566,1329,+
chr19,537058,2.24649438788828,755,522,1277,+
chr19,537060,2.22,628,424,1052,+
chr19,572571,0.9582777777777777,733,479,1212,+
chr19,572573,0.9582777777777777,733,479,1212,+
chr19,572595,1.7145257062931805,1113,664,1777,+
chr19,572598,1.2428887659103487,606,519,1125,+
chr19,572604,0.6634146341463415,713,614,1327,+
chr19,572611,1.529449202382915,2487,1396,3883,+
chr19,572621,1.4892018779342724,1585,922,2507,+
chr19,572622,1.6162844036697248,1565,1089,2654,+
chr19,572661,1.7752020038784744,2132,1546,3678,+
chr19,579512,1.6479404199777343,2332,1370,3702,+
chr19,579513,1.3327560731478685,1765,1113,2878,+
chr19,579516,2.10664359300219,1854,1192,3046,+
chr19,579520,1.4402749652661118,4108,2794,6902,+
chr19,579521,1.4402749652661118,4108,2794,6902,+
chr19,579534,2.5104205922322333,2313,1716,4029,+
chr19,579537,1.3526714944152074,16657,11694,28351,+
chr19,579538,1.36571295583353,12759,8759,21518,+
chr19,579640,1.3354852876592007,1293,1034,2327,+
chr19,580445,1.3432867883995705,1351,979,2330,+
chr19,580655,1.4172198172198172,1269,944,2213,+
chr19,580676,1.4632628221917512,1695,1380,3075,+
chr19,580681,1.3926313922703724,2176,1773,3949,+
chr19,580758,1.4174008327854484,2108,1520,3628,+
chr19,580759,1.3375415697078308,2307,2057,4364,+
chr19,581378,1.7772972972972976,2054,1664,3718,+
chr19,581549,1.315325698988697,2080,1311,3391,+
chr19,581555,1.1999259533506108,1388,1146,2534,+
chr19,581558,1.5804670629355062,1650,1425,3075,+
chr19,582513,0.998540563004376,4400,2775,7175,+
chr19,582515,1.2839492616545474,4381,2723,7104,+
chr19,582533,1.0143163635851922,3172,2368,5540,+
chr19,582793,1.7961556026072159,1351,1146,2497,+
chr19,582797,1.5004111078831839,5719,4219,9938,+
chr19,582813,1.4045637888663318,3524,3055,6579,+
chr19,582814,1.347167380940916,6807,4371,11178,+
chr19,582815,1.3684328518955429,10331,7426,17757,+
chr19,582854,0.7719606104447659,3445,3060,6505,+
chr19,583042,2.0487673256078165,1360,977,2337,+
chr19,583055,1.6769170531895667,1661,1276,2937,+
chr19,583081,1.3423445478074498,3420,2751,6171,+
chr19,583121,0.9998699664912125,4277,3529,7806,+
chr19,583278,0.7770255652586866,1817,1306,3123,+
chr19,583331,1.793403311287107,13272,8942,22214,+
chr19,583332,1.793403311287107,13272,8942,22214,+
chr19,677922,2.691811655313564,695,484,1179,+
chr19,681511,2.4676850763807288,839,591,1430,+
chr19,681512,2.4339795198925636,1110,790,1900,+
chr19,681783,0.46581594634873336,1666,975,2641,+
chr19,681784,0.46581594634873336,1666,975,2641,+
chr19,681904,9.17007434944238,1011,537,1548,+
chr19,681905,16.69858985654795,3215,1874,5089,+
chr19,681906,16.69858985654795,3215,1874,5089,+
chr19,682403,2.1575787120252525,819,656,1475,+
chr19,683190,1.8319672544094943,965,686,1651,+
chr19,797450,0.4607711071467579,903,453,1356,+
chr19,797451,0.8274524482830806,1138,679,1817,+
chr19,803593,1.718918918918919,1006,664,1670,+
chr19,804094,2.21455938697318,679,579,1258,+
chr19,804302,0.9741915422885572,1204,669,1873,+
chr19,804303,0.9741915422885572,1204,669,1873,+
chr19,804339,2.303341902313625,639,388,1027,+
chr19,804352,1.6542669584245078,699,456,1155,+
chr19,805499,2.796386293059442,1141,686,1827,+
chr19,805500,0.25399843231117936,604,457,1061,+
chr19,805501,1.9559523809523809,1430,809,2239,+
chr19,805503,1.8752362948960304,991,574,1565,+
chr19,806491,4.746021505376344,760,464,1224,+
chr19,806492,4.746021505376344,760,464,1224,+
chr19,806518,0.4516918493296446,565,507,1072,+
chr19,806519,1.1203825300594614,1053,844,1897,+
chr19,806525,2.1868245372555384,868,686,1554,+
chr19,808670,2.33462981734414,868,581,1449,+
chr19,808716,0.5199094598395457,1024,771,1795,+
chr19,808721,1.662224471434998,720,493,1213,+
chr19,810567,1.9248669201520912,1807,1051,2858,+
chr19,810568,1.9248669201520912,1807,1051,2858,+
chr19,810574,2.0826728144762585,1379,907,2286,+
chr19,810713,2.483817552310703,549,510,1059,+
chr19,810876,0.3543150684931507,738,583,1321,+
chr19,810892,1.1823519915069094,2219,1627,3846,+
chr19,810979,1.8923010752688167,646,464,1110,+
chr19,811225,26.62259434483666,2180,1044,3224,+
chr19,811227,17.703199668543483,2929,1662,4591,+
chr19,811228,14.940838667231965,1952,1310,3262,+
chr19,811250,24.839543546522272,1064,1201,2265,+
chr19,811268,0.36965516152769523,556,584,1140,+
chr19,811323,0.4565608919382505,506,582,1088,+
chr19,811324,0.4565608919382505,506,582,1088,+
chr19,811432,0.5996342737722048,997,659,1656,+
chr19,811435,0.6027649769585254,1089,874,1963,+
chr19,811450,1.9220366086981462,2274,1881,4155,+
chr19,811618,2.8446621014818136,1468,1047,2515,+
chr19,811715,1.513213677293916,1009,531,1540,+
chr19,811779,1.8163399924613643,1284,757,2041,+
chr19,811781,1.762375565703063,1731,1127,2858,+
chr19,811836,0.4017825311942959,965,659,1624,+
chr19,811937,6.256804324534279,1202,589,1791,+
chr19,811939,1.1043112897332843,2014,951,2965,+
chr19,811940,1.8906403234530966,2401,1200,3601,+
chr19,811941,1.5208697764820214,2121,1028,3149,+
chr19,811942,1.32176459474778,1626,789,2415,+
chr19,811959,2.5603977152528032,1273,651,1924,+
chr19,811960,2.5603977152528032,1273,651,1924,+
chr19,811985,1.9259358288770052,685,373,1058,+
chr19,811992,0.5956325710250421,644,448,1092,+
chr19,812032,2.1268700498679958,852,486,1338,+
chr19,812070,1.603765323992995,813,570,1383,+
chr19,812154,1.6504858891542649,1345,1065,2410,+
chr19,812198,2.1288389513108608,783,533,1316,+
chr19,863273,0.8384128809660726,728,628,1356,+
chr19,863337,1.4052880177685474,681,603,1284,+
chr19,1104069,0.8072864622952192,1018,489,1507,+
chr19,1104072,1.2996353820392061,787,434,1221,+
chr19,1105185,13.736007462686567,774,267,1041,+
chr19,1105186,13.736007462686567,774,267,1041,+
chr19,1105201,2.490452962086634,735,449,1184,+
chr19,1105207,2.4887133182844248,979,442,1421,+
chr19,1105209,2.4887133182844248,979,442,1421,+
chr19,1105228,1.9804570044541014,1068,684,1752,+
chr19,1105230,1.9749701433121016,922,627,1549,+
chr19,1105239,0.4052540474493433,795,426,1221,+
chr19,1105261,2.149802723685885,888,581,1469,+
chr19,1105379,1.7363413387838529,1908,1029,2937,+
chr19,1105400,1.4783321746315514,3133,1961,5094,+
chr19,1105408,1.593468664926645,7661,4721,12382,+
chr19,1105409,1.826245259165613,6018,3954,9972,+
chr19,1105464,1.1680738192353288,9549,5170,14719,+
chr19,1105465,1.397562271937543,6473,3710,10183,+
chr19,1105492,2.141706311449413,4403,3152,7555,+
chr19,1105676,1.499731182795699,796,619,1415,+
chr19,1105781,2.701070663811563,900,466,1366,+
chr19,1106403,2.5663530724322996,953,743,1696,+
chr19,1106544,0.5664711952841767,985,744,1729,+
chr19,1106632,1.1718343765319201,1034,675,1709,+
chr19,1203507,1.8941794245001724,991,670,1661,+
chr19,1258737,40.48908509338493,947,1275,2222,+
chr19,1258738,40.48908509338493,947,1275,2222,+
chr19,1258749,4.10056650144429,427,705,1132,+
chr19,1272427,0.7515736158778143,655,531,1186,+
chr19,1272429,1.5151653195309895,701,564,1265,+
chr19,1272441,0.5576759966072943,788,523,1311,+
chr19,1272442,1.070264464371085,1941,1516,3457,+
chr19,1272443,0.5442663813508957,2008,1370,3378,+
chr19,1272444,1.8650975889781856,721,669,1390,+
chr19,1272637,4.039871479048472,712,470,1182,+
chr19,1421198,1.87614963136769,875,787,1662,+
chr19,1421199,1.6882236550769951,1115,876,1991,+
chr19,1438378,1.0717487134326364,668,421,1089,+
chr19,1438395,0.6056967984934086,1161,530,1691,+
chr19,1438396,0.5969499723418956,1865,1091,2956,+
chr19,1438401,1.685207100591716,800,350,1150,+
chr19,1438413,1.7391518554727867,1335,737,2072,+
chr19,1438808,1.5754667644614027,2426,1332,3758,+
chr19,1438810,1.502471898545454,3119,1980,5099,+
chr19,1438819,0.994584748169073,3010,2540,5550,+
chr19,1438820,0.6381814030784261,1560,1230,2790,+
chr19,1438821,1.2570435531496065,1433,1023,2456,+
chr19,1438824,1.3849661021189303,2108,1125,3233,+
chr19,1438842,1.6362191899454923,10020,7940,17960,+
chr19,1438843,1.805883211107434,4879,4072,8951,+
chr19,1440082,1.484425021949782,2114,1779,3893,+
chr19,1440083,1.7674851883593543,1281,570,1851,+
chr19,1440140,1.412645325688804,2660,1931,4591,+
chr19,1440233,2.766432116947581,1236,678,1914,+
chr19,1440351,1.610347460862925,2409,1066,3475,+
chr19,1440352,1.7479253759281212,608,516,1124,+
chr19,1440353,1.5885518078847645,5143,2348,7491,+
chr19,1440354,1.49683369003207,6650,3330,9980,+
chr19,1440355,1.4708256738769432,7866,4394,12260,+
chr19,1440363,1.4070559476607154,3034,1846,4880,+
chr19,1440364,1.4594490429616118,4786,2753,7539,+
chr19,1440367,1.9394045709703291,1634,1031,2665,+
chr19,1440375,1.5487422696677025,5744,3584,9328,+
chr19,1440376,1.4547581133830305,3634,2446,6080,+
chr19,1440382,1.6484389924552196,4242,3044,7286,+
chr19,1440384,1.3707556548043942,5791,4190,9981,+
chr19,1440387,1.3338645418326691,1673,1254,2927,+
chr19,1440391,1.3795726376162831,2544,1971,4515,+
chr19,1979199,1.9939544422887292,895,523,1418,+
chr19,1979200,2.3105887247763683,765,417,1182,+
chr19,1979203,1.122376916868442,889,471,1360,+
chr19,1979204,2.102178313544216,993,648,1641,+
chr19,1979205,1.122376916868442,889,471,1360,+
chr19,1979206,2.102178313544216,993,648,1641,+
chr19,1979210,1.754504504504505,626,443,1069,+
chr19,1979217,1.8921404682274248,729,519,1248,+
chr19,1979228,2.2873194221508832,824,622,1446,+
chr19,1979231,1.656474294436686,918,750,1668,+
chr19,2245486,1.9640241601864097,593,416,1009,+
chr19,2245497,2.3485126521151245,1246,667,1913,+
chr19,2245498,2.3485126521151245,1246,667,1913,+
chr19,2245501,3.2421647230320696,658,391,1049,+
chr19,2246758,1.0313909639797187,1465,1137,2602,+
chr19,2246762,1.7823258526383525,1720,1343,3063,+
chr19,2246763,1.7823258526383525,1720,1343,3063,+
chr19,2246767,1.5726978349880911,1030,868,1898,+
chr19,2246772,1.4192462572261475,2368,2187,4555,+
chr19,2246773,1.5264849742865354,4679,4201,8880,+
chr19,2246775,1.6087877025342747,2507,2406,4913,+
chr19,2269519,0.918063675965028,3544,1331,4875,+
chr19,2269524,1.1951383737009542,3106,1143,4249,+
chr19,2269525,2.243650663878609,2216,1191,3407,+
chr19,2269534,2.3016274133225507,2276,760,3036,+
chr19,2269552,2.0683679899180847,2989,1586,4575,+
chr19,2269553,1.6688068847436246,5925,2465,8390,+
chr19,2269554,1.8512516883903203,11422,5728,17150,+
chr19,2269568,1.9618011474714194,7565,3947,11512,+
chr19,2269569,1.8531656669124532,6563,3248,9811,+
chr19,2269602,1.4924202856919018,3312,2055,5367,+
chr19,2269603,1.7548209366391183,1273,923,2196,+
chr19,2271406,1.5428311747330152,1679,1303,2982,+
chr19,2271408,1.5491312840546931,2597,2054,4651,+
chr19,2271409,1.3910645844604308,6862,5368,12230,+
chr19,2271410,1.3379414291902485,3472,2656,6128,+
chr19,2271462,1.2559092523998694,11455,7803,19258,+
chr19,2271463,0.9823328588000031,5824,4564,10388,+
chr19,2271464,1.2929517593583455,11215,6789,18004,+
chr19,2271465,1.2246677786999942,10192,6701,16893,+
chr19,2271471,0.5797473584969073,7107,4749,11856,+
chr19,2271484,1.4798173546623197,7914,6268,14182,+
chr19,2271908,1.2401358139606853,8250,5599,13849,+
chr19,2272801,1.2703742185590057,3128,2602,5730,+
chr19,2272802,1.3097981943706851,1843,1344,3187,+
chr19,2273040,1.4139214631522323,1775,1429,3204,+
chr19,2273147,2.0176470588235302,1028,679,1707,+
chr19,2273164,4.009880768015725,20645,15994,36639,+
chr19,2273165,3.2391139382232708,23982,18988,42970,+
chr19,2273166,3.089801000645054,14583,10827,25410,+
chr19,2273167,1.6551530516126771,8672,7693,16365,+
chr19,2273168,0.8726423688499426,4453,3966,8419,+
chr19,2273206,0.7994751472215744,3322,2728,6050,+
chr19,2273332,4.161889049288513,960,745,1705,+
chr19,2478110,2.0092212320805887,773,444,1217,+
chr19,2478112,1.9014257435666144,1243,752,1995,+
chr19,2478113,1.6703135492210583,1476,1006,2482,+
chr19,2478115,1.0538558265962938,1225,908,2133,+
chr19,2478119,0.5146136618141097,706,469,1175,+
chr19,2478122,1.5326836225338722,727,600,1327,+
chr19,2478145,0.6172807132555395,1711,1051,2762,+
chr19,2478147,1.8620590490797546,1294,1303,2597,+
chr19,2790431,0.36207441418008773,727,729,1456,+
chr19,2790433,0.3502928257686677,637,682,1319,+
chr19,3572976,1.044554585242876,2928,1711,4639,+
chr19,3572977,1.0735426358269557,2029,1315,3344,+
chr19,3572978,1.044554585242876,2928,1711,4639,+
chr19,3572980,0.6232444444444445,757,449,1206,+
chr19,3572981,0.5736101169172035,600,507,1107,+
chr19,3573702,3.2378075097108328,725,330,1055,+
chr19,3573704,2.9181418237900014,1089,538,1627,+
chr19,3573737,2.138900315370904,820,560,1380,+
chr19,3573738,2.138900315370904,820,560,1380,+
chr19,3573740,2.7145877378435515,641,472,1113,+
chr19,3573741,2.723533029501828,1048,784,1832,+
chr19,3574387,1.0580679086538465,938,767,1705,+
chr19,3574388,1.280666860749757,1609,1313,2922,+
chr19,3574406,0.4489836194987171,699,562,1261,+
chr19,3574422,1.0221239477306336,1623,1230,2853,+
chr19,3574435,0.6211878009630819,1160,622,1782,+
chr19,3574487,2.198359641392255,1372,1002,2374,+
chr19,3574494,1.819693303053959,1519,931,2450,+
chr19,3574500,0.5155730377257286,800,594,1394,+
chr19,3574519,0.5890808613351965,1626,1210,2836,+
chr19,3574521,0.5890808613351965,1626,1210,2836,+
chr19,3574530,1.6850191754554171,962,744,1706,+
chr19,3574559,2.011269572155181,1406,812,2218,+
chr19,3575540,1.3396040736926422,1581,970,2551,+
chr19,3575558,1.6062782467647523,5062,2989,8051,+
chr19,3575560,1.7061707523245981,4871,2729,7600,+
chr19,3575562,1.7068942614240168,3315,1881,5196,+
chr19,3575564,1.392570933506606,2170,1481,3651,+
chr19,3575573,1.4414807904333815,2517,1813,4330,+
chr19,3575578,1.4418433473086352,2734,2030,4764,+
chr19,3575597,1.8226014032465647,3376,2603,5979,+
chr19,3575608,1.6758045799576284,3815,3238,7053,+
chr19,3576568,1.9903385499840307,1186,807,1993,+
chr19,3577988,0.9652056967481635,621,616,1237,+
chr19,3577990,0.9652056967481635,621,616,1237,+
chr19,3578042,0.47630042694083813,840,498,1338,+
chr19,3578066,1.930701754385965,638,512,1150,+
chr19,3578073,1.6945100840797933,880,586,1466,+
chr19,3578545,2.348132487667371,594,472,1066,+
chr19,3578548,1.1907892014041386,1079,902,1981,+
chr19,3578660,1.6274980374565435,1987,1204,3191,+
chr19,3578661,1.6274980374565435,1987,1204,3191,+
chr19,3578662,0.5832134292565947,607,416,1023,+
chr19,3578695,2.083583583583584,723,665,1388,+
chr19,3578715,0.7197958026091889,1268,819,2087,+
chr19,3578745,1.3904247736613031,1553,1080,2633,+
chr19,3578840,2.2360093652736106,785,491,1276,+
chr19,3578849,2.932772384523954,704,479,1183,+
chr19,3578870,1.1152864435621102,1451,983,2434,+
chr19,3578872,1.1152864435621102,1451,983,2434,+
chr19,3578976,3.2846565847511027,718,528,1246,+
chr19,3578990,1.753663003663004,765,545,1310,+
chr19,3578992,1.830788485607009,1218,1019,2237,+
chr19,3578993,1.9289892781938933,2029,1620,3649,+
chr19,3579027,0.583228577414624,1309,1031,2340,+
chr19,4409027,2.4274076229269705,617,490,1107,+
chr19,4409054,2.204070726723897,1287,868,2155,+
chr19,4409067,1.6414169964198229,842,548,1390,+
chr19,4422719,8.297682635167067,541,481,1022,+
chr19,4724078,1.6093335543766578,705,831,1536,+
chr19,4941529,2.8091130280911303,1015,547,1562,+
chr19,4941530,2.8091130280911303,1015,547,1562,+
chr19,4941531,2.830612244897959,1386,769,2155,+
chr19,4941533,1.920631141022924,1172,728,1900,+
chr19,4941543,1.062265566391598,943,619,1562,+
chr19,4941544,1.062265566391598,943,619,1562,+
chr19,4941556,2.3923809523809525,627,449,1076,+
chr19,4941559,1.5484702093397746,600,404,1004,+
chr19,4941567,0.6625516079965232,1773,1247,3020,+
chr19,4941568,0.6181831653823355,2780,1927,4707,+
chr19,4941570,0.8510851140689694,2963,2036,4999,+
chr19,4941571,1.3704423782497703,2872,1950,4822,+
chr19,4941576,2.128225679887003,3086,2443,5529,+
chr19,4941577,1.9104268453856454,3630,2816,6446,+
chr19,4941578,2.128225679887003,3086,2443,5529,+
chr19,4961753,2.269565217391304,818,454,1272,+
chr19,4961755,2.269565217391304,818,454,1272,+
chr19,4961798,1.593677670003323,537,467,1004,+
chr19,5641740,3.238383907691011,647,380,1027,+
chr19,5654064,2.0111456959119374,788,549,1337,+
chr19,5654065,4.1905882513037875,806,574,1380,+
chr19,5690264,0.706433653024278,6294,2561,8855,+
chr19,5690265,0.715949058316315,2656,1242,3898,+
chr19,5690266,0.6989327725172496,5203,1952,7155,+
chr19,5690273,1.791518695741574,2168,1252,3420,+
chr19,5690274,1.6930539845111587,4441,2186,6627,+
chr19,5690292,1.6122977121706428,9234,4334,13568,+
chr19,5690293,1.6122977121706428,9234,4334,13568,+
chr19,5690294,1.575217456122079,10930,5431,16361,+
chr19,5690507,1.8880407124681933,1059,785,1844,+
chr19,5690511,1.6753201396973223,2336,1717,4053,+
chr19,5690512,1.660941681291649,5301,3929,9230,+
chr19,5690515,1.4271809561815039,3868,2304,6172,+
chr19,5690520,0.6139115742044495,1743,1271,3014,+
chr19,5690538,1.5996636560012758,3677,2998,6675,+
chr19,5690540,1.4241541404975995,7211,4917,12128,+
chr19,5690550,1.2947874208834542,2872,2394,5266,+
chr19,5690553,1.3269170246682036,3142,2622,5764,+
chr19,5691336,1.609461729777807,2852,2227,5079,+
chr19,5691594,1.6895214146224016,1661,1288,2949,+
chr19,5691609,1.574486207275525,1569,1347,2916,+
chr19,6362449,4.008048952231812,976,695,1671,+
chr19,6362472,3.169084168345957,580,545,1125,+
chr19,6364597,2.142904263240454,663,422,1085,+
chr19,6364619,2.4784585661879235,786,631,1417,+
chr19,6366268,1.9377421364350231,766,645,1411,+
chr19,6368728,1.0852642782326531,561,453,1014,+
chr19,6374479,7.907370351540472,669,458,1127,+
chr19,6746465,1.8478380546942277,637,521,1158,+
chr19,6746468,2.830553199747622,743,653,1396,+
chr19,6750007,1.9447319928254796,623,481,1104,+
chr19,7631493,1.3589975006942516,724,553,1277,+
chr19,7682493,0.458944141051455,658,427,1085,+
chr19,7911481,4.029427174338655,1092,754,1846,+
chr19,7911483,3.7744758903877056,1403,1017,2420,+
chr19,7911497,2.7587301587301596,710,404,1114,+
chr19,7911499,2.1577416329208923,921,580,1501,+
chr19,7911527,1.913312693498452,617,390,1007,+
chr19,7911534,2.7576402052799485,1509,1005,2514,+
chr19,7911535,2.270406519778379,2329,1591,3920,+
chr19,7911537,1.7334706036295189,2375,1702,4077,+
chr19,7911552,1.675105618726095,2605,2020,4625,+
chr19,8402112,4.499208061609575,582,420,1002,+
chr19,8402496,2.795119773843178,605,516,1121,+
chr19,8402498,2.795119773843178,605,516,1121,+
chr19,8404244,0.9114219114219116,594,454,1048,+
chr19,8404245,1.8794052009502618,1055,855,1910,+
chr19,8444976,1.0290205468158593,3129,1586,4715,+
chr19,8444978,0.9579620707999087,3521,1848,5369,+
chr19,8444984,0.4271978393891807,2804,1251,4055,+
chr19,8444985,0.45014420125845966,3345,1532,4877,+
chr19,8444996,1.526676163779238,677,462,1139,+
chr19,8445043,0.3958345028911469,640,378,1018,+
chr19,8445045,0.3958345028911469,640,378,1018,+
chr19,8445056,2.6731517509727634,686,513,1199,+
chr19,8445057,2.6731517509727634,686,513,1199,+
chr19,8455409,1.1258767412088013,1211,802,2013,+
chr19,8455441,0.5060879243183083,1855,1197,3052,+
chr19,8455442,0.4980001249292236,3013,1886,4899,+
chr19,8455444,0.4910623757554468,2120,1297,3417,+
chr19,8455451,0.5981152993348116,1493,791,2284,+
chr19,8455498,1.6987792675605364,3143,1577,4720,+
chr19,8455537,1.9015638315488477,4548,3037,7585,+
chr19,8463599,0.5014125585737502,638,528,1166,+
chr19,8463610,0.4926186152995974,935,716,1651,+
chr19,8463611,2.193858477970627,631,748,1379,+
chr19,8463612,0.4926186152995974,935,716,1651,+
chr19,8463613,2.193858477970627,631,748,1379,+
chr19,8463636,0.698068879203399,1412,1152,2564,+
chr19,8466240,0.6285329744279946,933,742,1675,+
chr19,8466276,1.5001140250855187,1264,876,2140,+
chr19,8467536,1.3780623070987654,852,575,1427,+
chr19,8468822,3.0448717948717947,759,467,1226,+
chr19,8471382,2.9024726128093183,760,531,1291,+
chr19,8485612,3.2167608631767526,1155,769,1924,+
chr19,8485614,3.5155148095909734,996,708,1704,+
chr19,8485615,6.402753738365886,1391,1021,2412,+
chr19,8485829,0.3058947927720931,850,603,1453,+
chr19,8488749,3.791666666666667,587,503,1090,+
chr19,8488750,4.357754056012303,2165,1642,3807,+
chr19,8488822,0.614280800039314,999,797,1796,+
chr19,8488834,0.6122923588039867,775,601,1376,+
chr19,9827917,2.4605265819409206,1018,663,1681,+
chr19,9827918,2.404393731755269,1207,785,1992,+
chr19,9827946,1.967349010319743,801,513,1314,+
chr19,9827975,3.3948919449901767,639,508,1147,+
chr19,9828338,1.712696293470659,868,641,1509,+
chr19,9828348,2.6711678832116785,1125,684,1809,+
chr19,9828616,1.4745511669658888,698,556,1254,+
chr19,9828623,1.65609962283782,834,698,1532,+
chr19,9828652,1.6460837887067394,1290,1097,2387,+
chr19,9828846,1.4755741404486924,1891,1487,3378,+
chr19,9829982,1.4935110734941457,1924,1250,3174,+
chr19,9838447,2.139787277836382,636,378,1014,+
chr19,9849098,2.2776880960867945,750,526,1276,+
chr19,9849481,11.798655469395142,1948,1433,3381,+
chr19,9849482,11.478108875884905,2223,1747,3970,+
chr19,9849483,11.478108875884905,2223,1747,3970,+
chr19,9849489,0.28100187711884067,798,747,1545,+
chr19,9849491,0.33988472077860715,653,556,1209,+
chr19,10109919,0.6626838235294118,720,407,1127,+
chr19,10110378,9.296404231416021,705,459,1164,+
chr19,10110379,11.063935742054598,872,556,1428,+
chr19,10252252,3.476744186046512,735,343,1078,+
chr19,10254605,2.1544038400084045,647,446,1093,+
chr19,10258471,1.5412740819307276,605,422,1027,+
chr19,10284893,1.8868051154439305,796,485,1281,+
chr19,10654476,2.8093294129463247,774,626,1400,+
chr19,10670527,0.8725502512562814,957,795,1752,+
chr19,10670528,1.1557843150310956,1470,1230,2700,+
chr19,10670530,2.2704932420572232,994,843,1837,+
chr19,10670533,1.3183748907881403,971,822,1793,+
chr19,10671149,0.4803464357095271,617,473,1090,+
chr19,10671159,1.0667968825261362,1706,1260,2966,+
chr19,10671167,1.248712076726526,1424,1025,2449,+
chr19,10671442,2.838271289454388,901,702,1603,+
chr19,10677182,3.1084057971014496,765,574,1339,+
chr19,10677184,3.1084057971014496,765,574,1339,+
chr19,10677242,2.2107474568774883,768,475,1243,+
chr19,10680371,1.6524735417179424,745,477,1222,+
chr19,10680420,0.4445271779597915,596,473,1069,+
chr19,10681050,2.5786220413086083,1068,602,1670,+
chr19,10681051,2.5786220413086083,1068,602,1670,+
chr19,10681084,2.2186022458628845,1017,845,1862,+
chr19,10681085,2.2186022458628845,1017,845,1862,+
chr19,10681093,1.1633220845733447,1387,951,2338,+
chr19,10682158,1.0587375415282392,770,644,1414,+
chr19,10682160,1.0587375415282392,770,644,1414,+
chr19,10683179,2.1660686628807437,1386,1489,2875,+
chr19,10683180,1.987292422335727,1872,2051,3923,+
chr19,10683181,1.987292422335727,1872,2051,3923,+
chr19,10683182,2.112699416684237,1417,1580,2997,+
chr19,10683188,1.4858577848268568,1021,678,1699,+
chr19,10683189,0.4568547605196819,991,763,1754,+
chr19,10683721,7.763962799002407,740,471,1211,+
chr19,10683722,5.328196060888326,1220,850,2070,+
chr19,10683745,8.381445384016573,835,805,1640,+
chr19,10683746,8.39258987509834,760,796,1556,+
chr19,10684579,1.6963118496623653,731,530,1261,+
chr19,10685064,4.333352005535543,616,453,1069,+
chr19,10685203,3.4469619812632666,678,470,1148,+
chr19,10689257,2.100611113529649,900,578,1478,+
chr19,10689273,1.3487074807835844,1595,1188,2783,+
chr19,10689274,1.7030141103782248,1045,811,1856,+
chr19,10689288,2.3072456973060733,1334,902,2236,+
chr19,10689291,0.6087813115676892,720,373,1093,+
chr19,10689300,0.6637022397891963,1239,758,1997,+
chr19,10689307,1.732445308701993,1562,934,2496,+
chr19,10783003,1.6764518318353017,741,578,1319,+
chr19,10786605,2.4157119476268414,737,563,1300,+
chr19,10786607,2.4490145050459082,1071,804,1875,+
chr19,10786661,2.2670528365053695,675,436,1111,+
chr19,10793839,4.0562984554741695,653,462,1115,+
chr19,10820051,0.531281561929234,996,633,1629,+
chr19,10820073,1.818181818181818,719,395,1114,+
chr19,10831747,24.453532242538284,641,843,1484,+
chr19,10831748,23.10234639391479,741,1002,1743,+
chr19,10930150,1.3928914695116625,636,497,1133,+
chr19,10991187,1.4912097349333384,946,613,1559,+
chr19,10991192,3.4640009255929782,1262,592,1854,+
chr19,10991194,4.046296296296296,758,323,1081,+
chr19,10991204,1.0820771323967764,1226,743,1969,+
chr19,10991237,2.0022175536881424,1094,713,1807,+
chr19,10991241,1.6348522167487685,1179,811,1990,+
chr19,10996249,2.4878267176486633,607,453,1060,+
chr19,11007925,3.0524642289348174,639,517,1156,+
chr19,11007926,2.7936666666666667,866,719,1585,+
chr19,11007927,2.7936666666666667,866,719,1585,+
chr19,11007928,2.5998734177215193,892,789,1681,+
chr19,11007930,2.852145543929919,1124,955,2079,+
chr19,11007932,3.1260144101053613,897,753,1650,+
chr19,11035055,1.5589790258051786,566,457,1023,+
chr19,11035095,0.9879188712522046,658,377,1035,+
chr19,11035097,0.9879188712522046,658,377,1035,+
chr19,11035115,1.7326455131127378,1090,598,1688,+
chr19,11058256,3.5942498481473986,633,448,1081,+
chr19,11058315,1.8242676692615598,2853,2543,5396,+
chr19,11058316,1.9871740352299008,4373,3998,8371,+
chr19,11058318,2.360235243921876,2985,2802,5787,+
chr19,11058863,2.6853065186374776,825,467,1292,+
chr19,11059864,4.817987716778202,1135,729,1864,+
chr19,11059867,6.4002492514151745,988,684,1672,+
chr19,11089566,1.677551540210109,1289,841,2130,+
chr19,11105463,0.8092005798454034,3768,2414,6182,+
chr19,11105576,2.379624735729387,666,472,1138,+
chr19,11106587,0.4568047337278106,578,519,1097,+
chr19,11107414,1.2365460213205048,1121,849,1970,+
chr19,11107435,0.35629188384214444,637,473,1110,+
chr19,11107452,1.6919905771495876,844,565,1409,+
chr19,11107483,1.8078941364362309,2263,1460,3723,+
chr19,11107484,1.8078941364362309,2263,1460,3723,+
chr19,11107486,1.7657204984566814,1792,1176,2968,+
chr19,11107487,1.7372613365155132,1238,837,2075,+
chr19,11107491,1.4260265762879996,1326,912,2238,+
chr19,11107494,1.7213219199501737,5542,3783,9325,+
chr19,11107495,0.4698801504680255,1118,804,1922,+
chr19,11107496,1.7213219199501737,5542,3783,9325,+
chr19,11107501,1.6052790310517049,1705,1336,3041,+
chr19,11107502,2.3915854118407585,1365,976,2341,+
chr19,11110657,1.5346620039242989,4126,3415,7541,+
chr19,11110659,1.511485892447159,8002,6518,14520,+
chr19,11110660,1.71581875209595,4348,3731,8079,+
chr19,11110708,1.9714915043444228,1884,1429,3313,+
chr19,11110760,1.4414969920843688,890,724,1614,+
chr19,11113343,2.5225225225225225,643,443,1086,+
chr19,11113345,2.5225225225225225,643,443,1086,+
chr19,11113414,1.841093459523407,1049,775,1824,+
chr19,11113415,1.841093459523407,1049,775,1824,+
chr19,11113435,1.8990000000000002,632,499,1131,+
chr19,11113641,1.5725789626887139,962,636,1598,+
chr19,11113699,0.5648336296672594,592,507,1099,+
chr19,11116097,2.289259876769245,937,750,1687,+
chr19,11116182,0.45726495726495725,855,662,1517,+
chr19,11116879,0.5610545350718569,654,552,1206,+
chr19,11116938,1.6987989886219976,644,451,1095,+
chr19,11116954,1.7555486089402936,701,456,1157,+
chr19,11120091,1.625911051613863,642,497,1139,+
chr19,11120174,2.176720183486238,702,435,1137,+
chr19,11123329,0.9885099337748344,962,754,1716,+
chr19,11123330,0.9885099337748344,962,754,1716,+
chr19,11128036,0.9906588003933136,805,677,1482,+
chr19,11128037,0.9906588003933136,805,677,1482,+
chr19,11128039,2.3872767857142865,620,447,1067,+
chr19,11128040,2.3872767857142865,620,447,1067,+
chr19,11128069,2.0121173469387754,630,391,1021,+
chr19,11129549,0.5883087164551696,605,436,1041,+
chr19,11129634,0.4734244802200469,835,525,1360,+
chr19,11131376,1.8787290379523391,733,514,1247,+
chr19,11131449,1.6155336521997492,1461,1074,2535,+
chr19,11131547,1.7379295983352485,1353,905,2258,+
chr19,11131550,1.8940554536627467,626,402,1028,+
chr19,11131619,1.7205184373859077,649,497,1146,+
chr19,11131649,2.671201814058957,607,503,1110,+
chr19,11131725,1.6871491335123259,642,481,1123,+
chr19,11131732,1.746279491833031,848,550,1398,+
chr19,11131855,1.8812351543942996,626,420,1046,+
chr19,11131874,2.3998622860515444,786,597,1383,+
chr19,11131904,0.4917312661498707,691,429,1120,+
chr19,11131954,2.7219539903436516,598,502,1100,+
chr19,11132103,2.4205330204492124,965,605,1570,+
chr19,11132107,1.2048094413739678,918,684,1602,+
chr19,11132111,2.079729729729729,1079,799,1878,+
chr19,11132112,2.079729729729729,1079,799,1878,+
chr19,11132878,2.1764851919918917,935,768,1703,+
chr19,11132936,1.773042126095561,864,523,1387,+
chr19,11132946,0.6118945432250155,997,698,1695,+
chr19,11133137,3.986435073361741,659,447,1106,+
chr19,11133156,0.8964180922327408,735,445,1180,+
chr19,11133158,1.521597254287318,1077,676,1753,+
chr19,11133222,1.771578947368421,815,474,1289,+
chr19,11133236,2.104002337131172,830,488,1318,+
chr19,11133268,2.5113078798604658,1155,960,2115,+
chr19,11133336,1.6688888888888889,750,554,1304,+
chr19,11133371,2.0714548802946595,759,542,1301,+
chr19,11133373,2.0714548802946595,759,542,1301,+
chr19,11133547,1.1705639676152073,825,478,1303,+
chr19,11133589,2.2445812807881773,700,405,1105,+
chr19,11133612,2.634804562432381,1242,873,2115,+
chr19,11133616,2.489413188142771,822,550,1372,+
chr19,11133730,4.1448493027440385,812,512,1324,+
chr19,11435662,2.505883077681266,945,772,1717,+
chr19,11435663,1.1086482902339678,1462,1172,2634,+
chr19,11435665,0.8312447786131997,994,797,1791,+
chr19,11435666,2.056795131845841,584,434,1018,+
chr19,11436044,1.515799591493452,663,405,1068,+
chr19,11436066,2.909502262443439,642,373,1015,+
chr19,11436147,1.5693321917301535,1218,795,2013,+
chr19,11436394,2.386168809796922,1200,852,2052,+
chr19,11436397,1.7879735835940214,642,410,1052,+
chr19,11436415,1.7771043771043773,753,494,1247,+
chr19,11437888,2.006079234972677,1365,731,2096,+
chr19,11437890,2.006079234972677,1365,731,2096,+
chr19,11437921,1.6464022324098069,825,518,1343,+
chr19,11437925,0.623491773308958,717,546,1263,+
chr19,11441241,1.8984375,728,575,1303,+
chr19,11441274,1.6756411250364827,2585,1862,4447,+
chr19,11441310,1.6881457313757473,886,612,1498,+
chr19,11442385,0.5811231022498629,705,496,1201,+
chr19,11442487,0.4946851562078455,763,430,1193,+
chr19,11442497,3.0405117270788917,743,401,1144,+
chr19,11446334,2.1106501345870696,1303,1045,2348,+
chr19,11447145,1.6598568185786626,678,497,1175,+
chr19,11447553,11.129100381058803,802,567,1369,+
chr19,11447556,4.975241287213451,890,1408,2298,+
chr19,11447557,4.603008502289078,390,833,1223,+
chr19,11447560,0.39458219002390255,421,782,1203,+
chr19,11447586,3.283825070101629,1343,2270,3613,+
chr19,11447587,3.4227330779054914,535,1043,1578,+
chr19,11447742,0.6646932918730359,1724,1639,3363,+
chr19,11447743,0.37556127907321357,1111,1320,2431,+
chr19,11447744,1.0192307692307692,1037,691,1728,+
chr19,11447745,0.5675706385879857,554,613,1167,+
chr19,11447747,0.5527532544011778,1789,1379,3168,+
chr19,11447748,0.6116934669985871,1336,834,2170,+
chr19,11448242,2.2017745645744333,669,536,1205,+
chr19,11448553,1.0147515415211938,2133,1678,3811,+
chr19,11448555,0.608886631207793,1490,1153,2643,+
chr19,11448583,1.6571777495829552,1495,1266,2761,+
chr19,11448952,1.6717724288840263,763,456,1219,+
chr19,11449110,2.114619432678732,658,370,1028,+
chr19,11449282,2.5845514037168837,975,825,1800,+
chr19,11449284,2.7360616844602608,658,561,1219,+
chr19,11449301,2.3629684307380723,970,660,1630,+
chr19,11450651,3.1254220935841768,1363,690,2053,+
chr19,11450652,3.1254220935841768,1363,690,2053,+
chr19,11450817,2.223590677501624,584,553,1137,+
chr19,11450889,1.1607912210136737,823,679,1502,+
chr19,11450891,1.1607912210136737,823,679,1502,+
chr19,12559806,1.9422596867676476,671,547,1218,+
chr19,12559808,1.856122448979592,641,559,1200,+
chr19,12559810,1.836308533835976,1045,932,1977,+
chr19,12559812,1.922154802427113,763,698,1461,+
chr19,12559813,0.8292986637234941,1388,1196,2584,+
chr19,12559815,1.9444625199941836,1474,1332,2806,+
chr19,12559820,0.9194692982769902,2508,2024,4532,+
chr19,12559821,0.814714591116108,3505,2841,6346,+
chr19,12559823,0.5907710890571951,2128,1640,3768,+
chr19,12559824,0.6249605221602275,1148,825,1973,+
chr19,12737503,0.4531686465398269,1027,462,1489,+
chr19,12737529,7.57997357399143,2171,1129,3300,+
chr19,12737530,7.569691777386493,2729,1483,4212,+
chr19,12737539,13.098433184832203,1028,756,1784,+
chr19,12737650,13.849459430784773,1940,1449,3389,+
chr19,12737651,13.849459430784771,1940,1449,3389,+
chr19,12738588,1.3073204322572545,984,627,1611,+
chr19,12745451,2.744859813084112,800,534,1334,+
chr19,12745452,2.744859813084112,800,534,1334,+
chr19,12745480,2.4577028775351444,612,434,1046,+
chr19,12745621,0.48306932957655113,644,467,1111,+
chr19,12748261,4.991005700122797,1049,817,1866,+
chr19,12748262,4.991005700122797,1049,817,1866,+
chr19,12791492,4.527481387835371,979,371,1350,+
chr19,12791542,2.5198256072483085,747,499,1246,+
chr19,12791744,2.641795437821928,618,452,1070,+
chr19,12791746,2.641795437821928,618,452,1070,+
chr19,12791776,2.331938633193863,835,716,1551,+
chr19,12791777,2.331938633193863,835,716,1551,+
chr19,12791779,1.5452846754767104,1319,1032,2351,+
chr19,12791781,1.8267275997978394,2563,2080,4643,+
chr19,12791783,2.5093378607809846,738,588,1326,+
chr19,12791811,1.9010890035208385,610,530,1140,+
chr19,12791972,2.5145249487354757,653,417,1070,+
chr19,12791973,2.2244105028154193,1106,709,1815,+
chr19,12792011,1.8375178997613368,801,418,1219,+
chr19,12792146,20.337109698811826,919,516,1435,+
chr19,12792147,20.99242598794125,2942,1675,4617,+
chr19,12792148,19.60946010390834,2765,1563,4328,+
chr19,12792151,4.881319256397613,1880,1407,3287,+
chr19,12792152,4.5918315575849835,786,437,1223,+
chr19,12792153,4.286843591191418,583,505,1088,+
chr19,12792171,2.8931176381076016,890,758,1648,+
chr19,12792210,0.4017391304347826,692,574,1266,+
chr19,12792311,0.9362183999510311,664,526,1190,+
chr19,12792312,0.9362183999510311,664,526,1190,+
chr19,12792317,1.4647468027737687,610,502,1112,+
chr19,12792554,1.0241053677932406,950,1005,1955,+
chr19,12792555,1.0241053677932406,950,1005,1955,+
chr19,12792568,1.8124280782508635,674,473,1147,+
chr19,12792620,1.4881123833216106,1616,1207,2823,+
chr19,12792686,1.8900381056069682,743,500,1243,+
chr19,12792743,2.101295097132285,648,375,1023,+
chr19,12792829,1.7746937005312806,681,400,1081,+
chr19,12792974,1.9384615384615391,615,428,1043,+
chr19,12793172,1.8142044479037172,825,436,1261,+
chr19,12793179,3.2218850692764835,623,486,1109,+
chr19,12793198,1.027199074074074,567,575,1142,+
chr19,12793199,1.027199074074074,567,575,1142,+
chr19,12806632,0.5859846547314579,715,390,1105,+
chr19,12806633,0.544361418586376,1248,759,2007,+
chr19,12806698,2.1059475783933985,784,546,1330,+
chr19,12807019,3.0432653061224486,698,489,1187,+
chr19,12807031,2.1267501842299192,887,471,1358,+
chr19,12807208,1.1506800286327843,642,507,1149,+
chr19,12807210,1.3930048361908627,989,858,1847,+
chr19,12807248,1.8984610959298145,1199,817,2016,+
chr19,12807250,1.8984610959298145,1199,817,2016,+
chr19,12807265,2.0751915708812256,618,463,1081,+
chr19,12810123,2.141786249732277,749,608,1357,+
chr19,12810124,1.0705244122965645,739,552,1291,+
chr19,12810125,2.141786249732277,749,608,1357,+
chr19,12810126,1.0705244122965645,739,552,1291,+
chr19,12810356,1.2290363893578662,809,699,1508,+
chr19,12810358,0.5032279389856937,1192,836,2028,+
chr19,12813336,2.474315708869621,764,556,1320,+
chr19,12813344,1.0502853335579305,1268,839,2107,+
chr19,12813346,0.4878999179655456,792,551,1343,+
chr19,12813364,1.755462715277569,1101,678,1779,+
chr19,12813365,1.755462715277569,1101,678,1779,+
chr19,12894119,0.8694452167081829,1110,881,1991,+
chr19,12894120,0.8589496430208063,706,602,1308,+
chr19,12894126,0.5281881897414866,1570,1086,2656,+
chr19,12894127,0.6370538650086686,959,777,1736,+
chr19,12894128,0.8436079114352709,7783,5784,13567,+
chr19,12894129,0.9296662174519856,4654,3291,7945,+
chr19,12894130,1.007380727444497,1451,1167,2618,+
chr19,12894131,0.5404498153742866,1224,992,2216,+
chr19,12894132,1.2951335055986215,2073,1349,3422,+
chr19,12894214,2.9541112361496826,1071,636,1707,+
chr19,12894735,0.9543377640636128,918,765,1683,+
chr19,12894736,0.951298733879165,2720,2084,4804,+
chr19,12894737,0.9470277879509248,1946,1375,3321,+
chr19,12894738,0.5931383322559793,1816,1399,3215,+
chr19,12894739,0.8442412352069509,2709,1995,4704,+
chr19,12894740,1.416354445435623,915,884,1799,+
chr19,12894741,1.416354445435623,915,884,1799,+
chr19,12894742,0.3236324703134125,664,466,1130,+
chr19,12894744,1.4560614619816967,1110,834,1944,+
chr19,12938637,1.4619469510999192,670,530,1200,+
chr19,12938641,0.5997988939165411,1192,883,2075,+
chr19,12938642,0.5997988939165411,1192,883,2075,+
chr19,12938740,1.4623638693145422,1190,891,2081,+
chr19,12938742,0.7114729627449332,1276,1011,2287,+
chr19,12938743,1.4005777713350869,2080,1122,3202,+
chr19,12938748,1.4261399303747981,6121,3867,9988,+
chr19,12938749,1.338535357275083,4658,2700,7358,+
chr19,12938755,1.318291505791506,1820,1405,3225,+
chr19,12939151,1.8571139548161113,3237,2556,5793,+
chr19,12939156,1.4419968950556037,4172,2880,7052,+
chr19,12939166,1.5149753961796268,1563,1228,2791,+
chr19,12939168,0.7759662978703877,2626,1958,4584,+
chr19,12939204,1.5283294117647062,2072,1699,3771,+
chr19,12939442,1.3284389806170915,5421,3703,9124,+
chr19,12939453,1.4973497044674051,8616,6495,15111,+
chr19,12940078,1.3786627218934908,2401,1689,4090,+
chr19,12940097,1.4550554721411577,7380,4915,12295,+
chr19,12940244,1.9816741519781533,2041,1501,3542,+
chr19,12940249,1.2602135433032053,4351,2750,7101,+
chr19,12940303,0.7622018938508299,4851,3007,7858,+
chr19,12940369,1.2531971199975172,10486,7347,17833,+
chr19,12940370,1.4613019241143677,7143,4979,12122,+
chr19,12940547,1.966710251046025,2278,1911,4189,+
chr19,12940556,2.0338006960909274,4051,3121,7172,+
chr19,12940558,1.6282199924300311,10231,7713,17944,+
chr19,12940614,0.7699105268971611,3484,2468,5952,+
chr19,12940631,1.3828128972008273,11704,8797,20501,+
chr19,12940632,1.3828128972008273,11704,8797,20501,+
chr19,12940768,1.7506650544135434,3419,2480,5899,+
chr19,12940775,1.3981542335070491,1841,1402,3243,+
chr19,12940798,0.4779354436301264,3064,2298,5362,+
chr19,12940804,1.314144309643783,2440,1978,4418,+
chr19,12940843,1.2632303835589944,7790,5295,13085,+
chr19,12943555,1.4989819811863438,3924,2478,6402,+
chr19,12943717,0.5583566760037348,2989,2260,5249,+
chr19,12943719,0.5583566760037348,2989,2260,5249,+
chr19,12943725,1.1134551641170936,3301,2472,5773,+
chr19,12943818,4.550401235635956,7336,4698,12034,+
chr19,12943827,3.407764691417516,3083,2201,5284,+
chr19,12943857,4.849876848957639,6542,4302,10844,+
chr19,12943866,6.699711741494236,6456,5410,11866,+
chr19,12943875,1.9722136309604568,6262,5648,11910,+
chr19,12943878,4.1583059165491205,6450,6690,13140,+
chr19,12943911,0.6668500547617228,1768,1706,3474,+
chr19,12943960,1.4415020765727868,2095,1373,3468,+
chr19,12944107,0.420784207665075,1340,946,2286,+
chr19,12944111,1.7997794117647057,596,424,1020,+
chr19,12944114,1.2295010213014297,2384,1489,3873,+
chr19,12944116,1.0783347418281295,4957,3203,8160,+
chr19,12944117,1.0631863296840314,3070,2033,5103,+
chr19,12944124,1.3789283087195157,1441,1289,2730,+
chr19,12944125,1.3789283087195157,1441,1289,2730,+
chr19,12944165,1.5204798404432578,3969,3352,7321,+
chr19,12944244,1.3917938843808737,3323,1982,5305,+
chr19,12945948,2.2708693149107653,685,385,1070,+
chr19,12945955,3.2360515021459233,1391,1164,2555,+
chr19,12945957,3.2360515021459233,1391,1164,2555,+
chr19,12945969,1.8359976317347544,885,562,1447,+
chr19,12945993,0.4467834947651307,839,673,1512,+
chr19,12947851,2.776315789473684,632,474,1106,+
chr19,12947863,0.6081925979159181,805,604,1409,+
chr19,12947865,1.5777439024390243,1172,696,1868,+
chr19,12947868,0.6218793645251396,1238,715,1953,+
chr19,12947869,1.7016819571865442,717,544,1261,+
chr19,12947911,1.47628927089508,878,722,1600,+
chr19,12947923,1.5754037209278644,2734,1951,4685,+
chr19,12948498,2.0715675057208243,1477,759,2236,+
chr19,12948499,2.0715675057208243,1477,759,2236,+
chr19,12948526,2.3855113636363643,621,439,1060,+
chr19,12948528,1.7679814385150812,761,430,1191,+
chr19,12948697,1.801320501671454,1139,889,2028,+
chr19,12948777,1.8024805635158125,1297,927,2224,+
chr19,12948798,1.78156862745098,648,509,1157,+
chr19,12949123,2.1667807587614236,1139,826,1965,+
chr19,12952710,2.8489713216957604,676,400,1076,+
chr19,12952758,1.6382751937984497,582,429,1011,+
chr19,12952779,9.261692113695432,1575,1190,2765,+
chr19,12952806,1.690606725146199,637,455,1092,+
chr19,12952808,0.5901960784313726,601,519,1120,+
chr19,12952811,1.1035669791861789,1132,951,2083,+
chr19,12952833,1.6400146708233998,812,573,1385,+
chr19,12952835,0.5548140211235267,862,694,1556,+
chr19,12952837,0.4586964658076245,745,633,1378,+
chr19,12952955,1.7878151260504196,850,577,1427,+
chr19,12952978,1.876003977663888,980,768,1748,+
chr19,12952992,0.5450508404233243,1141,789,1930,+
chr19,12952994,1.7089376873835185,1109,902,2011,+
chr19,12953141,2.0432778689164905,1005,752,1757,+
chr19,12953142,2.0432778689164905,1005,752,1757,+
chr19,12953144,1.9191374663072778,711,423,1134,+
chr19,12953163,1.8093249826026443,623,478,1101,+
chr19,12953167,2.2660171555649686,822,496,1318,+
chr19,12953171,2.102803738317757,899,534,1433,+
chr19,12953175,0.4910919729143383,995,573,1568,+
chr19,12953279,2.188762273034672,1930,1274,3204,+
chr19,12953280,2.151491309634504,1409,1022,2431,+
chr19,12953281,2.151491309634504,1409,1022,2431,+
chr19,12953306,2.7685943060498213,942,561,1503,+
chr19,12953308,2.7685943060498213,942,561,1503,+
chr19,12953412,2.0775831826219404,813,563,1376,+
chr19,12953418,1.0708214352195176,1014,700,1714,+
chr19,12953446,1.906820776255708,580,437,1017,+
chr19,12953447,1.6495896416373554,808,502,1310,+
chr19,12953543,1.635897435897436,615,454,1069,+
chr19,13153054,0.6880841893085662,1018,635,1653,+
chr19,13154471,6.003325412807963,995,784,1779,+
chr19,13154472,5.316428208551403,1588,1351,2939,+
chr19,13154473,5.316428208551403,1588,1351,2939,+
chr19,13154476,3.68712555968487,469,597,1066,+
chr19,13154486,0.4446771378708552,636,763,1399,+
chr19,13154487,0.4446771378708552,636,763,1399,+
chr19,13154488,0.4446771378708552,636,763,1399,+
chr19,13154774,3.9544507245262004,1795,1428,3223,+
chr19,13154775,3.9544507245262004,1795,1428,3223,+
chr19,13154792,3.1988012551531213,598,534,1132,+
chr19,13773382,1.9112291114792057,700,429,1129,+
chr19,13774470,3.700608743774212,742,277,1019,+
chr19,13774471,3.476477953490105,956,399,1355,+
chr19,13774474,1.7842170925622127,1032,382,1414,+
chr19,13774481,3.075524475524475,732,274,1006,+
chr19,13774490,2.233524467489639,1079,564,1643,+
chr19,13774495,1.593952483801296,1079,462,1541,+
chr19,13774497,2.2992074834351044,1734,894,2628,+
chr19,13774498,2.1009325348919567,2329,1284,3613,+
chr19,13774507,0.6437956204379562,755,547,1302,+
chr19,13774508,1.3542632570269486,3477,1631,5108,+
chr19,13774509,1.3542632570269486,3477,1631,5108,+
chr19,13774519,1.6367736339982657,2358,1152,3510,+
chr19,13774522,1.8170805572380375,2724,1416,4140,+
chr19,13774545,1.5161441351620817,3600,2182,5782,+
chr19,13774546,0.6479631805718763,1526,998,2524,+
chr19,13774550,1.2693116161484563,10618,6363,16981,+
chr19,13774551,1.2968347207303974,6385,3723,10108,+
chr19,13774652,1.4920842060454917,18388,10273,28661,+
chr19,13774654,1.5105696744356307,28427,15609,44036,+
chr19,13774655,1.4392286896924587,31082,17488,48570,+
chr19,13774656,1.4527957889831211,25605,14046,39651,+
chr19,13774657,1.3726513791621369,10603,5344,15947,+
chr19,13774668,1.35257923823077,36619,23085,59704,+
chr19,13774669,1.35257923823077,36619,23085,59704,+
chr19,13774681,1.7638780334730235,15399,10652,26051,+
chr19,13778222,1.9680007604382026,1336,905,2241,+
chr19,13778256,2.0703703703703704,1117,719,1836,+
chr19,13778281,2.7475999513914204,664,632,1296,+
chr19,13778313,3.7047325102880655,553,485,1038,+
chr19,13778322,0.4633766233766234,668,659,1327,+
chr19,13778347,1.6270564737148359,2610,2100,4710,+
chr19,14070324,0.4542259768063163,1275,879,2154,+
chr19,14070325,0.4312218468468468,900,591,1491,+
chr19,14070351,2.2082817012418925,1231,887,2118,+
chr19,14391040,4.905901855102085,739,605,1344,+
chr19,14391041,4.905901855102085,739,605,1344,+
chr19,14401392,2.589519976217505,641,419,1060,+
chr19,14404520,5.6593186372745485,705,498,1203,+
chr19,14404521,5.6593186372745485,705,498,1203,+
chr19,14404522,5.41073183807042,820,598,1418,+
chr19,14469754,0.5373485388453315,717,459,1176,+
chr19,14469755,1.0723358998436852,1147,819,1966,+
chr19,14469918,0.9728744939271255,711,493,1204,+
chr19,14469919,0.9728744939271255,711,493,1204,+
chr19,14469926,2.6377098660630067,798,588,1386,+
chr19,14469927,2.6377098660630067,798,588,1386,+
chr19,14529648,1.918540368926292,1132,678,1810,+
chr19,14562528,2.5492910766133896,2075,1534,3609,+
chr19,14562530,2.4429792020678267,1360,888,2248,+
chr19,14563235,1.8598845373693247,744,662,1406,+
chr19,14563236,1.8598845373693247,744,662,1406,+
chr19,14563804,1.7987633501967402,1023,592,1615,+
chr19,14563805,1.8852254963962705,1360,852,2212,+
chr19,14563988,0.5901360544217688,693,440,1133,+
chr19,14564018,1.5913137750911657,620,498,1118,+
chr19,14564051,2.0528455284552845,706,573,1279,+
chr19,14564210,1.5034965034965033,734,636,1370,+
chr19,14622279,1.3107442027512937,1847,1210,3057,+
chr19,14622280,1.174254994358532,2358,1585,3943,+
chr19,14622282,1.6301967475635357,2067,1396,3463,+
chr19,14623197,2.56651376146789,745,435,1180,+
chr19,14623198,2.56651376146789,745,435,1180,+
chr19,14792353,0.737171065131479,605,427,1032,+
chr19,14792384,0.8114938952190621,1097,839,1936,+
chr19,14792385,0.9374588545095456,800,650,1450,+
chr19,15611986,0.465414839937133,1081,784,1865,+
chr19,15611988,0.465414839937133,1081,784,1865,+
chr19,16076535,4.064724919093851,627,514,1141,+
chr19,16076536,4.064724919093851,627,514,1141,+
chr19,16076577,1.2429039732842637,1105,720,1825,+
chr19,16076596,0.43589743589743596,1104,844,1948,+
chr19,16076597,0.43589743589743596,1104,844,1948,+
chr19,16076601,0.6643939393939394,876,419,1295,+
chr19,16081913,2.231248928928929,1367,853,2220,+
chr19,16081914,2.231248928928929,1367,853,2220,+
chr19,16081922,1.2582177763815112,1025,700,1725,+
chr19,16081961,1.598726875092376,2188,1539,3727,+
chr19,16081963,1.598726875092376,2188,1539,3727,+
chr19,16081979,2.000610687022901,671,523,1194,+
chr19,16086473,1.7389006342494715,657,429,1086,+
chr19,16086481,1.8767880588763728,822,498,1320,+
chr19,16088063,2.759001024579343,1572,1064,2636,+
chr19,16088087,4.061996775869346,2526,2039,4565,+
chr19,16089045,0.6317650011092402,2255,1626,3881,+
chr19,16089046,0.6317650011092402,2255,1626,3881,+
chr19,16101279,0.508458666624848,702,359,1061,+
chr19,16101280,0.931179322925487,943,582,1525,+
chr19,16101281,0.931179322925487,943,582,1525,+
chr19,16101298,1.2511178247734138,811,661,1472,+
chr19,16101299,1.2511178247734138,811,661,1472,+
chr19,16101321,1.1054753459052984,1556,1082,2638,+
chr19,16101338,0.6007742257742258,1414,1039,2453,+
chr19,16101341,2.7290653314258466,1378,931,2309,+
chr19,16101363,1.7693554760318377,4831,3504,8335,+
chr19,16101663,1.395649699476687,1570,1180,2750,+
chr19,16101815,1.603126695604992,1152,775,1927,+
chr19,16101860,5.683891795475532,3774,2983,6757,+
chr19,16101861,4.82087755732903,6114,4619,10733,+
chr19,16102013,1.5853352051812433,3014,2319,5333,+
chr19,16102226,0.5005720823798627,629,551,1180,+
chr19,16102247,1.5782312925170066,898,650,1548,+
chr19,16102256,2.1190140845070418,1297,780,2077,+
chr19,16102419,1.9122807017543857,1961,1177,3138,+
chr19,16102528,1.5594267539209592,2244,1608,3852,+
chr19,16102836,2.197055446911122,653,426,1079,+
chr19,16102847,1.8750243757115213,662,426,1088,+
chr19,16102860,1.1638364928189036,939,636,1575,+
chr19,16102881,1.5145662847790509,1321,909,2230,+
chr19,16102889,1.0134747298661053,2595,1832,4427,+
chr19,16102892,1.7395792754187769,1144,754,1898,+
chr19,16102913,1.5785785785785786,1244,998,2242,+
chr19,16128074,1.6650717703349285,695,569,1264,+
chr19,16129556,2.0702947845804984,1517,1126,2643,+
chr19,16129557,2.123081841432225,2060,1563,3623,+
chr19,16129558,2.123081841432225,2060,1563,3623,+
chr19,16129559,2.092283776144715,1574,1219,2793,+
chr19,16133191,1.63615146992065,1817,1445,3262,+
chr19,16133192,2.28646045312712,910,755,1665,+
chr19,16133193,1.63615146992065,1817,1445,3262,+
chr19,16133200,2.30934631700635,800,643,1443,+
chr19,16185426,0.6840683209892988,566,437,1003,+
chr19,16185428,0.6840683209892988,566,437,1003,+
chr19,16191582,1.7957501037987778,836,556,1392,+
chr19,16191870,7.868279777430131,1039,849,1888,+
chr19,16191874,4.17137339375357,1033,1313,2346,+
chr19,16841904,0.8294325194274489,623,415,1038,+
chr19,17216016,0.41637583550818447,625,528,1153,+
chr19,17216017,0.41637583550818447,625,528,1153,+
chr19,17269071,0.9967679379444084,770,454,1224,+
chr19,17269073,1.5499286615887407,1190,673,1863,+
chr19,17271596,1.9137962104577098,2217,1326,3543,+
chr19,17271597,2.2535689592060844,1758,1068,2826,+
chr19,17271600,2.1313925354096486,1493,935,2428,+
chr19,17271603,2.134807967425993,1020,698,1718,+
chr19,17271618,1.5721559570728039,1619,1219,2838,+
chr19,17271624,0.6346568174823022,1030,569,1599,+
chr19,17271627,2.7692480359147025,948,494,1442,+
chr19,17273907,0.7155869091387155,8650,5562,14212,+
chr19,17273908,0.7103885984629758,7049,4783,11832,+
chr19,17273910,2.0216684723726983,1865,922,2787,+
chr19,17279045,4.252915125963407,714,499,1213,+
chr19,17279146,19.661173799564708,780,618,1398,+
chr19,17305871,0.9178990865593736,942,450,1392,+
chr19,17305878,2.2507387139854256,3570,1822,5392,+
chr19,17305879,1.812781065088757,3329,1689,5018,+
chr19,17305880,1.8175875903660057,4019,2078,6097,+
chr19,17306411,0.956581352833638,643,546,1189,+
chr19,17306412,0.956581352833638,643,546,1189,+
chr19,17306444,2.1999043519846966,574,491,1065,+
chr19,17306446,2.1999043519846966,574,491,1065,+
chr19,17306509,1.8980582524271843,645,411,1056,+
chr19,17306532,1.425707472504382,1079,852,1931,+
chr19,17306618,1.5565463244889084,841,725,1566,+
chr19,17306672,3.5627970128988458,655,490,1145,+
chr19,17306679,2.1330778443113774,1011,834,1845,+
chr19,17555681,0.5760452749538065,840,741,1581,+
chr19,17559343,3.5947930574098805,717,427,1144,+
chr19,17559344,3.5947930574098805,717,427,1144,+
chr19,17560376,1.1322943095324394,780,533,1313,+
chr19,17560378,1.1322943095324394,780,533,1313,+
chr19,17560453,2.139729299363057,1074,627,1701,+
chr19,17560454,2.139729299363057,1074,627,1701,+
chr19,17567491,1.6167813653038725,665,509,1174,+
chr19,17577251,2.5475638958232243,712,517,1229,+
chr19,17577430,10.165208232301028,685,401,1086,+
chr19,17578038,3.468746794540335,795,321,1116,+
chr19,17579494,3.742372881355932,1103,648,1751,+
chr19,17579495,3.007662082514735,1700,1017,2717,+
chr19,17579496,1.9362394274560835,743,317,1060,+
chr19,17579497,1.5303585519295921,1987,1210,3197,+
chr19,17579498,0.4428337618387152,2358,1152,3510,+
chr19,17579499,0.5735155195681512,2673,1063,3736,+
chr19,17579501,0.5906206875171158,2610,1080,3690,+
chr19,17579502,2.5050709939148077,1139,492,1631,+
chr19,17579542,0.34231349673600964,1038,708,1746,+
chr19,17579591,12.26271747578557,1421,926,2347,+
chr19,17580893,1.3120430934974991,619,451,1070,+
chr19,17580895,1.6191183998708614,835,653,1488,+
chr19,17581244,0.6137600041784026,1061,695,1756,+
chr19,17581387,2.740341419586702,609,476,1085,+
chr19,17581388,2.740341419586702,609,476,1085,+
chr19,17581685,2.6562726613488032,665,393,1058,+
chr19,17581703,1.1326773789234583,1050,755,1805,+
chr19,17581733,0.6500775067308475,995,720,1715,+
chr19,17581756,1.8352841927660024,915,653,1568,+
chr19,17581812,0.6415253344569684,1259,862,2121,+
chr19,17582261,2.01868103391263,2393,1628,4021,+
chr19,17582371,2.1255506607929515,771,453,1224,+
chr19,17582378,3.016626744446691,2249,1582,3831,+
chr19,17582435,2.5903502667594527,858,478,1336,+
chr19,17582447,0.5001146657493406,670,458,1128,+
chr19,17582450,0.5487778022462013,711,477,1188,+
chr19,17582471,0.6432270303527482,2280,1287,3567,+
chr19,17582472,1.126838988572461,3414,2111,5525,+
chr19,17582494,0.6567394094993583,1278,983,2261,+
chr19,17582519,1.8951862237561117,1786,1158,2944,+
chr19,17582532,1.7761325718685832,4177,2921,7098,+
chr19,17582534,1.7761325718685832,4177,2921,7098,+
chr19,17582880,0.35360941389454625,600,490,1090,+
chr19,17582881,0.636730082496842,1352,907,2259,+
chr19,17582883,1.0878347752399349,1149,658,1807,+
chr19,17582885,2.3487083762408143,948,607,1555,+
chr19,17583023,3.0847710908843906,840,432,1272,+
chr19,17583024,2.826133964089759,1485,867,2352,+
chr19,17583026,2.0602430161253693,884,475,1359,+
chr19,17583068,1.443182073234164,789,696,1485,+
chr19,17861366,0.7010542366290857,1026,454,1480,+
chr19,17861371,1.0872363392362223,1293,754,2047,+
chr19,17861372,1.0872363392362223,1293,754,2047,+
chr19,17861373,1.6066736558555128,1296,900,2196,+
chr19,17861375,2.208333333333333,953,566,1519,+
chr19,17861379,0.6543915934346957,680,602,1282,+
chr19,17861380,1.7754639823843976,1226,747,1973,+
chr19,17861383,1.5027284427284426,1477,924,2401,+
chr19,17861395,1.224943504774114,3145,1985,5130,+
chr19,17861407,1.6373326167763893,2284,1653,3937,+
chr19,17861422,1.4502161909014668,3370,1963,5333,+
chr19,17861425,1.4336365896097443,3728,2234,5962,+
chr19,17861427,1.390696444404189,8494,6648,15142,+
chr19,17861430,1.2884419076371527,4676,2464,7140,+
chr19,17861452,1.2385840628542328,7424,4627,12051,+
chr19,17862089,0.9314860063323269,1203,735,1938,+
chr19,17862090,0.7296596324658264,1362,786,2148,+
chr19,17862091,1.111903154494791,720,446,1166,+
chr19,17862092,1.0577424094095125,22579,14199,36778,+
chr19,17862093,1.055938224215038,11264,6511,17775,+
chr19,17862094,1.1819716445770725,10043,6859,16902,+
chr19,17862098,0.8841891805462021,12912,10144,23056,+
chr19,17862099,1.2909889934810608,10803,7600,18403,+
chr19,17942694,2.2134387351778657,719,482,1201,+
chr19,17942695,2.2134387351778657,719,482,1201,+
chr19,17942727,2.638679594719,782,565,1347,+
chr19,17942734,1.5903912205746835,882,518,1400,+
chr19,17942740,1.7488951136009956,877,594,1471,+
chr19,17942745,1.7270337301587297,940,671,1611,+
chr19,17942748,1.643984853517236,3343,2404,5747,+
chr19,17942749,1.7967007434944238,2089,1613,3702,+
chr19,18030823,1.0595481690965742,902,655,1557,+
chr19,18162413,1.988031914893617,689,375,1064,+
chr19,18162415,3.0060201757240486,738,438,1176,+
chr19,18162417,2.715277777777777,781,503,1284,+
chr19,18162421,0.49475679696686115,792,478,1270,+
chr19,18162423,0.8603134985835431,1596,1058,2654,+
chr19,18162424,1.1754332313965343,886,544,1430,+
chr19,18167133,5.528480048735913,604,468,1072,+
chr19,18167135,5.644376899696049,618,516,1134,+
chr19,18167137,3.9200515796260476,639,563,1202,+
chr19,18173816,3.836761477854492,789,576,1365,+
chr19,18173818,2.619665361535923,847,598,1445,+
chr19,18173820,1.4165574640160434,724,408,1132,+
chr19,18173827,2.775333128606362,861,506,1367,+
chr19,18173861,3.217026942355889,1324,1063,2387,+
chr19,18173862,3.217026942355889,1324,1063,2387,+
chr19,18173863,3.217026942355889,1324,1063,2387,+
chr19,18175042,2.167096061832904,735,428,1163,+
chr19,18175049,1.7208483458892894,933,567,1500,+
chr19,18175050,1.6460905349794237,549,485,1034,+
chr19,18175068,0.9424199137407223,2692,2055,4747,+
chr19,18175069,1.0677157001414426,2012,1413,3425,+
chr19,18175105,2.388181174805379,793,627,1420,+
chr19,18175109,1.4062312041380969,1335,977,2312,+
chr19,18175187,2.664562219637814,593,462,1055,+
chr19,18175311,0.9186263830290324,2323,1678,4001,+
chr19,18175312,0.8958517210944396,2029,1253,3282,+
chr19,18175313,1.233949010912582,3381,2617,5998,+
chr19,18175314,1.0851415448672548,3159,1952,5111,+
chr19,18175315,1.4151902317658487,4343,3143,7486,+
chr19,18175621,0.71175,1313,999,2312,+
chr19,18175680,1.8373699471260447,694,532,1226,+
chr19,18177151,2.8149350649350646,577,447,1024,+
chr19,18177720,0.995492371705964,1913,1175,3088,+
chr19,18177721,1.3088084942736815,2906,1806,4712,+
chr19,18177723,1.9620236321055995,1965,1231,3196,+
chr19,18177974,2.117276729167733,1464,1302,2766,+
chr19,18178047,1.8767217630853996,544,461,1005,+
chr19,18196089,1.7313550448793664,931,628,1559,+
chr19,18196090,1.8957199783979288,1119,788,1907,+
chr19,18388722,1.7658195463073512,713,532,1245,+
chr19,18388723,1.7658195463073512,713,532,1245,+
chr19,18388929,2.410141685309471,605,446,1051,+
chr19,18388930,2.410141685309471,605,446,1051,+
chr19,18389133,0.3319789055070459,767,537,1304,+
chr19,18389134,0.3319789055070459,767,537,1304,+
chr19,18562049,1.271846448499768,563,475,1038,+
chr19,18568944,1.1296124439158761,644,476,1120,+
chr19,18571856,0.9099907510901022,17502,7350,24852,+
chr19,18571857,0.8684124980105355,37127,14997,52124,+
chr19,18571858,0.9467975348307077,55485,24258,79743,+
chr19,18571859,0.973724247716323,65856,30331,96187,+
chr19,18571860,0.9933537161393623,66974,30339,97313,+
chr19,18571862,1.3951626366263148,23865,8783,32648,+
chr19,18571864,1.6257892685002089,33573,14946,48519,+
chr19,18571869,1.245582675304728,13246,5159,18405,+
chr19,18573297,1.6524949113114278,11142,4749,15891,+
chr19,18573688,1.5365124555160137,9251,5619,14870,+
chr19,18573735,1.3487175864249858,4197,2871,7068,+
chr19,18574906,1.8465780551748765,7302,6009,13311,+
chr19,18574907,1.3131151207873546,11150,7055,18205,+
chr19,18574908,1.2999229577172526,17234,11003,28237,+
chr19,18574910,1.3411359744039035,15514,10578,26092,+
chr19,18574955,1.5341063016479768,8337,6586,14923,+
chr19,18574956,1.5341063016479768,8337,6586,14923,+
chr19,18574959,1.5483366957589582,4482,3623,8105,+
chr19,18575132,1.5014361625736032,2986,2320,5306,+
chr19,18866589,0.5667909629304673,645,581,1226,+
chr19,18866592,0.8346301889027062,1531,1298,2829,+
chr19,18866593,0.8346301889027062,1531,1298,2829,+
chr19,18926315,0.22231465393022637,1031,609,1640,+
chr19,18926331,3.570957610233387,780,493,1273,+
chr19,18926335,2.2349042169877107,765,588,1353,+
chr19,19516226,0.7314454360199564,490,534,1024,+
chr19,19516229,0.6296296296296297,543,575,1118,+
chr19,19516296,1.676767676767677,829,714,1543,+
chr19,19516308,1.7316726690676274,1632,1019,2651,+
chr19,19526184,2.53424397061334,1803,1369,3172,+
chr19,19526207,1.6224021892884044,2027,1637,3664,+
chr19,19526214,1.8901601830663612,825,740,1565,+
chr19,19527288,1.4098229160239402,938,852,1790,+
chr19,19527720,1.6376329787234043,820,751,1571,+
chr19,19527746,1.4719159558976493,800,758,1558,+
chr19,19528007,3.3711790393013104,578,457,1035,+
chr19,19528012,1.7809187279151943,755,565,1320,+
chr19,19528080,1.7748681578468817,975,610,1585,+
chr19,19528092,1.6179607667636307,985,653,1638,+
chr19,20125284,1.1978183878736366,1261,904,2165,+
chr19,20125285,0.6462800026968716,1564,1151,2715,+
chr19,20125306,0.9619301350916778,4671,3160,7831,+
chr19,20125307,1.088374995124824,16226,12479,28705,+
chr19,20125308,1.2768655715646229,8082,7001,15083,+
chr19,20125309,1.0897252784056763,27210,20769,47979,+
chr19,20125310,0.8703433036647241,11133,7341,18474,+
chr19,20125311,1.1303440051240732,24256,18862,43118,+
chr19,20125312,1.4103812735928285,7257,6740,13997,+
chr19,20125315,1.3421616179847762,7557,6552,14109,+
chr19,20125318,1.5482475852887052,9407,10035,19442,+
chr19,20125320,1.4615853864129373,15366,13898,29264,+
chr19,20125323,0.7290038643234491,14362,8786,23148,+
chr19,20125324,0.7573903031233954,21278,13584,34862,+
chr19,20125325,0.9740389175991002,11872,8248,20120,+
chr19,20125326,1.2309560149854308,6451,7206,13657,+
chr19,20258383,1.6426987836007907,926,641,1567,+
chr19,23827093,0.5851144078451094,715,387,1102,+
chr19,23827095,2.2989214175654853,2237,1319,3556,+
chr19,23827096,0.5343326352915243,807,421,1228,+
chr19,23827269,1.0501529160988767,819,573,1392,+
chr19,23827273,0.9578082937216834,1296,972,2268,+
chr19,23827275,0.7622054986196726,1250,852,2102,+
chr19,23827278,1.035032680411895,12621,8631,21252,+
chr19,23827279,0.9333280356007627,7694,5433,13127,+
chr19,23827280,1.0087405513096614,11177,7917,19094,+
chr19,23827282,1.0948745108566067,31495,22545,54040,+
chr19,23827283,0.986718308336491,26591,19231,45822,+
chr19,23827284,1.0934780785547138,39047,25228,64275,+
chr19,23827285,1.019603079748036,48577,33803,82380,+
chr19,23827286,1.1381324385385332,33924,22627,56551,+
chr19,23827287,1.1614004989314195,25544,16160,41704,+
chr19,23827288,1.2539040828711756,11346,8820,20166,+
chr19,23827289,1.2030531598487475,28168,19577,47745,+
chr19,23827546,1.700358072916667,1010,575,1585,+
chr19,23827548,0.4579756380752917,2110,1330,3440,+
chr19,23827550,1.023621894732048,2273,1092,3365,+
chr19,23827552,1.7333423011389113,1246,755,2001,+
chr19,23827560,2.5222459132906896,1108,468,1576,+
chr19,23827571,1.5386119969627945,2845,1316,4161,+
chr19,23827572,1.4794063609941575,4115,2347,6462,+
chr19,23827575,1.4038508301779602,5645,3104,8749,+
chr19,23827576,1.6423920449155247,3340,1825,5165,+
chr19,23827577,1.1031316204957369,6184,2852,9036,+
chr19,23827578,1.6423920449155247,3340,1825,5165,+
chr19,23827579,1.5053523523887111,4329,2017,6346,+
chr19,23827581,0.7621881135960921,2300,1883,4183,+
chr19,23827582,1.5024555331431133,4560,2362,6922,+
chr19,23827586,1.6292341413582738,7852,4132,11984,+
chr19,23827587,1.6291630019617556,5635,2850,8485,+
chr19,23827603,1.4787437905415433,8113,4627,12740,+
chr19,23827605,1.4580824746896541,12490,7184,19674,+
chr19,23827606,1.329625273912038,12921,8570,21491,+
chr19,23827610,1.0528346286350687,8789,6237,15026,+
chr19,23827646,1.2894481503941784,5798,4849,10647,+
chr19,23827650,0.712900323072959,6116,3880,9996,+
chr19,23827724,1.473416683877096,11344,6622,17966,+
chr19,23827725,1.4783845299198246,16476,9818,26294,+
chr19,29612126,0.6410733326506853,597,436,1033,+
chr19,30009025,2.044041273136096,1041,744,1785,+
chr19,30009251,1.7802929449084777,661,426,1087,+
chr19,30012324,1.2066775675535597,760,589,1349,+
chr19,30015558,1.5486326109391124,685,455,1140,+
chr19,32483729,2.3140968968618334,591,470,1061,+
chr19,32584961,1.4878563517942083,1808,1333,3141,+
chr19,32584962,1.8481018882769475,1238,983,2221,+
chr19,32584963,1.8481018882769475,1238,983,2221,+
chr19,32584964,0.5647536636398475,1437,1043,2480,+
chr19,32584974,1.8364529155896057,1768,1250,3018,+
chr19,32584975,1.6701103208931358,2697,2022,4719,+
chr19,32587266,1.8637994909939009,2777,1729,4506,+
chr19,33379178,0.7646919924438895,626,451,1077,+
chr19,33379180,0.7326149649710455,638,463,1101,+
chr19,33379774,2.718781539590788,925,518,1443,+
chr19,33379776,2.2992414780712753,892,558,1450,+
chr19,33381757,2.2377179080824092,705,630,1335,+
chr19,33381758,2.2377179080824092,705,630,1335,+
chr19,34172737,1.2705275898357715,669,517,1186,+
chr19,34219442,11.899928404036721,928,250,1178,+
chr19,34219445,19.860956142986737,1761,906,2667,+
chr19,34219446,15.361710143799268,2650,3160,5810,+
chr19,34219447,7.734983371156594,3450,5274,8724,+
chr19,34219448,5.70896437037525,3320,6374,9694,+
chr19,34219449,4.991379055699478,2632,6146,8778,+
chr19,34219450,3.3338772043470737,1081,3710,4791,+
chr19,34219454,0.2366826377306256,1091,2698,3789,+
chr19,34219455,0.3307475001121026,460,768,1228,+
chr19,34219456,0.21095037260162372,938,2493,3431,+
chr19,34219458,0.2449296211672449,456,1312,1768,+
chr19,34219480,0.11252639981806199,640,1422,2062,+
chr19,34219485,0.10623252581704094,643,1234,1877,+
chr19,34221715,7.667850193117257,789,672,1461,+
chr19,34227385,1.4559700298411549,906,703,1609,+
chr19,34365333,2.8435148295706063,885,501,1386,+
chr19,34365336,1.8823051948051948,772,615,1387,+
chr19,34366346,3.1895910780669143,883,537,1420,+
chr19,34366364,2.5135042735042736,918,584,1502,+
chr19,34366380,1.8422000948316741,882,702,1584,+
chr19,34366384,1.1633381468046105,2053,1456,3509,+
chr19,34366783,1.899812364210942,1349,663,2012,+
chr19,34366785,1.8285653987116202,1974,1136,3110,+
chr19,34366818,1.8547311095983663,716,564,1280,+
chr19,34366819,1.929340856629905,884,556,1440,+
chr19,34366833,1.5422077922077921,949,615,1564,+
chr19,34366839,0.5745883083958485,1532,1181,2713,+
chr19,34368646,2.4780227911795176,965,698,1663,+
chr19,34377752,1.803864569083447,958,730,1688,+
chr19,34377760,1.4661246612466126,1081,860,1941,+
chr19,34393258,18.586416511257948,2980,1901,4881,+
chr19,34393292,0.5194805194805195,803,736,1539,+
chr19,34393728,2.079746935860098,1372,872,2244,+
chr19,34393732,0.5748921107501332,740,502,1242,+
chr19,34393943,1.738241308793456,594,488,1082,+
chr19,34393955,1.7011042612289142,836,508,1344,+
chr19,34394031,1.5439822024471632,806,774,1580,+
chr19,34396320,1.6086659454535102,1486,1350,2836,+
chr19,34396321,1.6486363636363637,805,549,1354,+
chr19,34396322,1.6121013811762925,2258,1874,4132,+
chr19,34396325,1.8038038038038038,794,554,1348,+
chr19,34396333,0.6185742329637521,1677,1286,2963,+
chr19,34396339,1.4760990247561891,862,774,1636,+
chr19,34396400,1.7676767676767675,949,683,1632,+
chr19,34396408,1.7427728794814292,1206,756,1962,+
chr19,34396582,1.7350705754614548,798,613,1411,+
chr19,34396585,0.5425556632184235,2083,1482,3565,+
chr19,34396586,0.4651372019793073,1033,854,1887,+
chr19,34396589,1.8420731707317075,1006,819,1825,+
chr19,34399252,1.63132625644188,1575,1243,2818,+
chr19,34399253,1.0549159341824172,1930,1156,3086,+
chr19,34399254,1.3300386117107312,3505,2399,5904,+
chr19,34399276,1.9458324694173752,872,741,1613,+
chr19,34399559,1.6203341801837015,1004,601,1605,+
chr19,34399562,0.617762159571919,1104,658,1762,+
chr19,34399565,1.3570297814057335,3366,2755,6121,+
chr19,34399566,1.4705849010445868,5113,3938,9051,+
chr19,34399608,1.4314497013368732,1484,1193,2677,+
chr19,34399739,0.7210945093695609,1250,1065,2315,+
chr19,34399926,1.1139247570824686,1935,1589,3524,+
chr19,34399945,1.8869461077844316,1211,834,2045,+
chr19,34400191,1.3697103494289327,839,535,1374,+
chr19,34400192,2.3099908060067427,669,501,1170,+
chr19,34400194,3.5462264150378147,836,589,1425,+
chr19,34400206,0.4354409416218135,817,637,1454,+
chr19,34400207,0.4354409416218135,817,637,1454,+
chr19,34400235,1.6273894436519258,867,700,1567,+
chr19,34409435,6.486042692939246,631,405,1036,+
chr19,34413744,0.40193302928420593,653,447,1100,+
chr19,34428488,7.2929072801649975,1146,247,1393,+
chr19,34428490,6.008323133414932,943,214,1157,+
chr19,34428492,5.34858763674436,1043,268,1311,+
chr19,34428493,5.222552428502086,1210,246,1456,+
chr19,34428502,8.151733852576767,2511,892,3403,+
chr19,34428503,9.681929940419472,4227,1387,5614,+
chr19,34428504,9.746933749403961,3953,1340,5293,+
chr19,34428505,10.063921276510976,2689,925,3614,+
chr19,34428508,27.283520058304404,2285,1856,4141,+
chr19,34428509,27.283520058304404,2285,1856,4141,+
chr19,34428512,11.140204297116483,1255,1507,2762,+
chr19,34428516,0.29062928331209387,615,772,1387,+
chr19,34428518,0.4554679992312128,696,604,1300,+
chr19,34428520,0.4554679992312128,696,604,1300,+
chr19,34428527,0.5286180703624733,773,895,1668,+
chr19,34428528,0.27103331451157536,559,505,1064,+
chr19,34428529,0.5038216560509554,1694,1883,3577,+
chr19,34428530,0.5126559060895084,1332,1456,2788,+
chr19,34428531,0.588962792229714,4580,4660,9240,+
chr19,34428532,0.6454124105372576,2664,2630,5294,+
chr19,34428533,0.5778891610183972,1067,1085,2152,+
chr19,34428549,0.47118953247025946,2124,1941,4065,+
chr19,34428556,0.6714799869124224,961,864,1825,+
chr19,34428559,0.4904314113668234,1033,897,1930,+
chr19,34430577,1.3964190849453066,2072,1545,3617,+
chr19,34430582,0.7381469671956702,18519,12930,31449,+
chr19,34430583,0.7418621247105254,17909,12751,30660,+
chr19,34430584,0.7027240426371891,10679,7649,18328,+
chr19,34430594,1.2317874905535238,14665,10212,24877,+
chr19,34430595,1.676407044158105,7843,5732,13575,+
chr19,34430598,1.2468949442907158,19825,14014,33839,+
chr19,34430599,1.2743449008094647,18868,13158,32026,+
chr19,34430606,1.690994098155056,23307,17192,40499,+
chr19,34430608,1.447487833486372,41274,27868,69142,+
chr19,34430609,1.3224114979964998,13046,7788,20834,+
chr19,34431882,1.6669001260680762,1049,648,1697,+
chr19,34433390,2.3585833333333333,912,599,1511,+
chr19,34434919,2.5785714285714283,721,559,1280,+
chr19,34434948,1.963183008982036,2179,1335,3514,+
chr19,34434949,1.963183008982036,2179,1335,3514,+
chr19,34445002,0.6281858533791523,762,581,1343,+
chr19,34445022,2.0612659698025557,915,573,1488,+
chr19,34445037,0.5951149425287355,1198,869,2067,+
chr19,34450329,3.6945876288659787,1219,775,1994,+
chr19,34451998,1.7046675625850527,5093,3558,8651,+
chr19,34451999,1.6548528875611774,5521,4143,9664,+
chr19,34452001,1.7067055661350756,3636,3145,6781,+
chr19,34452002,1.3302135303418599,9828,7559,17387,+
chr19,34452004,1.2766402057710091,14281,11200,25481,+
chr19,34452005,1.3875227050073564,9229,8053,17282,+
chr19,34452006,1.401752529124395,6394,6268,12662,+
chr19,34452007,1.3765198842674369,4941,4906,9847,+
chr19,34452010,1.3726725268656506,10791,8449,19240,+
chr19,34452011,1.4217109732696553,14888,12624,27512,+
chr19,34454271,1.5901503446470648,1603,1235,2838,+
chr19,34454467,2.214341085271318,590,429,1019,+
chr19,34454482,2.5205250777752486,976,572,1548,+
chr19,34454486,1.0200047274798265,2614,1741,4355,+
chr19,34458770,1.4733560090702948,1242,881,2123,+
chr19,34458776,1.4265010351966876,1430,1034,2464,+
chr19,34458781,2.151564801178204,1600,1357,2957,+
chr19,34458782,2.151564801178204,1600,1357,2957,+
chr19,34458799,1.64021164021164,774,674,1448,+
chr19,34458839,2.3150442477876103,871,677,1548,+
chr19,34458907,1.5248267898383372,1389,865,2254,+
chr19,34460470,2.304517270100464,2783,2461,5244,+
chr19,34460471,2.102438422449508,4276,3861,8137,+
chr19,34460473,1.9231744282171401,2907,2673,5580,+
chr19,34460476,1.8643694531762416,4956,4362,9318,+
chr19,34460477,1.5073926954148247,5149,4674,9823,+
chr19,34464029,2.144515306122449,730,559,1289,+
chr19,34464060,1.6545637198622274,1280,870,2150,+
chr19,34464062,1.3596936999651934,1027,883,1910,+
chr19,34466886,1.8962962962962966,639,449,1088,+
chr19,34466927,0.4225831399845321,682,430,1112,+
chr19,34466960,0.5389706608712832,1022,572,1594,+
chr19,34466968,0.6684597701149424,937,749,1686,+
chr19,34469040,1.7938399628540473,1709,922,2631,+
chr19,34469042,1.6870628977437305,6218,3491,9709,+
chr19,34469043,1.6383721837223977,7620,4378,11998,+
chr19,34469045,1.638795569335538,2846,1827,4673,+
chr19,34469048,0.5675244010647738,1091,804,1895,+
chr19,34469092,0.7848718942941509,3555,2578,6133,+
chr19,34469093,1.343066110507971,3133,2034,5167,+
chr19,34469117,1.5126681263684705,8462,6393,14855,+
chr19,34469119,1.57544035930846,12073,8825,20898,+
chr19,34469303,1.9165994101512158,2291,1752,4043,+
chr19,34469373,1.8096774193548388,968,759,1727,+
chr19,34469547,1.6582534073700153,1313,848,2161,+
chr19,34469614,1.4197662061636558,1335,940,2275,+
chr19,34469748,1.510301968635302,1477,887,2364,+
chr19,35155572,2.0526315789473686,979,664,1643,+
chr19,35155573,2.0526315789473686,979,664,1643,+
chr19,35155576,2.318907035090422,951,744,1695,+
chr19,35155593,1.8771784232365147,521,481,1002,+
chr19,35157421,0.4811740647179117,599,488,1087,+
chr19,35157428,2.365838454003028,717,590,1307,+
chr19,35157431,0.4752762689642255,724,561,1285,+
chr19,35157433,1.7858585858585858,832,692,1524,+
chr19,35158347,0.658008658008658,1367,755,2122,+
chr19,35158356,1.7738745235397135,1541,1141,2682,+
chr19,35158369,1.4453885097952894,1727,1297,3024,+
chr19,35158375,1.5373260702032059,6109,3281,9390,+
chr19,35158377,1.1470655906425502,6948,4174,11122,+
chr19,35160709,1.299249336852436,8160,5266,13426,+
chr19,35160712,1.227540945853673,7688,5234,12922,+
chr19,35160714,2.482532310177706,2137,1237,3374,+
chr19,35160715,1.3237722729248151,9137,6017,15154,+
chr19,35160716,0.6377560268261736,1815,1225,3040,+
chr19,35160717,1.2200543244496391,15298,10523,25821,+
chr19,35160722,1.6449280444435372,12340,9019,21359,+
chr19,35160723,1.4603954457164836,16322,12242,28564,+
chr19,35166307,4.350103092783504,958,484,1442,+
chr19,35166309,4.350103092783504,958,484,1442,+
chr19,35169570,1.7152768822970206,685,578,1263,+
chr19,35278714,7.586594868980779,1610,1274,2884,+
chr19,35278715,5.296680566887299,2114,1691,3805,+
chr19,35278966,1.9028676021964608,1355,744,2099,+
chr19,35278967,1.9028676021964608,1355,744,2099,+
chr19,35278974,2.353894289864789,1531,941,2472,+
chr19,35278976,2.133173076923077,2345,1471,3816,+
chr19,35278978,2.0053286345108696,1600,1023,2623,+
chr19,35278999,1.1071308327645293,2103,1498,3601,+
chr19,35279024,1.7170261951863584,3560,2808,6368,+
chr19,35279026,1.5773373434207603,7548,5873,13421,+
chr19,35279027,1.8057413479210251,5614,4302,9916,+
chr19,35279644,6.253942809461929,619,429,1048,+
chr19,35279645,6.415283221546339,715,535,1250,+
chr19,35545751,0.4293441514536849,634,492,1126,+
chr19,35545752,0.4293441514536849,634,492,1126,+
chr19,35545788,1.895919657279304,793,490,1283,+
chr19,35545802,0.8402409976180467,936,792,1728,+
chr19,35545803,0.8402409976180467,936,792,1728,+
chr19,35545907,1.1096891558874231,1719,1038,2757,+
chr19,35545908,1.2594718956455664,2651,1605,4256,+
chr19,35545910,1.008219178082192,1816,1094,2910,+
chr19,35546705,0.4653465346534654,610,403,1013,+
chr19,35546711,1.2297665405177836,2088,1489,3577,+
chr19,35546712,0.7479933743268594,2203,1471,3674,+
chr19,35546756,0.5673374056773266,830,505,1335,+
chr19,35546979,1.608974358974359,752,428,1180,+
chr19,35547125,0.5641412815126049,660,447,1107,+
chr19,35547152,2.0494117647058827,602,424,1026,+
chr19,35547171,0.6111435360820444,1010,577,1587,+
chr19,35629635,2.270781076278847,822,524,1346,+
chr19,35629644,1.3162647351945007,843,836,1679,+
chr19,35629645,0.6723497705628495,942,866,1808,+
chr19,35629646,2.0549760601915183,1264,687,1951,+
chr19,35629647,2.0549760601915183,1264,687,1951,+
chr19,35631209,1.2413532296542673,737,432,1169,+
chr19,35633687,2.4151090342679127,885,641,1526,+
chr19,35633688,2.2094263917442305,1243,968,2211,+
chr19,35633692,2.229469501250547,1262,1152,2414,+
chr19,35633694,2.514641620127801,1272,1264,2536,+
chr19,35633697,1.9774011299435026,524,530,1054,+
chr19,35634272,2.118715546093033,767,488,1255,+
chr19,35634274,3.1174024959708535,605,472,1077,+
chr19,35637256,2.8272575194409413,1031,805,1836,+
chr19,35637476,1.0384351285641864,1172,794,1966,+
chr19,35648322,0.5168251112578388,1037,570,1607,+
chr19,35648331,1.5385445986509403,1396,764,2160,+
chr19,35648335,1.647114495082934,1618,947,2565,+
chr19,35648351,1.7092173913043478,727,499,1226,+
chr19,35648355,1.4734264727063229,1394,785,2179,+
chr19,35648373,1.5242842445098803,1982,1190,3172,+
chr19,35651270,1.6962318840579709,1616,1149,2765,+
chr19,35651324,1.4079969803724206,2350,1986,4336,+
chr19,35654618,1.6981180483240517,2122,1698,3820,+
chr19,35658596,0.4026143790849673,1154,849,2003,+
chr19,35658639,1.4070155429098363,1505,1128,2633,+
chr19,35658645,0.7027560727025649,1438,1217,2655,+
chr19,35658709,2.6708242036069443,833,697,1530,+
chr19,35745930,2.55604343888347,851,533,1384,+
chr19,35745931,2.55604343888347,851,533,1384,+
chr19,35746421,2.676317591864103,602,440,1042,+
chr19,36141175,4.00714064890342,1124,830,1954,+
chr19,36141176,4.5949286718560725,1619,1402,3021,+
chr19,36141177,3.3147286821705424,1068,644,1712,+
chr19,36141178,3.709913267998877,1546,1530,3076,+
chr19,36141179,4.9199359756449,947,995,1942,+
chr19,36141201,1.4297232991481807,595,906,1501,+
chr19,36141202,0.3169014084507043,665,1135,1800,+
chr19,36141204,0.34224250325945244,454,766,1220,+
chr19,36142706,1.8734073641145528,681,589,1270,+
chr19,36145833,0.9522841553439608,1805,1437,3242,+
chr19,36145835,0.9522841553439608,1805,1437,3242,+
chr19,36145836,0.5150367309458218,640,483,1123,+
chr19,36145979,1.4660304711434962,1160,928,2088,+
chr19,36146217,2.183633387888707,952,704,1656,+
chr19,36149613,1.6117386489479508,765,629,1394,+
chr19,36149830,2.4004424778761058,1208,677,1885,+
chr19,36149934,0.527621722846442,783,711,1494,+
chr19,36150007,1.215822898494915,1748,1189,2937,+
chr19,36235755,1.2813842516644558,3585,3212,6797,+
chr19,36235756,1.2813842516644558,3585,3212,6797,+
chr19,36235757,1.3234529347194466,4213,3627,7840,+
chr19,36236000,2.0975989328590487,764,518,1282,+
chr19,36236620,0.33118027011156786,751,523,1274,+
chr19,36236728,1.7383820998278827,605,414,1019,+
chr19,36237167,3.5763475462590506,716,564,1280,+
chr19,36237168,3.5763475462590506,716,564,1280,+
chr19,36237383,2.1160907635815835,724,558,1282,+
chr19,36237562,1.5348131548299175,1190,823,2013,+
chr19,36237574,2.707714596160812,533,501,1034,+
chr19,36237624,2.1910768822201567,568,442,1010,+
chr19,36238208,2.2229515296340887,2158,1559,3717,+
chr19,36238215,2.177205882352941,944,849,1793,+
chr19,36238275,1.9872823805408075,869,622,1491,+
chr19,36238283,2.4128845267110206,813,798,1611,+
chr19,36238290,2.0734611824789204,1870,1768,3638,+
chr19,36238409,8.93547111619908,1385,320,1705,+
chr19,36238411,12.249197860962568,880,186,1066,+
chr19,36238414,9.839302946194149,3398,817,4215,+
chr19,36238415,9.05485505498316,4397,1101,5498,+
chr19,36238416,8.2310386953311,5182,1303,6485,+
chr19,36238418,18.956828534180193,3177,1144,4321,+
chr19,36238419,18.611714395917282,5889,4015,9904,+
chr19,36238420,18.611714395917282,5889,4015,9904,+
chr19,36238421,18.39494718313132,5104,3813,8917,+
chr19,36238434,7.656975043835851,5671,8837,14508,+
chr19,36238435,7.656975043835852,5671,8837,14508,+
chr19,36238436,7.656975043835851,5671,8837,14508,+
chr19,37792661,3.2893977108374677,625,557,1182,+
chr19,37792662,3.2893977108374677,625,557,1182,+
chr19,38304392,1.2364288584758296,780,513,1293,+
chr19,38304422,1.3695078031212484,1425,832,2257,+
chr19,38304423,1.3695078031212484,1425,832,2257,+
chr19,38304424,1.3695078031212484,1425,832,2257,+
chr19,38304665,1.7838905036833403,1133,744,1877,+
chr19,38304862,1.6332458770614693,580,463,1043,+
chr19,38374787,0.8800007436192328,674,531,1205,+
chr19,38376199,0.11785598966742009,729,488,1217,+
chr19,38376430,2.161556603773585,704,423,1127,+
chr19,38379262,0.540905134899913,677,382,1059,+
chr19,38379307,2.1203258774786384,739,592,1331,+
chr19,38379362,2.0552965412555566,676,400,1076,+
chr19,38382160,1.5854833926453145,610,561,1171,+
chr19,38382202,0.4873055605220812,1816,1665,3481,+
chr19,38382204,0.4873055605220812,1816,1665,3481,+
chr19,38383313,4.1141732283464565,626,380,1006,+
chr19,38383417,5.2514708336649605,971,638,1609,+
chr19,38619193,0.7769929578701508,1427,841,2268,+
chr19,38619194,1.1147595113050548,1285,691,1976,+
chr19,38619196,2.568506329113924,745,394,1139,+
chr19,38619202,2.6654067473412715,885,577,1462,+
chr19,38619226,1.921539515760621,672,397,1069,+
chr19,38619261,3.3251095932307067,905,576,1481,+
chr19,38620337,2.2930285714285707,791,524,1315,+
chr19,38620338,2.2930285714285707,791,524,1315,+
chr19,38620339,1.957894736842105,650,384,1034,+
chr19,38620408,2.041561468246261,656,541,1197,+
chr19,38624120,0.6674315022270212,859,477,1336,+
chr19,38624143,1.780614712365563,1469,1019,2488,+
chr19,38626028,1.479779411764706,804,543,1347,+
chr19,38632445,1.773690078037904,687,623,1310,+
chr19,38632635,0.5233965062468906,1506,1196,2702,+
chr19,38632637,0.5233965062468906,1506,1196,2702,+
chr19,38635017,0.5770810810810811,627,499,1126,+
chr19,38635019,2.1949626188575158,944,598,1542,+
chr19,38635067,2.208584905660377,570,529,1099,+
chr19,38635071,1.0667521069737518,1627,1222,2849,+
chr19,38647727,4.008110498044653,606,722,1328,+
chr19,38647835,0.9599598555497199,1470,1055,2525,+
chr19,38647836,1.0889610389610391,1031,879,1910,+
chr19,38647876,0.5508545979778526,1016,803,1819,+
chr19,38647884,1.7304143126177025,1080,471,1551,+
chr19,38647890,1.3717081529581527,3201,2111,5312,+
chr19,38647891,0.6916590997535349,1735,1185,2920,+
chr19,38647892,1.3633904027975556,4827,2872,7699,+
chr19,38700598,1.3819859283018052,5028,3572,8600,+
chr19,38700599,1.4645250758638693,4421,3225,7646,+
chr19,38700600,1.4645250758638693,4421,3225,7646,+
chr19,38700651,1.3230879051765845,799,576,1375,+
chr19,38700684,3.3149895178197064,758,476,1234,+
chr19,38701015,3.0025209598875935,1311,804,2115,+
chr19,38704933,1.7764258831463158,1012,706,1718,+
chr19,38706099,1.8830280291326413,710,393,1103,+
chr19,38708151,1.5590010405827264,680,464,1144,+
chr19,38717135,2.414705888854733,703,489,1192,+
chr19,38717152,1.7603740380501665,882,598,1480,+
chr19,38717933,2.715750915750916,673,454,1127,+
chr19,38717934,2.715750915750916,673,454,1127,+
chr19,38718056,2.643148134132624,625,380,1005,+
chr19,38723636,1.5668673557957864,768,566,1334,+
chr19,38724018,1.170351734745014,619,504,1123,+
chr19,38724160,3.0542689209489047,967,703,1670,+
chr19,38724178,1.787242509234093,829,548,1377,+
chr19,38724237,2.182560264816738,616,477,1093,+
chr19,38724313,1.5033723754994526,1190,830,2020,+
chr19,38726975,3.5921103630254345,684,499,1183,+
chr19,38727086,3.7318375275616615,630,437,1067,+
chr19,38729119,3.5981481481481485,736,494,1230,+
chr19,38729121,3.5981481481481485,736,494,1230,+
chr19,38729518,0.3407040970497437,864,463,1327,+
chr19,38729556,25.58009690631869,1424,105,1529,+
chr19,38729558,32.957615418170654,2125,184,2309,+
chr19,38729559,27.337845274144485,1899,181,2080,+
chr19,38729560,27.337845274144485,1899,181,2080,+
chr19,38729561,16.591194968553463,1318,158,1476,+
chr19,38729563,10.382382875816203,1574,277,1851,+
chr19,38729564,19.561248706965504,898,238,1136,+
chr19,38729565,14.281900744940774,1898,417,2315,+
chr19,38729568,9.161249875076352,1927,704,2631,+
chr19,38729569,9.64026484357055,2257,803,3060,+
chr19,38729570,9.64026484357055,2257,803,3060,+
chr19,38729574,13.285194179149844,2336,1463,3799,+
chr19,38729575,13.285194179149844,2336,1463,3799,+
chr19,38729576,13.285194179149844,2336,1463,3799,+
chr19,38729580,17.509115952317828,1557,1607,3164,+
chr19,38729582,17.509115952317824,1557,1607,3164,+
chr19,38729638,1.010843692144935,440,596,1036,+
chr19,38729640,1.010843692144935,440,596,1036,+
chr19,38730115,0.8542825361512792,671,433,1104,+
chr19,38730117,0.8542825361512792,671,433,1104,+
chr19,38730384,4.334186540220795,2133,1493,3626,+
chr19,38730385,3.8814115177751543,1137,725,1862,+
chr19,38730386,3.8814115177751543,1137,725,1862,+
chr19,38932739,3.1141480381678366,616,560,1176,+
chr19,39476126,1.3446969696969695,709,351,1060,+
chr19,39476127,1.3446969696969695,709,351,1060,+
chr19,39476128,1.3446969696969695,709,351,1060,+
chr19,39488138,2.0549587459512124,756,548,1304,+
chr19,39971173,1.3592053867591447,695,433,1128,+
chr19,39971181,1.4639863284763446,838,509,1347,+
chr19,39971182,1.4639863284763446,838,509,1347,+
chr19,39974526,1.1210708059349437,655,565,1220,+
chr19,39980357,2.324511657214871,713,413,1126,+
chr19,39980359,2.324511657214871,713,413,1126,+
chr19,39980675,2.7255431678167072,1035,671,1706,+
chr19,39981211,2.2114898989898992,1016,527,1543,+
chr19,39981212,2.2114898989898992,1016,527,1543,+
chr19,39981246,0.557144633752021,559,472,1031,+
chr19,39981269,2.1616671686495557,1254,835,2089,+
chr19,39981326,1.6743421052631582,1017,835,1852,+
chr19,39981347,3.401785714285714,634,447,1081,+
chr19,39981351,2.7769252628587666,697,390,1087,+
chr19,39981360,2.118344384167169,810,473,1283,+
chr19,39981367,1.0110733778484668,2772,2213,4985,+
chr19,39981373,0.7471190145042719,1156,718,1874,+
chr19,39981380,2.11737623226086,2521,2171,4692,+
chr19,39981381,2.11737623226086,2521,2171,4692,+
chr19,40348740,10.548085001235483,863,557,1420,+
chr19,40348752,12.566207475714192,1166,771,1937,+
chr19,40366870,0.5535870158098731,922,687,1609,+
chr19,40369910,2.9269099909888663,629,454,1083,+
chr19,40371811,1.330151231564541,745,570,1315,+
chr19,40374504,2.217537843716962,725,555,1280,+
chr19,40376663,4.430452379132028,811,551,1362,+
chr19,40377822,1.2179597058186322,751,584,1335,+
chr19,40377826,3.1712376933895916,621,473,1094,+
chr19,40377828,3.1712376933895916,621,473,1094,+
chr19,40751348,1.568306010928962,737,548,1285,+
chr19,40751362,2.0537585421412303,587,438,1025,+
chr19,40751379,0.4983778754397317,2718,1779,4497,+
chr19,40751380,0.540472506408628,1613,1006,2619,+
chr19,40751413,1.4963174210882757,2423,1662,4085,+
chr19,40757358,1.8579220779220782,621,384,1005,+
chr19,40757478,4.791902241557606,648,476,1124,+
chr19,40765302,5.669131957960294,661,366,1027,+
chr19,40765304,5.669131957960294,661,366,1027,+
chr19,41259582,2.5260650685684056,1369,1072,2441,+
chr19,41259583,2.49859693877551,1030,783,1813,+
chr19,41272162,1.758929319307898,703,481,1184,+
chr19,41273991,2.5801212397494813,750,449,1199,+
chr19,41274007,2.1642585822374456,816,489,1305,+
chr19,41274011,2.6027227722772275,700,403,1103,+
chr19,41274014,1.3393474732796316,1687,979,2666,+
chr19,41274015,0.8885606874328679,2205,1175,3380,+
chr19,41274017,0.814058863325284,1851,1058,2909,+
chr19,41274022,1.9202453987730066,938,488,1426,+
chr19,41274028,1.0236418511066396,1627,1135,2762,+
chr19,41274030,1.3583750071955922,2967,1863,4830,+
chr19,41274031,1.5545811999660548,1248,666,1914,+
chr19,41274037,1.8787331225217083,984,686,1670,+
chr19,41274043,2.5485893416927903,1083,811,1894,+
chr19,41276224,2.4103848726284745,575,463,1038,+
chr19,41294639,2.026831960366185,831,591,1422,+
chr19,41301537,1.1506114138776748,639,546,1185,+
chr19,41304186,1.0760603386890397,674,463,1137,+
chr19,41307151,5.943674518929687,1352,1101,2453,+
chr19,41307253,1.323247988375492,977,698,1675,+
chr19,41307441,13.386121443505333,941,628,1569,+
chr19,41307442,14.405404782353221,1647,1232,2879,+
chr19,41307443,14.405404782353221,1647,1232,2879,+
chr19,41307444,11.884172089069928,1467,1193,2660,+
chr19,41860253,0.717531723997302,3375,947,4322,+
chr19,41860254,0.9109483177181992,15592,6265,21857,+
chr19,41860255,0.9810150229158032,2575,1314,3889,+
chr19,41860256,0.9838272088294042,18282,6290,24572,+
chr19,41860257,1.9292758051392371,19919,7468,27387,+
chr19,41860259,1.9903465267081293,13756,4032,17788,+
chr19,41860261,1.8722913757926805,18303,6647,24950,+
chr19,41860262,2.0271270654058506,13688,5303,18991,+
chr19,41860265,1.6107252201031643,7586,3179,10765,+
chr19,41860272,1.923908395136282,8539,3934,12473,+
chr19,41860278,1.5229009468972337,5803,4308,10111,+
chr19,41860279,1.8586512696178024,12546,7086,19632,+
chr19,41860781,1.555382887462087,20246,10893,31139,+
chr19,41860782,1.5477458757989706,21305,10701,32006,+
chr19,41860788,1.283252111791418,35620,19988,55608,+
chr19,41860789,1.184599248824521,42207,24118,66325,+
chr19,41860790,1.280167974108263,29970,15236,45206,+
chr19,41861123,1.4161859518154054,11783,8840,20623,+
chr19,41861125,1.3442584318972277,25704,18529,44233,+
chr19,41861197,1.2863981351284022,19352,12757,32109,+
chr19,41869048,1.634024759024759,8744,4883,13627,+
chr19,41869093,1.2485934872436224,5995,4416,10411,+
chr19,41869107,1.1799456800998311,7951,4779,12730,+
chr19,41869186,1.4502372993128316,5475,2938,8413,+
chr19,41869187,1.2933880580971662,15074,10925,25999,+
chr19,41869188,1.2933880580971662,15074,10925,25999,+
chr19,41869189,1.2826346631857373,26607,18438,45045,+
chr19,41869197,1.3566858386071194,11615,8993,20608,+
chr19,41869198,1.3566858386071194,11615,8993,20608,+
chr19,41869201,1.8643936936980545,6137,4977,11114,+
chr19,41869734,0.875322445405923,5883,4953,10836,+
chr19,41869738,1.2783565838664397,5663,5281,10944,+
chr19,41901997,1.9742550303888597,666,414,1080,+
chr19,41902291,2.807873235949492,1030,576,1606,+
chr19,41902293,2.807873235949492,1030,576,1606,+
chr19,41902858,3.5838797271342475,1020,718,1738,+
chr19,41902859,3.5838797271342475,1020,718,1738,+
chr19,41902860,3.1802430100199404,1159,813,1972,+
chr19,44662072,3.844768950811408,726,541,1267,+
chr19,44663283,2.3529725932562977,1438,824,2262,+
chr19,44663287,3.0495455878041633,742,378,1120,+
chr19,44663288,2.6057030481809247,847,451,1298,+
chr19,44663301,2.146643109540636,944,565,1509,+
chr19,44663307,0.6299490950226244,989,543,1532,+
chr19,44663308,2.386154461784714,1067,713,1780,+
chr19,44663314,2.020010744023637,1156,656,1812,+
chr19,46353956,1.532875876560087,723,417,1140,+
chr19,46375604,1.9640179020150148,890,534,1424,+
chr19,46375612,3.6003125,842,599,1441,+
chr19,46375613,2.825308564957786,3041,2145,5186,+
chr19,46375615,2.332066295183716,2716,1971,4687,+
chr19,46375616,2.1086202623318173,1345,1044,2389,+
chr19,46609786,4.188771468335296,583,553,1136,+
chr19,46610123,3.4889409571713963,660,459,1119,+
chr19,47130959,2.7173198636806233,663,364,1027,+
chr19,47150363,0.2430369300598308,588,523,1111,+
chr19,47152949,2.3615560640732265,687,436,1123,+
chr19,47152956,2.7877081349194515,1087,758,1845,+
chr19,47197262,2.2567055913480822,1096,840,1936,+
chr19,47197263,2.568561872909699,575,482,1057,+
chr19,47209373,2.4893837537049652,1061,755,1816,+
chr19,47209749,2.4993380163206487,677,492,1169,+
chr19,47210018,1.511664079176444,674,533,1207,+
chr19,47210026,0.44779502252852826,625,515,1140,+
chr19,47309859,1.103519213851914,1426,1440,2866,+
chr19,47309860,0.9358647456514905,2258,2164,4422,+
chr19,47319867,2.876489707475623,589,425,1014,+
chr19,47319990,3.1827007943512795,600,411,1011,+
chr19,47319991,3.1827007943512795,600,411,1011,+
chr19,47320064,2.6208740371128205,630,415,1045,+
chr19,47320562,2.8488372093023258,636,429,1065,+
chr19,47320563,2.8488372093023258,636,429,1065,+
chr19,47320711,2.048141290414471,718,412,1130,+
chr19,47320712,2.048141290414471,718,412,1130,+
chr19,47320776,1.7857002325068843,806,619,1425,+
chr19,47321095,1.5759420082789914,660,509,1169,+
chr19,47321099,0.5021691430088302,614,422,1036,+
chr19,47321100,1.9861837191934282,590,411,1001,+
chr19,47321102,1.9861837191934282,590,411,1001,+
chr19,47321108,1.239912060110846,917,661,1578,+
chr19,47321163,1.5891301753967308,682,577,1259,+
chr19,47321517,3.9068915019821757,1157,972,2129,+
chr19,47321518,3.0455983981781003,2318,1736,4054,+
chr19,47321519,2.270097042108245,1819,1339,3158,+
chr19,47321555,1.0766541822721598,587,444,1031,+
chr19,47321557,0.8816706231623509,857,700,1557,+
chr19,47321574,0.47449507363478455,839,614,1453,+
chr19,47321634,1.9627822867140836,915,721,1636,+
chr19,47321894,3.3402814222091632,616,450,1066,+
chr19,47321895,2.8426384158546987,757,535,1292,+
chr19,47343230,1.3843878381636459,677,567,1244,+
chr19,47343232,0.2164810690423163,566,448,1014,+
chr19,47353706,1.7999206252530264,960,683,1643,+
chr19,47353709,2.592363434686312,1062,806,1868,+
chr19,47745599,2.3285931174089067,978,759,1737,+
chr19,47745601,2.6410831715742877,1344,1119,2463,+
chr19,47745683,0.4648729347988931,770,545,1315,+
chr19,47745689,2.29051774211144,1043,706,1749,+
chr19,47745743,1.687545436924532,1048,670,1718,+
chr19,47745765,1.9648123256569496,1813,1123,2936,+
chr19,47745767,1.8883039874145342,1327,786,2113,+
chr19,47745770,2.3165895571711834,700,444,1144,+
chr19,47746973,1.9368336886993605,558,468,1026,+
chr19,47746986,1.8366013071895424,561,475,1036,+
chr19,47746990,1.5324809083601285,1469,1243,2712,+
chr19,47746991,1.5324809083601285,1469,1243,2712,+
chr19,47750224,2.0273368606701943,725,566,1291,+
chr19,47751064,2.072421052631579,641,374,1015,+
chr19,47751083,1.7774244833068362,558,443,1001,+
chr19,47751576,2.542602517067624,709,538,1247,+
chr19,47752580,0.9604677060133628,1124,897,2021,+
chr19,47752582,0.9604677060133628,1124,897,2021,+
chr19,47754797,4.6422381707218054,2219,1963,4182,+
chr19,47754798,4.406947845105693,2482,2219,4701,+
chr19,47754799,4.353160183052567,3016,2474,5490,+
chr19,47754801,3.4289062500000003,797,511,1308,+
chr19,47755482,3.817915200439277,980,781,1761,+
chr19,47755483,3.611448283733925,1224,967,2191,+
chr19,47755486,7.176922921711056,699,561,1260,+
chr19,47755492,1.6528469470484797,672,627,1299,+
chr19,47755757,0.7565793547049806,1029,634,1663,+
chr19,47755768,0.5266752008328051,715,581,1296,+
chr19,47755798,1.033501695125771,1642,1057,2699,+
chr19,47756537,1.9762235552806422,1421,1129,2550,+
chr19,47756697,0.9872273644498268,1938,1576,3514,+
chr19,47939542,0.9848506967679396,644,647,1291,+
chr19,48904410,1.179815472424168,666,518,1184,+
chr19,48911166,3.0950732636113134,1161,796,1957,+
chr19,48911167,1.7877468060394888,785,573,1358,+
chr19,48913058,1.1659773517006558,954,619,1573,+
chr19,48918728,3.0952685421994888,1338,781,2119,+
chr19,48918730,3.0952685421994888,1338,781,2119,+
chr19,48919031,1.9074265449759051,2528,2012,4540,+
chr19,48919032,1.8157266236897038,3393,2640,6033,+
chr19,48919033,1.9074265449759051,2528,2012,4540,+
chr19,48919035,0.5410968178740689,665,421,1086,+
chr19,48919036,1.5581789013868999,2093,1704,3797,+
chr19,48921201,0.2276182432432433,538,517,1055,+
chr19,48921202,0.2276182432432433,538,517,1055,+
chr19,48922858,1.2570048623321355,721,565,1286,+
chr19,48923094,2.7651342985171263,709,487,1196,+
chr19,48954943,3.0193953066953214,579,495,1074,+
chr19,48954944,3.0193953066953214,579,495,1074,+
chr19,48965308,1.078754145045172,1873,1146,3019,+
chr19,48965310,1.078754145045172,1873,1146,3019,+
chr19,48965332,1.3739049209781302,7592,5182,12774,+
chr19,48965334,1.4562972822159408,7822,5605,13427,+
chr19,48965335,1.4226476257554563,8302,5770,14072,+
chr19,48965339,1.325023169601483,3363,2489,5852,+
chr19,48965342,1.3964702557054443,9812,7731,17543,+
chr19,48965436,1.127383555320232,25533,18753,44286,+
chr19,48965467,0.8767854999399831,10434,8330,18764,+
chr19,48965526,0.8610745917520067,14221,10838,25059,+
chr19,48965773,1.153129825283142,25571,18593,44164,+
chr19,48965775,1.2271324766582135,49426,32726,82152,+
chr19,48965776,1.3528408737483153,29313,17593,46906,+
chr19,48965868,0.7357633775159547,3299,2909,6208,+
chr19,48966280,0.7015170151701517,3893,2980,6873,+
chr19,48966281,1.5467504533760699,3911,2095,6006,+
chr19,48966288,1.6791542784675246,6921,4668,11589,+
chr19,48966290,1.446808027659539,15963,10235,26198,+
chr19,48966291,1.4261666181965245,7415,5136,12551,+
chr19,48966303,1.3864280528990311,4672,3539,8211,+
chr19,48966304,0.8394799067288876,18988,14065,33053,+
chr19,48966305,0.8394799067288876,18988,14065,33053,+
chr19,48966341,1.2797355971919355,52410,35606,88016,+
chr19,48966342,1.2552163894318575,51818,35626,87444,+
chr19,48966343,1.2427686182876938,39942,24908,64850,+
chr19,48966372,0.7836254605499223,10969,6598,17567,+
chr19,48966584,1.27095616976097,8398,4996,13394,+
chr19,48966611,1.3727452610610669,13227,8822,22049,+
chr19,48966722,1.4793219821915458,5225,3808,9033,+
chr19,49007054,0.772019968857711,630,387,1017,+
chr19,49007336,1.4423180418760246,558,519,1077,+
chr19,49010497,0.3393665158371041,649,441,1090,+
chr19,49010498,0.3393665158371041,649,441,1090,+
chr19,49010507,1.0220638201328416,1106,745,1851,+
chr19,49010520,1.028153480002322,1311,748,2059,+
chr19,49010522,1.028153480002322,1311,748,2059,+
chr19,49015593,1.7627219574344755,589,434,1023,+
chr19,49085515,2.351155518333238,813,541,1354,+
chr19,49085517,2.4423342541436464,642,361,1003,+
chr19,49086503,1.875699888017917,602,422,1024,+
chr19,49090298,2.264232073643411,762,687,1449,+
chr19,49090300,2.264232073643411,762,687,1449,+
chr19,49090322,0.9291891891891892,1145,813,1958,+
chr19,49090324,0.9291891891891892,1145,813,1958,+
chr19,49090490,2.008752410728895,877,645,1522,+
chr19,49098435,1.4700239808153477,612,416,1028,+
chr19,49098650,0.45686274509803915,698,509,1207,+
chr19,49108159,0.5907363052978566,858,657,1515,+
chr19,49108161,0.6747005846904451,710,541,1251,+
chr19,49108295,5.170261107800618,1158,346,1504,+
chr19,49108315,35.87063421679814,1253,916,2169,+
chr19,49108316,39.25850305419327,1151,797,1948,+
chr19,49108353,0.3448275862068965,507,507,1014,+
chr19,49108354,0.3448275862068965,507,507,1014,+
chr19,49108408,0.5621748864082293,746,653,1399,+
chr19,49487606,0.9849665851027442,1779,1311,3090,+
chr19,49487607,1.253990278686738,3940,3167,7107,+
chr19,49489849,0.07778599605522682,630,415,1045,+
chr19,49489851,0.6408254576998584,637,446,1083,+
chr19,49489853,1.68679676511955,618,473,1091,+
chr19,49489858,0.9461223193010326,2255,1258,3513,+
chr19,49489859,1.3494451294697904,987,810,1797,+
chr19,49489860,0.911723109226469,4517,2843,7360,+
chr19,49489862,0.8836247852408599,2559,1408,3967,+
chr19,49489872,1.1000121878953186,3995,2133,6128,+
chr19,49489874,1.1000121878953186,3995,2133,6128,+
chr19,49489875,1.605794543222394,3676,2461,6137,+
chr19,49489877,1.5592720314219073,5240,3909,9149,+
chr19,49489878,1.2396449119199666,2507,1366,3873,+
chr19,49489903,1.4269630307960868,7587,4433,12020,+
chr19,49489905,1.2190686517694858,10269,6820,17089,+
chr19,49490234,1.3331219424987983,22876,16302,39178,+
chr19,49490236,1.3299125870532758,29788,20526,50314,+
chr19,49490237,1.278614796869652,20558,14284,34842,+
chr19,49490243,1.6526266526266526,4999,4069,9068,+
chr19,49490476,1.3616082652603896,5098,2950,8048,+
chr19,49490477,1.37091604130475,4425,3003,7428,+
chr19,49490504,1.406309655960907,17030,12897,29927,+
chr19,49490506,1.5300520191692688,10994,8051,19045,+
chr19,49490558,1.187556999013568,6149,4132,10281,+
chr19,49490790,1.0163823558776126,29444,20309,49753,+
chr19,49490792,0.8062068668312475,14713,11429,26142,+
chr19,49490907,0.6535068496410316,847,1034,1881,+
chr19,49490923,0.39460716747070973,1237,1450,2687,+
chr19,49490924,0.39460716747070973,1237,1450,2687,+
chr19,49490927,0.6633551198257079,691,764,1455,+
chr19,49490931,0.6030823213369361,2462,2363,4825,+
chr19,49490933,0.6116237470663854,1882,1813,3695,+
chr19,49491738,1.1457535002270418,1236,819,2055,+
chr19,49491746,1.6808571839493744,753,408,1161,+
chr19,49491750,2.0753917831427358,979,786,1765,+
chr19,49491761,0.6219097849110785,1066,772,1838,+
chr19,49491767,1.596415472097546,5222,2592,7814,+
chr19,49491768,1.6139862575755306,6856,3536,10392,+
chr19,49491769,1.596415472097546,5222,2592,7814,+
chr19,49491773,1.0159854596553672,3744,2451,6195,+
chr19,49491791,1.3282982187890413,13314,7960,21274,+
chr19,49491792,1.3282982187890413,13314,7960,21274,+
chr19,49491812,1.603038126267274,7661,5896,13557,+
chr19,49491818,1.468284700507121,4719,3409,8128,+
chr19,49491947,1.2316191141260977,5309,3579,8888,+
chr19,49491959,1.5921375733159084,10806,8248,19054,+
chr19,49491982,0.8764192985855453,8737,6748,15485,+
chr19,49491983,1.3445248477553615,14202,9770,23972,+
chr19,49492021,1.3244370743835798,29085,22904,51989,+
chr19,49492093,1.431531810921711,8872,6720,15592,+
chr19,49492129,1.1751993989774638,22147,15112,37259,+
chr19,49492130,1.2352843958235922,31187,22230,53417,+
chr19,49492204,1.2489421428616947,7418,5505,12923,+
chr19,49496425,1.0823279407732382,830,520,1350,+
chr19,49496427,0.7125242281700396,2357,1545,3902,+
chr19,49496429,0.7142728848018555,3411,2268,5679,+
chr19,49496431,0.9194909190974132,2438,1895,4333,+
chr19,49496432,0.9305442494071258,10887,5773,16660,+
chr19,49496433,1.0144739261019815,13814,7184,20998,+
chr19,49496434,1.137369527990436,19770,10649,30419,+
chr19,49496435,1.2327138026762494,18052,9872,27924,+
chr19,49496436,1.3353198888246436,27103,16229,43332,+
chr19,49496437,1.3753463698223773,5882,4421,10303,+
chr19,49496438,1.3141647175387723,13398,8178,21576,+
chr19,49496442,0.6991288685297503,1964,1780,3744,+
chr19,49497209,1.6855983772819474,2492,2087,4579,+
chr19,49497228,0.7922796281040367,2719,2343,5062,+
chr19,49497230,1.0259458884306027,17826,13636,31462,+
chr19,49497231,0.8511378580092778,11401,9385,20786,+
chr19,49497232,1.0259458884306027,17826,13636,31462,+
chr19,49497235,1.3663827966590398,7780,5429,13209,+
chr19,49497236,1.3458661389646542,12078,8479,20557,+
chr19,49497238,1.3489088714667092,12726,9066,21792,+
chr19,49497239,1.3998474334366848,8724,6251,14975,+
chr19,49497255,1.0317735986948133,20270,14239,34509,+
chr19,49497289,1.2171610976706702,20575,14601,35176,+
chr19,49497543,0.7300130870169781,23224,15419,38643,+
chr19,49497544,0.7300130870169781,23224,15419,38643,+
chr19,49497561,1.1609285389455648,14878,8788,23666,+
chr19,49497915,0.9117660938637895,594,496,1090,+
chr19,49497927,1.4335429383358695,85089,56439,141528,+
chr19,49497928,1.3937882832871338,86398,59228,145626,+
chr19,49497933,1.4836363701332902,43758,27672,71430,+
chr19,49497964,1.329691722242578,57931,32828,90759,+
chr19,49497971,1.0784758735703865,138855,88502,227357,+
chr19,49497973,1.1381159807771972,64433,33856,98289,+
chr19,49497984,1.1487365066802702,166645,120234,286879,+
chr19,49497985,1.3056113254457273,144275,99649,243924,+
chr19,49497987,1.2797262116068502,203497,123647,327144,+
chr19,49497988,1.2968286636591109,104029,54547,158576,+
chr19,49499519,1.3359029870323746,12812,7774,20586,+
chr19,49499527,1.5051764610192568,25446,15794,41240,+
chr19,49499528,1.452734343424014,30421,20178,50599,+
chr19,49499611,1.1944298459832066,15744,13069,28813,+
chr19,49499612,1.4477423489137549,9132,8052,17184,+
chr19,49677259,1.091535150645624,633,424,1057,+
chr19,49677261,1.7270427695012334,826,563,1389,+
chr19,49677274,11.091760638630964,1467,1043,2510,+
chr19,49677275,14.942298761017383,947,701,1648,+
chr19,49680506,2.531544092018125,806,452,1258,+
chr19,49680507,2.926533771862325,1046,643,1689,+
chr19,49681973,3.1539362699156515,640,387,1027,+
chr19,49682009,0.5359207805521409,1297,723,2020,+
chr19,49682025,0.5551020408163265,679,349,1028,+
chr19,49682026,3.2263172263172266,1243,665,1908,+
chr19,49682027,3.2263172263172266,1243,665,1908,+
chr19,49682038,0.5725376031052887,1297,686,1983,+
chr19,49682050,1.9636957024029573,882,540,1422,+
chr19,49682053,2.214890016920473,923,590,1513,+
chr19,49682247,1.27737063987064,961,767,1728,+
chr19,49683962,2.5823955911622254,894,664,1558,+
chr19,49683983,2.3704476328118207,656,463,1119,+
chr19,49683985,2.1167470326409497,1086,673,1759,+
chr19,49683986,2.1167470326409497,1086,673,1759,+
chr19,49684036,1.2147066749369133,954,539,1493,+
chr19,49684824,1.0917280917280918,644,554,1198,+
chr19,49684826,1.5396764075833982,1432,1226,2658,+
chr19,49684828,2.587064676616916,662,602,1264,+
chr19,49684829,2.041935483870968,632,433,1065,+
chr19,49684974,2.7922348484848483,640,439,1079,+
chr19,49688171,1.7764670215157294,1157,811,1968,+
chr19,49688322,0.11575885444390772,1115,370,1485,+
chr19,49688323,0.0805508982035928,1120,333,1453,+
chr19,49688324,0.11185843353654916,1236,373,1609,+
chr19,49688325,0.12091168673278646,1334,366,1700,+
chr19,49688327,0.10429328217639414,889,216,1105,+
chr19,49688356,21.48635134043402,1215,122,1337,+
chr19,49688360,18.84433820231427,2157,288,2445,+
chr19,49688361,13.823025931497588,3228,499,3727,+
chr19,49688362,12.876779617087898,3403,538,3941,+
chr19,49688363,6.80974608374033,1469,271,1740,+
chr19,49688367,33.1816,1120,249,1369,+
chr19,49688368,24.779790815350346,2893,1082,3975,+
chr19,49688369,24.72423910354152,3179,1350,4529,+
chr19,49688370,22.872168790106773,3170,1449,4619,+
chr19,49688372,23.309324882358588,1479,1156,2635,+
chr19,49688373,23.805194463243474,2359,3470,5829,+
chr19,49688374,23.805194463243474,2359,3470,5829,+
chr19,49803113,1.6453426124197,682,466,1148,+
chr19,49803115,0.4119481041939053,767,488,1255,+
chr19,49803117,0.9700553429677439,1368,1010,2378,+
chr19,50476643,4.152885007197509,756,247,1003,+
chr19,50477934,4.99181615495331,719,294,1013,+
chr19,50477935,4.094358174769993,820,316,1136,+
chr19,50477950,3.965386783717149,3064,1452,4516,+
chr19,50477951,4.155697497695184,2386,1133,3519,+
chr19,50477956,3.429132876063726,2004,1068,3072,+
chr19,50480956,1.0857142857142856,807,504,1311,+
chr19,50480957,1.0857142857142856,807,504,1311,+
chr19,52143159,2.4585712265600406,553,457,1010,+
chr19,52143171,1.0002799937263,7571,6095,13666,+
chr19,52143172,0.9680539342922643,5421,4344,9765,+
chr19,52143173,1.057483021587351,13842,11893,25735,+
chr19,52143174,1.1862352028430565,3702,3504,7206,+
chr19,52143175,1.2144016991902296,4358,3874,8232,+
chr19,52143177,1.145384500419212,10856,8615,19471,+
chr19,52211459,2.5261160870830075,624,505,1129,+
chr19,52212705,0.3638192793122371,611,496,1107,+
chr19,52212706,0.3638192793122371,611,496,1107,+
chr19,52213065,1.9806192520766088,601,426,1027,+
chr19,52220214,0.47483339934082086,607,462,1069,+
chr19,52221014,1.3034680591335799,605,423,1028,+
chr19,52225748,1.3205582056001364,756,506,1262,+
chr19,54121886,1.6845078524450399,2330,1638,3968,+
chr19,54121887,1.7436775410674963,2014,1386,3400,+
chr19,54128318,2.120491832925129,856,558,1414,+
chr19,54128338,2.120824873344114,3074,2496,5570,+
chr19,54128339,2.1737971403169754,3556,2804,6360,+
chr19,54200856,1.003067236893567,1050,867,1917,+
chr19,54200857,0.9902832619433704,4730,3518,8248,+
chr19,54200858,0.8817595830264418,7795,4939,12734,+
chr19,54200859,1.0481211674074233,9096,6232,15328,+
chr19,54200860,1.0297467543260368,5579,3723,9302,+
chr19,54200865,1.6484395153811446,3407,2274,5681,+
chr19,54200867,1.5013819789939191,1357,870,2227,+
chr19,54201177,1.3936930137869732,4684,3144,7828,+
chr19,54201181,1.3772425812073392,4006,3177,7183,+
chr19,54201182,1.3658956378945284,9453,6981,16434,+
chr19,54201184,1.6120407849567042,4157,3364,7521,+
chr19,54201488,1.3380766594231237,12297,7722,20019,+
chr19,54201489,1.3380766594231237,12297,7722,20019,+
chr19,54201503,0.7942852693864839,4163,3210,7373,+
chr19,54206336,1.4067351042174017,3172,2582,5754,+
chr19,54206355,1.4164309189584925,5764,4351,10115,+
chr19,54206356,1.4164309189584925,5764,4351,10115,+
chr19,54207414,2.0570097190786845,2305,1294,3599,+
chr19,54207417,1.389881948628685,1638,1148,2786,+
chr19,54207429,1.4810399614829082,2901,1674,4575,+
chr19,54207442,1.2891391886605768,4342,3342,7684,+
chr19,54207443,1.2891391886605768,4342,3342,7684,+
chr19,54207515,0.5056104015777674,5998,3305,9303,+
chr19,54207516,0.444913947405074,13900,7005,20905,+
chr19,54207541,3.06991615368287,3126,672,3798,+
chr19,54207542,6.931813592633391,3774,1334,5108,+
chr19,54207547,40.95621971513851,12279,4445,16724,+
chr19,54207548,45.69296752454208,15245,5134,20379,+
chr19,54207570,7.237539517531445,5454,2557,8011,+
chr19,55385931,0.8574504133888273,656,381,1037,+
chr19,55385939,1.2133427182809333,799,506,1305,+
chr19,55386355,2.001343044578749,1335,955,2290,+
chr19,55386357,2.001343044578749,1335,955,2290,+
chr19,55386371,1.1698337926412696,3614,2717,6331,+
chr19,55386372,1.4011276739302938,3481,2817,6298,+
chr19,55386374,1.8524024872809497,992,609,1601,+
chr19,55386399,1.4335780349218201,1114,1025,2139,+
chr19,55386406,1.5406000559214108,3659,2734,6393,+
chr19,55386417,0.6815917995279175,1736,1368,3104,+
chr19,55386421,1.4809162046859672,2801,2306,5107,+
chr19,55386574,0.6519666446745078,3398,3038,6436,+
chr19,55386575,0.6519666446745078,3398,3038,6436,+
chr19,55386578,1.3795301751797675,1932,1718,3650,+
chr19,55386677,1.4014147431124346,1913,1019,2932,+
chr19,55387964,1.56289707750953,860,786,1646,+
chr19,55387965,1.9824154290429044,1038,605,1643,+
chr19,55387970,1.45439393166318,1858,1250,3108,+
chr19,55643314,0.3281779277503817,700,367,1067,+
chr19,55645290,1.1564632648447655,1000,521,1521,+
chr19,55645292,1.1640645791836992,983,569,1552,+
chr19,55654541,3.449942164890341,742,372,1114,+
chr19,55654543,3.449942164890341,742,372,1114,+
chr19,55654551,2.2865370770338376,793,462,1255,+
chr19,55654571,2.2529608201013964,751,456,1207,+
chr19,55654575,1.7397241398799195,839,541,1380,+
chr19,55662599,1.7759900990099011,614,403,1017,+
chr19,55663626,1.0893019527326535,938,644,1582,+
chr19,55663633,2.321956769055745,627,585,1212,+
chr19,55663635,2.321956769055745,627,585,1212,+
chr19,55663713,2.077080935137243,630,443,1073,+
chr19,55668512,1.3119345109866436,608,421,1029,+
chr19,55668514,1.3119345109866436,608,421,1029,+
chr19,55668535,1.618088899495881,784,521,1305,+
chr19,55669118,1.5718968901424677,752,506,1258,+
chr19,55669474,1.165669652114157,775,439,1214,+
chr19,55669521,0.5061170212765957,691,375,1066,+
chr19,55669537,2.4003635734072017,1026,721,1747,+
chr19,55669539,1.6490972710053982,2560,1598,4158,+
chr19,55669540,2.18042071197411,1649,1235,2884,+
chr19,55669542,2.187797637454388,1122,850,1972,+
chr19,55674337,25.797099621228742,1501,481,1982,+
chr19,55674338,29.518068832400957,1327,445,1772,+
chr19,55674339,24.72585587861943,1764,645,2409,+
chr19,55674344,8.8974103621694,620,460,1080,+
chr19,55674345,10.341689308788208,1014,693,1707,+
chr19,55674360,7.747546491546591,1306,1182,2488,+
chr19,55674361,8.471818793558507,2095,2102,4197,+
chr19,55674362,6.162484116899619,957,786,1743,+
chr19,55674363,7.8369943632894,1565,1635,3200,+
chr19,55674381,0.7503926067707073,1138,1120,2258,+
chr19,55674383,0.9545454545454547,749,624,1373,+
chr19,55674404,0.40876598738685715,515,576,1091,+
chr19,55674409,0.2850123186823033,1789,1684,3473,+
chr19,55674410,0.28999014868262063,2437,2107,4544,+
chr19,55674411,0.2819185164545989,1174,1163,2337,+
chr19,58387272,1.6999398862153128,939,674,1613,+
chr19,58387276,0.5464503871168901,870,682,1552,+
chr19,58387278,0.8870769370928803,2246,1513,3759,+
chr19,58387279,1.134694909438937,1365,1171,2536,+
chr19,58387280,0.8103908025878651,3634,2407,6041,+
chr19,58387281,0.7990340972859842,4030,2910,6940,+
chr19,58387282,1.3674626145682585,781,690,1471,+
chr19,58387298,1.6501819104965652,4809,3649,8458,+
chr19,58387299,1.4642729801041148,1520,1136,2656,+
chr19,58387302,1.5543098009978782,1464,1315,2779,+
chr19,58387308,0.5691191415943844,1719,1458,3177,+
chr19,58387314,0.6933607221197006,10831,7777,18608,+
chr19,58387316,0.7194438704725921,4973,3565,8538,+
chr19,58388135,1.3239697674897544,2951,2468,5419,+
chr19,58388137,1.3239697674897544,2951,2468,5419,+
chr19,58388152,1.8066258378743314,3121,2562,5683,+
chr19,58388157,1.301597245694453,8510,5837,14347,+
chr19,58388172,0.7180787992495308,3776,2924,6700,+
chr19,58388174,1.21269127414877,10260,6990,17250,+
chr19,58393005,1.1944846348166451,5146,4074,9220,+
chr19,58393086,1.3491213364190715,4569,3402,7971,+
chr19,58393110,1.285049670096952,10261,7739,18000,+
chr19,58393119,1.3290686127553015,17568,12605,30173,+
chr19,58393120,1.3155939867791988,10800,8721,19521,+
chr19,58394497,1.4836147080921025,2856,1495,4351,+
chr19,58394503,1.3599666784958842,8068,5471,13539,+
chr19,58394539,1.5359362723701442,2956,2290,5246,+
chr19,58394541,0.8309659390815659,3502,2674,6176,+
chr19,58394542,1.3577959057282478,9199,7729,16928,+
chr19,58394544,1.2635541953903329,6047,5232,11279,+
chr19,58394690,1.529890199267995,3134,2458,5592,+
chr19,58394705,1.7861624334732378,3439,2864,6303,+
chr19,58394735,1.358627403261134,4606,2934,7540,+
chr19,58545783,0.5718545020870601,684,389,1073,+
chr19,58545799,2.8965517241379306,734,434,1168,+
chr19,58545802,2.6400928792569656,757,455,1212,+
chr19,58545871,0.5462962962962963,589,431,1020,+
chr19,58547383,1.6549525709462785,1334,911,2245,+
chr19,58547411,0.582342027720179,666,560,1226,+
chr19,58547430,2.034046692607004,696,513,1209,+
chr19,58547621,1.660919540229885,781,551,1332,+
chr19,58547666,1.5987762663936425,3026,2321,5347,+
chr19,58547667,1.5987762663936425,3026,2321,5347,+
chr19,58547668,1.5987762663936425,3026,2321,5347,+
chr19,58547669,0.5050898044022811,1052,646,1698,+
chr19,58547670,1.664955487145353,2062,1413,3475,+
chr19,58547671,1.664955487145353,2062,1413,3475,+
chr19,58547680,2.1132644734107258,1931,1436,3367,+
chr19,58547685,1.0173276321903117,2756,2213,4969,+
chr19,58547799,1.4703864037197372,1815,1259,3074,+
chr19,58547805,1.5735511471497532,4317,3295,7612,+
chr19,58547807,1.5272906371349932,12193,9176,21369,+
chr19,58547808,1.3401208658586594,12433,9808,22241,+
chr19,58547809,1.3401208658586594,12433,9808,22241,+
chr19,58547812,1.6289080817289083,5090,4560,9650,+
chr19,58547814,1.4890022706249024,11305,8766,20071,+
chr19,58547870,0.4729469529219217,654,610,1264,+
chr19,58548049,2.2829509671614936,811,467,1278,+
chr19,58548081,1.736485787615511,1107,937,2044,+
chr19,58548109,1.0608409958528582,1548,1036,2584,+
chr19,58548141,0.408203125,740,511,1251,+
chr19,58548148,1.498464948209874,1908,1373,3281,+
chr19,58548297,1.4517488411293717,974,564,1538,+
chr19,58548320,0.6460610200364297,680,548,1228,+
chr19,58549017,1.121485715062935,937,637,1574,+
chr19,58549212,3.9352930186330655,901,514,1415,+
chr19,58549537,2.452913752913753,618,389,1007,+
chr19,58549543,1.0978447602686239,826,673,1499,+
chr19,58549545,1.8898612301758264,1281,1044,2325,+
chr19,58549562,1.849474321461503,941,822,1763,+
chr19,58549578,1.0570426757188123,1408,984,2392,+
chr19,58550258,2.089187473550571,636,555,1191,+
chr19,58550600,2.6409850665725334,614,535,1149,+
chr20,391346,2.076821580132076,704,423,1127,+
chr20,391451,2.509031198686371,763,405,1168,+
chr20,391452,2.509031198686371,763,405,1168,+
chr20,391537,3.4144245051257442,662,472,1134,+
chr20,396250,1.8390831924104662,633,389,1022,+
chr20,396662,3.3831682322218755,971,724,1695,+
chr20,396937,2.424832795312611,729,522,1251,+
chr20,396961,1.9200066940005016,1042,645,1687,+
chr20,396962,1.9200066940005016,1042,645,1687,+
chr20,397081,0.8747973338137272,606,426,1032,+
chr20,397082,0.8747973338137272,606,426,1032,+
chr20,409941,1.8639979659726882,643,431,1074,+
chr20,410521,2.5430587605054744,630,393,1023,+
chr20,2654211,1.0331417963129037,1725,1192,2917,+
chr20,2654465,0.7809523809523812,737,629,1366,+
chr20,2654467,0.7809523809523812,737,629,1366,+
chr20,2654473,1.0944905301142487,777,600,1377,+
chr20,2654524,1.6409373975745658,645,451,1096,+
chr20,2655457,0.4772282470894407,782,540,1322,+
chr20,2656476,1.082401102464332,762,513,1275,+
chr20,2656477,1.5283931733337757,3037,2103,5140,+
chr20,2656479,1.6983105958860536,2343,1805,4148,+
chr20,2656480,1.7583905059478129,2376,1697,4073,+
chr20,2656512,0.5802459465810292,925,750,1675,+
chr20,2656623,0.5728649498216659,1656,1228,2884,+
chr20,2656797,2.301844354475933,730,493,1223,+
chr20,2657945,1.3679597364009382,687,478,1165,+
chr20,2658163,2.2016129032258065,636,433,1069,+
chr20,2865253,4.063018614039023,670,342,1012,+
chr20,2865298,0.8248883077258363,756,436,1192,+
chr20,2865300,0.8248883077258363,756,436,1192,+
chr20,3046127,2.152778917959642,779,472,1251,+
chr20,3805889,3.9061438691714585,611,501,1112,+
chr20,4023937,0.6027026065016122,693,692,1385,+
chr20,4023938,1.30119122547745,1299,965,2264,+
chr20,4023940,1.5159175458925414,1361,862,2223,+
chr20,4023942,1.4293799013663189,1039,664,1703,+
chr20,4023953,1.5463244889082208,710,483,1193,+
chr20,4023965,0.5026124488868696,589,567,1156,+
chr20,4023978,0.5657342657342658,808,703,1511,+
chr20,4023979,0.6229403295472724,707,531,1238,+
chr20,4024008,0.47561848620146324,3760,2927,6687,+
chr20,4024009,0.7828458374833153,2686,2138,4824,+
chr20,4024088,2.1262945373065087,2015,1285,3300,+
chr20,4024100,3.5076923076923077,911,519,1430,+
chr20,4024103,1.816465169833045,985,578,1563,+
chr20,4024109,1.8280758370310608,1078,669,1747,+
chr20,4024113,1.4187781075733044,3918,2179,6097,+
chr20,4024115,1.292471557253678,8389,5367,13756,+
chr20,4024117,1.5003361596031002,4249,2901,7150,+
chr20,4024118,1.4826536737669085,2982,2092,5074,+
chr20,4024120,0.8030864973598191,2504,1939,4443,+
chr20,4024123,1.5266688661607832,3785,3030,6815,+
chr20,4024124,0.7071282255244452,8865,6121,14986,+
chr20,4024125,1.5266688661607832,3785,3030,6815,+
chr20,4024154,1.4359396404998133,4642,2833,7475,+
chr20,4024157,1.2408631713316138,7750,5481,13231,+
chr20,4024227,2.1777718193638393,645,539,1184,+
chr20,4024281,1.132835539676505,2372,1625,3997,+
chr20,4024282,1.019734136734402,4945,3405,8350,+
chr20,4024283,1.0430139885136331,5272,3729,9001,+
chr20,4024284,1.1883298097251584,1170,1074,2244,+
chr20,4024285,1.5279369725485905,1321,1293,2614,+
chr20,4024287,1.5552837316821673,1649,1330,2979,+
chr20,4699287,3.6466230937017037,770,577,1347,+
chr20,4699590,4.1608263649041195,850,509,1359,+
chr20,4699591,5.127520815536207,819,543,1362,+
chr20,4699612,2.5871840484282074,596,474,1070,+
chr20,4700008,0.6148268398268398,597,439,1036,+
chr20,4700216,2.1976744186046515,797,515,1312,+
chr20,4700222,0.4246233938856889,696,487,1183,+
chr20,4700293,1.9634977938227043,889,553,1442,+
chr20,4700938,0.577186512118019,625,583,1208,+
chr20,4700939,1.7124972054549519,765,496,1261,+
chr20,4700940,2.0865051903114185,602,492,1094,+
chr20,4701429,0.4176035502958579,940,519,1459,+
chr20,6009863,2.2736258052447207,1160,862,2022,+
chr20,6009883,1.6559793624470238,835,602,1437,+
chr20,6015381,2.481858496142666,782,523,1305,+
chr20,6768088,0.9347442680776014,529,524,1053,+
chr20,6768089,0.7714328783559552,989,861,1850,+
chr20,6768092,1.6061072316250444,589,475,1064,+
chr20,6768527,2.258175107261091,740,539,1279,+
chr20,6768537,1.9723749672689186,654,401,1055,+
chr20,6768641,1.4745002859236764,708,395,1103,+
chr20,6768760,1.709968186638388,644,409,1053,+
chr20,6770410,3.431129308979283,738,523,1261,+
chr20,6770413,3.0814780864171767,695,402,1097,+
chr20,6778291,1.9281115879828328,598,465,1063,+
chr20,6778305,0.6536587016855073,1245,868,2113,+
chr20,6778493,1.7738228194689625,1118,676,1794,+
chr20,6778583,2.1695238095238087,803,524,1327,+
chr20,6779137,2.267006802721089,743,503,1246,+
chr20,6779138,2.267006802721089,743,503,1246,+
chr20,6779145,1.2830702078393377,1419,828,2247,+
chr20,6779147,1.1852561440742297,2273,1207,3480,+
chr20,6779148,1.2151350261991134,1555,826,2381,+
chr20,6779149,1.2151350261991134,1555,826,2381,+
chr20,6779155,1.7757412649065005,1616,936,2552,+
chr20,6779157,1.659626832147684,2658,1604,4262,+
chr20,6779158,1.6975562605333596,1733,1047,2780,+
chr20,6779163,2.1367669753086416,626,485,1111,+
chr20,6779264,1.642549341713687,1791,1076,2867,+
chr20,11917951,0.2716379573338372,653,556,1209,+
chr20,11917960,2.672322375397667,629,450,1079,+
chr20,11917961,2.672322375397667,629,450,1079,+
chr20,11918365,1.5677521008403363,596,475,1071,+
chr20,11918542,2.9674744897959178,989,783,1772,+
chr20,11918543,2.9674744897959178,989,783,1772,+
chr20,11919719,1.0302857142857142,600,449,1049,+
chr20,11919721,1.0302857142857142,600,449,1049,+
chr20,11922641,0.6339278420694351,750,564,1314,+
chr20,11923112,1.997132385872892,881,785,1666,+
chr20,11923357,0.6153846153846154,863,571,1434,+
chr20,11923363,1.2065917011199037,1305,1149,2454,+
chr20,11923372,1.7274046133758885,1700,1242,2942,+
chr20,11923374,1.7274046133758885,1700,1242,2942,+
chr20,11923377,1.4610338971168741,1916,1716,3632,+
chr20,11923380,2.192101413944417,1404,878,2282,+
chr20,11923381,0.5873543594812352,1059,1076,2135,+
chr20,11923413,0.7031900138696257,1910,1714,3624,+
chr20,11923414,1.643492957746479,1682,1419,3101,+
chr20,11923417,1.2574349592402272,2781,1704,4485,+
chr20,11923420,1.3457516811915191,2250,1931,4181,+
chr20,11923421,1.3243944294106,3400,2084,5484,+
chr20,11923427,1.5318511352570026,13316,10131,23447,+
chr20,11923428,1.4494177420488135,14842,11330,26172,+
chr20,11923544,1.8165717900063247,717,526,1243,+
chr20,11923644,2.183874007268812,623,436,1059,+
chr20,11923663,1.5946784393270492,809,577,1386,+
chr20,11923672,2.820444915254237,638,471,1109,+
chr20,11923829,1.6878188124872475,1127,753,1880,+
chr20,11924276,1.9659839889070851,2547,1623,4170,+
chr20,11924277,2.2632639814150526,1351,886,2237,+
chr20,11924856,3.6636550308008218,810,486,1296,+
chr20,11924916,1.8804904051172704,568,468,1036,+
chr20,11924969,2.577605321507761,774,450,1224,+
chr20,11925418,1.9304086129907572,1432,1030,2462,+
chr20,11925947,0.5897435897435898,597,506,1103,+
chr20,11926054,2.206654991243433,899,570,1469,+
chr20,11926183,0.4129478315524827,656,515,1171,+
chr20,11926251,3.0294615963855422,784,663,1447,+
chr20,11926407,1.8260869565217392,713,526,1239,+
chr20,11926432,1.961315889164707,1677,1173,2850,+
chr20,16740391,5.476264997391758,723,425,1148,+
chr20,16740393,5.476264997391758,723,425,1148,+
chr20,16740946,3.1989330579934605,640,446,1086,+
chr20,16740958,1.8591224018475752,629,432,1061,+
chr20,16740971,2.4315900403672344,1432,1203,2635,+
chr20,16740972,2.4315900403672344,1432,1203,2635,+
chr20,16740976,1.7406833344564994,819,780,1599,+
chr20,16741021,1.8958333333333333,1070,764,1834,+
chr20,16741029,0.6399626251751945,1601,1622,3223,+
chr20,17600811,0.5878991596638655,582,424,1006,+
chr20,17600814,0.5856373958563741,610,410,1020,+
chr20,17600815,0.6,644,424,1068,+
chr20,17600826,2.3464824307258003,928,640,1568,+
chr20,17600827,0.6870165260196905,1077,710,1787,+
chr20,17600900,1.6401433691756273,1039,774,1813,+
chr20,17600962,0.6327584526941441,1145,932,2077,+
chr20,17601009,2.4145151199165795,1071,958,2029,+
chr20,17604578,0.6352601156069363,1255,864,2119,+
chr20,17604592,1.457332700522069,1180,734,1914,+
chr20,17607058,1.5478621699686752,1311,1045,2356,+
chr20,17607076,1.5171808136935556,1233,920,2153,+
chr20,17607639,2.4118421052631582,610,455,1065,+
chr20,17607665,5.4423480083857445,648,476,1124,+
chr20,17607666,4.083742690058479,601,474,1075,+
chr20,17607683,2.0176999438097023,694,561,1255,+
chr20,17607799,2.1508422249905217,650,498,1148,+
chr20,17607800,1.0498000727008359,1291,916,2207,+
chr20,17607801,1.0498000727008359,1291,916,2207,+
chr20,17608043,2.0727949720040586,656,501,1157,+
chr20,18504698,1.0885815148431517,1732,2040,3772,+
chr20,18504699,0.8852257456622792,4369,3952,8321,+
chr20,18560755,3.1743707093821505,577,436,1013,+
chr20,18560756,3.010677466863034,883,678,1561,+
chr20,18560758,3.3237687366167026,596,466,1062,+
chr20,18567541,1.5780696127378855,809,510,1319,+
chr20,18567568,2.2927930761708954,702,456,1158,+
chr20,18569240,3.2563443448197353,620,409,1029,+
chr20,20026857,1.702929771022881,1021,814,1835,+
chr20,20026858,2.551422319474836,582,456,1038,+
chr20,20026894,2.08100017608734,932,630,1562,+
chr20,20026895,2.08100017608734,932,630,1562,+
chr20,21115066,1.0310385994246754,1182,714,1896,+
chr20,21115067,1.306869026849713,2300,1569,3869,+
chr20,21115068,1.6262776877363587,817,616,1433,+
chr20,21115080,2.461783439490446,772,627,1399,+
chr20,21115081,2.3181964189483266,1410,1133,2543,+
chr20,21115088,1.38259705985941,3123,2124,5247,+
chr20,21115090,1.3212414929645433,3236,2166,5402,+
chr20,21115095,1.878787878787879,898,869,1767,+
chr20,21115098,2.280065973335777,938,948,1886,+
chr20,21162088,2.42153672440542,724,459,1183,+
chr20,21162092,2.7676118357446464,785,518,1303,+
chr20,21162100,4.159550561797753,616,444,1060,+
chr20,21162131,1.6475787433852962,2002,1415,3417,+
chr20,21162156,1.1709467587341658,1746,1217,2963,+
chr20,21162167,1.8280741156653568,891,684,1575,+
chr20,21162179,1.6016974276240556,2797,1984,4781,+
chr20,21326536,1.2947920866857752,992,723,1715,+
chr20,21326546,2.4690638810767376,722,523,1245,+
chr20,21326553,2.6817092651757197,789,625,1414,+
chr20,21389293,3.6402412119429326,549,522,1071,+
chr20,21389666,1.6698179000387448,652,444,1096,+
chr20,31544955,0.861193331894979,1683,948,2631,+
chr20,31544959,2.274348719057399,1577,956,2533,+
chr20,31544960,2.274348719057399,1577,956,2533,+
chr20,31544963,1.6760356789904503,1540,971,2511,+
chr20,31544981,0.3741598527334217,873,496,1369,+
chr20,31544982,1.426998698603637,1398,971,2369,+
chr20,31544990,1.460486149951156,4281,2588,6869,+
chr20,31561707,1.7742008614826568,601,400,1001,+
chr20,31569211,2.224180411483712,1143,916,2059,+
chr20,31757419,2.368286131962598,774,524,1298,+
chr20,31757487,0.3581329561527581,632,403,1035,+
chr20,31766657,2.259561128526646,847,659,1506,+
chr20,31766658,1.995891432270529,1530,1032,2562,+
chr20,31770384,2.117887573981683,1086,730,1816,+
chr20,31775914,2.017641162583301,870,668,1538,+
chr20,31777612,2.8079470198675494,741,452,1193,+
chr20,31778882,1.16507380437953,990,841,1831,+
chr20,31782343,2.049619726543035,979,724,1703,+
chr20,31782345,2.9566160520607383,657,460,1117,+
chr20,31783851,0.3054310169146118,1089,700,1789,+
chr20,31783879,1.7737574552683897,1486,1005,2491,+
chr20,31783910,1.6293352601156068,1434,864,2298,+
chr20,31792773,1.7445541854999744,5837,4087,9924,+
chr20,31792774,1.937613579244481,4008,2885,6893,+
chr20,31792778,1.7636604774535811,2195,1739,3934,+
chr20,31792783,2.3197081982399257,2391,2031,4422,+
chr20,31793869,1.1737792974123653,778,588,1366,+
chr20,31797502,1.6183385579937304,825,527,1352,+
chr20,31798388,2.457802547770701,685,470,1155,+
chr20,31798457,4.4983204134366925,940,644,1584,+
chr20,31798460,2.155116810563738,1950,1431,3381,+
chr20,31798461,2.155116810563738,1950,1431,3381,+
chr20,31801125,2.2781272762311655,682,491,1173,+
chr20,31801132,1.8438727455122055,1446,1140,2586,+
chr20,31801408,2.397754933816204,1172,780,1952,+
chr20,31801534,0.5648567119155354,641,441,1082,+
chr20,32165602,16.733447937972507,661,1256,1917,+
chr20,32165608,0.5321709185835869,771,1203,1974,+
chr20,32165616,0.3038939580770786,388,725,1113,+
chr20,32165633,0.2661126982379856,603,1063,1666,+
chr20,32236518,1.0654833288346373,778,462,1240,+
chr20,32236621,1.90918648968327,1392,1086,2478,+
chr20,32236622,1.7803196385381121,3432,2439,5871,+
chr20,32819952,1.3981486725378105,1004,939,1943,+
chr20,32819953,2.20249482941561,1122,1048,2170,+
chr20,32819975,0.3557996648668777,545,523,1068,+
chr20,32819976,0.3283089103980257,801,832,1633,+
chr20,32836634,1.6970054000981838,595,484,1079,+
chr20,32848744,3.2135403038328048,868,649,1517,+
chr20,32848788,2.440261437908497,717,424,1141,+
chr20,32849326,2.943782434318366,979,807,1786,+
chr20,32849510,3.5882055518006304,1069,792,1861,+
chr20,32849511,3.5708154506437766,639,465,1104,+
chr20,32850151,2.129370629370629,629,389,1018,+
chr20,33629749,2.3220957821657544,996,561,1557,+
chr20,33629750,2.3696145124716548,659,391,1050,+
chr20,33854162,5.2017943359104715,642,565,1207,+
chr20,34031524,1.423402489626556,535,481,1016,+
chr20,34072103,0.3182542694497154,598,424,1022,+
chr20,34072107,1.593535300660865,737,492,1229,+
chr20,34072111,2.245717806531115,535,540,1075,+
chr20,34072198,1.7503092783505154,652,484,1136,+
chr20,34072255,2.0207100591715976,682,337,1019,+
chr20,34072295,0.9892163009404388,1126,637,1763,+
chr20,34072297,0.9892163009404388,1126,637,1763,+
chr20,34073823,1.6358108726448481,708,432,1140,+
chr20,34073831,2.8075313807531384,670,477,1147,+
chr20,34073832,2.8075313807531384,670,477,1147,+
chr20,34075941,2.4222556153116104,746,435,1181,+
chr20,34075943,2.2751818238637913,1229,684,1913,+
chr20,34075972,0.6705328017397607,924,444,1368,+
chr20,34075993,1.5656518161514046,1401,723,2124,+
chr20,34075995,1.590499590499591,970,702,1672,+
chr20,34076030,1.2918105146968926,2288,1280,3568,+
chr20,34076703,2.0220064724919093,709,514,1223,+
chr20,34076748,1.4754738878143134,886,549,1435,+
chr20,34077146,0.23819275008713836,496,603,1099,+
chr20,34077147,0.23819275008713836,496,603,1099,+
chr20,34077148,0.23819275008713836,496,603,1099,+
chr20,34077180,2.2816326530612243,558,524,1082,+
chr20,34077182,2.2816326530612243,558,524,1082,+
chr20,34080006,2.916796590105084,808,447,1255,+
chr20,34080008,3.1524330831573124,967,610,1577,+
chr20,34080087,2.3398396050287285,859,745,1604,+
chr20,34080136,1.0404511593454402,1297,1099,2396,+
chr20,34080137,0.6109805931058808,1203,939,2142,+
chr20,34080147,2.7276243230805117,976,894,1870,+
chr20,34080157,1.892101473357705,609,530,1139,+
chr20,34080158,2.4346897755140073,916,702,1618,+
chr20,34080200,2.6697794117647056,740,799,1539,+
chr20,34200646,0.4604045007833642,430,825,1255,+
chr20,34200658,1.5420087153339757,934,1749,2683,+
chr20,34516411,2.311310247063588,1285,822,2107,+
chr20,34516412,2.311310247063588,1285,822,2107,+
chr20,34516413,2.006408355440803,2376,1382,3758,+
chr20,34516418,0.5906862745098039,722,373,1095,+
chr20,34516421,1.1076098697817351,3325,2228,5553,+
chr20,34526287,2.3957382039573822,786,437,1223,+
chr20,34526319,3.4462006960556844,678,430,1108,+
chr20,34534722,2.3152821939586645,862,628,1490,+
chr20,34534723,2.2480144968586684,2028,1452,3480,+
chr20,34534756,1.586590038314176,605,539,1144,+
chr20,34534757,0.5146778497903164,824,670,1494,+
chr20,34540608,1.7839386602098466,712,589,1301,+
chr20,34540705,1.7916106151400268,585,480,1065,+
chr20,34882862,8.898807412360446,611,435,1046,+
chr20,35176993,4.114002590185141,592,425,1017,+
chr20,35542078,0.9360882405666653,1115,899,2014,+
chr20,35542079,1.235738532248656,808,754,1562,+
chr20,35542080,1.374793993774034,508,507,1015,+
chr20,35542121,1.7206749672346004,777,435,1212,+
chr20,35542132,1.095745508283425,1173,896,2069,+
chr20,35542134,1.3187196768705176,1709,1319,3028,+
chr20,35542324,2.486290101453249,584,520,1104,+
chr20,35542328,1.627586206896552,943,579,1522,+
chr20,35542343,2.125624927334031,1544,1097,2641,+
chr20,35542344,2.125624927334031,1544,1097,2641,+
chr20,35542376,1.5552503052503053,1018,839,1857,+
chr20,35542825,1.399150514786561,4895,3068,7963,+
chr20,35542826,1.3798930004458316,3800,2242,6042,+
chr20,35547420,1.9876961829102888,976,793,1769,+
chr20,35548515,2.211102831594635,1098,670,1768,+
chr20,35548567,1.4520901023783137,1959,1478,3437,+
chr20,35548581,1.7315024775342234,1555,881,2436,+
chr20,35548615,1.8329081632653064,957,734,1691,+
chr20,35548629,1.5530874785591766,1392,879,2271,+
chr20,35548813,2.736242884250474,823,619,1442,+
chr20,35555048,1.6162908119150734,2037,1435,3472,+
chr20,35556035,0.6272285251215559,773,616,1389,+
chr20,35556047,0.6070327734792729,771,756,1527,+
chr20,35556048,1.5936298240057911,951,712,1663,+
chr20,35556981,1.6868209876543212,1270,809,2079,+
chr20,35556983,1.3101961320322153,2626,2110,4736,+
chr20,35556984,1.7105055292259082,1707,1265,2972,+
chr20,35556988,1.5571190802435095,2360,1631,3991,+
chr20,35557195,1.7659785629217946,573,457,1030,+
chr20,35557431,2.2019685039370085,798,507,1305,+
chr20,35557437,2.0647694646174632,997,763,1760,+
chr20,35557438,2.0808531746031744,838,575,1413,+
chr20,35557451,1.5251148369497687,2441,1760,4201,+
chr20,35557454,1.8999589995899957,992,812,1804,+
chr20,35699658,1.7301444043321301,638,553,1191,+
chr20,35699688,1.394816200328282,2609,1540,4149,+
chr20,35699690,1.2130796402191744,3513,2233,5746,+
chr20,35700836,1.255613493313606,1567,1318,2885,+
chr20,35700840,1.8835434353828997,645,506,1151,+
chr20,35700843,1.6814014225383416,828,817,1645,+
chr20,36240311,3.2190626945108725,676,479,1155,+
chr20,36544981,2.7232791705477855,654,472,1126,+
chr20,36605808,0.5896866603325829,1668,957,2625,+
chr20,36605952,3.3847630099467994,616,445,1061,+
chr20,36606009,0.9464990646063859,1454,1010,2464,+
chr20,36606010,1.238881829733164,749,786,1535,+
chr20,36606011,0.5720498426994015,1090,753,1843,+
chr20,36606012,1.3968510294622083,1522,1220,2742,+
chr20,36606029,0.4528935185185185,558,539,1097,+
chr20,36607717,1.8764302059496567,573,482,1055,+
chr20,36607718,0.5798548621190129,907,649,1556,+
chr20,36607724,1.7359862800520849,1162,850,2012,+
chr20,36609608,1.6981889676561803,1114,975,2089,+
chr20,36609653,1.453821629747097,1353,1186,2539,+
chr20,36609666,0.6851104167398097,1773,1251,3024,+
chr20,36612145,2.037735849056604,935,741,1676,+
chr20,36612227,1.415950744558992,1797,1163,2960,+
chr20,36612231,1.328286633702221,2038,1369,3407,+
chr20,37179113,1.7856074425471162,680,343,1023,+
chr20,37179123,6.712871640509859,1078,620,1698,+
chr20,37179229,1.6665020794021796,923,724,1647,+
chr20,37179287,2.3877960885117053,701,459,1160,+
chr20,37179343,2.62945231126966,841,498,1339,+
chr20,37179351,1.7364330130016958,1116,853,1969,+
chr20,37179353,1.7364330130016958,1116,853,1969,+
chr20,37179354,1.4711538461538465,764,419,1183,+
chr20,37179356,1.9101046255506609,554,453,1007,+
chr20,37184180,2.0229535592546495,1246,1044,2290,+
chr20,37184181,2.9149659863945576,856,489,1345,+
chr20,37184184,2.2937729338956134,973,588,1561,+
chr20,37184209,1.6990595611285266,812,626,1438,+
chr20,37184213,1.527458227597883,2433,1689,4122,+
chr20,37184273,0.7150655981386632,4018,3236,7254,+
chr20,37184274,1.5332875874517058,2506,1558,4064,+
chr20,37198425,1.4435815868263469,2779,1669,4448,+
chr20,37199053,0.7487134658883259,1918,1606,3524,+
chr20,37199055,1.5804038397881497,1491,1139,2630,+
chr20,37199060,1.3841612578454685,2737,1754,4491,+
chr20,37199122,1.1885790386587836,3031,2298,5329,+
chr20,37199141,1.310936238902341,1751,1415,3166,+
chr20,37199170,1.896608122389412,1674,1281,2955,+
chr20,37204788,1.8304367201426024,1084,923,2007,+
chr20,37204815,1.1174705564122276,4578,3662,8240,+
chr20,37204816,1.5410318963951106,2456,2180,4636,+
chr20,37204826,1.7138729899155085,1366,1222,2588,+
chr20,37204838,1.3994294364229158,2477,1807,4284,+
chr20,37207372,1.5343588133950017,3931,2550,6481,+
chr20,37207384,1.9423695678735797,1513,1141,2654,+
chr20,37210050,1.6606642317166396,1861,1157,3018,+
chr20,37210060,2.2897281517971173,1254,944,2198,+
chr20,37213761,2.4003489565130796,2936,2247,5183,+
chr20,37213845,1.3390599675850892,2915,1850,4765,+
chr20,37225692,2.0822797927461143,1181,964,2145,+
chr20,37225719,1.8514984344714485,1773,1411,3184,+
chr20,37225737,1.4564005823479844,5477,3937,9414,+
chr20,37225739,1.5183812484979573,2908,2335,5243,+
chr20,37228551,1.476243890713885,2679,1782,4461,+
chr20,37228612,1.6185540166204986,2950,1899,4849,+
chr20,37228627,1.406792980562013,4230,2828,7058,+
chr20,37228697,1.3012726665275731,6706,4946,11652,+
chr20,37232339,1.0000334106161912,4637,3819,8456,+
chr20,37232340,0.9426701019570879,6372,5211,11583,+
chr20,37232344,1.1095971215354101,3294,2265,5559,+
chr20,37232356,1.617691557156432,5663,4119,9782,+
chr20,37234046,0.693684533741194,2370,1855,4225,+
chr20,37234047,2.11371237458194,1421,1103,2524,+
chr20,37241321,1.5439793691727834,2161,1774,3935,+
chr20,37241367,1.267644726407613,3196,2618,5814,+
chr20,37316452,23.543447894230507,902,475,1377,+
chr20,37316453,20.75839948769486,1168,629,1797,+
chr20,37316456,6.240473459615068,703,511,1214,+
chr20,37316459,16.273840937795658,1289,1408,2697,+
chr20,37316460,14.310440179464276,1566,1666,3232,+
chr20,37316461,14.310440179464276,1566,1666,3232,+
chr20,37316475,4.839934882186629,457,666,1123,+
chr20,37732979,2.175142585551331,677,525,1202,+
chr20,37732981,1.708876540669957,931,700,1631,+
chr20,37803005,2.826927650306253,658,506,1164,+
chr20,37840181,0.9434776250365604,560,525,1085,+
chr20,37840182,0.9434776250365604,560,525,1085,+
chr20,38091010,4.0578209539705785,1433,1548,2981,+
chr20,38091011,4.280760354873797,1604,1926,3530,+
chr20,38091012,4.280760354873797,1604,1926,3530,+
chr20,38535179,2.5763888888888884,741,557,1298,+
chr20,38535180,2.0496746057931112,1170,867,2037,+
chr20,38535181,2.2979204339963832,781,631,1412,+
chr20,38535182,2.2171816787201406,603,506,1109,+
chr20,38952472,0.3372305599251733,660,546,1206,+
chr20,38952473,0.3372305599251733,660,546,1206,+
chr20,38952554,6.063684016133704,535,475,1010,+
chr20,38972584,1.8012733164240486,1763,1327,3090,+
chr20,38972585,1.671185372005044,1022,792,1814,+
chr20,41029010,2.8486956521739133,909,499,1408,+
chr20,41029011,2.8486956521739133,909,499,1408,+
chr20,41029012,2.8486956521739133,909,499,1408,+
chr20,41029065,2.085739913760569,1586,924,2510,+
chr20,41029067,2.054693357324936,928,512,1440,+
chr20,41029070,2.253156693744804,1578,1037,2615,+
chr20,41029076,0.6034221129192612,960,658,1618,+
chr20,41029078,2.040209374256483,734,466,1200,+
chr20,41029083,1.9968640627592074,2171,1470,3641,+
chr20,41029085,1.7013157802796885,4177,2974,7151,+
chr20,41029086,1.5989942296182815,2399,1782,4181,+
chr20,41029427,0.9551045010694863,576,511,1087,+
chr20,41029432,1.683505005152744,4833,4043,8876,+
chr20,41029433,1.683505005152744,4833,4043,8876,+
chr20,41029434,1.683505005152744,4833,4043,8876,+
chr20,41061447,0.8706079196876744,668,488,1156,+
chr20,41061449,0.8706079196876744,668,488,1156,+
chr20,41092531,2.174314380797847,623,419,1042,+
chr20,41092534,1.335104265868094,697,475,1172,+
chr20,41097222,2.177223492331064,785,468,1253,+
chr20,41114005,1.3273189716312057,714,586,1300,+
chr20,41114125,1.3897721249675847,744,488,1232,+
chr20,41114128,0.9965888202657658,918,733,1651,+
chr20,41116282,1.4910223000449396,655,461,1116,+
chr20,41123289,0.9575041553372133,825,638,1463,+
chr20,41123720,3.1741982227945384,878,551,1429,+
chr20,41124024,4.5087925985638355,1222,521,1743,+
chr20,41124030,22.60115445406472,3094,1739,4833,+
chr20,41124031,22.870948030556875,3497,2257,5754,+
chr20,41124032,22.870948030556875,3497,2257,5754,+
chr20,43460054,1.3797786720321932,843,496,1339,+
chr20,43460055,1.3797786720321932,843,496,1339,+
chr20,43460209,2.1337332833395823,775,380,1155,+
chr20,43460521,2.8611198987662134,1291,653,1944,+
chr20,43460522,1.2222470127423275,1048,485,1533,+
chr20,43460524,1.0853695896074036,3205,1598,4803,+
chr20,43460525,1.125164392569456,1164,552,1716,+
chr20,43460527,1.6524791997306785,1717,955,2672,+
chr20,43460538,0.9157298786056646,953,536,1489,+
chr20,43460539,2.151617652016587,1933,1218,3151,+
chr20,43460542,2.048120828942747,2022,1325,3347,+
chr20,43460554,1.4977562876126207,2391,1690,4081,+
chr20,43460563,1.7772245361605452,1078,555,1633,+
chr20,43460566,1.5787523453779662,2801,1452,4253,+
chr20,43460574,0.7191623618883627,7986,5519,13505,+
chr20,43460575,0.909939563634386,11362,7361,18723,+
chr20,43460757,1.5412663217541265,1087,450,1537,+
chr20,43460766,1.7556270096463025,2651,1243,3894,+
chr20,43460768,1.7556270096463025,2651,1243,3894,+
chr20,43460775,1.6581225598370395,1583,821,2404,+
chr20,43460813,2.040650406504065,752,368,1120,+
chr20,43460823,1.4225801431683782,777,475,1252,+
chr20,43460835,1.7650289899298135,963,677,1640,+
chr20,43460838,1.5852011494252871,648,479,1127,+
chr20,43460850,1.9342810300703777,1758,1041,2799,+
chr20,43460868,1.4356461225544035,9699,6280,15979,+
chr20,43460975,3.3657603177385145,799,438,1237,+
chr20,43460981,1.9924528301886795,823,514,1337,+
chr20,43460983,1.426861081890123,1406,810,2216,+
chr20,43460984,0.6996065025718207,1578,935,2513,+
chr20,43460986,2.430502227000461,1054,765,1819,+
chr20,43460988,2.430502227000461,1054,765,1819,+
chr20,43461058,2.729631813969163,610,469,1079,+
chr20,43461228,1.678137003841229,698,567,1265,+
chr20,43461437,1.7963368651274276,845,565,1410,+
chr20,43705301,2.1386861313868613,585,547,1132,+
chr20,43705308,0.49504506100657897,1351,1226,2577,+
chr20,43705310,0.49504506100657897,1351,1226,2577,+
chr20,43705316,1.8916480950864905,774,697,1471,+
chr20,43705324,2.3413106796116505,1397,1029,2426,+
chr20,43705326,2.392284373342162,2827,2037,4864,+
chr20,43705327,2.741173648717215,2200,1776,3976,+
chr20,43705329,2.281884160194318,3056,2412,5468,+
chr20,43705331,2.0837765957446805,1566,1343,2909,+
chr20,43716145,11.662938105891126,781,446,1227,+
chr20,43716146,11.662938105891126,781,446,1227,+
chr20,43716147,11.662938105891126,781,446,1227,+
chr20,43716152,1.244752739519297,581,452,1033,+
chr20,44715369,0.6883217250021884,1969,1286,3255,+
chr20,44715381,1.1382470791765793,602,458,1060,+
chr20,44715405,0.8806319408989786,1548,1074,2622,+
chr20,44715406,1.0692587782955212,856,688,1544,+
chr20,44715423,2.0830092125396398,1803,1206,3009,+
chr20,44719923,1.790979650555077,996,671,1667,+
chr20,44724842,3.107426004228331,870,472,1342,+
chr20,44724844,3.107426004228331,870,472,1342,+
chr20,44727206,3.327972937809003,610,497,1107,+
chr20,44727416,2.018609487232093,1381,989,2370,+
chr20,44727424,1.840097853886356,590,528,1118,+
chr20,44727450,0.5253231532649006,2772,2021,4793,+
chr20,44727452,0.5305065985525755,1683,1349,3032,+
chr20,44727453,0.6814610652535269,1653,1192,2845,+
chr20,44727477,1.915893108298172,972,789,1761,+
chr20,44727524,1.6710997442455244,725,574,1299,+
chr20,44727596,0.638477088948787,1136,741,1877,+
chr20,44727667,1.628682780320366,1110,735,1845,+
chr20,44727755,1.2241258507368178,1060,927,1987,+
chr20,44746163,2.367244136519419,920,647,1567,+
chr20,44750866,2.309865434866246,622,423,1045,+
chr20,44750915,2.607730622641085,603,477,1080,+
chr20,44901659,2.296616270698344,637,462,1099,+
chr20,44901672,2.0505902192242838,1055,592,1647,+
chr20,44901717,1.4519312823165422,4631,3642,8273,+
chr20,44901719,1.669788664745437,2453,2081,4534,+
chr20,44901726,1.6728974529351421,3171,2539,5710,+
chr20,44904012,1.7404761904761905,730,419,1149,+
chr20,44905023,1.7594654788418709,631,448,1079,+
chr20,44907369,0.3821801876540863,814,587,1401,+
chr20,44907370,0.3821801876540863,814,587,1401,+
chr20,44907723,1.7203501506024095,1118,663,1781,+
chr20,44907871,4.2877756319156095,680,560,1240,+
chr20,44907872,3.922100320798546,749,554,1303,+
chr20,45416141,0.8803641158686547,827,672,1499,+
chr20,45416143,0.8160191789892045,1347,1032,2379,+
chr20,45416598,2.743529411764706,582,424,1006,+
chr20,45416652,3.444924530978311,980,591,1571,+
chr20,45418857,1.8807859583721651,793,695,1488,+
chr20,45418858,1.8807859583721651,793,695,1488,+
chr20,45418898,2.448620942152795,527,481,1008,+
chr20,45418958,1.8130257149723623,655,437,1092,+
chr20,45419350,1.7285714285714284,1088,783,1871,+
chr20,45419351,1.7285714285714284,1088,783,1871,+
chr20,45420135,2.3344671664323284,1682,1092,2774,+
chr20,45420137,1.9189457209934435,2072,1422,3494,+
chr20,45420144,1.0504115226337447,1020,593,1613,+
chr20,45420146,1.0504115226337447,1020,593,1613,+
chr20,45420618,3.943995381062356,593,432,1025,+
chr20,45421412,3.2803983042078775,731,476,1207,+
chr20,45421438,2.7226890756302518,623,475,1098,+
chr20,45421439,2.6023293080439003,1002,687,1689,+
chr20,45421451,2.8622191247957485,615,451,1066,+
chr20,45421462,2.8425799086757992,672,583,1255,+
chr20,45421463,2.8425799086757992,672,583,1255,+
chr20,45424315,2.4599589322381936,598,486,1084,+
chr20,45425655,2.2890299852975384,752,630,1382,+
chr20,45425715,2.770382599344144,1087,844,1931,+
chr20,45425716,2.914662084765178,726,581,1307,+
chr20,45425791,2.3324985574386425,958,707,1665,+
chr20,45425792,2.356093900739629,627,490,1117,+
chr20,45425921,1.5815766359244618,669,505,1174,+
chr20,45425942,1.7416201117318435,644,536,1180,+
chr20,45425969,1.7407407407407407,657,377,1034,+
chr20,45426010,0.5131105028093935,837,630,1467,+
chr20,45426033,1.9332107843137252,630,543,1173,+
chr20,45426052,0.4185507246376812,721,574,1295,+
chr20,45426064,2.3387216372534483,829,612,1441,+
chr20,45426067,1.7228001905972046,1008,786,1794,+
chr20,45426070,0.6676767011395823,1085,798,1883,+
chr20,45426074,0.6484843367390021,1199,910,2109,+
chr20,45812645,2.004519766232473,973,554,1527,+
chr20,45812647,2.126698779543775,807,497,1304,+
chr20,45813444,2.2832335743611485,640,411,1051,+
chr20,45814396,0.28032770703780474,567,613,1180,+
chr20,45814397,0.28032770703780474,567,613,1180,+
chr20,45815658,1.7802105126583303,1545,1208,2753,+
chr20,45815660,1.7802105126583303,1545,1208,2753,+
chr20,45815701,1.6656775469831846,841,673,1514,+
chr20,45816709,0.5312359550561798,590,444,1034,+
chr20,45816859,1.4803400637619557,1392,940,2332,+
chr20,45891965,0.72377296545594,592,416,1008,+
chr20,45892827,1.2134103552895994,643,408,1051,+
chr20,45893258,0.7721995358266771,610,491,1101,+
chr20,45897758,3.5894329896907218,732,484,1216,+
chr20,45897760,3.2822773146543884,1529,1041,2570,+
chr20,45897762,2.9713171818434976,775,531,1306,+
chr20,45898640,0.6593546151693668,923,775,1698,+
chr20,49013583,1.9731164951875204,614,392,1006,+
chr20,49013612,3.3338419416135467,692,364,1056,+
chr20,49013661,0.5731093250702043,622,448,1070,+
chr20,49013663,0.2861685214626391,674,369,1043,+
chr20,49013664,0.32383490976699825,1386,841,2227,+
chr20,49013674,1.5844837758112096,2509,1355,3864,+
chr20,49013675,1.769949776246423,3221,1907,5128,+
chr20,49013679,1.623003194888179,761,625,1386,+
chr20,49046319,0.8338645250174648,1172,424,1596,+
chr20,49046332,2.842020061032616,2057,853,2910,+
chr20,49046333,2.864392501636741,2893,1288,4181,+
chr20,49046356,4.681568431568432,814,363,1177,+
chr20,49046372,2.7629716981132075,780,423,1203,+
chr20,49046404,2.0654088050314465,820,529,1349,+
chr20,49046410,0.9002670094936709,1427,1023,2450,+
chr20,49046411,0.9002670094936709,1427,1023,2450,+
chr20,49066195,2.310077519379845,744,644,1388,+
chr20,49066196,1.6807794756764336,1261,1018,2279,+
chr20,49066469,0.581416575392479,1637,1187,2824,+
chr20,49068720,0.6097402597402597,938,769,1707,+
chr20,49068732,1.7505944293478262,588,511,1099,+
chr20,49070209,1.6675517790759427,784,537,1321,+
chr20,49072318,1.664216065624516,1563,993,2556,+
chr20,49072409,1.882548148148148,835,624,1459,+
chr20,49072629,1.0730210067395705,2063,1515,3578,+
chr20,49075398,1.5574408468244083,1333,875,2208,+
chr20,49077005,2.1621621621621623,1199,749,1948,+
chr20,49077007,1.6428460583488516,682,536,1218,+
chr20,49084032,2.5285294572444723,1167,891,2058,+
chr20,49084033,2.5285294572444723,1167,891,2058,+
chr20,49084042,2.1385732323232327,1354,791,2145,+
chr20,49084149,2.161989795918368,564,447,1011,+
chr20,49085294,0.4248878923766816,757,668,1425,+
chr20,49088044,1.660176730995384,2221,1656,3877,+
chr20,49089587,2.080082665977784,731,552,1283,+
chr20,49089589,2.015855095228745,1520,925,2445,+
chr20,49089676,2.2504494275711986,1064,812,1876,+
chr20,49089716,2.03921568627451,791,560,1351,+
chr20,49096373,1.6401042469066833,1278,1028,2306,+
chr20,49096398,1.5613002626793293,950,807,1757,+
chr20,49221504,3.6782496939115625,747,557,1304,+
chr20,49223323,2.418648310387985,772,469,1241,+
chr20,49223352,2.2605965463108317,1023,783,1806,+
chr20,49223361,2.087909578719032,761,460,1221,+
chr20,49223371,1.5942028985507248,1066,581,1647,+
chr20,49223373,1.5988310961204957,1773,1092,2865,+
chr20,49223374,1.5988310961204957,1773,1092,2865,+
chr20,49223402,2.057886846394422,3023,1869,4892,+
chr20,49223412,3.057602261683894,1305,1028,2333,+
chr20,49233318,1.423054655678048,672,470,1142,+
chr20,49233627,2.83070544332671,598,459,1057,+
chr20,49236362,0.6270947832997652,1087,686,1773,+
chr20,49236363,1.4404576635942903,786,572,1358,+
chr20,49236364,1.7011417675840947,833,576,1409,+
chr20,49239238,1.6933090704274174,662,453,1115,+
chr20,49243867,0.34816374823222396,1152,736,1888,+
chr20,49243868,0.39497075452128855,2331,1360,3691,+
chr20,49243870,0.506993006993007,849,441,1290,+
chr20,49278641,1.0133279778556414,909,916,1825,+
chr20,49278642,0.9682932379532623,832,1054,1886,+
chr20,49278644,0.9621632320592433,1010,958,1968,+
chr20,49278645,0.44680851063829785,467,563,1030,+
chr20,49278654,0.4672205510194337,514,536,1050,+
chr20,49278663,2.0593548387096776,835,681,1516,+
chr20,49278668,1.5109966316623735,1106,720,1826,+
chr20,49278673,1.1649255016605302,2419,1861,4280,+
chr20,49278679,1.405828588552592,1250,1127,2377,+
chr20,49278944,0.9599238264006188,7831,6575,14406,+
chr20,49278945,0.9793794249230445,33258,24277,57535,+
chr20,49279131,1.3530369555208694,3346,2070,5416,+
chr20,49279186,1.2889574608772316,4606,3522,8128,+
chr20,49280324,0.9302176259529937,2551,1977,4528,+
chr20,49280687,0.985880232104566,1043,993,2036,+
chr20,49280688,0.9772463128037827,3895,3027,6922,+
chr20,49280930,1.4696322123495669,1685,1045,2730,+
chr20,49280936,0.7474795268425841,1866,1255,3121,+
chr20,49289079,1.2566114223503473,15980,10601,26581,+
chr20,49289080,1.2566114223503473,15980,10601,26581,+
chr20,49289165,1.352968555783099,7508,5438,12946,+
chr20,49289166,0.7825409514084077,10811,8287,19098,+
chr20,49936475,2.5494861363061445,732,447,1179,+
chr20,49941598,2.0674097664543525,854,470,1324,+
chr20,49941599,0.48428207306711973,759,320,1079,+
chr20,49941617,1.6929312331924704,1190,684,1874,+
chr20,49941632,1.4693654266958422,1421,913,2334,+
chr20,49949314,2.2155498529964754,828,606,1434,+
chr20,49952080,1.563726198738851,756,567,1323,+
chr20,49952874,6.3974427578141295,1408,674,2082,+
chr20,49952880,2.0658016682113067,742,331,1073,+
chr20,49952881,2.0658016682113067,742,331,1073,+
chr20,49952895,82.75373972780636,2451,2307,4758,+
chr20,49952896,82.75373972780636,2451,2307,4758,+
chr20,49952934,0.2457722252399059,616,788,1404,+
chr20,49952935,0.2457722252399059,616,788,1404,+
chr20,50190830,0.461237047078737,2554,1554,4108,+
chr20,50190832,0.4778653445896962,1201,700,1901,+
chr20,50190898,1.6703804347826088,682,459,1141,+
chr20,50191114,1.8049552037082828,1372,906,2278,+
chr20,50191750,0.44489383215369055,703,551,1254,+
chr20,50191751,0.44489383215369055,703,551,1254,+
chr20,50191754,2.111217948717949,561,453,1014,+
chr20,50191808,1.7163249001331558,1215,750,1965,+
chr20,50191810,1.9058970018256636,1807,1198,3005,+
chr20,50191811,1.468789758523642,1176,850,2026,+
chr20,50191823,0.4994615140956604,656,769,1425,+
chr20,50191850,1.1972014032588454,1657,1331,2988,+
chr20,50191855,0.5648622456043195,1631,1397,3028,+
chr20,50191856,0.9828087795866906,2978,2308,5286,+
chr20,50191876,1.7855509717182767,886,681,1567,+
chr20,50191975,2.1911145186203105,2566,1548,4114,+
chr20,50191976,2.260856829149338,2935,1894,4829,+
chr20,50192139,1.8595598693097026,820,491,1311,+
chr20,50192164,0.9322830535024871,1012,801,1813,+
chr20,50192165,1.4852594856580696,1375,976,2351,+
chr20,50192184,1.803225806451613,558,509,1067,+
chr20,50192223,0.7094119125408394,1612,1037,2649,+
chr20,50192244,1.0626204234982464,1147,777,1924,+
chr20,50192245,1.3908119603371851,1961,1258,3219,+
chr20,50192248,1.51790243902439,840,499,1339,+
chr20,50192270,1.9529339144946127,1796,1467,3263,+
chr20,50192271,1.793384109916368,1021,743,1764,+
chr20,50192391,1.6965277777777772,1046,719,1765,+
chr20,50192407,1.6611643690808962,2945,1886,4831,+
chr20,50192411,1.823421599737389,1306,961,2267,+
chr20,50192458,1.5836196156241364,3303,2236,5539,+
chr20,50192479,1.4774002754179993,4135,2874,7009,+
chr20,50192488,0.7437843194874189,3001,2090,5091,+
chr20,50192489,1.8652796285947644,1355,1081,2436,+
chr20,50192581,1.7009500206526231,567,537,1104,+
chr20,50574616,5.088172043010752,727,464,1191,+
chr20,50574618,5.088172043010752,727,464,1191,+
chr20,50584639,11.61880709159517,300,782,1082,+
chr20,54208095,1.613900349095525,1081,547,1628,+
chr20,54208097,1.24550171939442,1959,1295,3254,+
chr20,54208098,1.2332773655418947,1759,997,2756,+
chr20,54208100,0.8311120366513952,1227,685,1912,+
chr20,54214355,1.553668317999528,711,470,1181,+
chr20,54214395,1.9799331103678932,607,493,1100,+
chr20,54215309,1.3339899188716673,1771,1438,3209,+
chr20,54215375,1.6395530145530146,1401,887,2288,+
chr20,55074616,1.4035500274730426,1529,1198,2727,+
chr20,55074617,2.1576797385620914,833,611,1444,+
chr20,55074618,1.0038350252562405,1401,970,2371,+
chr20,55074619,1.0038350252562405,1401,970,2371,+
chr20,55074834,0.8974216909287491,1005,600,1605,+
chr20,55074840,0.45017709563164093,737,483,1220,+
chr20,55074842,0.45017709563164093,737,483,1220,+
chr20,55074843,2.038601989818095,1982,1013,2995,+
chr20,55074844,1.7691796008869183,1514,824,2338,+
chr20,55074923,1.263281079999998,8960,5378,14338,+
chr20,55074924,1.0524811409683428,15534,10400,25934,+
chr20,55074925,1.1684274357967008,15989,9335,25324,+
chr20,55074926,1.0737648720120785,20922,14070,34992,+
chr20,55074927,1.1237081599872296,9191,5804,14995,+
chr20,55074928,0.8992516966881614,11451,8371,19822,+
chr20,55074930,1.2895876276085818,4805,2514,7319,+
chr20,55074972,1.34288799477286,5880,3230,9110,+
chr20,56399013,4.09175377709919,666,446,1112,+
chr20,56468656,0.4573620706271417,788,462,1250,+
chr20,56474725,1.6143607705779335,837,570,1407,+
chr20,56477108,2.6490161996469634,683,428,1111,+
chr20,56518088,3.510516252390057,713,522,1235,+
chr20,56518089,3.510516252390057,713,522,1235,+
chr20,56518304,1.148762814060045,618,515,1133,+
chr20,56518511,1.7682351043526794,784,481,1265,+
chr20,56518539,3.1748797988016864,726,503,1229,+
chr20,56601988,1.4742823312531723,878,850,1728,+
chr20,56601990,0.48339684267827987,591,667,1258,+
chr20,56602001,1.4526057157636103,716,406,1122,+
chr20,56602006,0.5882049840734496,1298,1185,2483,+
chr20,56602007,0.5882049840734496,1298,1185,2483,+
chr20,56602010,1.9654114660461182,1092,651,1743,+
chr20,57365385,1.8125417213443378,923,582,1505,+
chr20,57365387,2.3858386638237383,654,401,1055,+
chr20,57373699,1.441541270520598,726,564,1290,+
chr20,57378027,1.0517799698330121,736,510,1246,+
chr20,57378272,1.9344948962293111,1462,916,2378,+
chr20,57378274,1.8817512455359107,1066,612,1678,+
chr20,57378278,1.2306693711967545,1263,724,1987,+
chr20,57378280,1.2306693711967545,1263,724,1987,+
chr20,58444358,0.9353586497890296,651,394,1045,+
chr20,58444359,0.9353586497890296,651,394,1045,+
chr20,58445395,4.424829155575892,749,591,1340,+
chr20,58651684,0.5887008733624454,718,457,1175,+
chr20,58651685,0.5887008733624454,718,457,1175,+
chr20,58651686,0.5887008733624454,718,457,1175,+
chr20,58651712,5.365577548916987,1174,752,1926,+
chr20,58651720,8.353096464486729,1133,1203,2336,+
chr20,58651721,6.930243338339654,1600,1579,3179,+
chr20,58671260,1.3040158371040729,1589,1039,2628,+
chr20,58671261,1.3040158371040729,1589,1039,2628,+
chr20,58671262,1.3040158371040729,1589,1039,2628,+
chr20,58671283,2.6191040093864983,1342,910,2252,+
chr20,58673630,2.209205983474592,1563,1016,2579,+
chr20,58673645,2.1992610187384534,640,420,1060,+
chr20,58673648,2.08366935483871,1442,991,2433,+
chr20,58673649,2.08366935483871,1442,991,2433,+
chr20,58673652,1.3734362037497927,1356,860,2216,+
chr20,58673654,0.7479131584133525,2500,1634,4134,+
chr20,58673655,1.2473960536657969,2688,1761,4449,+
chr20,58673658,1.8969028301471562,1820,1273,3093,+
chr20,58673662,1.3847272727272728,1903,1374,3277,+
chr20,58676929,2.4985096245394636,621,430,1051,+
chr20,58678817,3.084779735002592,657,471,1128,+
chr20,58715299,5.304098051774516,977,1220,2197,+
chr20,58715300,4.718865555859368,1113,1398,2511,+
chr20,58891390,0.897509606616214,933,596,1529,+
chr20,58891393,1.280888322807361,2060,1356,3416,+
chr20,58891394,1.1207838700944066,2036,1371,3407,+
chr20,58891420,0.3897869628624523,1476,874,2350,+
chr20,58891467,4.938931371809952,722,391,1113,+
chr20,58891690,0.39411307147262153,834,563,1397,+
chr20,58891711,2.9513461405021757,717,302,1019,+
chr20,58891713,2.101422708618331,862,424,1286,+
chr20,58891714,1.7346686170937748,1643,854,2497,+
chr20,58891715,1.3587586276565495,2360,1352,3712,+
chr20,58891723,0.7771545403984225,2962,1913,4875,+
chr20,58891724,0.7151406572144979,4148,2525,6673,+
chr20,58891725,1.555269476372925,1833,1124,2957,+
chr20,58891726,0.5243271221532091,2025,1011,3036,+
chr20,58891727,1.555269476372925,1833,1124,2957,+
chr20,58891728,0.7324517210962859,2500,1230,3730,+
chr20,58891729,1.8860424028268554,853,565,1418,+
chr20,58891730,0.8880237045203969,1840,906,2746,+
chr20,58891739,1.2751234283441297,10064,6497,16561,+
chr20,58891740,1.135595035119635,5038,3312,8350,+
chr20,58891741,1.2751234283441297,10064,6497,16561,+
chr20,58891743,1.392288591215601,2622,1487,4109,+
chr20,58891744,1.3834965074685588,6024,4387,10411,+
chr20,58891746,1.3465054284988613,21200,15125,36325,+
chr20,58891747,1.3337344975599972,24766,17451,42217,+
chr20,58891748,1.5291838886065965,14825,11986,26811,+
chr20,58891750,1.5762374516381388,8004,6694,14698,+
chr20,58891754,1.533384067785543,7195,5729,12924,+
chr20,58895618,1.2759210486483217,2198,1286,3484,+
chr20,58895625,1.0247281590618544,4370,2812,7182,+
chr20,58895629,0.43083321683209846,1760,1243,3003,+
chr20,58898967,2.4592592592592597,663,413,1076,+
chr20,58903719,0.6958525345622121,1509,1177,2686,+
chr20,58903725,0.6491001445023428,1288,1113,2401,+
chr20,58903726,1.3469662921348315,2834,1779,4613,+
chr20,58903732,1.5764106583072102,1936,1507,3443,+
chr20,58903747,1.3693719210576896,3500,2298,5798,+
chr20,58905382,0.7332027513323919,2011,1513,3524,+
chr20,58905416,2.039231966787753,2455,1926,4381,+
chr20,58905448,1.4035876323307006,2708,2163,4871,+
chr20,58909171,1.6339664416418849,2443,2002,4445,+
chr20,58909172,1.3421170450911415,2751,2119,4870,+
chr20,58909380,1.6591384637843358,2932,1786,4718,+
chr20,58909386,1.7605838531887836,2126,1500,3626,+
chr20,58909410,1.6564113914711522,2040,1505,3545,+
chr20,58909521,1.4367563609738239,2838,1820,4658,+
chr20,58909522,1.7755231452124285,1784,1410,3194,+
chr20,58909557,1.6766756881964258,1656,1322,2978,+
chr20,58909561,1.537546933667084,1322,1189,2511,+
chr20,58909701,1.5188785800726101,1466,1109,2575,+
chr20,58909773,1.1517761196044545,5833,4137,9970,+
chr20,58909782,1.324635922330097,2182,1647,3829,+
chr20,58909970,1.5279721232340837,5280,3766,9046,+
chr20,58909998,0.7023753342771748,3195,2118,5313,+
chr20,58910375,1.70976067252663,2628,1553,4181,+
chr20,58910702,1.434459525199455,1492,1141,2633,+
chr20,58910727,1.2884993993593168,2941,1872,4813,+
chr20,58910787,0.7980552712384852,2598,1953,4551,+
chr20,58910827,1.292406597420832,7349,5787,13136,+
chr20,58910828,1.6017277922590036,4298,3573,7871,+
chr20,58910921,1.5363202355598118,2528,1626,4154,+
chr20,58910922,1.5205082408974115,1590,1181,2771,+
chr20,58910927,1.4241649435933368,9931,7176,17107,+
chr20,58910928,1.4290780829407694,8273,5917,14190,+
chr20,58910955,1.2779251399941054,3251,2348,5599,+
chr20,58911047,2.364998807789913,4885,4491,9376,+
chr20,58986779,2.511986705766457,607,463,1070,+
chr20,58987749,2.776038612443823,619,431,1050,+
chr20,58987765,1.3511523687580025,602,425,1027,+
chr20,58987767,1.3511523687580025,602,425,1027,+
chr20,58988967,2.3700516351118757,728,497,1225,+
chr20,58988969,2.3700516351118757,728,497,1225,+
chr20,58989548,0.5712864493996569,792,529,1321,+
chr20,58989550,0.5548178137651822,1141,649,1790,+
chr20,58989551,0.5548178137651822,1141,649,1790,+
chr20,58989552,1.850993377483444,558,452,1010,+
chr20,58991019,1.6653592772435535,587,481,1068,+
chr20,58991355,2.5279218212689614,595,411,1006,+
chr20,58991913,2.4149593662477615,618,443,1061,+
chr20,58993750,2.258029540975752,749,533,1282,+
chr20,62134210,1.0799243634814104,988,595,1583,+
chr20,62134212,1.3831214512646797,1317,853,2170,+
chr20,62135103,14.790977669235268,856,784,1640,+
chr20,62135104,11.830777551141344,1394,1484,2878,+
chr20,62135105,9.594077247204513,1009,1266,2275,+
chr20,62303687,1.1868386243386242,872,755,1627,+
chr20,62303688,1.86784692964358,1698,1375,3073,+
chr20,62304535,1.4475968787432185,655,489,1144,+
chr20,62308048,1.2994418445939357,924,654,1578,+
chr20,62308049,0.8235294117647058,579,434,1013,+
chr20,62308435,2.1014586079882402,594,483,1077,+
chr20,62387098,0.9213871995366348,3348,2301,5649,+
chr20,62387099,0.7054295402387133,11832,8910,20742,+
chr20,62387101,0.6342715065119106,24443,16279,40722,+
chr20,62387103,0.6811449029774007,23085,14719,37804,+
chr20,62387105,0.6932602962232309,8392,5417,13809,+
chr20,62387107,1.40032428438407,11182,6571,17753,+
chr20,62387334,1.2221658524284706,31390,23247,54637,+
chr20,62387335,1.1418985605446503,24489,15599,40088,+
chr20,62387336,1.2392459191947416,17882,13980,31862,+
chr20,62387338,1.2609596589204912,12701,9931,22632,+
chr20,62387342,1.28067945525641,26730,18073,44803,+
chr20,62387357,1.2131317751211768,10732,7763,18495,+
chr20,62387617,1.2526272077948826,43442,31667,75109,+
chr20,62387619,1.2317472775422929,31800,25240,57040,+
chr20,62387657,1.1202253943359783,35768,24835,60603,+
chr20,62387840,0.9828207496158743,796,645,1441,+
chr20,62387845,1.2553622749962183,9575,7211,16786,+
chr20,62388455,1.5171863916264565,935,799,1734,+
chr20,62668096,2.9005902451082166,576,431,1007,+
chr20,62671823,2.038286968125921,1532,1197,2729,+
chr20,62671824,2.1191562143671607,1070,876,1946,+
chr20,63742000,2.538843557353369,647,418,1065,+
chr20,63742959,1.0181605055357557,947,654,1601,+
chr20,63742961,1.2417209761602483,820,570,1390,+
chr20,63873769,0.913202803796863,923,592,1515,+
chr20,63890215,4.2020236570468805,1321,832,2153,+
chr20,63890216,3.8299465290869485,3162,2149,5311,+
chr20,63890218,3.6493881613413657,2175,1483,3658,+
chr20,63890479,1.8069930069930067,645,428,1073,+
chr20,63890497,1.1899334463269349,1024,754,1778,+
chr20,63891044,22.80827812486108,1804,1592,3396,+
chr20,63891045,22.80827812486108,1804,1592,3396,+
chr20,63891108,0.4690605841115451,644,603,1247,+
chr20,63984952,2.7686567164179103,635,401,1036,+
chr20,63984953,2.7686567164179103,635,401,1036,+
chr20,63994992,0.7655283389951726,2675,1597,4272,+
chr20,63994993,0.7655283389951726,2675,1597,4272,+
chr20,63994994,0.7655283389951726,2675,1597,4272,+
chr20,63995002,1.7921571579105826,3013,2043,5056,+
chr20,63995003,1.7492693518609574,5294,3590,8884,+
chr20,63995004,1.5369832309769214,8530,5986,14516,+
chr20,63995005,1.7704969723865305,5614,4176,9790,+
chr20,63995006,1.429605047307158,9169,6542,15711,+
chr20,63995007,1.7347165310184716,3559,2753,6312,+
chr20,63995012,1.847883016023476,2973,2227,5200,+
chr20,64016728,1.094047619047619,918,419,1337,+
chr20,64016729,1.5347444539004265,1577,796,2373,+
chr20,64016748,0.962757087270706,1731,770,2501,+
chr20,64016750,0.962757087270706,1731,770,2501,+
chr20,64016753,2.215909090909091,779,447,1226,+
chr20,64016758,1.6503723511943444,2352,1458,3810,+
chr20,64016759,1.880184210526316,1930,1199,3129,+
chr20,64016771,2.275102945834653,1689,860,2549,+
chr20,64027012,1.3514060089193634,773,589,1362,+
chr20,64027013,0.9973969631236443,604,460,1064,+
chr20,64027029,0.8830944142362825,793,475,1268,+
chr20,64027031,0.8830944142362825,793,475,1268,+
chr20,64027060,2.3944073062800117,1556,816,2372,+
chr20,64027062,2.3944073062800117,1556,816,2372,+
chr20,64027066,2.0400184536248007,2573,1587,4160,+
chr20,64027067,2.1938803088803094,1862,1035,2897,+
chr20,64070340,1.751523881898786,1166,928,2094,+
chr21,6123294,0.9777153558052434,680,533,1213,+
chr21,6123295,0.9777153558052434,680,533,1213,+
chr21,8216235,1.7354370074266885,1023,569,1592,+
chr21,18857757,0.8033000281452293,2321,2243,4564,+
chr21,18857771,1.0937076077932784,11524,8298,19822,+
chr21,18857784,0.805997894973261,10057,6739,16796,+
chr21,18857794,1.5238919637314308,6607,3413,10020,+
chr21,18857803,1.0548259611497692,15412,11192,26604,+
chr21,18857944,1.6038350910834134,2787,1489,4276,+
chr21,18857955,1.367921623820729,1802,1228,3030,+
chr21,18857958,1.3711055215181034,8397,5893,14290,+
chr21,18858105,1.008945492246125,1375,999,2374,+
chr21,18858107,0.9464969623939069,3134,2113,5247,+
chr21,18858108,1.1579176047714974,714,521,1235,+
chr21,18858109,0.9765205374210586,4085,2472,6557,+
chr21,18858111,1.0905313816509028,10271,6956,17227,+
chr21,18858112,1.0095374910923627,10073,6905,16978,+
chr21,18858113,0.9651328737707476,7966,6019,13985,+
chr21,18858115,1.113883927328787,11203,8185,19388,+
chr21,18858118,1.2373054544156492,3577,2783,6360,+
chr21,18858120,1.3229576399394856,4996,3304,8300,+
chr21,18858123,1.0451372476720107,9560,6775,16335,+
chr21,18858129,0.9783907704882958,16463,10860,27323,+
chr21,18858130,0.8309266649767812,30038,20789,50827,+
chr21,18858132,0.6595021519198072,13575,9929,23504,+
chr21,31659662,0.4879699658062055,644,411,1055,+
chr21,31659667,2.033598835493924,749,349,1098,+
chr21,31659687,1.1148805319905315,729,484,1213,+
chr21,31659696,2.1385281385281387,1462,725,2187,+
chr21,31659698,2.1685912542550407,2268,1139,3407,+
chr21,31659700,1.7975500239766338,1555,790,2345,+
chr21,31659766,0.54750623892365,840,642,1482,+
chr21,31659775,1.7250936329588011,657,533,1190,+
chr21,31659821,1.7263095238095236,852,599,1451,+
chr21,31659826,0.5950417177763853,2453,1684,4137,+
chr21,31663849,1.8709146968139772,983,694,1677,+
chr21,31666450,1.4976681741096665,1569,975,2544,+
chr21,31667288,0.6483996120271581,1336,1030,2366,+
chr21,31667292,1.540494533557811,3516,2674,6190,+
chr21,31667293,1.6198290126861554,2072,1553,3625,+
chr21,31668474,0.6987889273356401,1153,849,2002,+
chr21,31668475,2.476770960314235,891,641,1532,+
chr21,31668477,0.6033811475409836,1358,975,2333,+
chr21,31668510,1.4070308575054866,1418,1281,2699,+
chr21,31668511,1.9677061329705343,1144,900,2044,+
chr21,32496942,1.095905936718504,621,459,1080,+
chr21,33421486,2.1329563578367408,625,417,1042,+
chr21,33421488,1.6821304566739819,1013,752,1765,+
chr21,33432754,2.725598526703499,739,542,1281,+
chr21,33432755,2.565745162700886,1247,900,2147,+
chr21,33432805,3.4889064976228212,776,630,1406,+
chr21,33432809,1.9782321566449896,3277,2899,6176,+
chr21,33432811,2.104670020065419,1766,1628,3394,+
chr21,33432823,1.1073477367592062,2059,1850,3909,+
chr21,36070970,1.2735314685314685,1348,879,2227,+
chr21,36070971,1.378267344300998,1606,1046,2652,+
chr21,36070972,1.2735314685314685,1348,879,2227,+
chr21,36072465,2.1250545757778045,677,597,1274,+
chr21,36072705,2.2589118022688006,562,482,1044,+
chr21,36072758,5.477939123259169,675,482,1157,+
chr21,38805931,1.0529793510324486,775,338,1113,+
chr21,38805932,1.7559611788770302,1040,482,1522,+
chr21,38814286,2.3771626297577853,686,441,1127,+
chr21,38814798,2.3072344561854377,815,539,1354,+
chr21,38814866,2.582003546099291,698,422,1120,+
chr21,38814875,1.8008720551867758,1666,1181,2847,+
chr21,38814876,1.8008720551867758,1666,1181,2847,+
chr21,38814893,0.4043255913062007,1011,721,1732,+
chr21,38814932,1.6541751835869485,1149,713,1862,+
chr21,38814933,1.4278916959329329,1643,1260,2903,+
chr21,38817026,2.174239350912779,793,492,1285,+
chr21,38819510,0.48310936663305476,790,536,1326,+
chr21,38819731,0.4231651376146789,614,435,1049,+
chr21,38822697,1.6650222929632124,1313,909,2222,+
chr21,38822699,1.0179395028451632,828,476,1304,+
chr21,38822757,1.029674839524361,1029,883,1912,+
chr21,38822758,1.029674839524361,1029,883,1912,+
chr21,38822972,3.3851341235076315,612,487,1099,+
chr21,38822982,4.765716374269005,766,607,1373,+
chr21,38822983,4.765716374269005,766,607,1373,+
chr21,38823121,1.091965768988076,1448,1030,2478,+
chr21,38823189,1.88470066518847,679,450,1129,+
chr21,38823190,1.7885487077534792,832,502,1334,+
chr21,38823271,0.5932446591948273,1697,1008,2705,+
chr21,38823276,2.435308016794038,2217,1430,3647,+
chr21,38823277,2.687973484848485,1621,1055,2676,+
chr21,38823278,2.220179724511713,2852,1765,4617,+
chr21,38823306,5.383686651549429,7084,6258,13342,+
chr21,38823307,5.383686651549429,7084,6258,13342,+
chr21,38823308,3.3111481258343085,1773,1945,3718,+
chr21,38823599,2.0304196859903376,726,575,1301,+
chr21,38823600,2.0304196859903376,726,575,1301,+
chr21,38824009,3.0482511192124777,603,475,1078,+
chr21,38824147,8.508660308235319,1455,1164,2619,+
chr21,38824148,8.50866030823532,1455,1164,2619,+
chr21,41168489,2.546996490542288,593,437,1030,+
chr21,41168537,1.9673854873543402,877,599,1476,+
chr21,41226323,3.495941450432468,820,500,1320,+
chr21,41226326,2.102167182662539,775,645,1420,+
chr21,41237519,2.503267973856209,765,467,1232,+
chr21,41237548,2.0424710424710426,528,480,1008,+
chr21,41237684,0.6173747923095182,866,765,1631,+
chr21,41241817,0.3603012773623647,895,836,1731,+
chr21,41243385,0.5800827092880295,1037,777,1814,+
chr21,41243389,1.8055257164955096,954,628,1582,+
chr21,41245962,1.4923373866049026,1153,941,2094,+
chr21,41250758,1.103990588101015,1208,885,2093,+
chr21,41250802,1.6518821126349577,628,595,1223,+
chr21,41250805,1.6155116696588872,702,556,1258,+
chr21,41250812,1.6242920091456936,1801,1285,3086,+
chr21,41250848,0.6499683996939761,976,910,1886,+
chr21,41257198,2.4796610169491533,1063,589,1652,+
chr21,41257206,1.8028662420382164,764,627,1391,+
chr21,41257226,1.5867084639498432,702,637,1339,+
chr21,41257292,2.0995610995611,1340,1052,2392,+
chr21,41257293,2.0995610995611,1340,1052,2392,+
chr21,41275392,2.0857685009487663,915,526,1441,+
chr21,41275521,1.7873204700420715,1759,1242,3001,+
chr21,41275523,1.716624091883113,2598,1944,4542,+
chr21,41275586,1.8089668615984404,695,512,1207,+
chr21,41275587,1.691963572455664,705,568,1273,+
chr21,41275621,2.43313414382856,737,632,1369,+
chr21,41275622,1.7253097715271606,999,616,1615,+
chr21,41275669,1.7058961004273503,928,767,1695,+
chr21,41275676,1.6660810252170315,1315,943,2258,+
chr21,41275740,1.4570731707317073,926,737,1663,+
chr21,41275920,2.4659793814432986,597,484,1081,+
chr21,41275933,0.5159350155547874,877,525,1402,+
chr21,41275982,0.5266829718134798,820,508,1328,+
chr21,41275991,1.8829787234042556,884,563,1447,+
chr21,41276098,1.8351357846671472,663,437,1100,+
chr21,41276181,0.3850018841854038,612,418,1030,+
chr21,41276204,2.5467608076303723,1027,597,1624,+
chr21,41276205,2.5467608076303723,1027,597,1624,+
chr21,41276215,1.1733552631578947,1188,683,1871,+
chr21,41276217,1.4006569656781485,1824,1067,2891,+
chr21,41276219,2.4698586411308714,1230,730,1960,+
chr21,41276463,0.33413654618473904,623,414,1037,+
chr21,43030143,0.9676320272572404,567,586,1153,+
chr21,43030145,0.9676320272572404,567,586,1153,+
chr21,43795202,2.8600000000000003,623,449,1072,+
chr21,43795204,2.1496439793023012,1512,1014,2526,+
chr21,43795206,2.3960570322126387,663,493,1156,+
chr21,46286933,2.08201581027668,587,551,1138,+
chr21,46291350,2.45421918796615,736,466,1202,+
chr21,46635751,3.271167104644133,605,411,1016,+
chr22,17683222,3.2792865016534725,908,586,1494,+
chr22,17683224,3.2792865016534725,908,586,1494,+
chr22,17689076,1.169627236835561,731,516,1247,+
chr22,17726855,3.468954244574568,689,437,1126,+
chr22,17726856,3.2990769680854073,658,484,1142,+
chr22,17727721,2.6826086956521737,616,459,1075,+
chr22,17727722,2.6826086956521737,616,459,1075,+
chr22,17728261,2.5402312460018717,796,463,1259,+
chr22,17728290,3.5589144841420803,657,463,1120,+
chr22,17728627,1.6069811189298404,658,462,1120,+
chr22,17729020,0.4535955224658586,1281,864,2145,+
chr22,17729021,0.42291009463722395,857,633,1490,+
chr22,19432575,1.1664890658195441,699,515,1214,+
chr22,19432582,1.2170871339224976,1182,950,2132,+
chr22,19434764,1.8673651551777195,2312,2043,4355,+
chr22,19434765,1.913551340069109,3006,2526,5532,+
chr22,19434783,0.5236077481840193,1037,707,1744,+
chr22,19435637,2.0030894847180845,625,476,1101,+
chr22,19435680,1.5821462488129152,832,620,1452,+
chr22,19435717,1.685360824742268,1607,1163,2770,+
chr22,19435729,2.440941629955947,1042,907,1949,+
chr22,19435759,1.9351032448377579,655,451,1106,+
chr22,19435771,1.4487092850385188,1190,754,1944,+
chr22,19435775,1.3906577971783332,3247,3088,6335,+
chr22,19435777,1.3906577971783332,3247,3088,6335,+
chr22,19435792,1.5908528721871287,3410,2455,5865,+
chr22,19435869,0.9168857811410707,1698,1099,2797,+
chr22,19435870,0.4429618842812876,1307,808,2115,+
chr22,19435888,1.4426677489177488,750,479,1229,+
chr22,19962719,1.8451178451178447,547,461,1008,+
chr22,19962741,2.2902565016031358,694,400,1094,+
chr22,19962760,1.574871145996411,1966,1726,3692,+
chr22,19962761,1.574871145996411,1966,1726,3692,+
chr22,19962779,1.7279321799978837,2791,2504,5295,+
chr22,19963696,2.443531204494894,908,641,1549,+
chr22,19964212,1.013356256220767,1115,887,2002,+
chr22,19968809,1.267304742593192,589,452,1041,+
chr22,19968889,0.5523891767415084,605,578,1183,+
chr22,20117545,19.367941712204004,685,365,1050,+
chr22,20119048,0.675342008675342,659,554,1213,+
chr22,20122355,1.636237144585602,730,434,1164,+
chr22,20122390,1.2111665270207188,1158,877,2035,+
chr22,20122391,0.5195052979455556,952,598,1550,+
chr22,20126329,1.2868133036623288,876,631,1507,+
chr22,20126331,1.0407239819004526,689,458,1147,+
chr22,20126338,0.32694541231126595,562,461,1023,+
chr22,20126340,0.32694541231126595,562,461,1023,+
chr22,20126341,0.9398261758691208,592,488,1080,+
chr22,20126343,0.9398261758691208,592,488,1080,+
chr22,20126964,1.6467781020349999,1587,1160,2747,+
chr22,20126978,1.7270404273291167,1915,1359,3274,+
chr22,20583155,2.136031190135036,652,450,1102,+
chr22,20583169,3.4284000616028654,833,544,1377,+
chr22,20870482,4.002457466918714,682,528,1210,+
chr22,20887786,2.8814636430792206,602,445,1047,+
chr22,20887801,2.080097532045053,588,415,1003,+
chr22,20918111,2.0578682098189285,847,486,1333,+
chr22,20918112,2.0578682098189285,847,486,1333,+
chr22,21610856,1.6375027239049904,790,705,1495,+
chr22,21621538,0.951086956521739,1049,695,1744,+
chr22,21621539,1.3047182175622545,1628,1089,2717,+
chr22,21621541,1.4810691341152853,2364,1592,3956,+
chr22,21621542,2.1081930415263748,1173,809,1982,+
chr22,21622786,3.2295582885336915,612,408,1020,+
chr22,21644041,1.6797434667397662,541,515,1056,+
chr22,21644213,17.3466344337944,2594,1455,4049,+
chr22,21644214,17.3466344337944,2594,1455,4049,+
chr22,21644215,17.3466344337944,2594,1455,4049,+
chr22,21644225,8.328482934666875,967,844,1811,+
chr22,21644226,9.444217415102987,1347,1258,2605,+
chr22,23787247,1.1742523466167705,721,552,1273,+
chr22,23791792,1.8034106782705437,1051,777,1828,+
chr22,23791794,2.7813329088400716,988,697,1685,+
chr22,23791796,2.8955193482688397,676,490,1166,+
chr22,23791844,0.5460426179604261,614,437,1051,+
chr22,23793597,1.7271604938271603,1398,809,2207,+
chr22,23793598,1.7271604938271603,1398,809,2207,+
chr22,23801005,2.0109743018116677,710,468,1178,+
chr22,23803304,0.7089966934807284,1167,880,2047,+
chr22,23803305,0.7089966934807284,1167,880,2047,+
chr22,23803308,0.5576287657920311,754,524,1278,+
chr22,23803317,1.5756309543707172,856,578,1434,+
chr22,23803325,2.192173720730932,1634,1185,2819,+
chr22,23803326,2.192173720730932,1634,1185,2819,+
chr22,23803374,1.976082504001951,887,640,1527,+
chr22,23816772,2.3294292619445995,715,488,1203,+
chr22,23816774,2.3294292619445995,715,488,1203,+
chr22,23816797,1.1764078978502228,1288,823,2111,+
chr22,23825225,2.3259415364892035,593,422,1015,+
chr22,23825243,2.4637564082647194,1238,784,2022,+
chr22,23825244,2.4637564082647194,1238,784,2022,+
chr22,23825245,2.4637564082647194,1238,784,2022,+
chr22,23825344,3.380388281022876,1352,919,2271,+
chr22,23825378,10.3521370672312,840,841,1681,+
chr22,23825379,12.42222222222222,545,629,1174,+
chr22,23833622,3.150402072002072,769,518,1287,+
chr22,23834312,21.21283841630417,797,740,1537,+
chr22,23834313,19.411014254025122,899,846,1745,+
chr22,23894374,1.3885409477093598,900,545,1445,+
chr22,23894376,1.8275670741773737,1041,598,1639,+
chr22,23894382,0.5204795766148822,1677,958,2635,+
chr22,23894385,2.7793427230046945,1627,780,2407,+
chr22,23894387,2.7474094871249806,1989,995,2984,+
chr22,23894393,0.8925887901015305,10695,7604,18299,+
chr22,23894394,0.8960001400708582,17252,12577,29829,+
chr22,23894395,0.8960001400708582,17252,12577,29829,+
chr22,23894404,1.2868347742860664,10236,6769,17005,+
chr22,23894408,0.7544085322908812,7385,5412,12797,+
chr22,23894490,1.4382283342812023,18251,13175,31426,+
chr22,23894770,1.0567554020878973,9367,6133,15500,+
chr22,23894771,1.134797196833252,3342,2582,5924,+
chr22,23894772,1.1748996196111579,5066,2807,7873,+
chr22,23894820,1.5932907669820486,8897,7491,16388,+
chr22,23894822,1.4558369849249988,20675,14390,35065,+
chr22,23894862,1.333992994494305,4282,2305,6587,+
chr22,23895044,1.3268550701410622,9859,7154,17013,+
chr22,23895049,1.3338651471984806,6595,5524,12119,+
chr22,23895050,1.3081311765845738,10198,8583,18781,+
chr22,23895052,1.2471527207968984,12566,9259,21825,+
chr22,23895170,1.6916072270832732,1996,1648,3644,+
chr22,24321451,2.2541527715062117,1056,602,1658,+
chr22,24321457,2.861681329423265,1170,725,1895,+
chr22,24321459,2.861681329423265,1170,725,1895,+
chr22,24322144,1.9868131868131869,677,324,1001,+
chr22,24322146,2.2817534296835427,1948,1122,3070,+
chr22,24322148,2.3240318881117226,1662,1027,2689,+
chr22,24322149,2.6359745517640247,632,454,1086,+
chr22,24555984,0.876844258651324,1092,687,1779,+
chr22,24556024,1.9328440875103852,845,627,1472,+
chr22,24556031,1.4362842235790705,1450,1100,2550,+
chr22,24556051,1.5395795852665468,1048,715,1763,+
chr22,24556052,1.537500266564306,1221,956,2177,+
chr22,24556055,2.340712223291627,1291,1038,2329,+
chr22,24568056,2.1929545644715924,1007,628,1635,+
chr22,24568069,1.7935532935532938,988,776,1764,+
chr22,24568159,1.9080351466715104,2074,1572,3646,+
chr22,24572024,1.3876777251184835,2195,1476,3671,+
chr22,29268332,1.7927883855303661,899,896,1795,+
chr22,29273788,0.4221190842664527,782,518,1300,+
chr22,29273790,0.7923076923076924,926,571,1497,+
chr22,29273791,1.0229535864978905,637,394,1031,+
chr22,29278112,3.5675267211049233,662,408,1070,+
chr22,29278202,2.368932038834952,731,514,1245,+
chr22,29278204,2.368932038834952,731,514,1245,+
chr22,29282448,2.4485669906076115,977,741,1718,+
chr22,29282507,5.625154564240948,690,533,1223,+
chr22,29286923,2.487725473140861,877,677,1554,+
chr22,29286924,2.6142557651991614,608,476,1084,+
chr22,29288763,25.317817817817808,754,332,1086,+
chr22,29288764,24.99095340476663,1051,491,1542,+
chr22,29288765,29.196167801580597,861,437,1298,+
chr22,29288768,26.047346423266344,740,648,1388,+
chr22,29288771,2.9151979583199092,532,493,1025,+
chr22,29292496,2.0634912077647822,608,418,1026,+
chr22,29292499,0.7937213410308811,706,545,1251,+
chr22,29292517,2.121017156862745,601,407,1008,+
chr22,29292532,3.599653106275623,616,452,1068,+
chr22,29296275,2.3612637362637363,572,503,1075,+
chr22,29297849,2.0353726082578047,873,661,1534,+
chr22,29297850,2.0353726082578047,873,661,1534,+
chr22,29297883,2.2700686200367994,1082,843,1925,+
chr22,29299247,1.555707584324565,981,710,1691,+
chr22,29299712,2.411330049261084,889,405,1294,+
chr22,29299736,1.6509379865002827,1457,701,2158,+
chr22,29299740,1.7509833916083917,640,415,1055,+
chr22,29299744,2.479399255715045,1364,626,1990,+
chr22,29299755,1.9696976738449372,4291,2557,6848,+
chr22,29299756,2.2540225392083464,5210,3102,8312,+
chr22,29299757,0.09327789327789328,672,369,1041,+
chr22,29299758,2.071556773574489,4701,2964,7665,+
chr22,29299784,2.5564102564102558,996,524,1520,+
chr22,29299790,1.8194795539033461,2414,1344,3758,+
chr22,29299792,1.7806750620289309,3680,2083,5763,+
chr22,29299793,1.5997369466624383,4457,2807,7264,+
chr22,29299802,1.5617801840524603,2118,1577,3695,+
chr22,29299824,1.946016492586881,3339,2548,5887,+
chr22,29299830,1.5504486658491927,11896,8852,20748,+
chr22,29299833,3.1493277035075,13846,10959,24805,+
chr22,29299836,1.4170852057449994,6432,4289,10721,+
chr22,29299838,1.6784652660356225,18766,15788,34554,+
chr22,29299839,1.681614963210635,15717,13781,29498,+
chr22,29300155,1.2277184184928607,1153,963,2116,+
chr22,29300158,2.0614439324116742,670,433,1103,+
chr22,29300159,1.462642256308758,738,687,1425,+
chr22,29300167,1.5848268661910565,827,820,1647,+
chr22,29767382,1.1858028681078145,782,698,1480,+
chr22,29767383,0.6891417555732225,850,793,1643,+
chr22,29767388,0.8777228887320631,582,544,1126,+
chr22,29767389,0.8777228887320631,582,544,1126,+
chr22,29767393,1.6484584060500294,658,572,1230,+
chr22,29767446,1.8662940461725397,892,822,1714,+
chr22,29767528,1.6333474317225916,2011,1308,3319,+
chr22,29769690,1.6721294471527848,986,932,1918,+
chr22,29769747,1.96821215314366,1600,948,2548,+
chr22,29769845,1.7035714285714287,1241,965,2206,+
chr22,30428628,2.9570605187319883,661,346,1007,+
chr22,30428630,2.2127578747856256,879,537,1416,+
chr22,30428805,0.2801039025295318,646,436,1082,+
chr22,30428806,0.2801039025295318,646,436,1082,+
chr22,30428910,3.100522193211489,759,382,1141,+
chr22,30428912,2.383977432050173,961,580,1541,+
chr22,30907534,2.6479008535948036,664,460,1124,+
chr22,30977114,0.86959201008094,833,522,1355,+
chr22,30977845,1.9695526329781945,776,464,1240,+
chr22,30977849,2.7020674144249663,821,527,1348,+
chr22,30977901,2.235053653551354,809,514,1323,+
chr22,30977906,0.3631032927379342,965,738,1703,+
chr22,30977928,1.6627694556083303,1109,781,1890,+
chr22,30977929,0.4085,816,479,1295,+
chr22,30977933,1.9526100445123868,1315,966,2281,+
chr22,30977938,1.9704937575255719,3021,2426,5447,+
chr22,30977939,1.9704937575255719,3021,2426,5447,+
chr22,30978109,3.045375967432918,714,503,1217,+
chr22,31399622,1.1463073440671732,747,584,1331,+
chr22,31399625,0.6180247805827453,1244,776,2020,+
chr22,31399640,1.983086240369422,1075,669,1744,+
chr22,31399654,2.6782429009465405,680,576,1256,+
chr22,31399661,1.536765432671578,3046,2334,5380,+
chr22,31399665,1.7839573398429043,5955,4649,10604,+
chr22,31399666,1.6168940584622207,5141,3803,8944,+
chr22,31403029,2.0207646531774555,887,686,1573,+
chr22,31403031,2.335797471095694,817,616,1433,+
chr22,31403122,1.3180026728833452,1133,870,2003,+
chr22,31403142,2.4358586404409377,682,486,1168,+
chr22,31420273,2.3969742550479842,1172,851,2023,+
chr22,31420325,1.7270908621579764,810,595,1405,+
chr22,31426620,1.6941425120772946,723,575,1298,+
chr22,31426712,2.0634170742552245,824,691,1515,+
chr22,31426767,1.932976932976933,780,480,1260,+
chr22,31427079,2.1388888888888893,692,539,1231,+
chr22,31427086,1.94296875,828,511,1339,+
chr22,31433909,2.111466666666667,641,449,1090,+
chr22,31433920,0.48966191515881546,1848,1389,3237,+
chr22,31434071,2.019097736092632,1129,763,1892,+
chr22,31434086,2.1438097354967773,642,408,1050,+
chr22,31434120,0.4867407570422535,982,767,1749,+
chr22,31944808,2.236256770486599,767,460,1227,+
chr22,31956438,3.838637632607482,624,397,1021,+
chr22,31956474,0.980336744407425,844,763,1607,+
chr22,31956475,0.980336744407425,844,763,1607,+
chr22,31956476,0.4419404125286479,533,475,1008,+
chr22,31956769,2.1806599861335285,596,455,1051,+
chr22,31957007,1.9101123595505616,611,444,1055,+
chr22,31957094,1.819906910132474,662,440,1102,+
chr22,31957095,1.7423076923076923,754,519,1273,+
chr22,31957298,1.8259705488621145,681,497,1178,+
chr22,32039463,0.9965367558472169,4910,4636,9546,+
chr22,32039605,0.559593023255814,769,575,1344,+
chr22,32039619,2.5098225562420144,2729,1887,4616,+
chr22,32039620,2.3543219845636703,1790,1132,2922,+
chr22,32039621,2.3543219845636703,1790,1132,2922,+
chr22,32039628,0.7919865477283318,2657,2004,4661,+
chr22,32039629,1.051894329896907,1520,1199,2719,+
chr22,32039631,0.868866376437191,3437,2501,5938,+
chr22,32039632,0.868866376437191,3437,2501,5938,+
chr22,32039665,1.6754032380071406,2431,1599,4030,+
chr22,32039670,1.8346739792809263,1770,1093,2863,+
chr22,32039671,1.8346739792809263,1770,1093,2863,+
chr22,32039673,1.3763691665590327,2730,1802,4532,+
chr22,32039674,1.3532274742358046,3952,2624,6576,+
chr22,32039675,0.5642778762555921,1336,1076,2412,+
chr22,32039681,1.1727111882476724,3118,2320,5438,+
chr22,32039685,1.3541810793259508,5883,4379,10262,+
chr22,32039686,1.4195053928683232,3769,2702,6471,+
chr22,32039689,1.326182662290883,2735,1921,4656,+
chr22,32039701,0.6607290269322051,3414,2642,6056,+
chr22,32039702,1.4606321802974522,2745,2150,4895,+
chr22,32039714,1.431283656150441,3361,2814,6175,+
chr22,32039717,1.5269607162549734,3665,3190,6855,+
chr22,32039719,0.7580458222499534,11723,8324,20047,+
chr22,32039720,1.0854604213075845,19751,15884,35635,+
chr22,32039721,1.3369911200303164,19098,16125,35223,+
chr22,32039739,1.2223434947213632,17245,12803,30048,+
chr22,32039804,1.3436435607106691,1639,1206,2845,+
chr22,32487751,2.729450640231309,825,537,1362,+
chr22,32487753,2.729450640231309,825,537,1362,+
chr22,32491109,5.539138191511329,586,560,1146,+
chr22,32493199,1.3514332558555393,816,595,1411,+
chr22,32493254,1.6651925465838506,1135,874,2009,+
chr22,32493255,1.7118200639939771,1765,1379,3144,+
chr22,32493256,0.4244156180845343,2041,1456,3497,+
chr22,32493257,1.6764344262295083,1211,959,2170,+
chr22,32493258,0.4622271164749475,2317,1638,3955,+
chr22,32493260,1.3061173783037614,3226,2591,5817,+
chr22,32493261,1.505721935911449,2673,2159,4832,+
chr22,32493267,2.110010764262648,890,928,1818,+
chr22,32859950,2.5870919912690837,786,482,1268,+
chr22,35265088,3.4470084357819935,649,514,1163,+
chr22,35295463,14.104544021292602,836,639,1475,+
chr22,35394140,7.813099443519001,930,1771,2701,+
chr22,35394141,7.813099443519001,930,1771,2701,+
chr22,35400460,0.9833765542921737,642,556,1198,+
chr22,35400462,0.9833765542921737,642,556,1198,+
chr22,35400538,4.463343108504398,760,371,1131,+
chr22,35400540,4.463343108504398,760,371,1131,+
chr22,35403216,1.2150872547299858,559,484,1043,+
chr22,35403223,2.2188382566075178,633,482,1115,+
chr22,35403306,3.6295435592148286,765,509,1274,+
chr22,35408425,1.1441647597254003,919,528,1447,+
chr22,35408427,1.4158319386506133,1416,816,2232,+
chr22,35408428,0.939443535188216,983,563,1546,+
chr22,35408477,2.0925490196078433,695,424,1119,+
chr22,35410796,0.6212716463910096,1024,679,1703,+
chr22,35410853,17.80187575078377,2077,1141,3218,+
chr22,35410854,18.23483881632492,2391,1367,3758,+
chr22,35410897,3.3888057338891104,771,524,1295,+
chr22,35410898,2.05210653875586,722,598,1320,+
chr22,35412628,1.7072073673533195,994,645,1639,+
chr22,35413941,0.9202558127618743,1013,785,1798,+
chr22,35413942,0.5108710150726958,765,587,1352,+
chr22,35413956,1.8214285714285716,611,405,1016,+
chr22,35416675,4.078649507902622,620,498,1118,+
chr22,35416776,0.4168874757110052,589,458,1047,+
chr22,35417810,1.1104914626410667,789,681,1470,+
chr22,35417829,0.5264351523742027,618,414,1032,+
chr22,35419916,0.9576304551924648,1019,622,1641,+
chr22,35419918,0.9576304551924648,1019,622,1641,+
chr22,35424404,2.61432084241761,627,380,1007,+
chr22,37029315,1.3782172138583573,753,559,1312,+
chr22,37029325,0.46385070957648905,592,470,1062,+
chr22,37029326,0.46385070957648905,592,470,1062,+
chr22,37029721,3.570033327734819,602,416,1018,+
chr22,37029754,3.5413154655604333,726,482,1208,+
chr22,37666007,6.836250520617731,863,541,1404,+
chr22,37666008,7.686971637917916,979,642,1621,+
chr22,37666021,5.549888069450972,721,646,1367,+
chr22,37666492,1.5226880425510563,1034,718,1752,+
chr22,37666646,2.6,737,491,1228,+
chr22,37666648,2.6,737,491,1228,+
chr22,37675637,1.1174221441732373,3882,3127,7009,+
chr22,37675639,1.0871494403791184,9224,7618,16842,+
chr22,37677005,1.373028978468512,1863,1419,3282,+
chr22,37677011,1.0008986694848905,4951,3583,8534,+
chr22,37678490,1.8638888888888892,1341,959,2300,+
chr22,37678526,1.4465522753916658,1107,852,1959,+
chr22,37678529,1.806589383770592,1133,893,2026,+
chr22,37678619,3.9671932311887104,4128,3188,7316,+
chr22,37678621,3.287425149700599,1463,1335,2798,+
chr22,37678639,1.6075367647058825,688,543,1231,+
chr22,37678641,0.6567867457060343,744,730,1474,+
chr22,37679646,0.4827497425334706,1124,970,2094,+
chr22,37679662,0.6931128420490122,1780,1550,3330,+
chr22,37679663,1.6299831892411143,1596,1387,2983,+
chr22,37679699,1.7461617644877128,5101,3524,8625,+
chr22,37757910,3.3235868596298044,845,387,1232,+
chr22,37757945,1.8229251148959176,612,410,1022,+
chr22,37757962,1.8423446540121915,2342,1286,3628,+
chr22,37757963,1.5509804521398636,1559,673,2232,+
chr22,37805459,2.0980473597219325,641,432,1073,+
chr22,37805600,2.2259191409344776,650,431,1081,+
chr22,37805658,1.0102586009422807,1989,1178,3167,+
chr22,37805659,1.854458753775294,1465,867,2332,+
chr22,37805660,1.231593940857287,3289,2000,5289,+
chr22,37805662,1.4461798413180216,3257,2040,5297,+
chr22,37805701,1.060093167888522,1776,1042,2818,+
chr22,37806401,38.06347733898754,822,685,1507,+
chr22,37806402,27.04294800830255,5260,4591,9851,+
chr22,37806403,27.04294800830255,5260,4591,9851,+
chr22,37806404,26.17167062296881,4989,4529,9518,+
chr22,37806414,0.3980291630601239,426,652,1078,+
chr22,37806451,4.314709245793523,4126,5550,9676,+
chr22,37806452,4.419144702872242,4884,6511,11395,+
chr22,37806453,4.419144702872242,4884,6511,11395,+
chr22,37806664,1.8928390693730146,700,459,1159,+
chr22,37806837,1.648763786764706,805,743,1548,+
chr22,37806896,7.907277286567634,1574,1212,2786,+
chr22,37807113,5.830354241143971,1195,180,1375,+
chr22,37807114,5.8267716535433065,924,126,1050,+
chr22,37807115,9.244286313396392,3383,519,3902,+
chr22,37807116,11.234603075793704,1594,261,1855,+
chr22,37807117,9.36230727922191,2193,337,2530,+
chr22,37807118,7.881226053639847,934,144,1078,+
chr22,37807122,28.262612853197698,3580,644,4224,+
chr22,37807123,31.487258444194083,3284,596,3880,+
chr22,37807124,20.578019443071344,1863,356,2219,+
chr22,37807126,21.589506010891906,3349,2605,5954,+
chr22,37807127,20.226658237088095,2885,2522,5407,+
chr22,37807130,0.43891936841115187,2002,3010,5012,+
chr22,37807131,1.3286524141181677,3764,6129,9893,+
chr22,37807132,0.8822984465580476,3661,6618,10279,+
chr22,37807133,0.9502205297128358,6455,10062,16517,+
chr22,37807134,0.9531665574966988,4617,7453,12070,+
chr22,37807135,0.9093969235735254,3514,5930,9444,+
chr22,37807170,0.6020932927712589,664,707,1371,+
chr22,37807229,0.3470067397911986,690,804,1494,+
chr22,37849415,1.1790111921995248,928,767,1695,+
chr22,37849417,1.1191221273380871,1430,1221,2651,+
chr22,37849418,1.8960849369608486,784,684,1468,+
chr22,37849420,0.5180198005622001,1299,1004,2303,+
chr22,37849422,0.4949029465158498,885,692,1577,+
chr22,37849437,0.5986842105263158,636,531,1167,+
chr22,37849438,1.2726063001662338,2127,1566,3693,+
chr22,37849447,0.6113257921731188,790,661,1451,+
chr22,37849454,0.6897986712012283,1044,800,1844,+
chr22,37849465,0.6757590747414789,1303,953,2256,+
chr22,37849466,1.5074198180947824,3195,2088,5283,+
chr22,37849468,1.5074198180947824,3195,2088,5283,+
chr22,37850020,1.4786391499795668,2848,2446,5294,+
chr22,37850022,1.5949998158345247,4857,3809,8666,+
chr22,37850034,1.7643818849449204,1921,1590,3511,+
chr22,37855593,1.4480413150270812,1915,1400,3315,+
chr22,37863295,1.547314418207279,6625,4680,11305,+
chr22,37863296,1.5128854949151733,6604,4972,11576,+
chr22,37870191,1.6106629236138188,4134,3429,7563,+
chr22,37870260,1.2639252844901843,2111,1609,3720,+
chr22,37874393,1.7799570424277757,2661,2165,4826,+
chr22,37874417,0.7985074626865672,2099,1607,3706,+
chr22,37874501,1.6608285312273623,3079,2769,5848,+
chr22,37877673,0.7154498586396142,1194,858,2052,+
chr22,37877674,1.536573426573427,1021,649,1670,+
chr22,37877676,0.974315861687775,2937,1813,4750,+
chr22,37877677,2.2612546564159466,2328,1627,3955,+
chr22,37877679,2.2612546564159466,2328,1627,3955,+
chr22,37877683,1.038526392417287,3561,2492,6053,+
chr22,37877685,1.038526392417287,3561,2492,6053,+
chr22,37877692,1.3691760435571685,2027,1449,3476,+
chr22,37877748,1.7845584835876098,1543,1235,2778,+
chr22,37877784,1.391360294117647,1826,1427,3253,+
chr22,37877800,1.4068874671287295,6247,4615,10862,+
chr22,37877925,2.064744668911336,1014,527,1541,+
chr22,37877932,1.9567587209302328,1076,601,1677,+
chr22,37877941,2.113412075530344,1264,756,2020,+
chr22,37877944,1.5726923076923078,1362,831,2193,+
chr22,37877956,2.2561728395061733,1138,803,1941,+
chr22,37878034,1.7856023327865866,1323,929,2252,+
chr22,37878041,1.4665476026926778,1399,1003,2402,+
chr22,37878081,1.2948774509803922,2296,1599,3895,+
chr22,37878115,1.3402243023666551,1970,1489,3459,+
chr22,37886767,1.4828571899495406,4062,2512,6574,+
chr22,37886768,1.4783026515010929,6346,3760,10106,+
chr22,37886774,1.064746728075634,4521,3081,7602,+
chr22,37886800,1.4712065151719418,7365,4337,11702,+
chr22,37886802,1.4712065151719418,7365,4337,11702,+
chr22,37886804,1.5846991400723969,3452,2437,5889,+
chr22,37953721,0.4291371060881044,764,550,1314,+
chr22,37953722,0.4291371060881044,764,550,1314,+
chr22,37953782,2.4270414993306555,685,497,1182,+
chr22,37953784,2.4270414993306555,685,497,1182,+
chr22,37956790,1.115375503435205,855,602,1457,+
chr22,37956792,1.115375503435205,855,602,1457,+
chr22,37959406,2.1072060543819924,871,555,1426,+
chr22,38482607,2.2218286417059514,761,646,1407,+
chr22,38482632,2.0280280280280283,1012,998,2010,+
chr22,38482634,2.0280280280280283,1012,998,2010,+
chr22,38482904,2.5669604770721888,766,562,1328,+
chr22,39520561,0.8396854943051527,4918,2072,6990,+
chr22,39520562,0.9129162165914826,10682,4538,15220,+
chr22,39520563,0.931491221645468,8513,3612,12125,+
chr22,39520564,0.8185404604753056,8137,3264,11401,+
chr22,39520565,2.176548695303245,6959,2881,9840,+
chr22,39520567,2.068303329563861,7784,2989,10773,+
chr22,39520568,2.026489972101967,9827,4424,14251,+
chr22,39520583,1.804223433242507,1614,733,2347,+
chr22,39520589,1.8152480733125893,1893,1208,3101,+
chr22,39520610,1.865572333559106,1950,1320,3270,+
chr22,39520635,3.1135405690200213,1337,875,2212,+
chr22,39520644,1.5026819158802767,3542,2100,5642,+
chr22,39520726,0.6465665088838581,1884,1016,2900,+
chr22,39521429,1.864312736443884,1567,909,2476,+
chr22,39521442,1.5083748615725359,1766,902,2668,+
chr22,39521445,1.5857474974429928,3927,2291,6218,+
chr22,39521452,1.2656669979689725,2361,1584,3945,+
chr22,39521525,1.5098465643762506,4503,2997,7500,+
chr22,39521527,1.665890497829507,6910,4678,11588,+
chr22,39521528,1.5048466658464368,7027,4583,11610,+
chr22,39521546,0.8240719796566702,3762,2832,6594,+
chr22,39521599,1.4736463555397892,4635,3286,7921,+
chr22,39521607,1.5369522563767168,2599,1806,4405,+
chr22,39521791,1.110070059433955,4293,3197,7490,+
chr22,39521798,1.5691953987635716,2292,1585,3877,+
chr22,39521805,1.4146046096322342,2460,1809,4269,+
chr22,39521808,1.3343955184461889,5206,4090,9296,+
chr22,39521922,1.491929339974965,3167,2926,6093,+
chr22,39521934,0.9839500975701876,3356,2443,5799,+
chr22,39521936,0.9839500975701876,3356,2443,5799,+
chr22,39521989,1.482435768642539,9751,6866,16617,+
chr22,39521990,1.649376395962981,5015,3682,8697,+
chr22,39521992,0.7577919187349033,2844,1650,4494,+
chr22,39522024,1.4667430144100648,4086,2975,7061,+
chr22,39522080,1.5188089628984198,4033,2816,6849,+
chr22,39522210,0.9302207278605984,7463,4941,12404,+
chr22,39522271,1.4180501968468007,5509,3409,8918,+
chr22,39522396,1.7860585197934598,1152,580,1732,+
chr22,39522408,1.8765469464622009,1360,707,2067,+
chr22,39522411,1.5398808053359685,1634,1011,2645,+
chr22,39522425,1.6035471873167988,6470,4262,10732,+
chr22,39522438,1.3269360269360269,2251,1319,3570,+
chr22,39522540,1.416196128896709,1518,1312,2830,+
chr22,39522559,1.5761903500172227,2258,1550,3808,+
chr22,39522585,1.1657253539790111,13216,9983,23199,+
chr22,39522587,1.4054447715853997,5678,4622,10300,+
chr22,40349858,0.5594260523813639,808,502,1310,+
chr22,40349997,2.211527854384997,593,517,1110,+
chr22,40354257,2.548677881242367,852,567,1419,+
chr22,40354295,0.9815770081061163,591,471,1062,+
chr22,40354296,0.9815770081061163,591,471,1062,+
chr22,40360442,1.443205358194012,1138,891,2029,+
chr22,40360444,0.9588059701492537,802,669,1471,+
chr22,40361501,2.668163952835485,593,410,1003,+
chr22,40361502,2.668163952835485,593,410,1003,+
chr22,40361619,2.8709281823122086,1176,835,2011,+
chr22,40364319,2.192795836376917,1116,591,1707,+
chr22,40364321,2.1468212835795115,1684,907,2591,+
chr22,40364323,2.9539615846338534,1696,951,2647,+
chr22,40364324,2.9542635658914733,1132,644,1776,+
chr22,40364889,1.144204477460959,1278,969,2247,+
chr22,40364890,0.54051593323217,821,658,1479,+
chr22,40364946,1.9322408762720833,660,515,1175,+
chr22,40365006,2.077104642014162,959,655,1614,+
chr22,40365012,2.065243902439025,1128,819,1947,+
chr22,40404617,2.128314995974726,700,553,1253,+
chr22,40409306,0.9383859634595547,675,473,1148,+
chr22,40951451,2.605459572969932,768,699,1467,+
chr22,40951459,2.044539614561028,681,466,1147,+
chr22,40953555,1.2768250554124798,1706,1261,2967,+
chr22,40953556,1.8659330143540667,628,474,1102,+
chr22,40953557,1.0187570621468929,1287,884,2171,+
chr22,40953620,1.612064482579303,774,640,1414,+
chr22,40964048,0.5224304372515617,804,586,1390,+
chr22,40967803,3.3205128205128203,839,719,1558,+
chr22,40967823,1.6365131578947365,994,664,1658,+
chr22,41064447,1.3582474226804122,836,484,1320,+
chr22,41064449,1.3582474226804122,836,484,1320,+
chr22,41359952,0.1929718765418563,439,628,1067,+
chr22,41359954,0.2843898428936792,478,643,1121,+
chr22,41621312,0.6691663916969133,1858,1257,3115,+
chr22,41621313,0.6691663916969133,1858,1257,3115,+
chr22,41621314,0.6691663916969133,1858,1257,3115,+
chr22,41621319,0.8117842953961205,884,777,1661,+
chr22,41621320,0.6409948751527453,1470,1033,2503,+
chr22,41621994,1.6060822047992396,1247,1097,2344,+
chr22,41622001,1.7543538038496789,1715,1090,2805,+
chr22,41636542,1.4825581395348841,1109,887,1996,+
chr22,41636563,0.758410242731395,2153,1629,3782,+
chr22,41637613,1.0300947966619327,2010,1451,3461,+
chr22,41637622,1.6184718247242575,2578,1626,4204,+
chr22,41637707,2.5543434343434344,871,549,1420,+
chr22,41637712,1.560960061671658,1482,1162,2644,+
chr22,41637734,1.5172530446549388,2299,1477,3776,+
chr22,41646924,1.6991869918699187,1319,719,2038,+
chr22,41646930,1.662869592281357,721,458,1179,+
chr22,41646942,0.5815677966101696,1219,884,2103,+
chr22,41646949,1.4283279321035836,3418,2414,5832,+
chr22,41650783,1.5101994875427869,3455,2068,5523,+
chr22,41650784,1.5101994875427869,3455,2068,5523,+
chr22,41650830,0.6208717357910907,1114,867,1981,+
chr22,41653593,1.4960299003322257,1593,1203,2796,+
chr22,41653594,1.5073253874235428,2444,1865,4309,+
chr22,41653596,1.5004086302713304,1668,1287,2955,+
chr22,41653649,1.5914129743126024,1032,806,1838,+
chr22,41656937,0.6576453135651787,4222,2926,7148,+
chr22,41658265,1.6345783596457453,1414,741,2155,+
chr22,41658286,1.8316275998679432,1313,698,2011,+
chr22,41658291,2.557171213589992,1258,746,2004,+
chr22,41658292,2.557171213589992,1258,746,2004,+
chr22,41661348,1.9350073855243723,916,676,1592,+
chr22,41663657,1.6278093115374361,2127,1418,3545,+
chr22,41663659,0.6564664687523788,1077,905,1982,+
chr22,41663708,2.4459617180205417,1102,951,2053,+
chr22,41663710,1.648961635504949,1727,1065,2792,+
chr22,41663768,1.5715265530080342,745,566,1311,+
chr22,41695662,1.6746064779231582,743,479,1222,+
chr22,41695676,3.264233276213967,747,501,1248,+
chr22,41866854,1.8790777264968184,952,603,1555,+
chr22,41867204,2.765545606797656,773,567,1340,+
chr22,41870917,2.4276377217553686,779,458,1237,+
chr22,41870919,2.4276377217553686,779,458,1237,+
chr22,41875400,2.4095238095238094,703,419,1122,+
chr22,41875403,2.9447903014416776,718,435,1153,+
chr22,41875437,2.080498212432245,879,597,1476,+
chr22,41875542,1.7838419405320813,828,567,1395,+
chr22,41875546,1.9243454957740667,1866,1385,3251,+
chr22,41875548,1.9243454957740667,1866,1385,3251,+
chr22,41875549,0.6293229046852236,848,566,1414,+
chr22,41877981,1.7158658831662634,583,525,1108,+
chr22,41877983,1.8588067304893359,995,787,1782,+
chr22,41880716,3.0440399295361127,647,392,1039,+
chr22,41880718,3.0440399295361127,647,392,1039,+
chr22,41884849,1.9483380056067279,694,453,1147,+
chr22,41884872,1.6199217814669964,943,736,1679,+
chr22,41884956,1.0827773772820213,900,543,1443,+
chr22,41884975,2.404890218598006,792,563,1355,+
chr22,41893261,2.1446954377507246,934,645,1579,+
chr22,41894855,1.3359941231978758,575,434,1009,+
chr22,41903060,0.7882304311164426,694,544,1238,+
chr22,41903062,0.8344748975930598,587,476,1063,+
chr22,41905818,1.2318589801289197,692,515,1207,+
chr22,41905938,1.898469637997596,821,639,1460,+
chr22,41905976,3.4610643436500963,922,671,1593,+
chr22,41906276,5.184225339764796,997,290,1287,+
chr22,41906286,15.174492530328068,1185,483,1668,+
chr22,41906287,13.623869505458474,1505,613,2118,+
chr22,41906295,17.63714614234396,2702,2634,5336,+
chr22,41906296,17.637146142343962,2702,2634,5336,+
chr22,41906297,17.63714614234396,2702,2634,5336,+
chr22,41906353,0.49456807524676005,523,569,1092,+
chr22,41906479,5.56535630134563,965,789,1754,+
chr22,41906480,6.14241336482669,1342,1102,2444,+
chr22,41907202,2.2406876790830945,781,348,1129,+
chr22,41907203,2.71125787225855,2080,1102,3182,+
chr22,41907209,2.335180802870874,1250,737,1987,+
chr22,41907210,3.1109197876309365,1083,605,1688,+
chr22,41907212,3.491606714628297,727,416,1143,+
chr22,41907220,9.424951549055752,4462,3375,7837,+
chr22,41907221,7.173604968826789,6174,4873,11047,+
chr22,41907222,8.258068779042913,4439,3550,7989,+
chr22,41907223,5.378273595903357,4504,3678,8182,+
chr22,42082009,0.9441113550638968,1368,1145,2513,+
chr22,42082010,0.9441113550638968,1368,1145,2513,+
chr22,42082026,0.6338220526210083,1017,765,1782,+
chr22,43151558,0.6328005526243096,1019,537,1556,+
chr22,43151562,2.0774251287561833,883,535,1418,+
chr22,43151577,1.962006107118564,781,491,1272,+
chr22,43159231,1.934708510670677,831,626,1457,+
chr22,43159352,1.903940178314639,661,365,1026,+
chr22,43159404,2.3942652329749103,834,464,1298,+
chr22,43159407,1.4389282899921196,912,516,1428,+
chr22,43161062,0.5909346670834636,555,456,1011,+
chr22,43161072,1.874390838206628,904,607,1511,+
chr22,43161075,2.540404858299595,580,474,1054,+
chr22,43161093,0.5105633802816901,1159,709,1868,+
chr22,43161140,2.9610389610389616,607,538,1145,+
chr22,43161178,0.4176325289758692,627,553,1180,+
chr22,43161179,1.1798499582558937,1768,1251,3019,+
chr22,43162816,1.5099927513720617,633,521,1154,+
chr22,43162890,1.796100818612667,724,421,1145,+
chr22,43162898,0.990630511463845,1633,895,2528,+
chr22,43162899,0.990630511463845,1633,895,2528,+
chr22,43162927,1.8677601809954751,1880,1169,3049,+
chr22,43162929,1.5275164982134102,2373,1665,4038,+
chr22,43163041,2.251344086021505,669,371,1040,+
chr22,43163042,2.828034682080925,926,691,1617,+
chr22,43163043,2.828034682080925,926,691,1617,+
chr22,43163084,1.3738909531401198,2485,1670,4155,+
chr22,43163085,1.2831392329945848,1673,1036,2709,+
chr22,43163158,0.6224690111615907,1073,848,1921,+
chr22,43645280,0.34733367561354206,788,578,1366,+
chr22,43972304,0.642412419060269,736,633,1369,+
chr22,44093977,1.9586016538684605,2424,1815,4239,+
chr22,44093978,1.6642363736946886,2294,1790,4084,+
chr22,44093981,1.6855072342680033,5011,3902,8913,+
chr22,44093982,1.8347613370888296,3788,2982,6770,+
chr22,45181300,1.424975848209824,891,587,1478,+
chr22,45181301,1.7334539577648869,674,439,1113,+
chr22,45181306,2.8983237489294016,1007,742,1749,+
chr22,45181307,2.8983237489294016,1007,742,1749,+
chr22,45181317,0.3699626630867978,1160,655,1815,+
chr22,45181319,1.7032516351068823,1491,1012,2503,+
chr22,45503031,4.7436843854314885,663,394,1057,+
chr22,45518721,2.7217848267328715,1872,1363,3235,+
chr22,45518723,2.305429553264605,1197,969,2166,+
chr22,45518726,2.0779092702169626,601,506,1107,+
chr22,45518733,2.051024046168385,1500,1035,2535,+
chr22,45518736,2.075892857142857,774,503,1277,+
chr22,45525543,1.608695652173913,811,643,1454,+
chr22,45525646,2.4355742296918765,751,671,1422,+
chr22,45525648,1.787351560342447,808,425,1233,+
chr22,45527903,1.7205357142857145,860,671,1531,+
chr22,45527907,1.66848635235732,983,779,1762,+
chr22,45527977,2.2694524495677237,1679,1387,3066,+
chr22,45531291,1.5044638245444817,2225,1789,4014,+
chr22,45531307,1.3703187011272313,2183,1670,3853,+
chr22,45533083,0.4232616212063004,677,547,1224,+
chr22,45533760,1.8010001470804529,789,522,1311,+
chr22,45533801,3.342299349240781,641,460,1101,+
chr22,45533803,0.6826982553360956,2301,1456,3757,+
chr22,45533804,0.6826982553360956,2301,1456,3757,+
chr22,45535199,1.467852918145316,1420,1052,2472,+
chr22,45541245,0.7539453211824849,2119,1635,3754,+
chr22,45542197,1.7622682660850597,1009,785,1794,+
chr22,45542222,1.466468253968254,1166,719,1885,+
chr22,45547084,1.6745612783563992,1066,814,1880,+
chr22,45547086,1.5804821150855366,812,642,1454,+
chr22,45547087,1.7569996506621781,1744,1427,3171,+
chr22,45548612,2.7637556789500253,1094,848,1942,+
chr22,45548665,1.2051505250801433,1701,1145,2846,+
chr22,45548668,1.8086529741338928,1913,1316,3229,+
chr22,45550496,0.5907575917892287,970,726,1696,+
chr22,45550592,2.294690412782956,1312,750,2062,+
chr22,45550596,1.7720586097624793,1716,1165,2881,+
chr22,45550602,1.966660423300244,1399,842,2241,+
chr22,45562937,0.5611491232044951,1031,760,1791,+
chr22,45562975,2.2916944407412347,572,576,1148,+
chr22,45562999,1.510808069705887,1549,1201,2750,+
chr22,45563098,1.8635404175470913,1445,950,2395,+
chr22,45563102,2.4594594594594588,727,517,1244,+
chr22,45563188,1.8646307237744904,3882,2690,6572,+
chr22,45563189,1.8646307237744904,3882,2690,6572,+
chr22,45563246,1.3625954198473282,1257,1047,2304,+
chr22,45600486,2.197465201288146,753,503,1256,+
chr22,45600523,2.454762970302318,647,567,1214,+
chr22,45672160,0.871991576413959,681,553,1234,+
chr22,45672162,0.871991576413959,681,553,1234,+
chr22,45689712,1.271105355515311,727,614,1341,+
chr22,45689766,1.5511669658886893,767,556,1323,+
chr22,45700299,0.3869741729290835,839,680,1519,+
chr22,45700330,0.5827650755448589,757,553,1310,+
chr22,45700331,1.5579227696404794,909,750,1659,+
chr22,45702697,1.6348045397225728,925,609,1534,+
chr22,45702712,0.6677322869216838,1186,958,2144,+
chr22,45718417,0.6538323865847016,1166,904,2070,+
chr22,45718439,1.7300970873786408,1055,823,1878,+
chr22,45729453,1.910755813953488,938,644,1582,+
chr22,45729496,2.1939727463312373,1020,794,1814,+
chr22,45738734,2.1078381147540983,632,487,1119,+
chr22,45738743,1.8788673621460503,2162,1524,3686,+
chr22,45738744,1.8788673621460503,2162,1524,3686,+
chr22,45738745,1.8788673621460503,2162,1524,3686,+
chr22,45738769,0.6287562604340567,785,598,1383,+
chr22,45738770,1.5958471760797344,738,601,1339,+
chr22,45740372,0.5540435458786935,749,642,1391,+
chr22,45740416,1.6597933257489572,744,585,1329,+
chr22,45740455,2.8042874156411277,882,686,1568,+
chr22,45807012,1.9812749842204924,875,678,1553,+
chr22,45843009,1.6529171311780009,833,620,1453,+
chr22,45843020,1.6110526570171053,1632,1294,2926,+
chr22,45843740,1.458574768730304,1476,1092,2568,+
chr22,46675519,1.625732585167823,595,483,1078,+
chr22,46678051,1.8639900515701144,610,498,1108,+
chr22,46678803,3.6934614189453434,651,416,1067,+
chr22,46679265,4.540629598035173,736,587,1323,+
chr22,46679266,4.540629598035173,736,587,1323,+
chr22,46679577,1.8597518610421835,913,649,1562,+
chr22,49961714,0.7612378976486859,628,481,1109,+
chr22,49961716,0.7612378976486859,628,481,1109,+
chr22,49962945,2.37834092838641,664,427,1091,+
chr22,49963188,2.352027412003039,871,565,1436,+
chr22,49963573,0.7071590451479113,727,542,1269,+
chr22,49963712,32.61689861482951,2911,1506,4417,+
chr22,49963713,32.616898614829516,2911,1506,4417,+
chr22,49963714,32.616898614829516,2911,1506,4417,+
chr22,49963792,0.4122621564482029,610,472,1082,+
chr22,49963805,1.0540958268933538,857,646,1503,+
chr22,49963806,1.0540958268933538,857,646,1503,+
chr22,49963832,0.6480872069107363,821,571,1392,+
chr22,49963861,1.6157565415244597,896,585,1481,+
chr22,50438623,2.6319682409049445,652,483,1135,+
chr22,50438624,3.449302663496794,668,517,1185,+
chrX,7190955,1.8064199113616681,709,544,1253,+
chrX,7334027,1.7806200720303107,704,599,1303,+
chrX,7350591,1.413393414563179,620,389,1009,+
chrX,7351433,7.082886264501436,640,466,1106,+
chrX,7352880,3.042461885940147,928,769,1697,+
chrX,7352881,3.2302636049053834,1752,1541,3293,+
chrX,7352882,3.2302636049053834,1752,1541,3293,+
chrX,7352883,3.420681423611111,1260,1151,2411,+
chrX,7352885,4.614991683358762,945,901,1846,+
chrX,9719235,1.1766784452296821,1109,565,1674,+
chrX,9719236,1.1766784452296821,1109,565,1674,+
chrX,9719237,1.1766784452296821,1109,565,1674,+
chrX,9719279,2.0951304085632443,1068,736,1804,+
chrX,12799374,0.6825660897526759,743,591,1334,+
chrX,12826678,0.821512673474178,1340,770,2110,+
chrX,12826680,1.4827650111193476,888,567,1455,+
chrX,12826682,1.6548179560532483,2070,1361,3431,+
chrX,12826684,1.61990637710076,626,470,1096,+
chrX,12975107,1.0418753822098532,39019,28257,67276,+
chrX,12975108,1.0757122770139758,9566,7071,16637,+
chrX,12975109,1.0418753822098534,39019,28257,67276,+
chrX,12976877,2.3060465116279074,803,429,1232,+
chrX,12976890,1.6449006896984215,1818,1070,2888,+
chrX,12976900,1.5434930343187223,1579,980,2559,+
chrX,12976909,1.2479158007345275,4044,2604,6648,+
chrX,12976915,1.3287002649379716,3996,2372,6368,+
chrX,12976918,0.7765816374476616,2720,1806,4526,+
chrX,12976920,1.6157365960409829,2194,1116,3310,+
chrX,12976942,1.3113499029338582,2639,1502,4141,+
chrX,12976944,1.4217421223614513,3640,1964,5604,+
chrX,12976945,1.3422439759036144,2874,1659,4533,+
chrX,12976947,0.9770625209399352,21726,13868,35594,+
chrX,12976948,1.0074428044027228,8572,4607,13179,+
chrX,12976949,1.0945121481213136,13244,8828,22072,+
chrX,12976951,1.3320998157530703,10084,5601,15685,+
chrX,12976952,1.3320998157530703,10084,5601,15685,+
chrX,12976955,0.7398579321231255,4686,3438,8124,+
chrX,12976959,1.8492086464522892,4368,2860,7228,+
chrX,12977055,3.2711913453833135,9796,2041,11837,+
chrX,12977056,3.2711913453833135,9796,2041,11837,+
chrX,12977069,84.34671480871631,38316,18857,57173,+
chrX,12977070,84.34671480871631,38316,18857,57173,+
chrX,12977085,0.6669507136149637,4626,3656,8282,+
chrX,13708724,1.773654597709322,878,457,1335,+
chrX,13708725,1.4307196562835658,1035,531,1566,+
chrX,13708727,2.0271105010295125,715,375,1090,+
chrX,13708729,1.2950151062594033,737,464,1201,+
chrX,13708742,1.8509725400457662,718,436,1154,+
chrX,13709021,1.5325171475528983,1595,1150,2745,+
chrX,13709116,4.87784679089027,759,482,1241,+
chrX,13709242,1.8220461245850508,1121,744,1865,+
chrX,16735300,2.348304600964137,798,535,1333,+
chrX,16735301,1.809090909090909,596,439,1035,+
chrX,16760251,1.1244608749229823,802,540,1342,+
chrX,16760252,2.0725330059677853,1196,822,2018,+
chrX,16760274,0.70052872576019,794,617,1411,+
chrX,16843510,1.1242668691803104,1082,767,1849,+
chrX,16843511,1.0596776674336925,853,583,1436,+
chrX,17754273,1.7083333333333333,696,407,1103,+
chrX,17754580,1.9703216408733641,934,667,1601,+
chrX,19349313,1.3787847646625149,596,439,1035,+
chrX,19349994,2.656538252848617,815,678,1493,+
chrX,19349995,2.656538252848617,815,678,1493,+
chrX,19350004,1.1457099151717425,957,798,1755,+
chrX,19350005,1.034182986269325,2595,2074,4669,+
chrX,19350006,0.5418982872596153,994,831,1825,+
chrX,19351357,0.9457135838860232,1099,827,1926,+
chrX,19351358,0.9457135838860232,1099,827,1926,+
chrX,19354506,2.9680731589924596,924,541,1465,+
chrX,19354507,2.9680731589924596,924,541,1465,+
chrX,19354527,0.9691768744222343,1637,1105,2742,+
chrX,19354532,1.7031546403785907,1085,751,1836,+
chrX,19354536,1.7307692307692308,1535,1039,2574,+
chrX,19354537,1.6957930491956121,2282,1514,3796,+
chrX,19355355,1.6798704534130544,612,445,1057,+
chrX,19355370,2.4885327438518927,710,516,1226,+
chrX,19355409,1.864744712380439,768,570,1338,+
chrX,19355412,0.621849710982659,977,691,1668,+
chrX,19355414,1.8294804871986081,919,595,1514,+
chrX,19355447,1.1085025460623825,1992,1372,3364,+
chrX,19355691,1.8988005997001505,893,551,1444,+
chrX,19358945,2.016457680250784,746,521,1267,+
chrX,19359606,0.4769230769230769,712,459,1171,+
chrX,19359689,1.756989247311828,930,650,1580,+
chrX,19359723,0.9978735550164121,1370,1273,2643,+
chrX,19359724,0.9978735550164121,1370,1273,2643,+
chrX,21940820,3.2284873203901383,1365,911,2276,+
chrX,21940821,2.686757968902006,1118,776,1894,+
chrX,21940822,2.6616541353383463,766,454,1220,+
chrX,21967213,1.0413379454261706,1137,771,1908,+
chrX,21967214,0.5002826455624647,884,579,1463,+
chrX,21967266,2.129319955406912,954,623,1577,+
chrX,21967283,0.6020777177718729,2852,1708,4560,+
chrX,21967284,0.6020777177718729,2852,1708,4560,+
chrX,21967285,0.6061152973163828,3563,2060,5623,+
chrX,21967297,1.7725475357109073,2867,1704,4571,+
chrX,21967299,1.7725475357109073,2867,1704,4571,+
chrX,21967301,0.5896490051419628,1054,496,1550,+
chrX,21967302,1.3893271970195047,1635,1013,2648,+
chrX,21971903,0.5142957171198507,677,450,1127,+
chrX,21972510,2.2415412902777057,1087,692,1779,+
chrX,21984306,2.254156010230179,640,390,1030,+
chrX,21984310,1.847475961538461,808,639,1447,+
chrX,21984319,1.705225007550589,940,601,1541,+
chrX,21984321,2.1740467404674044,706,541,1247,+
chrX,21992616,2.356555901791175,935,592,1527,+
chrX,21992654,1.9140338827838828,726,415,1141,+
chrX,21994356,1.5318840435628804,1236,805,2041,+
chrX,21994380,2.085036057692308,770,511,1281,+
chrX,21994381,2.067117775800615,1458,976,2434,+
chrX,21994407,2.2853855005753743,661,394,1055,+
chrX,21994584,1.8181818181818183,703,483,1186,+
chrX,21994585,2.0368589743589745,712,597,1309,+
chrX,21994607,0.5222948523403759,941,658,1599,+
chrX,21994675,1.3117726569070502,3165,2282,5447,+
chrX,21994729,1.1080612557496639,1277,957,2234,+
chrX,23075837,2.0547794211007773,1200,890,2090,+
chrX,23075840,1.3002802756723983,869,617,1486,+
chrX,23667523,0.7488180567699483,1624,892,2516,+
chrX,23667549,2.0555320247881457,2075,1278,3353,+
chrX,23667550,1.9293487359785702,803,542,1345,+
chrX,23667597,2.0238119092558344,949,675,1624,+
chrX,23667599,2.0187620889748548,851,469,1320,+
chrX,23667631,3.399694572431246,1547,1141,2688,+
chrX,23667634,2.0655679603048025,751,593,1344,+
chrX,23667712,2.0893553223388306,870,579,1449,+
chrX,23667730,1.674242424242424,662,575,1237,+
chrX,23667784,0.6479138984852513,902,709,1611,+
chrX,23667793,1.7680990356676087,2790,2099,4889,+
chrX,23667797,1.070670162215304,2840,1794,4634,+
chrX,23667798,1.070670162215304,2840,1794,4634,+
chrX,23679164,1.6400325027085592,1383,922,2305,+
chrX,23679168,1.045953275393646,4563,3227,7790,+
chrX,23686285,1.548626119172584,911,789,1700,+
chrX,23686286,0.6886770300098625,1691,1193,2884,+
chrX,23783183,0.46308324914421123,871,781,1652,+
chrX,23783197,1.4509666476409266,859,602,1461,+
chrX,23783201,1.3558474108479328,1457,1248,2705,+
chrX,23783203,1.3558474108479328,1457,1248,2705,+
chrX,23783304,1.4334858188472095,3916,3278,7194,+
chrX,23783305,1.4334858188472095,3916,3278,7194,+
chrX,23783331,1.4973482981624386,4740,3226,7966,+
chrX,23783333,1.5297067724625515,3268,2312,5580,+
chrX,23783334,1.526825606703045,3959,2717,6676,+
chrX,23783339,0.6974374437309007,3432,2702,6134,+
chrX,23783347,0.8165429480381761,3849,2869,6718,+
chrX,23783349,1.4437595560555767,4404,2930,7334,+
chrX,23783356,0.787527153926415,4897,3438,8335,+
chrX,23783670,2.2611826723959347,20336,17226,37562,+
chrX,23783671,1.8483453012812978,35231,29100,64331,+
chrX,23783672,1.1435508529551588,9021,7056,16077,+
chrX,23783682,1.5775711219978066,17635,15790,33425,+
chrX,23783683,1.6636416730560062,38498,35911,74409,+
chrX,23783684,1.5775711219978066,17635,15790,33425,+
chrX,23783831,1.45944817300522,3167,2234,5401,+
chrX,23784085,2.3506921416170203,1087,517,1604,+
chrX,23784118,2.249297529040294,1687,932,2619,+
chrX,23784120,2.134449208723986,3848,2071,5919,+
chrX,23784122,2.1046784583469806,2786,1703,4489,+
chrX,23784123,2.0148590441303837,3373,1950,5323,+
chrX,23784356,2.185584649553196,1161,710,1871,+
chrX,23784443,1.5412306747151736,575,435,1010,+
chrX,23784675,1.5465721715630343,1236,742,1978,+
chrX,23784676,1.2648318042813456,1033,653,1686,+
chrX,23784677,1.2648318042813456,1033,653,1686,+
chrX,23784686,1.0422732466000808,807,630,1437,+
chrX,23784688,1.0422732466000808,807,630,1437,+
chrX,23784730,0.4120458653595332,1674,1043,2717,+
chrX,23784737,0.8098419606958506,2805,1611,4416,+
chrX,23784738,0.8098419606958506,2805,1611,4416,+
chrX,23784739,0.8098419606958506,2805,1611,4416,+
chrX,23785722,1.6512705175953533,1975,1588,3563,+
chrX,23785735,0.8010304293320383,6574,4392,10966,+
chrX,23785736,1.0501189131732542,11104,8315,19419,+
chrX,23785737,1.2319888896725695,24063,18947,43010,+
chrX,23785738,1.2319888896725695,24063,18947,43010,+
chrX,23785741,0.826555497388884,4707,3467,8174,+
chrX,23785777,2.225891399092802,18580,14667,33247,+
chrX,23785836,1.2665677764877588,4952,3811,8763,+
chrX,23785996,1.6515287769784173,3672,3279,6951,+
chrX,24057424,0.5484342540586289,1295,633,1928,+
chrX,24057425,0.8401275265422353,1985,978,2963,+
chrX,24057427,2.008941877794337,1347,670,2017,+
chrX,24057432,1.520171082677879,931,586,1517,+
chrX,24057434,1.055349984582177,1664,845,2509,+
chrX,24057435,1.055349984582177,1664,845,2509,+
chrX,24057632,1.785632688927944,5243,3413,8656,+
chrX,24057634,1.760493115305052,10860,6954,17814,+
chrX,24057635,1.7811857584458346,5482,3670,9152,+
chrX,24057692,0.6860559372536742,2152,1582,3734,+
chrX,24062431,1.6692160611854685,581,522,1103,+
chrX,24062432,2.0385154061624653,1311,1343,2654,+
chrX,24062433,2.0385154061624653,1311,1343,2654,+
chrX,24062434,1.6268266420550686,660,590,1250,+
chrX,24062442,0.8253344678515394,3313,2690,6003,+
chrX,24062444,0.9870700829983096,2479,1862,4341,+
chrX,24067973,1.3672133753742617,687,516,1203,+
chrX,24067975,1.735939594947428,983,765,1748,+
chrX,24067977,1.84237641129135,3004,2246,5250,+
chrX,24067979,2.091415830546265,1035,850,1885,+
chrX,24067980,1.9693263258480649,556,454,1010,+
chrX,24068004,0.7083073857267406,1814,1294,3108,+
chrX,24071580,3.1851211072664363,1051,577,1628,+
chrX,24071581,3.1851211072664363,1051,577,1628,+
chrX,24071611,1.4952760862122505,1686,1256,2942,+
chrX,24073091,1.5045968012694326,695,439,1134,+
chrX,24073093,1.6349765401379133,777,504,1281,+
chrX,24073124,2.0321566855531357,1974,1410,3384,+
chrX,24073126,1.3178687930409567,1817,1332,3149,+
chrX,24073127,1.1306941431670283,1250,921,2171,+
chrX,24073131,1.9972677595628416,713,548,1261,+
chrX,24073154,1.5401568128840857,1263,857,2120,+
chrX,24076743,1.7540615949706864,1398,1088,2486,+
chrX,24076744,1.7540615949706864,1398,1088,2486,+
chrX,24076745,2.4930069930069934,712,532,1244,+
chrX,24076746,2.4930069930069934,712,532,1244,+
chrX,24076751,0.46258935140586005,971,624,1595,+
chrX,24076835,0.4809242008450477,1884,1172,3056,+
chrX,24076940,2.0839808046863513,1884,1184,3068,+
chrX,24076941,2.483550433659205,2151,1408,3559,+
chrX,24076943,4.1089743589743595,640,431,1071,+
chrX,24076944,1.9838554679992315,793,472,1265,+
chrX,24076946,1.8397877984084883,1155,714,1869,+
chrX,24076948,1.1292977758218767,1516,1063,2579,+
chrX,24076953,0.6774716962082985,2696,1952,4648,+
chrX,24076954,0.6873621489943049,2319,1641,3960,+
chrX,24077171,0.844506491535976,2381,1256,3637,+
chrX,24077172,0.8230500390608938,1651,828,2479,+
chrX,24077173,0.9500829467979582,2349,1230,3579,+
chrX,24077174,1.2858846918489064,1022,502,1524,+
chrX,24077177,1.643853778561634,995,531,1526,+
chrX,24077192,2.2839834515366433,1309,939,2248,+
chrX,24077193,2.0409742384575127,2742,1904,4646,+
chrX,24077334,0.7795335037620071,2280,1486,3766,+
chrX,24077335,1.2491230889442013,2255,1539,3794,+
chrX,24077336,1.3933466291469734,1353,881,2234,+
chrX,24077555,1.6520763187429854,735,593,1328,+
chrX,24077656,2.36441893830703,720,573,1293,+
chrX,24077733,1.5643141554619426,752,558,1310,+
chrX,24077782,1.1546338922781918,2692,1942,4634,+
chrX,24077783,1.4563311373764771,1178,793,1971,+
chrX,24078339,1.7310696463441095,590,418,1008,+
chrX,24078418,1.8992693114670196,1118,722,1840,+
chrX,24078473,0.3923007450891849,694,411,1105,+
chrX,24704419,0.5080927749040547,608,460,1068,+
chrX,24704424,2.087068965517241,806,579,1385,+
chrX,24704425,2.1546570169918184,1244,907,2151,+
chrX,24704427,2.043413533112424,850,630,1480,+
chrX,24716945,2.1794112001719794,567,441,1008,+
chrX,30617466,1.1403508771929824,662,341,1003,+
chrX,30617473,2.7892995292911404,854,498,1352,+
chrX,30617474,2.7892995292911404,854,498,1352,+
chrX,30630929,0.6324524312896407,1157,859,2016,+
chrX,33041546,0.8469680864028352,1092,845,1937,+
chrX,38804283,0.34720953075133193,884,773,1657,+
chrX,38805182,2.129120879120879,699,391,1090,+
chrX,38805183,3.955019476280539,1255,878,2133,+
chrX,38805384,2.584375,826,479,1305,+
chrX,38805385,2.584375,826,479,1305,+
chrX,38805661,9.273624450903979,964,815,1779,+
chrX,38805662,8.734954294719747,1149,903,2052,+
chrX,38805663,14.057542088870715,798,724,1522,+
chrX,38805727,7.817642712352057,958,682,1640,+
chrX,38805728,7.059984168038292,1536,1186,2722,+
chrX,38805976,1.1053652230122817,569,475,1044,+
chrX,38805978,1.1053652230122817,569,475,1044,+
chrX,38806327,2.077364994255075,677,372,1049,+
chrX,38806337,1.6206060606060604,763,439,1202,+
chrX,40588996,2.116515635453236,653,572,1225,+
chrX,40589046,1.2869226462535073,778,556,1334,+
chrX,40589069,2.0877970866490907,774,517,1291,+
chrX,40591236,2.9994166163356755,1077,662,1739,+
chrX,40591238,2.8494133885438235,793,482,1275,+
chrX,40599697,0.5485350033549542,653,525,1178,+
chrX,40606386,1.0852385944820968,1453,1071,2524,+
chrX,40606482,2.095428001709158,612,412,1024,+
chrX,41337435,1.370373748245058,781,539,1320,+
chrX,41337451,1.13431790357286,660,491,1151,+
chrX,41341554,0.5420743639921722,830,510,1340,+
chrX,41344030,0.35416666666666663,764,623,1387,+
chrX,41344031,2.352980132450331,626,452,1078,+
chrX,41344038,0.6240433673469388,823,511,1334,+
chrX,41344053,0.653405572755418,1406,1019,2425,+
chrX,41344054,1.4625746383947664,3468,2868,6336,+
chrX,41344055,1.4625746383947664,3468,2868,6336,+
chrX,41344056,1.4250395041480954,4881,3770,8651,+
chrX,41344105,1.5140902333390784,1363,869,2232,+
chrX,41344111,0.641025641025641,829,497,1326,+
chrX,41344377,1.8063552996374488,604,520,1124,+
chrX,41345469,1.6819493097053368,652,421,1073,+
chrX,41345500,4.911246855910886,803,505,1308,+
chrX,41346263,2.823359073359073,649,443,1092,+
chrX,41346274,1.5376623376623375,719,494,1213,+
chrX,41346390,2.078181591107781,639,470,1109,+
chrX,41347657,0.4466813315030886,649,436,1085,+
chrX,41347679,1.8633475806686475,1007,708,1715,+
chrX,41347714,1.8923482849604218,651,378,1029,+
chrX,41347880,2.477637315369869,1391,1190,2581,+
chrX,41347882,2.711535546460512,831,732,1563,+
chrX,41348117,4.278145695364239,968,603,1571,+
chrX,41348199,1.5133887538552668,4193,4244,8437,+
chrX,41348201,1.1928577574662018,7723,6724,14447,+
chrX,41348622,0.6448042870456664,1024,739,1763,+
chrX,41348761,1.5384548611111113,957,639,1596,+
chrX,41348833,2.7572406529752502,747,632,1379,+
chrX,41348836,1.8832502304069614,1716,1387,3103,+
chrX,41349023,1.7231674018063432,585,528,1113,+
chrX,41349067,1.961930326217496,1174,817,1991,+
chrX,41349081,1.630540037243948,795,536,1331,+
chrX,41349354,0.6230376766091053,634,489,1123,+
chrX,41349437,2.9829457364341083,591,429,1020,+
chrX,41349974,1.951996026051235,1820,1361,3181,+
chrX,47185339,1.6974562272523437,607,405,1012,+
chrX,47185441,0.26764735928082545,654,501,1155,+
chrX,47185442,0.26764735928082545,654,501,1155,+
chrX,47193832,1.0387617780279033,923,880,1803,+
chrX,47198846,1.2493865581423185,613,538,1151,+
chrX,47198848,1.2493865581423185,613,538,1151,+
chrX,47199057,2.7057481751824817,658,410,1068,+
chrX,47199251,2.2001100788414627,1233,800,2033,+
chrX,47199253,1.7477647058823529,618,424,1042,+
chrX,47199294,0.889967637540453,714,514,1228,+
chrX,47199296,0.889967637540453,714,514,1228,+
chrX,47199506,2.361247039200638,850,567,1417,+
chrX,47200966,18.595501365213106,745,507,1252,+
chrX,47201505,1.2426592846162927,935,769,1704,+
chrX,47201569,1.9719545632589108,867,554,1421,+
chrX,47201595,2.0418246374195097,916,572,1488,+
chrX,47202176,1.7537876118666762,731,616,1347,+
chrX,47202242,0.5307308970099668,638,601,1239,+
chrX,47202380,1.7061363564036507,1284,891,2175,+
chrX,47202976,0.2561241814212952,703,433,1136,+
chrX,47203143,0.5022473877765454,716,462,1178,+
chrX,47203573,0.35196072503530923,2729,1177,3906,+
chrX,47203574,0.35418826864311137,2028,890,2918,+
chrX,47203577,0.5121686655666395,1058,380,1438,+
chrX,47203595,8.380820298367702,1069,293,1362,+
chrX,47203610,22.20062966700691,4233,2265,6498,+
chrX,47203611,22.20062966700691,4233,2265,6498,+
chrX,47203612,9.66891757256404,1732,960,2692,+
chrX,47203614,8.222907696552195,2910,2613,5523,+
chrX,47203615,4.349921677310519,949,771,1720,+
chrX,47203627,0.9377298350557576,2071,1970,4041,+
chrX,47203648,0.4526884779516359,467,702,1169,+
chrX,47205949,1.7151251526251523,774,545,1319,+
chrX,47205953,0.4465116279069768,575,429,1004,+
chrX,47205984,2.0474950690335305,810,506,1316,+
chrX,47206061,1.9418382913806256,598,436,1034,+
chrX,47206270,0.3791709598161211,597,406,1003,+
chrX,47206382,2.32686170212766,672,469,1141,+
chrX,47210079,1.0757160356997024,682,552,1234,+
chrX,47210081,1.0757160356997024,682,552,1234,+
chrX,47210843,2.2485020740513137,886,565,1451,+
chrX,47210844,2.2485020740513137,886,565,1451,+
chrX,47210901,2.296875,692,395,1087,+
chrX,47210905,1.8194243114516462,763,438,1201,+
chrX,47211153,1.578571428571428,818,489,1307,+
chrX,47211176,1.5222816399286987,853,560,1413,+
chrX,47212446,1.0793016619103577,1036,804,1840,+
chrX,47212447,2.049817547199746,679,572,1251,+
chrX,47212448,1.0793016619103577,1036,804,1840,+
chrX,47212782,0.5723211141350318,3038,2400,5438,+
chrX,47212783,1.0011684606067186,3213,2473,5686,+
chrX,47212789,1.6116451612903226,1062,774,1836,+
chrX,47212996,1.701111249993328,1203,796,1999,+
chrX,47213109,1.6420751692885402,2585,1687,4272,+
chrX,47213110,1.9418029075026186,2413,1600,4013,+
chrX,47214327,1.5605515587529977,821,555,1376,+
chrX,47214382,1.578939393939394,1225,879,2104,+
chrX,47214390,2.5016707364092015,1365,1003,2368,+
chrX,47214395,1.8664131123788825,3030,2453,5483,+
chrX,47214396,1.8664131123788825,3030,2453,5483,+
chrX,47214552,1.7146825396825398,595,479,1074,+
chrX,47214587,1.7820728720146968,750,567,1317,+
chrX,47214906,1.945619047619048,658,374,1032,+
chrX,47215058,2.8029658323569917,699,662,1361,+
chrX,47228590,1.414004232185071,842,595,1437,+
chrX,47240587,2.0409160670012136,1423,933,2356,+
chrX,47240607,1.8515919205751457,745,507,1252,+
chrX,47240608,1.9455608718766613,1306,683,1989,+
chrX,47240609,1.9455608718766613,1306,683,1989,+
chrX,47240611,1.7259796027911969,871,647,1518,+
chrX,47240618,1.7095774188285202,805,453,1258,+
chrX,47247614,1.3739917371630928,581,441,1022,+
chrX,47569012,3.0818692641520395,876,471,1347,+
chrX,47569016,2.423554693298922,721,425,1146,+
chrX,47569021,2.372147879080642,664,422,1086,+
chrX,47582404,1.7004231827889953,598,449,1047,+
chrX,47583507,1.6623532231008864,990,534,1524,+
chrX,47583522,1.490995260663507,1088,632,1720,+
chrX,47584935,1.0000175167976444,1247,1023,2270,+
chrX,47584963,1.5034413535990825,1164,950,2114,+
chrX,47585559,2.819905213270142,594,421,1015,+
chrX,47585566,2.375425318089929,1141,918,2059,+
chrX,47585571,0.5482954545454546,578,461,1039,+
chrX,47585634,1.627017132008656,1761,1272,3033,+
chrX,47585635,1.5707762557077625,1183,875,2058,+
chrX,47585656,1.848,758,499,1257,+
chrX,47586547,0.7939068100358423,1328,1079,2407,+
chrX,47586548,0.7939068100358423,1328,1079,2407,+
chrX,47586600,1.580930324084586,1470,1158,2628,+
chrX,47586601,0.6133662369057211,640,583,1223,+
chrX,47586602,1.6148822337939734,2270,1691,3961,+
chrX,47586680,1.6918510523475443,759,435,1194,+
chrX,47586681,0.3782520838595605,598,427,1025,+
chrX,47586683,2.0817685690500416,681,568,1249,+
chrX,47586689,0.4461343472750317,527,525,1052,+
chrX,48478081,1.1246046279743975,682,466,1148,+
chrX,48478125,1.17322022240055,1504,714,2218,+
chrX,48478126,1.17322022240055,1504,714,2218,+
chrX,48478127,1.17322022240055,1504,714,2218,+
chrX,48478129,2.051948051948052,631,391,1022,+
chrX,48478138,1.6205357142857142,725,461,1186,+
chrX,48478147,0.6421187952565851,978,732,1710,+
chrX,48478461,1.0094123911777826,4210,2611,6821,+
chrX,48478464,1.498093058733791,1472,1103,2575,+
chrX,48478467,1.3684221381444035,2195,1627,3822,+
chrX,48478469,1.9267991499626669,1490,756,2246,+
chrX,48478669,1.4579125708926712,1061,671,1732,+
chrX,48478670,1.4579125708926712,1061,671,1732,+
chrX,48478683,2.742533616418967,691,470,1161,+
chrX,48478684,2.6479487236510066,992,656,1648,+
chrX,48485896,0.32533044323306787,650,434,1084,+
chrX,48523818,2.2533256989389727,711,652,1363,+
chrX,48524003,1.6554086195414328,599,456,1055,+
chrX,48527265,2.95703933747412,590,482,1072,+
chrX,48528509,1.20984840558559,1071,726,1797,+
chrX,48528533,1.8413043478260869,604,459,1063,+
chrX,48528635,2.348684210526316,713,495,1208,+
chrX,48528649,2.5632396449704142,716,506,1222,+
chrX,48576515,4.168004694631375,925,630,1555,+
chrX,48576516,4.168004694631375,925,630,1555,+
chrX,48576529,2.3752751806681025,854,742,1596,+
chrX,48576530,2.5478667445938052,613,589,1202,+
chrX,48576539,1.5325909766770853,1400,1332,2732,+
chrX,48576540,1.0602409638554218,780,829,1609,+
chrX,48576541,2.20935960591133,620,503,1123,+
chrX,48577503,1.801700921332388,668,414,1082,+
chrX,48577597,3.1708911529746446,673,501,1174,+
chrX,48577661,1.7278846153846157,598,415,1013,+
chrX,48578086,0.6065313697318008,880,695,1575,+
chrX,48897932,1.3588354884135707,1363,392,1755,+
chrX,48897933,4.316730446561664,1193,418,1611,+
chrX,48897934,3.763499853377789,2180,771,2951,+
chrX,48897935,4.083474337281444,1085,393,1478,+
chrX,48897936,3.124100846590267,1651,627,2278,+
chrX,48901946,1.5920402194087235,683,508,1191,+
chrX,48902307,3.8271291064348913,636,392,1028,+
chrX,49171920,3.2003883495145633,1004,514,1518,+
chrX,49171921,3.825842696629213,680,355,1035,+
chrX,49171930,2.326241595032109,589,423,1012,+
chrX,49171944,1.4651345109499105,1379,1199,2578,+
chrX,49171945,1.5186749081341135,1644,1353,2997,+
chrX,49171946,1.3485775630703167,1141,1034,2175,+
chrX,49172043,2.7219512195121958,836,614,1450,+
chrX,49172045,2.5566733752167607,1415,950,2365,+
chrX,49172066,2.7081339712918657,565,436,1001,+
chrX,49173128,0.5813492063492063,585,447,1032,+
chrX,49173252,1.7457193968821876,827,601,1428,+
chrX,49174368,2.146502226974296,1484,1058,2542,+
chrX,49174850,0.4442427986717121,884,562,1446,+
chrX,49174876,1.598647062112149,816,576,1392,+
chrX,49174952,1.9836687785850446,1526,984,2510,+
chrX,49174976,2.032706093189964,697,431,1128,+
chrX,49174977,2.7474487679415907,894,708,1602,+
chrX,49581694,0.5979051381132592,587,447,1034,+
chrX,54445128,0.2718971607544559,699,406,1105,+
chrX,54809197,25.202539744255613,951,379,1330,+
chrX,54809198,17.4800972996165,2366,1039,3405,+
chrX,54809200,10.731555132019874,2018,908,2926,+
chrX,54809201,2.8466817155756208,1016,442,1458,+
chrX,54809203,2.709871675388917,1049,480,1529,+
chrX,54809204,2.618726965137215,982,516,1498,+
chrX,54809210,12.712939626302239,1699,1338,3037,+
chrX,54809211,12.85781920040927,3230,2598,5828,+
chrX,54809212,12.85781920040927,3230,2598,5828,+
chrX,54809213,12.175559380378655,1079,829,1908,+
chrX,54809357,1.9197494033412887,584,418,1002,+
chrX,54809723,1.2395353933815472,807,701,1508,+
chrX,54809725,0.9521826875068188,1361,1133,2494,+
chrX,54809732,1.1305686735264113,1083,861,1944,+
chrX,54809967,1.221060525222092,686,568,1254,+
chrX,54810167,3.8130841121495327,599,534,1133,+
chrX,54810168,3.8130841121495327,599,534,1133,+
chrX,54810969,2.0246004615990767,620,409,1029,+
chrX,54811079,0.7386790993912369,742,595,1337,+
chrX,54811250,2.5936810407130806,644,542,1186,+
chrX,54811594,2.1765075376884417,692,397,1089,+
chrX,54811595,2.0646391977327228,1221,833,2054,+
chrX,54811597,2.0646391977327228,1221,833,2054,+
chrX,54812945,1.246015077903578,642,462,1104,+
chrX,54813007,2.227720848243326,1017,819,1836,+
chrX,54814713,3.807106598984772,624,393,1017,+
chrX,54815676,2.0543478260869565,629,413,1042,+
chrX,55007091,0.7810671828231089,550,486,1036,+
chrX,56566474,2.6847407407407404,696,449,1145,+
chrX,56566475,2.6847407407407404,696,449,1145,+
chrX,56732173,2.5155279503105588,674,574,1248,+
chrX,56817345,1.7251845775225596,700,529,1229,+
chrX,62779580,0.9346983672980042,929,591,1520,+
chrX,65716857,2.5606392088616334,693,404,1097,+
chrX,65727859,0.5898639455782313,666,419,1085,+
chrX,65729475,3.759411764705883,580,509,1089,+
chrX,65729476,3.759411764705883,580,509,1089,+
chrX,65729480,1.9203082003302148,670,394,1064,+
chrX,65729522,2.3467362924281985,641,382,1023,+
chrX,65729642,1.1793980963326585,1131,769,1900,+
chrX,65731917,1.62070571192053,894,603,1497,+
chrX,65733193,1.65896542137707,1031,862,1893,+
chrX,65735376,1.5316204251972867,1619,1032,2651,+
chrX,65735381,1.723618090452261,1028,596,1624,+
chrX,65735414,1.7409700996677742,1423,874,2297,+
chrX,65736794,1.752132895816243,1963,1059,3022,+
chrX,65736795,1.673679612264196,4643,2722,7365,+
chrX,65736804,0.4463414634146342,1890,1239,3129,+
chrX,65736826,1.4597636647547707,5915,4028,9943,+
chrX,65736850,1.458984324153002,8697,6251,14948,+
chrX,65738529,1.5910192837465564,861,483,1344,+
chrX,65738531,1.5910192837465564,861,483,1344,+
chrX,65738540,1.7093196042629153,599,470,1069,+
chrX,65739164,0.38676611144659157,768,582,1350,+
chrX,65739786,1.7289082969432314,706,457,1163,+
chrX,65739821,0.3498165297920671,714,484,1198,+
chrX,65739840,2.339030289526829,982,672,1654,+
chrX,65740128,0.3884892086330936,593,416,1009,+
chrX,65740334,0.5989465763732129,596,442,1038,+
chrX,65740338,1.6313857086458745,960,744,1704,+
chrX,65740345,0.6304609218436873,725,498,1223,+
chrX,65740346,1.820354422910251,2145,1777,3922,+
chrX,65740347,1.820354422910251,2145,1777,3922,+
chrX,65740354,1.7338235294117648,1178,1019,2197,+
chrX,65740422,1.3039261985971318,7990,6147,14137,+
chrX,65740423,2.0838318596811747,3384,2836,6220,+
chrX,65740430,1.2702177569117008,6483,4411,10894,+
chrX,65740432,1.1943235092653068,15497,11318,26815,+
chrX,65740433,1.3096376732740371,6999,4883,11882,+
chrX,65740550,2.021768992129852,1565,1249,2814,+
chrX,65740663,1.9408240390819431,657,570,1227,+
chrX,65740793,2.1201646090534982,735,485,1220,+
chrX,65740830,3.816964285714286,569,447,1016,+
chrX,65740951,1.119562556478425,570,450,1020,+
chrX,65740990,1.1298056036557895,1142,862,2004,+
chrX,65741059,1.851851851851852,727,467,1194,+
chrX,65741165,2.1953261567038163,925,579,1504,+
chrX,65741456,2.0227064085280784,1020,687,1707,+
chrX,65741653,2.6403007488583055,787,659,1446,+
chrX,65741665,0.34303869721301783,609,458,1067,+
chrX,65741731,1.8230739450251647,553,573,1126,+
chrX,65741756,1.6883231836850305,866,613,1479,+
chrX,68522795,3.0274610315254358,818,635,1453,+
chrX,68522797,0.9074187614960146,591,465,1056,+
chrX,68532917,4.664861593078875,655,436,1091,+
chrX,68533072,10.430173044009607,1235,957,2192,+
chrX,68533144,9.590801204656076,955,879,1834,+
chrX,68533145,7.356255648176586,1796,1527,3323,+
chrX,68784491,0.3449156872764435,599,411,1010,+
chrX,68784569,0.6772870100847078,660,461,1121,+
chrX,68784575,1.7623844348604267,821,491,1312,+
chrX,68784768,0.9447342367990357,1132,678,1810,+
chrX,68784799,0.8995537008056569,775,638,1413,+
chrX,68784800,0.8995537008056569,775,638,1413,+
chrX,68784807,0.5964168080646771,702,465,1167,+
chrX,68784827,0.8819256516165788,773,825,1598,+
chrX,68784828,0.8819256516165788,773,825,1598,+
chrX,68784829,1.5470576050248865,1793,1415,3208,+
chrX,70134006,2.160919540229885,1033,560,1593,+
chrX,70134008,1.6301822848117926,1487,871,2358,+
chrX,70134064,2.3043354655294954,558,468,1026,+
chrX,70134076,0.49545379401553985,665,525,1190,+
chrX,70134524,1.8088100336494344,656,466,1122,+
chrX,70134563,1.70182841068917,604,473,1077,+
chrX,70134602,1.8665325285043597,725,425,1150,+
chrX,70134736,1.1773155072535415,1962,1375,3337,+
chrX,70146634,2.5546296296296296,800,539,1339,+
chrX,70146642,2.381683258652501,2421,1590,4011,+
chrX,70146643,2.152782885141357,3344,2257,5601,+
chrX,70146703,1.4610247848979068,1834,1197,3031,+
chrX,70148772,1.4533811506060548,1277,900,2177,+
chrX,70166114,3.0580023267409016,574,546,1120,+
chrX,70166115,1.1882119172346683,1502,1150,2652,+
chrX,70962973,1.855831116311614,842,683,1525,+
chrX,70962974,0.5768762183235867,946,683,1629,+
chrX,70962975,0.5768762183235867,946,683,1629,+
chrX,70962986,1.8423761988262621,1455,1413,2868,+
chrX,70962987,1.9231868524473024,768,932,1700,+
chrX,70962992,0.485899814471243,872,587,1459,+
chrX,70962995,1.100845292028016,8646,6684,15330,+
chrX,70962996,0.988182934625061,9540,7909,17449,+
chrX,70962997,0.988182934625061,9540,7909,17449,+
chrX,70962998,1.2374151459049634,1275,1139,2414,+
chrX,70963000,0.8606504299025074,1555,1671,3226,+
chrX,70963003,0.8637133996826771,2210,2310,4520,+
chrX,70963005,1.2084521662542465,5079,3615,8694,+
chrX,70963006,1.1965079268847192,3555,2998,6553,+
chrX,70963017,0.7780042880489205,9414,8351,17765,+
chrX,70963018,1.1365908614738822,7634,5523,13157,+
chrX,70963021,1.1664010435867622,6633,5369,12002,+
chrX,70963099,1.1292335583569086,5673,4051,9724,+
chrX,70963125,1.3926555482572078,5528,3373,8901,+
chrX,70963126,1.323597713469096,8641,5363,14004,+
chrX,70963128,1.3036452641361684,9233,5883,15116,+
chrX,70963129,1.2786239448125625,6402,4139,10541,+
chrX,70963136,1.1943124909421747,6095,5057,11152,+
chrX,70963137,0.859734841113863,14507,10454,24961,+
chrX,70963138,1.0056343871145532,16894,12644,29538,+
chrX,71283653,0.3840667101899021,663,485,1148,+
chrX,71283668,0.944337811900192,819,520,1339,+
chrX,71283670,0.944337811900192,819,520,1339,+
chrX,71283702,1.4233954451345756,714,482,1196,+
chrX,71283703,1.917772346368715,844,715,1559,+
chrX,71290684,1.716050997057862,672,436,1108,+
chrX,71290754,0.4853988603988604,939,779,1718,+
chrX,71290755,0.48161636953924886,2590,1915,4505,+
chrX,71290757,0.547344021634151,1011,834,1845,+
chrX,71290765,1.7424242424242422,809,485,1294,+
chrX,71291789,1.7491776315789471,708,607,1315,+
chrX,71291894,2.2695386064030134,621,471,1092,+
chrX,71294226,2.4955693815987936,1150,662,1812,+
chrX,71294245,1.5502962704775185,1058,754,1812,+
chrX,71294347,1.5141009055627428,1329,772,2101,+
chrX,71294441,3.2193627450980395,638,431,1069,+
chrX,71294444,0.6197261814938806,1933,1238,3171,+
chrX,71294451,1.6418031129977764,1047,581,1628,+
chrX,71296640,1.681721536351166,1690,1079,2769,+
chrX,71296649,0.6969464226471002,2513,1582,4095,+
chrX,71296852,1.4237759122391302,3396,1837,5233,+
chrX,71296856,1.7921722688304298,1774,892,2666,+
chrX,71296936,1.6612931555460289,3985,2348,6333,+
chrX,71296948,1.4481291601872008,10021,5923,15944,+
chrX,71296951,1.4787248253429233,10534,6657,17191,+
chrX,71296952,1.4787248253429233,10534,6657,17191,+
chrX,71296999,1.4942545508247216,4270,2977,7247,+
chrX,71297005,1.2400690210123082,6774,5619,12393,+
chrX,71297840,1.9689825190497532,577,484,1061,+
chrX,71297843,1.8374405533938607,1359,770,2129,+
chrX,71297844,1.8984735692704882,1995,1236,3231,+
chrX,71297861,2.593856655290103,759,585,1344,+
chrX,71297865,1.747003374839986,833,660,1493,+
chrX,71297882,1.6122733612273363,866,716,1582,+
chrX,71297888,1.5491803278688523,1232,821,2053,+
chrX,71297890,1.6599696989658124,1199,798,1997,+
chrX,71298719,0.5416051191664442,1446,1157,2603,+
chrX,71299953,1.9877457965232257,774,362,1136,+
chrX,71299955,2.502395974762464,1540,843,2383,+
chrX,71299957,2.8455428067078548,805,411,1216,+
chrX,71299977,2.1212755272849013,684,411,1095,+
chrX,71299996,1.8091243862520459,716,610,1326,+
chrX,71299997,0.4973775818055233,1127,694,1821,+
chrX,71300018,0.7202290076335879,1257,916,2173,+
chrX,71300099,1.4712092130518235,1700,1041,2741,+
chrX,71300237,11.644239281104817,13659,9089,22748,+
chrX,71300238,11.644239281104817,13659,9089,22748,+
chrX,71300239,11.644239281104817,13659,9089,22748,+
chrX,71300250,1.7847718624417654,1090,720,1810,+
chrX,71300396,0.8237606105747914,1153,892,2045,+
chrX,71300397,1.0053511303511302,726,593,1319,+
chrX,71300489,0.48205571186345936,572,453,1025,+
chrX,71300583,0.5682610503959145,2576,1639,4215,+
chrX,71300676,0.5314285714285715,774,624,1398,+
chrX,71300680,1.747710544334132,1432,1015,2447,+
chrX,71300681,1.747710544334132,1432,1015,2447,+
chrX,71300914,1.6488131357846585,4126,2974,7100,+
chrX,71301036,1.6469743589743588,867,649,1516,+
chrX,71536244,0.9788995726495727,732,467,1199,+
chrX,71536246,0.9788995726495727,732,467,1199,+
chrX,71537853,0.48936312296502055,979,667,1646,+
chrX,71545754,1.6503747148908439,1012,464,1476,+
chrX,71545906,1.3156154806491884,2715,1601,4316,+
chrX,71545907,1.3156154806491884,2715,1601,4316,+
chrX,71545908,1.3156154806491884,2715,1601,4316,+
chrX,71546201,0.4921052631578947,747,531,1278,+
chrX,71546502,3.712015201290849,1090,825,1915,+
chrX,71546516,0.5542857142857143,678,489,1167,+
chrX,71546957,1.1855004236154236,894,559,1453,+
chrX,71547959,2.0458934956656085,1476,1073,2549,+
chrX,71555977,0.5401045102367036,1079,716,1795,+
chrX,71556706,1.8300403225806445,625,495,1120,+
chrX,71556709,1.6110234148908182,661,542,1203,+
chrX,71561833,0.4700778359065969,613,460,1073,+
chrX,71562941,2.9472312703583063,753,613,1366,+
chrX,71562942,2.9472312703583063,753,613,1366,+
chrX,71563131,2.095728718615585,1021,768,1789,+
chrX,71564664,0.6008547008547008,702,584,1286,+
chrX,71564732,1.2154838565188057,895,651,1546,+
chrX,71568074,2.85037037037037,591,449,1040,+
chrX,71573624,0.5445318646734855,768,619,1387,+
chrX,71573647,1.7409202054871344,1825,1142,2967,+
chrX,71573648,1.7409202054871344,1825,1142,2967,+
chrX,71573652,0.9966617448802719,1349,841,2190,+
chrX,71573654,0.8501050428197147,2472,1548,4020,+
chrX,71573662,1.6122706009355885,1235,793,2028,+
chrX,71573760,1.6762237762237762,845,659,1504,+
chrX,71574089,4.711534026571647,1181,1089,2270,+
chrX,71574090,3.8989198837666215,2678,2150,4828,+
chrX,71574092,1.9099108715375992,1233,913,2146,+
chrX,71574096,0.5763257575757575,715,527,1242,+
chrX,71574839,1.7160117878192531,646,508,1154,+
chrX,72160304,0.9300510227737974,751,500,1251,+
chrX,72160306,0.9415440033790514,1135,700,1835,+
chrX,72160308,1.201236365749348,1086,769,1855,+
chrX,72160314,1.5340854918163038,1608,1014,2622,+
chrX,72160315,1.580630315824588,2019,1345,3364,+
chrX,72160316,1.770935960591133,718,927,1645,+
chrX,72160318,1.770935960591133,718,927,1645,+
chrX,72160336,1.1644925376194677,3357,2389,5746,+
chrX,72160340,1.1678366447951645,3888,2845,6733,+
chrX,74174059,1.1537794729542303,604,411,1015,+
chrX,74174061,1.1537794729542303,604,411,1015,+
chrX,77899462,0.7762209918651186,852,442,1294,+
chrX,77899467,1.1683824646729097,2308,1483,3791,+
chrX,77899468,1.5206008123030559,4712,2785,7497,+
chrX,77899469,1.8808975624017832,2404,1302,3706,+
chrX,77899470,1.8808975624017832,2404,1302,3706,+
chrX,77899472,1.8339802399435428,692,435,1127,+
chrX,77899474,0.7210576393983205,1456,875,2331,+
chrX,77899479,0.7995431995847732,3477,1879,5356,+
chrX,77899481,0.8359216618106041,2994,1536,4530,+
chrX,77899482,1.4853237622301982,2384,1848,4232,+
chrX,77899484,1.4853237622301982,2384,1848,4232,+
chrX,77899487,1.4952457044142284,2539,1576,4115,+
chrX,77899500,1.3640833374442964,2182,1397,3579,+
chrX,77899512,1.571179189614477,1252,991,2243,+
chrX,77902640,1.0750208723883061,745,519,1264,+
chrX,78104244,1.1566709340562793,2338,1354,3692,+
chrX,78104245,1.1566709340562793,2338,1354,3692,+
chrX,78104246,1.1566709340562793,2338,1354,3692,+
chrX,78104252,0.8223231667748215,2375,1379,3754,+
chrX,78104254,0.8172397184848954,3903,2434,6337,+
chrX,78104257,0.6022366829076877,1753,1153,2906,+
chrX,78104276,0.561024894924022,1261,1030,2291,+
chrX,78104303,1.0973870302838118,9352,5405,14757,+
chrX,78104304,1.149838351238211,12735,7532,20267,+
chrX,78104305,1.021698517242132,11623,7150,18773,+
chrX,78104328,1.2971946948015889,3017,2283,5300,+
chrX,78104338,1.2602641063199462,9338,6037,15375,+
chrX,78104352,1.28971167145441,6269,3614,9883,+
chrX,78109898,1.5209304651556417,3162,2240,5402,+
chrX,78113768,0.8655623293207046,12838,8003,20841,+
chrX,78113769,0.9727891688772152,8809,5077,13886,+
chrX,78113849,1.4822326150618472,4535,2876,7411,+
chrX,78114017,1.6351394225684774,1783,1492,3275,+
chrX,78114089,1.4748436093985011,5122,3267,8389,+
chrX,78114100,2.166110858471022,2065,1465,3530,+
chrX,78114137,1.6961544901490206,5064,3894,8958,+
chrX,78114138,1.6346914961672945,19396,14605,34001,+
chrX,78114140,1.729105058365759,5227,4111,9338,+
chrX,78117312,1.5644854344246986,6805,4820,11625,+
chrX,78118062,1.5562698078810824,3991,2376,6367,+
chrX,78118090,1.5693802583244465,3310,2812,6122,+
chrX,78122838,0.6880448863139658,3864,3068,6932,+
chrX,78122839,1.258466897596422,7861,5262,13123,+
chrX,78123228,0.9949339663245517,9904,6771,16675,+
chrX,78123261,1.5048760087709383,3617,2853,6470,+
chrX,78124890,1.6534998209810243,3130,1959,5089,+
chrX,78124900,2.053972872764819,2083,1638,3721,+
chrX,78124903,1.4097161192748675,8621,5628,14249,+
chrX,78124904,1.4097161192748675,8621,5628,14249,+
chrX,78124934,1.3916435733060577,2271,2025,4296,+
chrX,78124965,1.3188569140110988,3573,2496,6069,+
chrX,78125789,1.8225572396001288,1738,1328,3066,+
chrX,78125792,1.3121915733356495,3502,2205,5707,+
chrX,78125924,1.5216423404143018,3215,1915,5130,+
chrX,78125957,1.5348065204874772,3434,2451,5885,+
chrX,78125958,1.5348065204874772,3434,2451,5885,+
chrX,78125962,2.2768595041322315,1937,1451,3388,+
chrX,78125964,1.0109268307040262,7230,4246,11476,+
chrX,78125965,1.0769912305314895,9457,5913,15370,+
chrX,78125966,0.7925875914462149,3918,2948,6866,+
chrX,78125995,1.301085048488455,3819,3218,7037,+
chrX,78126324,2.1985503080224884,850,620,1470,+
chrX,78126413,3.470434782608696,613,459,1072,+
chrX,78126517,2.856178386345267,1225,778,2003,+
chrX,78126518,2.4359483320027087,1458,935,2393,+
chrX,78126551,1.951436388508892,633,515,1148,+
chrX,80929812,2.2657894736842112,629,455,1084,+
chrX,80929814,2.2657894736842112,629,455,1084,+
chrX,80930170,1.7149390243902438,674,409,1083,+
chrX,80930173,0.6786776046672776,645,538,1183,+
chrX,80930174,1.6311368015414258,571,518,1089,+
chrX,80930176,1.7977631730658366,1948,1238,3186,+
chrX,80930177,1.7977631730658366,1948,1238,3186,+
chrX,81276986,2.6148912430470745,695,441,1136,+
chrX,81276990,2.8239753052030103,984,756,1740,+
chrX,81297515,3.449173813009832,766,682,1448,+
chrX,81297516,3.449173813009832,766,682,1448,+
chrX,100803998,2.5426653883029724,611,446,1057,+
chrX,100804000,2.5426653883029724,611,446,1057,+
chrX,101390984,0.6659095400236362,2772,1246,4018,+
chrX,101390985,0.6659951203416689,2572,1062,3634,+
chrX,101390987,1.9459041095890413,1560,729,2289,+
chrX,101390988,1.7126665511455281,1461,779,2240,+
chrX,101391006,1.546783847261156,927,393,1320,+
chrX,101391009,1.7215518806186885,2119,942,3061,+
chrX,101391010,1.7974607454642395,3471,1824,5295,+
chrX,101411978,1.3495827425903957,617,535,1152,+
chrX,101412038,4.005704586856553,656,530,1186,+
chrX,101412164,0.6026831785345718,656,458,1114,+
chrX,101412177,0.4306643091689821,619,427,1046,+
chrX,101412373,2.4131593914536587,814,560,1374,+
chrX,101412460,1.3474381302688798,1220,930,2150,+
chrX,101412483,3.2346437273323914,1241,1018,2259,+
chrX,101412571,0.3654388774498589,598,422,1020,+
chrX,101412608,0.3531914893617021,746,422,1168,+
chrX,101412636,2.235934664246824,923,550,1473,+
chrX,101412642,0.531903856217602,946,588,1534,+
chrX,101412644,1.7703104190144454,1079,680,1759,+
chrX,101412675,1.778120619326011,2428,1261,3689,+
chrX,101412678,2.3108320251177394,1183,636,1819,+
chrX,101412711,4.946794511468016,5341,3996,9337,+
chrX,101412712,3.03767546716143,19683,13911,33594,+
chrX,101412713,2.5847050859522516,22575,16483,39058,+
chrX,101412714,1.7032249520630147,7975,5104,13079,+
chrX,101412715,3.108527883458154,3871,3523,7394,+
chrX,101412718,0.719719499509776,4239,3146,7385,+
chrX,101412763,0.5760058701235172,627,480,1107,+
chrX,101412944,1.8434475971789408,1142,937,2079,+
chrX,101412946,1.8434475971789408,1142,937,2079,+
chrX,101412987,1.887150527680059,754,490,1244,+
chrX,101412989,1.7358474858474855,718,545,1263,+
chrX,101413184,9.443887775551099,724,498,1222,+
chrX,101413185,9.443887775551099,724,498,1222,+
chrX,101413189,7.102193768731393,2687,2441,5128,+
chrX,101413190,7.102193768731393,2687,2441,5128,+
chrX,101413206,0.5200146239796339,678,707,1385,+
chrX,101413440,2.081197392424251,2369,1543,3912,+
chrX,101413981,2.231034482758621,646,405,1051,+
chrX,101413982,2.231034482758621,646,405,1051,+
chrX,101626328,0.5383748879186877,735,502,1237,+
chrX,103356587,2.136967852125314,1241,972,2213,+
chrX,103357083,2.372026194831379,1026,746,1772,+
chrX,103357122,1.9333698430083965,622,497,1119,+
chrX,103357138,1.7800274536719287,987,751,1738,+
chrX,103357140,1.7711280890398036,1014,683,1697,+
chrX,103357614,1.6163439242965467,831,590,1421,+
chrX,103357760,3.3840483561845787,997,797,1794,+
chrX,103357812,2.1903575150663825,1178,760,1938,+
chrX,103357860,1.9689587973273943,1844,1346,3190,+
chrX,103357867,1.8631445477599329,1394,1182,2576,+
chrX,103357965,1.5418734630002235,931,638,1569,+
chrX,103376600,2.2699386503067487,665,488,1153,+
chrX,103377039,2.253657018362901,556,458,1014,+
chrX,103377068,1.9122628662056793,1772,1277,3049,+
chrX,103377509,1.6792369153816515,2178,1580,3758,+
chrX,103377510,1.6792369153816515,2178,1580,3758,+
chrX,103377519,1.5315535837221754,851,768,1619,+
chrX,103377537,1.4928167877320422,866,825,1691,+
chrX,103377550,1.8709382151029748,1021,873,1894,+
chrX,103377626,0.7101517075452783,1517,1150,2667,+
chrX,103377654,1.7812636165577342,2189,1376,3565,+
chrX,103586651,2.609137484586766,752,535,1287,+
chrX,103586678,1.3155083240596412,749,637,1386,+
chrX,103586766,2.219838308457712,648,401,1049,+
chrX,103586913,7.145483817313319,3558,1711,5269,+
chrX,103586914,7.145483817313319,3558,1711,5269,+
chrX,103586931,24.66674722817416,3482,3231,6713,+
chrX,103586932,24.66674722817416,3482,3231,6713,+
chrX,103586935,9.866019205257498,1771,2238,4009,+
chrX,103586950,2.98112725513265,1068,1499,2567,+
chrX,103587146,5.186763522745429,789,578,1367,+
chrX,103587299,0.8977405182462118,800,586,1386,+
chrX,103587301,1.4149371405815794,1047,781,1828,+
chrX,104191650,1.4623655913978495,631,473,1104,+
chrX,104191665,1.12904056206337,820,595,1415,+
chrX,104193197,2.4998342175066317,886,463,1349,+
chrX,104193199,2.1183768415611266,1365,729,2094,+
chrX,104193200,1.679212199859652,1672,1087,2759,+
chrX,104193202,1.4586725882062668,738,578,1316,+
chrX,104193230,1.7774294670846396,860,450,1310,+
chrX,107628489,1.0843821595564602,578,437,1015,+
chrX,107628508,1.113958298327492,1548,1253,2801,+
chrX,107628510,0.9288111429566046,1657,1350,3007,+
chrX,107628514,0.6890947802329498,3945,2599,6544,+
chrX,107628515,0.5813172402719049,1608,951,2559,+
chrX,107628579,4.056341719077569,672,423,1095,+
chrX,107628583,1.954860524091293,745,454,1199,+
chrX,107640917,0.5803958281759319,792,600,1392,+
chrX,107642393,0.2768602540834845,677,550,1227,+
chrX,107642429,0.5054074638233054,710,504,1214,+
chrX,107642430,2.005467078678393,766,600,1366,+
chrX,107647607,1.5413008258804608,578,495,1073,+
chrX,107647609,4.323006602336212,797,536,1333,+
chrX,107647610,4.323006602336212,797,536,1333,+
chrX,107647629,1.832512315270936,991,695,1686,+
chrX,107647630,1.832512315270936,991,695,1686,+
chrX,107647651,2.027354186593114,1065,853,1918,+
chrX,107647717,1.7318435754189945,779,536,1315,+
chrX,107647738,2.1955555555555555,569,449,1018,+
chrX,107649965,0.5924325463743676,802,592,1394,+
chrX,107650099,3.4619565217391313,636,459,1095,+
chrX,107650272,1.115069326900455,1180,964,2144,+
chrX,107650573,5.784718108895314,872,995,1867,+
chrX,107650574,5.6457686261271744,944,1146,2090,+
chrX,107650575,4.553668051548815,793,1066,1859,+
chrX,107650578,1.4550901508000205,520,886,1406,+
chrX,107650579,0.5666384662305,387,1003,1390,+
chrX,107650580,0.37398831092843804,630,1401,2031,+
chrX,107650582,0.2772887323943662,389,922,1311,+
chrX,107650584,0.3203021993677037,649,1009,1658,+
chrX,107650592,0.39466596399690734,530,784,1314,+
chrX,107650594,0.3892564181330331,1251,1422,2673,+
chrX,107650596,0.4349665924276169,650,448,1098,+
chrX,107650602,0.3699143537387215,425,577,1002,+
chrX,107650606,2.0237537057346975,688,584,1272,+
chrX,107650702,2.6390796703296706,794,545,1339,+
chrX,107650861,4.0329565472695235,1220,1047,2267,+
chrX,107650862,3.9845929614824005,1737,1424,3161,+
chrX,107650902,1.99297395517868,913,634,1547,+
chrX,115561192,2.3570472163150527,678,412,1090,+
chrX,115610265,0.4719453514349544,844,528,1372,+
chrX,115634037,0.42344691358024694,1260,674,1934,+
chrX,115634883,2.3749420222634514,1780,923,2703,+
chrX,115634897,1.834902989300509,2086,1156,3242,+
chrX,115634902,1.9300663164240808,1244,682,1926,+
chrX,115634961,1.920337443218689,4429,2874,7303,+
chrX,115634962,1.920337443218689,4429,2874,7303,+
chrX,115634963,1.3016874515132355,3414,1516,4930,+
chrX,115635027,0.27043950850661624,762,551,1313,+
chrX,115636950,0.5377917102055033,771,521,1292,+
chrX,115643312,2.032225691347012,728,471,1199,+
chrX,115643449,2.3146845694799656,748,551,1299,+
chrX,115646143,2.1091954022988504,733,521,1254,+
chrX,115647587,0.5759649122807018,937,599,1536,+
chrX,115647962,2.010972593450904,1172,989,2161,+
chrX,115647987,0.9993611517387788,2089,1651,3740,+
chrX,115649575,1.8329678362573096,1002,607,1609,+
chrX,115649602,1.7705971614746052,1043,658,1701,+
chrX,115649821,1.8052862994459244,1050,871,1921,+
chrX,115650321,1.7027027027027029,1070,739,1809,+
chrX,115650507,2.135593220338983,811,471,1282,+
chrX,118791922,2.219685708218305,1129,553,1682,+
chrX,118791923,2.219685708218305,1129,553,1682,+
chrX,118791932,1.8638985005767008,1211,662,1873,+
chrX,118791933,1.8638985005767008,1211,662,1873,+
chrX,118794203,7.057911795289193,637,474,1111,+
chrX,119236432,0.49753289473684215,725,511,1236,+
chrX,119236434,0.49753289473684215,725,511,1236,+
chrX,119240432,2.2826585179526355,746,475,1221,+
chrX,119240438,1.5822745098039217,916,509,1425,+
chrX,119243150,1.023826377534022,5481,3626,9107,+
chrX,119243151,1.0364894922124146,7693,5102,12795,+
chrX,119243152,1.0959226485991862,3286,1871,5157,+
chrX,119243153,1.067759282173402,2212,1476,3688,+
chrX,119243154,0.6036764036764036,1617,1220,2837,+
chrX,119243156,1.5584159156351671,2893,2056,4949,+
chrX,119243157,1.5584159156351671,2893,2056,4949,+
chrX,119243220,1.699513381995134,761,547,1308,+
chrX,119243223,1.6318430656934308,1322,1095,2417,+
chrX,119243225,1.6318430656934308,1322,1095,2417,+
chrX,119243443,1.6141750653228817,934,563,1497,+
chrX,119243587,1.5897262842144733,985,761,1746,+
chrX,119243697,1.5878140232470939,900,761,1661,+
chrX,119243714,1.9876926155693413,684,525,1209,+
chrX,119243928,1.5648148148148149,1013,647,1660,+
chrX,119244131,0.4583931133428981,638,573,1211,+
chrX,119468427,0.6160829480647444,1789,909,2698,+
chrX,119468442,1.2548027648438982,3096,1957,5053,+
chrX,119468449,1.6617675876935136,794,566,1360,+
chrX,119468456,1.6811301858707999,2943,1991,4934,+
chrX,119468457,1.53478404220244,930,673,1603,+
chrX,119468458,1.6299664268585132,1846,1389,3235,+
chrX,119468478,1.6928849009509968,1700,1020,2720,+
chrX,119468575,1.505319784817693,1573,1194,2767,+
chrX,119468579,1.5525874241825768,3376,2551,5927,+
chrX,119469672,1.5847311167299418,4873,3441,8314,+
chrX,119469689,1.4254297169624073,1909,1554,3463,+
chrX,119469786,1.564404817044928,2936,2379,5315,+
chrX,119469789,1.4776116504854366,3105,2574,5679,+
chrX,119469828,1.2850239693192709,4130,2681,6811,+
chrX,119470042,0.7739626547394605,7312,5285,12597,+
chrX,119470132,1.362106552357624,2978,2129,5107,+
chrX,119470390,1.480555151700273,6415,4276,10691,+
chrX,119470903,1.4658206357877763,3982,2489,6471,+
chrX,119470908,1.730868837454884,8968,6024,14992,+
chrX,119470909,1.730868837454884,8968,6024,14992,+
chrX,119470939,1.3713024533484892,2428,1954,4382,+
chrX,119471029,1.3864315777499716,3856,2949,6805,+
chrX,119471059,0.781596176001418,5324,3967,9291,+
chrX,119471116,1.2611764705882351,4103,3059,7162,+
chrX,119582623,1.4301045557046443,990,742,1732,+
chrX,119583158,2.810265282583622,885,577,1462,+
chrX,119583160,2.810265282583622,885,577,1462,+
chrX,119583417,1.1292202793357529,603,432,1035,+
chrX,119583418,1.1292202793357529,603,432,1035,+
chrX,119584022,2.306242918958612,686,536,1222,+
chrX,119871842,0.5457295722169583,1212,964,2176,+
chrX,119871856,0.7542743540806661,3542,2646,6188,+
chrX,119871857,0.7187463636011017,1852,1523,3375,+
chrX,119871861,1.3585095504828673,3193,2409,5602,+
chrX,119871876,0.6813561338727321,6332,4888,11220,+
chrX,119871878,0.6953170192504461,3479,2782,6261,+
chrX,119871884,1.5617625283852417,7847,5841,13688,+
chrX,119871960,1.6165729673548448,1900,1734,3634,+
chrX,119873302,0.6712531017369726,1833,1239,3072,+
chrX,119873303,0.6712531017369726,1833,1239,3072,+
chrX,119876569,1.3777537549342374,3710,2597,6307,+
chrX,120258146,2.4248877796381656,627,433,1060,+
chrX,120604108,1.483679846027194,1393,907,2300,+
chrX,120604109,1.0940249905338888,606,474,1080,+
chrX,120605409,2.087053571428571,560,447,1007,+
chrX,120605414,1.9150579150579152,805,517,1322,+
chrX,120605419,1.6093953892996955,924,626,1550,+
chrX,120605531,0.572090112640801,652,469,1121,+
chrX,120608228,1.7242883379247016,1072,659,1731,+
chrX,120608309,2.9684601113172535,575,440,1015,+
chrX,120608321,7.968091168091169,735,584,1319,+
chrX,121048737,1.6658455363540783,640,532,1172,+
chrX,124050198,0.35052332907473205,685,502,1187,+
chrX,124051171,1.3825358839039912,816,541,1357,+
chrX,124061298,1.6169508336345095,1265,887,2152,+
chrX,124061299,2.1134335655787804,909,605,1514,+
chrX,124062952,1.9225620604930949,731,406,1137,+
chrX,124062958,1.8653081510934397,833,502,1335,+
chrX,124063121,1.9247427101200685,1145,635,1780,+
chrX,124063122,1.915466771907924,3137,1934,5071,+
chrX,124063123,1.910449704142012,1992,1299,3291,+
chrX,124063124,3.3014583333333336,688,399,1087,+
chrX,124063130,1.136691512604482,2016,1306,3322,+
chrX,124063160,1.672839954487133,1381,842,2223,+
chrX,124063161,0.6840723076017194,2191,1529,3720,+
chrX,124063176,1.9890066049026993,1922,1326,3248,+
chrX,124063179,1.782923677778704,6480,4866,11346,+
chrX,124063180,1.782923677778704,6480,4866,11346,+
chrX,124063181,1.782923677778704,6480,4866,11346,+
chrX,124066218,1.518914397705568,828,630,1458,+
chrX,124071156,3.7173248008301893,648,523,1171,+
chrX,124071182,2.018830726371989,733,549,1282,+
chrX,124078032,2.617192726001213,1012,735,1747,+
chrX,124081421,2.286599099099099,654,443,1097,+
chrX,124086709,2.569437994926816,608,446,1054,+
chrX,124095383,1.888721804511278,627,419,1046,+
chrX,124101084,2.0731736963656253,655,432,1087,+
chrX,124101675,1.9267770662627102,970,678,1648,+
chrX,129924914,0.9844157009544643,900,751,1651,+
chrX,130409342,2.7376084497669324,822,631,1453,+
chrX,130495944,3.763636363636364,647,359,1006,+
chrX,130495946,3.763636363636364,647,359,1006,+
chrX,130495953,2.150055707726828,787,617,1404,+
chrX,132068299,4.552731206927413,715,547,1262,+
chrX,132069498,3.124667217480863,769,556,1325,+
chrX,132071073,0.5876475930971844,646,366,1012,+
chrX,132073016,2.878005226770885,785,529,1314,+
chrX,132074204,0.3680345572354212,851,462,1313,+
chrX,132074206,0.3680345572354212,851,462,1313,+
chrX,132074725,3.192269713640852,729,416,1145,+
chrX,132074733,3.1404886510801293,870,556,1426,+
chrX,132074748,2.5171475875118263,945,603,1548,+
chrX,132074758,0.3660520270689762,736,412,1148,+
chrX,132074783,1.7033822208919491,812,513,1325,+
chrX,132074824,2.0517067238840845,3925,3372,7297,+
chrX,132074825,2.0517067238840845,3925,3372,7297,+
chrX,132074826,2.0517067238840845,3925,3372,7297,+
chrX,132074941,1.168037244982325,673,524,1197,+
chrX,132075321,1.6107550777727149,571,436,1007,+
chrX,133671123,3.593107054040986,1049,485,1534,+
chrX,133671131,3.4304282974643083,946,493,1439,+
chrX,133671133,3.3959856692294546,1333,643,1976,+
chrX,133671140,0.8571479923845651,1205,739,1944,+
chrX,133671141,1.0456873180038155,761,432,1193,+
chrX,133671143,1.5007447864945382,584,423,1007,+
chrX,133671150,1.4294476100031657,2124,1052,3176,+
chrX,133671151,1.4653685234512066,2883,1526,4409,+
chrX,133671159,1.3012506495180793,4335,2495,6830,+
chrX,133671160,1.0980357339150877,2853,1496,4349,+
chrX,133671163,1.7540482079576107,5071,3427,8498,+
chrX,133671164,1.7268610558869006,5309,4023,9332,+
chrX,133671166,1.516274204500375,7037,5201,12238,+
chrX,133671167,1.5224494738281944,3792,2992,6784,+
chrX,133671170,1.5841769778777652,4224,3555,7779,+
chrX,133671171,1.500009823302919,6598,4850,11448,+
chrX,133671185,1.267594265564441,5795,4660,10455,+
chrX,133671186,1.329593267882188,2369,1425,3794,+
chrX,133671190,1.330062649844438,7058,5804,12862,+
chrX,133671204,1.4565064350480967,6938,4810,11748,+
chrX,133671205,1.332825479794581,17703,11812,29515,+
chrX,133671206,1.2902654090595491,16801,11011,27812,+
chrX,133671208,1.3600684816226174,21911,14727,36638,+
chrX,133671210,1.3222421381266147,12519,8309,20828,+
chrX,133671211,1.2037321789484023,17152,13142,30294,+
chrX,133671212,1.247340923755802,9024,6734,15758,+
chrX,133671213,0.6730197350635306,5361,4913,10274,+
chrX,134377639,2.611438385428567,577,429,1006,+
chrX,134427303,1.7647350426111914,588,422,1010,+
chrX,134428311,24.061203291490582,1076,1382,2458,+
chrX,134428312,24.061203291490582,1076,1382,2458,+
chrX,134460307,1.2441555269363267,708,568,1276,+
chrX,134473392,2.329992737835876,616,404,1020,+
chrX,134475212,1.6003787878787878,844,615,1459,+
chrX,134475297,1.8851621240601504,2873,2127,5000,+
chrX,134475299,1.2315115745038219,8563,6207,14770,+
chrX,134475300,1.1216590493556358,7168,5195,12363,+
chrX,134475303,1.6553760616117212,3456,2836,6292,+
chrX,134475304,1.6701074660633484,5424,4549,9973,+
chrX,134475305,0.5610804318901671,2887,1806,4693,+
chrX,134475306,1.6193201815471596,5788,4517,10305,+
chrX,134486489,1.9161290322580649,1187,774,1961,+
chrX,134490194,2.565799256505576,713,537,1250,+
chrX,134498612,2.2950890570502134,1221,890,2111,+
chrX,134500075,2.5934379457917256,1110,700,1810,+
chrX,134500149,0.6041222459132908,764,602,1366,+
chrX,134500441,1.9463877084014385,686,482,1168,+
chrX,134500524,2.3009231685527096,908,583,1491,+
chrX,135032354,0.8403156695772175,720,355,1075,+
chrX,135032355,1.2399356118924456,737,384,1121,+
chrX,135032516,3.2540135745417866,570,466,1036,+
chrX,135033190,0.45473174360510976,730,476,1206,+
chrX,135033304,2.048964218455744,607,530,1137,+
chrX,135033306,2.048964218455744,607,530,1137,+
chrX,135033405,3.2791361043194787,618,408,1026,+
chrX,136207027,1.3933007638822028,834,563,1397,+
chrX,136207028,1.1309892286740124,629,393,1022,+
chrX,136207149,0.3984632881196084,1104,590,1694,+
chrX,136209904,2.2180296898930005,806,534,1340,+
chrX,136210168,3.3389888021717,614,420,1034,+
chrX,136210175,1.7723495341223874,611,417,1028,+
chrX,136210477,2.0662617580017995,595,444,1039,+
chrX,136210502,2.3882445608689955,675,508,1183,+
chrX,136211148,0.5580232888383981,613,502,1115,+
chrX,136504403,4.498417380471784,874,484,1358,+
chrX,136504421,2.0796578454958565,1166,521,1687,+
chrX,136504422,2.0796578454958565,1166,521,1687,+
chrX,136510985,2.306477093206951,583,421,1004,+
chrX,136511160,1.7841813939287436,698,505,1203,+
chrX,147949903,4.791637630662022,763,573,1336,+
chrX,147949905,4.233992735399263,1053,722,1775,+
chrX,148052268,1.4107291723055266,1523,909,2432,+
chrX,148052269,1.3230401477698701,2275,1397,3672,+
chrX,148052270,1.3492737154150196,3138,1999,5137,+
chrX,148052271,1.3903449014653273,3715,2490,6205,+
chrX,148052272,1.3025857935734477,2920,1916,4836,+
chrX,148052570,1.9534257120862202,724,432,1156,+
chrX,148052571,0.48335747785093874,1197,1140,2337,+
chrX,148052572,1.9534257120862202,724,432,1156,+
chrX,148052573,0.5129676248463205,1010,898,1908,+
chrX,148052575,1.3098945368095625,1475,1272,2747,+
chrX,148052576,2.0154247744048965,1783,1131,2914,+
chrX,148052577,0.7487569464755778,895,1051,1946,+
chrX,148052578,0.6993986469556501,1083,1227,2310,+
chrX,148052580,1.0099056182346884,2515,2223,4738,+
chrX,148052581,0.6767354432593111,1581,1633,3214,+
chrX,148052582,1.5676419965576591,758,580,1338,+
chrX,148052583,1.0191870928890723,6776,5556,12332,+
chrX,148052584,0.9018045815801776,2111,2069,4180,+
chrX,148052585,1.1617436936585872,8076,5921,13997,+
chrX,148052586,1.0220026780636917,8759,7013,15772,+
chrX,148052587,0.9852221435428204,9171,7169,16340,+
chrX,150727694,2.4791458124791457,742,665,1407,+
chrX,150987903,7.347396778969479,607,730,1337,+
chrX,150987906,4.332889238240571,794,1216,2010,+
chrX,150993499,1.732469875212884,867,754,1621,+
chrX,151397308,0.7762055992721155,644,422,1066,+
chrX,151403630,2.373073880920063,738,576,1314,+
chrX,151406170,0.7434539917389139,706,506,1212,+
chrX,151406826,1.242161632497319,1436,954,2390,+
chrX,151406828,0.910425261821644,849,547,1396,+
chrX,151406835,0.6112776752767527,836,541,1377,+
chrX,151406841,2.016662258661729,609,397,1006,+
chrX,151406857,1.7566050970306288,682,610,1292,+
chrX,151406871,1.5362212970773408,4468,3278,7746,+
chrX,151408189,0.13963865518461874,997,587,1584,+
chrX,153794608,0.9244215919790182,1203,541,1744,+
chrX,153794624,2.9634109359846352,745,276,1021,+
chrX,153794649,1.5606090409238063,923,610,1533,+
chrX,153794662,1.5959397810218978,896,684,1580,+
chrX,153794667,1.4168179297157248,2398,1563,3961,+
chrX,153794668,0.9810239990600124,2201,1730,3931,+
chrX,153794669,0.9810239990600124,2201,1730,3931,+
chrX,153794671,1.7265722097936864,1207,893,2100,+
chrX,153796454,1.228202305776027,2119,1262,3381,+
chrX,153796471,1.6179075513634875,1911,1452,3363,+
chrX,153796472,0.7759643336679224,2380,1870,4250,+
chrX,153797488,1.3071639555930266,2383,1500,3883,+
chrX,153797743,1.4314140034566245,3852,2886,6738,+
chrX,153797745,1.503915726043178,5902,4465,10367,+
chrX,153797746,1.5734798534611405,5822,4591,10413,+
chrX,153798078,0.7102260377324658,4008,3251,7259,+
chrX,153798082,1.834749034749035,1781,1479,3260,+
chrX,153798110,1.4443800171825967,4528,3679,8207,+
chrX,153798386,2.224378488077118,2222,1313,3535,+
chrX,153798419,1.614215745312939,1362,1082,2444,+
chrX,154398375,1.097270552414093,650,626,1276,+
chrX,154399342,0.626353393592301,1195,697,1892,+
chrX,154399343,0.6095783484641082,1595,888,2483,+
chrX,154399345,0.8602960563486384,1141,572,1713,+
chrX,154399346,1.0033122553447755,832,409,1241,+
chrX,154399350,0.7737003562475261,822,423,1245,+
chrX,154399352,0.667026351658337,782,567,1349,+
chrX,154399361,0.5508426000229278,960,670,1630,+
chrX,154399366,1.6577733860342556,1437,1187,2624,+
chrX,154399367,0.30571018893387314,1317,623,1940,+
chrX,154399486,1.640702479338843,2646,1484,4130,+
chrX,154399488,1.4351888536714212,2556,1261,3817,+
chrX,154399491,1.4644285398490495,10201,5528,15729,+
chrX,154399492,1.3941253155285838,16969,9463,26432,+
chrX,154399493,1.3702145771427021,19930,11777,31707,+
chrX,154399497,1.3672950361976939,8463,4955,13418,+
chrX,154399498,1.3672950361976939,8463,4955,13418,+
chrX,154399500,1.46878102718076,8566,5326,13892,+
chrX,154399501,1.3720025223822083,13775,8476,22251,+
chrX,154399504,1.4365421501821969,15473,10576,26049,+
chrX,154399516,0.8851147947864234,21875,14367,36242,+
chrX,154399517,1.3303337815188403,20661,14876,35537,+
chrX,154399518,1.0911272127453524,45776,30073,75849,+
chrX,154399519,1.0281463794247492,54072,37497,91569,+
chrX,154399842,1.4160496366378719,4089,1869,5958,+
chrX,154400461,0.861917534200236,829,657,1486,+
chrX,154400467,0.9814890514126506,9738,7799,17537,+
chrX,154400468,0.9316976364619186,14836,11963,26799,+
chrX,154400531,1.0764941093091245,8240,6674,14914,+
chrX,154400532,1.3064516129032258,4535,2687,7222,+
chrX,154400554,0.749062735339259,9479,7658,17137,+
chrX,154400561,1.2599905749525817,16132,11227,27359,+
chrX,154400563,1.2966506678301408,17789,10475,28264,+
chrX,154431840,1.2757635135408787,787,665,1452,+
chrX,154432938,1.688690974421578,858,643,1501,+
chrX,154433655,5.835183696706002,690,474,1164,+
chrX,154434403,2.228669444634891,629,442,1071,+
chrX,154435437,2.111637832460402,604,523,1127,+
chrX,154435771,2.917243496706487,712,536,1248,+
chrX,154435920,36.47850942989994,2010,1379,3389,+
chrX,154435921,36.987796477741576,1842,1329,3171,+
chrX,154436082,3.904874710543208,945,702,1647,+
chrX,154436088,1.7891479567592667,1038,835,1873,+
chrX,154436214,1.9873621323529411,557,543,1100,+
chrX,154439098,0.9427353030764544,618,468,1086,+
chrX,154439100,0.9427353030764544,618,468,1086,+
chrX,154442164,0.7315430672141057,612,509,1121,+
chrX,154442581,0.964879218776769,703,448,1151,+
chrX,154442583,0.964879218776769,703,448,1151,+
chrX,154443281,3.7476306858270094,635,446,1081,+
chrX,154446518,5.906421786545933,661,411,1072,+
chrX,154762959,1.3202465868087367,670,505,1175,+
chrX,154764903,2.492209348081304,771,511,1282,+
chrX,154765443,0.5004608294930876,1085,769,1854,+
chrX,154765445,0.5004608294930876,1085,769,1854,+
chrX,154765479,1.657986111111111,763,511,1274,+
chrX,154765932,3.0878859857482186,649,420,1069,+
chrX,154766381,1.2325329482238947,989,630,1619,+
chrX,154767279,2.0849557522123896,873,564,1437,+
chrX,154767280,2.0849557522123896,873,564,1437,+
chrX,154768307,0.412580834803057,637,485,1122,+
chrX,154768334,1.8816641753861485,580,445,1025,+
chrX,154769195,2.5342635938292,909,625,1534,+
chrX,154770760,1.1380065145567746,1056,774,1830,+
chrX,154770771,0.5207669998376222,1078,785,1863,+
chrX,154770782,2.47008547008547,1002,766,1768,+
chrX,154770784,2.47008547008547,1002,766,1768,+
chrX,154774617,2.712030902381765,756,661,1417,+
chrX,154777451,1.6458565072302558,622,463,1085,+
chrX,154777461,1.2197479257458648,1104,1028,2132,+
chrX,155033507,1.0690878300938988,1184,782,1966,+
chrX,155046519,2.136876155268022,1100,540,1640,+
chrX,155046539,2.152869393139842,2610,1515,4125,+
chrX,155046540,2.152869393139842,2610,1515,4125,+
chrX,155046548,2.2535062636165577,1350,863,2213,+
chrX,155046566,1.884959669486524,1094,597,1691,+
chrX,155046567,1.8164179104477611,1216,669,1885,+
chrX,155051670,2.2007237344698654,2656,1614,4270,+
chrX,155051671,1.8130096471605006,5540,3673,9213,+
chrX,155051680,1.4790809216709335,1629,1045,2674,+
chrX,155051688,1.4821739130434781,1947,1299,3246,+
chrX,155054615,0.9130277878022377,659,488,1147,+
chrX,155054616,1.5164111603043136,839,637,1476,+
chrX,155054963,2.259566620562472,753,481,1234,+
chrX,155238828,2.0013027930093203,995,713,1708,+
chrX,155238887,0.5453496906784103,742,560,1302,+
chrX,155239376,1.9019573878399447,609,501,1110,+
chrX,155239398,0.5361216730038023,704,525,1229,+
chrX,155239438,2.2542517006802725,722,587,1309,+
chrY,13286678,1.0398098633392752,749,560,1309,+
chrY,13286680,1.0398098633392752,749,560,1309,+
chrY,13286681,0.5328947368421052,620,436,1056,+
chrY,13286799,1.03092977450902,1229,840,2069,+
chrY,13286801,1.1618612380220963,856,657,1513,+
chrY,13286812,0.4881948595337716,890,716,1606,+
chrY,13286814,0.4881948595337716,890,716,1606,+
chrY,13286847,1.7901077521700088,1017,1027,2044,+
chrY,13286848,1.7901077521700088,1017,1027,2044,+
chrY,13286852,2.640673485072453,1406,1331,2737,+
chrY,13286855,2.028245661014679,1092,1145,2237,+
chrY,13287017,0.5608699994196468,2541,1208,3749,+
chrY,13287018,0.832100867607151,4872,2027,6899,+
chrY,13287019,0.6040127734789549,4845,2069,6914,+
chrY,13287020,0.9585895857801237,2852,1240,4092,+
chrY,13287024,1.4642781064682155,2551,1073,3624,+
chrY,13287026,1.4210077546036448,4943,2296,7239,+
chrY,13287027,1.569384744135536,6913,2736,9649,+
chrY,13287028,1.4288601871449833,6234,2297,8531,+
chrY,13287030,1.4309654637949791,5308,2287,7595,+
chrY,13287220,2.277310924369748,812,424,1236,+
chrY,13287221,1.9356247037581304,1013,537,1550,+
chrY,13287224,2.411113179579916,1156,654,1810,+
chrY,13287311,0.5357770745428974,1218,789,2007,+
chr3,6773275,2.8223684210526314,779,569,1348,-
chr3,6773277,2.8223684210526314,779,569,1348,-
chr3,8941611,2.2010712208509986,3713,2545,6258,-
chr3,8941612,2.517466311496942,4506,3138,7644,-
chr3,8941614,2.43161221082757,2398,1796,4194,-
chr3,8941616,2.6345759755831697,2323,1667,3990,-
chr3,8941617,2.1521033591731262,1530,1074,2604,-
chr3,8941624,1.8795104895104893,866,571,1437,-
chr3,8941631,1.8250276854928016,1132,692,1824,-
chr3,8941632,1.8250276854928016,1132,692,1824,-
chr3,8941643,2.3354718961774474,1004,576,1580,-
chr3,9789800,2.575704609606038,824,601,1425,-
chr3,9792305,5.177697816993206,745,500,1245,-
chr3,9842223,2.2018607393893745,686,400,1086,-
chr3,9842225,2.792450704225352,750,354,1104,-
chr3,9973699,3.3965530456875768,605,434,1039,-
chr3,9977400,2.4427336005062217,625,430,1055,-
chr3,9977401,2.4427336005062217,625,430,1055,-
chr3,10301148,2.962097611630322,1140,962,2102,-
chr3,10301155,1.8771478961955157,1111,881,1992,-
chr3,10301156,1.423886236028756,1004,645,1649,-
chr3,10301162,2.46337543053961,893,669,1562,-
chr3,10301180,1.913104089219331,715,537,1252,-
chr3,10301319,1.0861047375941693,1907,1397,3304,-
chr3,10301321,0.8126298026998959,1317,855,2172,-
chr3,10304101,0.6455888033756277,1277,921,2198,-
chr3,10305055,1.8814548162859979,658,423,1081,-
chr3,10305126,4.770876872168125,2012,1393,3405,-
chr3,10305656,2.1299319727891155,807,489,1296,-
chr3,10311980,2.9780299875052068,772,685,1457,-
chr3,10312022,2.086007130124777,905,560,1465,-
chr3,10312028,2.6476190476190475,1111,979,2090,-
chr3,10312044,2.919718309859155,690,425,1115,-
chr3,10312058,1.7378497790868923,884,678,1562,-
chr3,10312061,2.9698713608666227,848,632,1480,-
chr3,10312095,1.117537372396574,1104,596,1700,-
chr3,10312096,1.117537372396574,1104,596,1700,-
chr3,10312612,0.6540785498489425,865,661,1526,-
chr3,10312649,2.191967109424415,716,557,1273,-
chr3,10312679,1.3348427672955976,1515,953,2468,-
chr3,10312680,1.3348427672955976,1515,953,2468,-
chr3,10312709,1.6941794640781453,1235,1024,2259,-
chr3,10315344,0.6511560623960267,843,702,1545,-
chr3,10315365,1.6837800661734637,870,726,1596,-
chr3,10315388,1.0973717543517103,1356,1191,2547,-
chr3,10315416,2.0869786109840978,892,728,1620,-
chr3,10318083,1.8717079497617062,1200,904,2104,-
chr3,10318089,1.9133040719244545,900,727,1627,-
chr3,12587620,2.0301648136356953,732,469,1201,-
chr3,12591777,0.4366482223375074,783,572,1355,-
chr3,12611978,2.6783000281452303,792,560,1352,-
chr3,12611983,2.166103127641589,749,506,1255,-
chr3,12611988,1.9346253582639552,674,430,1104,-
chr3,12611991,0.4311802633102969,697,438,1135,-
chr3,12611994,0.21837708830548927,609,418,1027,-
chr3,12612021,1.916018199600289,1098,602,1700,-
chr3,12612022,1.916018199600289,1098,602,1700,-
chr3,12836184,1.2988122974851646,37275,25611,62886,-
chr3,12836185,1.2988122974851646,37275,25611,62886,-
chr3,12836195,1.388980868810623,5897,3273,9170,-
chr3,12836199,1.4077421288573813,5205,2815,8020,-
chr3,12836208,1.3716827191554402,7942,5683,13625,-
chr3,12836218,1.4054028718722875,21967,12800,34767,-
chr3,12836220,1.4645825606896474,23735,11986,35721,-
chr3,12836221,1.4158144439736757,13103,6744,19847,-
chr3,12836222,1.6057652608004804,10519,4664,15183,-
chr3,12839465,1.2005972737747657,33494,23154,56648,-
chr3,12839484,1.136427298298066,44724,34455,79179,-
chr3,12839530,1.2600240750335814,763,596,1359,-
chr3,12840184,1.218326918545465,21143,16912,38055,-
chr3,12840185,1.1999587876437503,34450,25408,59858,-
chr3,12840196,0.8051799518603431,7773,5828,13601,-
chr3,12840197,1.319853800775434,7355,5616,12971,-
chr3,12840199,1.1727615924344108,6362,4751,11113,-
chr3,12840205,1.2099850033847854,39026,27114,66140,-
chr3,12840206,1.2099850033847854,39026,27114,66140,-
chr3,12840212,1.4825344803444536,5420,4080,9500,-
chr3,12840213,1.2433319828214893,4593,3009,7602,-
chr3,12840214,1.29362563333239,6334,4801,11135,-
chr3,12840216,1.29362563333239,6334,4801,11135,-
chr3,12840225,1.4671286077843333,7939,4921,12860,-
chr3,12840238,1.7232644468941336,6141,2923,9064,-
chr3,12840239,1.7444797985138474,9035,4245,13280,-
chr3,12840241,1.7622807505187033,5919,2746,8665,-
chr3,12841508,1.7743153570366232,3793,2470,6263,-
chr3,12841541,1.7413124230840784,1816,1089,2905,-
chr3,12841544,1.1986269098741331,1589,663,2252,-
chr3,12841545,0.7654499444022477,973,591,1564,-
chr3,12841546,0.7251304494192896,717,456,1173,-
chr3,13316352,2.445155608573008,754,572,1326,-
chr3,13316808,1.5029932651534048,617,421,1038,-
chr3,13316857,2.8069153069153066,577,428,1005,-
chr3,13316890,1.9146799116997792,912,603,1515,-
chr3,13316891,2.045784212518241,1256,843,2099,-
chr3,13317153,3.0923600017303787,811,501,1312,-
chr3,13321769,1.968818689217307,575,505,1080,-
chr3,13322247,0.36537166435475277,757,551,1308,-
chr3,13322266,1.2333469578375533,647,497,1144,-
chr3,13322289,1.419702311006659,658,443,1101,-
chr3,13322290,1.9636869874232055,856,607,1463,-
chr3,13323344,0.6254399195575667,621,441,1062,-
chr3,13327296,1.7191574327125492,627,414,1041,-
chr3,13328798,0.6872578372666432,945,667,1612,-
chr3,13328799,0.3491910029288822,2455,1517,3972,-
chr3,13328800,1.8103931042055559,1690,1300,2990,-
chr3,13328805,1.5018227055917681,3760,2390,6150,-
chr3,13328806,0.6657312435981985,3388,2298,5686,-
chr3,13328808,0.6657312435981985,3388,2298,5686,-
chr3,13328827,0.5270565396748361,1085,633,1718,-
chr3,13328828,0.6494431494431494,1002,701,1703,-
chr3,13328830,0.4589787722317843,949,580,1529,-
chr3,13328842,2.2067694827350888,702,430,1132,-
chr3,13330549,7.689386122870643,718,559,1277,-
chr3,13335555,0.5587092644160974,727,586,1313,-
chr3,13335556,0.6158674624408315,569,451,1020,-
chr3,13335557,0.6158674624408315,569,451,1020,-
chr3,13340254,3.4669980047252125,662,391,1053,-
chr3,13343293,1.77756268958535,673,411,1084,-
chr3,13375582,2.4702349874830993,645,456,1101,-
chr3,13386370,1.3314336940513545,716,678,1394,-
chr3,14943560,0.3682575545828695,1284,643,1927,-
chr3,14943561,0.3955638858899939,1810,1012,2822,-
chr3,14943692,2.476483748481233,648,448,1096,-
chr3,14944281,0.5696079568812412,648,458,1106,-
chr3,14944338,2.44316484797254,574,427,1001,-
chr3,14945817,2.1435271342234006,870,613,1483,-
chr3,14946098,0.40653378032407533,786,560,1346,-
chr3,15052268,8.481595872094294,1109,917,2026,-
chr3,15052271,35.31316083598106,1136,774,1910,-
chr3,15059384,1.4887531549062387,5894,3736,9630,-
chr3,15059388,1.309599118918831,2742,1690,4432,-
chr3,15059404,0.9911827256902668,5752,4176,9928,-
chr3,15059406,1.4377209428804514,4439,2611,7050,-
chr3,15059407,1.125919767667933,7616,5283,12899,-
chr3,15059411,1.5633979885057474,1740,959,2699,-
chr3,15059421,1.7954086173623862,4044,3019,7063,-
chr3,15059438,1.517455214471544,4023,3162,7185,-
chr3,15059439,1.517455214471544,4023,3162,7185,-
chr3,15059447,1.6802979313615818,4807,3320,8127,-
chr3,15059448,1.6656391336419398,5631,3778,9409,-
chr3,15059449,1.6802979313615818,4807,3320,8127,-
chr3,15059452,1.9775917926565878,1464,925,2389,-
chr3,15059460,1.874843939497151,3016,1759,4775,-
chr3,15059462,2.1251149242811307,3994,2399,6393,-
chr3,15059463,2.188974688974689,2354,1331,3685,-
chr3,15059473,1.810999005257922,943,453,1396,-
chr3,15065091,2.8296610169491534,741,471,1212,-
chr3,15065093,2.8296610169491534,741,471,1212,-
chr3,15065096,0.4934769355821988,1867,1109,2976,-
chr3,15065097,0.4934769355821988,1867,1109,2976,-
chr3,15065098,0.4934769355821988,1867,1109,2976,-
chr3,15255171,1.977761304670126,695,425,1120,-
chr3,15255325,0.53035413153457,591,592,1183,-
chr3,15255328,8.861111111111109,538,881,1419,-
chr3,15255370,4.786765926023276,2183,3359,5542,-
chr3,15255371,4.786765926023276,2183,3359,5542,-
chr3,15255387,5.498992020209103,1949,2011,3960,-
chr3,15255388,5.868425763463385,1792,1787,3579,-
chr3,15255399,4.838689306763963,542,508,1050,-
chr3,15255401,7.355042920618697,2012,1433,3445,-
chr3,15255402,9.136543139353687,1732,1172,2904,-
chr3,15255409,7.29193075641039,990,255,1245,-
chr3,15255416,9.543295019157087,957,173,1130,-
chr3,15255417,10.576346245875188,1605,280,1885,-
chr3,15255418,13.014782706223553,1812,283,2095,-
chr3,15255419,17.849999999999994,951,127,1078,-
chr3,15255420,16.746613851265014,1129,149,1278,-
chr3,15255683,2.2742735580140807,1310,1116,2426,-
chr3,15255747,2.7655041804104696,914,630,1544,-
chr3,15256257,2.1603207310882806,643,629,1272,-
chr3,15257015,2.273798657415867,630,386,1016,-
chr3,15262191,1.3069480897900212,821,593,1414,-
chr3,15262245,1.3167685420586206,605,425,1030,-
chr3,15332295,2.5647738869438967,798,1142,1940,-
chr3,15568570,2.957443665260434,842,521,1363,-
chr3,15575073,2.2648474775497682,629,415,1044,-
chr3,15686292,1.0680613310607225,590,427,1017,-
chr3,15796570,2.4297520661157024,1028,846,1874,-
chr3,15796572,2.4297520661157024,1028,846,1874,-
chr3,25615496,1.476791475397747,668,480,1148,-
chr3,25624334,2.295260021017283,771,512,1283,-
chr3,25624335,2.869122807017544,628,379,1007,-
chr3,25626847,2.295344474017191,1696,1598,3294,-
chr3,25626848,2.295344474017191,1696,1598,3294,-
chr3,25626853,2.542921930677033,784,685,1469,-
chr3,25626857,2.207142857142857,720,587,1307,-
chr3,25626862,1.7348657259899867,846,506,1352,-
chr3,25627207,1.680409663865546,710,407,1117,-
chr3,25627213,1.2077100100563445,1285,873,2158,-
chr3,25632529,6.64418039987786,591,420,1011,-
chr3,27404930,0.9177404094050393,1500,955,2455,-
chr3,27404934,0.5786199095022624,681,441,1122,-
chr3,27404954,1.4982143178647067,693,480,1173,-
chr3,27404956,1.5559778642284494,710,506,1216,-
chr3,28323910,2.258346273291925,894,671,1565,-
chr3,28323913,1.7637700192755723,2081,1420,3501,-
chr3,28323918,1.570451570237537,1266,812,2078,-
chr3,28323921,1.995747696669029,639,414,1053,-
chr3,28323925,0.5900170648464164,921,585,1506,-
chr3,28332403,1.7279923451635348,684,478,1162,-
chr3,28336840,2.6910116997311233,787,603,1390,-
chr3,28336843,2.013885944320565,2418,1675,4093,-
chr3,28336844,2.013885944320565,2418,1675,4093,-
chr3,31702495,2.1118031791249634,900,694,1594,-
chr3,31733273,1.6213540480469733,625,450,1075,-
chr3,32482645,1.151274654424129,688,480,1168,-
chr3,32635302,1.192059714577417,2603,2084,4687,-
chr3,32635303,2.3014864282636798,928,843,1771,-
chr3,32635304,0.5677063017802255,2372,1796,4168,-
chr3,32635305,0.5597846006371762,1443,1125,2568,-
chr3,32635327,2.106698564593301,776,569,1345,-
chr3,32635341,1.7601952610767189,677,405,1082,-
chr3,33014162,1.8291135265315384,613,552,1165,-
chr3,33016754,1.737994568118296,1240,912,2152,-
chr3,33018494,4.158466355318562,774,607,1381,-
chr3,33024321,2.153675450762829,646,514,1160,-
chr3,33024322,1.3856217663404782,711,508,1219,-
chr3,33024323,2.153675450762829,646,514,1160,-
chr3,33046130,2.483246463142219,666,473,1139,-
chr3,33046132,2.483246463142219,666,473,1139,-
chr3,33065512,0.49879334836201844,814,614,1428,-
chr3,33072690,0.909027380725494,697,593,1290,-
chr3,33072692,1.636083021026629,744,599,1343,-
chr3,33072697,3.2708923682456694,723,512,1235,-
chr3,33389795,1.2918824763792374,768,536,1304,-
chr3,33409484,1.7949340476827056,1280,959,2239,-
chr3,33409487,1.7948250648873638,908,598,1506,-
chr3,38122965,2.718458726411664,620,396,1016,-
chr3,42784965,1.0811913504691963,1059,644,1703,-
chr3,42784966,1.0811913504691963,1059,644,1703,-
chr3,42784980,3.4741573033707867,772,444,1216,-
chr3,42784981,0.3843807199511897,629,446,1075,-
chr3,42784990,2.377525557433792,1135,605,1740,-
chr3,42784991,2.377525557433792,1135,605,1740,-
chr3,42785011,1.1014994232987312,954,458,1412,-
chr3,42785013,1.1014994232987312,954,458,1412,-
chr3,42785272,2.205267629566695,926,534,1460,-
chr3,42786123,1.7278043593833068,624,494,1118,-
chr3,42804497,1.0207966457023059,657,449,1106,-
chr3,42804498,1.0207966457023059,657,449,1106,-
chr3,44926049,5.440332716735262,770,641,1411,-
chr3,45827415,2.3350960181734663,805,607,1412,-
chr3,45827416,2.436123348017621,552,453,1005,-
chr3,45827429,5.396144396144395,630,371,1001,-
chr3,47587713,10.242731478818396,1166,1027,2193,-
chr3,47587714,9.635633549093157,1323,1157,2480,-
chr3,47680455,0.8140560560578923,1084,717,1801,-
chr3,47680457,0.9339875185158204,880,563,1443,-
chr3,47686162,2.0397647727318136,594,458,1052,-
chr3,47701326,3.451368011081404,648,454,1102,-
chr3,47710739,2.414814814814815,651,539,1190,-
chr3,47710740,2.414814814814815,651,539,1190,-
chr3,47851065,5.9788877788877794,548,453,1001,-
chr3,47851637,0.3387096774193549,671,495,1166,-
chr3,47851652,1.190069817142244,1538,1250,2788,-
chr3,47851654,1.0220231978139216,1344,997,2341,-
chr3,47851709,2.7887657148056597,687,463,1150,-
chr3,47852304,2.326817149260503,984,683,1667,-
chr3,47852305,1.8818335877712897,1011,763,1774,-
chr3,47852306,1.2075829383886254,881,632,1513,-
chr3,47852561,0.3516787815853236,507,641,1148,-
chr3,47852562,0.3516787815853236,507,641,1148,-
chr3,47852568,3.370247264373375,713,677,1390,-
chr3,47852576,1.6771146809764401,858,883,1741,-
chr3,47852582,1.4986922151057664,538,476,1014,-
chr3,47852590,6.805842759408708,899,645,1544,-
chr3,47852591,6.507936507936507,655,440,1095,-
chr3,47852596,5.359202573635919,1411,1033,2444,-
chr3,47852599,4.427683658130482,1494,960,2454,-
chr3,47852600,5.080564487271286,1038,676,1714,-
chr3,47852601,5.358092014780334,1108,772,1880,-
chr3,47855282,3.1353456669912365,689,473,1162,-
chr3,47855283,3.1353456669912365,689,473,1162,-
chr3,47867271,1.2917465916296766,770,558,1328,-
chr3,47869313,2.3428368477537593,632,516,1148,-
chr3,47870875,0.35414483721856127,734,487,1221,-
chr3,47871250,3.518730774144878,687,494,1181,-
chr3,47875745,2.47377243015495,989,649,1638,-
chr3,47875794,3.347826086956522,659,367,1026,-
chr3,47875795,3.347826086956522,659,367,1026,-
chr3,47916288,1.7734952742728551,1580,1132,2712,-
chr3,48174392,0.38262993796406414,743,586,1329,-
chr3,48174394,0.38262993796406414,743,586,1329,-
chr3,48434918,2.818548472532758,1140,656,1796,-
chr3,48467968,1.174834919055942,1146,827,1973,-
chr3,48467996,1.5824989675711352,1236,1035,2271,-
chr3,48468018,3.0921732530460746,737,559,1296,-
chr3,48468487,2.2215639311698028,691,466,1157,-
chr3,48468784,9.19285714285714,1022,619,1641,-
chr3,48468785,9.19285714285714,1022,619,1641,-
chr3,48468786,8.638973286875723,1252,798,2050,-
chr3,48469144,2.3041765169424746,687,375,1062,-
chr3,48469146,2.3041765169424746,687,375,1062,-
chr3,48473095,0.613437303716891,974,895,1869,-
chr3,48473096,0.7462412907957462,549,504,1053,-
chr3,48473097,0.43127876096327145,702,592,1294,-
chr3,48564172,19.913757354876807,718,570,1288,-
chr3,48575885,2.3612988734261102,523,502,1025,-
chr3,48575894,1.9938391425436743,874,696,1570,-
chr3,48575896,2.118086956521739,1281,999,2280,-
chr3,48575897,2.3338364979741,1223,920,2143,-
chr3,48575899,2.21345403190479,1385,980,2365,-
chr3,48575900,2.6224489795918364,770,545,1315,-
chr3,48588759,4.719370478893372,597,420,1017,-
chr3,48599065,1.04476281060516,702,646,1348,-
chr3,48599066,0.5495444191343963,1157,877,2034,-
chr3,48599067,0.6927966106360842,2155,1779,3934,-
chr3,48599168,1.5566767307590441,1108,898,2006,-
chr3,48599657,1.6672629695885512,1164,909,2073,-
chr3,48599663,1.421861656703672,1844,1170,3014,-
chr3,48599669,2.009419152276295,1023,818,1841,-
chr3,48599697,1.488432267884323,888,729,1617,-
chr3,48600074,0.6454114663022509,1987,1492,3479,-
chr3,48600083,1.6829268292682928,735,655,1390,-
chr3,48600516,1.6448495716278142,868,716,1584,-
chr3,48600517,0.6370048309178744,1387,1103,2490,-
chr3,48600520,1.5874797916292436,1749,1171,2920,-
chr3,48600521,1.5874797916292436,1749,1171,2920,-
chr3,48600538,1.58730812815494,855,570,1425,-
chr3,48600715,1.31933158392586,3560,2474,6034,-
chr3,48600788,1.5387438825448614,1616,1225,2841,-
chr3,48600789,0.6485747192628851,900,754,1654,-
chr3,48600803,2.1205732946298985,846,688,1534,-
chr3,48600816,2.0236338077666494,742,541,1283,-
chr3,48600825,1.9207088776104504,1214,706,1920,-
chr3,48600999,1.8006311637080867,786,506,1292,-
chr3,48601002,0.9913565065069492,2000,1036,3036,-
chr3,48601003,0.9913565065069492,2000,1036,3036,-
chr3,48601092,1.7031731640979149,1514,1102,2616,-
chr3,48601094,1.7031731640979149,1514,1102,2616,-
chr3,48601445,1.948173306303787,1568,1408,2976,-
chr3,48603596,1.995274914089347,928,775,1703,-
chr3,48603601,0.6041422253234192,1965,1544,3509,-
chr3,48603603,1.5448498669707336,1477,876,2353,-
chr3,48604323,1.4816073830842893,1204,946,2150,-
chr3,48604337,1.4652084899059268,1046,820,1866,-
chr3,48604379,1.4501826799644515,1048,778,1826,-
chr3,48604677,1.65088890720743,2833,1732,4565,-
chr3,48604685,1.6909212283044062,2532,1283,3815,-
chr3,48604717,1.540845768967077,3363,2538,5901,-
chr3,48604718,0.7072503790340047,3113,1943,5056,-
chr3,48604719,1.259546732785928,7867,5430,13297,-
chr3,48604720,1.6223151797924544,2880,2004,4884,-
chr3,48604771,1.6150602409638553,2297,1659,3956,-
chr3,48604772,0.6409636386080994,2583,1721,4304,-
chr3,48604773,1.6150602409638553,2297,1659,3956,-
chr3,48605811,0.9081748392237836,3491,2721,6212,-
chr3,48605812,0.5961082424937847,2010,1659,3669,-
chr3,48605845,1.5865962484064833,725,577,1302,-
chr3,48609179,2.2924538148418745,1155,736,1891,-
chr3,48609210,1.8916109873793616,587,448,1035,-
chr3,48609224,2.2440296003674916,925,755,1680,-
chr3,48609272,2.2324159021406733,729,435,1164,-
chr3,48609571,2.4330864197530864,757,404,1161,-
chr3,48609576,1.8977460832465494,1591,1096,2687,-
chr3,48609578,1.8307391587634836,871,726,1597,-
chr3,48609633,2.226829268292683,912,389,1301,-
chr3,48609634,2.226829268292683,912,389,1301,-
chr3,48609638,1.5033755070298727,904,497,1401,-
chr3,48609643,1.2044311214586743,955,314,1269,-
chr3,48628007,2.540402639814759,1354,772,2126,-
chr3,48717187,0.6536302168872782,1241,918,2159,-
chr3,48717195,2.105776117866306,671,432,1103,-
chr3,48717199,2.0565744934790087,1336,991,2327,-
chr3,48717200,1.9958106813464436,1593,1165,2758,-
chr3,48717202,1.945260477148999,733,515,1248,-
chr3,49024670,1.3353503413582464,6326,5224,11550,-
chr3,49024676,1.4456468747119071,25099,17142,42241,-
chr3,49024677,1.744710259792246,18844,13515,32359,-
chr3,49024678,1.742916310515274,22806,15902,38708,-
chr3,49024679,1.4631987083280507,28543,17888,46431,-
chr3,49024680,1.3916776071314632,23728,14310,38038,-
chr3,49024710,1.506971013690935,4568,2830,7398,-
chr3,49024734,0.7383522363006912,1948,1417,3365,-
chr3,49024784,0.8966900505195927,6089,3472,9561,-
chr3,49024785,0.7743164190439022,9914,5835,15749,-
chr3,49024794,0.621022914301375,3378,2176,5554,-
chr3,49024798,1.4925408831355198,1782,1078,2860,-
chr3,49024910,0.4864277958740499,1791,1227,3018,-
chr3,49024927,0.38368441002869996,1531,1251,2782,-
chr3,49024961,1.718150707044618,2254,1821,4075,-
chr3,49024962,1.718150707044618,2254,1821,4075,-
chr3,49024970,0.5919326899282356,1103,897,2000,-
chr3,49025160,1.7973231000791088,2385,1683,4068,-
chr3,49025178,1.741788617886179,1338,1049,2387,-
chr3,49025220,0.5234567901234568,847,728,1575,-
chr3,49025230,0.4022086602731764,691,650,1341,-
chr3,49025235,1.8931698774080559,712,570,1282,-
chr3,49025243,1.1099874253828539,1372,1166,2538,-
chr3,49025246,1.7597332527015215,1642,1185,2827,-
chr3,49025247,0.5762077693408166,615,465,1080,-
chr3,49026335,1.5497329827552153,2114,1462,3576,-
chr3,49026337,1.9646025878003692,732,540,1272,-
chr3,49026595,1.3817373853211008,1682,1198,2880,-
chr3,49026723,2.1111111111111107,1341,1097,2438,-
chr3,49026735,1.0739084444718214,2946,2327,5273,-
chr3,49026736,1.6078019323671502,1798,1149,2947,-
chr3,49026784,0.7034373923383825,1375,1138,2513,-
chr3,49026819,0.7201646090534978,1924,1349,3273,-
chr3,49027750,0.5445810107983301,933,808,1741,-
chr3,49027812,1.525139664804469,1091,894,1985,-
chr3,49027852,1.482069629833494,1098,844,1942,-
chr3,49027899,1.5885750962772784,1079,778,1857,-
chr3,49028302,1.7194154550801215,9211,8357,17568,-
chr3,49028310,1.8618250246247483,8159,6774,14933,-
chr3,49028311,1.8618250246247483,8159,6774,14933,-
chr3,49028459,1.4075917736241041,5536,4048,9584,-
chr3,49028465,1.4939387406370144,5037,4230,9267,-
chr3,49028473,1.666517471248952,4345,3476,7821,-
chr3,49028495,1.726458274135046,3625,2353,5978,-
chr3,49028500,1.6541975593875364,1485,1012,2497,-
chr3,49028506,1.3827510548523203,1462,1184,2646,-
chr3,49028507,0.6251832111925383,2719,1899,4618,-
chr3,49028508,0.6251832111925383,2719,1899,4618,-
chr3,49029300,1.498407643312102,940,784,1724,-
chr3,49029334,1.7560567212600071,838,658,1496,-
chr3,49029335,1.802206120904077,1514,1320,2834,-
chr3,49029336,1.802206120904077,1514,1320,2834,-
chr3,49046523,0.37803089785642346,637,449,1086,-
chr3,49057707,2.3919033551778437,880,482,1362,-
chr3,49057747,3.0235368956742996,678,392,1070,-
chr3,49057748,3.0235368956742996,678,392,1070,-
chr3,49057749,3.0235368956742996,678,392,1070,-
chr3,49098043,0.6463264982978386,932,742,1674,-
chr3,49098050,1.7216318785578748,843,526,1369,-
chr3,49098097,1.7613751263902933,669,429,1098,-
chr3,49098247,2.4483648881239244,568,497,1065,-
chr3,49098361,1.611336032388664,596,493,1089,-
chr3,49098405,1.9130753999755734,2078,1515,3593,-
chr3,49098423,1.996514464970373,715,452,1167,-
chr3,49098443,2.351851851851852,634,404,1038,-
chr3,49098673,1.8723361893379096,903,597,1500,-
chr3,49099132,2.136416184971098,1007,691,1698,-
chr3,49099134,2.136416184971098,1007,691,1698,-
chr3,49099234,2.511402884996881,1058,675,1733,-
chr3,49099235,2.7019700992035767,585,420,1005,-
chr3,49099357,1.8134666689608232,845,509,1354,-
chr3,49099360,6.071428571428571,679,489,1168,-
chr3,49099362,6.071428571428571,679,489,1168,-
chr3,49099636,2.137532436895494,696,470,1166,-
chr3,49099773,1.9358316811261924,1301,968,2269,-
chr3,49099791,2.171535194955604,674,408,1082,-
chr3,49100020,3.351351351351352,805,628,1433,-
chr3,49100021,2.400453132341678,1143,950,2093,-
chr3,49100454,1.2013203300825208,1081,774,1855,-
chr3,49100455,1.9523220164675803,1436,1024,2460,-
chr3,49100668,2.0844087695537667,853,656,1509,-
chr3,49101419,1.4050465458108774,868,784,1652,-
chr3,49101420,1.7494796402865374,1983,1566,3549,-
chr3,49101652,0.6346139628872076,695,526,1221,-
chr3,49102433,1.5609148490711051,1201,1166,2367,-
chr3,49102439,1.5918265137476837,1095,973,2068,-
chr3,49102448,0.937556683921201,1766,1486,3252,-
chr3,49102450,1.1245715631807727,2392,2043,4435,-
chr3,49102461,1.9397459165154265,667,550,1217,-
chr3,49103363,1.5933516483516483,616,454,1070,-
chr3,49103364,1.7735426008968609,564,445,1009,-
chr3,49103373,0.47315629005483467,958,705,1663,-
chr3,49103407,2.652083043384476,809,550,1359,-
chr3,49104395,2.161990579561745,781,513,1294,-
chr3,49104420,1.1015173890573005,1111,858,1969,-
chr3,49104466,2.4715072038835992,734,454,1188,-
chr3,49104657,1.3787367405978783,601,487,1088,-
chr3,49104659,1.3787367405978783,601,487,1088,-
chr3,49104750,0.8326446280991736,688,317,1005,-
chr3,49104751,0.7458107502585873,1507,804,2311,-
chr3,49357239,1.9140306733764678,742,641,1383,-
chr3,49357270,1.6112366412213739,775,654,1429,-
chr3,49357271,1.3494013616088896,1436,982,2418,-
chr3,49357273,2.497505345687812,729,609,1338,-
chr3,49357274,0.6410429918347093,1014,820,1834,-
chr3,49357306,2.3236859614105128,634,500,1134,-
chr3,49357328,1.6292613636363638,1084,703,1787,-
chr3,49357333,1.7883780332056192,736,539,1275,-
chr3,49357352,2.186887254901961,912,543,1455,-
chr3,49357365,2.440613026819923,636,376,1012,-
chr3,49357378,2.3178173277399585,717,493,1210,-
chr3,49357523,2.44507338233438,1641,1063,2704,-
chr3,49357720,0.7070660295943928,987,616,1603,-
chr3,49357721,1.7156766002236694,651,562,1213,-
chr3,49357739,2.917298180732845,891,584,1475,-
chr3,49358156,2.388197325956662,739,481,1220,-
chr3,49358164,2.3442745244311824,1256,765,2021,-
chr3,49358165,2.4146607637591044,1533,1000,2533,-
chr3,49358286,0.42708661446546453,752,437,1189,-
chr3,49359394,2.1824607908106914,1139,1005,2144,-
chr3,49359398,0.4933799533799534,1113,714,1827,-
chr3,49359737,1.638434868746904,1653,1345,2998,-
chr3,49359739,1.3818699818699818,1441,1169,2610,-
chr3,49360081,1.509956948656501,1757,1545,3302,-
chr3,49360209,1.7146472805600435,1872,1237,3109,-
chr3,49360236,0.6419726393584402,1718,1105,2823,-
chr3,49360364,1.8416087375188832,2528,1811,4339,-
chr3,49368479,1.6669015970567922,1764,1162,2926,-
chr3,49368507,1.5111546519748584,1276,1051,2327,-
chr3,49368511,1.4406341521726138,1438,857,2295,-
chr3,49368513,1.8189937896866928,1063,842,1905,-
chr3,49375464,1.6287388553350592,1393,1158,2551,-
chr3,49375503,1.465032784481053,2787,2045,4832,-
chr3,49375572,1.8121544497948991,1675,1423,3098,-
chr3,49375573,1.8121544497948991,1675,1423,3098,-
chr3,49411847,2.051179350244771,837,641,1478,-
chr3,49411848,1.5424083418817558,1471,1104,2575,-
chr3,49411922,1.3816125184492543,2071,1399,3470,-
chr3,49411923,1.824607683982684,1299,923,2222,-
chr3,49411943,2.809139851855183,673,560,1233,-
chr3,50288160,1.960206337509212,531,471,1002,-
chr3,50288166,2.023335878890203,1372,1044,2416,-
chr3,50288167,2.0492513790386133,742,657,1399,-
chr3,50288234,2.3323066084939463,964,698,1662,-
chr3,50288484,0.8736757492612006,1149,792,1941,-
chr3,50288485,1.3747718171017596,936,719,1655,-
chr3,50288695,2.8224598930481277,753,560,1313,-
chr3,50288696,2.8224598930481277,753,560,1313,-
chr3,50288697,2.82139825690841,1122,784,1906,-
chr3,50288866,3.3230769230769237,647,415,1062,-
chr3,50288867,3.1059855985598563,962,605,1567,-
chr3,50288869,3.797619047619047,637,391,1028,-
chr3,50288873,2.207664597257963,681,446,1127,-
chr3,50289296,2.1535734711984134,788,518,1306,-
chr3,50289598,1.6484911919360308,650,541,1191,-
chr3,50290188,1.3246899023113856,585,427,1012,-
chr3,50317895,12.67379443874843,756,662,1418,-
chr3,51968583,2.8335521517140765,606,456,1062,-
chr3,51968584,2.8335521517140765,606,456,1062,-
chr3,51968613,4.131683273262284,740,480,1220,-
chr3,51993802,1.2855369204083023,24841,18981,43822,-
chr3,51993808,1.41750541240229,6712,5285,11997,-
chr3,51993828,1.436389865195734,14055,9202,23257,-
chr3,51993831,1.395255741853705,19177,13538,32715,-
chr3,51993834,1.4003061435709996,19830,12121,31951,-
chr3,51993836,1.3192990995376004,20849,11739,32588,-
chr3,51993838,1.33765748413554,24428,14989,39417,-
chr3,51993839,1.2845815531447455,23088,13915,37003,-
chr3,51993840,1.2863430549897723,9994,6716,16710,-
chr3,51993933,1.2718272093533782,53892,35587,89479,-
chr3,51993935,1.2718272093533782,53892,35587,89479,-
chr3,51993971,0.6919386987209079,17193,10283,27476,-
chr3,51993977,1.2624705021873233,5287,3109,8396,-
chr3,51993978,1.366763483661198,5566,2668,8234,-
chr3,51993984,1.353004558434774,17725,10127,27852,-
chr3,51993985,1.2851475735083326,9265,4243,13508,-
chr3,51993989,1.3456002633426376,4005,1740,5745,-
chr3,51993999,1.3271719657776215,2979,2314,5293,-
chr3,51994002,1.3912675330412694,2906,1180,4086,-
chr3,51994003,1.4375917176711397,4278,2947,7225,-
chr3,51994011,1.4514614569135245,2395,922,3317,-
chr3,51994076,0.5904547045781633,659,546,1205,-
chr3,51994077,0.6418596582531008,739,426,1165,-
chr3,51994085,1.4535984303557272,830,656,1486,-
chr3,51994090,0.3146660403790758,754,513,1267,-
chr3,51995887,1.9461817170164974,1564,1046,2610,-
chr3,51995902,1.291706896551724,662,399,1061,-
chr3,51995922,0.6080013189515816,691,511,1202,-
chr3,52228672,8.556502394009588,1684,1236,2920,-
chr3,52228673,8.55650239400959,1684,1236,2920,-
chr3,52228674,8.682110238424848,1454,975,2429,-
chr3,52409564,1.7634111384111384,1059,1055,2114,-
chr3,52409566,1.7834623264284086,1553,1527,3080,-
chr3,52409568,1.8250978890023837,1008,978,1986,-
chr3,52409570,0.3494071717755928,536,493,1029,-
chr3,52409578,0.5022792763157414,684,663,1347,-
chr3,52409592,2.038864459696821,784,618,1402,-
chr3,52451420,2.6364015688892595,717,520,1237,-
chr3,52451422,3.03921568627451,712,482,1194,-
chr3,52527717,0.2454522330796787,667,439,1106,-
chr3,52527927,1.4970553154434025,846,552,1398,-
chr3,52527928,0.6538013749260791,720,526,1246,-
chr3,52528197,1.1748913122919973,760,685,1445,-
chr3,52697734,1.266546373364401,694,454,1148,-
chr3,52697740,3.3019059295549584,891,602,1493,-
chr3,53225726,1.238919312347873,10816,11209,22025,-
chr3,53225728,6.986623976650456,49507,52334,101841,-
chr3,53225729,11.535420730135057,57972,55221,113193,-
chr3,53225730,11.535420730135057,57972,55221,113193,-
chr3,53225731,17.55957776519329,42923,37076,79999,-
chr3,53225735,11.00686714037507,5524,1944,7468,-
chr3,53225744,2.1444357713060818,11377,3632,15009,-
chr3,53225746,2.251653613374189,32638,10138,42776,-
chr3,53225747,2.5433943626668594,37652,12437,50089,-
chr3,53225748,2.439875461409332,48112,15924,64036,-
chr3,53225750,2.171222925314511,25765,8623,34388,-
chr3,53225848,1.3150175055463118,4484,3605,8089,-
chr3,53225863,1.2519417721358859,4018,3193,7211,-
chr3,53226874,1.232523821882763,4616,3852,8468,-
chr3,53226877,1.5520900682259444,7706,5626,13332,-
chr3,53228295,0.7700965439190695,10548,9046,19594,-
chr3,53228326,1.3940972223832664,49426,37938,87364,-
chr3,53228327,1.4064501684521036,64524,49144,113668,-
chr3,53228328,1.4351250911416018,71860,55104,126964,-
chr3,53228329,1.427254879407726,54900,41846,96746,-
chr3,53228330,1.4605801613400755,22908,19010,41918,-
chr3,53228351,1.4031206444226332,15053,10805,25858,-
chr3,53229095,1.2459735910592238,12223,8704,20927,-
chr3,53229099,1.1764135511086875,5619,4483,10102,-
chr3,53229118,1.3695959666739221,9438,6256,15694,-
chr3,53229380,1.4370252596215811,4610,2756,7366,-
chr3,53229381,1.3270615491288535,8085,6279,14364,-
chr3,53229384,2.135812332050258,3675,2809,6484,-
chr3,53229405,2.059229931766106,4308,2357,6665,-
chr3,53230509,1.045042529014056,20299,16083,36382,-
chr3,53230511,0.9725982987909179,12038,9998,22036,-
chr3,53230567,1.5831382799446394,17590,12125,29715,-
chr3,53230569,1.4191577570676466,33054,21273,54327,-
chr3,53230570,1.3242064156345028,16874,11218,28092,-
chr3,53231468,1.2954807476352368,9373,7850,17223,-
chr3,53231474,0.7272913632525181,6094,4044,10138,-
chr3,53231538,1.4157395363961538,4851,3913,8764,-
chr3,53231541,1.1859814308296182,5262,3691,8953,-
chr3,53231542,1.3968502787127566,8506,6605,15111,-
chr3,53231543,1.4117501300800055,12387,9562,21949,-
chr3,53231545,1.2016353241630051,10865,8507,19372,-
chr3,53233198,0.7654428904428904,2626,2287,4913,-
chr3,53233209,1.20095884205025,9412,6873,16285,-
chr3,53235093,1.3030383220265338,25611,16673,42284,-
chr3,53235094,1.3030383220265338,25611,16673,42284,-
chr3,53235095,1.2894979177667367,15606,9096,24702,-
chr3,53235162,1.2317347595380086,21611,15276,36887,-
chr3,53240266,1.3125719504240052,10141,7499,17640,-
chr3,53240268,1.3115790910897311,19264,13960,33224,-
chr3,53240269,1.2973640951627816,14067,10086,24153,-
chr3,53240270,1.1217641338774582,22510,15484,37994,-
chr3,53240275,1.5468394834840642,3997,2696,6693,-
chr3,53240278,1.420404267258774,7254,4523,11777,-
chr3,53241165,1.1773065644033387,4604,2820,7424,-
chr3,53241166,0.7111249877462941,6879,5327,12206,-
chr3,53241177,1.5573927649767136,7603,5371,12974,-
chr3,53241222,1.3685436181903816,4335,3151,7486,-
chr3,53242149,0.853538431181373,5497,4151,9648,-
chr3,53242157,1.3074519300251468,4599,3022,7621,-
chr3,53242174,1.2372424307638854,3698,3397,7095,-
chr3,53242195,1.2770499217337956,7544,6058,13602,-
chr3,53242212,1.5001702675091757,2831,2222,5053,-
chr3,53242229,1.4880141286422923,5224,3553,8777,-
chr3,53255916,1.4274696762985828,5127,4237,9364,-
chr3,53255980,1.175895132904479,4622,3541,8163,-
chr3,53255982,1.1546024693215524,6770,5588,12358,-
chr3,53255986,0.6674470356697239,3311,2420,5731,-
chr3,53255987,0.6473606911636578,5808,4720,10528,-
chr3,53255996,1.4880002203749296,2174,1501,3675,-
chr3,53256007,1.5681330472103003,789,465,1254,-
chr3,53256013,1.814476645523603,1152,752,1904,-
chr3,53256014,0.7671060891399875,939,884,1823,-
chr3,53256015,0.6485413710098801,1284,1247,2531,-
chr3,53885536,2.4941239316239314,666,519,1185,-
chr3,53885538,2.4941239316239314,666,519,1185,-
chr3,53885544,1.9683540082699744,880,587,1467,-
chr3,53885545,1.9295103792801513,1275,911,2186,-
chr3,53885546,1.9683540082699744,880,587,1467,-
chr3,53885859,0.17849343028824327,1559,1060,2619,-
chr3,53885860,0.2552747339927065,1346,953,2299,-
chr3,53888482,1.6099917198485456,954,727,1681,-
chr3,53891783,0.4731269349845201,848,645,1493,-
chr3,53891785,0.4731269349845201,848,645,1493,-
chr3,53891846,0.8641721692345316,630,434,1064,-
chr3,53891847,1.0745331236521396,1309,1110,2419,-
chr3,53891849,1.0485602217571168,659,578,1237,-
chr3,55466292,1.9426712675007636,2764,2441,5205,-
chr3,55466293,2.0167094784427535,2182,1971,4153,-
chr3,55466336,2.813769937852414,1009,757,1766,-
chr3,55466353,1.3392592029235293,843,622,1465,-
chr3,55467972,1.0974094767457871,2132,1574,3706,-
chr3,55467980,1.9756468797564688,825,656,1481,-
chr3,55467982,0.6899766899766899,1109,659,1768,-
chr3,55467986,1.1252235998771947,1438,968,2406,-
chr3,55468588,2.1498316047303763,616,444,1060,-
chr3,55469395,2.4315532664678776,689,526,1215,-
chr3,55469396,2.4315532664678776,689,526,1215,-
chr3,55469493,1.8827426128831735,1790,1108,2898,-
chr3,55469495,1.9539560233038904,1123,625,1748,-
chr3,56627091,1.4177818503229074,593,416,1009,-
chr3,56682741,1.6143203763174627,748,403,1151,-
chr3,56682747,2.2356687898089174,935,470,1405,-
chr3,56682749,1.726669908372313,1250,686,1936,-
chr3,56745285,1.9693211822502439,614,398,1012,-
chr3,57571966,1.407964425565806,1452,1234,2686,-
chr3,57571981,1.7588327091136082,1198,889,2087,-
chr3,57572045,2.0581095041322315,1225,725,1950,-
chr3,57572232,1.9485378506174544,1958,1232,3190,-
chr3,57572274,1.6927397402354456,3779,2591,6370,-
chr3,57575626,2.41184625078765,1366,1057,2423,-
chr3,57575652,1.764385854781335,1359,1061,2420,-
chr3,57575660,1.7791785679109622,2257,1561,3818,-
chr3,57575661,1.7791785679109622,2257,1561,3818,-
chr3,57575664,0.554843205574913,1326,819,2145,-
chr3,57577369,1.7107261288623052,1149,786,1935,-
chr3,57583980,1.7693034238488785,1650,1000,2650,-
chr3,57584409,1.6925110132158592,1242,907,2149,-
chr3,57597148,2.0819702951682646,790,590,1380,-
chr3,57597155,1.6732267322673229,741,541,1282,-
chr3,57597160,0.3461603091917325,617,540,1157,-
chr3,57597298,1.4705690217952914,778,659,1437,-
chr3,57597336,2.871180623272906,687,414,1101,-
chr3,58430905,1.0705954573357888,871,542,1413,-
chr3,58430906,1.0705954573357888,871,542,1413,-
chr3,61742457,0.9501466616887302,2582,1774,4356,-
chr3,61742524,1.3887961201701782,1738,1128,2866,-
chr3,61742525,1.3887961201701782,1738,1128,2866,-
chr3,61742630,0.7593656156782427,3164,2459,5623,-
chr3,61742631,0.479461428963704,3482,2415,5897,-
chr3,61742632,0.44682100913729883,2838,2137,4975,-
chr3,61742634,0.3012108375959079,1808,1471,3279,-
chr3,61742636,0.3163626209977662,1132,947,2079,-
chr3,61742681,2.878182834080586,869,522,1391,-
chr3,61742865,0.6763108106727945,691,595,1286,-
chr3,61743033,1.6810344827586208,1598,1147,2745,-
chr3,61743037,0.6613380971589927,1850,1294,3144,-
chr3,61743038,0.6613380971589927,1850,1294,3144,-
chr3,61743136,0.8982112361995829,2451,1772,4223,-
chr3,61743137,0.9638520804269392,1893,1377,3270,-
chr3,64018848,1.9249590956418263,2352,1295,3647,-
chr3,64018849,2.03915915915916,1060,554,1614,-
chr3,64018850,1.696729181335211,3383,1837,5220,-
chr3,64018852,1.4939221093189285,2172,1150,3322,-
chr3,64018866,0.6611897180000657,1388,733,2121,-
chr3,64018883,0.5098122653316646,1970,1174,3144,-
chr3,64018884,0.5098122653316646,1970,1174,3144,-
chr3,64018887,0.4636264581463914,850,537,1387,-
chr3,64019429,0.39670591299322344,617,424,1041,-
chr3,67375138,1.6047780742178028,801,588,1389,-
chr3,67375247,2.02673658872077,1149,726,1875,-
chr3,67375273,0.9316861725184219,976,768,1744,-
chr3,67375274,0.9316861725184219,976,768,1744,-
chr3,67375310,0.5183016885891139,1160,722,1882,-
chr3,67375314,2.41977708051218,1479,922,2401,-
chr3,67375629,10.28246292894647,1449,1184,2633,-
chr3,67375635,11.783921505778148,1937,1335,3272,-
chr3,67375658,4.44013940268711,1198,696,1894,-
chr3,67495820,1.010162601626016,780,450,1230,-
chr3,67495821,1.010162601626016,780,450,1230,-
chr3,67498271,1.009789975734248,861,628,1489,-
chr3,67498273,0.7525684611648672,1258,922,2180,-
chr3,67498274,0.37431360585722995,817,595,1412,-
chr3,67609543,2.6338919089607864,719,536,1255,-
chr3,67609575,0.2168146566258289,642,433,1075,-
chr3,67609576,0.2168146566258289,642,433,1075,-
chr3,67609577,0.47127460299711393,1113,753,1866,-
chr3,69035080,1.9303613053613051,794,571,1365,-
chr3,69035082,1.9615558189376427,1130,743,1873,-
chr3,69055328,3.012701412490516,833,539,1372,-
chr3,69061892,3.3366108786610877,777,477,1254,-
chr3,69061893,3.3366108786610877,777,477,1254,-
chr3,81536983,1.8384348125978058,5277,4130,9407,-
chr3,81536984,1.8684135106866122,6773,5248,12021,-
chr3,81536988,2.682134944612286,1188,992,2180,-
chr3,81536991,1.8115853409971057,1110,662,1772,-
chr3,81537010,1.5142735768903994,913,534,1447,-
chr3,81537012,2.500218408736349,870,640,1510,-
chr3,81537016,3.5431423611111112,832,575,1407,-
chr3,81537031,1.9782811459027319,706,394,1100,-
chr3,81537074,2.503326679973387,1049,667,1716,-
chr3,81537075,2.503326679973387,1049,667,1716,-
chr3,81578042,0.743638911388432,670,495,1165,-
chr3,81591121,0.9447527138568843,651,514,1165,-
chr3,100364087,4.332604268121503,625,401,1026,-
chr3,100372673,3.1880419935214457,598,424,1022,-
chr3,100373552,1.3154111424046904,625,403,1028,-
chr3,100375078,0.3235294117647059,695,492,1187,-
chr3,100375080,1.1118398093026198,874,643,1517,-
chr3,101576599,1.2625277317438257,15326,10347,25673,-
chr3,101576600,1.2430534986092348,36535,22137,58672,-
chr3,101576601,1.2279026762429706,21209,11790,32999,-
chr3,101576664,1.0911033990033703,19047,14468,33515,-
chr3,101576665,1.2007197455615792,13044,9565,22609,-
chr3,101576666,1.0358204193272706,24581,18832,43413,-
chr3,101576667,1.1775221431830305,26758,19821,46579,-
chr3,101576668,1.1960996550147456,30490,20995,51485,-
chr3,101576669,1.2217000681369927,21686,14003,35689,-
chr3,101576696,1.2448438416667265,2783,2067,4850,-
chr3,101576705,0.5429127853135043,1138,843,1981,-
chr3,101576706,0.5476396213859341,1450,890,2340,-
chr3,101576708,0.5351738714045111,1723,1414,3137,-
chr3,101576710,0.6644942349070504,3612,3081,6693,-
chr3,101576712,0.7231543695074903,4030,3593,7623,-
chr3,101576713,0.6373782636968364,2047,1890,3937,-
chr3,101576714,0.6373782636968364,2047,1890,3937,-
chr3,101576718,0.5415514717840301,665,472,1137,-
chr3,101576726,1.6358184619523093,731,542,1273,-
chr3,101576732,2.040098106319872,760,486,1246,-
chr3,101576734,2.040098106319872,760,486,1246,-
chr3,101576763,1.3678930855564413,1727,1148,2875,-
chr3,101576764,1.9971109587798668,2716,1750,4466,-
chr3,101576851,1.1407952424024919,13673,10378,24051,-
chr3,101576852,1.2462531109185904,4447,3930,8377,-
chr3,101576856,1.4526607518007206,1832,1567,3399,-
chr3,101576864,1.4503603655399442,5998,4001,9999,-
chr3,101576865,1.4231140123136266,1278,1036,2314,-
chr3,101576866,1.4144565217391305,8722,5749,14471,-
chr3,101576867,1.1498037470287912,7972,5130,13102,-
chr3,101576869,1.2099135668963648,7380,4720,12100,-
chr3,101576870,1.020530242651907,8764,5799,14563,-
chr3,101576871,1.221224171440262,1552,1247,2799,-
chr3,101576872,1.0950898804195737,9621,6470,16091,-
chr3,101576873,1.087095805761315,8113,5610,13723,-
chr3,101576874,0.9929173477097228,3756,2767,6523,-
chr3,101576875,1.1410189075630253,1974,1427,3401,-
chr3,101652632,2.993496670547709,1527,1072,2599,-
chr3,101652661,2.707937152944725,1364,844,2208,-
chr3,101652662,2.136533084808947,916,517,1433,-
chr3,101652664,2.7730318257956452,1203,795,1998,-
chr3,101652665,2.3491124260355027,1587,1026,2613,-
chr3,101652666,1.9423549812630365,2010,1348,3358,-
chr3,101652667,2.2916351478090986,1872,1094,2966,-
chr3,101652669,2.139124293785311,698,353,1051,-
chr3,101681167,1.1118930918967966,18702,15383,34085,-
chr3,101681186,1.285889633733009,51454,42570,94024,-
chr3,101681187,1.0977379448241409,114856,98980,213836,-
chr3,101681189,1.0311919419408162,133444,115756,249200,-
chr3,101681190,1.093911798216071,100010,85844,185854,-
chr3,101681192,1.2884275639200236,58803,45947,104750,-
chr3,101681193,1.1607687411775711,52399,43502,95901,-
chr3,101681197,1.2377919833543536,15790,11600,27390,-
chr3,101681200,1.3650270167035734,14678,10600,25278,-
chr3,101681207,1.3900041279181354,7291,5227,12518,-
chr3,101681208,1.4870934614847755,4734,3101,7835,-
chr3,101681211,1.5529668729523118,4265,2746,7011,-
chr3,101682454,1.238998256334362,31153,24793,55946,-
chr3,101682455,1.2290655083859423,36261,28174,64435,-
chr3,101682456,1.2435891843318942,23050,19840,42890,-
chr3,101682484,0.7235775932591624,4748,3819,8567,-
chr3,101682888,1.2784757586909161,21823,13014,34837,-
chr3,101682889,1.3262385807967854,11195,5703,16898,-
chr3,101682892,1.2592618638811257,27562,16519,44081,-
chr3,101682893,1.2617313707106432,32526,20341,52867,-
chr3,101685920,0.6389326689731913,4136,3606,7742,-
chr3,101685927,1.6326631450337794,3825,2318,6143,-
chr3,101686495,1.6400346372986594,3150,2192,5342,-
chr3,101686521,0.7996725297222834,11737,8408,20145,-
chr3,101686700,1.2062631711371807,10541,7434,17975,-
chr3,101686703,0.8723574991493923,2830,2022,4852,-
chr3,101686704,0.8723574991493923,2830,2022,4852,-
chr3,101686706,1.4983729223094762,1689,1405,3094,-
chr3,101686707,1.4983729223094762,1689,1405,3094,-
chr3,101686711,1.4087554929110355,3920,1722,5642,-
chr3,101686712,1.3818264438799457,4838,2113,6951,-
chr3,101686713,1.1570466735925409,3478,2250,5728,-
chr3,101686714,1.3084892853555752,7484,4032,11516,-
chr3,101686715,1.143014875150769,4364,2819,7183,-
chr3,101686716,1.1605734615008718,4361,2191,6552,-
chr3,101686717,0.8772636883637703,1443,610,2053,-
chr3,101686719,0.7759895885189242,784,333,1117,-
chr3,108551070,8.543291222968412,979,1564,2543,-
chr3,108551071,8.543291222968412,979,1564,2543,-
chr3,108559806,5.454678362573099,573,455,1028,-
chr3,112541866,1.6358014190009946,1439,1083,2522,-
chr3,112541877,2.0633001422475106,966,702,1668,-
chr3,112541878,2.0633001422475106,966,702,1668,-
chr3,112541881,2.163090500985642,1010,654,1664,-
chr3,112548615,0.4661244719583267,785,560,1345,-
chr3,112548631,0.4681049050260908,822,678,1500,-
chr3,113005500,3.2289999843870323,1388,929,2317,-
chr3,113005501,3.6779720897367967,885,628,1513,-
chr3,113005505,1.9040488217646605,1325,660,1985,-
chr3,113005506,1.9040488217646605,1325,660,1985,-
chr3,113719517,0.6465112075198843,621,460,1081,-
chr3,113719996,1.6656639449935542,683,536,1219,-
chr3,113720079,3.135492859630791,642,521,1163,-
chr3,113720175,2.0644430051813467,1124,578,1702,-
chr3,113720176,2.0644430051813467,1124,578,1702,-
chr3,113720281,1.968713704994193,732,491,1223,-
chr3,113720482,1.725217391304348,743,482,1225,-
chr3,113720654,3.1635674622863443,836,697,1533,-
chr3,113721362,0.5769102570722077,1312,1041,2353,-
chr3,113721515,0.4882926829268293,636,409,1045,-
chr3,113721815,2.103370786516854,909,622,1531,-
chr3,113721834,1.922560216727297,1436,1214,2650,-
chr3,113721909,0.5599669148056244,676,495,1171,-
chr3,113722932,0.5629960317460317,680,503,1183,-
chr3,113724057,0.8067341681367919,1175,749,1924,-
chr3,113724058,1.0039182463200254,789,496,1285,-
chr3,116644296,2.4591734112350943,1579,1098,2677,-
chr3,116644297,2.4591734112350943,1579,1098,2677,-
chr3,116644303,0.5885742865981021,1035,692,1727,-
chr3,116644306,2.096317777424166,746,576,1322,-
chr3,116644307,2.5184176809737346,628,445,1073,-
chr3,116645953,1.3814878335507352,3669,2956,6625,-
chr3,116645960,1.3327922564754444,10409,7560,17969,-
chr3,116645961,1.2655235623306416,6256,4792,11048,-
chr3,116645963,0.7857139452977929,5887,3958,9845,-
chr3,116645964,1.3544722941546297,10415,7764,18179,-
chr3,116645965,1.573967887048176,11523,8072,19595,-
chr3,116645966,1.4200758562162046,13014,9176,22190,-
chr3,116646074,1.3521563860214565,8079,5586,13665,-
chr3,116646088,0.639980183304434,2152,1834,3986,-
chr3,116646090,1.323522361588393,5602,3743,9345,-
chr3,116646201,0.7926292338259324,4420,2907,7327,-
chr3,116646214,1.290691605045672,3296,2089,5385,-
chr3,116646217,1.6972661020511335,3048,1892,4940,-
chr3,116646220,1.4459564393939397,2880,1759,4639,-
chr3,116646234,2.242721890262203,2251,1285,3536,-
chr3,116646236,1.5380049005986811,1844,1276,3120,-
chr3,116646237,1.6516636939541178,2097,1144,3241,-
chr3,116646352,1.2583696125931818,13334,9207,22541,-
chr3,116646370,1.2628173220507717,2831,2351,5182,-
chr3,116646371,1.3666840895514636,3708,2223,5931,-
chr3,116646376,1.3762504365808041,6533,5266,11799,-
chr3,116646377,1.3691889597814495,4105,3357,7462,-
chr3,116646379,1.4717348288061125,7086,4846,11932,-
chr3,116646380,1.5783427118826119,4248,3253,7501,-
chr3,116646383,1.8022236873005437,11675,7737,19412,-
chr3,116646384,1.8022236873005437,11675,7737,19412,-
chr3,116646518,1.223823091704355,20364,13847,34211,-
chr3,116646519,1.2031693180416818,14772,9536,24308,-
chr3,116646533,1.2657793888830822,16443,11380,27823,-
chr3,116646544,1.4512882250079253,8369,5431,13800,-
chr3,116646636,0.7230209024825773,3819,3010,6829,-
chr3,116646642,0.6015560026827633,1318,1064,2382,-
chr3,116646649,0.8229673590504449,1980,1684,3664,-
chr3,116646650,0.8202888998736749,4784,3212,7996,-
chr3,116646651,0.6764371648780634,13046,9514,22560,-
chr3,116646652,0.8014564942849266,6109,4146,10255,-
chr3,116646653,0.6965861359900343,7213,5253,12466,-
chr3,116646655,1.0000798200924526,2462,1756,4218,-
chr3,116646677,0.4735900673400674,642,647,1289,-
chr3,116646679,0.4735900673400674,642,647,1289,-
chr3,116646685,2.005099054675552,1210,916,2126,-
chr3,116646708,2.250573098502237,728,603,1331,-
chr3,119230220,7.550942962927589,718,533,1251,-
chr3,119434824,2.298202951202371,649,414,1063,-
chr3,119447061,1.784933811291401,1707,996,2703,-
chr3,119447085,1.980609418282548,714,550,1264,-
chr3,119447107,2.7890559732665,606,398,1004,-
chr3,119447127,0.5889925560760348,889,582,1471,-
chr3,119669643,1.0913987087896675,1074,716,1790,-
chr3,119669649,0.41102756892230574,655,455,1110,-
chr3,119677263,2.6596219269777945,2455,1971,4426,-
chr3,119677264,2.5769589741508745,1567,1296,2863,-
chr3,119677266,2.8419856459330153,1032,835,1867,-
chr3,119677380,1.0802700675168793,599,429,1028,-
chr3,119677381,1.0802700675168793,599,429,1028,-
chr3,119677387,2.0351290915688596,754,486,1240,-
chr3,120326113,1.7902840108522844,945,457,1402,-
chr3,120326115,2.282450638991051,782,389,1171,-
chr3,120329678,1.5956378261541981,627,411,1038,-
chr3,120394941,0.44008339376359673,970,590,1560,-
chr3,120394942,0.44008339376359673,970,590,1560,-
chr3,120395020,2.0111641727733076,767,656,1423,-
chr3,120395040,2.456077372681678,833,593,1426,-
chr3,120395263,0.29708357057000057,586,478,1064,-
chr3,120395877,2.4513680784242045,808,625,1433,-
chr3,120396378,2.182255359738842,804,633,1437,-
chr3,120396465,1.6385604875416606,1052,746,1798,-
chr3,120396656,2.0177789709472553,758,620,1378,-
chr3,120396958,1.2773260108963607,935,558,1493,-
chr3,120402902,3.3055861752330067,623,453,1076,-
chr3,121696148,2.282210673539732,986,703,1689,-
chr3,121696150,2.1570241265230377,651,458,1109,-
chr3,121697518,1.7000565930956424,750,588,1338,-
chr3,121697526,2.2201634877384198,678,366,1044,-
chr3,121697530,1.8233628318584072,605,451,1056,-
chr3,121697544,2.4775413711583925,785,563,1348,-
chr3,121697546,2.4775413711583925,785,563,1348,-
chr3,121772626,3.0475789473684216,769,474,1243,-
chr3,121772627,3.357626258593856,1289,767,2056,-
chr3,121772629,3.306116271787913,1260,695,1955,-
chr3,122740802,2.7675911658962504,828,707,1535,-
chr3,122740815,1.9326677260456908,1065,736,1801,-
chr3,122740818,2.272102318145484,645,416,1061,-
chr3,122740837,1.8767442280969864,1168,649,1817,-
chr3,123493741,2.8410846213626972,694,481,1175,-
chr3,123494892,4.310763888888888,572,431,1003,-
chr3,123494893,4.310763888888888,572,431,1003,-
chr3,123949079,2.138695890187292,1127,1004,2131,-
chr3,123949080,2.523659217089874,1570,958,2528,-
chr3,123949081,2.523659217089874,1570,958,2528,-
chr3,123949084,2.2297482837528606,608,574,1182,-
chr3,123949087,2.634188034188034,535,467,1002,-
chr3,124809072,3.6229314420803793,612,422,1034,-
chr3,125469470,1.4931334043869753,988,691,1679,-
chr3,128081064,1.7360992301112064,737,500,1237,-
chr3,128081068,1.7704976727533117,644,440,1084,-
chr3,128081115,2.205674491313997,581,575,1156,-
chr3,128081367,0.4715618751388579,848,642,1490,-
chr3,128081369,0.4715618751388579,848,642,1490,-
chr3,128082494,2.0813562845916858,681,500,1181,-
chr3,128087745,1.7998949579831933,744,475,1219,-
chr3,128087747,1.7414268727705111,950,840,1790,-
chr3,128087748,1.8440271404299895,1607,1230,2837,-
chr3,128087751,1.4193808739731544,1018,828,1846,-
chr3,128087791,1.9159455858032743,686,544,1230,-
chr3,128098935,2.4970198883242367,994,692,1686,-
chr3,128098936,2.4970198883242367,994,692,1686,-
chr3,128100714,2.1173895958690396,867,617,1484,-
chr3,128112979,1.6105109221490495,4577,3420,7997,-
chr3,128112980,1.6219991971095942,3002,2490,5492,-
chr3,128112983,1.5304675414579731,4962,3265,8227,-
chr3,128112984,1.8984366176626142,3901,2683,6584,-
chr3,128112991,0.5140234059725586,1018,530,1548,-
chr3,128112994,2.144241864758828,977,618,1595,-
chr3,128113002,1.8532591906085882,856,497,1353,-
chr3,128113005,2.3994060876020793,807,448,1255,-
chr3,128113015,0.4814156634223587,1611,947,2558,-
chr3,128119338,2.55242718446602,716,411,1127,-
chr3,128119376,1.7334160649819492,877,553,1430,-
chr3,128119399,2.493415346512641,689,460,1149,-
chr3,128123627,2.5864002140610594,712,560,1272,-
chr3,128123760,2.034710723912206,9090,4703,13793,-
chr3,128123761,2.034710723912206,9090,4703,13793,-
chr3,128123762,1.5867550919488587,13587,7021,20608,-
chr3,128123768,2.0241913961276548,2733,1248,3981,-
chr3,128123811,0.9752923160282447,4116,2073,6189,-
chr3,128123818,2.336158300810549,1259,732,1991,-
chr3,128123819,0.924761278765728,1236,811,2047,-
chr3,128123821,0.9602931149016364,1664,854,2518,-
chr3,128620205,0.6116803278688525,994,609,1603,-
chr3,128620299,0.5240627336073937,3090,2907,5997,-
chr3,128620301,0.4302821246284144,1602,1697,3299,-
chr3,128620333,18.347122887679564,2863,2531,5394,-
chr3,128620336,7.092367554403544,2822,1672,4494,-
chr3,128620501,1.7455516014234878,653,561,1214,-
chr3,128620504,2.5233033197208914,1690,1193,2883,-
chr3,128620544,1.50827104097453,1062,671,1733,-
chr3,128620586,1.542857142857143,1106,699,1805,-
chr3,128622218,1.6948626416265715,1091,757,1848,-
chr3,128622239,2.030155838899008,1432,1097,2529,-
chr3,128622258,1.7539797395079595,1009,690,1699,-
chr3,128622356,1.6937172774869111,1293,763,2056,-
chr3,128622367,0.638457546604926,726,610,1336,-
chr3,128622386,1.2522733552113483,1680,1384,3064,-
chr3,128622397,1.764705882352941,767,543,1310,-
chr3,128625561,0.7372808568734012,2266,1496,3762,-
chr3,128625900,1.8288508557457213,1019,817,1836,-
chr3,128625945,1.6128056160735895,1024,809,1833,-
chr3,128626825,1.6761904761904762,857,636,1493,-
chr3,128630000,1.5921253822629968,1104,871,1975,-
chr3,128630007,1.7242524916943525,1037,902,1939,-
chr3,128630112,0.5090228123935989,974,800,1774,-
chr3,128630113,2.5034573199809254,912,698,1610,-
chr3,128631997,0.6398983028889753,1128,995,2123,-
chr3,128632090,2.151398601398601,878,779,1657,-
chr3,128632140,1.8669438669438674,897,702,1599,-
chr3,128637835,1.7618573797678276,829,602,1431,-
chr3,128644963,1.8377289377289379,691,519,1210,-
chr3,128644974,1.5357556608741443,950,632,1582,-
chr3,128650594,1.1760932233205843,3557,2413,5970,-
chr3,128650599,0.8152875825498551,3830,2083,5913,-
chr3,128650601,0.687531825125482,6300,4193,10493,-
chr3,128650602,0.9335866785582783,21034,13708,34742,-
chr3,128650604,0.9937342711044781,20442,12978,33420,-
chr3,128650605,1.2234605082178882,8887,5587,14474,-
chr3,128650610,1.4856560819892473,3244,1859,5103,-
chr3,128650612,1.5798226164079818,4749,2705,7454,-
chr3,128650613,1.3825980177424648,3875,2379,6254,-
chr3,128650616,2.2011600663934128,2757,1634,4391,-
chr3,128650619,1.6717116125481561,1214,643,1857,-
chr3,128650630,2.152395061728395,1177,674,1851,-
chr3,128650639,1.8205484206872613,1048,602,1650,-
chr3,128650674,1.7556593604024435,697,505,1202,-
chr3,128650685,2.218950285813269,853,501,1354,-
chr3,128650703,1.5753086419753086,637,494,1131,-
chr3,128650708,2.194078947368421,782,431,1213,-
chr3,129130586,2.1719675804592438,896,537,1433,-
chr3,129156915,1.117872470876763,560,465,1025,-
chr3,129156917,1.117872470876763,560,465,1025,-
chr3,129169749,1.3243588987152843,20683,10779,31462,-
chr3,129169759,1.2360562018858408,16345,9104,25449,-
chr3,129169813,1.1882494988491992,21766,12464,34230,-
chr3,129169823,0.621851862743176,6736,3527,10263,-
chr3,129169842,0.7824462581127496,9548,5428,14976,-
chr3,129170337,1.5745790532669703,3049,1987,5036,-
chr3,129170346,1.4256014543204143,2563,2223,4786,-
chr3,129170358,0.759877797430238,3647,2695,6342,-
chr3,129170368,1.680750641680108,4083,3392,7475,-
chr3,129170422,1.7871900826446283,1729,1451,3180,-
chr3,129170449,2.0633652822151225,1549,1251,2800,-
chr3,129171108,1.9517089093702,2102,1673,3775,-
chr3,129171271,1.7077586936289029,1681,1337,3018,-
chr3,129171473,1.41625059326056,1841,1504,3345,-
chr3,129171649,1.5170389570786005,1473,1008,2481,-
chr3,129171672,1.38955244114389,3427,2662,6089,-
chr3,129171675,1.43801652892562,1247,967,2214,-
chr3,129171720,1.3786150512957946,1332,952,2284,-
chr3,129171747,1.5846656120628722,1120,802,1922,-
chr3,129171766,0.6930621738727705,1035,802,1837,-
chr3,129183855,0.6061663077067141,958,723,1681,-
chr3,129183857,1.58362119360153,1891,1213,3104,-
chr3,129183859,1.58362119360153,1891,1213,3104,-
chr3,129183860,0.4862973760932945,555,489,1044,-
chr3,129314858,1.18605059963193,902,627,1529,-
chr3,129314887,2.91375,776,449,1225,-
chr3,129314889,2.91375,776,449,1225,-
chr3,129314897,1.8218255213787669,689,427,1116,-
chr3,129315087,0.3113618876635035,606,556,1162,-
chr3,129315088,0.3113618876635035,606,556,1162,-
chr3,129315112,2.648325358851675,614,417,1031,-
chr3,129315385,1.3547223687295809,684,448,1132,-
chr3,129315609,2.7813905223106192,730,412,1142,-
chr3,129315679,1.7171621601931701,895,640,1535,-
chr3,129315696,1.8917862805379941,1300,854,2154,-
chr3,129315697,2.0205872652844605,775,538,1313,-
chr3,129315846,1.216246189082942,1323,977,2300,-
chr3,129315847,1.4277973229236323,1264,1041,2305,-
chr3,129315872,0.9758112094395279,826,564,1390,-
chr3,129315873,0.9758112094395279,826,564,1390,-
chr3,129316209,3.406907630522088,963,497,1460,-
chr3,129316210,3.406907630522088,963,497,1460,-
chr3,129433898,1.6708038908778111,757,617,1374,-
chr3,129437021,3.580315678042552,999,636,1635,-
chr3,129437022,3.888489888489888,761,480,1241,-
chr3,129557197,2.166226050338184,550,483,1033,-
chr3,130690529,2.4912860025683363,678,473,1151,-
chr3,130690533,1.8007598142676235,631,411,1042,-
chr3,130690548,2.5592092457420925,893,477,1370,-
chr3,130690567,2.370955922614679,1022,506,1528,-
chr3,130690575,3.345357392237918,645,430,1075,-
chr3,131462505,1.5537285558551117,2035,1402,3437,-
chr3,131462584,1.0823761180021392,5816,4273,10089,-
chr3,131462601,1.3873598775462457,5979,4134,10113,-
chr3,131462619,1.4776574248898606,1438,1040,2478,-
chr3,131462630,1.209806881579424,3104,2400,5504,-
chr3,131462723,2.435838355193194,1017,727,1744,-
chr3,131468132,1.7941176470588234,975,679,1654,-
chr3,131468139,2.970873786407767,849,514,1363,-
chr3,131469745,0.3712784588441331,741,570,1311,-
chr3,131469746,1.6771015761821364,814,570,1384,-
chr3,131469749,0.5632846843678565,842,604,1446,-
chr3,131471239,1.8206521739130437,1339,799,2138,-
chr3,131471240,1.8206521739130437,1339,799,2138,-
chr3,131471260,0.333724571166818,771,500,1271,-
chr3,131471274,1.7103149148999564,708,455,1163,-
chr3,131471275,2.3135674346270236,1132,637,1769,-
chr3,131471277,2.223374798593883,1103,613,1716,-
chr3,131498237,2.4480151228733456,739,528,1267,-
chr3,131501602,0.5948191593352884,1216,867,2083,-
chr3,131501637,1.9567154801235505,1331,1218,2549,-
chr3,131501701,1.333671902395376,1621,1020,2641,-
chr3,131501702,1.333671902395376,1621,1020,2641,-
chr3,131501703,1.333671902395376,1621,1020,2641,-
chr3,131501710,1.9474489795918366,693,489,1182,-
chr3,131501712,1.0724961584657118,1420,1155,2575,-
chr3,131501713,0.3314870259481038,510,500,1010,-
chr3,131502824,1.6880260862159822,793,550,1343,-
chr3,131502826,1.4661525082601194,914,585,1499,-
chr3,133640056,1.0436046136789048,1447,1068,2515,-
chr3,133640058,0.8993835316975681,1327,978,2305,-
chr3,134477933,1.7669683257918551,638,441,1079,-
chr3,134478127,3.046445956269676,796,520,1316,-
chr3,134478553,1.7,611,419,1030,-
chr3,134478656,0.3686017549758378,671,494,1165,-
chr3,138102281,2.0368385517765213,1026,696,1722,-
chr3,138102283,2.0368385517765213,1026,696,1722,-
chr3,138500145,4.939209726443769,584,422,1006,-
chr3,138500159,1.7362485615650172,655,394,1049,-
chr3,138500166,2.41974843358396,1414,866,2280,-
chr3,138500198,3.222610687641981,733,331,1064,-
chr3,139357707,1.4569604612850084,848,606,1454,-
chr3,139357808,1.8400157232704404,754,529,1283,-
chr3,139358797,1.824175824175824,663,517,1180,-
chr3,139359076,1.6617771195251514,1951,1277,3228,-
chr3,139359333,1.5930979712656124,648,512,1160,-
chr3,139361093,1.832191780821918,1069,802,1871,-
chr3,139361127,0.5281553398058252,863,617,1480,-
chr3,139361252,1.8193661768170648,1631,1216,2847,-
chr3,139362439,0.49162371134020627,762,581,1343,-
chr3,139366581,0.6909727626459143,1365,1027,2392,-
chr3,139366606,1.714580131971437,1915,1494,3409,-
chr3,139366607,1.714580131971437,1915,1494,3409,-
chr3,139366712,1.7243243243243245,637,554,1191,-
chr3,139366740,1.8092416314694573,699,546,1245,-
chr3,139368156,1.8377653278623847,684,550,1234,-
chr3,139368213,1.9120987654320991,967,674,1641,-
chr3,139369337,2.9103656139431267,672,586,1258,-
chr3,139369360,1.4325529542920847,1284,896,2180,-
chr3,139369471,1.8157672074458302,1072,696,1768,-
chr3,139371756,0.5093498277475559,1916,1592,3508,-
chr3,139371794,0.6481563592681092,2260,2088,4348,-
chr3,139371806,4.640505891606344,4974,4449,9423,-
chr3,139371807,4.640505891606344,4974,4449,9423,-
chr3,139373289,1.8089256198347106,683,549,1232,-
chr3,139373365,0.5954724865733426,1530,1078,2608,-
chr3,139375500,0.2963500548730839,760,600,1360,-
chr3,139375511,1.782798423423423,744,591,1335,-
chr3,139375554,1.7384665632399772,905,661,1566,-
chr3,139375606,2.302570093457944,583,427,1010,-
chr3,139389605,1.5971641746785301,763,663,1426,-
chr3,142818317,1.54852611932617,762,609,1371,-
chr3,142818376,0.9658643572151615,686,522,1208,-
chr3,142818378,0.9658643572151615,686,522,1208,-
chr3,142827438,0.9628345613980082,648,495,1143,-
chr3,142827593,1.3080343256545846,2233,2541,4774,-
chr3,142827594,1.2458711264279538,5518,5128,10646,-
chr3,142827597,1.4078954023569874,1686,1162,2848,-
chr3,142827611,1.9593613933236576,836,688,1524,-
chr3,142827612,1.7740259740259738,682,699,1381,-
chr3,142827618,1.7648649379444608,1219,1192,2411,-
chr3,142827620,1.8629842012873026,1781,1708,3489,-
chr3,142827621,1.7203781949954113,2234,1866,4100,-
chr3,142827623,1.3274403935308945,2169,1636,3805,-
chr3,142827625,1.4943774657733422,3386,2528,5914,-
chr3,142827627,1.2155386603061022,1686,1160,2846,-
chr3,142827630,0.989713462540622,2234,1698,3932,-
chr3,142827631,1.8108633653098265,686,550,1236,-
chr3,142827636,0.31934737990699125,877,630,1507,-
chr3,142827638,0.31934737990699125,877,630,1507,-
chr3,142827641,1.8368915492103157,858,718,1576,-
chr3,142838893,3.0861013986013983,613,415,1028,-
chr3,142838895,3.0861013986013983,613,415,1028,-
chr3,143517557,0.5266129032258065,652,495,1147,-
chr3,143517560,1.2481602647405483,2376,1623,3999,-
chr3,143517562,0.5476190476190477,1314,788,2102,-
chr3,143517563,1.0992770878374252,6704,5069,11773,-
chr3,143517564,0.9780774473722701,8283,6222,14505,-
chr3,143517565,0.6192102267752385,2039,1268,3307,-
chr3,143517566,0.6316273628923688,5450,3714,9164,-
chr3,143517567,1.5844324667089411,1238,995,2233,-
chr3,143517571,0.3807531380753138,727,477,1204,-
chr3,143517582,1.7196163103458046,1148,743,1891,-
chr3,143517583,1.2050036576450724,2223,1730,3953,-
chr3,143517584,0.6647443581894997,1312,1176,2488,-
chr3,143517587,1.2257181975908693,1013,643,1656,-
chr3,143517590,1.6532630216083695,831,659,1490,-
chr3,146069596,1.7099932223812033,1565,1083,2648,-
chr3,146069718,2.9569771791994013,607,485,1092,-
chr3,146070035,2.0039783615942555,1501,1056,2557,-
chr3,146070156,0.988437235576691,3299,2693,5992,-
chr3,146070263,1.5607199817726132,1095,835,1930,-
chr3,146070298,6.063302425106992,918,700,1618,-
chr3,146070619,1.460655737704918,1538,949,2487,-
chr3,146070665,1.5557336854017352,1221,963,2184,-
chr3,146070758,1.496998799519808,1246,832,2078,-
chr3,146070791,0.3479166666666666,834,639,1473,-
chr3,146070822,1.6627450980392158,741,594,1335,-
chr3,146071099,3.008426415833823,1211,728,1939,-
chr3,146072583,2.186762225969645,740,592,1332,-
chr3,146072600,1.6979130434782612,750,574,1324,-
chr3,146072627,2.1719676549865228,1105,741,1846,-
chr3,146077911,2.1857817818114555,892,723,1615,-
chr3,146079245,2.3625044154009185,862,595,1457,-
chr3,146081771,0.6851595006934813,1139,839,1978,-
chr3,146081845,2.1366127348643005,654,478,1132,-
chr3,146086815,1.2388871603461669,2223,1531,3754,-
chr3,146086840,1.8615387773535328,1536,1058,2594,-
chr3,146102797,1.7661915740934817,886,733,1619,-
chr3,146102829,2.2207568807339446,1290,871,2161,-
chr3,146104335,1.6394095940959406,765,541,1306,-
chr3,146110397,1.102121338254714,2091,1645,3736,-
chr3,146121177,1.9241598546775656,1114,733,1847,-
chr3,146124148,3.0840278726601995,683,562,1245,-
chr3,146124226,1.992436180271037,653,500,1153,-
chr3,146517040,4.284860752433154,794,638,1432,-
chr3,149030687,1.714236090990022,5917,3767,9684,-
chr3,149030688,1.6283697730667734,4265,2913,7178,-
chr3,149030689,1.6283697730667734,4265,2913,7178,-
chr3,149030696,2.2185286891169245,1227,747,1974,-
chr3,149030725,1.8151516433315007,893,502,1395,-
chr3,149030735,1.7019322900031941,734,403,1137,-
chr3,149030777,0.18876663965791618,1028,568,1596,-
chr3,149030962,1.8668985098587665,12338,9072,21410,-
chr3,149030963,1.7702231611411545,16220,11753,27973,-
chr3,149030964,1.7702231611411545,16220,11753,27973,-
chr3,149030965,1.7663904063957356,11978,8549,20527,-
chr3,149030997,1.6562006183442115,2126,1229,3355,-
chr3,149031038,0.6132365319865319,1266,719,1985,-
chr3,149031066,1.4137029015881435,2235,1161,3396,-
chr3,149031089,1.6891521197007482,873,400,1273,-
chr3,149032205,1.5459453769736604,9608,6380,15988,-
chr3,149032206,1.5459453769736604,9608,6380,15988,-
chr3,149032220,1.4094789520164852,2260,1342,3602,-
chr3,149032235,1.578499818818698,1765,973,2738,-
chr3,149032281,2.316098081023454,868,468,1336,-
chr3,149032323,1.1547981803057799,1449,755,2204,-
chr3,149032329,0.4882596685082872,706,361,1067,-
chr3,149041624,0.3076479076479076,532,494,1026,-
chr3,149041625,0.3076479076479076,532,494,1026,-
chr3,149046221,3.310960591133005,565,463,1028,-
chr3,149046222,3.310960591133005,565,463,1028,-
chr3,149059731,2.153427967381456,689,472,1161,-
chr3,149059733,2.828058893577998,959,684,1643,-
chr3,149060673,4.189357429718877,672,497,1169,-
chr3,149060674,4.189357429718877,672,497,1169,-
chr3,149071372,2.6662003419657805,828,566,1394,-
chr3,149074320,2.173007747648036,848,555,1403,-
chr3,149075940,2.54283048841273,848,536,1384,-
chr3,149369616,0.5881555024993798,5822,4773,10595,-
chr3,149369617,0.5881555024993798,5822,4773,10595,-
chr3,149369641,1.5834921845215402,2555,2195,4750,-
chr3,149369649,1.764184344411056,2175,1768,3943,-
chr3,149369863,1.2907396288209607,5196,3199,8395,-
chr3,149369864,1.2520367563471007,3860,3015,6875,-
chr3,149371734,1.2554007666041125,4299,3478,7777,-
chr3,149371796,1.3682432432432434,2915,2367,5282,-
chr3,149371830,1.6556829005609128,5511,3363,8874,-
chr3,149371832,1.6556829005609128,5511,3363,8874,-
chr3,149371847,1.7858392999204458,1402,1256,2658,-
chr3,149371857,1.5423258689091786,3436,2248,5684,-
chr3,149371863,1.907342269544,1851,941,2792,-
chr3,149375703,1.2884206560641531,6603,4128,10731,-
chr3,149375704,1.3515704973757063,8893,6061,14954,-
chr3,149375731,1.6447800507741763,1956,1580,3536,-
chr3,149377445,1.2804338002711253,3035,2212,5247,-
chr3,149377566,0.6991615392605536,8209,5365,13574,-
chr3,149377567,0.6991615392605536,8209,5365,13574,-
chr3,149377606,0.7830358498340888,2406,1881,4287,-
chr3,149377626,1.3425309015860196,2601,1904,4505,-
chr3,149377636,1.4414692858628786,2020,1462,3482,-
chr3,149377644,1.0019582874892234,7521,6452,13973,-
chr3,149377645,1.059561303629172,9097,7655,16752,-
chr3,149377648,0.9948469981278161,4537,3316,7853,-
chr3,149377649,0.9948469981278161,4537,3316,7853,-
chr3,149965374,1.9405779405779409,1191,818,2009,-
chr3,149965503,0.4995791954216462,741,456,1197,-
chr3,149965636,0.9530771372876636,1368,911,2279,-
chr3,149965638,0.9530771372876636,1368,911,2279,-
chr3,149965647,1.2482799151607702,752,532,1284,-
chr3,149965914,18.95156890944805,1809,1516,3325,-
chr3,149965915,5.646128500823723,713,606,1319,-
chr3,149965945,2.3701553668763333,1149,784,1933,-
chr3,149966148,1.5827774408732564,724,484,1208,-
chr3,149966242,1.0693649314338969,752,608,1360,-
chr3,149966243,1.0693649314338969,752,608,1360,-
chr3,149966379,11.47696434657316,1066,805,1871,-
chr3,149966535,1.0694555965954713,700,478,1178,-
chr3,149966537,1.0694555965954713,700,478,1178,-
chr3,149968537,0.4581409856519027,611,457,1068,-
chr3,149982539,0.5610983981693364,612,459,1071,-
chr3,149982963,1.0884064810445178,747,488,1235,-
chr3,149982964,1.0884064810445178,747,488,1235,-
chr3,149982965,0.7144616900714462,695,450,1145,-
chr3,150542268,1.8092949244790002,1144,673,1817,-
chr3,150542277,2.3016661149729667,595,476,1071,-
chr3,150542278,1.6001588941938172,1030,741,1771,-
chr3,150542720,0.39810484863401424,646,477,1123,-
chr3,150542806,2.0888931188731323,707,552,1259,-
chr3,150542825,0.6027588964414234,669,487,1156,-
chr3,150543185,1.0297619047619049,691,623,1314,-
chr3,150543187,1.0297619047619049,691,623,1314,-
chr3,150543275,13.295621340025855,887,574,1461,-
chr3,150543282,7.374993804974326,1506,1036,2542,-
chr3,150543950,2.06498812163778,894,644,1538,-
chr3,150544152,1.4570777771942458,656,485,1141,-
chr3,150544477,1.770760233918128,1513,1044,2557,-
chr3,150545738,0.664495430682481,1366,972,2338,-
chr3,150545763,1.5073987538940812,868,641,1509,-
chr3,150545773,1.7695652173913043,769,574,1343,-
chr3,150545775,2.2195304963018545,608,490,1098,-
chr3,150546088,0.5383759733036707,846,650,1496,-
chr3,150546100,2.334165322269258,1164,952,2116,-
chr3,150546118,3.5011709601873533,597,426,1023,-
chr3,150546259,3.6542768537602295,629,462,1091,-
chr3,150546495,1.0806796510025676,690,372,1062,-
chr3,150741558,0.9587669013634709,1425,1031,2456,-
chr3,150741559,1.1720364741641338,963,704,1667,-
chr3,150741578,2.5433721875847115,694,433,1127,-
chr3,150741579,2.4146117543089294,1006,659,1665,-
chr3,150742034,2.7694697979548266,593,476,1069,-
chr3,156540800,2.7146085199879204,622,454,1076,-
chr3,156541429,1.3991867091581935,653,494,1147,-
chr3,156541858,0.5117075043183418,940,637,1577,-
chr3,156541870,2.381147116678745,806,742,1548,-
chr3,156541872,2.381147116678745,806,742,1548,-
chr3,156542182,3.054298642533937,647,407,1054,-
chr3,156542222,1.666460914421763,878,612,1490,-
chr3,156542403,0.9285714285714284,987,607,1594,-
chr3,156542404,0.9285714285714284,987,607,1594,-
chr3,156542419,1.5092936802973975,811,537,1348,-
chr3,156542625,1.0252779154570557,723,486,1209,-
chr3,156542626,1.0252779154570557,723,486,1209,-
chr3,156542811,2.341884816753927,638,381,1019,-
chr3,156542861,1.651076097221532,976,648,1624,-
chr3,156542899,2.759651307596513,830,437,1267,-
chr3,156542949,1.8763213530655392,851,472,1323,-
chr3,156543102,1.9849306811332128,800,710,1510,-
chr3,156543120,5.987962291667895,7738,6143,13881,-
chr3,156543121,5.987962291667895,7738,6143,13881,-
chr3,156543144,1.7612244128623666,1167,646,1813,-
chr3,156543147,0.4282376841036059,1053,715,1768,-
chr3,156544433,0.5383597883597884,1035,783,1818,-
chr3,156548932,1.4989982101354418,1168,912,2080,-
chr3,156548935,1.6833779684962749,2456,1868,4324,-
chr3,156548978,1.869937164054811,1234,776,2010,-
chr3,156553766,0.45303030303030306,597,559,1156,-
chr3,156553774,1.6728414442700157,591,454,1045,-
chr3,156555017,1.7488552702736746,868,792,1660,-
chr3,156555032,1.7061950146627567,641,495,1136,-
chr3,156555033,1.9330331169825066,1937,1403,3340,-
chr3,156555035,1.236883199208591,1743,1140,2883,-
chr3,156714685,2.6951219512195115,1325,983,2308,-
chr3,156714706,1.6648686514886164,931,570,1501,-
chr3,156714712,2.2231915667030173,1389,916,2305,-
chr3,156714713,1.9933493948990415,3467,2114,5581,-
chr3,156714714,1.8316319937976482,2078,1198,3276,-
chr3,156714715,1.8316319937976482,2078,1198,3276,-
chr3,156714719,0.3304642166344294,602,563,1165,-
chr3,156714724,3.038977405707084,1054,528,1582,-
chr3,156714726,3.038977405707084,1054,528,1582,-
chr3,156714732,2.187192118226601,850,482,1332,-
chr3,156714733,2.187192118226601,850,482,1332,-
chr3,156810519,2.4096805116904103,1034,791,1825,-
chr3,156810525,0.5119556603082164,1634,1207,2841,-
chr3,156810526,0.5472165049495247,970,715,1685,-
chr3,156810556,1.5791302703627028,681,452,1133,-
chr3,157159444,3.116124457349025,628,439,1067,-
chr3,158666642,0.6603866721513778,1046,662,1708,-
chr3,158666727,0.6441127694859038,970,674,1644,-
chr3,158669109,0.6208695652173913,951,689,1640,-
chr3,158669550,2.005388113034465,3856,3112,6968,-
chr3,158669555,1.4350654046409983,6964,5263,12227,-
chr3,158669556,1.3732270093474588,12925,9364,22289,-
chr3,158669558,1.3103600518489753,20939,14884,35823,-
chr3,158669559,1.2941524542461151,19930,13866,33796,-
chr3,158669560,1.3108960162448917,19827,13854,33681,-
chr3,158669562,1.4169753742378708,4891,3308,8199,-
chr3,158669585,0.603738957322384,1492,1025,2517,-
chr3,158669586,1.8042957227138643,1057,677,1734,-
chr3,158669596,2.4715793207413324,870,536,1406,-
chr3,158669607,1.9861781687855353,2678,1721,4399,-
chr3,158669608,1.8590947384544692,1758,1186,2944,-
chr3,158670970,0.4839255499153976,623,393,1016,-
chr3,158670971,0.43783542039355994,978,644,1622,-
chr3,158671016,1.8580853174603167,796,559,1355,-
chr3,158671017,1.8580853174603167,796,559,1355,-
chr3,158672365,2.319785148891758,1557,1054,2611,-
chr3,158672366,2.0777679492849765,1190,797,1987,-
chr3,158672367,2.0777679492849765,1190,797,1987,-
chr3,158672422,1.7770847914767829,1125,816,1941,-
chr3,161429186,1.2805664271622599,12219,9473,21692,-
chr3,161429187,1.2805664271622599,12219,9473,21692,-
chr3,161429196,1.3004691019817958,18032,12106,30138,-
chr3,161429197,1.335411231958533,25845,17245,43090,-
chr3,161429199,1.2981554417345982,21165,14619,35784,-
chr3,161429215,0.6659859976662778,2282,1713,3995,-
chr3,161429216,1.464542654052406,19396,12057,31453,-
chr3,161429217,1.3529701378027148,17063,9615,26678,-
chr3,161429218,1.4715455209508448,23061,14036,37097,-
chr3,161429219,1.3266755525363116,12001,6598,18599,-
chr3,161429224,2.16494708994709,2517,1679,4196,-
chr3,161429256,1.1285631852279283,3301,1732,5033,-
chr3,161429258,1.2745414626231926,4695,2384,7079,-
chr3,161429259,2.4470549135903465,2586,1396,3982,-
chr3,161429272,1.5932017543859651,1452,703,2155,-
chr3,161429273,1.358690418873375,1742,937,2679,-
chr3,161429392,1.4619816264772276,8797,4078,12875,-
chr3,161429394,1.6995073385317458,4550,1696,6246,-
chr3,161429575,1.134936848052733,54789,40288,95077,-
chr3,161429576,1.2908777139688785,25128,15226,40354,-
chr3,161429577,1.191090376231068,61251,40464,101715,-
chr3,161429578,1.2327406129203387,55147,35791,90938,-
chr3,161429580,1.2270812471561734,54054,37896,91950,-
chr3,161429581,1.3248609387616876,35018,23101,58119,-
chr3,161429582,1.3454819769330508,39635,25429,65064,-
chr3,161429583,1.3514929815283214,43468,30166,73634,-
chr3,161429584,1.3784245430184034,32573,19385,51958,-
chr3,161429585,1.308283164486385,39278,29266,68544,-
chr3,161429586,1.0979949036858698,34833,25354,60187,-
chr3,161429587,0.9163480625234169,19314,16721,36035,-
chr3,161429588,0.9051394481654779,26706,18511,45217,-
chr3,161429589,0.7884955137788169,16031,9137,25168,-
chr3,161429591,0.7227316389796995,9326,6804,16130,-
chr3,161429592,0.6180037383151994,7100,5612,12712,-
chr3,161429595,0.8260869565217391,930,620,1550,-
chr3,161429596,1.1050319071032533,566,710,1276,-
chr3,167684131,3.0544267053701017,731,423,1154,-
chr3,167684197,0.8889010593658772,1378,1039,2417,-
chr3,167684382,1.238408720473165,1663,1152,2815,-
chr3,167687675,2.7926829268292686,915,655,1570,-
chr3,167687676,2.7926829268292686,915,655,1570,-
chr3,167695647,3.928994082840236,912,571,1483,-
chr3,167695714,3.1204146730462523,1091,791,1882,-
chr3,167695715,3.1204146730462523,1091,791,1882,-
chr3,167704887,1.9168257431142623,638,385,1023,-
chr3,167720119,1.8321616871704745,694,568,1262,-
chr3,167734830,2.7462995396825436,2076,1764,3840,-
chr3,167734831,3.128678246630065,1286,1223,2509,-
chr3,169483851,1.2150173427900037,22067,15486,37553,-
chr3,169483852,1.2356877591531332,20935,14582,35517,-
chr3,169483855,1.3463452244909202,3942,2404,6346,-
chr3,169483858,1.047578686744233,8077,6358,14435,-
chr3,169483943,1.1438704172980685,6266,3893,10159,-
chr3,169483944,0.9887619217164936,8114,5038,13152,-
chr3,169483945,0.8605707860628262,11491,7313,18804,-
chr3,169483946,0.875126994619913,5904,3636,9540,-
chr3,169483952,1.2932083453593333,2363,1726,4089,-
chr3,169483955,0.6654929577464789,706,403,1109,-
chr3,169483956,1.3811465180131457,799,475,1274,-
chr3,169483959,1.4635254988913526,920,494,1414,-
chr3,169483960,1.4635254988913526,920,494,1414,-
chr3,169483961,0.543163247029537,738,484,1222,-
chr3,169765025,0.816177710623157,27450,1849,29299,-
chr3,169765028,0.6301166504652131,14636,1136,15772,-
chr3,169765031,0.5660927731913159,22361,1884,24245,-
chr3,169765032,0.5660927731913159,22361,1884,24245,-
chr3,169765036,0.3147893772893773,2874,804,3678,-
chr3,169765037,0.3147893772893773,2874,804,3678,-
chr3,169765042,0.3101135668896011,1761,700,2461,-
chr3,169765043,0.2958269763236707,2434,1019,3453,-
chr3,169765045,0.4872507552870091,1439,661,2100,-
chr3,170866478,1.5400376929294461,2287,1443,3730,-
chr3,170866500,1.7319908405172413,2040,1159,3199,-
chr3,170866502,1.7319908405172413,2040,1159,3199,-
chr3,170866518,1.4813431811317646,1123,846,1969,-
chr3,170868177,1.6825684545878994,1093,686,1779,-
chr3,170868350,0.9813334467723006,1090,806,1896,-
chr3,170868375,2.85478338203532,748,462,1210,-
chr3,170868376,2.85478338203532,748,462,1210,-
chr3,171602263,2.608021366748855,834,560,1394,-
chr3,171602378,4.4198219438384125,683,410,1093,-
chr3,171644946,4.280809523809523,577,448,1025,-
chr3,171726045,1.2259289760112948,5527,4108,9635,-
chr3,171726061,1.5339364444919068,1763,1110,2873,-
chr3,171726064,1.5625682463419959,2119,1445,3564,-
chr3,171726065,1.896416836175872,1514,912,2426,-
chr3,171733490,2.20484163828496,1919,1282,3201,-
chr3,171733497,1.5538228286766296,843,512,1355,-
chr3,171733504,2.6717881660673433,742,436,1178,-
chr3,171734917,0.3729151984965938,634,395,1029,-
chr3,171734918,0.3729151984965938,634,395,1029,-
chr3,172426757,1.1994733997746085,4023,3025,7048,-
chr3,172426758,1.4684772612608623,2629,2008,4637,-
chr3,172426772,1.4137726057452664,1344,1028,2372,-
chr3,172426782,0.6447587354409318,774,600,1374,-
chr3,172426805,0.5687708442158557,744,606,1350,-
chr3,172426848,0.7575556733828208,1269,942,2211,-
chr3,172426850,0.7287003136677142,3804,2762,6566,-
chr3,172426851,0.7240496968239674,1844,1150,2994,-
chr3,172632199,1.9906348684271467,901,701,1602,-
chr3,172632204,0.36543209876543215,628,458,1086,-
chr3,175718500,0.5134443954665425,926,691,1617,-
chr3,175718512,3.430526098588279,581,505,1086,-
chr3,177020838,2.1894609440461785,602,466,1068,-
chr3,177020863,3.2091324200913243,752,437,1189,-
chr3,177020864,2.914401945917543,1224,717,1941,-
chr3,177024682,1.700373134328358,650,535,1185,-
chr3,177024685,1.3729977116704806,599,482,1081,-
chr3,177024694,1.054608079186731,670,533,1203,-
chr3,177024696,1.054608079186731,670,533,1203,-
chr3,177297863,2.897252321981424,712,645,1357,-
chr3,177297869,1.143573578494364,2432,1396,3828,-
chr3,177297870,1.143573578494364,2432,1396,3828,-
chr3,177297871,1.049394713589128,2882,1779,4661,-
chr3,177297873,1.1393746687864337,799,628,1427,-
chr3,177297874,1.112538371003156,1550,1118,2668,-
chr3,177297876,1.3416965909620855,684,522,1206,-
chr3,179400475,0.9114014040700258,640,362,1002,-
chr3,179400476,0.9114014040700258,640,362,1002,-
chr3,179405369,1.9617828838320464,794,540,1334,-
chr3,179405370,1.1267942583732058,627,417,1044,-
chr3,179419495,2.056200235327304,624,413,1037,-
chr3,179593818,1.7494039103481165,758,465,1223,-
chr3,179598756,1.7782716049382716,553,449,1002,-
chr3,179604556,2.4623599578572875,1509,785,2294,-
chr3,179604588,5.5024304873832355,1255,538,1793,-
chr3,179604625,5.678768763148584,2070,567,2637,-
chr3,179604626,6.683835845896148,1450,397,1847,-
chr3,179604629,3.7384582892455582,1996,499,2495,-
chr3,179604630,5.288812682725564,1715,427,2142,-
chr3,179604637,0.8697065940409194,2047,552,2599,-
chr3,184242876,2.3624500214813953,957,615,1572,-
chr3,184245489,1.8628069186990446,797,674,1471,-
chr3,184245537,1.9583128316497176,973,686,1659,-
chr3,184245573,2.0706892978337064,697,563,1260,-
chr3,184245591,3.9156769316928774,698,515,1213,-
chr3,184245746,1.206282525380315,828,671,1499,-
chr3,184245785,1.034128662035639,855,472,1327,-
chr3,184245787,1.8109955678177807,1136,728,1864,-
chr3,184711335,17.098068372710795,604,695,1299,-
chr3,184711338,5.683245200353008,1002,849,1851,-
chr3,184711339,6.039456452081392,1307,1088,2395,-
chr3,184711341,6.275651660782003,864,685,1549,-
chr3,185417457,0.6285714285714287,683,419,1102,-
chr3,185417489,1.5250685468076772,598,413,1011,-
chr3,185417745,1.265816329002402,18023,15972,33995,-
chr3,185417747,1.265816329002402,18023,15972,33995,-
chr3,185417749,0.8831954037292846,6550,5356,11906,-
chr3,185417763,1.4014359067571982,20881,14968,35849,-
chr3,185417766,1.4463822621729285,18355,12760,31115,-
chr3,185417768,1.5470016644866829,11152,8128,19280,-
chr3,185417786,1.2367526554758317,9868,6215,16083,-
chr3,185417788,1.0372310398492361,17745,12698,30443,-
chr3,185417794,1.136724198602461,15984,10888,26872,-
chr3,185417795,1.0936894598569475,22356,15733,38089,-
chr3,185417798,1.5250908032364987,3778,2113,5891,-
chr3,185417866,1.1735170807888005,4192,3596,7788,-
chr3,185417868,0.6954016558514208,3608,2615,6223,-
chr3,185417869,0.8694524712058949,12839,13421,26260,-
chr3,185417870,0.8694524712058949,12839,13421,26260,-
chr3,185417898,1.7956735057983944,6656,8259,14915,-
chr3,185417899,1.7956735057983944,6656,8259,14915,-
chr3,185417900,1.7324402879740295,8745,9766,18511,-
chr3,185417903,1.8993963782696182,1887,1987,3874,-
chr3,185417907,1.558478462251197,3429,2896,6325,-
chr3,185417911,0.7695901337679605,1600,1261,2861,-
chr3,185417914,1.4337940282561552,2605,1895,4500,-
chr3,185417922,1.2234407687053694,4308,3097,7405,-
chr3,185417923,0.7171789802679965,3678,2322,6000,-
chr3,185417924,1.5813571447497417,2939,2584,5523,-
chr3,185417925,1.7067678084627238,2699,2300,4999,-
chr3,185417926,0.7003219118288957,1193,927,2120,-
chr3,185417927,1.7152218797689938,1736,1452,3188,-
chr3,185418110,1.2254136537409321,36738,26644,63382,-
chr3,185418111,1.1696134219372136,26724,18436,45160,-
chr3,185418113,1.6059961312946731,26660,20662,47322,-
chr3,185418114,1.4672232001985352,38338,28660,66998,-
chr3,185418115,1.6059961312946731,26660,20662,47322,-
chr3,185418123,1.2756498197270698,23359,16823,40182,-
chr3,185418126,1.2174356557186692,18450,13646,32096,-
chr3,185418128,1.2746206489729917,31995,23298,55293,-
chr3,185418132,1.3770356909006236,5538,4138,9676,-
chr3,185418137,1.0544252570129646,10909,7557,18466,-
chr3,185418138,1.1011279277102846,14166,9797,23963,-
chr3,185418139,1.2001523281967197,29823,20480,50303,-
chr3,185418140,1.2003233871436572,25940,17783,43723,-
chr3,185418143,1.0086365718317185,6651,4256,10907,-
chr3,185418144,0.8447732101714702,10111,7282,17393,-
chr3,185418145,1.0086365718317185,6651,4256,10907,-
chr3,185418146,0.8177561010765675,8117,5832,13949,-
chr3,185418147,0.8632077173229854,6635,4944,11579,-
chr3,185418148,0.7159659745265053,2821,2138,4959,-
chr3,185418149,1.0584294123991684,6080,4378,10458,-
chr3,185418152,1.6222883879200343,3813,2350,6163,-
chr3,185418153,1.7305197750362846,5569,3391,8960,-
chr3,185418155,1.5452126328290012,8362,5132,13494,-
chr3,185418156,1.5422580075981567,7956,5096,13052,-
chr3,185418170,1.6447349641766331,1339,660,1999,-
chr3,185418194,1.874022988505747,1018,434,1452,-
chr3,185418239,1.3715437788018432,2380,1679,4059,-
chr3,185418362,1.326979419938413,8937,5497,14434,-
chr3,185418363,1.3544512167993952,6607,3821,10428,-
chr3,185418366,1.4975818118082145,7757,4963,12720,-
chr3,185418367,0.6019871171609139,2445,1869,4314,-
chr3,185418368,1.4975818118082145,7757,4963,12720,-
chr3,185418419,0.5643403663343382,3650,1815,5465,-
chr3,185418421,0.6131591838466675,5393,3213,8606,-
chr3,185418422,1.8006410256410257,1271,831,2102,-
chr3,185418426,1.6432912575970078,1139,712,1851,-
chr3,185418434,1.781324896941808,1092,548,1640,-
chr3,185418438,1.8409681227863044,1005,483,1488,-
chr3,185418501,0.5792892010953685,2665,2269,4934,-
chr3,185418502,1.40157119975593,2296,1872,4168,-
chr3,185418529,1.4791841509655523,7890,5790,13680,-
chr3,185418538,1.7102774731527657,2015,1558,3573,-
chr3,185418544,1.0592118035332945,5703,3433,9136,-
chr3,185418545,0.7313453928773318,2174,1681,3855,-
chr3,185418546,1.0592118035332945,5703,3433,9136,-
chr3,185418553,1.0115133793712945,4166,2727,6893,-
chr3,185418554,1.4335803919796328,1654,1217,2871,-
chr3,185418608,1.1497156848566414,18028,13879,31907,-
chr3,185418610,0.9988962093450289,19583,15379,34962,-
chr3,185418611,1.0531270043263004,14379,10990,25369,-
chr3,185418612,1.0502221113329857,14491,11079,25570,-
chr3,185418613,1.0266205767879575,7981,5975,13956,-
chr3,185418614,0.8689059209240724,1183,789,1972,-
chr3,185418834,0.9977508022340392,41820,32432,74252,-
chr3,185645483,2.2170656157314044,1024,667,1691,-
chr3,185645499,2.3151205936920225,1061,615,1676,-
chr3,185645500,2.3151205936920225,1061,615,1676,-
chr3,185645508,0.28926396848137537,922,697,1619,-
chr3,185645509,0.28926396848137537,922,697,1619,-
chr3,185645510,0.28926396848137537,922,697,1619,-
chr3,185675395,2.1370883322135845,628,524,1152,-
chr3,185916926,1.7075675675675677,701,443,1144,-
chr3,185917149,0.6418164488017429,856,575,1431,-
chr3,185917463,2.6056419113413933,875,578,1453,-
chr3,185918379,0.6147334771036397,1343,1207,2550,-
chr3,185918421,0.2269987946966653,1016,1178,2194,-
chr3,185918422,0.2269987946966653,1016,1178,2194,-
chr3,185918425,0.2816989437432304,1295,1792,3087,-
chr3,185919457,0.40661196911196906,673,1183,1856,-
chr3,185919467,6.280815913143398,1662,2723,4385,-
chr3,185919471,19.205003342792256,3992,2958,6950,-
chr3,185919472,14.027958917659515,5461,3551,9012,-
chr3,185919473,14.536277438083399,4312,2399,6711,-
chr3,185919474,7.6951557330655485,4229,1717,5946,-
chr3,185919475,8.663911845730027,1183,362,1545,-
chr3,185919477,6.81143756129454,830,182,1012,-
chr3,185919480,5.532640844299979,996,230,1226,-
chr3,185919483,3.8505854662853753,1350,339,1689,-
chr3,185921163,2.349626429021514,841,528,1369,-
chr3,185922060,2.6939354838709684,948,774,1722,-
chr3,185923915,1.5619600525260904,1129,818,1947,-
chr3,185923952,2.2120148856990967,742,494,1236,-
chr3,185923966,0.3338632750397456,989,628,1617,-
chr3,185923968,0.5871094849423023,595,417,1012,-
chr3,185923975,2.4595488721804513,845,524,1369,-
chr3,185923981,0.6488135593220339,956,749,1705,-
chr3,185925532,1.1549161515567767,1351,1049,2400,-
chr3,185925594,1.6278828669093452,1234,1082,2316,-
chr3,185925595,0.9549856527977044,1064,655,1719,-
chr3,185925596,0.9549856527977044,1064,655,1719,-
chr3,185926625,1.7605805958747134,1001,769,1770,-
chr3,185926631,1.770002622265655,2232,1711,3943,-
chr3,185926648,1.9166666666666663,574,499,1073,-
chr3,185926688,1.8171918443002784,758,497,1255,-
chr3,185937896,1.4417882684500385,665,502,1167,-
chr3,185937924,2.3664750439743454,714,467,1181,-
chr3,185937928,1.9612302152906187,1374,817,2191,-
chr3,185937929,2.7539999999999996,917,499,1416,-
chr3,186105321,3.0168972436371315,582,556,1138,-
chr3,186105322,3.0168972436371315,582,556,1138,-
chr3,186105323,3.0168972436371315,582,556,1138,-
chr3,186790026,1.1683161804775573,1036,743,1779,-
chr3,186790152,2.0236486486486487,1197,799,1996,-
chr3,186790153,2.0236486486486487,1197,799,1996,-
chr3,186790160,3.7565789473684217,570,455,1025,-
chr3,186790161,0.5306763285024154,675,459,1134,-
chr3,186790391,0.446578073089701,610,429,1039,-
chr3,186792587,2.070042831947594,631,440,1071,-
chr3,186792588,1.8488959829741953,694,536,1230,-
chr3,186792871,0.4331498579545455,1784,1055,2839,-
chr3,186792872,0.303346968372448,4139,2423,6562,-
chr3,186792901,3.694980694980694,637,517,1154,-
chr3,186794705,1.8001759315821626,3897,3273,7170,-
chr3,186794706,1.8001759315821626,3897,3273,7170,-
chr3,186794716,2.3739112739112738,1597,1259,2856,-
chr3,186794723,1.0964285714285713,1841,1175,3016,-
chr3,186794724,1.0964285714285713,1841,1175,3016,-
chr3,186794731,1.8751311003402982,3188,2334,5522,-
chr3,186794732,1.9580788450860636,2350,1800,4150,-
chr3,186794733,0.5911706918435832,1359,1008,2367,-
chr3,186794755,1.838958333333333,678,479,1157,-
chr3,186794770,0.9678153114921064,982,684,1666,-
chr3,186794771,0.784340868117292,1641,1189,2830,-
chr3,186797576,0.6510828211881768,808,535,1343,-
chr3,186801176,3.102199099377485,844,608,1452,-
chr3,186806330,4.183662280701754,586,455,1041,-
chr3,186806331,3.9217948085835888,1182,917,2099,-
chr3,187121257,1.246903674762462,687,616,1303,-
chr3,187139315,0.7110503253067995,1283,896,2179,-
chr3,187139317,0.7560962373371924,852,690,1542,-
chr3,187722253,0.1619402985074627,433,669,1102,-
chr3,189973942,1.1869837940996053,2883,1672,4555,-
chr3,189973943,1.213755815241953,3564,2014,5578,-
chr3,189973945,0.8246771879483501,1436,696,2132,-
chr3,189973946,0.6284968099277851,1558,838,2396,-
chr3,189973947,0.6284968099277851,1558,838,2396,-
chr3,189973956,0.5645732004025548,1213,791,2004,-
chr3,189973958,0.5227878787878788,1134,749,1883,-
chr3,189973960,0.3955833768040341,909,647,1556,-
chr3,194402991,5.901916998292607,2026,1515,3541,-
chr3,194402992,5.901916998292607,2026,1515,3541,-
chr3,194402993,4.764280549530008,598,460,1058,-
chr3,194403760,1.0405003403041269,939,605,1544,-
chr3,194431018,1.8944131546689633,1986,1244,3230,-
chr3,194431128,2.2221763993936174,1809,1041,2850,-
chr3,194431130,1.0793677204658902,997,600,1597,-
chr3,194641315,7.477237596973389,592,428,1020,-
chr3,195516543,2.0712074303405568,668,475,1143,-
chr3,195519162,2.326889831840327,672,605,1277,-
chr3,195519164,1.4864946522448488,983,870,1853,-
chr3,195519165,1.0712810563865072,633,550,1183,-
chr3,195524827,1.3429326549897067,826,585,1411,-
chr3,196049493,5.224353741496597,2020,1749,3769,-
chr3,196049656,1.6879582755496032,5311,3671,8982,-
chr3,196049671,0.681788695238507,2101,1216,3317,-
chr3,196049997,1.5294469462426117,1010,835,1845,-
chr3,196050014,0.6923076923076924,1205,909,2114,-
chr3,196050065,3.997600796989882,4922,3787,8709,-
chr3,196050917,0.6352135054617676,1522,1059,2581,-
chr3,196050933,1.4691810010847668,1378,955,2333,-
chr3,196050947,1.2546511359463144,1920,1420,3340,-
chr3,196051004,1.7408448673587085,778,577,1355,-
chr3,196051345,1.3954076715497303,1754,1296,3050,-
chr3,196051347,2.1333333333333333,1031,773,1804,-
chr3,196051695,1.5300230946882218,1059,865,1924,-
chr3,196052077,0.6351891003053793,1182,902,2084,-
chr3,196053556,1.5226546129034426,4165,2783,6948,-
chr3,196055103,0.5653148390916395,2227,1390,3617,-
chr3,196058359,1.372608839050132,1073,757,1830,-
chr3,196058362,1.4389029977985754,2381,1649,4030,-
chr3,196062597,0.6011121951219511,1466,1249,2715,-
chr3,196062921,1.5039554136507116,5988,4931,10919,-
chr3,196062933,1.1941594114840968,2814,2441,5255,-
chr3,196064348,1.5486910994764398,985,763,1748,-
chr3,196065529,1.5711574952561669,1379,1053,2432,-
chr3,196067529,3.0288057806854805,1192,930,2122,-
chr3,196067531,1.431266265817105,1398,1012,2410,-
chr3,196067567,0.610296429694423,1219,896,2115,-
chr3,196067622,2.5567394611702645,2175,1711,3886,-
chr3,196068089,2.3796326135997417,1277,962,2239,-
chr3,196069475,2.6466821345707654,1163,861,2024,-
chr3,196069567,1.6911764705882353,1039,883,1922,-
chr3,196071440,1.647321428571429,881,783,1664,-
chr3,196072108,0.6470878752601686,1078,858,1936,-
chr3,196072133,1.5397290457578907,2380,1780,4160,-
chr3,196072138,1.8932475884244373,895,621,1516,-
chr3,196073997,0.5840711073636875,874,592,1466,-
chr3,196075203,1.8656748204940976,1156,912,2068,-
chr3,196075309,0.6534018928385126,1369,944,2313,-
chr3,196075338,1.886697214102372,2447,1963,4410,-
chr3,196075340,1.9478309753314726,1990,1709,3699,-
chr3,196077083,1.6097107438016531,953,604,1557,-
chr3,196077097,2.3267053701015965,942,688,1630,-
chr3,196077098,2.078649938886092,1508,1160,2668,-
chr3,196077102,2.3223819301848048,782,486,1268,-
chr3,196077113,1.0490620490620493,726,538,1264,-
chr3,196077114,1.0490620490620493,726,538,1264,-
chr3,196082054,1.8878557340095805,669,337,1006,-
chr3,196082058,2.8077823301082905,1942,1308,3250,-
chr3,196082059,2.786248444132396,1309,994,2303,-
chr3,196082078,2.257345009842366,1334,620,1954,-
chr3,196082080,2.2901015712683273,1537,735,2272,-
chr3,196936127,3.565251989389921,659,451,1110,-
chr3,196936517,1.405682248313838,820,581,1401,-
chr3,196936518,0.9432779097387176,583,420,1003,-
chr3,196939398,2.5189969604863216,662,469,1131,-
chr3,197044442,2.900503271085095,608,540,1148,-
chr3,197282837,2.0108670836948086,2201,1990,4191,-
chr3,197282838,2.0108670836948086,2201,1990,4191,-
chr3,197282840,0.5059360730593607,1107,729,1836,-
chr3,197296371,1.8721198156682026,749,495,1244,-
chr3,197296378,2.1814955640050697,1323,788,2111,-
chr3,197296380,2.1814955640050697,1323,788,2111,-
chr3,197296381,1.6729699666295883,657,433,1090,-
chr3,197296394,2.3825309320571826,1283,822,2105,-
chr3,197296461,2.125396966886704,1020,627,1647,-
chr3,197296463,2.735874560692079,659,410,1069,-
chr3,197850943,0.6461564495239086,2919,2066,4985,-
chr3,197850944,1.1284973053118286,6954,5657,12611,-
chr3,197850946,1.0501914486279516,4133,3133,7266,-
chr3,197850947,0.6824607208515505,1766,1320,3086,-
chr3,197850949,1.4989674441205054,850,783,1633,-
chr3,197850951,1.3970116163598991,1277,1006,2283,-
chr3,197850952,1.0446284609881369,2161,1642,3803,-
chr3,197850953,0.7661984767882428,1559,1478,3037,-
chr3,197850954,0.7867018599299801,6622,5352,11974,-
chr3,197850955,0.8161257218472063,3346,2822,6168,-
chr3,197850956,0.5734393616606682,2059,1584,3643,-
chr4,342806,2.026222612398282,2407,1962,4369,-
chr4,342808,2.5439065648399213,1514,1317,2831,-
chr4,342810,1.3096518901537972,4476,3308,7784,-
chr4,342811,1.4710220121552626,1387,1177,2564,-
chr4,342814,1.5173534552933179,798,713,1511,-
chr4,342815,0.7080698203895777,1865,1356,3221,-
chr4,673347,0.5856820190513601,851,598,1449,-
chr4,673397,2.437591741724165,774,612,1386,-
chr4,673399,0.4337121212121213,915,659,1574,-
chr4,673400,0.4337121212121213,915,659,1574,-
chr4,674246,0.903311762466692,790,496,1286,-
chr4,674248,0.903311762466692,790,496,1286,-
chr4,1211641,1.0413486956955458,802,488,1290,-
chr4,1211642,1.0413486956955458,802,488,1290,-
chr4,1228271,0.4601932870524226,1034,847,1881,-
chr4,1228273,0.5994908568865559,794,650,1444,-
chr4,1228315,2.9763774106336314,613,455,1068,-
chr4,1693028,4.539306104523496,607,505,1112,-
chr4,1693030,4.539306104523496,607,505,1112,-
chr4,1700028,2.0812069663831507,1194,822,2016,-
chr4,1700061,2.0824930657529777,1876,1134,3010,-
chr4,1700062,2.0824930657529777,1876,1134,3010,-
chr4,1700065,2.2768302273474967,1075,639,1714,-
chr4,1700066,1.6775338395510069,812,465,1277,-
chr4,1716044,10.565142021075756,716,529,1245,-
chr4,1716045,10.565142021075756,716,529,1245,-
chr4,1983625,3.370345640250717,860,469,1329,-
chr4,2948402,1.1556880880238218,1497,1171,2668,-
chr4,2948403,1.6112415232133543,705,425,1130,-
chr4,2949948,1.2513645717532145,1122,774,1896,-
chr4,2951140,2.834742296154895,944,578,1522,-
chr4,2951141,2.4806343960527752,1528,904,2432,-
chr4,3512695,0.5762090864680021,673,533,1206,-
chr4,3512850,1.5892329670329672,778,522,1300,-
chr4,3512906,2.1076780941056126,593,451,1044,-
chr4,3512980,4.282415996701712,798,440,1238,-
chr4,3512982,4.282415996701712,798,440,1238,-
chr4,3514902,1.8482724430449775,1049,677,1726,-
chr4,3516131,1.5772821639875148,2349,1844,4193,-
chr4,3516134,1.86592676675888,3351,2605,5956,-
chr4,3516135,1.77774529864562,3484,2798,6282,-
chr4,3516137,1.7479476071491036,3151,2340,5491,-
chr4,3516141,1.9988404452690165,883,615,1498,-
chr4,3516156,1.7684729064039408,717,492,1209,-
chr4,3518045,2.1482486331823067,729,492,1221,-
chr4,3524989,3.03882252559727,837,585,1422,-
chr4,3525005,0.8990905230377239,1036,795,1831,-
chr4,3525006,0.5059050647285941,659,475,1134,-
chr4,3525007,0.8990905230377239,1036,795,1831,-
chr4,3532236,2.243434138656466,921,740,1661,-
chr4,3532239,1.7962180498427105,995,728,1723,-
chr4,4274491,1.9014970709481451,625,418,1043,-
chr4,4274536,1.9039596229666143,1436,1014,2450,-
chr4,4274537,2.4635197817189636,1025,732,1757,-
chr4,4283633,1.7053669222343923,691,497,1188,-
chr4,4283673,2.5164282953227675,619,397,1016,-
chr4,6707906,1.5916022974846504,573,458,1031,-
chr4,6708207,1.4974244560055259,890,469,1359,-
chr4,6709282,3.190751445086705,959,691,1650,-
chr4,6709294,1.8892193308550187,846,537,1383,-
chr4,6709296,1.9965243836211584,706,340,1046,-
chr4,6709304,1.077891282577832,1763,1005,2768,-
chr4,6709312,1.9526572829659385,923,542,1465,-
chr4,6709321,1.9405501330967168,809,489,1298,-
chr4,6709324,1.5031880286271957,721,434,1155,-
chr4,7060841,4.65186218255886,1209,854,2063,-
chr4,7060842,6.204605735333532,1385,1025,2410,-
chr4,7759336,1.4524444444444444,816,599,1415,-
chr4,7759337,1.4524444444444444,816,599,1415,-
chr4,7759338,1.11233615116146,1140,802,1942,-
chr4,7760676,3.4127324749642347,733,465,1198,-
chr4,7760678,3.4127324749642347,733,465,1198,-
chr4,7760749,2.5494515489227294,585,418,1003,-
chr4,7763126,1.9557813911472453,1006,539,1545,-
chr4,7763127,1.5653448649955637,1743,1040,2783,-
chr4,7763128,1.0780876494023903,737,501,1238,-
chr4,7838597,4.637654320987653,682,404,1086,-
chr4,7838599,4.637654320987653,682,404,1086,-
chr4,7838699,3.946603788657512,789,465,1254,-
chr4,10074880,2.1296992481203003,617,398,1015,-
chr4,10077346,1.7294787527151259,9995,5752,15747,-
chr4,10077347,1.7445070924411097,11487,6408,17895,-
chr4,10077349,1.6436959147332593,3667,1753,5420,-
chr4,10077350,2.2545045045045047,923,665,1588,-
chr4,10077356,0.5183480328425688,3339,1787,5126,-
chr4,10077357,0.5074910943836235,3763,2054,5817,-
chr4,10077359,2.002557544757033,782,509,1291,-
chr4,10077383,0.5788295165394403,1033,654,1687,-
chr4,10077389,0.5746470099667774,1352,945,2297,-
chr4,10077390,0.5746470099667774,1352,945,2297,-
chr4,10077399,3.171240985900333,1015,488,1503,-
chr4,10077401,3.171240985900333,1015,488,1503,-
chr4,15605384,1.9212753053975224,1511,1116,2627,-
chr4,15605385,1.9212753053975224,1511,1116,2627,-
chr4,15605397,2.3073022312373226,636,405,1041,-
chr4,15605403,2.9592175861966985,1571,885,2456,-
chr4,15605405,2.5666666666666664,1077,629,1706,-
chr4,15640879,1.6355654761904759,757,559,1316,-
chr4,15640881,2.7907617248977017,864,705,1569,-
chr4,15644514,1.6283185840707963,1471,1016,2487,-
chr4,15644516,1.6283185840707963,1471,1016,2487,-
chr4,15644532,2.4413750767341926,872,542,1414,-
chr4,15644533,2.6517850906798675,1428,978,2406,-
chr4,16256512,1.2629457898829428,658,466,1124,-
chr4,22461780,3.894100523650553,626,462,1088,-
chr4,22461782,3.894100523650553,626,462,1088,-
chr4,22727880,1.804090934076639,513,511,1024,-
chr4,24527865,0.2405042016806723,953,713,1666,-
chr4,24527877,2.1422950819672133,989,609,1598,-
chr4,24527879,1.6612787356321843,874,671,1545,-
chr4,24528017,0.5734818541142651,671,483,1154,-
chr4,24529689,0.4090664272890485,650,556,1206,-
chr4,24529758,2.266088383542375,715,448,1163,-
chr4,24529763,2.0322206759761343,970,633,1603,-
chr4,24532949,1.649481658692185,1008,659,1667,-
chr4,24532954,2.0552677029360966,883,578,1461,-
chr4,24532967,1.6658399470899468,649,503,1152,-
chr4,24533032,2.0995088618407003,1228,668,1896,-
chr4,24533033,2.1461639322238515,1562,860,2422,-
chr4,24537093,1.7710501419110691,647,452,1099,-
chr4,24540175,1.7281209180817316,685,465,1150,-
chr4,24540176,0.4566959921798632,583,464,1047,-
chr4,24542016,0.9366835715383433,1059,963,2022,-
chr4,24542017,0.9366835715383433,1059,963,2022,-
chr4,24543010,2.4354496490941733,828,556,1384,-
chr4,24554919,1.7862623838635392,1654,1189,2843,-
chr4,24556340,1.841896007218588,1316,1159,2475,-
chr4,24576528,2.502858076106484,612,470,1082,-
chr4,24576674,1.6804924454939587,1609,963,2572,-
chr4,24576676,1.6804924454939587,1609,963,2572,-
chr4,24584359,1.0621446353995303,1171,807,1978,-
chr4,24584468,0.243343653250774,523,679,1202,-
chr4,24584469,0.31943365121920714,916,1026,1942,-
chr4,24584480,12.549378375010475,2266,2047,4313,-
chr4,24584481,14.732760142185569,2908,2660,5568,-
chr4,24584482,14.732760142185569,2908,2660,5568,-
chr4,24584483,19.128327071526694,1070,1056,2126,-
chr4,24584503,4.054391125518725,739,313,1052,-
chr4,25788317,1.4958355767053124,584,603,1187,-
chr4,25804728,1.8716918515064065,747,494,1241,-
chr4,25818150,3.863714842342661,860,557,1417,-
chr4,25833009,1.0543572044866265,845,548,1393,-
chr4,25833010,1.0543572044866265,845,548,1393,-
chr4,25833546,0.37814486551250054,583,432,1015,-
chr4,25847342,1.52127876200277,714,538,1252,-
chr4,25847623,2.465275215489814,878,597,1475,-
chr4,25847713,2.1002168646367187,952,615,1567,-
chr4,39321310,0.632427585787666,1188,996,2184,-
chr4,39321315,4.991561181434599,727,710,1437,-
chr4,39321319,1.6345357776463634,690,622,1312,-
chr4,39321320,1.7336872192731727,922,789,1711,-
chr4,39321337,0.5641511741682974,614,510,1124,-
chr4,39321342,0.3566787941787942,548,480,1028,-
chr4,39321369,2.737284464792326,804,617,1421,-
chr4,39454191,1.8868162901307965,650,463,1113,-
chr4,39863014,0.42378328741965104,567,527,1094,-
chr4,39910307,2.3040865384615383,638,415,1053,-
chr4,39910308,2.3040865384615383,638,415,1053,-
chr4,39928000,0.4017956125385996,559,445,1004,-
chr4,39973363,0.5478458049886622,603,494,1097,-
chr4,39973370,1.6202898550724638,730,594,1324,-
chr4,39973371,1.6202898550724638,730,594,1324,-
chr4,39973377,1.6792116611425925,888,596,1484,-
chr4,39973378,1.4367958018212688,641,417,1058,-
chr4,39973379,1.7440618304254667,1043,706,1749,-
chr4,46724219,3.1099150179616326,929,634,1563,-
chr4,47460244,1.6507365637966285,621,419,1040,-
chr4,48904560,2.150313894322328,605,441,1046,-
chr4,54048997,3.1593406593406588,689,467,1156,-
chr4,54048998,3.1593406593406588,689,467,1156,-
chr4,57031222,1.9309727558505063,940,817,1757,-
chr4,57031233,1.905633802816901,860,709,1569,-
chr4,57031269,2.0218818380743984,615,456,1071,-
chr4,57032499,1.007741935483871,922,649,1571,-
chr4,57032501,1.007741935483871,922,649,1571,-
chr4,57033212,2.1888795094303335,807,563,1370,-
chr4,57110087,0.30088551296169025,638,640,1278,-
chr4,57110088,0.2793561812545122,505,500,1005,-
chr4,62105660,1.0905685999995653,963,713,1676,-
chr4,68314104,0.5875876882157489,767,551,1318,-
chr4,68330021,2.002334120581886,1135,790,1925,-
chr4,68337769,2.0327269317329333,1226,1031,2257,-
chr4,68337778,1.962597150259068,2138,1543,3681,-
chr4,68337779,1.709826279932944,2597,1831,4428,-
chr4,70820115,2.593670381380913,598,449,1047,-
chr4,70824342,2.0659588861817606,1420,924,2344,-
chr4,70825351,1.7957543775485727,650,378,1028,-
chr4,70825365,3.0622741520752697,676,513,1189,-
chr4,70826225,1.3099767825351547,1637,1116,2753,-
chr4,70831553,2.784386405811905,842,676,1518,-
chr4,70831586,1.8190179830418374,1192,915,2107,-
chr4,70832380,2.8730769230769235,746,519,1265,-
chr4,70832390,3.4577922077922074,709,503,1212,-
chr4,70833193,1.9506586050529042,622,420,1042,-
chr4,70836218,2.702097902097902,643,494,1137,-
chr4,70836268,1.1692165655499869,590,445,1035,-
chr4,70836270,1.1692165655499869,590,445,1035,-
chr4,73140117,1.5679709794407455,1731,1219,2950,-
chr4,73140135,1.4276228419654713,687,501,1188,-
chr4,74086248,1.7408521867148867,1097,1088,2185,-
chr4,74086251,2.101748457243609,937,663,1600,-
chr4,74086253,1.8592203781627579,2124,1998,4122,-
chr4,74086254,1.7164119481456663,1530,1686,3216,-
chr4,74086255,1.7164119481456663,1530,1686,3216,-
chr4,74086256,1.7302854523761901,1932,1904,3836,-
chr4,74086258,1.900546448087432,939,914,1853,-
chr4,74086259,2.2699511937739083,812,721,1533,-
chr4,74086298,0.6555137268042817,781,622,1403,-
chr4,75644275,0.3294944647750437,540,813,1353,-
chr4,75644276,0.32841335754847895,516,763,1279,-
chr4,75644289,9.61841662722438,735,1027,1762,-
chr4,75644292,3.6367887241491395,611,589,1200,-
chr4,75644296,17.295621798961303,978,909,1887,-
chr4,75644302,19.35064495573069,1684,700,2384,-
chr4,75644303,19.35064495573069,1684,700,2384,-
chr4,75644304,15.32360104506421,1425,519,1944,-
chr4,75644482,3.9103482062104313,831,533,1364,-
chr4,75645430,2.5315807449281595,776,569,1345,-
chr4,75662028,2.8143958908176194,641,378,1019,-
chr4,76161076,9.14210643561411,568,692,1260,-
chr4,76161519,1.1221776197047364,584,465,1049,-
chr4,76958947,0.5662954488215076,1733,1301,3034,-
chr4,76958956,1.8110967072854551,658,550,1208,-
chr4,76958958,1.8110967072854551,658,550,1208,-
chr4,76958959,0.6151661459812553,721,502,1223,-
chr4,76958965,1.3043583053355068,809,654,1463,-
chr4,76958993,1.0168276907697036,1878,1553,3431,-
chr4,76958994,0.8968995653994171,2564,2077,4641,-
chr4,76959051,1.2760352692091503,1193,844,2037,-
chr4,77047263,1.960556844547564,584,430,1014,-
chr4,77047493,1.6843537414965988,618,489,1107,-
chr4,77048462,2.115058863315924,793,546,1339,-
chr4,77048515,2.769121891044729,600,409,1009,-
chr4,78181466,1.6680351906158355,710,619,1329,-
chr4,78181496,2.3971177100058636,890,548,1438,-
chr4,78181591,0.8824407841893177,1960,1273,3233,-
chr4,78181593,0.6231373501781665,1398,881,2279,-
chr4,78181596,0.7493317224193914,998,614,1612,-
chr4,78181597,0.7493317224193914,998,614,1612,-
chr4,78181738,0.4778534923339012,857,586,1443,-
chr4,78181743,0.29565329218106995,835,575,1410,-
chr4,82353944,2.7140668096843394,655,501,1156,-
chr4,82354049,1.6594082840236688,778,649,1427,-
chr4,82354063,1.678806798473812,725,557,1282,-
chr4,82354069,0.4175319971021492,664,504,1168,-
chr4,82356674,3.5756312788207016,734,541,1275,-
chr4,82357389,2.026369168356998,665,579,1244,-
chr4,82357413,1.7021918835568994,1354,955,2309,-
chr4,82357418,1.8090666666666668,847,599,1446,-
chr4,82358771,1.727485380116959,632,512,1144,-
chr4,82358772,0.5569387071564139,906,675,1581,-
chr4,82359539,1.4282779205973621,6542,5046,11588,-
chr4,82359540,1.441987736255252,2806,2354,5160,-
chr4,82359543,1.5915349469888977,3423,2489,5912,-
chr4,82359544,1.800128732544147,1236,830,2066,-
chr4,82359546,1.7006644343915882,3124,2224,5348,-
chr4,82359590,1.5542168674698795,1031,663,1694,-
chr4,82359633,1.4496298981850555,11546,8969,20515,-
chr4,82359634,1.302645912813865,16280,13012,29292,-
chr4,82359636,1.5897365345087882,15516,11736,27252,-
chr4,82359637,1.5259890490635568,7887,6337,14224,-
chr4,82359638,1.2391815682220708,17451,12880,30331,-
chr4,82371553,1.088474705211107,2043,1194,3237,-
chr4,82371555,0.8377522780887294,3816,2612,6428,-
chr4,82371556,2.0074031890660597,1127,877,2004,-
chr4,82371559,0.9193581862040916,3981,3272,7253,-
chr4,82371561,0.6587705905986341,2927,2488,5415,-
chr4,82371563,2.019867549668874,731,452,1183,-
chr4,82373461,0.6337403051541461,1177,1096,2273,-
chr4,82373464,0.6606581701678121,3335,3277,6612,-
chr4,82373467,0.6182842109430028,4284,4141,8425,-
chr4,82373468,0.492845695970696,1852,1903,3755,-
chr4,82373475,0.5320496634514801,1208,1428,2636,-
chr4,82373477,0.4705977159697919,756,711,1467,-
chr4,82373479,1.4355219973589668,4803,5388,10191,-
chr4,82373481,2.0301038734500194,8181,8547,16728,-
chr4,82373482,3.708268457989776,5811,5897,11708,-
chr4,82373483,3.708268457989776,5811,5897,11708,-
chr4,82373501,6.054431462084662,3104,2572,5676,-
chr4,82373502,5.97761401156363,3383,2739,6122,-
chr4,82373503,6.435123979962079,2705,2282,4987,-
chr4,82373528,2.207093776648955,1020,684,1704,-
chr4,82373530,2.214741602989023,1749,1254,3003,-
chr4,82373531,2.178982703244336,1518,1098,2616,-
chr4,82373532,2.178982703244336,1518,1098,2616,-
chr4,82373713,1.990066410913624,8279,9493,17772,-
chr4,82373722,0.5609042269408411,3560,4334,7894,-
chr4,82373738,0.5686890141784788,8519,11652,20171,-
chr4,82373739,0.577930119404962,12235,17082,29317,-
chr4,82373741,0.5778546878261204,7759,11091,18850,-
chr4,82373744,0.6808382200026988,5546,6818,12364,-
chr4,82373746,0.72622813653348,2946,2357,5303,-
chr4,82373747,0.5677622627998568,1801,1469,3270,-
chr4,82373748,0.4862292364239205,4472,8309,12781,-
chr4,82373749,0.515515798758285,6339,11218,17557,-
chr4,82373750,0.7677405093513214,8408,15097,23505,-
chr4,82373752,2.4686050207131967,9309,14281,23590,-
chr4,82373753,3.2781895970441965,7403,10569,17972,-
chr4,82373754,3.491013240884841,5774,9097,14871,-
chr4,82373778,1.6144919833466207,700,638,1338,-
chr4,82373840,4.580516453165919,927,580,1507,-
chr4,82373841,4.820454545454545,706,439,1145,-
chr4,82373851,6.523059522989108,1459,841,2300,-
chr4,82373852,3.1384430176565004,710,355,1065,-
chr4,82373931,1.7638520914015448,1336,1013,2349,-
chr4,82424869,1.9337848793748078,1270,890,2160,-
chr4,82426052,1.5632808046222326,1237,838,2075,-
chr4,82426604,1.9477832512315274,658,434,1092,-
chr4,82428037,2.1581286549707603,658,449,1107,-
chr4,82428298,1.7280715949146224,1903,1596,3499,-
chr4,82428299,1.443607888922556,3946,3085,7031,-
chr4,82428371,1.9308475269807166,1509,930,2439,-
chr4,82428440,1.500556407277476,9207,6855,16062,-
chr4,82428443,1.2195774589523143,10067,7205,17272,-
chr4,82428444,0.6321057527116731,3630,2391,6021,-
chr4,82428446,0.5558214624881291,1828,1214,3042,-
chr4,82429256,1.5375404080127348,3048,2232,5280,-
chr4,82429264,1.3353901529759609,3919,2592,6511,-
chr4,82429265,1.2965903403403405,2481,1775,4256,-
chr4,82429266,1.3833439040691862,3292,2186,5478,-
chr4,82429269,1.421478112993663,5154,3478,8632,-
chr4,82429280,1.5289125955205762,5368,3639,9007,-
chr4,82429281,1.4846231913744623,3773,2587,6360,-
chr4,82429298,1.4814462416745957,1556,1050,2606,-
chr4,82429317,1.6224014336917565,822,539,1361,-
chr4,82429322,1.6937142857142855,740,499,1239,-
chr4,82429323,1.9943871917556129,1274,835,2109,-
chr4,82429326,0.9492427343430208,1545,1046,2591,-
chr4,82429327,0.9492427343430208,1545,1046,2591,-
chr4,82429328,1.7173717371737174,1112,706,1818,-
chr4,82429334,2.4930054352668627,1141,773,1914,-
chr4,82429336,2.4930054352668627,1141,773,1914,-
chr4,82429344,1.771226549580886,1502,922,2424,-
chr4,82429346,1.771226549580886,1502,922,2424,-
chr4,82429363,2.2343518688662933,819,476,1295,-
chr4,82429371,1.4782009408356762,648,432,1080,-
chr4,82853632,3.682824810980216,1156,678,1834,-
chr4,82854969,2.400795050162718,581,479,1060,-
chr4,82891123,0.7324951801465435,900,599,1499,-
chr4,86949853,1.6351506661361221,1441,1043,2484,-
chr4,86949891,3.4245732433505363,638,457,1095,-
chr4,86949892,2.5221972977202776,947,660,1607,-
chr4,86949894,1.9805666916577647,1441,865,2306,-
chr4,86949990,1.5253720225938696,1648,1133,2781,-
chr4,86950044,2.7019052044609664,801,537,1338,-
chr4,86950056,1.2807903974366779,977,725,1702,-
chr4,88521868,2.456140350877193,574,436,1010,-
chr4,88521975,1.6439088465298142,1144,681,1825,-
chr4,88521993,0.9047041461752159,2192,1388,3580,-
chr4,88521995,0.5665280282675108,1663,1075,2738,-
chr4,89726380,0.5305771590717114,749,510,1259,-
chr4,89726562,2.4888297349513815,587,522,1109,-
chr4,89726616,2.4875565610859725,732,662,1394,-
chr4,89726617,2.4875565610859725,732,662,1394,-
chr4,90838562,0.6353731343283582,1160,1004,2164,-
chr4,90838582,0.5231939753891541,585,830,1415,-
chr4,90838592,0.49642620456413267,1071,1315,2386,-
chr4,90838637,0.3551165645140085,746,1265,2011,-
chr4,90838638,0.35736225779649433,664,1081,1745,-
chr4,90838639,0.30709570829210625,872,1465,2337,-
chr4,90838641,0.24728269549256496,987,1943,2930,-
chr4,90838643,0.2284843420765729,440,1087,1527,-
chr4,90838646,17.41630141476607,443,905,1348,-
chr4,90838941,0.7631322456431762,2390,1600,3990,-
chr4,90838942,1.1701490841722595,2818,2303,5121,-
chr4,90838944,1.5415968732551648,5521,3183,8704,-
chr4,90838945,1.5415968732551648,5521,3183,8704,-
chr4,90838946,0.7341814196034144,2148,1770,3918,-
chr4,90838949,1.6173938731563853,4995,3411,8406,-
chr4,90838953,1.4509683852162798,4568,3041,7609,-
chr4,90838956,1.5451623272259722,2023,1036,3059,-
chr4,90838958,0.4835386550831968,1566,1358,2924,-
chr4,90838960,1.0022593229031314,6002,4058,10060,-
chr4,90838961,0.9618961986660928,3325,2550,5875,-
chr4,90838964,1.522504892367906,1166,692,1858,-
chr4,90838965,0.6094527363184079,759,401,1160,-
chr4,90838966,1.522504892367906,1166,692,1858,-
chr4,90838967,0.5860235003092146,617,494,1111,-
chr4,90838969,1.9875930521091807,800,402,1202,-
chr4,90838970,1.372700541642143,1323,827,2150,-
chr4,90839059,1.2128050317944588,1571,1231,2802,-
chr4,90839107,0.9289066959959413,1091,810,1901,-
chr4,90839111,0.9683748941898058,670,458,1128,-
chr4,98880820,2.011054658822307,657,414,1071,-
chr4,98880950,0.46582769716733163,573,479,1052,-
chr4,99072050,20.63472285029243,799,611,1410,-
chr4,99072398,2.671407731582786,585,456,1041,-
chr4,99072401,1.8433059087509347,953,572,1525,-
chr4,99076347,1.7152428810720268,1983,1790,3773,-
chr4,99076349,1.7152428810720268,1983,1790,3773,-
chr4,99076353,1.5415959252971136,907,759,1666,-
chr4,99076394,1.5380804953560372,971,854,1825,-
chr4,99076396,1.529278494248867,899,603,1502,-
chr4,99076419,0.5070162135961466,1187,804,1991,-
chr4,99076496,1.9344825328030864,988,726,1714,-
chr4,99076527,5.521235521235522,604,406,1010,-
chr4,99076768,1.5873015873015872,849,503,1352,-
chr4,99076859,0.527896551724138,728,579,1307,-
chr4,99082018,2.134570765661253,574,430,1004,-
chr4,99559327,0.2765693466221369,753,507,1260,-
chr4,99559339,2.2805451163729167,970,635,1605,-
chr4,99948486,1.1041151000538745,4841,3665,8506,-
chr4,99948496,1.4803186470835499,4607,3161,7768,-
chr4,99948502,1.4131858979127936,6917,4594,11511,-
chr4,99948503,1.354855179185076,5137,3394,8531,-
chr4,99948922,1.341249870434612,4769,2953,7722,-
chr4,99948923,1.3511442506430074,6863,4205,11068,-
chr4,99948924,1.8649547631719001,2567,1878,4445,-
chr4,99948925,1.5381601992352423,8725,6065,14790,-
chr4,99948931,1.4860134003350085,1612,1392,3004,-
chr4,99948932,1.3865810868635005,1140,778,1918,-
chr4,99948934,1.5607537201756703,3109,2170,5279,-
chr4,99948937,1.5869870041039666,1572,859,2431,-
chr4,99949349,0.7504175824175825,2327,1949,4276,-
chr4,99950178,0.7514312689580362,2021,1485,3506,-
chr4,99950230,1.3638793255940267,4898,3648,8546,-
chr4,99950267,1.574837487243593,4850,3042,7892,-
chr4,99950268,1.604092261429051,4751,2939,7690,-
chr4,99950271,0.9458933869269788,2157,1289,3446,-
chr4,99950272,0.9439992846536571,3319,2063,5382,-
chr4,99950279,2.9805742176720726,607,498,1105,-
chr4,99950281,4.5731750065302315,1544,1248,2792,-
chr4,99950282,6.539043857897874,1232,997,2229,-
chr4,102261957,1.7431429605279143,879,580,1459,-
chr4,102639831,2.3096004940255552,985,568,1553,-
chr4,102639832,2.05525203537764,610,463,1073,-
chr4,102639836,1.0314545647836533,809,434,1243,-
chr4,102796132,5.950596300578123,1926,1768,3694,-
chr4,102796133,6.261629209218741,2309,2023,4332,-
chr4,102796601,2.4325203252032517,1121,614,1735,-
chr4,102796747,1.6520881470644355,1379,1083,2462,-
chr4,102796748,2.0182998819362457,788,461,1249,-
chr4,102796779,2.6535087719298245,604,474,1078,-
chr4,102797030,2.4899598393574296,867,580,1447,-
chr4,102797112,1.827409521338695,804,592,1396,-
chr4,102797428,0.5847665847665847,679,439,1118,-
chr4,102797448,2.54279541299651,849,546,1395,-
chr4,102797449,2.54279541299651,849,546,1395,-
chr4,102797452,1.5656449918616007,1425,887,2312,-
chr4,102797453,1.2144802365390601,1006,611,1617,-
chr4,102797454,1.5656449918616007,1425,887,2312,-
chr4,102799465,1.181180547383733,853,760,1613,-
chr4,102801525,2.0561753510959444,745,400,1145,-
chr4,102802607,2.295440670773039,688,545,1233,-
chr4,102802625,0.2634062634062634,613,440,1053,-
chr4,102802627,0.2634062634062634,613,440,1053,-
chr4,102802632,0.6261378445501444,644,486,1130,-
chr4,102809686,1.046259344426224,579,476,1055,-
chr4,105369712,1.6577878937007875,690,507,1197,-
chr4,105369723,3.4523983087913686,1183,721,1904,-
chr4,105369725,3.4523983087913686,1183,721,1904,-
chr4,105370848,1.7648833467417535,701,451,1152,-
chr4,105370849,0.44162129461585,729,521,1250,-
chr4,105386623,0.5041322314049587,609,439,1048,-
chr4,105386624,1.7157620741884787,1850,1267,3117,-
chr4,105399082,1.832048811817598,814,518,1332,-
chr4,105424290,1.7135740072202166,1757,1384,3141,-
chr4,105446404,1.6861278311642605,2106,1248,3354,-
chr4,105456737,2.4040919390484703,698,555,1253,-
chr4,105473910,2.5498127340823973,850,533,1383,-
chr4,105473911,2.5498127340823973,850,533,1383,-
chr4,109714385,1.988330696202532,1116,631,1747,-
chr4,109714391,2.748648350435838,858,476,1334,-
chr4,109714394,1.9485362815322333,862,493,1355,-
chr4,109714395,2.9662068965517236,1563,799,2362,-
chr4,109714397,2.9662068965517236,1563,799,2362,-
chr4,109714436,0.904383429672447,750,345,1095,-
chr4,109714437,0.904383429672447,750,345,1095,-
chr4,109714441,1.128024193548387,745,383,1128,-
chr4,109714442,2.4024710830704517,961,633,1594,-
chr4,109714443,1.874338793804879,1706,1016,2722,-
chr4,109740831,2.196733155819638,747,513,1260,-
chr4,109749548,2.2962036466810365,599,417,1016,-
chr4,109766818,2.096874610453949,856,573,1429,-
chr4,112788263,1.4221726439983164,4617,3520,8137,-
chr4,112788281,0.8133462282398451,3421,2595,6016,-
chr4,112788285,1.0904440408601492,5512,4361,9873,-
chr4,112788288,1.1934528389399028,7042,5688,12730,-
chr4,112788289,1.3980763648463994,3690,3173,6863,-
chr4,112788290,0.8055104924381182,3289,2757,6046,-
chr4,112788291,1.1777607689142278,7324,5646,12970,-
chr4,112788293,1.3850036630946319,4208,2776,6984,-
chr4,112788294,1.3246189588705353,2617,1702,4319,-
chr4,113500507,2.187695268094534,748,530,1278,-
chr4,119300383,1.7419950738916254,614,405,1019,-
chr4,119300427,1.2834662310137641,779,520,1299,-
chr4,120059707,1.85625,879,511,1390,-
chr4,120060156,1.7741187384044528,749,489,1238,-
chr4,120062066,2.8368986063172965,865,597,1462,-
chr4,120065770,1.6146666666666667,518,499,1017,-
chr4,120065797,1.2407800932467086,686,588,1274,-
chr4,120066805,1.6911469760833728,909,593,1502,-
chr4,121668505,1.5237430776610124,1663,1206,2869,-
chr4,121668524,1.4371233867256832,1285,970,2255,-
chr4,121670003,0.6959530966958621,1984,1362,3346,-
chr4,121670010,0.5048982942625194,1627,1153,2780,-
chr4,121672564,1.5402352379621886,4021,2915,6936,-
chr4,121672601,1.4858923787936769,1886,1476,3362,-
chr4,121677927,0.6860472091418974,1172,865,2037,-
chr4,121678434,1.7259749839654115,3488,2441,5929,-
chr4,121678475,1.5890544469406633,1748,1080,2828,-
chr4,121681744,0.5267857142857142,2123,1455,3578,-
chr4,121683471,1.526464637674854,1230,1068,2298,-
chr4,121684730,2.771355498721228,1031,781,1812,-
chr4,121686318,1.775666298236203,3654,2776,6430,-
chr4,121686365,0.6146341463414635,881,819,1700,-
chr4,121696599,1.750910036401456,961,640,1601,-
chr4,121696881,1.841648590021692,565,460,1025,-
chr4,121696882,2.4622792937399685,589,444,1033,-
chr4,121696892,1.8362282878411909,739,402,1141,-
chr4,121696961,1.507479926596851,638,474,1112,-
chr4,121817032,0.4590268711923412,784,1531,2315,-
chr4,121817033,0.45433830238579787,1881,3157,5038,-
chr4,121817037,0.1925253903897876,435,858,1293,-
chr4,121817044,0.29707587259064355,1224,2240,3464,-
chr4,121817045,0.23616535297531077,1066,2302,3368,-
chr4,121817051,52.16295041039722,2169,2626,4795,-
chr4,121817052,53.729792147806,704,865,1569,-
chr4,121817053,70.93849938499386,855,812,1667,-
chr4,121817060,3.6860845205147603,1616,432,2048,-
chr4,121817061,3.6860845205147603,1616,432,2048,-
chr4,121817063,6.479215387415834,1004,297,1301,-
chr4,121817066,4.853994490358127,880,230,1110,-
chr4,121817067,6.446700707719992,1166,319,1485,-
chr4,121817211,2.6639584743850144,907,632,1539,-
chr4,121817212,2.6639584743850144,907,632,1539,-
chr4,121817486,1.8452344152498712,967,646,1613,-
chr4,121817634,0.6011771300448431,714,445,1159,-
chr4,121817637,2.4957905857136478,1056,729,1785,-
chr4,121819554,3.6631016042780753,684,458,1142,-
chr4,121820733,1.7972972972972971,683,443,1126,-
chr4,121822507,2.7998911465892595,670,423,1093,-
chr4,121822577,1.9574951431973426,1372,1181,2553,-
chr4,121822579,1.9574951431973426,1372,1181,2553,-
chr4,121822617,0.4841699205419499,764,625,1389,-
chr4,128270555,2.9896919416527754,913,657,1570,-
chr4,128270736,0.24745475113122173,499,543,1042,-
chr4,128270801,0.4449866903283051,589,643,1232,-
chr4,128270809,0.4370834064037512,879,1256,2135,-
chr4,128270836,11.542864868564587,3975,4739,8714,-
chr4,128270837,11.786410704650336,5257,5423,10680,-
chr4,128270838,11.786410704650335,5257,5423,10680,-
chr4,128270839,15.319456154487044,3909,3458,7367,-
chr4,128270855,3.2653896368542172,1034,494,1528,-
chr4,128272454,0.6066714662826974,631,462,1093,-
chr4,138167064,1.1629032258064516,617,464,1081,-
chr4,138167066,1.1629032258064516,617,464,1081,-
chr4,138242281,1.7660639341173654,2073,1235,3308,-
chr4,138242285,1.6168446515207742,1383,920,2303,-
chr4,138242287,2.0395142760156078,3708,2064,5772,-
chr4,138242288,2.1438881933176583,2991,1578,4569,-
chr4,138242289,2.45510469264667,2965,1599,4564,-
chr4,138242291,2.9293821555467825,1262,595,1857,-
chr4,139115009,0.7863425925925928,710,647,1357,-
chr4,139115010,1.9506155478281302,654,465,1119,-
chr4,139115122,1.9256276921882884,832,580,1412,-
chr4,139292595,0.5110192837465565,635,483,1118,-
chr4,139295077,2.0960029472555184,946,756,1702,-
chr4,139295087,2.464301568054705,1876,1261,3137,-
chr4,139295088,2.300438733290335,2020,1443,3463,-
chr4,139295089,2.407317859445519,1544,1033,2577,-
chr4,139533175,3.434405940594059,674,605,1279,-
chr4,139533176,2.0220598594581713,733,568,1301,-
chr4,144995529,1.197389798596839,4518,2798,7316,-
chr4,144995530,1.5197441138004328,5913,4127,10040,-
chr4,144995537,0.5927117584168801,1678,1113,2791,-
chr4,144995544,1.7020232438823082,1089,878,1967,-
chr4,144995581,2.351350867558949,825,494,1319,-
chr4,144995588,2.962604559619485,668,468,1136,-
chr4,154537376,4.062310263691143,591,473,1064,-
chr4,154547052,4.416195003220425,685,408,1093,-
chr4,154550313,2.715296095861796,874,618,1492,-
chr4,154550324,0.47801649945835556,958,534,1492,-
chr4,154550399,0.6641244755330413,801,489,1290,-
chr4,154604960,1.8109488184301152,609,400,1009,-
chr4,154604978,0.4542305027330818,589,418,1007,-
chr4,154605042,0.3655011655011655,587,428,1015,-
chr4,154605054,2.588358382209189,619,469,1088,-
chr4,154608581,2.112978524743231,583,475,1058,-
chr4,154608622,2.2380496808724555,572,429,1001,-
chr4,154611895,2.0282405203871168,798,572,1370,-
chr4,158709265,2.0871504847137596,937,509,1446,-
chr4,158715625,3.507294532707042,605,459,1064,-
chr4,158715631,0.9018770742136034,688,485,1173,-
chr4,158719212,1.5679940592221295,823,797,1620,-
chr4,158719215,2.0218894691734994,1162,1281,2443,-
chr4,158719218,2.0921633554083883,1337,1358,2695,-
chr4,158719219,2.037541086029392,1757,1752,3509,-
chr4,158719220,2.0741291117026077,2091,2200,4291,-
chr4,158719221,2.050632911392405,1295,1263,2558,-
chr4,158719226,0.4695379582935805,529,505,1034,-
chr4,168990200,0.9967091723870357,662,397,1059,-
chr4,173331917,1.6743831006979064,1761,1002,2763,-
chr4,173332095,4.849674778249342,3346,2716,6062,-
chr4,173332101,3.8006630385879823,3259,2433,5692,-
chr4,173332118,1.6059705852793555,1980,1383,3363,-
chr4,173332119,1.8366792929292928,1237,879,2116,-
chr4,173332124,2.1222346507581404,922,595,1517,-
chr4,173332125,2.2001284043035065,2137,1430,3567,-
chr4,173332194,2.024739583333333,932,767,1699,-
chr4,173332195,1.8048697428911968,1199,838,2037,-
chr4,173332911,1.489299527288354,1082,894,1976,-
chr4,173333099,1.567928945996649,6188,4065,10253,-
chr4,173333101,1.6387820762305076,3922,2657,6579,-
chr4,173333110,1.512186395957247,1748,1136,2884,-
chr4,173333173,1.4553571428571428,1466,1077,2543,-
chr4,173333181,1.7312741312741309,1120,664,1784,-
chr4,173333560,1.45272746804168,4122,2674,6796,-
chr4,173333561,0.7672067851889749,8804,4559,13363,-
chr4,173333563,0.7546669311924984,15932,9037,24969,-
chr4,173333564,0.7580632712103268,12423,7683,20106,-
chr4,173333565,0.7073273761525498,18470,10558,29028,-
chr4,173333568,0.824213883017804,11370,6914,18284,-
chr4,173333569,0.8162488874196234,9204,5954,15158,-
chr4,173333570,0.899116989681431,13127,7876,21003,-
chr4,173333572,1.4538341499612604,3649,2013,5662,-
chr4,173333574,1.6223123732251523,1487,985,2472,-
chr4,173333576,0.6592893088220192,1387,748,2135,-
chr4,173333614,0.5313859150217464,1772,1175,2947,-
chr4,173333616,0.5313859150217464,1772,1175,2947,-
chr4,173333637,1.7988785046728968,801,534,1335,-
chr4,173334286,2.7803535125367067,1562,931,2493,-
chr4,173334287,2.7803535125367067,1562,931,2493,-
chr4,173334352,0.7601242103640985,2241,1196,3437,-
chr4,173334358,1.6630462709924556,711,602,1313,-
chr4,173334359,1.1615481660452505,1675,1257,2932,-
chr4,173334360,1.4962516491435487,1158,893,2051,-
chr4,182915548,2.1447392787532085,541,464,1005,-
chr4,184628570,2.1899745114698392,715,534,1249,-
chr4,184628581,1.6600790513833992,599,459,1058,-
chr4,184628597,1.9259185211669643,732,491,1223,-
chr4,185190259,3.2427331153353123,854,554,1408,-
chr5,205652,1.335063434846824,694,555,1249,-
chr5,205656,2.599791883454735,1040,774,1814,-
chr5,205657,2.599791883454735,1040,774,1814,-
chr5,205658,2.599791883454735,1040,774,1814,-
chr5,205839,2.376541836000922,609,473,1082,-
chr5,471908,2.2909777033299106,607,464,1071,-
chr5,1051113,0.9491627824375782,671,529,1200,-
chr5,1317982,0.5074642244958496,1448,1169,2617,-
chr5,1318038,1.7926693128256013,704,555,1259,-
chr5,1318039,0.5674267048148685,1098,1112,2210,-
chr5,1318045,6.772984997064271,5202,4441,9643,-
chr5,1318046,6.77298499706427,5202,4441,9643,-
chr5,1318047,6.77298499706427,5202,4441,9643,-
chr5,1318066,5.611748735729866,1574,998,2572,-
chr5,1318297,1.568523753077414,1127,996,2123,-
chr5,1318324,0.43934760448521926,861,653,1514,-
chr5,1318337,2.0107903178769324,787,507,1294,-
chr5,1318368,2.005055611729019,660,386,1046,-
chr5,1318439,0.4611111111111112,663,479,1142,-
chr5,1320630,2.1622763949854824,968,844,1812,-
chr5,1320642,1.7751540041067762,545,486,1031,-
chr5,1325790,2.219827586206897,1029,608,1637,-
chr5,1331872,1.584205396784769,4732,3234,7966,-
chr5,1331873,1.584205396784769,4732,3234,7966,-
chr5,1331874,1.584205396784769,4732,3234,7966,-
chr5,1334304,1.7096774193548385,1550,1022,2572,-
chr5,1334369,1.5652408089869907,1671,1360,3031,-
chr5,1334372,1.8158881424777378,2582,2075,4657,-
chr5,1334373,1.7540653747384096,3406,2609,6015,-
chr5,1334374,1.8158881424777378,2582,2075,4657,-
chr5,1334377,2.5935406434480743,1459,971,2430,-
chr5,1335076,1.6483588621444203,728,456,1184,-
chr5,1335091,0.6902086677367576,619,433,1052,-
chr5,1335117,1.9525280898876405,661,355,1016,-
chr5,1335122,2.35562015503876,662,343,1005,-
chr5,1335128,2.713005478145071,905,541,1446,-
chr5,1335170,1.9277989821882955,550,523,1073,-
chr5,1335172,1.9277989821882955,550,523,1073,-
chr5,1338914,1.8073188946975356,1231,720,1951,-
chr5,1338916,1.8073188946975356,1231,720,1951,-
chr5,1338969,4.20570317740339,910,627,1537,-
chr5,1341704,1.7022724736861683,1236,1168,2404,-
chr5,1341705,1.648758504714359,3936,3355,7291,-
chr5,1341706,1.6224340558892658,2700,2187,4887,-
chr5,1341707,1.6224340558892658,2700,2187,4887,-
chr5,1341721,1.7825322839459006,728,568,1296,-
chr5,1341725,1.5656609696546913,664,487,1151,-
chr5,1344389,1.6768205616373155,812,572,1384,-
chr5,1344407,1.8503694581280792,600,405,1005,-
chr5,1461488,7.72174449297968,488,567,1055,-
chr5,1461991,1.7384057977034375,691,497,1188,-
chr5,1463527,1.4431372549019608,735,458,1193,-
chr5,1463528,1.5603762075290024,899,585,1484,-
chr5,1463529,1.4431372549019608,735,458,1193,-
chr5,1798609,0.550250593510947,595,445,1040,-
chr5,1798718,1.863676692396416,976,577,1553,-
chr5,1798755,1.9824136065088567,955,786,1741,-
chr5,1798779,2.2504252504252507,881,480,1361,-
chr5,1798887,1.4965644858342475,2904,2155,5059,-
chr5,1798922,1.7731676003734826,1474,951,2425,-
chr5,1798924,1.8794322254233715,2105,1329,3434,-
chr5,1798925,1.6484780057344048,1320,810,2130,-
chr5,6372118,2.850853889943074,625,526,1151,-
chr5,6372119,2.850853889943074,625,526,1151,-
chr5,6374388,0.3091060745513116,976,655,1631,-
chr5,6374390,1.862225506756757,568,591,1159,-
chr5,6374394,2.0038910505836576,514,513,1027,-
chr5,6374406,1.5597200418628991,1254,881,2135,-
chr5,6374407,1.5597200418628991,1254,881,2135,-
chr5,6374408,1.6848214285714285,628,559,1187,-
chr5,6374409,1.6848214285714285,628,559,1187,-
chr5,6377239,0.9185365853658536,806,614,1420,-
chr5,6377241,0.9185365853658536,806,614,1420,-
chr5,6599809,0.6366128540968625,835,669,1504,-
chr5,6599827,1.9712918660287082,617,527,1144,-
chr5,6599853,2.0810439397765466,1214,907,2121,-
chr5,6599855,1.8470505896135387,1133,888,2021,-
chr5,6599900,1.0308315020061234,632,413,1045,-
chr5,6600085,1.7607267633619295,3396,2428,5824,-
chr5,6600086,1.7793182570042485,4081,2970,7051,-
chr5,6600105,1.6943166641935006,691,585,1276,-
chr5,6600185,2.522974812797821,592,451,1043,-
chr5,6602478,1.777219873150106,806,472,1278,-
chr5,6604220,2.310260499734184,775,494,1269,-
chr5,6604652,2.0989518764792066,581,466,1047,-
chr5,6607217,1.8967920272241758,1728,1232,2960,-
chr5,6607259,1.380712284980501,1693,1224,2917,-
chr5,6607309,0.6675341574495771,645,492,1137,-
chr5,6609854,1.7139955999323069,843,621,1464,-
chr5,6609920,2.2529880478087647,1286,1003,2289,-
chr5,6609921,2.2529880478087647,1286,1003,2289,-
chr5,6610970,1.2103416915093528,1209,863,2072,-
chr5,6611084,0.23948495216242235,866,610,1476,-
chr5,6611769,1.8271531100478469,610,439,1049,-
chr5,6616744,0.5600821662471194,1259,978,2237,-
chr5,6616795,1.0052530334418468,1293,871,2164,-
chr5,6616796,1.3023195188371925,1899,1318,3217,-
chr5,6616845,1.9854154389710295,965,702,1667,-
chr5,6620126,0.531638198757764,912,643,1555,-
chr5,6620153,1.7722100656455144,622,456,1078,-
chr5,6620201,3.2196605426571105,729,537,1266,-
chr5,6620205,2.233658159807799,815,432,1247,-
chr5,6625616,1.6141011854164853,2060,1499,3559,-
chr5,6625627,1.6749272124043604,852,546,1398,-
chr5,6632656,1.1442307692307692,1070,623,1693,-
chr5,6632658,1.1442307692307692,1070,623,1693,-
chr5,6632748,7.72491633564371,2750,1810,4560,-
chr5,6632899,2.084504398690012,2348,1230,3578,-
chr5,6632900,1.9365152264011212,1472,631,2103,-
chr5,6632901,2.054140975225667,1852,1045,2897,-
chr5,10279423,1.8470121861694322,1257,972,2229,-
chr5,10279487,2.0969419596421885,629,436,1065,-
chr5,10279648,3.7086092715231787,615,452,1067,-
chr5,10279681,0.6059328563090697,1407,951,2358,-
chr5,10279918,1.9212268106407269,1814,1235,3049,-
chr5,10280046,1.8520851063829784,805,469,1274,-
chr5,10280049,4.015255530129672,657,436,1093,-
chr5,10280067,1.3063291139240507,644,394,1038,-
chr5,10280080,0.47441894679082564,772,599,1371,-
chr5,10280109,0.45393995881801535,722,515,1237,-
chr5,10280450,1.637137330754352,1287,769,2056,-
chr5,10280463,1.7161919867595337,1058,852,1910,-
chr5,10280468,2.8584241669261914,1042,844,1886,-
chr5,10286381,1.6002084806930386,2538,1799,4337,-
chr5,10286478,1.4802631578947367,974,740,1714,-
chr5,10288466,2.168946771854,4363,3383,7746,-
chr5,10288508,1.9812390940783944,2505,1682,4187,-
chr5,10288528,1.7179136063737086,919,553,1472,-
chr5,10290581,1.6119498362489018,1008,641,1649,-
chr5,10290590,1.6237452948557092,985,796,1781,-
chr5,10290766,1.123223596791821,1430,1073,2503,-
chr5,10290772,0.9608840309902704,1843,1339,3182,-
chr5,10290773,0.6543022678984266,1704,1318,3022,-
chr5,10290775,0.9943817591231018,1962,1494,3456,-
chr5,10290776,0.9507680399193328,1336,1067,2403,-
chr5,10307651,3.9458810983737678,778,340,1118,-
chr5,10307653,3.9458810983737678,778,340,1118,-
chr5,10307837,1.600298058631392,687,483,1170,-
chr5,10679626,2.0216901984857785,759,542,1301,-
chr5,10679627,2.0216901984857785,759,542,1301,-
chr5,10680509,1.0860576923076923,752,415,1167,-
chr5,10680510,1.0860576923076923,752,415,1167,-
chr5,10680796,2.1239922385779493,1165,804,1969,-
chr5,10680806,2.224883983444124,656,468,1124,-
chr5,10748211,5.548998178506375,475,548,1023,-
chr5,14639515,0.6664489311163895,773,420,1193,-
chr5,14639518,0.7423601811621582,1920,1164,3084,-
chr5,14639519,0.773199870842751,1227,651,1878,-
chr5,14639521,1.1389284545170018,1400,820,2220,-
chr5,14710697,3.508410699743157,594,426,1020,-
chr5,14713647,4.33538557580287,592,413,1005,-
chr5,16451621,2.834224598930481,1695,1495,3190,-
chr5,16451628,1.1943787269257637,4445,2995,7440,-
chr5,16451663,1.6048402417631593,7140,4233,11373,-
chr5,16451664,1.639811040420453,9390,5456,14846,-
chr5,16451666,1.5884179697442202,4790,2644,7434,-
chr5,16451687,1.6926713947990544,715,422,1137,-
chr5,16451731,0.4830882352941177,656,359,1015,-
chr5,16451736,0.34975198412698416,640,447,1087,-
chr5,16451737,0.34975198412698416,640,447,1087,-
chr5,16451753,1.084396872365441,674,457,1131,-
chr5,16453117,0.6317965936132247,6446,3539,9985,-
chr5,16453118,1.629343029577765,3273,2380,5653,-
chr5,16453119,1.629343029577765,3273,2380,5653,-
chr5,16453120,0.5610389610389611,1031,601,1632,-
chr5,16453122,1.8154535723842653,1458,1009,2467,-
chr5,16453123,0.6560642264316469,3201,1723,4924,-
chr5,16453125,0.8777376515854344,7243,4138,11381,-
chr5,16453126,1.422323481815859,1236,795,2031,-
chr5,16453127,1.0467820910243766,4042,2415,6457,-
chr5,16453128,0.582723970373166,771,516,1287,-
chr5,16453129,1.5087011349306432,996,609,1605,-
chr5,16453132,0.6907244702520293,1419,888,2307,-
chr5,16453144,1.4747793513957306,1222,811,2033,-
chr5,16453145,1.8463023161316536,726,427,1153,-
chr5,16453148,1.7428571428571427,853,489,1342,-
chr5,16463695,2.9772924111136674,553,455,1008,-
chr5,16666075,6.670066613903179,630,453,1083,-
chr5,16701009,2.7079718056072046,727,335,1062,-
chr5,17354305,1.9370300751879697,686,531,1217,-
chr5,17354306,0.7353551781516551,4552,2942,7494,-
chr5,17354307,0.5967383500991891,3905,2573,6478,-
chr5,17354308,0.6425564485265977,1678,1540,3218,-
chr5,17354312,0.6377190895392181,945,466,1411,-
chr5,31401558,1.5836568537921034,619,589,1208,-
chr5,31421332,1.4251599147121536,1670,979,2649,-
chr5,31421338,2.566202722149597,4535,3138,7673,-
chr5,31421339,2.566202722149597,4535,3138,7673,-
chr5,31421340,2.566202722149597,4535,3138,7673,-
chr5,31421345,1.9054098360655736,1378,853,2231,-
chr5,31421358,1.80078431372549,1147,679,1826,-
chr5,31422833,1.7890295358649788,847,473,1320,-
chr5,31422932,0.43544223309204233,790,608,1398,-
chr5,31437297,2.868692672287683,605,420,1025,-
chr5,31464332,2.1061788362634077,616,485,1101,-
chr5,31466276,1.9445659728884965,627,474,1101,-
chr5,31466278,1.9445659728884965,627,474,1101,-
chr5,31515082,1.4561718925310274,626,440,1066,-
chr5,31526109,2.259548872180451,1365,874,2239,-
chr5,31526113,1.8841395341138,3807,2770,6577,-
chr5,31526115,2.0201782798163066,3700,2805,6505,-
chr5,31526116,2.052454465949276,2398,1767,4165,-
chr5,31526130,0.6699051378366333,922,694,1616,-
chr5,31526133,2.265768958185684,694,414,1108,-
chr5,31526138,1.8011015911872705,653,515,1168,-
chr5,31526150,2.126969124133585,941,528,1469,-
chr5,31526152,2.204970316238036,1880,1100,2980,-
chr5,31526153,1.9707011140899486,1367,857,2224,-
chr5,31526157,1.4987068965517245,1158,579,1737,-
chr5,31526158,1.4987068965517245,1158,579,1737,-
chr5,31526159,1.4987068965517245,1158,579,1737,-
chr5,31526255,3.9277502356008505,745,488,1233,-
chr5,31526344,0.3265913549152383,587,456,1043,-
chr5,32125187,1.7659883720930232,809,515,1324,-
chr5,32125483,0.611762610869867,1053,867,1920,-
chr5,32125683,2.400669642857143,716,559,1275,-
chr5,32125856,2.4474448348131204,1309,930,2239,-
chr5,32126198,2.074188908753512,767,539,1306,-
chr5,32126358,3.8639387220318486,660,450,1110,-
chr5,32126359,3.8639387220318486,660,450,1110,-
chr5,32135684,2.0104529589835463,1237,828,2065,-
chr5,32230030,2.0556926710141443,1492,1079,2571,-
chr5,32230031,2.1592920353982303,839,677,1516,-
chr5,32355741,2.714158019168593,678,519,1197,-
chr5,32385606,1.2675021573965337,736,544,1280,-
chr5,32390295,5.690045411894565,627,420,1047,-
chr5,32395289,1.7140421152088723,1134,871,2005,-
chr5,32395295,2.4622173193601764,1115,776,1891,-
chr5,32395296,2.4622173193601764,1115,776,1891,-
chr5,32397258,2.0840670389424423,1138,882,2020,-
chr5,32400143,3.7063032009924877,689,497,1186,-
chr5,34913493,0.3688801860621401,738,554,1292,-
chr5,34914730,1.344049762681761,2735,1961,4696,-
chr5,36201136,2.5786640487957557,605,428,1033,-
chr5,37299539,2.2045800132756654,759,528,1287,-
chr5,37302846,1.8987241549469531,571,479,1050,-
chr5,38481161,1.0196627591924248,856,545,1401,-
chr5,38481163,1.42994362512068,730,486,1216,-
chr5,38482644,1.3755395683453238,716,416,1132,-
chr5,38938620,1.789419098401742,1109,910,2019,-
chr5,38939571,3.2609168930077437,750,436,1186,-
chr5,39372664,2.2428238515982493,1606,1246,2852,-
chr5,39372666,2.0930966898954706,1226,860,2086,-
chr5,39372871,1.6727921329131112,694,582,1276,-
chr5,39373360,1.6900200171575637,590,537,1127,-
chr5,39373393,0.7304432222581688,1703,1404,3107,-
chr5,39373394,1.2079371019577636,2198,1821,4019,-
chr5,39373395,0.7304432222581688,1703,1404,3107,-
chr5,39376061,1.3932210504425755,1870,1262,3132,-
chr5,39376702,1.5601639739570772,646,637,1283,-
chr5,39376705,2.039128595600677,621,590,1211,-
chr5,39376727,2.3141242937853104,575,530,1105,-
chr5,39376905,1.5699026738569017,773,554,1327,-
chr5,39381592,2.355457290218131,790,661,1451,-
chr5,39382809,2.499265785609398,850,680,1530,-
chr5,39382811,2.499265785609398,850,680,1530,-
chr5,39383049,1.5581790629095675,1950,1525,3475,-
chr5,39383088,0.5796490413749532,4086,2780,6866,-
chr5,39383089,0.5796490413749532,4086,2780,6866,-
chr5,39383090,0.5796490413749532,4086,2780,6866,-
chr5,39389914,2.0017793594306053,699,561,1260,-
chr5,39389917,1.8024665981500516,947,694,1641,-
chr5,39389918,2.6532258064516134,657,495,1152,-
chr5,39390458,1.6161508864869074,2492,1822,4314,-
chr5,39390459,1.0354285952671485,1359,1030,2389,-
chr5,39390460,2.336849875434442,1133,792,1925,-
chr5,39390485,1.2844766672940247,1158,779,1937,-
chr5,39392386,1.9995556872037916,586,421,1007,-
chr5,39394257,4.2174048499730885,761,682,1443,-
chr5,39394260,3.3682968682968677,765,665,1430,-
chr5,39394261,3.0091047765283894,1133,903,2036,-
chr5,39394399,3.0570330996718567,884,609,1493,-
chr5,40746841,2.114641529866358,1431,990,2421,-
chr5,40746843,2.114641529866358,1431,990,2421,-
chr5,40746862,2.0816326530612246,935,636,1571,-
chr5,40746879,3.2970475999196625,683,382,1065,-
chr5,40760411,3.6639948144548335,585,484,1069,-
chr5,40763020,1.8942080378250588,640,469,1109,-
chr5,40764566,2.469686932138911,1537,1181,2718,-
chr5,40764567,1.989217960966289,1099,861,1960,-
chr5,40798163,3.877507096654102,818,284,1102,-
chr5,40825522,1.7624471200780996,676,438,1114,-
chr5,40826680,0.5836584532938583,1733,1375,3108,-
chr5,40826687,1.4985576923076924,1038,831,1869,-
chr5,40826797,1.6356368804405756,593,432,1025,-
chr5,40826853,1.8645276310237844,806,650,1456,-
chr5,40827092,1.5741364096865906,982,826,1808,-
chr5,40827105,1.862351429489239,772,565,1337,-
chr5,40827172,1.5398121464403889,1418,1040,2458,-
chr5,40827537,3.0664272890484736,731,556,1287,-
chr5,40827660,2.5021647661442774,1108,712,1820,-
chr5,40827695,1.6345015930814748,797,675,1472,-
chr5,40827700,1.9292219204345742,689,568,1257,-
chr5,40827737,1.7539202888317593,1695,1240,2935,-
chr5,40827739,1.3419441090219075,840,681,1521,-
chr5,40827740,1.348369119496364,702,553,1255,-
chr5,40832574,1.1113896203626283,697,588,1285,-
chr5,40834201,1.1781070375165499,41559,27163,68722,-
chr5,40834245,0.9005624278394012,28188,21409,49597,-
chr5,40834262,1.136113934651366,88598,62012,150610,-
chr5,40834264,0.9237755966511426,40517,31759,72276,-
chr5,40834520,1.2683167878786894,40726,32849,73575,-
chr5,40834536,1.501684912108133,19897,16846,36743,-
chr5,40834569,1.1345889030007872,42598,30316,72914,-
chr5,40834572,0.9665675628684909,68100,53975,122075,-
chr5,40834573,1.015743331248175,37302,28448,65750,-
chr5,40835191,0.8954163399557485,47713,38574,86287,-
chr5,40835192,0.9492045156415962,33587,30107,63694,-
chr5,40835194,0.9750547535966974,18054,15487,33541,-
chr5,40835203,0.8157846700187517,3686,3410,7096,-
chr5,40835206,0.7831058299918123,5238,5013,10251,-
chr5,40835208,0.7809111715062222,7214,6990,14204,-
chr5,40835210,0.7642172222586784,4418,4353,8771,-
chr5,40835211,0.9210012638316308,13633,10394,24027,-
chr5,40835213,1.0322963267822043,19125,15383,34508,-
chr5,40835214,1.0046983211793574,10084,7976,18060,-
chr5,40835225,1.6430103333983233,635,445,1080,-
chr5,40835237,0.5968645839185501,2610,1845,4455,-
chr5,40835239,0.760772047925636,2765,2050,4815,-
chr5,40835240,1.0160542916749828,888,752,1640,-
chr5,41739416,1.4736098527220154,817,698,1515,-
chr5,41739468,2.0942524173707198,840,521,1361,-
chr5,41762148,2.0843351423869705,996,669,1665,-
chr5,41762149,2.0669056152927117,864,557,1421,-
chr5,41762166,3.082414807610303,648,443,1091,-
chr5,41762196,1.5961738246141735,660,527,1187,-
chr5,41861372,1.1678359619747554,577,456,1033,-
chr5,41862687,2.1322078230888124,853,646,1499,-
chr5,41862688,2.231717531294467,1162,893,2055,-
chr5,41862740,1.4470593083137553,765,579,1344,-
chr5,42465513,2.110809588421529,1076,736,1812,-
chr5,42465519,1.5673076923076925,977,639,1616,-
chr5,42465522,1.9272671541796207,862,556,1418,-
chr5,43289603,1.4916308892443246,6858,3393,10251,-
chr5,43289604,1.4916308892443246,6858,3393,10251,-
chr5,43289605,1.4916308892443246,6858,3393,10251,-
chr5,43289615,1.776308860480162,5902,4636,10538,-
chr5,43289616,1.776308860480162,5902,4636,10538,-
chr5,43290008,0.5857619914996964,680,548,1228,-
chr5,43290070,5.169480257127694,577,514,1091,-
chr5,43290304,2.30830164765526,704,525,1229,-
chr5,43290306,2.30830164765526,704,525,1229,-
chr5,43290605,2.7025307302964574,583,460,1043,-
chr5,43290952,1.7835760046592897,527,504,1031,-
chr5,43291061,0.3382142634954597,2126,3925,6051,-
chr5,43291062,0.34960238767373775,1816,3163,4979,-
chr5,43291063,0.34960238767373775,1816,3163,4979,-
chr5,43291072,10.06234478193245,1629,2702,4331,-
chr5,43291073,9.404573472626584,1442,2456,3898,-
chr5,43291078,7.827303952479629,1243,1135,2378,-
chr5,43291079,9.81368455661626,2559,2009,4568,-
chr5,43291080,9.81368455661626,2559,2009,4568,-
chr5,43291081,12.022578821632568,1566,1076,2642,-
chr5,43291085,99.69908709762525,1542,146,1688,-
chr5,43291086,126.77888068891089,1804,161,1965,-
chr5,43291087,148.98333333333332,1276,99,1375,-
chr5,43291088,64.32203389830508,1034,58,1092,-
chr5,43292520,2.067976847489568,568,436,1004,-
chr5,43292558,1.9713665943600869,567,460,1027,-
chr5,43292581,3.0643420750607686,790,676,1466,-
chr5,43292611,1.9807477506999336,821,697,1518,-
chr5,43292959,1.6615692821368948,753,598,1351,-
chr5,43297024,1.6224781507800372,763,582,1345,-
chr5,43297084,1.681195516811955,629,510,1139,-
chr5,43298097,0.4911340479026069,570,457,1027,-
chr5,43298548,4.447486001685345,994,673,1667,-
chr5,43298646,0.8456349594290742,1037,578,1615,-
chr5,43298647,0.7138702887718206,1952,1144,3096,-
chr5,43298828,0.9857038790748496,865,577,1442,-
chr5,43298829,0.9857038790748496,865,577,1442,-
chr5,43298853,1.7155691160267823,697,512,1209,-
chr5,43445552,3.306291735179477,715,481,1196,-
chr5,43445553,3.2214111922141115,661,410,1071,-
chr5,43527239,1.7787644058190064,1344,947,2291,-
chr5,43527241,1.7787644058190064,1344,947,2291,-
chr5,43527262,1.3556306056858005,727,428,1155,-
chr5,43534939,2.4135338345864663,855,503,1358,-
chr5,43534943,2.4659863945578238,782,440,1222,-
chr5,43534967,1.4876736024740977,1440,945,2385,-
chr5,43538997,0.42775824832162984,1027,776,1803,-
chr5,43538999,0.4757769652650822,693,546,1239,-
chr5,43547803,2.0641986879100283,880,678,1558,-
chr5,43555864,0.5765235824059354,945,739,1684,-
chr5,43555894,1.5173121482952665,1117,794,1911,-
chr5,43555896,1.8455718736092568,637,427,1064,-
chr5,43555904,1.8931710615280597,874,509,1383,-
chr5,43555957,1.0405762304921968,787,594,1381,-
chr5,43555958,1.0405762304921968,787,594,1381,-
chr5,43556848,6.675031688794296,1039,768,1807,-
chr5,43556850,6.436489375296536,712,494,1206,-
chr5,43575348,3.4708189871186805,1049,797,1846,-
chr5,43575350,3.4708189871186805,1049,797,1846,-
chr5,53107176,1.4610312095511138,961,695,1656,-
chr5,53107177,0.7607305936073059,685,510,1195,-
chr5,53108569,1.5952706477390088,1033,723,1756,-
chr5,53108571,1.5325627157688224,964,739,1703,-
chr5,55839021,2.168690783133197,613,507,1120,-
chr5,56504910,1.1364664959030342,10770,7397,18167,-
chr5,56504913,1.0799425505093858,57906,43258,101164,-
chr5,56504914,1.115927931808546,71637,56791,128428,-
chr5,56504915,1.082219239532755,77736,57140,134876,-
chr5,56504916,1.0687728416841573,80677,61802,142479,-
chr5,56504917,1.3855681631801036,10286,9008,19294,-
chr5,56504918,1.0881806783087555,18598,12522,31120,-
chr5,56504919,1.0584110555050046,18305,13187,31492,-
chr5,56504920,0.9323856098314635,52409,37539,89948,-
chr5,56504921,0.9564233721739145,53307,39387,92694,-
chr5,56504922,0.8728519994321482,31787,22094,53881,-
chr5,56504923,1.1448504812014562,13221,10769,23990,-
chr5,56504924,1.236307790065279,9420,7677,17097,-
chr5,56504925,1.236307790065279,9420,7677,17097,-
chr5,56504931,0.9940696671402476,5282,3743,9025,-
chr5,56504932,0.9940696671402476,5282,3743,9025,-
chr5,56504934,1.0297661604114188,2340,2168,4508,-
chr5,56504935,1.2085609324511462,1380,1071,2451,-
chr5,56504936,0.9668523317916925,2978,2720,5698,-
chr5,56504938,0.9734983486383969,6449,5086,11535,-
chr5,56504939,1.1798177730281223,4679,3511,8190,-
chr5,56504941,1.6392395176691712,1195,796,1991,-
chr5,56504955,1.5850409836065569,636,487,1123,-
chr5,56504966,0.9960585001555856,872,621,1493,-
chr5,56504967,0.9960585001555856,872,621,1493,-
chr5,58457006,0.6176134934331043,603,448,1051,-
chr5,59185255,2.3836490661407,653,403,1056,-
chr5,59185260,1.7171085686292311,695,404,1099,-
chr5,61159073,2.214814814814815,597,413,1010,-
chr5,61159239,2.625,623,511,1134,-
chr5,61159241,2.625,623,511,1134,-
chr5,61161215,1.5062673394094954,847,607,1454,-
chr5,62403307,0.8003727446300732,667,494,1161,-
chr5,65542846,0.384144554937029,684,492,1176,-
chr5,65551616,3.7753081007876257,813,597,1410,-
chr5,65561474,1.0707771355170201,520,518,1038,-
chr5,65561475,1.0707771355170201,520,518,1038,-
chr5,68159414,1.0297142857142858,1427,874,2301,-
chr5,68159416,1.2153304794414466,2064,1270,3334,-
chr5,68159417,1.1994014020280606,1512,1025,2537,-
chr5,69352163,2.0212736565824008,1828,1396,3224,-
chr5,69352165,1.8836433474836558,3405,2543,5948,-
chr5,69352166,1.6403716216216218,1742,1294,3036,-
chr5,69365035,2.814663951120163,690,490,1180,-
chr5,69365161,2.307443365695793,712,617,1329,-
chr5,69365173,1.6931137724550895,782,500,1282,-
chr5,69365553,1.6937669376693767,1124,737,1861,-
chr5,69365649,1.7837493881546744,958,680,1638,-
chr5,69365650,2.0863636363636364,560,483,1043,-
chr5,69365684,3.4597386238387657,1771,1094,2865,-
chr5,69365685,3.4597386238387657,1771,1094,2865,-
chr5,69365751,2.253668763102725,773,476,1249,-
chr5,69366561,1.0975631525669811,4073,2654,6727,-
chr5,69366562,0.9088015579108673,3060,1909,4969,-
chr5,69366570,1.8931860036832415,770,542,1312,-
chr5,69366574,2.7986559139784943,717,495,1212,-
chr5,69366576,1.828616663368296,839,488,1327,-
chr5,69366579,0.6653419440304686,783,548,1331,-
chr5,69366584,0.5414414414414415,600,443,1043,-
chr5,71055383,1.3915857605177993,773,514,1287,-
chr5,72219696,2.4166666666666665,715,536,1251,-
chr5,72219704,2.0741428259445294,654,481,1135,-
chr5,72219719,2.86281179138322,605,440,1045,-
chr5,72220023,2.090752808552909,781,575,1356,-
chr5,72220095,2.4361948955916475,629,430,1059,-
chr5,72220097,2.4169898137297454,1024,731,1755,-
chr5,72220797,2.456793184048982,681,453,1134,-
chr5,72223740,1.0836792893411107,769,538,1307,-
chr5,72232544,2.6157064692629546,601,477,1078,-
chr5,72232546,2.6157064692629546,601,477,1078,-
chr5,72238056,0.5218382939901928,703,473,1176,-
chr5,72297676,0.7930047222763413,2400,1890,4290,-
chr5,72297678,0.6670337604926375,4306,3304,7610,-
chr5,72297679,0.6349048737967106,2042,1669,3711,-
chr5,72297680,1.6437442020528474,930,710,1640,-
chr5,72297681,0.524823688758115,660,548,1208,-
chr5,72297684,0.46527285613040403,1312,1189,2501,-
chr5,72297686,0.46527285613040403,1312,1189,2501,-
chr5,72297687,1.6753274186734262,720,525,1245,-
chr5,72297689,0.5468809073724008,525,528,1053,-
chr5,73555503,1.8786105425615944,1195,974,2169,-
chr5,73555504,1.910185623256776,1658,1343,3001,-
chr5,73555506,2.5364189289422936,1235,962,2197,-
chr5,73555508,2.49537750385208,789,589,1378,-
chr5,73565483,3.2787539936102235,820,625,1445,-
chr5,73565485,3.2787539936102235,820,625,1445,-
chr5,73565491,1.898567398172926,689,460,1149,-
chr5,74722511,1.093519882179676,659,387,1046,-
chr5,74722513,1.3085016252311006,889,579,1468,-
chr5,74760920,1.3123423352449701,967,657,1624,-
chr5,74760922,0.9690766550522647,711,447,1158,-
chr5,76173622,1.8664320276326172,784,533,1317,-
chr5,76174134,0.9098377922898674,616,403,1019,-
chr5,77691386,1.7839512267364368,1224,861,2085,-
chr5,77693277,1.5887540960747402,1822,1365,3187,-
chr5,77776228,1.478432945870923,1933,1440,3373,-
chr5,77776229,1.2088924591076748,2863,2080,4943,-
chr5,77776248,4.411764705882354,1099,747,1846,-
chr5,77776258,1.880184331797235,577,433,1010,-
chr5,77776271,1.7054574638844302,1124,622,1746,-
chr5,77776302,2.507976071784646,773,471,1244,-
chr5,77776310,2.0451965524490223,1042,566,1608,-
chr5,77776333,2.909015813075289,746,445,1191,-
chr5,77776335,0.9356551608744009,1098,638,1736,-
chr5,77776336,0.8997947685143229,1142,601,1743,-
chr5,78113788,0.6458464343357757,589,532,1121,-
chr5,78113790,0.6458464343357757,589,532,1121,-
chr5,82276130,2.005019364044028,9257,7358,16615,-
chr5,82276131,1.4869496795028114,17172,13224,30396,-
chr5,82276139,1.3008204406938584,5259,3791,9050,-
chr5,82276140,1.5570256876504638,7886,5577,13463,-
chr5,82276142,1.4637240318185483,12686,8964,21650,-
chr5,82276151,1.3827089170686615,3988,2662,6650,-
chr5,82276169,1.6773676759146567,3404,2118,5522,-
chr5,82276443,1.2965099085515857,25954,18062,44016,-
chr5,82276447,1.7540027420816584,10063,7483,17546,-
chr5,82276455,1.1667481255538839,49475,33588,83063,-
chr5,82276456,1.2280561048619736,48384,33162,81546,-
chr5,82276461,1.346317914026367,25146,17131,42277,-
chr5,82276475,1.234541141172011,7216,3927,11143,-
chr5,82277814,1.3624598146523554,41803,30517,72320,-
chr5,82277821,1.4114166319525308,7943,6285,14228,-
chr5,82277825,1.2138869896462066,34379,23702,58081,-
chr5,82277831,1.340231398587376,13611,9790,23401,-
chr5,82277834,1.1900726824235748,6365,4704,11069,-
chr5,82277841,1.3371992631860172,4952,3742,8694,-
chr5,82277849,1.2271333549924122,11277,6893,18170,-
chr5,82277852,0.8165795968251196,743,618,1361,-
chr5,82278342,1.2489109545886692,5730,2961,8691,-
chr5,82278344,1.4855821025708695,6334,4324,10658,-
chr5,82278347,1.6307153887264767,4832,2346,7178,-
chr5,82278349,1.3057763645998939,3717,2515,6232,-
chr5,82278350,0.9553559388525983,24961,14349,39310,-
chr5,82278351,0.9318444689209516,24932,13946,38878,-
chr5,82278352,0.9262262213540359,20374,10872,31246,-
chr5,82278353,0.8711103061236467,19695,10530,30225,-
chr5,82278354,0.9134400646782892,11046,5830,16876,-
chr5,82278355,0.9296374363847976,11088,6277,17365,-
chr5,82278356,0.8725306032998341,1603,1013,2616,-
chr5,82278360,2.443018038360264,780,491,1271,-
chr5,82278382,0.6895652706857164,617,419,1036,-
chr5,83054187,1.081773325156589,589,413,1002,-
chr5,83055105,0.529485834207765,956,952,1908,-
chr5,83055106,1.6248275862068966,805,724,1529,-
chr5,83055142,1.982517865687426,897,712,1609,-
chr5,83055160,1.9872680252645711,732,619,1351,-
chr5,83056794,1.5543713399253922,1682,1209,2891,-
chr5,83056960,1.841201716738197,626,465,1091,-
chr5,83057046,2.1497755728797543,1399,995,2394,-
chr5,83057120,1.8769613947696135,569,453,1022,-
chr5,83065103,2.5103134479272,670,429,1099,-
chr5,83065105,2.5103134479272,670,429,1099,-
chr5,83065112,0.44308503447343517,689,568,1257,-
chr5,83940933,1.298705081662282,2252,1679,3931,-
chr5,83941053,1.950075918615244,1395,889,2284,-
chr5,83941098,1.9701960784313726,627,449,1076,-
chr5,83941196,1.852060707323865,718,531,1249,-
chr5,83941556,1.1283198539050636,2404,1607,4011,-
chr5,83942000,1.6295264623955432,974,717,1691,-
chr5,83942146,0.6488407188914803,1390,984,2374,-
chr5,83942284,2.314647377938517,759,552,1311,-
chr5,83942356,1.791005291005291,676,503,1179,-
chr5,83942420,2.270443251941303,1833,1246,3079,-
chr5,83942483,1.8140522875816996,853,679,1532,-
chr5,83943308,2.4135643772838082,1131,820,1951,-
chr5,83943406,2.485630734290942,2082,1583,3665,-
chr5,83943407,2.8869034406215315,702,529,1231,-
chr5,83943408,2.100508905852417,761,654,1415,-
chr5,83943529,1.8554578836096585,574,472,1046,-
chr5,83943534,2.9037710555458416,1059,816,1875,-
chr5,83943535,2.9037710555458416,1059,816,1875,-
chr5,83963249,3.1597845601436267,714,556,1270,-
chr5,83963338,0.4477225672877847,864,551,1415,-
chr5,83963348,1.507023258181078,1038,801,1839,-
chr5,83963351,1.482007429190528,750,496,1246,-
chr5,84060311,1.8373101952277653,604,460,1064,-
chr5,84064784,1.0297969000534477,2568,1870,4438,-
chr5,84064786,1.0297969000534477,2568,1870,4438,-
chr5,84064826,2.1053087263613577,982,626,1608,-
chr5,84106693,2.0438138347260906,858,717,1575,-
chr5,84106788,2.7696741854636593,770,629,1399,-
chr5,84106799,1.7605266144591991,1107,800,1907,-
chr5,84137253,2.3362676056338025,1326,851,2177,-
chr5,84137322,1.5388739946380698,1259,745,2004,-
chr5,84137346,2.5714285714285707,591,517,1108,-
chr5,84137347,2.0296446551639864,1456,997,2453,-
chr5,84137349,2.0296446551639864,1456,997,2453,-
chr5,84180431,0.4928389841173954,978,696,1674,-
chr5,84180432,1.968842105263158,667,499,1166,-
chr5,84254175,2.0999410956214413,712,462,1174,-
chr5,84384318,1.109407335692986,967,611,1578,-
chr5,84384375,0.8994669509594883,766,535,1301,-
chr5,84384376,0.8994669509594883,766,535,1301,-
chr5,86884601,0.918863847639186,4314,3780,8094,-
chr5,86884602,0.7275443186461438,5596,4200,9796,-
chr5,86884605,0.7129217367117284,2326,1960,4286,-
chr5,86884606,0.923195084485407,1201,1294,2495,-
chr5,86884607,0.7151029276570154,5326,4688,10014,-
chr5,86884609,0.7616327946787006,1970,2039,4009,-
chr5,86884610,1.0359116527524181,2620,2227,4847,-
chr5,86884611,0.939339666130117,2199,1565,3764,-
chr5,86884613,0.9382966757747309,1474,1092,2566,-
chr5,87394481,1.6239327731092437,670,424,1094,-
chr5,87401714,2.093575256290773,1306,1072,2378,-
chr5,87401734,1.8881614008374568,1180,709,1889,-
chr5,87401762,1.907869863695154,798,436,1234,-
chr5,87404917,1.907722007722008,731,517,1248,-
chr5,87412866,0.2824534152972992,669,545,1214,-
chr5,90399526,2.4260065335252587,819,574,1393,-
chr5,91308296,2.3153759698274574,824,549,1373,-
chr5,91308756,3.2826025966807872,587,417,1004,-
chr5,91309855,2.1664233576642338,635,410,1045,-
chr5,91309857,2.1664233576642338,635,410,1045,-
chr5,93682954,1.389950981808746,16254,11540,27794,-
chr5,93682955,1.1956760297026263,5568,4116,9684,-
chr5,93682961,0.8130500343797054,8130,5838,13968,-
chr5,93682974,1.1965686400886864,8182,5086,13268,-
chr5,93682975,1.1965686400886864,8182,5086,13268,-
chr5,93682989,1.4109529402694698,2488,2022,4510,-
chr5,93683015,1.177255606549534,3872,2993,6865,-
chr5,93683016,1.525604527525296,2340,1714,4054,-
chr5,93683022,1.1911597059208083,4535,3325,7860,-
chr5,93683024,1.0274041146380146,3238,2514,5752,-
chr5,93683025,1.9842775820005425,914,650,1564,-
chr5,93683027,1.4867127633084143,4608,3399,8007,-
chr5,93683028,1.521931306103968,2646,1945,4591,-
chr5,93683033,1.502859203544382,747,412,1159,-
chr5,93683055,1.1123882503192848,870,579,1449,-
chr5,93683056,1.1123882503192848,870,579,1449,-
chr5,93683057,1.4831730769230769,616,415,1031,-
chr5,93683059,0.9724301318872339,1679,1208,2887,-
chr5,93683061,1.0778174465261758,1382,1020,2402,-
chr5,93683253,1.316818430182247,4986,3805,8791,-
chr5,93683268,1.4024246148029114,3651,2383,6034,-
chr5,93683269,1.1396972369194591,4771,3359,8130,-
chr5,93683270,1.1396972369194591,4771,3359,8130,-
chr5,93683291,1.3878400475694963,1555,1084,2639,-
chr5,93683297,0.6534222469204409,2549,1769,4318,-
chr5,93683298,0.6845145469807078,4146,2704,6850,-
chr5,93683300,1.2359504317763443,1693,1225,2918,-
chr5,93683306,0.7368371576293639,2283,1613,3896,-
chr5,93683307,0.7368371576293639,2283,1613,3896,-
chr5,93683308,1.4232878951325552,2971,1853,4824,-
chr5,93683309,1.4232878951325552,2971,1853,4824,-
chr5,93683310,1.4497200702089423,3525,2194,5719,-
chr5,93683313,1.2628020132640112,1118,678,1796,-
chr5,93683320,0.3775582814103045,723,488,1211,-
chr5,93683321,1.0585138387484958,1134,553,1687,-
chr5,93683323,1.0585138387484958,1134,553,1687,-
chr5,93683441,1.4046678635547576,1955,1113,3068,-
chr5,93683442,1.857887874837028,1424,884,2308,-
chr5,93683463,1.9568696182275396,1604,1192,2796,-
chr5,93683465,1.7281400079887783,2513,1296,3809,-
chr5,93683467,1.6382590625721545,3529,1774,5303,-
chr5,93683469,1.4951586147053568,2185,1058,3243,-
chr5,93683472,1.622746185852982,909,411,1320,-
chr5,93683475,1.6908987426915714,2279,1505,3784,-
chr5,93683477,1.7002617500719868,4078,2489,6567,-
chr5,93683479,1.6812774481130746,2153,1380,3533,-
chr5,93683480,0.5837104072398189,644,454,1098,-
chr5,93683485,1.7181889149102263,709,426,1135,-
chr5,93683489,2.726575809199318,1066,586,1652,-
chr5,93683490,2.584102333095783,1427,726,2153,-
chr5,93683499,1.865662825334923,1034,457,1491,-
chr5,93683500,1.7078109932497592,769,365,1134,-
chr5,93683710,1.7453415536374846,2390,1621,4011,-
chr5,93683711,1.6100803177558605,4028,2594,6622,-
chr5,93683714,0.5738549231793062,1802,1818,3620,-
chr5,93683715,1.7178153446033808,1320,768,2088,-
chr5,93683716,0.5738549231793062,1802,1818,3620,-
chr5,93683723,2.9920747815484656,817,517,1334,-
chr5,93683734,1.6318503070327888,1656,821,2477,-
chr5,93683735,1.6366985074708362,2328,1362,3690,-
chr5,93683737,1.4515050167224082,1735,919,2654,-
chr5,93683738,1.4515050167224082,1735,919,2654,-
chr5,93683739,1.47563652986297,2160,1386,3546,-
chr5,93683742,1.684437624130951,835,740,1575,-
chr5,93683762,1.1449357438443406,805,676,1481,-
chr5,93683764,1.2617833602785724,533,472,1005,-
chr5,95512570,2.5660158775857136,643,444,1087,-
chr5,95814118,2.3205856643356637,776,623,1399,-
chr5,95814351,0.5493497988586397,733,508,1241,-
chr5,95814357,0.5253259176195288,1227,845,2072,-
chr5,95816575,0.6526272745859742,797,583,1380,-
chr5,95822693,0.9683693700077618,1807,1524,3331,-
chr5,95886097,1.6951095746790912,879,640,1519,-
chr5,95886362,2.1065634218289087,590,451,1041,-
chr5,95886442,1.4165492739458143,1035,692,1727,-
chr5,95887645,2.1594202898550727,744,551,1295,-
chr5,95887646,2.1594202898550727,744,551,1295,-
chr5,95887866,5.555035128805621,592,426,1018,-
chr5,95887875,2.3993171416761148,846,678,1524,-
chr5,95887878,1.6972236773179676,1199,829,2028,-
chr5,95888275,1.826086956521739,698,465,1163,-
chr5,95888282,0.6690248503773094,1326,1007,2333,-
chr5,95888311,3.6864668452967,781,535,1316,-
chr5,95888612,1.4579321136254209,1274,803,2077,-
chr5,95888634,4.906380511246449,560,447,1007,-
chr5,95888976,1.2371838687628165,723,417,1140,-
chr5,95888978,1.2371838687628165,723,417,1140,-
chr5,95891269,1.1841880149010264,1592,1190,2782,-
chr5,95891272,0.6128401744098632,1018,738,1756,-
chr5,95898506,1.7486691236691236,588,443,1031,-
chr5,95898581,0.5972826086956522,784,574,1358,-
chr5,95898783,1.9600262123197905,996,653,1649,-
chr5,95900774,1.761797752808989,671,533,1204,-
chr5,95901068,0.6984412470023981,1164,833,1997,-
chr5,95906633,1.8264125635723465,816,616,1432,-
chr5,95906722,2.826630828078156,881,568,1449,-
chr5,95906723,2.826630828078156,881,568,1449,-
chr5,95906730,3.5539358600583086,688,342,1030,-
chr5,95906732,3.5539358600583086,688,342,1030,-
chr5,95906740,2.4085448150822635,621,384,1005,-
chr5,95943044,2.7452173913043483,573,459,1032,-
chr5,95943046,2.7452173913043483,573,459,1032,-
chr5,95961649,1.659543817527011,431,594,1025,-
chr5,95961651,2.9938025048153616,708,899,1607,-
chr5,95961689,4.9048367289888715,597,548,1145,-
chr5,95961697,32.34944099545914,803,547,1350,-
chr5,95961698,40.006107464631974,1076,676,1752,-
chr5,95961699,40.006107464631974,1076,676,1752,-
chr5,95961700,40.3195434950537,808,466,1274,-
chr5,98879682,2.0613918859234017,882,586,1468,-
chr5,98879690,4.316023080337328,883,750,1633,-
chr5,98879691,4.316023080337328,883,750,1633,-
chr5,98879711,2.595433789954338,608,437,1045,-
chr5,98879713,2.3062246543814773,1105,783,1888,-
chr5,111192877,1.8250428816466555,1215,1165,2380,-
chr5,111192883,1.816157272804254,3546,2455,6001,-
chr5,111192909,1.524184632393588,806,602,1408,-
chr5,111192912,0.38445378151260506,731,475,1206,-
chr5,111192913,0.8538076143810241,1307,658,1965,-
chr5,111192914,1.03992673992674,1631,831,2462,-
chr5,111192915,0.9243088475171767,3936,2316,6252,-
chr5,111192916,1.1034727612620843,2180,1319,3499,-
chr5,111192917,0.7532808398950129,860,575,1435,-
chr5,112878662,0.46320380350916107,827,594,1421,-
chr5,112878702,1.1435563747316775,9243,6491,15734,-
chr5,112878705,0.6046555594942692,1162,650,1812,-
chr5,112878708,0.5615763546798029,1067,622,1689,-
chr5,112878724,1.5815456773049112,2565,1546,4111,-
chr5,112878726,0.4812677556818182,833,511,1344,-
chr5,112878743,2.3483140229646176,1673,1012,2685,-
chr5,112878754,1.5232125072632046,4046,2609,6655,-
chr5,112878795,1.9353685368536853,3404,2019,5423,-
chr5,112878796,1.6948082807377456,5696,3397,9093,-
chr5,112878798,1.8004467609828745,3275,1895,5170,-
chr5,112887028,1.9676415022793972,7031,4359,11390,-
chr5,112887031,1.5653045716471605,6482,3904,10386,-
chr5,112887033,1.591228374298974,8960,5227,14187,-
chr5,112887082,1.6835679498298757,1469,1152,2621,-
chr5,112887083,1.6445536445536448,1003,494,1497,-
chr5,112887086,1.4109224109224108,1337,1000,2337,-
chr5,112887091,1.9947229551451189,755,378,1133,-
chr5,112887100,2.3102452316076296,1086,733,1819,-
chr5,112887124,1.8185623395468244,930,577,1507,-
chr5,112887142,2.5,719,413,1132,-
chr5,115613761,2.494195688225539,892,602,1494,-
chr5,115614327,2.948201374621997,1508,967,2475,-
chr5,115614329,2.186021505376344,855,495,1350,-
chr5,115614912,2.3943711763881756,745,480,1225,-
chr5,115615203,0.6080260847755204,712,442,1154,-
chr5,115616041,1.2502276010026372,919,634,1553,-
chr5,115616394,2.9404619679730297,909,673,1582,-
chr5,115625620,1.8370979088768868,815,596,1411,-
chr5,115831741,2.7448970251716247,832,574,1406,-
chr5,115831743,2.7448970251716247,832,574,1406,-
chr5,116051912,0.8574027974014518,9400,6674,16074,-
chr5,116051918,1.5935977501683414,8469,6585,15054,-
chr5,116051919,1.4985736248093602,14741,10661,25402,-
chr5,116051953,1.1742167285896288,6126,4703,10829,-
chr5,116052010,1.4977634113690534,1951,995,2946,-
chr5,116052096,0.7422438672438673,1645,1088,2733,-
chr5,116052104,1.3538093792684778,1150,598,1748,-
chr5,116052117,1.5532544378698223,824,571,1395,-
chr5,116052146,0.5216706067769897,661,563,1224,-
chr5,116052196,0.6039025114857767,1673,1192,2865,-
chr5,116052197,0.3649906890130354,1175,1073,2248,-
chr5,116052219,1.4139116314300155,2347,2023,4370,-
chr5,116052221,1.2418503862822687,1075,695,1770,-
chr5,116052224,0.8953010948905109,1098,958,2056,-
chr5,116052225,1.0226688468364664,2678,2128,4806,-
chr5,116052226,1.1582369354380289,4543,3792,8335,-
chr5,116052228,0.9479289957222495,2363,2043,4406,-
chr5,116052229,0.9488375058103905,2028,1597,3625,-
chr5,123029379,1.3594906103742257,677,488,1165,-
chr5,123029385,2.5319372044282034,666,497,1163,-
chr5,123029388,0.33416481069042314,681,448,1129,-
chr5,123029390,0.33416481069042314,681,448,1129,-
chr5,123401150,1.8422431865828095,664,476,1140,-
chr5,123401161,1.93317230273752,979,689,1668,-
chr5,123401162,1.6359235957689557,1187,851,2038,-
chr5,123402044,1.498668207053689,933,798,1731,-
chr5,123402047,1.4422999533184166,1119,850,1969,-
chr5,123402062,1.8597014925373136,711,535,1246,-
chr5,123402065,1.1114599686028257,825,727,1552,-
chr5,123402066,1.1114599686028257,825,727,1552,-
chr5,123402069,1.2678114088640406,639,551,1190,-
chr5,126549992,1.2552921078334482,1289,777,2066,-
chr5,126550207,0.5500341763499658,618,417,1035,-
chr5,126552103,2.2427228279069555,820,486,1306,-
chr5,126552117,1.6749990157633903,860,470,1330,-
chr5,126552119,1.4205574912891987,905,409,1314,-
chr5,126559259,3.056321652392308,664,571,1235,-
chr5,126593401,1.4176606930860989,642,360,1002,-
chr5,126593402,1.8684524519798151,1113,820,1933,-
chr5,127511768,0.7407379631018449,580,451,1031,-
chr5,127511769,0.7407379631018449,580,451,1031,-
chr5,128258825,1.5525114155251138,934,656,1590,-
chr5,128258829,2.007792207792208,772,538,1310,-
chr5,128258832,1.030438583818668,939,763,1702,-
chr5,128258846,0.28857858933046904,805,531,1336,-
chr5,128258847,0.28857858933046904,805,531,1336,-
chr5,128261785,0.31342534823645146,575,463,1038,-
chr5,128328491,1.857967626080015,796,627,1423,-
chr5,128328796,2.17741935483871,647,495,1142,-
chr5,128333004,0.6099756433336864,719,496,1215,-
chr5,128333019,0.43312765283582455,975,632,1607,-
chr5,128335247,0.5918328584995252,819,584,1403,-
chr5,128335280,0.5859504132231405,708,483,1191,-
chr5,128335281,1.807173836595944,570,448,1018,-
chr5,128335509,1.7623512666525165,1603,1312,2915,-
chr5,128335510,1.7623512666525165,1603,1312,2915,-
chr5,128336061,1.7034590648357382,699,522,1221,-
chr5,128336075,1.6060344827586206,620,479,1099,-
chr5,128336107,1.4151718309951646,1208,802,2010,-
chr5,128345449,1.0643929829758612,1020,851,1871,-
chr5,128345450,0.8271345029239766,815,569,1384,-
chr5,128357381,3.066723655634443,938,616,1554,-
chr5,128366412,1.8210402200969475,555,448,1003,-
chr5,128378871,3.0309278350515467,587,484,1071,-
chr5,128392127,0.19396417821593098,533,686,1219,-
chr5,128392135,0.3878594348170356,1408,1780,3188,-
chr5,128392146,0.2841469428007889,460,623,1083,-
chr5,128392152,0.4428913429608464,739,1125,1864,-
chr5,128392153,0.3886569592383086,1066,1798,2864,-
chr5,128393153,16.244837343030248,1798,2808,4606,-
chr5,128393154,16.244837343030245,1798,2808,4606,-
chr5,128393159,9.471984883947982,1958,1907,3865,-
chr5,128393160,10.1638201458049,3072,2457,5529,-
chr5,128393161,10.1638201458049,3072,2457,5529,-
chr5,128393162,11.271108820091921,2160,1503,3663,-
chr5,128393364,2.0120191068765316,710,588,1298,-
chr5,128393365,1.9986744424330187,906,718,1624,-
chr5,128446602,2.359030551956346,660,404,1064,-
chr5,128519357,2.274107142857143,565,479,1044,-
chr5,128527886,2.6702497459757204,1018,812,1830,-
chr5,128527887,2.6000759311559847,1410,1070,2480,-
chr5,128537978,1.1030751334209343,759,528,1287,-
chr5,131159594,1.3581132811913592,2871,2296,5167,-
chr5,131162609,0.8638424780368209,7424,5393,12817,-
chr5,131165128,1.2268549824687942,6347,4908,11255,-
chr5,131165129,1.2786621709419708,3889,2388,6277,-
chr5,131165186,1.605235191599367,3672,2883,6555,-
chr5,131165199,1.2825089240183585,1508,1112,2620,-
chr5,131165200,1.3784690969096907,2013,1110,3123,-
chr5,131165206,1.3536285936285937,1795,974,2769,-
chr5,131165252,0.6593139898608565,977,507,1484,-
chr5,131165255,0.594647201946472,751,410,1161,-
chr5,131165259,0.4326974600793056,849,601,1450,-
chr5,131165260,0.8576751592356687,1145,627,1772,-
chr5,131165261,0.6664220047425817,1994,1228,3222,-
chr5,133955613,0.559508124725516,636,494,1130,-
chr5,133955615,3.6272692429936244,679,518,1197,-
chr5,133955795,2.2473416023040214,839,546,1385,-
chr5,133956557,2.383263295895635,926,704,1630,-
chr5,133956608,2.2781783681214423,666,464,1130,-
chr5,133956720,2.6249407894308643,1450,941,2391,-
chr5,133956722,2.760401096163428,1080,668,1748,-
chr5,133959606,2.2499852072100057,710,470,1180,-
chr5,133972149,2.082902016776727,1372,861,2233,-
chr5,133972150,1.416500994035785,1249,1005,2254,-
chr5,133972197,3.359375,816,607,1423,-
chr5,133972294,2.022312373225152,996,679,1675,-
chr5,133972329,0.5342539648289999,1237,712,1949,-
chr5,133972518,0.6474980299448385,1428,1079,2507,-
chr5,133972552,2.9901656314699787,1089,919,2008,-
chr5,133972699,1.5021791767554478,1055,825,1880,-
chr5,133972737,1.7631460397443295,1427,1061,2488,-
chr5,133972745,2.1212520736998326,1257,972,2229,-
chr5,133972859,1.4226766917293234,647,474,1121,-
chr5,133973811,2.2266401590457257,767,502,1269,-
chr5,133973813,1.7174334426965503,1032,715,1747,-
chr5,133976020,2.955665024630542,699,405,1104,-
chr5,133980847,1.5166374781085812,865,570,1435,-
chr5,133980911,1.631535233432418,956,601,1557,-
chr5,133980936,1.0473657440869277,1122,679,1801,-
chr5,133980942,2.8502692998204666,1133,556,1689,-
chr5,133980943,2.8502692998204666,1133,556,1689,-
chr5,133980955,1.5316668362990735,670,389,1059,-
chr5,133991051,1.7652032408324219,2091,1590,3681,-
chr5,133991053,1.4102917292355186,3041,2297,5338,-
chr5,133991086,1.9138726919339164,684,391,1075,-
chr5,133992982,1.5589383746412617,734,520,1254,-
chr5,134004680,3.43531179606665,756,507,1263,-
chr5,134004708,2.61151570323168,674,337,1011,-
chr5,134157222,2.847241867043847,670,403,1073,-
chr5,134157223,2.847241867043847,670,403,1073,-
chr5,134157290,2.6440964588510854,812,643,1455,-
chr5,134157306,3.310279714616449,666,426,1092,-
chr5,134157307,3.310279714616449,666,426,1092,-
chr5,134157652,1.8411243455029955,6078,4088,10166,-
chr5,134157654,1.764880209033795,4426,2851,7277,-
chr5,134157719,2.8093137254901963,1041,815,1856,-
chr5,134157732,1.677233329189379,4495,2746,7241,-
chr5,134157733,1.677233329189379,4495,2746,7241,-
chr5,134157734,1.6453066277535573,3545,2372,5917,-
chr5,134158533,1.6232855764554293,2836,1833,4669,-
chr5,134158534,0.7656061612657169,1777,1310,3087,-
chr5,134161074,1.6625132309520714,1443,1098,2541,-
chr5,134161101,1.4297917122239232,1714,1075,2789,-
chr5,134161104,1.609189450936207,2484,1856,4340,-
chr5,134161107,2.1681162386165966,1008,673,1681,-
chr5,134161127,1.9084675014907573,864,558,1422,-
chr5,134174008,1.8566958698372968,1031,798,1829,-
chr5,134176866,1.5384724290035228,2281,1750,4031,-
chr5,134176871,0.5792086400619915,1138,711,1849,-
chr5,134176928,1.7723991456665262,1276,882,2158,-
chr5,134176935,1.5251681537252033,1250,869,2119,-
chr5,134176937,2.3950350197461026,1426,928,2354,-
chr5,134176943,2.007787274453941,681,350,1031,-
chr5,134176945,1.9604211087420045,938,468,1406,-
chr5,134176947,1.919634049314463,858,439,1297,-
chr5,134197248,1.6055850372996565,2747,2091,4838,-
chr5,134197348,1.7386956521739132,1332,919,2251,-
chr5,134197463,2.3602305475504317,909,693,1602,-
chr5,134197756,1.7793176881104285,5603,5167,10770,-
chr5,134197759,1.752440356439538,5360,4762,10122,-
chr5,134197762,1.7637309723516619,5027,4291,9318,-
chr5,134197765,1.3191676543826631,17505,12901,30406,-
chr5,134197766,1.802017625231911,9026,7139,16165,-
chr5,134197770,1.7672790901137359,4039,3047,7086,-
chr5,134197781,1.2889631156295827,12104,7849,19953,-
chr5,134197782,1.2395881892464795,8900,5545,14445,-
chr5,134197794,1.9615578311230488,2459,1701,4160,-
chr5,134197800,1.604358489807406,5619,3229,8848,-
chr5,134197801,1.5027268132323037,7798,4620,12418,-
chr5,134197818,1.3862783138904986,1833,1117,2950,-
chr5,134197838,1.775021533161068,2575,1676,4251,-
chr5,134199168,0.6625919036229958,1099,794,1893,-
chr5,134199187,0.5857380319148937,838,639,1477,-
chr5,134199202,0.4314888010540184,654,482,1136,-
chr5,134199203,2.4176125244618394,638,510,1148,-
chr5,134200390,2.723936613844871,567,435,1002,-
chr5,134200407,0.5882428525538067,762,565,1327,-
chr5,134200444,1.659652457235949,814,507,1321,-
chr5,134200469,0.5696357735304725,717,589,1306,-
chr5,134201069,1.2217720912086747,2055,1569,3624,-
chr5,134201072,1.8415327978580989,709,497,1206,-
chr5,134202009,1.8268442622950816,1782,1727,3509,-
chr5,134202016,1.6531199504172474,1588,1368,2956,-
chr5,134205945,1.6015760138381705,1281,967,2248,-
chr5,134225842,0.3653375829513186,516,561,1077,-
chr5,134225864,5.097263759399229,589,551,1140,-
chr5,134225867,6.62419752099173,777,679,1456,-
chr5,134226011,2.8710220318237454,694,343,1037,-
chr5,134226012,2.8710220318237454,694,343,1037,-
chr5,134402735,0.3717890709484506,732,542,1274,-
chr5,134606714,1.7231584669747213,817,565,1382,-
chr5,134606879,2.1204819277108435,703,497,1200,-
chr5,134608487,2.2453340198223706,622,456,1078,-
chr5,134612748,2.6848899012908123,679,438,1117,-
chr5,134612749,2.6848899012908123,679,438,1117,-
chr5,134620973,2.012813094182908,1042,822,1864,-
chr5,134624017,1.0286966646120128,750,470,1220,-
chr5,134624018,1.0286966646120128,750,470,1220,-
chr5,135334601,2.083265987004131,831,584,1415,-
chr5,135334783,2.1551116333725027,785,554,1339,-
chr5,135343349,3.6439225395020065,830,573,1403,-
chr5,135346044,1.7929158802092395,651,450,1101,-
chr5,137752703,0.6104194119485368,2797,3677,6474,-
chr5,137752737,0.4915227291855648,1167,1752,2919,-
chr5,137752741,0.24012091233855457,513,1212,1725,-
chr5,137752754,0.2995279666061679,2574,5757,8331,-
chr5,137752755,0.2909584779367842,3635,8084,11719,-
chr5,137752757,0.3166829942296693,2045,3866,5911,-
chr5,137752758,2.0718213099052867,1863,3676,5539,-
chr5,137752759,9.104303593056118,1013,2476,3489,-
chr5,137752760,9.914134231555881,6739,11186,17925,-
chr5,137752761,10.09885350472154,7950,11153,19103,-
chr5,137752762,12.441068270808126,9297,10452,19749,-
chr5,137752763,13.740284627806442,7328,6202,13530,-
chr5,137752764,15.228137754561695,5431,3560,8991,-
chr5,137752767,42.4472584649178,4713,565,5278,-
chr5,137752768,42.4472584649178,4713,565,5278,-
chr5,137752769,47.67437678676417,3835,450,4285,-
chr5,137752775,11.079129850397946,2027,301,2328,-
chr5,137752776,9.032392904896625,1450,239,1689,-
chr5,137752790,0.19486166007905134,985,183,1168,-
chr5,137752792,0.17656344722228953,1328,302,1630,-
chr5,137752812,8.967804783660279,3392,1015,4407,-
chr5,137752813,8.767888187693496,2879,887,3766,-
chr5,137752988,0.6487941429801894,654,515,1169,-
chr5,137752995,3.9177148846960166,597,476,1073,-
chr5,137753008,1.9882653828794945,825,577,1402,-
chr5,137753020,1.2723873337345877,941,739,1680,-
chr5,137753137,1.5366300366300365,838,559,1397,-
chr5,137753140,0.5439716312056737,766,479,1245,-
chr5,137753160,3.926741730938951,919,713,1632,-
chr5,137753169,6.8707369401011364,882,613,1495,-
chr5,137753231,3.052821315938479,1228,840,2068,-
chr5,137753232,3.987041999669484,1633,1178,2811,-
chr5,137753348,5.259631490787269,627,596,1223,-
chr5,137753457,4.603328479544844,791,492,1283,-
chr5,137753459,3.47930029154519,662,342,1004,-
chr5,137753460,4.6849546671074656,853,583,1436,-
chr5,137753468,8.4070698861629,577,480,1057,-
chr5,137753656,2.2565055762081783,606,537,1143,-
chr5,137753692,0.5962692967409948,926,703,1629,-
chr5,137753707,1.680333778535403,1524,1099,2623,-
chr5,137753714,1.6132132132132129,947,554,1501,-
chr5,137753751,1.9138663967611336,572,493,1065,-
chr5,137753753,1.670226359985396,630,497,1127,-
chr5,137753777,1.4291271814948656,1527,1035,2562,-
chr5,137753778,1.1713964734039957,1141,693,1834,-
chr5,137753782,3.2401960784313726,660,560,1220,-
chr5,137753783,3.2401960784313726,660,560,1220,-
chr5,137753840,2.197041227593626,630,478,1108,-
chr5,137753945,1.6792514558659948,801,492,1293,-
chr5,137753989,1.7172897196261685,783,427,1210,-
chr5,137754019,1.8905543659290982,547,466,1013,-
chr5,137754023,0.2393229218297626,1205,883,2088,-
chr5,137754044,0.5716473140232231,639,460,1099,-
chr5,137754059,0.8507126781695424,755,601,1356,-
chr5,137754060,0.693123290004672,1264,993,2257,-
chr5,137754304,9.900235285356182,1183,770,1953,-
chr5,137754307,10.688808332899992,1164,629,1793,-
chr5,137754313,9.551122169540879,1979,840,2819,-
chr5,137754314,10.405419730284555,2729,1194,3923,-
chr5,137754315,15.91773778920308,773,388,1161,-
chr5,137754316,11.588219951110824,1161,484,1645,-
chr5,138157119,3.354399611084103,689,362,1051,-
chr5,138166021,0.8246741532494474,646,521,1167,-
chr5,138192574,1.8431533639334894,1719,948,2667,-
chr5,138192581,2.39750346740638,1607,823,2430,-
chr5,138192588,1.8351392547674668,4232,1946,6178,-
chr5,138192589,1.8351392547674668,4232,1946,6178,-
chr5,138192590,1.902829638265653,7005,2955,9960,-
chr5,138192592,2.454561558901683,2597,1128,3725,-
chr5,138192596,1.720891851633739,1532,664,2196,-
chr5,138192603,1.777640162372987,3529,1248,4777,-
chr5,138192605,1.9308604331582366,2924,1000,3924,-
chr5,138192626,0.5289871418903677,1004,428,1432,-
chr5,138198250,0.38984794394237593,708,351,1059,-
chr5,138507540,3.336454949042647,554,486,1040,-
chr5,138507965,3.149265905383361,857,612,1469,-
chr5,138507967,3.149265905383361,857,612,1469,-
chr5,138508087,0.3816290885995554,873,535,1408,-
chr5,138508088,0.3816290885995554,873,535,1408,-
chr5,138511092,1.0467487074929005,574,442,1016,-
chr5,138511093,1.0467487074929005,574,442,1016,-
chr5,138512915,1.0041850732387816,616,505,1121,-
chr5,138512916,1.585494516712073,1077,852,1929,-
chr5,138542923,2.327500577657564,681,437,1118,-
chr5,138555247,1.0867997183613245,1049,868,1917,-
chr5,138555248,0.47345030900379964,1608,1049,2657,-
chr5,138555255,1.9407032442698344,1529,962,2491,-
chr5,138555256,2.1372545169124026,1720,1254,2974,-
chr5,138555258,3.783207205857752,1296,1040,2336,-
chr5,138555259,2.5633802816901414,587,496,1083,-
chr5,138555303,0.9151087431500378,813,510,1323,-
chr5,138555304,1.0958498658333995,877,565,1442,-
chr5,138555305,0.2857421875,626,383,1009,-
chr5,138555532,1.3678770635418174,1978,1397,3375,-
chr5,138555577,1.9920872540633017,2159,1335,3494,-
chr5,138555641,1.4627551020408165,1097,839,1936,-
chr5,138555966,1.5654292708147073,9634,7301,16935,-
chr5,138556055,0.598427260812582,1521,1089,2610,-
chr5,138556060,0.673686323495735,2826,1957,4783,-
chr5,138556104,1.7438129899216126,2306,1879,4185,-
chr5,138556496,2.0537056928034367,1911,1329,3240,-
chr5,138557980,1.4846938775510208,1745,1119,2864,-
chr5,138558655,1.6332429990966577,1807,1106,2913,-
chr5,138559960,1.8469701747450893,3706,2663,6369,-
chr5,138561109,0.8855825647263876,569,453,1022,-
chr5,138561661,1.613796887470072,1948,1431,3379,-
chr5,138561687,0.7682268964513035,9207,6601,15808,-
chr5,138561765,0.7661936053895854,1664,1392,3056,-
chr5,138561780,1.6663831490468803,1091,868,1959,-
chr5,138561788,2.398678414096916,725,453,1178,-
chr5,138566703,1.487226181050409,1522,1262,2784,-
chr5,138567078,1.549611734253667,1346,1158,2504,-
chr5,138567149,1.5402857142857145,1197,874,2071,-
chr5,138567509,0.6431149531111238,2587,1765,4352,-
chr5,138567512,1.442918105365893,4990,3155,8145,-
chr5,138567533,0.7919548402387262,2477,1718,4195,-
chr5,138567541,0.9467098215723188,5843,3890,9733,-
chr5,138567675,1.6646377380718635,1255,925,2180,-
chr5,138567688,1.4238421440923044,3125,2241,5366,-
chr5,138568978,1.7942576742394292,7535,4052,11587,-
chr5,138569031,1.015535587471153,5979,3750,9729,-
chr5,138571020,0.6942483388704319,1485,1119,2604,-
chr5,138571031,1.943578322197476,1231,897,2128,-
chr5,138571102,1.4701417979773197,1612,966,2578,-
chr5,138571124,1.0642596854470197,2348,1515,3863,-
chr5,138571131,0.9810031149720954,2749,1681,4430,-
chr5,138571133,1.5495403974893165,4983,2865,7848,-
chr5,138571134,1.852315167367269,3961,2297,6258,-
chr5,138571135,1.8799801781281864,3413,2030,5443,-
chr5,138574107,1.098158004695343,2062,1447,3509,-
chr5,138574115,0.533485017601099,730,612,1342,-
chr5,138574124,1.5790608160123172,640,432,1072,-
chr5,138575326,1.6520210896309313,939,568,1507,-
chr5,138575350,1.9970862470862472,744,428,1172,-
chr5,139026890,2.5384615384615383,593,521,1114,-
chr5,140303052,0.8556586454036081,791,805,1596,-
chr5,140303053,0.5751554783244924,558,615,1173,-
chr5,140645572,0.5046620046620046,865,571,1436,-
chr5,140645629,1.6551427032848678,903,618,1521,-
chr5,140645660,0.4730792498487598,781,550,1331,-
chr5,140647329,0.5330454192546584,844,447,1291,-
chr5,140647350,1.9551934826883912,815,490,1305,-
chr5,140647608,0.11572580645161293,573,479,1052,-
chr5,140647627,0.6112914680832796,736,486,1222,-
chr5,140647630,0.681922700277636,736,602,1338,-
chr5,140677694,2.011818425247754,862,553,1415,-
chr5,141318636,2.893953634085213,738,455,1193,-
chr5,141318642,2.1621621621621623,767,443,1210,-
chr5,141318689,1.5728239011778224,1459,943,2402,-
chr5,141318693,0.6960955456634954,2633,1808,4441,-
chr5,141318694,1.7971541042849768,2870,2383,5253,-
chr5,141318695,1.1692540673043075,6639,5008,11647,-
chr5,141318696,1.277834394166512,5227,4055,9282,-
chr5,141318776,1.7617200674536255,673,592,1265,-
chr5,141318922,0.6396586059743955,802,702,1504,-
chr5,141319016,2.037754719339917,651,420,1071,-
chr5,141319095,0.6526046229530292,1075,780,1855,-
chr5,141319101,1.710415412402167,946,754,1700,-
chr5,141319108,1.5697722567287782,891,551,1442,-
chr5,141319141,2.087114337568058,689,521,1210,-
chr5,141319164,2.779510022271715,571,448,1019,-
chr5,141319165,1.822710622710623,621,454,1075,-
chr5,141319330,1.8005628506202964,7036,5486,12522,-
chr5,141319338,1.5281812370273735,8859,6310,15169,-
chr5,141319340,1.010489856848643,5190,3417,8607,-
chr5,141319341,1.6816951889560643,3361,2464,5825,-
chr5,141319345,1.547121411644871,5983,4128,10111,-
chr5,141319346,1.3280093496944432,12729,8960,21689,-
chr5,141319349,1.4387755102040816,2609,1739,4348,-
chr5,141319370,1.7043671377422858,6000,4082,10082,-
chr5,141319379,1.5211966232543426,3254,1916,5170,-
chr5,141319426,2.064182634004366,1334,867,2201,-
chr5,141319467,0.632015065913371,838,530,1368,-
chr5,141319468,2.2535695115405256,655,404,1059,-
chr5,141319623,4.359528487229864,633,508,1141,-
chr5,141319843,2.027057926829269,590,491,1081,-
chr5,141319847,0.5465139642354833,951,710,1661,-
chr5,141319848,1.6393823695142817,1633,1175,2808,-
chr5,141320203,0.4736,813,624,1437,-
chr5,141320543,1.317966979398663,708,506,1214,-
chr5,141528466,1.773690932311622,671,404,1075,-
chr5,141528467,0.5737742830712304,826,563,1389,-
chr5,141528743,0.9990338164251209,2067,1609,3676,-
chr5,141528744,0.8306168088237217,4579,3687,8266,-
chr5,141528745,0.8709572085172907,3477,2748,6225,-
chr5,141528760,1.6412056151940546,794,518,1312,-
chr5,142001414,13.512490847837686,495,546,1041,-
chr5,144159616,1.547771926405972,895,643,1538,-
chr5,144160557,2.832891995814012,690,431,1121,-
chr5,144169942,1.7423794668117445,667,482,1149,-
chr5,144169962,2.745533259122634,798,547,1345,-
chr5,144170587,4.235128980622471,846,604,1450,-
chr5,146124041,0.6238536585365854,608,499,1107,-
chr5,146126505,2.5180876685332443,997,724,1721,-
chr5,146129062,2.37443921654448,619,480,1099,-
chr5,146129064,2.37443921654448,619,480,1099,-
chr5,146135614,0.3691044405752374,844,645,1489,-
chr5,146140258,2.4491144120809745,613,428,1041,-
chr5,146143062,2.108164140692022,796,537,1333,-
chr5,146143063,2.108164140692022,796,537,1333,-
chr5,146143066,2.098007200197807,690,466,1156,-
chr5,146144281,1.8277629401982147,1051,612,1663,-
chr5,146144282,1.0915714106268055,789,418,1207,-
chr5,146157608,1.7448972718364706,1111,817,1928,-
chr5,146157609,0.8850384309567982,702,538,1240,-
chr5,146157610,2.1109389734608652,846,570,1416,-
chr5,146157612,2.1109389734608652,846,570,1416,-
chr5,146157760,1.3303861129136925,780,535,1315,-
chr5,146157762,1.706904487917146,1140,789,1929,-
chr5,146157764,1.5586206864807803,1037,762,1799,-
chr5,146160439,2.2053571428571432,607,447,1054,-
chr5,146164470,2.068325684508669,671,445,1116,-
chr5,146168244,2.490575646926097,724,566,1290,-
chr5,149495646,2.589166666666667,716,479,1195,-
chr5,149495648,2.1280340099069712,911,602,1513,-
chr5,149496288,0.5543226105784101,1061,847,1908,-
chr5,149496483,1.8681355665555035,1317,1014,2331,-
chr5,149496833,2.119967324075155,585,450,1035,-
chr5,149511829,1.5265866209262435,889,582,1471,-
chr5,149511839,1.7838541666666663,821,511,1332,-
chr5,149550155,1.8006095123900878,1273,1090,2363,-
chr5,149550156,1.8006095123900878,1273,1090,2363,-
chr5,149550857,3.4282352941176466,563,509,1072,-
chr5,149550858,2.9556990871027518,926,788,1714,-
chr5,149550936,0.6178400133015316,1868,1194,3062,-
chr5,149550937,1.9099302082760892,992,586,1578,-
chr5,149550942,2.190815836997009,1657,1205,2862,-
chr5,149550945,1.7792004584002172,1547,1099,2646,-
chr5,149550958,2.056073153899241,700,482,1182,-
chr5,149550976,2.3646071700991613,774,455,1229,-
chr5,149550978,2.3646071700991613,774,455,1229,-
chr5,149550996,3.0859263516028625,1338,1065,2403,-
chr5,149550997,3.350548109914054,989,871,1860,-
chr5,150444317,1.5936021409447152,14148,9780,23928,-
chr5,150444352,1.3973393900064894,4235,3679,7914,-
chr5,150445622,1.255646527385658,5336,4047,9383,-
chr5,150445625,1.3291924454575057,9070,6805,15875,-
chr5,150445679,1.2879127749641772,30483,20361,50844,-
chr5,150445680,1.3233472427872748,13911,9689,23600,-
chr5,150445685,0.6705437346276351,2275,1498,3773,-
chr5,150445687,0.7476206661879742,1758,1072,2830,-
chr5,150446831,1.4054094147673972,7603,5500,13103,-
chr5,150446961,1.5388418444105878,24699,16950,41649,-
chr5,150447632,1.27640185963541,35276,24480,59756,-
chr5,150447700,1.1156890731321867,24341,17390,41731,-
chr5,150447708,1.2155583784707469,21896,15036,36932,-
chr5,150447709,0.6100124397681664,10521,7426,17947,-
chr5,150447732,1.4091587236546508,10365,7845,18210,-
chr5,150447734,1.3618328319100712,32573,22928,55501,-
chr5,150447736,1.4297425722369186,9322,5764,15086,-
chr5,150447737,0.948026990964087,1285,1207,2492,-
chr5,150449734,1.2792593853155685,8353,4818,13171,-
chr5,150449736,0.8947908107322112,15662,8370,24032,-
chr5,150449738,0.9583644859320312,7433,4140,11573,-
chr5,150733459,2.706518678398659,1166,661,1827,-
chr5,150733473,1.0042501517911353,826,487,1313,-
chr5,150733474,1.0042501517911353,826,487,1313,-
chr5,150742122,1.1100697063599396,929,558,1487,-
chr5,151029987,4.34065054791582,917,780,1697,-
chr5,151029995,1.765158016265306,1492,1623,3115,-
chr5,151029996,2.2888412309368187,946,1223,2169,-
chr5,151030004,1.5481697206810485,889,820,1709,-
chr5,151030019,2.190508063068314,1101,970,2071,-
chr5,151030648,0.9509932533733132,596,463,1059,-
chr5,151030649,1.3720406060517778,844,653,1497,-
chr5,151042942,3.1435730393385115,611,613,1224,-
chr5,151042944,2.4276915693489043,905,892,1797,-
chr5,151042945,1.982420826623725,868,827,1695,-
chr5,151042947,1.902975073706781,567,532,1099,-
chr5,151049903,1.6050469942323422,1986,1252,3238,-
chr5,151049917,2.1149470760170344,1283,828,2111,-
chr5,151049926,1.6009487666034157,648,464,1112,-
chr5,151133134,0.3848479850459069,699,422,1121,-
chr5,151133135,0.3848479850459069,699,422,1121,-
chr5,157786612,1.8146103896103891,728,439,1167,-
chr5,157786656,2.0784313725490198,635,431,1066,-
chr5,157787485,3.2887780548628434,627,400,1027,-
chr5,157787681,2.821019504653551,764,537,1301,-
chr5,157787682,1.4755183471640838,888,625,1513,-
chr5,157791725,0.34617134345235934,932,576,1508,-
chr5,157791970,2.772066842892977,593,424,1017,-
chr5,157806095,2.8303427169089517,836,594,1430,-
chr5,157814239,2.527541225649432,788,535,1323,-
chr5,157858942,0.4891752577319588,729,484,1213,-
chr5,157858953,1.289294649120275,1067,876,1943,-
chr5,157858964,0.4632329122125041,649,629,1278,-
chr5,157858965,0.4632329122125041,649,629,1278,-
chr5,157858989,7.5390254363741205,706,608,1314,-
chr5,157858998,3.3626596438499643,713,548,1261,-
chr5,157858999,3.3626596438499643,713,548,1261,-
chr5,159157586,6.975620074762579,653,497,1150,-
chr5,159157587,6.975620074762579,653,497,1150,-
chr5,159158038,8.428189244235574,829,1253,2082,-
chr5,159158039,8.164336602417155,903,1403,2306,-
chr5,159950570,1.00513836798711,2801,2276,5077,-
chr5,159950574,1.0370824819630822,4567,3628,8195,-
chr5,159950575,0.9479266105327208,6501,5035,11536,-
chr5,159950576,1.0859407892609811,5335,4438,9773,-
chr5,159950578,1.339675788187649,768,810,1578,-
chr5,159950579,0.7764723832773879,726,550,1276,-
chr5,159950580,0.9122740988210057,724,550,1274,-
chr5,159950582,1.1302480786050249,578,524,1102,-
chr5,159951379,0.6883611399097801,1765,1308,3073,-
chr5,159951380,1.0156857396167225,741,601,1342,-
chr5,160404834,2.1341090900913073,1275,882,2157,-
chr5,160404841,1.1238579236730482,1076,761,1837,-
chr5,160415269,1.648995671670499,769,654,1423,-
chr5,163453831,0.7338267613105312,1742,1276,3018,-
chr5,163453981,1.85038868357334,604,412,1016,-
chr5,163453982,0.5846656552689928,667,450,1117,-
chr5,163457070,1.5517587939698494,771,596,1367,-
chr5,163457597,1.3540207938605855,649,472,1121,-
chr5,163459872,1.5167686972322507,728,485,1213,-
chr5,163459906,2.5530503978779837,769,376,1145,-
chr5,163459907,2.3672226343336673,1165,587,1752,-
chr5,163459909,3.8760342789598115,708,422,1130,-
chr5,163459910,3.8760342789598115,708,422,1130,-
chr5,168553131,0.6691535150645623,900,696,1596,-
chr5,168553161,2.203964847741672,673,465,1138,-
chr5,168553163,2.203964847741672,673,465,1138,-
chr5,168556927,2.711201378796507,989,610,1599,-
chr5,168561504,1.482651622002821,1313,708,2021,-
chr5,168561505,2.322374759152216,1014,691,1705,-
chr5,168563994,1.725578199807816,974,616,1590,-
chr5,168568960,1.5685400643185614,1090,789,1879,-
chr5,168568968,0.5697841726618704,593,416,1009,-
chr5,168579316,3.1317585978228037,599,413,1012,-
chr5,172211973,0.43569958847736623,604,485,1089,-
chr5,172211974,0.43569958847736623,604,485,1089,-
chr5,172768280,1.2264174685577023,9712,6884,16596,-
chr5,172768360,1.3398727146772296,5771,3863,9634,-
chr5,172768622,1.3767619814740235,2278,1909,4187,-
chr5,172768792,1.7226494323385575,1465,1180,2645,-
chr5,172768798,1.873753142486416,1466,1120,2586,-
chr5,172768822,1.4351043332103472,1320,1037,2357,-
chr5,172768846,1.6582482716114668,3151,2520,5671,-
chr5,172768847,1.5642987457240594,2248,1753,4001,-
chr5,172768852,1.7772704714640195,1278,774,2052,-
chr5,172768868,2.0176357335386985,1277,741,2018,-
chr5,172769081,1.3297154836777478,2412,1574,3986,-
chr5,172769122,1.2836699789298442,5579,4155,9734,-
chr5,172769123,1.3515141699256765,9675,6992,16667,-
chr5,172769621,1.3308871795734942,2470,2013,4483,-
chr5,172769657,1.6240499517969644,2317,1897,4214,-
chr5,172769699,1.3511155595577973,4258,3194,7452,-
chr5,172769749,2.0639194139194137,1145,935,2080,-
chr5,172769781,0.49594473980364,1419,1058,2477,-
chr5,172770189,1.4781238413051536,1070,898,1968,-
chr5,172770222,1.5715986855659634,3723,2841,6564,-
chr5,172770261,0.6991712856807555,1548,1141,2689,-
chr5,172770264,1.15808785699046,3100,2517,5617,-
chr5,172770291,1.655893536121673,1923,1051,2974,-
chr5,172770292,1.655893536121673,1923,1051,2974,-
chr5,172770296,3.6607879924953104,812,614,1426,-
chr5,172770299,2.5008447823573867,1678,832,2510,-
chr5,172770300,1.731795985326703,2625,1607,4232,-
chr5,172770302,1.81988377353238,1323,926,2249,-
chr5,172770303,1.81988377353238,1323,926,2249,-
chr5,172770623,2.6304820657692902,1045,758,1803,-
chr5,172770804,0.6160991769406783,819,622,1441,-
chr5,172770883,1.8864152261218785,696,497,1193,-
chr5,172771034,2.0750300776550366,1580,1337,2917,-
chr5,172771078,1.7226702985678106,1618,958,2576,-
chr5,172771133,1.4159978598180845,1184,889,2073,-
chr5,172771134,1.5897247706422022,1215,544,1759,-
chr5,172771143,2.929617000495496,2862,1939,4801,-
chr5,172771186,1.9494647355163728,853,396,1249,-
chr5,172771188,1.1034507778035756,1490,943,2433,-
chr5,172771190,1.0822610997497881,2791,1761,4552,-
chr5,172771191,0.904821897262842,1402,888,2290,-
chr5,173317154,0.4767025089605735,455,557,1012,-
chr5,173317177,5.897716209697658,2365,2314,4679,-
chr5,173317191,5.648985959438377,638,640,1278,-
chr5,173317245,9.235264195062456,1760,1834,3594,-
chr5,173317248,6.71706365632736,2190,1895,4085,-
chr5,173317249,7.641693811074918,965,920,1885,-
chr5,173317299,0.425978703853518,929,933,1862,-
chr5,173317304,0.17597942822568444,830,600,1430,-
chr5,173317305,0.17597942822568444,830,600,1430,-
chr5,173317306,0.17597942822568444,830,600,1430,-
chr5,173317322,20.642263167728682,4057,2702,6759,-
chr5,173317323,20.21307191603979,4446,2898,7344,-
chr5,173317324,19.775886806433395,4727,2975,7702,-
chr5,173317325,18.368552232336366,1168,768,1936,-
chr5,173317512,11.700633259288551,1667,1209,2876,-
chr5,173317513,11.700633259288551,1667,1209,2876,-
chr5,173317518,3.7626686875936017,1259,707,1966,-
chr5,173317519,4.041175382123506,848,506,1354,-
chr5,173317643,1.4863313997218506,1338,1089,2427,-
chr5,173317820,1.2260086406631916,1523,1258,2781,-
chr5,173317844,2.3879726464326954,966,754,1720,-
chr5,173317860,0.7931034482758621,942,579,1521,-
chr5,173317861,0.7931034482758621,942,579,1521,-
chr5,173317865,0.37375226100355047,796,648,1444,-
chr5,173317867,0.37375226100355047,796,648,1444,-
chr5,173317875,1.0029585798816567,1129,844,1973,-
chr5,173317877,1.5361734624489711,1449,1118,2567,-
chr5,173317909,3.2790834986739603,575,480,1055,-
chr5,173317930,0.933991917377638,639,523,1162,-
chr5,173317932,0.933991917377638,639,523,1162,-
chr5,173317965,2.295026849195168,779,548,1327,-
chr5,173323275,2.026554856743536,579,476,1055,-
chr5,173323335,3.5737051792828685,597,501,1098,-
chr5,173325931,1.5384331797235025,855,699,1554,-
chr5,173325946,1.5657331136738055,755,606,1361,-
chr5,173325958,2.453525382604246,985,743,1728,-
chr5,173328086,2.991725037883074,871,556,1427,-
chr5,173328196,0.42478303827517255,720,699,1419,-
chr5,173328225,0.3467076106723213,682,1029,1711,-
chr5,173328231,0.5767236910316226,444,642,1086,-
chr5,173328239,5.355596038157242,2818,3190,6008,-
chr5,173328240,5.355596038157242,2818,3190,6008,-
chr5,173328241,5.050328515445505,2438,2897,5335,-
chr5,173328247,5.00345692907502,1313,1162,2475,-
chr5,173328249,5.0607490711918866,719,432,1151,-
chr5,173328250,5.429759719122851,1180,766,1946,-
chr5,173328253,6.207318414689654,1098,588,1686,-
chr5,173328262,3.8580655391120504,737,303,1040,-
chr5,173328277,8.490973327866945,1549,526,2075,-
chr5,173328278,9.756250370234353,2741,910,3651,-
chr5,173328279,9.756250370234353,2741,910,3651,-
chr5,173328280,15.752380952380953,826,284,1110,-
chr5,173328414,1.1665392075543208,1666,1273,2939,-
chr5,173328416,1.1817711832144056,990,618,1608,-
chr5,173328444,0.4884004720270343,846,723,1569,-
chr5,173328446,0.8466973400685156,1833,1523,3356,-
chr5,173328447,1.0309055893552763,742,681,1423,-
chr5,173608186,0.5769242046692838,1214,892,2106,-
chr5,173608213,1.101256976620498,1237,896,2133,-
chr5,176346160,1.3401683925397652,587,456,1043,-
chr5,176346321,5.536310944425503,705,418,1123,-
chr5,176346322,5.536310944425503,705,418,1123,-
chr5,176355702,4.066867985754925,730,451,1181,-
chr5,176384061,0.3006033288799383,632,482,1114,-
chr5,176384374,0.7304279155541985,539,479,1018,-
chr5,176385242,1.5367228819479095,1620,910,2530,-
chr5,176385244,1.641847826086957,1367,919,2286,-
chr5,176385269,2.0818700614574186,1354,937,2291,-
chr5,176385296,1.778951115329853,956,587,1543,-
chr5,176385313,2.1676975142957176,742,450,1192,-
chr5,176397672,2.094662967194385,712,556,1268,-
chr5,176397673,2.094662967194385,712,556,1268,-
chr5,176397691,0.8904933814681107,739,553,1292,-
chr5,176397692,0.8904933814681107,739,553,1292,-
chr5,177331743,2.7992516935085443,886,839,1725,-
chr5,177331744,5.423456475953747,1241,1045,2286,-
chr5,177332029,1.728358793576185,705,443,1148,-
chr5,177332222,1.3953410890569447,674,434,1108,-
chr5,177334322,2.1308900523560212,791,572,1363,-
chr5,177334384,0.43487179487179484,741,584,1325,-
chr5,177337245,0.8391692184795633,572,517,1089,-
chr5,177337246,1.7132776076762208,1126,927,2053,-
chr5,177337766,0.4935578722266774,576,434,1010,-
chr5,177337767,0.25272620100206306,685,376,1061,-
chr5,177338544,0.5563269876819709,620,469,1089,-
chr5,177338547,0.6126650366748166,736,408,1144,-
chr5,177351188,2.1618357487922704,715,551,1266,-
chr5,177351230,0.5205479452054794,664,510,1174,-
chr5,177351467,1.6159677902942562,1047,630,1677,-
chr5,177351485,0.7070707070707072,1031,593,1624,-
chr5,177351513,2.6678774816881403,1342,1136,2478,-
chr5,177351562,0.514757885985398,2059,1590,3649,-
chr5,177351567,2.404572703192528,1175,796,1971,-
chr5,177351568,2.5620117130536424,1719,1256,2975,-
chr5,177351569,2.6254182973623177,1981,1576,3557,-
chr5,177351628,7.982227163074619,1249,1022,2271,-
chr5,177351629,1.3634146341463416,558,450,1008,-
chr5,177457695,2.3005405405405406,783,517,1300,-
chr5,177457696,2.3568524878273522,1435,1104,2539,-
chr5,177457697,2.391649048625793,904,773,1677,-
chr5,177457746,1.469783981265217,709,535,1244,-
chr5,177466961,2.660520552131615,1273,676,1949,-
chr5,177466964,1.9208272078564974,3428,2418,5846,-
chr5,177466967,1.9927331778678743,1916,1237,3153,-
chr5,177466970,1.7226644226239471,1991,1503,3494,-
chr5,177466991,7.1454545454545455,785,329,1114,-
chr5,177467028,2.908929844979466,923,596,1519,-
chr5,177516187,2.400625978090767,727,638,1365,-
chr5,178149591,0.44866828087167065,653,589,1242,-
chr5,178149605,3.8490284005979074,823,445,1268,-
chr5,178149797,1.7194558521560577,608,486,1094,-
chr5,178150945,1.5793716986377533,740,653,1393,-
chr5,178150951,2.3576254826254828,976,665,1641,-
chr5,178150952,2.2418901660280968,1440,956,2396,-
chr5,178150954,2.3126430205949657,1385,873,2258,-
chr5,178150956,2.11174487943998,904,550,1454,-
chr5,178153806,1.818519715578539,725,441,1166,-
chr5,178153809,2.1950953678474114,635,366,1001,-
chr5,178153816,3.193311036789298,615,459,1074,-
chr5,178153818,3.193311036789298,615,459,1074,-
chr5,179082734,1.9483758005987015,1698,1411,3109,-
chr5,179082735,2.008080155138978,653,475,1128,-
chr5,179082745,0.7063342645026923,759,505,1264,-
chr5,179614615,3.906200317965024,881,517,1398,-
chr5,179614728,1.7609265734265733,710,623,1333,-
chr5,179614760,1.6328066215199395,619,442,1061,-
chr5,179614765,1.4729345531315972,968,724,1692,-
chr5,179614769,1.0324919481158,799,592,1391,-
chr5,179614846,6.229814554017318,6362,5165,11527,-
chr5,179614847,6.189854155921085,7325,5785,13110,-
chr5,179614848,4.53701774016873,4770,3642,8412,-
chr5,179615577,1.8356176817645455,748,478,1226,-
chr5,179616140,0.5869158878504673,627,534,1161,-
chr5,179616145,1.7907226977586987,1111,959,2070,-
chr5,179616184,0.430976430976431,639,404,1043,-
chr5,179616891,0.5831111111111111,573,524,1097,-
chr5,179616932,1.520757020757021,635,503,1138,-
chr5,179617081,4.162152837674659,831,526,1357,-
chr5,179617084,1.9915960908122736,1575,1067,2642,-
chr5,179617085,1.9087153255951206,791,597,1388,-
chr5,179617088,1.7379134860050889,682,392,1074,-
chr5,179618042,0.7825743777805274,26236,17789,44025,-
chr5,179618043,1.4292577441300536,12678,11109,23787,-
chr5,179618044,1.0786823036831923,48184,35905,84089,-
chr5,179618046,1.571077447801552,29968,23254,53222,-
chr5,179618047,1.5579710995695282,51082,38167,89249,-
chr5,179618048,1.7573043831832658,64678,47268,111946,-
chr5,179618049,1.8816095223034541,79337,54265,133602,-
chr5,179618050,2.2508314894801695,62931,42089,105020,-
chr5,179618051,4.068937921019725,14433,9534,23967,-
chr5,179618056,1.3275624028101582,6186,3414,9600,-
chr5,179618184,1.9795727174599296,2626,1258,3884,-
chr5,179618230,1.7050415800415801,3239,1479,4718,-
chr5,179619281,0.9958810068649886,2175,1632,3807,-
chr5,179619282,0.9958810068649886,2175,1632,3807,-
chr5,179619316,0.5919028340080972,601,493,1094,-
chr5,179619340,3.8167525060004124,2869,2265,5134,-
chr5,179619343,9.760677466863033,963,775,1738,-
chr5,179619344,9.114596850304098,2545,1912,4457,-
chr5,179619400,2.477086230289533,1184,959,2143,-
chr5,179619401,1.9580026455026456,763,575,1338,-
chr5,179620982,2.6413798517824625,2015,1353,3368,-
chr5,179621302,2.27307206068268,898,790,1688,-
chr5,179621354,1.755398361876396,819,631,1450,-
chr5,179623092,0.4491421568627451,732,543,1275,-
chr5,179623162,2.747183090524661,1069,668,1737,-
chr5,179801897,2.250148148148148,820,449,1269,-
chr5,179801899,2.250148148148148,820,449,1269,-
chr5,180013190,2.080851664153369,1325,841,2166,-
chr5,180239973,2.624633230979188,1201,976,2177,-
chr5,180239974,2.624633230979188,1201,976,2177,-
chr5,180239977,0.4237867395762133,619,461,1080,-
chr5,181237019,1.7210139581550448,7439,4840,12279,-
chr5,181237037,1.4701455114799689,6581,3970,10551,-
chr5,181237042,1.0823016670802639,1138,848,1986,-
chr5,181237043,0.8818215617638919,1060,784,1844,-
chr5,181238119,1.9016922092844208,22372,18656,41028,-
chr5,181238121,1.609868541504724,44266,33447,77713,-
chr5,181238212,0.9888759309591412,17089,12898,29987,-
chr5,181238239,1.279034887481182,1394,1181,2575,-
chr5,181239117,0.8659757795221961,19505,14430,33935,-
chr5,181239118,1.2891518833425242,9015,6777,15792,-
chr5,181239139,1.1895135057490949,22996,17540,40536,-
chr5,181239161,1.261802366228011,6310,4888,11198,-
chr5,181239580,2.334283852558806,14168,11244,25412,-
chr5,181239583,0.9427341032693045,610,517,1127,-
chr5,181241505,1.4985091776328037,8162,5931,14093,-
chr5,181241547,0.7539241316839854,30951,22942,53893,-
chr5,181241603,1.2010365509941725,7403,4637,12040,-
chr5,181241607,1.3697468569014581,12446,8386,20832,-
chr5,181241621,1.318061559487379,15712,11051,26763,-
chr5,181242342,1.2260862864817672,15155,11126,26281,-
chr5,181242346,0.970258910974215,722,566,1288,-
chr5,181243712,1.1946594735579923,9388,6078,15466,-
chr5,181243723,1.2479418640522222,22320,17209,39529,-
chr5,181243733,1.3820067151073767,32446,23310,55756,-
chr5,181243734,1.4000228872430796,26941,18371,45312,-
chr5,181243741,1.2768209686256817,12404,8166,20570,-
chr5,181243747,1.5426179681882393,14577,7629,22206,-
chr5,181243748,1.5426179681882393,14577,7629,22206,-
chr5,181243789,1.284525419856929,6878,5211,12089,-
chr5,181243796,1.0548648851763813,12563,9152,21715,-
chr5,181243853,1.2010529387530895,8116,6619,14735,-
chr5,181243855,1.2518740212209452,13553,9619,23172,-
chr5,181243861,1.3323003395540107,10169,7725,17894,-
chr5,181243862,1.3652670508648321,6832,5016,11848,-
chr5,181243875,1.457753767575722,8700,5700,14400,-
chr5,181243880,1.8859231110112846,3304,1630,4934,-
chr5,181243891,1.6720804331013148,1586,1292,2878,-
chr5,181243894,1.496502978387008,8690,4747,13437,-
chr5,181243896,1.5045500204366857,12634,6899,19533,-
chr5,181243897,1.3731419248682264,7109,3117,10226,-
chr5,181243899,1.4236235253595109,4566,1974,6540,-
chr5,181243902,0.8755233974644516,3033,1197,4230,-
chr5,181243903,0.7504347085540205,5910,3055,8965,-
chr5,181243905,0.6747149613083193,3696,1939,5635,-
chr5,181243913,0.5358658314811072,701,440,1141,-
chr5,181243915,1.0307149459352396,968,636,1604,-
chr5,181243916,1.111551460442487,785,592,1377,-
chr6,497468,2.604506247164912,710,493,1203,-
chr6,599219,2.254571570631457,2331,1573,3904,-
chr6,599220,2.0218987499023506,3432,2284,5716,-
chr6,599223,1.8532876418933395,1017,643,1660,-
chr6,610107,2.4393203883495143,1004,617,1621,-
chr6,610108,2.4017493410016773,1054,641,1695,-
chr6,610117,1.7977824365695445,2462,1497,3959,-
chr6,610119,1.986457692125574,1471,861,2332,-
chr6,610127,1.6336690411856218,687,413,1100,-
chr6,610134,1.9869614944719791,1132,609,1741,-
chr6,610135,1.6271278773032873,1409,777,2186,-
chr6,610140,2.5445623764076393,1049,581,1630,-
chr6,610141,2.403755868544601,799,425,1224,-
chr6,1742519,1.5798576859407902,769,565,1334,-
chr6,2115867,0.534555526246373,578,445,1023,-
chr6,2115872,2.6041666666666665,594,475,1069,-
chr6,2115879,1.3921578897565174,884,689,1573,-
chr6,2117493,0.984060984060984,638,480,1118,-
chr6,2117494,1.6851391667052475,1076,781,1857,-
chr6,2832461,12.857766971128735,723,437,1160,-
chr6,2833230,2.6302864938608455,963,732,1695,-
chr6,2833232,2.6302864938608455,963,732,1695,-
chr6,2833357,1.8966557017543861,628,383,1011,-
chr6,2833695,1.5423947262777582,1459,892,2351,-
chr6,2833723,1.7183257918552035,1126,597,1723,-
chr6,2833797,1.5850033192353692,2602,1821,4423,-
chr6,2833859,1.4283915724563203,1565,972,2537,-
chr6,2835884,1.9784877529286473,1326,938,2264,-
chr6,2836191,1.4479746399678697,1462,1201,2663,-
chr6,2836215,1.894965013690295,1358,1037,2395,-
chr6,2836248,0.7697806125254302,1924,1398,3322,-
chr6,2836249,1.590509644452398,2120,1549,3669,-
chr6,2838622,1.2825623988414685,1881,2063,3944,-
chr6,2838627,2.029837806596106,3511,3533,7044,-
chr6,2838629,2.029837806596106,3511,3533,7044,-
chr6,2838636,0.6773122813313,1358,1412,2770,-
chr6,2838673,1.4684540963359407,1316,1040,2356,-
chr6,2840500,1.3214874141876432,1461,949,2410,-
chr6,2840548,1.7744282744282744,568,480,1048,-
chr6,2840565,0.7548173322921119,1439,1269,2708,-
chr6,2840566,0.9048656499636893,889,764,1653,-
chr6,2948355,1.892924035950195,1450,972,2422,-
chr6,2948413,1.8112814895947424,718,414,1132,-
chr6,2948506,0.6499965699389448,1136,773,1909,-
chr6,2948508,0.4359355884006215,823,592,1415,-
chr6,2948533,2.311743555983188,829,636,1465,-
chr6,2948600,1.7501976284584981,655,459,1114,-
chr6,2948604,1.1698192341298155,1538,1025,2563,-
chr6,2948666,1.521774193548387,917,619,1536,-
chr6,2948694,2.2010408313348053,1405,1170,2575,-
chr6,2953077,2.472334682860999,915,740,1655,-
chr6,2953113,1.0473488605735155,2061,1536,3597,-
chr6,2953125,1.9533527696793005,736,538,1274,-
chr6,2953182,1.0885404513981138,1862,1265,3127,-
chr6,2953185,0.5256552233296419,800,566,1366,-
chr6,2954630,1.8992248062015504,699,644,1343,-
chr6,2954689,0.6695108077360636,1176,878,2054,-
chr6,2954707,1.614802354920101,1039,753,1792,-
chr6,2955561,0.6491458607095928,1006,760,1766,-
chr6,2955575,1.7385098487011135,869,677,1546,-
chr6,2955579,1.66104192763982,866,661,1527,-
chr6,2955603,2.718828451882845,721,477,1198,-
chr6,2955629,1.7435613167320485,704,450,1154,-
chr6,2955664,2.113636363636364,681,483,1164,-
chr6,2959265,1.8574251835121398,730,643,1373,-
chr6,2959315,1.7441855308959493,1107,850,1957,-
chr6,2959317,1.7441855308959493,1107,850,1957,-
chr6,2959330,2.5379851604956567,755,572,1327,-
chr6,3738090,1.4693023255813955,1637,1504,3141,-
chr6,3738093,1.8826039460483044,3497,2569,6066,-
chr6,3738103,1.5859307359307357,1292,989,2281,-
chr6,3738105,0.48882999744287137,1501,1102,2603,-
chr6,3738114,0.6459251101321586,1172,907,2079,-
chr6,3738117,2.1265889246119314,1390,820,2210,-
chr6,3738128,1.6014962593516209,675,400,1075,-
chr6,4117356,0.41193021330599955,681,580,1261,-
chr6,4119217,2.848807093083867,665,566,1231,-
chr6,4126235,2.45805414098097,1018,573,1591,-
chr6,4126236,2.45805414098097,1018,573,1591,-
chr6,4133664,1.9354077862399035,569,506,1075,-
chr6,5109346,4.403361396071729,796,634,1430,-
chr6,5109371,2.530472157309531,674,409,1083,-
chr6,5216694,2.3181624361039894,988,657,1645,-
chr6,5260735,1.2202005609075959,642,445,1087,-
chr6,7287675,2.7618025751072963,692,465,1157,-
chr6,7287840,1.7034453781512604,698,475,1173,-
chr6,7287912,2.517184342513295,878,575,1453,-
chr6,7288048,2.2352352352352347,637,443,1080,-
chr6,7288181,1.8794213916165134,711,450,1161,-
chr6,7288540,2.2678164023791356,1300,937,2237,-
chr6,7288768,2.661290322580645,791,464,1255,-
chr6,7289014,1.6729351032448376,697,451,1148,-
chr6,7289201,2.279377958079784,601,492,1093,-
chr6,7289288,1.8678247911120385,1433,990,2423,-
chr6,7289644,0.5202839756592292,1025,782,1807,-
chr6,7289929,1.686103175936818,691,540,1231,-
chr6,7295459,1.5493395493395494,996,701,1697,-
chr6,7298809,0.6739651756855385,1211,833,2044,-
chr6,7298818,1.864754098360656,979,731,1710,-
chr6,7309991,1.9266170573081796,1561,1058,2619,-
chr6,7309992,0.5884857775506728,690,617,1307,-
chr6,7310010,0.463927192498621,646,489,1135,-
chr6,7313061,1.645856246360872,847,532,1379,-
chr6,7339238,2.359194395796848,708,570,1278,-
chr6,7339241,1.53840280958925,2417,1769,4186,-
chr6,7339242,1.53840280958925,2417,1769,4186,-
chr6,7339245,1.5340909090909092,769,923,1692,-
chr6,7339246,0.3728566018846339,1743,1164,2907,-
chr6,7339247,1.5010002233277735,1018,1188,2206,-
chr6,7339249,1.7160395408163265,751,783,1534,-
chr6,7339250,1.6537109428622925,727,614,1341,-
chr6,7339416,1.1334468995171683,14120,11462,25582,-
chr6,7339418,1.210734191312653,18857,13941,32798,-
chr6,7339419,1.250482134679701,13318,9376,22694,-
chr6,7339422,1.170872093023256,5732,4299,10031,-
chr6,7339423,1.170872093023256,5732,4299,10031,-
chr6,7339425,0.9241742416838467,7642,5317,12959,-
chr6,7339426,1.1137064374474446,3999,2779,6778,-
chr6,7339427,0.931961594033476,13464,9453,22917,-
chr6,7339428,1.1137064374474446,3999,2779,6778,-
chr6,7339433,0.4272445820433437,643,475,1118,-
chr6,7339434,0.4272445820433437,643,475,1118,-
chr6,7881613,2.7600563909774443,752,559,1311,-
chr6,7881614,2.306133931704177,1319,893,2212,-
chr6,7881738,1.8898179383144573,2497,2091,4588,-
chr6,7881833,1.7399258343634116,1172,808,1980,-
chr6,7881885,1.5254671842556649,1431,1006,2437,-
chr6,7881908,2.027568922305764,808,664,1472,-
chr6,7882340,1.5535732051069475,975,814,1789,-
chr6,7882341,0.5319238473628923,2317,1732,4049,-
chr6,7882696,1.076463842153554,2508,1827,4335,-
chr6,7882780,1.6067835192351467,1216,954,2170,-
chr6,7882826,1.4034847029770887,1704,1181,2885,-
chr6,7883030,1.1289402773381698,2344,1640,3984,-
chr6,7883049,2.720987228691072,1727,1146,2873,-
chr6,7883144,2.442477876106195,781,677,1458,-
chr6,7883150,2.3938657407407407,1117,719,1836,-
chr6,7883217,1.9617211964150743,844,685,1529,-
chr6,7884371,0.6283945939118353,994,753,1747,-
chr6,7884410,1.3983739837398377,1375,983,2358,-
chr6,7884479,0.4814117647058823,1301,874,2175,-
chr6,7885973,1.479452054794521,1707,1280,2987,-
chr6,7886015,1.6685509704164312,804,548,1352,-
chr6,7886028,0.6415830226555779,798,633,1431,-
chr6,7888722,2.5708126036484247,673,401,1074,-
chr6,7888725,2.498101115594588,678,382,1060,-
chr6,7888741,4.1685499058380415,698,353,1051,-
chr6,7888822,2.4910287738418355,1430,1134,2564,-
chr6,7888840,1.2690499155480108,1200,967,2167,-
chr6,7889564,0.6912641673931996,1165,924,2089,-
chr6,7889574,1.4991083812165644,1163,720,1883,-
chr6,7889578,1.6338539547403674,869,742,1611,-
chr6,7891650,1.6640931372549022,1100,679,1779,-
chr6,7891696,1.990748299319728,707,524,1231,-
chr6,7891721,0.6669571374108165,941,601,1542,-
chr6,7895128,2.0032894736842106,608,495,1103,-
chr6,7895136,1.8742857142857143,871,544,1415,-
chr6,7895158,1.8725935828877005,608,439,1047,-
chr6,7904583,3.6515542461766572,882,670,1552,-
chr6,7904642,0.4937044400265076,595,502,1097,-
chr6,8015731,3.1877230549607427,608,466,1074,-
chr6,8079677,1.8297794117647062,552,479,1031,-
chr6,8079847,1.6792715177622073,1338,852,2190,-
chr6,8079994,1.6039926962872793,1266,774,2040,-
chr6,8080013,1.62613858165257,644,423,1067,-
chr6,8097290,0.7200108053469039,1558,1170,2728,-
chr6,8097353,2.2125125125125127,712,554,1266,-
chr6,8097355,1.7751358695652173,1138,735,1873,-
chr6,8097383,1.6997179125528914,926,708,1634,-
chr6,8102522,2.5349119611414697,667,487,1154,-
chr6,8102523,2.2780021626785367,984,670,1654,-
chr6,10397643,0.5073131760078663,634,451,1085,-
chr6,10398145,0.4405945992920047,1345,989,2334,-
chr6,10398146,0.4892764604698761,976,728,1704,-
chr6,10400488,1.549981824790985,819,916,1735,-
chr6,10400515,2.5110294117647056,682,577,1259,-
chr6,10400546,3.1385350318471334,656,470,1126,-
chr6,10400584,3.0453920220082527,1025,726,1751,-
chr6,10400586,2.3924731182795695,1512,1053,2565,-
chr6,10400587,1.9525222551928787,986,673,1659,-
chr6,10402546,0.3682076236820762,680,410,1090,-
chr6,10404541,1.1789730277518784,760,466,1226,-
chr6,10404554,2.0230343980343983,940,615,1555,-
chr6,10404556,2.3978339111835645,1464,922,2386,-
chr6,10404594,1.1275428138896773,700,541,1241,-
chr6,10404595,1.1275428138896773,700,541,1241,-
chr6,10406339,3.538593358311668,622,443,1065,-
chr6,10406842,2.3811615223971354,562,469,1031,-
chr6,10412084,1.1693501242309718,582,448,1030,-
chr6,13793931,1.9412964836182212,1689,1240,2929,-
chr6,13798874,0.5587044534412956,735,519,1254,-
chr6,13798901,2.651705019377349,1170,747,1917,-
chr6,13800377,1.9847100409883023,885,620,1505,-
chr6,13806996,1.4802520439366187,629,545,1174,-
chr6,17629453,2.946102819237148,560,602,1162,-
chr6,17629455,2.946102819237148,560,602,1162,-
chr6,17629458,1.5413305198137404,588,507,1095,-
chr6,18224348,4.031285944329423,673,482,1155,-
chr6,18224384,1.9747550240823784,1159,668,1827,-
chr6,18224454,1.956521739130435,1079,643,1722,-
chr6,18224536,1.9114877589453865,734,530,1264,-
chr6,18224555,0.49585899341686124,933,553,1486,-
chr6,18224770,1.5839464882943142,1479,896,2375,-
chr6,18224773,1.3528606102635228,2108,1441,3549,-
chr6,18225077,1.573885350318471,1058,784,1842,-
chr6,18225212,0.6713634880545251,1461,996,2457,-
chr6,18225286,1.727816856563801,2197,1581,3778,-
chr6,18225671,1.6485842283613807,972,756,1728,-
chr6,18236507,1.7628856051446118,2033,1182,3215,-
chr6,18236510,2.24955561198578,1864,1073,2937,-
chr6,18237431,2.0825973835611418,1183,940,2123,-
chr6,18249702,2.0123901339984847,6579,7310,13889,-
chr6,18249721,1.3392178785379687,5356,4882,10238,-
chr6,18249740,1.2148203436903318,3953,3291,7244,-
chr6,18249743,1.6813849978709328,7370,6099,13469,-
chr6,18249751,1.4193988290732544,2996,2234,5230,-
chr6,18249752,1.4539260421613365,3083,2441,5524,-
chr6,18249761,1.450074579160452,2567,1975,4542,-
chr6,18249799,1.8163489018517796,3092,2295,5387,-
chr6,18255764,1.3532736527997191,1675,1054,2729,-
chr6,18255846,1.7298343504986982,1988,1509,3497,-
chr6,18257991,2.1525519421860886,1732,1079,2811,-
chr6,18258007,1.604409691065248,1787,1075,2862,-
chr6,18258368,0.5723692683728616,1834,1191,3025,-
chr6,18258371,1.382824771423434,2032,1345,3377,-
chr6,18258372,1.7798195108007675,1405,906,2311,-
chr6,18258374,2.2134387351778653,759,505,1264,-
chr6,18258375,2.8119620795299296,1618,1140,2758,-
chr6,18258398,1.4909857663426802,1706,1003,2709,-
chr6,18258399,1.4786224416942153,1860,1074,2934,-
chr6,18258400,1.2973239610309533,1314,764,2078,-
chr6,18263994,3.0225590669737343,704,348,1052,-
chr6,18264394,0.32881761437162654,1039,585,1624,-
chr6,18264395,0.3562388931978457,1048,583,1631,-
chr6,18264432,3.4566765578635015,705,336,1041,-
chr6,18264484,2.5636902649919766,803,465,1268,-
chr6,24718642,1.1886438399009454,572,455,1027,-
chr6,25023929,1.3675033025099077,1940,1513,3453,-
chr6,25023931,1.3954025098713345,9042,6492,15534,-
chr6,25023932,1.438394435202097,10688,7433,18121,-
chr6,25023934,1.4208310471014938,10018,6807,16825,-
chr6,25023935,1.2624330609875407,10722,7389,18111,-
chr6,25023936,0.6617381539012619,3933,3153,7086,-
chr6,25023937,1.5764770324045692,4672,2637,7309,-
chr6,25023938,1.2336100864948931,5443,3672,9115,-
chr6,25023943,1.5347303354865567,4521,2684,7205,-
chr6,25023944,1.5347303354865567,4521,2684,7205,-
chr6,25023947,1.6776957036923783,2600,1647,4247,-
chr6,25023948,1.6755995080650592,3583,2101,5684,-
chr6,25023949,1.6776957036923783,2600,1647,4247,-
chr6,25023963,2.0721804511278195,688,384,1072,-
chr6,25023964,2.1414961600158984,1313,746,2059,-
chr6,26056103,2.487069496774046,779,608,1387,-
chr6,26056260,2.757034260348089,556,463,1019,-
chr6,27138627,2.1344319829098954,1075,770,1845,-
chr6,27138628,2.1344319829098954,1075,770,1845,-
chr6,27146440,3.127363844689357,931,628,1559,-
chr6,27146441,3.986618344020072,649,421,1070,-
chr6,27146442,2.873151596858714,762,506,1268,-
chr6,27146752,2.125890642359448,966,518,1484,-
chr6,27146831,1.5823412698412698,824,419,1243,-
chr6,27146851,1.3055396916047972,761,308,1069,-
chr6,27146854,0.8740861658251258,1067,413,1480,-
chr6,27780924,1.0347216517429283,1302,986,2288,-
chr6,27780925,1.8684210526315788,638,417,1055,-
chr6,27780926,1.2573457461266648,1868,1414,3282,-
chr6,27780928,1.5816632166429134,2026,1450,3476,-
chr6,28904266,0.4892559542455192,756,516,1272,-
chr6,28904398,3.2406394780736645,662,454,1116,-
chr6,28904476,2.4937085021340675,1685,1339,3024,-
chr6,28904477,3.6660471464809428,2377,2003,4380,-
chr6,28904478,3.6921189729771116,2088,1736,3824,-
chr6,28904499,0.4431907407920201,631,441,1072,-
chr6,28920123,2.117281650944259,624,435,1059,-
chr6,28921982,1.559253340816232,1039,841,1880,-
chr6,28921984,0.4890555453935736,616,496,1112,-
chr6,28923234,2.335836728561192,955,636,1591,-
chr6,28923235,2.3115942028985508,637,459,1096,-
chr6,29636213,2.5136380255941497,673,546,1219,-
chr6,29636217,0.6381818181818183,755,559,1314,-
chr6,29636232,2.004951147219011,1683,1221,2904,-
chr6,29636234,1.7741935483870963,1055,743,1798,-
chr6,30712715,1.5671743530433162,633,443,1076,-
chr6,30727887,1.6813252067188138,3762,3071,6833,-
chr6,30727889,1.706180990324417,2341,1756,4097,-
chr6,30727925,1.6102003642987253,747,670,1417,-
chr6,30727963,1.695936139332366,778,688,1466,-
chr6,30727992,0.5813127090301003,617,597,1214,-
chr6,30728078,2.0601306489612337,854,643,1497,-
chr6,30728126,1.961721321467756,893,630,1523,-
chr6,30728137,1.8137236752294512,1803,1115,2918,-
chr6,30728142,1.6070175438596492,915,531,1446,-
chr6,30730041,0.6697173620457604,1243,742,1985,-
chr6,30730046,1.8425891984359724,1230,743,1973,-
chr6,30730079,1.205105583290221,2096,1433,3529,-
chr6,30730088,1.6533599467731204,567,500,1067,-
chr6,30730175,1.5976206817661858,811,704,1515,-
chr6,30730442,0.7320142298532913,1265,902,2167,-
chr6,30730469,0.5150165350610785,586,448,1034,-
chr6,30730470,1.109659104418955,1924,1241,3165,-
chr6,30730720,0.8986086237773797,1185,853,2038,-
chr6,30730721,0.8986086237773797,1185,853,2038,-
chr6,30730946,2.006415846518002,1192,697,1889,-
chr6,30730948,2.177038285487541,2086,1291,3377,-
chr6,30730949,2.0045844248630624,1160,645,1805,-
chr6,30730960,2.228809523809524,850,699,1549,-
chr6,30730961,2.228809523809524,850,699,1549,-
chr6,30731080,1.947945205479452,710,437,1147,-
chr6,30740184,1.8638814042372847,6010,5042,11052,-
chr6,30740185,1.9308508932865465,8812,7243,16055,-
chr6,30740187,1.8800936366327305,8250,6152,14402,-
chr6,30740198,1.7340392303848078,2162,1333,3495,-
chr6,30740209,1.9741058253109411,2080,1497,3577,-
chr6,30740238,1.3399320718098011,1725,1144,2869,-
chr6,30740293,1.8453701797329551,2749,1618,4367,-
chr6,30740547,0.7111653604008736,1619,1085,2704,-
chr6,30740589,1.7002198035009666,1365,920,2285,-
chr6,30740710,1.7034230467729292,1229,889,2118,-
chr6,30740775,0.5479462144710243,1632,1120,2752,-
chr6,30740778,2.089273750502479,1326,877,2203,-
chr6,30740790,0.6991253935728923,1248,934,2182,-
chr6,30740793,1.7978258300838943,894,650,1544,-
chr6,30740796,0.705945925801703,996,800,1796,-
chr6,30741259,1.6381438910174542,831,647,1478,-
chr6,30741283,2.1533333333333333,951,699,1650,-
chr6,30741632,1.5705278822055138,1233,797,2030,-
chr6,30741659,1.6451612903225807,779,619,1398,-
chr6,30741660,2.722619954303122,661,504,1165,-
chr6,30741807,0.6332073970968384,837,534,1371,-
chr6,30741821,2.2484276273593706,996,776,1772,-
chr6,30741824,1.8110795454545452,662,415,1077,-
chr6,30742167,1.029772005772006,1537,1154,2691,-
chr6,30742169,1.029772005772006,1537,1154,2691,-
chr6,30742185,1.4826582278481013,662,473,1135,-
chr6,30742623,0.4778859872216364,641,657,1298,-
chr6,30742636,13.04554260665497,658,505,1163,-
chr6,30742651,5.665547747879289,772,449,1221,-
chr6,30743249,0.6626296743063933,885,828,1713,-
chr6,30743267,35.627321593479614,6511,4444,10955,-
chr6,30743269,37.89294868204112,11790,7169,18959,-
chr6,30743270,48.15998490135514,8555,4890,13445,-
chr6,30743279,8.079069616366775,4564,1912,6476,-
chr6,30743319,0.32674039211156986,942,586,1528,-
chr6,30743322,0.5363237445148709,879,585,1464,-
chr6,30743425,0.4700724173604611,733,765,1498,-
chr6,30743426,1.4889480147359804,969,697,1666,-
chr6,30743430,10.892797538316717,5894,4987,10881,-
chr6,30743431,11.076038612685032,4978,4363,9341,-
chr6,30743447,2.1932202375609613,1077,856,1933,-
chr6,30743448,2.0601066293744874,3521,2527,6048,-
chr6,30743449,1.662706394565822,2316,1553,3869,-
chr6,30743462,3.932810740518403,2251,1300,3551,-
chr6,30743465,2.177085302039174,1238,828,2066,-
chr6,30743468,13.987328639163554,1854,1048,2902,-
chr6,30743491,0.5402433660753555,736,358,1094,-
chr6,30743492,1.7594563106796113,838,514,1352,-
chr6,30743571,1.030707670226705,1975,1367,3342,-
chr6,30743723,2.5176151761517613,928,614,1542,-
chr6,30743754,0.3748651564185545,694,411,1105,-
chr6,30743826,2.737710524066,1032,556,1588,-
chr6,30743899,0.44853017019082,668,553,1221,-
chr6,30743901,1.4297273526824978,1015,757,1772,-
chr6,30743902,0.3286233511659247,618,520,1138,-
chr6,30743910,0.6302438285627745,860,638,1498,-
chr6,30744004,1.543997513598579,1463,1119,2582,-
chr6,30744010,1.8920158617424243,1345,1023,2368,-
chr6,30744011,1.6002731174404994,630,465,1095,-
chr6,30744012,1.8920158617424243,1345,1023,2368,-
chr6,30744032,1.750904392764858,615,386,1001,-
chr6,30744102,0.3747961956521739,612,459,1071,-
chr6,30744116,1.5394990366088632,628,518,1146,-
chr6,30744318,2.3300110741971207,788,601,1389,-
chr6,30744320,2.0772557891935057,1177,883,2060,-
chr6,30744321,1.9211538461538464,782,579,1361,-
chr6,30744546,0.9914893003314265,2477,1381,3858,-
chr6,31269072,1.3240361451906364,2003,1501,3504,-
chr6,31269139,0.6468102820954916,2630,1980,4610,-
chr6,31269143,1.4277539341917023,1995,1397,3392,-
chr6,31269145,1.0203607061573807,3180,2685,5865,-
chr6,31269149,0.7070770519262982,1227,1193,2420,-
chr6,31269164,1.766782006920415,1331,1019,2350,-
chr6,31269168,0.7013621389541677,2557,2163,4720,-
chr6,31269361,1.4148103414878708,2991,2235,5226,-
chr6,31269362,1.5218810345783433,5297,4160,9457,-
chr6,31269363,1.6541314345052662,2306,1925,4231,-
chr6,31269376,1.4308849045691152,1236,740,1976,-
chr6,31269383,1.643438538483132,1844,1167,3011,-
chr6,31269521,1.315202702702703,1144,924,2068,-
chr6,31269522,1.7659060402684563,857,744,1601,-
chr6,31269980,1.9064065855404442,1205,1015,2220,-
chr6,31270045,0.7266483516483517,1586,1091,2677,-
chr6,31270047,1.6595623740433032,4188,2505,6693,-
chr6,31270048,1.688054662379421,2257,1554,3811,-
chr6,31270049,1.637585174813153,6413,4025,10438,-
chr6,31270060,1.232923374617368,5551,3521,9072,-
chr6,31270063,1.661311769435339,3091,1701,4792,-
chr6,31270064,1.6446360418627486,4731,2752,7483,-
chr6,31270067,1.434989378926895,2761,1725,4486,-
chr6,31270076,1.5070784395973154,1286,893,2179,-
chr6,31270231,0.5406212547975576,907,590,1497,-
chr6,31270274,1.4744560994560996,645,467,1112,-
chr6,31270336,0.6061788617886179,931,614,1545,-
chr6,31270338,1.942686056458512,756,500,1256,-
chr6,31270342,1.8711437170805119,685,442,1127,-
chr6,31270345,1.9170731707317077,1178,779,1957,-
chr6,31270346,1.585856619494477,1265,883,2148,-
chr6,31270347,1.9170731707317077,1178,779,1957,-
chr6,31270350,1.9776016199930853,1096,793,1889,-
chr6,31270352,1.9297976041600255,2512,1679,4191,-
chr6,31270354,1.7979315831344471,1355,837,2192,-
chr6,31270355,1.6940021983889544,2490,1492,3982,-
chr6,31270356,1.440025978456477,1951,1177,3128,-
chr6,31270367,1.7090541225931424,805,413,1218,-
chr6,31270477,0.587107063536478,4554,3504,8058,-
chr6,31270478,0.4519186407594712,2790,2209,4999,-
chr6,31270479,0.7537839650515707,2598,1987,4585,-
chr6,31270480,0.6133379405666897,1774,1446,3220,-
chr6,31270484,1.7348940135103657,1048,529,1577,-
chr6,31271139,1.2044441761123903,4858,3782,8640,-
chr6,31271142,1.588136001929105,889,714,1603,-
chr6,31271143,1.2219023810712333,3773,2634,6407,-
chr6,31271144,1.4060657523120377,3987,2484,6471,-
chr6,31271146,1.2108513938153256,7396,5049,12445,-
chr6,31271147,1.183780226378471,3505,2505,6010,-
chr6,31271148,1.3058201182032163,5111,3365,8476,-
chr6,31271149,0.6330947511929107,742,651,1393,-
chr6,31271150,1.0338930348258708,1006,803,1809,-
chr6,31271151,0.8637486716908307,1726,1219,2945,-
chr6,31271280,1.8146120503683083,4532,3451,7983,-
chr6,31271281,1.707159467083694,3483,2760,6243,-
chr6,31271325,1.846308499944153,1652,1278,2930,-
chr6,31271327,1.7820033433881766,3293,2300,5593,-
chr6,31271329,1.9717297930495896,1577,1181,2758,-
chr6,31271335,2.5659722222222223,738,415,1153,-
chr6,31271344,2.1189956331877733,646,457,1103,-
chr6,31271672,1.0183233593520764,2568,2157,4725,-
chr6,31271675,1.2034091091472885,3434,3387,6821,-
chr6,31271677,1.4938373048479867,2423,2433,4856,-
chr6,31271681,2.224235283003563,4917,4383,9300,-
chr6,31271682,2.3577914259176023,4823,4454,9277,-
chr6,31271696,1.6362658663247083,3686,2834,6520,-
chr6,31271739,1.1309140331243395,4527,3395,7922,-
chr6,31271745,0.6948986100003037,3743,2876,6619,-
chr6,31271746,0.682130190739345,5418,3835,9253,-
chr6,31271762,1.9889315361956617,1713,1317,3030,-
chr6,31271774,0.7043430186129369,2456,2006,4462,-
chr6,31271775,0.7043430186129369,2456,2006,4462,-
chr6,31271778,1.7126880575156438,1205,608,1813,-
chr6,31271779,1.6756414317389927,1034,860,1894,-
chr6,31271789,1.7569247209021122,1156,826,1982,-
chr6,31271804,1.7264957264957261,807,629,1436,-
chr6,31271843,1.5057734811769876,1816,1128,2944,-
chr6,31271846,1.873825950361859,1467,1149,2616,-
chr6,31271849,1.5665725818689489,726,522,1248,-
chr6,31272041,2.6153846153846154,594,454,1048,-
chr6,31272045,1.8820621468926555,1639,959,2598,-
chr6,31272046,1.8820621468926555,1639,959,2598,-
chr6,31272079,1.9207920792079207,969,504,1473,-
chr6,31272081,1.9207920792079207,969,504,1473,-
chr6,31354035,1.5012768271927583,4629,3362,7991,-
chr6,31354036,1.1901717995863021,4539,3647,8186,-
chr6,31354041,1.2588996014943252,7563,5366,12929,-
chr6,31354043,1.2582474401377803,14829,11418,26247,-
chr6,31354102,0.7939680085574188,2968,1968,4936,-
chr6,31354108,1.534957314133765,3013,2403,5416,-
chr6,31354212,1.1489861281299003,7617,5713,13330,-
chr6,31354279,1.7955000000000003,1367,1199,2566,-
chr6,31354287,1.3829759807502258,1671,1368,3039,-
chr6,31354289,0.5816192772644151,1197,1012,2209,-
chr6,31354517,1.4129298894336793,4330,3268,7598,-
chr6,31354647,1.5406352128790757,3044,2517,5561,-
chr6,31354657,1.7120522468356496,3106,2305,5411,-
chr6,31354658,1.2663592036581124,5192,4119,9311,-
chr6,31354660,0.6889205743741315,3361,2788,6149,-
chr6,31355161,1.582093395999444,7109,6862,13971,-
chr6,31355162,1.5281363988062342,10433,9959,20392,-
chr6,31355164,1.3329940595158085,18875,16536,35411,-
chr6,31355165,1.3835475515981492,18303,15764,34067,-
chr6,31355166,1.6386067829753086,15259,13610,28869,-
chr6,31355167,1.6983965078577403,14740,12395,27135,-
chr6,31355168,1.8445105704501417,13828,11603,25431,-
chr6,31355170,1.9027778727860367,13041,9680,22721,-
chr6,31355171,1.8074041064052626,10251,7348,17599,-
chr6,31355187,0.7241273929466471,3932,2969,6901,-
chr6,31355205,1.5697463418400834,1401,877,2278,-
chr6,31355210,0.6816122966233341,1225,754,1979,-
chr6,31355214,1.020538779339231,2448,1856,4304,-
chr6,31355217,1.9062029331679493,2194,1450,3644,-
chr6,31355222,1.6307552406119081,1875,1324,3199,-
chr6,31355372,1.3678823053823053,2706,1923,4629,-
chr6,31355375,0.5779446064139943,1933,1399,3332,-
chr6,31355421,1.318876644152151,2344,1942,4286,-
chr6,31355424,0.6677788204219234,1477,1250,2727,-
chr6,31355428,1.625432858791843,2129,1694,3823,-
chr6,31355492,0.4423454578547548,2495,1501,3996,-
chr6,31355498,0.6572087604297836,4744,2586,7330,-
chr6,31355500,0.6838796465948475,8611,5147,13758,-
chr6,31355504,1.103998234364836,5645,3797,9442,-
chr6,31355505,1.103998234364836,5645,3797,9442,-
chr6,31355506,1.0120064274869238,6773,4575,11348,-
chr6,31355513,1.490216816499207,1408,914,2322,-
chr6,31355516,1.3794910179667252,2993,1895,4888,-
chr6,31355524,4.235865724381625,958,565,1523,-
chr6,31355540,0.5087719298245614,695,379,1074,-
chr6,31356291,1.2980617915183632,4958,3580,8538,-
chr6,31356345,1.0396401798153367,5776,3558,9334,-
chr6,31356346,1.6715512540894222,980,785,1765,-
chr6,31356347,1.0169171642644828,8275,5356,13631,-
chr6,31356349,0.9830853325235348,2615,1779,4394,-
chr6,31356369,1.8018362463587183,948,711,1659,-
chr6,31356372,0.6898800208659364,689,567,1256,-
chr6,31356438,1.7508114812501652,2397,1438,3835,-
chr6,31356440,1.7508114812501652,2397,1438,3835,-
chr6,31356705,1.4082777159807194,1544,1115,2659,-
chr6,31356707,1.4556155373723203,2418,1699,4117,-
chr6,31356722,1.586153375306051,1368,952,2320,-
chr6,31356741,1.6131981382978726,1293,751,2044,-
chr6,31356742,0.5135546756015839,842,803,1645,-
chr6,31356745,0.3772057881931105,1051,684,1735,-
chr6,31356755,1.6421836745324792,2599,2132,4731,-
chr6,31356756,1.6242751179412567,3766,2811,6577,-
chr6,31356764,1.4017454317417737,1237,972,2209,-
chr6,31356804,0.7162985387001533,1368,990,2358,-
chr6,31356846,2.1525186677729056,3311,2595,5906,-
chr6,31356848,2.0480868997421817,4845,3666,8511,-
chr6,31356849,1.9805569749616765,4627,3295,7922,-
chr6,31356851,1.6646691265587548,3014,2081,5095,-
chr6,31356855,1.5313785623457252,1387,921,2308,-
chr6,31356863,1.4850751534824642,1219,765,1984,-
chr6,31356864,0.6342994145525304,1455,1132,2587,-
chr6,31356935,1.5898830433817916,1786,1352,3138,-
chr6,31356939,0.5924528301886792,941,476,1417,-
chr6,31357108,2.3049371632248676,1879,1166,3045,-
chr6,31357171,1.7737272155876809,663,443,1106,-
chr6,31357174,1.7887422938554918,2595,1455,4050,-
chr6,31357179,2.0603305785123966,830,494,1324,-
chr6,31357183,2.289937690574042,750,396,1146,-
chr6,31357204,2.6479411087769513,1022,480,1502,-
chr6,31357211,0.9055459597652286,1461,610,2071,-
chr6,31530819,0.5408950617283951,700,575,1275,-
chr6,31530867,1.9439612326043736,893,502,1395,-
chr6,31530886,1.9879518072289155,791,414,1205,-
chr6,31531340,1.6916751613999317,802,544,1346,-
chr6,31531394,1.5589920117721252,750,567,1317,-
chr6,31531400,0.5910770105143507,623,458,1081,-
chr6,31532810,2.0576404727348123,826,688,1514,-
chr6,31535460,1.0969404915235246,1582,1016,2598,-
chr6,31536568,1.9402597402597401,746,489,1235,-
chr6,31536571,0.6111111111111109,637,521,1158,-
chr6,31536572,1.5753424657534243,689,437,1126,-
chr6,31538848,0.4477825464949929,625,465,1090,-
chr6,31540534,1.4669101433584086,789,696,1485,-
chr6,31540535,0.5308240396530359,595,537,1132,-
chr6,31542000,0.9412885662431942,2276,869,3145,-
chr6,31542001,0.8951401931640912,4603,1716,6319,-
chr6,31542002,0.9020576832642149,5703,2184,7887,-
chr6,31639210,2.9300884955752218,692,677,1369,-
chr6,31639211,2.818559162999171,907,840,1747,-
chr6,31639212,2.9300884955752218,692,677,1369,-
chr6,31640886,1.3057885818328112,1135,872,2007,-
chr6,31640931,2.4550419790095184,685,528,1213,-
chr6,31645587,0.400577094159222,654,486,1140,-
chr6,31647724,2.5817901234567904,716,485,1201,-
chr6,31647725,2.5817901234567904,716,485,1201,-
chr6,31648702,0.30510127974750617,656,510,1166,-
chr6,31649272,0.9983888292158968,675,391,1066,-
chr6,31649273,1.5107395893580104,1208,768,1976,-
chr6,31649275,0.8854059256204028,643,372,1015,-
chr6,31649608,1.8631465517241377,664,463,1127,-
chr6,31649613,2.059903381642512,655,459,1114,-
chr6,31649625,2.068792178172838,894,656,1550,-
chr6,31652461,1.2266222662226622,825,541,1366,-
chr6,31652463,1.2266222662226622,825,541,1366,-
chr6,31730641,22.51908088934034,5679,4904,10583,-
chr6,31730642,22.519080889340337,5679,4904,10583,-
chr6,31730656,1.565693430656934,1022,547,1569,-
chr6,31730659,1.5507901774860202,937,456,1393,-
chr6,31730664,6.703577983681941,4875,2522,7397,-
chr6,31730665,6.739211427902123,4039,2155,6194,-
chr6,31730670,7.918784822199187,4801,2116,6917,-
chr6,31730671,8.384883003865465,5818,2440,8258,-
chr6,31730672,7.895312778104284,3628,1462,5090,-
chr6,31730680,1.6319278547539418,1092,321,1413,-
chr6,31730684,4.622325627344213,5548,1841,7389,-
chr6,31730685,4.622325627344213,5548,1841,7389,-
chr6,31730753,1.2575328237860666,1791,1196,2987,-
chr6,31730941,1.5351580186543512,1576,817,2393,-
chr6,31730989,1.8417375455650065,1127,822,1949,-
chr6,31730993,0.4146753955264593,690,469,1159,-
chr6,31733590,1.4431417526868018,1281,797,2078,-
chr6,31733597,2.06508195786127,2851,1810,4661,-
chr6,31733598,2.2922389567743364,2044,1172,3216,-
chr6,31733637,3.542725930785632,799,468,1267,-
chr6,31734243,1.7466697289848416,844,621,1465,-
chr6,31734256,0.5926479378362224,660,477,1137,-
chr6,31736315,1.6115405117270791,833,535,1368,-
chr6,31736444,0.4217768871075485,573,498,1071,-
chr6,31736445,0.4212191997588727,429,576,1005,-
chr6,31736448,3.380795338695831,2348,2285,4633,-
chr6,31736459,8.272680767537524,2168,1891,4059,-
chr6,31736462,13.749066989272299,6282,4371,10653,-
chr6,31736463,13.79242606467557,6695,4554,11249,-
chr6,31736464,13.79242606467557,6695,4554,11249,-
chr6,31736465,15.360370370370369,1237,719,1956,-
chr6,31779011,4.523012779842291,610,393,1003,-
chr6,31780516,0.2978518733604415,753,474,1227,-
chr6,31780756,1.7221020161689908,659,512,1171,-
chr6,31780776,5.817073059749098,775,508,1283,-
chr6,31792863,0.7145861833265919,656,519,1175,-
chr6,31797531,1.9394990116950654,864,664,1528,-
chr6,31797560,3.905908096280088,594,456,1050,-
chr6,31797561,3.905908096280088,594,456,1050,-
chr6,31797674,1.823939176298522,762,575,1337,-
chr6,31797871,2.5094314734203933,927,797,1724,-
chr6,31797872,2.5094314734203933,927,797,1724,-
chr6,31798039,3.618395063567858,780,525,1305,-
chr6,31806129,2.0143890953400243,772,513,1285,-
chr6,31884715,3.0944792237416308,643,416,1059,-
chr6,31952383,2.3688234312579977,698,547,1245,-
chr6,31954586,5.183645078667354,1462,1231,2693,-
chr6,31954592,4.610452442710667,1430,1047,2477,-
chr6,31954628,9.500848625961881,2431,1287,3718,-
chr6,31954629,17.712177121771212,959,541,1500,-
chr6,31954737,2.7846907993966816,843,623,1466,-
chr6,31954740,2.27673762503206,806,556,1362,-
chr6,31954744,1.984835514247279,2163,1325,3488,-
chr6,31954745,1.984835514247279,2163,1325,3488,-
chr6,31954746,1.984835514247279,2163,1325,3488,-
chr6,31955075,0.508173889599683,1860,1343,3203,-
chr6,31955077,0.4868360277136259,619,432,1051,-
chr6,31955242,2.3282747603833864,1319,938,2257,-
chr6,31955244,2.3282747603833864,1319,938,2257,-
chr6,31956980,2.3650306748466257,770,488,1258,-
chr6,31957009,1.6722482575333038,1022,772,1794,-
chr6,31958387,0.5902372961196489,715,458,1173,-
chr6,31958435,2.2160940325497287,644,394,1038,-
chr6,31958436,2.2160940325497287,644,394,1038,-
chr6,32115333,10.570920644726465,577,870,1447,-
chr6,32115415,4.899413264254025,985,649,1634,-
chr6,32115471,15.551428347258174,762,569,1331,-
chr6,32116793,2.7870068276057443,620,465,1085,-
chr6,32127136,1.5444069863214531,631,444,1075,-
chr6,32168286,21.37429468712834,1806,1407,3213,-
chr6,32168287,16.681044710131665,1969,1506,3475,-
chr6,32169277,4.892607129631906,635,546,1181,-
chr6,32170974,4.319895182422898,738,450,1188,-
chr6,32185112,7.7195005861575785,822,573,1395,-
chr6,32185113,9.052925261843237,717,474,1191,-
chr6,32185114,10.010384194720796,709,485,1194,-
chr6,32186177,4.59633122206031,694,587,1281,-
chr6,32186178,6.4685354146467455,697,584,1281,-
chr6,32827789,2.0563355096515097,1601,1176,2777,-
chr6,32827821,0.8353033884948778,1589,845,2434,-
chr6,32827822,1.1700637822248363,2303,1267,3570,-
chr6,32827823,1.021117542685942,2064,1108,3172,-
chr6,32827824,0.8086036123519129,1513,812,2325,-
chr6,32827869,2.672767540622693,961,518,1479,-
chr6,32827896,4.424118322195782,833,395,1228,-
chr6,32842759,0.43165231652316527,751,541,1292,-
chr6,32842761,0.43165231652316527,751,541,1292,-
chr6,32843001,2.8706980788694447,679,555,1234,-
chr6,32843083,2.231974921630094,711,483,1194,-
chr6,32843085,2.231974921630094,711,483,1194,-
chr6,32845430,1.5447588917521682,661,636,1297,-
chr6,32852485,1.2200372657855323,576,434,1010,-
chr6,33194084,9.658154923377863,626,795,1421,-
chr6,33251958,0.9461682579621199,607,444,1051,-
chr6,33269515,2.813140377518998,607,467,1074,-
chr6,33288211,26.21322819838071,1967,1620,3587,-
chr6,33288212,26.21322819838071,1967,1620,3587,-
chr6,33288213,35.76963923805946,1174,860,2034,-
chr6,33416610,2.5480684811237926,610,535,1145,-
chr6,33416963,0.6570820021299255,1233,938,2171,-
chr6,33417124,1.8533944189920861,889,685,1574,-
chr6,33417262,1.4654761904761904,1230,767,1997,-
chr6,33417267,1.4737089634528058,3409,2296,5705,-
chr6,33417269,1.4737089634528058,3409,2296,5705,-
chr6,33417271,1.4152065101441496,3690,3380,7070,-
chr6,33417272,1.2844698277996462,7107,6097,13204,-
chr6,33417274,1.1900196574648585,7924,6321,14245,-
chr6,33417275,1.2849785034800858,7970,6199,14169,-
chr6,33417277,1.345364587873674,4168,3341,7509,-
chr6,33417504,1.9930346605622982,1413,1121,2534,-
chr6,33417522,0.9111091271612652,1423,973,2396,-
chr6,33417524,0.9111091271612652,1423,973,2396,-
chr6,33417529,2.115714927463468,1194,922,2116,-
chr6,33417531,1.9690139562416047,1764,1330,3094,-
chr6,33417532,1.9622263336416896,1156,845,2001,-
chr6,33417533,1.4156668271716029,1099,744,1843,-
chr6,33417783,7.6530135361120095,790,549,1339,-
chr6,33697641,1.8869778869778877,767,443,1210,-
chr6,33697643,0.8116837834411056,882,716,1598,-
chr6,33697644,0.5627969982059058,2342,1734,4076,-
chr6,33697707,2.2252915899324743,624,542,1166,-
chr6,33700491,1.6275180835342615,674,558,1232,-
chr6,33700500,0.49137072685031535,657,523,1180,-
chr6,33701414,0.5884677564217711,727,585,1312,-
chr6,33711560,2.9426839833899527,3378,2514,5892,-
chr6,33711561,2.278553183725597,1454,1133,2587,-
chr6,33711576,3.564710308502633,757,442,1199,-
chr6,34263543,1.4791061098368883,1195,975,2170,-
chr6,34263544,1.8690760917707503,843,638,1481,-
chr6,34263622,1.908380027700779,826,688,1514,-
chr6,34263672,1.135171281965915,11079,10807,21886,-
chr6,34263673,0.9490691436471385,9608,9477,19085,-
chr6,34263674,1.1220922439563923,12034,11667,23701,-
chr6,34263676,1.1849268450340653,3872,3412,7284,-
chr6,34263677,1.2938141495289435,2063,1780,3843,-
chr6,34282035,2.451138819617623,1797,1202,2999,-
chr6,34282036,2.578267502146666,2499,1788,4287,-
chr6,34282039,2.0805647840531565,834,515,1349,-
chr6,34282042,2.5685851322891384,1892,1401,3293,-
chr6,34282047,2.197263901147396,1148,823,1971,-
chr6,34282048,2.197263901147396,1148,823,1971,-
chr6,34282074,1.6361031122918268,775,467,1242,-
chr6,34417505,1.377495968456869,1853,1426,3279,-
chr6,34417509,0.7291537035702824,1824,1282,3106,-
chr6,34417538,1.3977644555341895,2139,1782,3921,-
chr6,34417540,2.078977482790796,2035,1437,3472,-
chr6,34417541,2.1696945967110413,1882,1276,3158,-
chr6,34417543,1.352456775951904,2183,1919,4102,-
chr6,34417544,0.562322393714827,1391,1643,3034,-
chr6,34417546,1.0817853618885724,2416,2151,4567,-
chr6,34418378,0.5799467827769714,684,423,1107,-
chr6,34418379,1.0412802649645374,843,766,1609,-
chr6,34424779,1.3662647968792037,3217,1887,5104,-
chr6,34424808,1.3267806764603227,6628,4148,10776,-
chr6,34424809,1.4167932306357127,6529,3398,9927,-
chr6,34424811,1.4144777462654987,5834,3050,8884,-
chr6,34424813,1.4406390031816894,3072,2428,5500,-
chr6,34424814,1.4406390031816894,3072,2428,5500,-
chr6,34424815,0.7058922802449491,1272,668,1940,-
chr6,34424818,1.8611755297880848,1292,609,1901,-
chr6,34424834,0.584809765829098,683,568,1251,-
chr6,34424837,1.6561371841155237,733,553,1286,-
chr6,34425083,0.7669603697227324,985,475,1460,-
chr6,34425086,1.0315505617977527,603,444,1047,-
chr6,34425087,1.0315505617977527,603,444,1047,-
chr6,34426054,0.6084737432928172,4234,3115,7349,-
chr6,34426061,0.8752225581961266,12271,9287,21558,-
chr6,34426063,0.8805343084104564,8638,7336,15974,-
chr6,34426064,0.6522191871783649,2057,1977,4034,-
chr6,34426066,1.0936010909784013,5389,3451,8840,-
chr6,34426067,1.1921354729439353,8933,8337,17270,-
chr6,34426068,1.1408163900845725,11037,8644,19681,-
chr6,34426069,1.1882537134738973,6270,4512,10782,-
chr6,34426071,1.2274158573438836,2325,1293,3618,-
chr6,34426073,1.0502830502830502,1367,755,2122,-
chr6,35833797,2.82547931475021,688,470,1158,-
chr6,35838416,2.2272229351194017,634,443,1077,-
chr6,35842595,2.653439937742037,2366,1860,4226,-
chr6,35842596,2.250603428349752,6117,4464,10581,-
chr6,35842598,2.0697029935824403,5991,4243,10234,-
chr6,35842600,1.9055146844164184,2193,1556,3749,-
chr6,35857280,1.6622463652340633,866,568,1434,-
chr6,35857301,1.0410648727288678,1084,703,1787,-
chr6,35857315,1.0036057692307692,834,575,1409,-
chr6,35857317,1.0036057692307692,834,575,1409,-
chr6,35857332,1.3249243793006917,660,463,1123,-
chr6,35870360,1.2833333333333334,692,494,1186,-
chr6,35870362,1.2833333333333334,692,494,1186,-
chr6,36092180,2.6289529325636845,742,564,1306,-
chr6,36855391,2.7460629921259843,619,507,1126,-
chr6,36855392,2.7460629921259843,619,507,1126,-
chr6,36855875,1.6206424083550748,7940,5958,13898,-
chr6,36855876,1.5722088218693755,5202,3323,8525,-
chr6,36855877,1.712485030369792,10214,7433,17647,-
chr6,36855878,1.5961800628968674,10267,7115,17382,-
chr6,36855879,1.687013237744178,10623,7291,17914,-
chr6,36855881,1.9425097685192896,3589,2262,5851,-
chr6,36855897,1.8186138613861391,655,403,1058,-
chr6,36968227,1.5374160300397817,2065,1586,3651,-
chr6,36968306,1.5883283024292079,1189,772,1961,-
chr6,36968343,1.5076018612558788,1895,1621,3516,-
chr6,36968425,1.3961925070955894,1995,1417,3412,-
chr6,36968448,1.6747159090909092,654,351,1005,-
chr6,36968482,2.2914001421464114,619,468,1087,-
chr6,36968657,0.4749586092715232,1019,905,1924,-
chr6,36968659,0.4749586092715232,1019,905,1924,-
chr6,36968666,3.406533775547706,2986,2858,5844,-
chr6,36968667,3.406533775547706,2986,2858,5844,-
chr6,36968685,1.898180780554188,889,677,1566,-
chr6,36968696,6.136261337563473,1313,969,2282,-
chr6,36968704,4.354358610914245,1023,497,1520,-
chr6,36968705,3.553981687168467,1816,1076,2892,-
chr6,36968710,7.243686858943283,2059,1305,3364,-
chr6,36968712,2.5211056644880183,804,543,1347,-
chr6,36968724,20.51535753059638,2998,1419,4417,-
chr6,36968725,19.542176437972508,2583,1187,3770,-
chr6,36968810,1.4597980025954973,538,478,1016,-
chr6,36968931,0.5962891874600128,698,520,1218,-
chr6,36970054,3.2390556030460176,1213,779,1992,-
chr6,36972792,1.2080670926517572,1451,938,2389,-
chr6,36972794,1.2080670926517572,1451,938,2389,-
chr6,36975691,1.7553760382296049,550,516,1066,-
chr6,36975708,1.6751248644214567,816,660,1476,-
chr6,36977244,1.8663401693704724,1075,593,1668,-
chr6,36977246,1.8663401693704724,1075,593,1668,-
chr6,36978093,1.81431334622824,602,422,1024,-
chr6,36978109,1.7741972477064218,572,435,1007,-
chr6,36978530,1.6986678410216889,833,585,1418,-
chr6,36978561,1.6709326788218797,705,495,1200,-
chr6,36978595,3.108695652173913,714,459,1173,-
chr6,36978607,1.7642549057679182,1025,789,1814,-
chr6,36981602,2.119065374098931,681,446,1127,-
chr6,36985877,3.067571664734571,774,597,1371,-
chr6,36985946,8.737214462679704,1221,922,2143,-
chr6,36985947,4.912666400186868,1104,738,1842,-
chr6,38676155,0.7140060438838522,1752,1289,3041,-
chr6,38676231,1.7750865051903113,1367,1155,2522,-
chr6,38676233,1.9056424398407323,2353,1734,4087,-
chr6,38676240,1.6701428390848185,754,585,1339,-
chr6,38676502,1.7270187393526404,791,586,1377,-
chr6,38676691,1.911570611526617,3159,2272,5431,-
chr6,38676693,4.432064060345752,6858,4972,11830,-
chr6,38676840,1.7442510732103491,1902,1325,3227,-
chr6,38676853,1.5609756097560974,1151,737,1888,-
chr6,38677215,1.8715424285044542,997,710,1707,-
chr6,38677317,1.5240448504983384,940,687,1627,-
chr6,38682096,3.0444078947368416,616,455,1071,-
chr6,38682097,1.539313399778516,1250,755,2005,-
chr6,38684418,2.1785894553296927,1736,1146,2882,-
chr6,38686939,1.6866843033509702,616,539,1155,-
chr6,38686965,2.5680933852140084,1319,1027,2346,-
chr6,38686966,1.8547331187476026,2152,1506,3658,-
chr6,38686967,2.5680933852140084,1319,1027,2346,-
chr6,38686970,1.010421286031042,1084,819,1903,-
chr6,38686971,1.010421286031042,1084,819,1903,-
chr6,38686973,0.4127280327298432,732,531,1263,-
chr6,38703137,1.8516114005019866,724,688,1412,-
chr6,39958506,0.6700387286324787,1280,1151,2431,-
chr6,39958507,1.3513725490196076,1722,1359,3081,-
chr6,39958513,0.8500738355572852,3623,2666,6289,-
chr6,39958515,0.8769967663274868,7679,5800,13479,-
chr6,39958516,1.0558536118030273,3295,2455,5750,-
chr6,39958517,0.8541774891774891,3533,2799,6332,-
chr6,39958518,1.067541942110669,2190,1765,3955,-
chr6,39958534,0.9981284644937738,2099,1540,3639,-
chr6,39958537,1.0081047670555514,1890,1504,3394,-
chr6,39958539,1.4300136998460808,2346,1861,4207,-
chr6,39958544,0.5910980910980911,694,480,1174,-
chr6,39958612,1.7912417379629957,5918,6470,12388,-
chr6,39958613,0.8466735669699836,2962,1885,4847,-
chr6,39958614,1.2157277364384698,13496,13220,26716,-
chr6,39958615,0.9963561232329202,8726,8320,17046,-
chr6,39958616,0.9097355859676098,6463,5286,11749,-
chr6,39958617,0.7891003057013998,1841,1225,3066,-
chr6,39958635,1.726977828168304,996,881,1877,-
chr6,39958636,1.5979696078204266,1332,1761,3093,-
chr6,39958637,1.7016026420003718,1911,2475,4386,-
chr6,39958639,1.667488656539751,1763,2191,3954,-
chr6,39958641,1.4543714142545427,3313,3191,6504,-
chr6,39958642,1.9824880079605918,1676,1781,3457,-
chr6,39958643,0.6549888697400545,1696,1265,2961,-
chr6,39958649,1.0355069347382002,1149,1047,2196,-
chr6,39958650,0.9715098665769654,2909,2565,5474,-
chr6,39958651,1.2216440713663643,1398,1262,2660,-
chr6,39958652,0.9286369069424102,1760,1518,3278,-
chr6,41935600,2.5644505418380286,690,566,1256,-
chr6,42207801,2.6447101999493796,852,877,1729,-
chr6,42207827,0.5464262411324109,1399,997,2396,-
chr6,42207980,1.735629841011007,654,445,1099,-
chr6,42208134,0.4319880418535127,577,445,1022,-
chr6,42208935,1.7014644946816229,822,521,1343,-
chr6,42211906,1.7253906754443233,1008,717,1725,-
chr6,42214135,1.7020989145238823,861,695,1556,-
chr6,42214161,2.169684129429892,750,471,1221,-
chr6,42214162,2.3223322265672803,1212,761,1973,-
chr6,42214335,3.037108619597994,891,504,1395,-
chr6,42956540,1.0813462662643436,3623,2700,6323,-
chr6,42956541,1.1863734491285094,4952,3696,8648,-
chr6,42956545,1.3859242410840844,2772,2149,4921,-
chr6,42956546,1.2842858229967278,1757,1545,3302,-
chr6,42956547,1.279158115496967,2258,1974,4232,-
chr6,42956549,1.344790307548928,1060,924,1984,-
chr6,42956581,0.6597209608573245,1636,1231,2867,-
chr6,42956583,0.6597209608573245,1636,1231,2867,-
chr6,42956709,1.3929483648019232,3284,2434,5718,-
chr6,42956724,1.5288870960512753,8416,5091,13507,-
chr6,42956726,1.3441228478518932,17304,11910,29214,-
chr6,42956727,1.297121977132734,22473,15389,37862,-
chr6,42956729,1.2535530344394488,13406,8404,21810,-
chr6,42956738,1.2624274291603927,4693,2664,7357,-
chr6,42956739,1.3783158180862358,7498,4708,12206,-
chr6,42956749,1.8486328125,1892,1023,2915,-
chr6,42956752,1.1396382521780632,5773,3945,9718,-
chr6,42956754,1.0853288196345894,2794,1894,4688,-
chr6,42956756,0.6092817254552667,1797,1034,2831,-
chr6,42956757,0.4062450273581205,812,575,1387,-
chr6,43013921,0.9892381939304221,2103,1350,3453,-
chr6,43013922,1.022170495600172,3489,2371,5860,-
chr6,43013923,1.022170495600172,3489,2371,5860,-
chr6,43013924,1.0028601668277777,2163,1623,3786,-
chr6,43046915,1.6070901173278611,796,501,1297,-
chr6,43046938,2.3080063915076954,696,396,1092,-
chr6,43225729,1.8468593296384268,1216,841,2057,-
chr6,43225747,1.9166408108387631,903,585,1488,-
chr6,43225787,0.5470035252643948,734,554,1288,-
chr6,43225790,1.9754736424566293,1742,1438,3180,-
chr6,43225791,1.7920782200937837,1282,1027,2309,-
chr6,43225852,1.7958435207823962,677,408,1085,-
chr6,43226075,0.3765075376884423,665,397,1062,-
chr6,43226355,2.098556943675874,708,616,1324,-
chr6,43226361,0.5631497913481667,778,646,1424,-
chr6,43226367,1.9747355756591847,689,592,1281,-
chr6,43226375,2.3136464357937556,847,634,1481,-
chr6,43229406,2.608999842866895,1546,1121,2667,-
chr6,43229407,2.1995282718174285,907,580,1487,-
chr6,43229408,2.327267362362126,1355,903,2258,-
chr6,43512491,1.5730704006263687,630,425,1055,-
chr6,43513618,2.919984080959691,781,572,1353,-
chr6,43515944,0.19191249585681144,578,430,1008,-
chr6,43515945,0.19191249585681144,578,430,1008,-
chr6,43675601,0.6848160985942616,1137,576,1713,-
chr6,43675602,1.546839212093449,1038,707,1745,-
chr6,43675606,1.0400802357111487,2442,1564,4006,-
chr6,43675614,2.419898498808096,2434,1254,3688,-
chr6,43675615,2.099747238344879,1573,762,2335,-
chr6,43678531,1.8154727793696277,719,348,1067,-
chr6,43687699,2.2133861397040526,734,522,1256,-
chr6,44113880,1.8940228522950062,1167,849,2016,-
chr6,44113985,1.7788235294117647,755,611,1366,-
chr6,44113994,1.6567489114658929,760,582,1342,-
chr6,44114039,0.6046025104602512,577,477,1054,-
chr6,44114137,3.1163406682966586,664,408,1072,-
chr6,44114180,0.5457725947521866,701,419,1120,-
chr6,44116601,2.1291399381659843,1000,808,1808,-
chr6,44116607,1.3329916083399485,1010,762,1772,-
chr6,44127360,4.247596153846153,968,543,1511,-
chr6,44127361,4.247596153846153,968,543,1511,-
chr6,44127417,1.755496902661619,832,439,1271,-
chr6,44254447,5.829830412337222,1898,1551,3449,-
chr6,44254481,5.942857142857144,647,404,1051,-
chr6,44254676,1.7275805299288665,868,656,1524,-
chr6,44254677,1.7275805299288665,868,656,1524,-
chr6,44254812,11.564528146018368,1593,1023,2616,-
chr6,44254813,13.805297672417025,2334,1353,3687,-
chr6,44254814,16.347097405136775,1792,1069,2861,-
chr6,44255200,1.7912479261659864,906,617,1523,-
chr6,44255546,2.1488602386412645,710,518,1228,-
chr6,44255553,2.684370301793251,1074,726,1800,-
chr6,52264161,3.122047244094488,792,634,1426,-
chr6,52264306,2.149828302909813,792,502,1294,-
chr6,52264340,2.235054347826087,657,551,1208,-
chr6,52264347,1.9661299831241807,1275,877,2152,-
chr6,52264518,1.5923621022427836,1508,1112,2620,-
chr6,52264521,2.3425112741625314,1390,959,2349,-
chr6,52264539,1.9828140282241158,616,420,1036,-
chr6,52264546,2.3877950348538586,780,480,1260,-
chr6,52264706,2.0635747785304845,719,605,1324,-
chr6,52266643,1.9277180406212664,921,619,1540,-
chr6,52266668,1.637834448160535,1450,1103,2553,-
chr6,52266669,1.637834448160535,1450,1103,2553,-
chr6,52267951,1.0540777692761811,1683,1330,3013,-
chr6,52269104,1.9150389401918293,2433,1873,4306,-
chr6,52269113,1.6962872793670116,928,582,1510,-
chr6,52272349,2.2886002886002887,609,461,1070,-
chr6,52273315,2.032347140039448,735,506,1241,-
chr6,52273318,2.396875947831362,544,470,1014,-
chr6,52273320,1.9863325740318911,653,438,1091,-
chr6,52273752,1.941532258064516,641,495,1136,-
chr6,52273803,0.6027651323554206,714,658,1372,-
chr6,52273873,2.3010790523105795,852,811,1663,-
chr6,52273890,1.775798069784707,597,448,1045,-
chr6,52273909,2.367302955665025,698,405,1103,-
chr6,52276417,2.4272107290499823,1428,1006,2434,-
chr6,52276418,2.3925181462869904,856,596,1452,-
chr6,52276459,2.416125295426317,823,543,1366,-
chr6,52277106,2.1415744749078085,702,593,1295,-
chr6,52277108,2.1415744749078085,702,593,1295,-
chr6,52277577,1.9107954545454544,569,439,1008,-
chr6,52277578,1.7742702702702704,745,554,1299,-
chr6,52277579,1.77890841813136,640,516,1156,-
chr6,52277580,0.5647536820721178,833,536,1369,-
chr6,52277581,2.063756953359007,688,491,1179,-
chr6,52277632,1.922932330827068,743,607,1350,-
chr6,52277652,0.5258844631370608,894,687,1581,-
chr6,52277680,1.7612037037037034,826,719,1545,-
chr6,52278811,2.4987831589194447,1109,1173,2282,-
chr6,52278815,2.1499513145082765,1034,1026,2060,-
chr6,52278827,1.775624856684247,910,622,1532,-
chr6,52278832,0.6678197353914002,1030,906,1936,-
chr6,52278838,2.3639705882352944,642,543,1185,-
chr6,52278841,1.6275801875549367,1344,1133,2477,-
chr6,52279378,2.0194662480376766,1071,734,1805,-
chr6,52279379,2.0194662480376766,1071,734,1805,-
chr6,52279572,0.5684121621621622,672,443,1115,-
chr6,52282089,0.4654592649401215,788,736,1524,-
chr6,52282153,2.1348564335753473,5512,4860,10372,-
chr6,52282155,2.78164593708874,3278,2980,6258,-
chr6,52282156,2.0453283433992073,4863,4227,9090,-
chr6,52282158,2.4409683426443203,4067,3221,7288,-
chr6,52282159,2.3717917313083485,3960,2978,6938,-
chr6,52282160,2.3717917313083485,3960,2978,6938,-
chr6,52282161,2.4168636995827537,2936,2156,5092,-
chr6,52282164,2.511626162616262,904,605,1509,-
chr6,52282167,1.588567615658363,870,561,1431,-
chr6,52282168,0.6993012191495689,1226,1061,2287,-
chr6,52282759,1.8436392043747367,943,773,1716,-
chr6,52282771,0.5620448338643604,858,675,1533,-
chr6,52282855,2.8433317399617586,720,522,1242,-
chr6,52283315,2.4975369458128083,623,608,1231,-
chr6,52284620,1.8612157592102254,1762,1337,3099,-
chr6,52284623,1.816764132553606,931,626,1557,-
chr6,52284626,2.1506233394645413,618,465,1083,-
chr6,52284720,0.4819614411741796,1316,839,2155,-
chr6,52284748,0.7319537448630717,1319,857,2176,-
chr6,53267649,3.0754240974336677,981,604,1585,-
chr6,53267651,2.7894375609579884,1484,892,2376,-
chr6,53267652,2.3319034547865773,1450,956,2406,-
chr6,53267792,1.9864061172472385,1001,748,1749,-
chr6,53267794,1.9864061172472385,1001,748,1749,-
chr6,53267844,2.1233493397358947,565,475,1040,-
chr6,53268048,3.3957845433255267,579,426,1005,-
chr6,53268336,0.6312144647139663,936,628,1564,-
chr6,53268513,2.0615447320154883,842,700,1542,-
chr6,53268558,1.8563753112305075,786,586,1372,-
chr6,53268700,0.9298387096774194,1152,929,2081,-
chr6,53268701,0.9712193861287662,2291,1727,4018,-
chr6,53268702,1.0156763751299294,1139,798,1937,-
chr6,53268879,1.891573155828382,1545,1149,2694,-
chr6,53269161,0.41219204947087035,715,470,1185,-
chr6,53269196,1.3702211160724356,889,611,1500,-
chr6,53270710,3.302051922600511,754,574,1328,-
chr6,53276229,3.8290598290598292,767,467,1234,-
chr6,53276231,1.8686813186813187,894,699,1593,-
chr6,53291955,1.0998307952622677,649,590,1239,-
chr6,53291957,1.0998307952622677,649,590,1239,-
chr6,73372981,1.7455521987244045,1039,661,1700,-
chr6,73373169,1.3150505711266545,5693,3506,9199,-
chr6,73373173,1.384253945444975,11160,6442,17602,-
chr6,73373176,0.6852172173087897,9968,6699,16667,-
chr6,73373177,1.2661962109490381,4647,2756,7403,-
chr6,73373279,0.8911645087317897,16224,13796,30020,-
chr6,73373280,1.0848078675035395,17597,14316,31913,-
chr6,73373284,0.912643400367313,12148,8366,20514,-
chr6,73373285,1.0452579882804538,19168,14746,33914,-
chr6,73373286,1.248277067120019,7020,6380,13400,-
chr6,73373294,0.9407196020607762,9324,7444,16768,-
chr6,73373300,0.7565119444314077,1790,1638,3428,-
chr6,73373302,1.02053201628742,4252,3105,7357,-
chr6,73373303,1.2402563429275926,5575,4919,10494,-
chr6,73373304,1.0989700843846155,6903,5625,12528,-
chr6,73373307,1.3159999999999998,657,499,1156,-
chr6,73373308,0.5730553090801538,1549,1126,2675,-
chr6,73373309,0.5022146552403295,2164,1608,3772,-
chr6,73373310,0.8737268963162164,1162,854,2016,-
chr6,73373311,0.6798219195431277,2529,1893,4422,-
chr6,73373312,0.8474650755344556,1574,1255,2829,-
chr6,73517632,1.2172011551099904,21841,14955,36796,-
chr6,73517633,1.2172011551099904,21841,14955,36796,-
chr6,73517635,1.3997896938624712,5780,3634,9414,-
chr6,73517650,0.6656358249983748,4574,2760,7334,-
chr6,73517658,1.1380422751552035,9935,7475,17410,-
chr6,73517662,1.23487887344426,3200,1918,5118,-
chr6,73517663,1.4102524610086118,5910,4840,10750,-
chr6,73517665,1.3951811992132064,8553,6920,15473,-
chr6,73517666,1.3671348995331132,10112,7034,17146,-
chr6,73517668,1.1807352499442074,8659,5065,13724,-
chr6,73517670,1.286090727490346,11452,7509,18961,-
chr6,73517671,1.2338214947582187,8186,4752,12938,-
chr6,73517673,1.2599993132427068,13384,8118,21502,-
chr6,73517674,1.4128745570516088,9268,5673,14941,-
chr6,73517675,1.2369983260462392,7755,4410,12165,-
chr6,73517676,1.7566459061218294,2939,2042,4981,-
chr6,73517677,0.6634630932808812,6341,4497,10838,-
chr6,73517678,1.3251850409037786,1236,603,1839,-
chr6,73517679,0.9073175123121731,6568,4650,11218,-
chr6,73517681,1.6722362043251304,1965,893,2858,-
chr6,73517683,1.3556700951065266,4957,2486,7443,-
chr6,73517684,1.6234382463199215,4446,2062,6508,-
chr6,73517685,1.376762593124133,4706,2306,7012,-
chr6,73517686,1.7448749999999995,2474,999,3473,-
chr6,73517692,0.6582132660589255,1094,719,1813,-
chr6,73518235,1.3175409506615077,95268,64392,159660,-
chr6,73518236,1.255676176079531,240657,149370,390027,-
chr6,73518237,1.172128940709687,334398,224236,558634,-
chr6,73518238,1.1839311655829754,258761,167982,426743,-
chr6,73518253,1.385648904330756,68994,45213,114207,-
chr6,73518259,1.1244841982950566,161852,101443,263295,-
chr6,73518260,1.2243756348000103,138622,74250,212872,-
chr6,73518261,1.159840917183969,177076,105170,282246,-
chr6,73518262,1.2645386925944757,100252,53296,153548,-
chr6,73518265,1.000696403633767,1296,863,2159,-
chr6,73518501,1.5763649870001235,5921,3279,9200,-
chr6,73518516,0.6821540368328223,8585,6282,14867,-
chr6,73518518,0.6888835073098989,16497,11230,27727,-
chr6,73518519,0.6534764005065776,7770,5872,13642,-
chr6,73518524,0.737101840897684,6148,4648,10796,-
chr6,73518526,1.1818045776850588,28503,18319,46822,-
chr6,73518527,1.2283272704523702,25590,14444,40034,-
chr6,73518528,0.7331103886263759,8410,6598,15008,-
chr6,73518529,0.8810588795610995,17839,10420,28259,-
chr6,73518535,1.5664227544750555,5341,2528,7869,-
chr6,73518536,0.7851641818348121,2258,1884,4142,-
chr6,73518537,1.4482055576425097,10313,5470,15783,-
chr6,73518542,1.3978092722034607,12292,6400,18692,-
chr6,73518543,1.3830221276955745,14573,7321,21894,-
chr6,73518544,1.4316657087111393,11335,4709,16044,-
chr6,73518545,1.4091240820994342,9025,3691,12716,-
chr6,73518546,1.4354510413768666,6744,2721,9465,-
chr6,73518793,1.4479578445852883,35923,23465,59388,-
chr6,73518794,1.3559261992456804,94439,57598,152037,-
chr6,73518796,1.2755021111733982,105085,69610,174695,-
chr6,73518799,1.314379291604394,14580,9127,23707,-
chr6,73518814,1.221441266763613,11629,6188,17817,-
chr6,73518822,1.3805845117774265,26583,16952,43535,-
chr6,73518825,1.0290441866137436,63099,40916,104015,-
chr6,73518826,1.062033089397854,75373,49464,124837,-
chr6,73518827,1.0422979045689305,29174,14667,43841,-
chr6,73518828,0.9857974974835262,31787,22587,54374,-
chr6,73518829,1.252235825208994,25135,16365,41500,-
chr6,73518832,1.4622460469232843,10251,5651,15902,-
chr6,73518834,1.4622460469232843,10251,5651,15902,-
chr6,73518837,1.2418883133709944,17157,10842,27999,-
chr6,73518838,1.550994582925133,21596,11703,33299,-
chr6,73518839,1.0142715167352383,7731,6255,13986,-
chr6,73518840,1.3557428588411111,8808,4205,13013,-
chr6,73518847,1.3123620075570492,6351,4078,10429,-
chr6,73518940,1.2463841958097035,2926,2115,5041,-
chr6,73518951,1.3726749669877678,8778,4901,13679,-
chr6,73518953,1.3552726429869149,12685,6984,19669,-
chr6,73518954,1.2717425131631586,9805,5800,15605,-
chr6,73518956,1.4827321468495185,3284,1590,4874,-
chr6,73518957,0.7174519270789977,1378,1171,2549,-
chr6,73518958,1.4827321468495185,3284,1590,4874,-
chr6,73518964,1.3150820076458256,1332,794,2126,-
chr6,73518965,1.6561735749670785,1077,430,1507,-
chr6,73518966,1.1375416346439065,1758,1155,2913,-
chr6,73518969,1.6124314442413161,944,546,1490,-
chr6,73518975,0.9590176248724985,813,622,1435,-
chr6,73518976,0.6054394548273669,1919,1118,3037,-
chr6,73519403,1.3757931150130724,42301,30111,72412,-
chr6,73519413,1.477584704440903,33837,22726,56563,-
chr6,73519423,1.1237492950464207,119074,72106,191180,-
chr6,73519424,1.0694478983954554,147710,88523,236233,-
chr6,73519426,0.9818786470871099,160393,113700,274093,-
chr6,73519427,1.0558955841950386,120974,92408,213382,-
chr6,73519433,1.2964932669575815,42714,25030,67744,-
chr6,73519439,1.2542350493589223,106286,60065,166351,-
chr6,73519440,1.2047955947634783,121307,72572,193879,-
chr6,73519441,1.2542225905792381,141335,82930,224265,-
chr6,73519443,1.2875913094773543,49934,26334,76268,-
chr6,73519445,1.2391967289771446,76372,46439,122811,-
chr6,73519446,1.2568044460605372,72862,45149,118011,-
chr6,73519451,1.412471017037701,12630,6344,18974,-
chr6,73519459,1.3758661827557164,21089,10923,32012,-
chr6,73519472,1.280195810599038,20892,14588,35480,-
chr6,73519473,1.306493378033801,13495,10914,24409,-
chr6,73519475,1.125347022339418,17918,8791,26709,-
chr6,73519476,0.9153964336920195,50672,28670,79342,-
chr6,73519477,1.1135408998234553,44567,24463,69030,-
chr6,73519478,0.9222083849838463,49318,27919,77237,-
chr6,73519480,1.433620545576023,20071,10950,31021,-
chr6,73519481,1.3188212021195174,9554,4482,14036,-
chr6,73519484,0.7742394581026386,3906,3141,7047,-
chr6,73519485,1.4232325454441754,4501,3146,7647,-
chr6,73519493,1.7132089965746522,3200,1417,4617,-
chr6,73519495,1.1266222122959797,8162,5005,13167,-
chr6,73519497,1.0765185303044371,10898,5315,16213,-
chr6,73519498,1.118729258705682,6174,2576,8750,-
chr6,73519499,1.1474460659898478,7621,3151,10772,-
chr6,73519500,1.3071625522874115,5644,3588,9232,-
chr6,73519501,1.348830113608925,6085,3121,9206,-
chr6,73519502,1.36233618625548,8195,4609,12804,-
chr6,73519503,1.3846093260408068,6771,4010,10781,-
chr6,73519505,1.354083113994663,7057,3849,10906,-
chr6,73519507,1.094942748091603,2474,1440,3914,-
chr6,73519508,0.9698277862878896,1228,386,1614,-
chr6,73519510,0.5862488845449115,3200,1610,4810,-
chr6,75085181,1.602065104428576,918,488,1406,-
chr6,75085183,1.7639392592520708,1388,772,2160,-
chr6,75117474,1.1504438276296187,1552,999,2551,-
chr6,75117489,0.5527512196595527,1306,760,2066,-
chr6,75117490,0.5527512196595527,1306,760,2066,-
chr6,75125239,2.949042696638896,674,371,1045,-
chr6,75237943,1.2933941129764066,2722,1855,4577,-
chr6,75237969,2.0949098621420994,1316,942,2258,-
chr6,75237972,1.8340710932260234,1242,851,2093,-
chr6,75241202,1.5878524945770067,1890,1382,3272,-
chr6,75243736,1.4065322850451656,2996,1707,4703,-
chr6,75243746,1.3664518415658111,7439,4590,12029,-
chr6,75243766,1.3311850133195842,2212,1292,3504,-
chr6,75243785,0.8503990594705543,6826,3657,10483,-
chr6,75243789,1.4549398297286318,1019,610,1629,-
chr6,75253090,11.152858462009442,412,623,1035,-
chr6,75253096,8.217892240578527,887,1065,1952,-
chr6,75253097,8.762915662171258,805,899,1704,-
chr6,75253396,1.562210370067024,1326,938,2264,-
chr6,75253774,1.4239602853713937,771,525,1296,-
chr6,75256083,1.4263894812939455,635,375,1010,-
chr6,75256245,2.271609722128625,666,474,1140,-
chr6,79016635,2.033333333333333,670,494,1164,-
chr6,79016636,2.585042139587734,1125,787,1912,-
chr6,79016638,2.6326179120296764,640,443,1083,-
chr6,79201582,3.017407345615369,1107,660,1767,-
chr6,79201693,2.0134132420091317,829,583,1412,-
chr6,79201705,1.6846717327308822,768,540,1308,-
chr6,79203627,2.0938468833205675,972,740,1712,-
chr6,79203628,2.0938468833205675,972,740,1712,-
chr6,79203629,1.8456493643919247,1134,848,1982,-
chr6,80067479,1.0829075417602274,704,552,1256,-
chr6,82172415,2.505627970430583,1450,1241,2691,-
chr6,82172416,3.4420822571031198,731,718,1449,-
chr6,82172417,2.117550872093023,924,687,1611,-
chr6,82172418,3.05570431905157,1061,866,1927,-
chr6,83212035,0.8467652252986428,1320,888,2208,-
chr6,83216536,2.3974391184573003,3256,3024,6280,-
chr6,83216537,2.3023659492933266,4296,3931,8227,-
chr6,83216538,2.3023659492933266,4296,3931,8227,-
chr6,83216539,2.270035259117788,3189,2865,6054,-
chr6,83216570,0.4974069693385497,993,757,1750,-
chr6,83216571,0.4873217201947811,1657,1268,2925,-
chr6,83216573,0.8312845109024223,824,576,1400,-
chr6,83216574,0.9732055052369872,1932,1483,3415,-
chr6,83216575,1.0718106625910275,1108,907,2015,-
chr6,83216593,0.8326193875932095,767,572,1339,-
chr6,83216595,0.9009154949514256,1311,978,2289,-
chr6,83227390,0.5883116063802647,660,400,1060,-
chr6,85547328,2.23381596714735,632,449,1081,-
chr6,85549842,0.3459412266294343,640,415,1055,-
chr6,85612087,0.5148385273333718,964,723,1687,-
chr6,85612088,0.486751244474091,1049,809,1858,-
chr6,85612883,1.3136896789642438,951,572,1523,-
chr6,85612884,1.3136896789642438,951,572,1523,-
chr6,85612885,1.1692487518370935,1095,707,1802,-
chr6,85615301,1.9513046578139621,736,429,1165,-
chr6,85618927,1.909255898366606,1577,1025,2602,-
chr6,85618928,1.909255898366606,1577,1025,2602,-
chr6,85618931,0.6097836571586054,850,614,1464,-
chr6,85624062,1.7909239511169925,718,442,1160,-
chr6,85637122,3.2948897080859583,669,412,1081,-
chr6,85640559,2.8126066674251904,823,516,1339,-
chr6,85640560,2.8126066674251904,823,516,1339,-
chr6,85677367,0.5600052621911882,850,537,1387,-
chr6,85678025,0.4106435371023117,827,563,1390,-
chr6,85678729,2.9619269619269617,952,233,1185,-
chr6,85678730,2.8577063389433888,1098,315,1413,-
chr6,85678731,2.9619269619269617,952,233,1185,-
chr6,87524637,4.022889224789463,809,420,1229,-
chr6,87524639,4.022889224789463,809,420,1229,-
chr6,87529555,2.6325,701,319,1020,-
chr6,87529556,2.6325,701,319,1020,-
chr6,87529562,4.434906145793136,764,418,1182,-
chr6,87677917,3.760326886421254,687,490,1177,-
chr6,87702213,8.341171982997464,548,642,1190,-
chr6,89328417,1.720886551465064,1017,483,1500,-
chr6,89328482,4.105598543468366,819,506,1325,-
chr6,89328484,4.105598543468366,819,506,1325,-
chr6,89338266,1.7462031117818104,3848,3727,7575,-
chr6,89338269,2.009806380417336,3068,3203,6271,-
chr6,89338271,1.6335285996545992,8121,7615,15736,-
chr6,89338272,1.4361820710328745,8446,7478,15924,-
chr6,89338278,1.6050610031631272,2495,2212,4707,-
chr6,89338280,1.6050610031631272,2495,2212,4707,-
chr6,89338282,0.7130256410256409,1421,1124,2545,-
chr6,89338286,1.4629649365874455,1035,852,1887,-
chr6,89338295,1.5311938382541719,993,759,1752,-
chr6,89338296,1.082036775106082,1421,1105,2526,-
chr6,89338298,1.266676810418375,2236,1704,3940,-
chr6,89338301,0.5569582680923926,1323,1097,2420,-
chr6,89338302,1.8269335937499998,1050,799,1849,-
chr6,89338304,1.8269335937499998,1050,799,1849,-
chr6,89338307,2.1360811781609192,1306,927,2233,-
chr6,89338308,1.7729825563491304,1718,1212,2930,-
chr6,89338309,2.1360811781609192,1306,927,2233,-
chr6,99376124,0.9987642115669796,897,475,1372,-
chr6,99376126,0.970677508528656,1677,928,2605,-
chr6,99376128,0.8685511724640925,1194,673,1867,-
chr6,99401348,2.3785831266955433,636,400,1036,-
chr6,99401584,2.571454618457876,739,506,1245,-
chr6,99549561,1.3941316534634054,996,717,1713,-
chr6,99562923,4.515991471215352,705,468,1173,-
chr6,99562924,4.515991471215352,705,468,1173,-
chr6,106592253,1.4224820892736645,568,522,1090,-
chr6,106970073,2.155797152851669,798,431,1229,-
chr6,107210486,2.992071292533242,644,396,1040,-
chr6,107871418,1.4864718614718613,1138,747,1885,-
chr6,107871419,2.363199282891252,1159,908,2067,-
chr6,107871441,1.582094723786151,1911,1289,3200,-
chr6,107871445,1.8819782854059552,1520,953,2473,-
chr6,107871478,2.2875201721355567,1133,571,1704,-
chr6,107871479,2.2875201721355567,1133,571,1704,-
chr6,107881232,2.2391478696741856,1440,949,2389,-
chr6,107881233,2.2391478696741856,1440,949,2389,-
chr6,107881241,2.5147058823529416,1253,679,1932,-
chr6,107881242,2.5147058823529416,1253,679,1932,-
chr6,107882999,3.1522598384602167,1078,528,1606,-
chr6,107883000,2.9330049437506323,1441,746,2187,-
chr6,107902873,1.9018483110261315,745,522,1267,-
chr6,107902911,2.12397685918104,1044,664,1708,-
chr6,107902919,2.2142278324360722,854,505,1359,-
chr6,107908987,1.5900011725189682,573,529,1102,-
chr6,108004888,1.4866900785459614,1421,1021,2442,-
chr6,108004889,0.6410387896019497,2121,2461,4582,-
chr6,108004890,0.7567388746831567,4578,4427,9005,-
chr6,108004891,0.8567316973965793,5180,5154,10334,-
chr6,108004893,1.7237604273252285,1766,2115,3881,-
chr6,108004895,1.7364100762883716,1603,1760,3363,-
chr6,108004897,1.084919417324155,1585,1213,2798,-
chr6,108004898,1.2521443503168277,834,792,1626,-
chr6,108004902,0.2956589253646083,1213,1014,2227,-
chr6,108005070,0.7309993431214158,3049,2138,5187,-
chr6,108005071,1.3510134621235168,1464,1383,2847,-
chr6,108005074,1.1082864769172909,2216,2056,4272,-
chr6,108005075,1.0014730737622304,2252,2330,4582,-
chr6,108005076,0.8942319531261441,8560,7517,16077,-
chr6,108005077,1.2364524003254678,1571,1228,2799,-
chr6,108005078,0.649139929375768,5064,3995,9059,-
chr6,108005081,1.236925724877532,908,818,1726,-
chr6,108005082,1.236925724877532,908,818,1726,-
chr6,108005594,0.9025524547152534,3069,2613,5682,-
chr6,108211675,2.644986998496299,1419,1256,2675,-
chr6,108211676,2.9710512950736407,974,894,1868,-
chr6,108211870,1.6276745495495497,745,591,1336,-
chr6,108211969,0.6483762597984322,771,607,1378,-
chr6,108212160,1.8740494712000701,1020,672,1692,-
chr6,108212183,2.7469266773671275,1210,878,2088,-
chr6,108212230,1.7985523809523807,813,524,1337,-
chr6,108214554,0.6009026434558349,698,422,1120,-
chr6,108222964,1.9319571861541456,1416,989,2405,-
chr6,108222999,2.097892765755477,2315,1542,3857,-
chr6,108223003,3.2263374485596716,1063,728,1791,-
chr6,108223011,2.143290960451977,978,589,1567,-
chr6,108223044,2.0084367476009457,1107,706,1813,-
chr6,108260868,1.4773917680894426,2184,1220,3404,-
chr6,108260874,1.1248496397094025,2860,2329,5189,-
chr6,108260875,0.6518977750223875,2405,1612,4017,-
chr6,108260881,1.7538120533496389,3128,2465,5593,-
chr6,108260883,1.7866329884247971,4561,3515,8076,-
chr6,108260884,1.8824643239592374,4714,3408,8122,-
chr6,108260886,1.9900027333441384,4092,2890,6982,-
chr6,108260887,2.0791987387554483,2659,1840,4499,-
chr6,108260889,1.5850106586296009,1425,873,2298,-
chr6,108260901,1.5707819546369794,1780,1213,2993,-
chr6,108260902,1.112977791800284,3600,2481,6081,-
chr6,108260922,1.4783523008411674,628,563,1191,-
chr6,108260926,1.867803520146545,1104,819,1923,-
chr6,108260931,1.584396145343301,1388,783,2171,-
chr6,108260932,1.5988484699087937,1396,777,2173,-
chr6,108260933,1.6435641342161376,1702,937,2639,-
chr6,108260934,1.5819590701370951,1326,718,2044,-
chr6,108260935,1.3433044450656977,960,510,1470,-
chr6,108260951,3.1021557897171084,1099,751,1850,-
chr6,108260952,2.571650348963893,1534,953,2487,-
chr6,109366652,2.267066267066267,591,428,1019,-
chr6,109367030,2.7181467181467185,639,369,1008,-
chr6,109367546,2.5619047619047617,806,559,1365,-
chr6,109367895,2.4694096601073343,713,558,1271,-
chr6,109368319,2.078663974423692,796,565,1361,-
chr6,109368487,1.9693096058459714,1191,832,2023,-
chr6,109368525,2.641042030962188,819,516,1335,-
chr6,109368781,2.0823700825643514,793,709,1502,-
chr6,109368833,2.5463006049325267,683,613,1296,-
chr6,109368884,2.23728813559322,769,412,1181,-
chr6,109368886,2.23728813559322,769,412,1181,-
chr6,109368951,2.078714859437751,646,414,1060,-
chr6,109369011,3.194470553319069,740,512,1252,-
chr6,109379611,2.5821960297766746,665,402,1067,-
chr6,109382254,2.574591621513271,706,527,1233,-
chr6,109382304,0.8857466589703432,674,429,1103,-
chr6,110100579,1.6899766899766897,724,506,1230,-
chr6,111047353,1.5334212454212457,1687,1124,2811,-
chr6,111047354,1.7053820183135617,2286,1637,3923,-
chr6,111047357,2.564348417214042,1263,920,2183,-
chr6,111047375,0.481300604035471,1283,1003,2286,-
chr6,111047376,0.481300604035471,1283,1003,2286,-
chr6,111696288,1.848856378566689,2242,2191,4433,-
chr6,111696290,1.848856378566689,2242,2191,4433,-
chr6,111696293,1.2556565986483317,3709,3149,6858,-
chr6,111696294,1.7710896673763374,2784,2451,5235,-
chr6,111696296,1.6495743159810228,1812,1560,3372,-
chr6,111696302,1.1983084853032329,702,603,1305,-
chr6,111696415,1.9443407158893986,3236,2414,5650,-
chr6,111696423,1.809203142536476,1455,1133,2588,-
chr6,111696427,0.4270859880727866,1196,852,2048,-
chr6,111696433,1.7881380580735855,1134,841,1975,-
chr6,111696434,2.7367053525030314,853,501,1354,-
chr6,111696437,1.4964788732394367,1019,709,1728,-
chr6,111696438,2.3778723404255317,761,422,1183,-
chr6,111696441,1.8047595018854476,1692,1188,2880,-
chr6,111696444,1.8670585184544903,799,502,1301,-
chr6,111696448,1.7782118055555556,722,431,1153,-
chr6,111714396,1.9822271591224658,1375,1107,2482,-
chr6,111714397,1.9332889903402823,2013,1593,3606,-
chr6,111714399,2.0924439197166467,1915,1451,3366,-
chr6,111714401,2.100084817642069,1237,916,2153,-
chr6,111714421,0.3995157384987893,791,471,1262,-
chr6,111714423,0.3995157384987893,791,471,1262,-
chr6,111719851,3.6951937716013306,667,395,1062,-
chr6,113940965,2.5169811320754714,597,529,1126,-
chr6,113941725,1.7452326468344777,615,436,1051,-
chr6,113943400,2.3708832335329344,904,667,1571,-
chr6,113943420,1.907098052728131,1187,924,2111,-
chr6,113943431,1.7528888888888892,815,539,1354,-
chr6,113943462,2.4984211804712166,1111,715,1826,-
chr6,113944341,1.6926179911254535,1048,602,1650,-
chr6,113944359,0.49965355300639,589,418,1007,-
chr6,113946049,1.9800420168067228,579,447,1026,-
chr6,113953387,1.822983077528532,873,769,1642,-
chr6,113953393,2.13269367448472,810,669,1479,-
chr6,113953417,1.8967640918580377,672,478,1150,-
chr6,113956137,1.3502772136402554,2004,1540,3544,-
chr6,113956139,1.040909090909091,1373,1077,2450,-
chr6,113958757,1.0073529411764706,1232,695,1927,-
chr6,113958758,1.0073529411764706,1232,695,1927,-
chr6,116258575,0.9053165359321764,787,600,1387,-
chr6,116258577,1.3111888111888113,1109,857,1966,-
chr6,116258579,0.95741612086032,1117,831,1948,-
chr6,116258803,1.1640483659511307,1297,1224,2521,-
chr6,116258805,0.9361592721280744,2987,2138,5125,-
chr6,116258807,1.0552775792232547,1956,1398,3354,-
chr6,116258810,1.5349946977730646,771,551,1322,-
chr6,116258815,1.0951039569911438,713,657,1370,-
chr6,116453188,1.0283192413589932,2862,2113,4975,-
chr6,116453192,1.6369389256806477,1361,905,2266,-
chr6,116453202,2.2357743097238902,969,832,1801,-
chr6,116453239,1.2595002220432252,2614,1666,4280,-
chr6,116453240,1.8580431348306887,1272,843,2115,-
chr6,116453241,1.3240603610377628,3302,2175,5477,-
chr6,116453245,1.1075476450340025,1163,830,1993,-
chr6,116453247,1.1930600011455308,1588,1110,2698,-
chr6,116453249,1.7456257189562268,606,397,1003,-
chr6,116453250,1.1975335277851449,1356,827,2183,-
chr6,116453251,1.8081595353436954,1233,747,1980,-
chr6,116453252,1.449801051584482,668,453,1121,-
chr6,116453399,1.3949211908931698,1646,1141,2787,-
chr6,116453404,0.5983620257395955,536,578,1114,-
chr6,116453405,1.6495218777166039,1770,1420,3190,-
chr6,116453406,1.6495218777166039,1770,1420,3190,-
chr6,116453427,0.8621504157218444,1824,1367,3191,-
chr6,116453428,0.8621504157218444,1824,1367,3191,-
chr6,116453429,0.8621504157218444,1824,1367,3191,-
chr6,116453434,0.31012748721627276,1066,807,1873,-
chr6,117561147,1.3637754633403933,1518,1032,2550,-
chr6,117561149,3.8850226498759444,720,481,1201,-
chr6,122444459,1.7858727309792142,590,422,1012,-
chr6,122444465,2.6252742199424977,591,418,1009,-
chr6,122445156,1.282934011570759,626,470,1096,-
chr6,122458532,2.7210672677092083,629,489,1118,-
chr6,122471799,0.3947208121827411,647,393,1040,-
chr6,122471800,0.41128754471116036,974,713,1687,-
chr6,125276134,1.7144480519480518,1073,839,1912,-
chr6,125276136,1.7144480519480518,1073,839,1912,-
chr6,125300580,2.1296217089630263,1006,1001,2007,-
chr6,125300581,1.9996455655145178,1504,1338,2842,-
chr6,125300582,2.1296217089630263,1006,1001,2007,-
chr6,127996980,1.3441173457727038,1874,1210,3084,-
chr6,127996982,2.228621555356856,2326,1562,3888,-
chr6,127996983,2.576210134369435,1200,851,2051,-
chr6,127996984,2.576210134369435,1200,851,2051,-
chr6,127996985,0.3563218390804598,619,434,1053,-
chr6,127998761,3.8766492662395495,916,438,1354,-
chr6,130869692,3.168542825361513,1206,898,2104,-
chr6,130869693,3.168542825361513,1206,898,2104,-
chr6,130869703,1.8130328415746164,1018,657,1675,-
chr6,130869704,1.8130328415746164,1018,657,1675,-
chr6,130895059,0.20431725321489977,745,441,1186,-
chr6,134170165,1.23241288625904,814,506,1320,-
chr6,134170167,1.23241288625904,814,506,1320,-
chr6,134987767,2.6064898274530006,697,352,1049,-
chr6,134987777,0.3311472101705176,1093,582,1675,-
chr6,134987778,0.9247987029560983,1583,843,2426,-
chr6,134997510,2.574184326915802,812,658,1470,-
chr6,136261394,0.6305114638447972,714,431,1145,-
chr6,136343945,3.230129201094994,874,602,1476,-
chr6,136344094,2.6954545454545453,592,439,1031,-
chr6,136345978,2.5127926806615286,798,635,1433,-
chr6,136362461,4.850999258602218,782,631,1413,-
chr6,136389486,2.3477941176470587,720,475,1195,-
chr6,136389488,1.9876464905575435,1041,651,1692,-
chr6,136389490,1.1375,1273,783,2056,-
chr6,136389492,1.1375,1273,783,2056,-
chr6,137198094,2.356368263284341,782,560,1342,-
chr6,137206204,4.649128122798439,610,497,1107,-
chr6,138091321,2.238704177323103,1312,781,2093,-
chr6,138092019,1.729280582294812,4767,3558,8325,-
chr6,138092046,1.6747071858182971,777,584,1361,-
chr6,138092064,2.976447580988012,760,618,1378,-
chr6,138092093,0.5301960784313725,1143,849,1992,-
chr6,138092175,0.5828677839851024,938,715,1653,-
chr6,138092226,1.7880790430264968,1857,1235,3092,-
chr6,138092240,1.7195512820512822,554,467,1021,-
chr6,138096436,0.7355769230769232,953,623,1576,-
chr6,138096437,0.5174405174405174,559,467,1026,-
chr6,138096442,2.4000910176252215,1826,1380,3206,-
chr6,138096451,1.691248391248391,772,517,1289,-
chr6,138096454,2.9274159652762957,956,715,1671,-
chr6,138107143,1.707462686567164,623,401,1024,-
chr6,138107194,1.5498082407602765,827,544,1371,-
chr6,138917620,3.42152466367713,762,445,1207,-
chr6,138917621,3.42152466367713,762,445,1207,-
chr6,139373110,2.987151082435609,717,525,1242,-
chr6,139373148,2.6325224688538045,596,430,1026,-
chr6,142760534,3.7117661161312943,652,598,1250,-
chr6,143497473,3.545268890401634,743,338,1081,-
chr6,143497474,3.545268890401634,743,338,1081,-
chr6,143504049,3.0059947260365774,693,480,1173,-
chr6,143511445,1.8755950443276743,940,754,1694,-
chr6,143511447,1.0233598361862482,804,630,1434,-
chr6,144094998,2.778119366025195,780,594,1374,-
chr6,144095168,1.1711289153997135,869,685,1554,-
chr6,144095378,3.2841283882813315,999,714,1713,-
chr6,144095379,3.5296645607866837,949,601,1550,-
chr6,144095393,1.4575551580071653,1077,748,1825,-
chr6,144095562,0.8738963070693244,1233,615,1848,-
chr6,144095563,0.7552698928521625,891,482,1373,-
chr6,144095564,0.8248037277147422,1383,692,2075,-
chr6,144200943,0.7910751051835239,1038,2065,3103,-
chr6,144200945,1.2221345335140283,1033,1572,2605,-
chr6,149660486,3.130518029996809,653,552,1205,-
chr6,149660487,2.1682046526864287,1046,851,1897,-
chr6,149819051,5.001524996099396,877,749,1626,-
chr6,149819359,2.166132472076763,1497,1049,2546,-
chr6,149819628,0.9287379323828536,1311,973,2284,-
chr6,149819903,0.45156179266636487,797,563,1360,-
chr6,149819908,1.6730769230769231,779,519,1298,-
chr6,149819943,1.712984377241251,1742,1230,2972,-
chr6,149819944,1.2988483492522875,1747,1282,3029,-
chr6,149820067,2.5225,1008,799,1807,-
chr6,149820068,2.5225,1008,799,1807,-
chr6,151225935,1.0555379883289735,1005,808,1813,-
chr6,151225936,0.7721193665702644,2049,1807,3856,-
chr6,151225937,0.8152101288736652,3687,3127,6814,-
chr6,152975079,4.728812024628757,588,416,1004,-
chr6,152975129,0.6661950671664648,2899,1852,4751,-
chr6,152975131,1.3301578822412157,2358,1439,3797,-
chr6,152975137,1.6543329414205683,1195,760,1955,-
chr6,152975145,1.4379764713435088,1722,988,2710,-
chr6,152975160,1.8786862224996101,1744,985,2729,-
chr6,152975161,1.878808027079304,2390,1315,3705,-
chr6,152975162,1.5513791404183628,5631,3290,8921,-
chr6,152975170,1.8909574468085104,710,375,1085,-
chr6,152975204,2.483552631578948,754,415,1169,-
chr6,152991242,1.8388217522658608,986,661,1647,-
chr6,152991248,2.25776397515528,726,482,1208,-
chr6,152991257,2.0477967018113,1305,821,2126,-
chr6,152991258,2.0477967018113,1305,821,2126,-
chr6,152991274,5.1589487693592,877,482,1359,-
chr6,153282271,2.7377776082555085,3048,2282,5330,-
chr6,153282272,2.867242617601668,3297,2570,5867,-
chr6,153282275,0.8822846448551065,1918,1202,3120,-
chr6,153282276,0.5898934037158562,1641,1013,2654,-
chr6,153282457,0.7114094875920237,5101,3974,9075,-
chr6,153282459,1.3882403903731733,6190,4616,10806,-
chr6,153282460,1.3196138157467463,22468,15705,38173,-
chr6,153282461,1.4950847970926713,8660,4952,13612,-
chr6,153282470,1.4447455040554515,6373,3712,10085,-
chr6,153282597,1.1782530005149485,17924,14433,32357,-
chr6,153282603,1.2063543787413418,11089,6993,18082,-
chr6,153282608,1.3292600495829574,32513,23870,56383,-
chr6,153282614,1.4029838907323746,22113,14652,36765,-
chr6,153282616,1.3535686224056087,34851,22668,57519,-
chr6,153282617,1.3232526534542235,38618,25440,64058,-
chr6,153282619,1.256275629766433,25167,16439,41606,-
chr6,153282625,1.987032206895988,4189,2982,7171,-
chr6,153282632,1.2739426611124725,4998,2694,7692,-
chr6,153282633,0.7219211008138344,4162,3178,7340,-
chr6,153282653,1.708430755274284,3401,1698,5099,-
chr6,153282669,1.239786698426987,10537,7177,17714,-
chr6,153282670,1.4746765233054957,13627,8018,21645,-
chr6,153282671,1.4746765233054957,13627,8018,21645,-
chr6,153282732,1.2783906383538228,2675,1854,4529,-
chr6,153282734,1.0578211094195935,4430,3320,7750,-
chr6,153282735,1.0976878524846845,5575,4189,9764,-
chr6,153282736,1.1281842560875333,6594,4938,11532,-
chr6,153282737,1.0084388813336889,7837,5646,13483,-
chr6,153282738,0.9353167700802684,7679,5978,13657,-
chr6,153282739,0.8562494400897994,7118,5402,12520,-
chr6,153282744,1.7010666581189504,2342,1611,3953,-
chr6,153282746,1.7100228902708008,2570,1788,4358,-
chr6,153282752,1.336065820543278,1612,985,2597,-
chr6,153282753,1.3578501505550036,1223,765,1988,-
chr6,154406132,2.423944756861127,871,840,1711,-
chr6,157292879,3.013925169134604,641,403,1044,-
chr6,158636702,2.0568663036902604,679,550,1229,-
chr6,158636762,0.5055308590923189,651,568,1219,-
chr6,158636775,0.5683520599250936,606,533,1139,-
chr6,158641344,1.2252786567251064,902,601,1503,-
chr6,158766381,3.5307732475081615,2566,1678,4244,-
chr6,158766382,3.5307732475081615,2566,1678,4244,-
chr6,158766503,1.6017002740111008,893,661,1554,-
chr6,158770837,1.966808717390343,907,747,1654,-
chr6,158771267,3.421402128700389,895,768,1663,-
chr6,158783655,1.9988270804449115,776,517,1293,-
chr6,158783662,0.4566384208528356,638,439,1077,-
chr6,158784676,2.184270200770334,626,506,1132,-
chr6,158785479,1.1907868888606619,1001,761,1762,-
chr6,158785556,1.2724018613530603,687,577,1264,-
chr6,158785557,1.2724018613530603,687,577,1264,-
chr6,158818101,1.1857195551826007,557,479,1036,-
chr6,158818114,0.7733624280015524,661,429,1090,-
chr6,159679659,0.6165266106442577,1135,839,1974,-
chr6,159679818,0.5637821729775753,1399,998,2397,-
chr6,159679820,0.5637821729775753,1399,998,2397,-
chr6,159679890,1.7062073779122757,635,425,1060,-
chr6,159680086,1.675673712500908,1002,705,1707,-
chr6,159680401,1.7877781133595083,682,472,1154,-
chr6,159680546,1.9977484472049687,952,643,1595,-
chr6,159680548,2.1421462294245246,1398,921,2319,-
chr6,159680549,1.764391035602058,928,590,1518,-
chr6,159680641,2.25143815915628,908,595,1503,-
chr6,159680671,2.4091778202676863,867,522,1389,-
chr6,159680673,2.4091778202676863,867,522,1389,-
chr6,159680852,1.869338925026803,756,498,1254,-
chr6,159680853,1.48262607672671,1020,678,1698,-
chr6,159681413,1.858552631578948,677,479,1156,-
chr6,159681584,15.491582592470639,2326,4108,6434,-
chr6,159681586,17.00161341560813,3942,4796,8738,-
chr6,159681587,29.28349885544635,2875,2456,5331,-
chr6,159681588,27.79473130384363,2003,1623,3626,-
chr6,159681589,26.857563025210084,857,339,1196,-
chr6,159681591,8.139559585923163,844,186,1030,-
chr6,159681771,1.6391793690180787,1253,867,2120,-
chr6,159681777,1.8689909384119183,1131,765,1896,-
chr6,159681778,1.9353988134475943,1100,614,1714,-
chr6,159681783,1.5270162785471835,1413,905,2318,-
chr6,159681814,2.0238999683444128,672,350,1022,-
chr6,159681815,0.4353224834237493,1255,789,2044,-
chr6,159681816,0.4353224834237493,1255,789,2044,-
chr6,159682148,2.5400613706102964,595,418,1013,-
chr6,159682558,1.3640921244530868,1229,967,2196,-
chr6,159682579,1.6036004932182488,1065,810,1875,-
chr6,159682582,1.0998731641875226,2361,1800,4161,-
chr6,159684897,0.5176840166820127,530,498,1028,-
chr6,159684919,0.46511627906976744,899,644,1543,-
chr6,159685015,2.0012051763609193,1789,1228,3017,-
chr6,159688202,1.8694416515674794,1320,928,2248,-
chr6,159688226,2.3375,883,519,1402,-
chr6,159688227,1.3664547351118332,1165,889,2054,-
chr6,159688236,2.6945454545454544,740,439,1179,-
chr6,159688238,1.838545454545455,631,499,1130,-
chr6,159688240,1.4792822966507178,718,549,1267,-
chr6,159692686,1.5509030370295631,808,582,1390,-
chr6,159692728,0.4760466712422786,577,469,1046,-
chr6,159692840,1.8569809238542259,953,703,1656,-
chr6,159693241,0.9148188115709961,2554,1248,3802,-
chr6,159693243,1.008537392101238,4033,2450,6483,-
chr6,159693249,1.9373753774048423,2825,1707,4532,-
chr6,159693251,2.06010863367644,1400,708,2108,-
chr6,159693266,0.5355114535047024,2086,1224,3310,-
chr6,159779161,2.1097399332693447,1488,1121,2609,-
chr6,159779236,1.4999289772727271,1292,959,2251,-
chr6,159779754,1.4061804697156983,1421,808,2229,-
chr6,159780054,1.637931034482759,1291,985,2276,-
chr6,159780528,1.5544619422572181,1029,761,1790,-
chr6,159781077,1.596240529831082,3231,2157,5388,-
chr6,159781108,2.4633853541416566,1443,832,2275,-
chr6,159784039,1.4104193475008235,3180,2307,5487,-
chr6,159784055,1.5029959204487509,1386,887,2273,-
chr6,159784065,2.2194264069264067,630,461,1091,-
chr6,159784721,1.5886824324324322,1088,887,1975,-
chr6,159785994,2.200766038940313,984,722,1706,-
chr6,159787862,1.8209650582362733,854,600,1454,-
chr6,159789494,1.5856079404466499,3194,1797,4991,-
chr6,159789496,1.5762074783043134,3709,2144,5853,-
chr6,159789518,1.7305769824128354,683,462,1145,-
chr6,159789528,0.4200205699908462,2598,1581,4179,-
chr6,159789529,0.4172165534704563,2221,1321,3542,-
chr6,159789530,0.5061094948426342,1494,994,2488,-
chr6,159789531,0.4314819462389574,2368,1510,3878,-
chr6,159789588,1.7706499888318068,733,604,1337,-
chr6,159789590,1.7706499888318068,733,604,1337,-
chr6,159789611,3.8860672810739034,880,692,1572,-
chr6,159789615,4.6646500556817,790,478,1268,-
chr6,165939767,2.663265306122449,782,440,1222,-
chr6,165939769,2.663265306122449,782,440,1222,-
chr6,165939871,0.8527755430410296,1619,1242,2861,-
chr6,165939872,0.8527755430410296,1619,1242,2861,-
chr6,165939873,1.0751191172705816,1885,1466,3351,-
chr6,165939948,2.9119966791199663,609,437,1046,-
chr6,165940298,0.2230521719145024,646,457,1103,-
chr6,165940503,0.9642921748433639,1303,882,2185,-
chr6,165940504,1.325752328498929,955,634,1589,-
chr6,165949293,0.5573623415947068,709,481,1190,-
chr6,165987833,1.6006777577283813,2040,1438,3478,-
chr6,165987837,1.5431034482758617,1073,695,1768,-
chr6,165987840,1.219084232196727,1728,1199,2927,-
chr6,165987846,1.5988420906789786,1383,994,2377,-
chr6,165987848,1.5032165227695953,825,536,1361,-
chr6,165987854,1.5532416592170457,1481,913,2394,-
chr6,165987900,1.4170141577348776,1071,677,1748,-
chr6,165987934,0.4239852682379461,763,546,1309,-
chr6,165987962,1.1879995786983466,607,471,1078,-
chr6,166320115,1.6361730512673909,1009,635,1644,-
chr6,166320196,3.937234944868533,632,392,1024,-
chr6,166320210,0.5555304281459493,1300,971,2271,-
chr6,166320246,0.4683257918552036,620,441,1061,-
chr6,166329520,1.7947598253275112,547,457,1004,-
chr6,166329557,0.9852758630546031,1186,893,2079,-
chr6,166329559,0.5563389923329681,902,663,1565,-
chr6,166342521,5.797357855879698,799,721,1520,-
chr6,166342523,6.450354181328376,1064,1024,2088,-
chr6,169704024,0.5298959959464443,1782,1223,3005,-
chr6,169704025,0.5917318982387475,819,583,1402,-
chr6,169705644,0.2858961577956036,661,514,1175,-
chr6,169708457,2.26321752265861,921,661,1582,-
chr6,169708609,1.718209655007672,1375,835,2210,-
chr6,169708611,2.285981187991238,958,596,1554,-
chr6,169709244,0.6049154334038055,762,527,1289,-
chr6,169709788,1.0447395794372425,892,615,1507,-
chr6,169710288,1.6453473746733513,1279,897,2176,-
chr6,169710313,2.1235114926613132,638,470,1108,-
chr6,169710315,1.0069471523307956,1016,703,1719,-
chr6,169710316,0.4759378552482002,627,454,1081,-
chr6,169715799,1.581456553548036,2256,1697,3953,-
chr6,169715834,2.497090765664702,1461,893,2354,-
chr6,169715997,2.106847941942631,2137,1421,3558,-
chr6,169715998,1.954153846153846,2262,1549,3811,-
chr6,169716000,1.3898417795142897,2462,1714,4176,-
chr6,169717853,0.44117647058823534,554,480,1034,-
chr6,169721018,2.3246268656716422,800,669,1469,-
chr6,169721041,1.5113892647722147,1030,738,1768,-
chr6,169721091,1.2062131326259595,1008,733,1741,-
chr6,170535195,0.6568342119708755,1713,1060,2773,-
chr6,170535306,1.629810636994692,1964,1263,3227,-
chr6,170535334,1.7386565047855371,852,727,1579,-
chr6,170535337,1.6438440177290052,2019,1727,3746,-
chr6,170535373,1.438448459625438,1642,1036,2678,-
chr6,170543669,1.5367198335644936,1342,1029,2371,-
chr6,170549109,1.3875567266871611,1480,1241,2721,-
chr6,170553156,1.38783646672635,1905,1116,3021,-
chr6,170553222,0.6631174089068825,1488,1299,2787,-
chr6,170553223,1.8304087338570094,1296,1014,2310,-
chr6,170553271,0.5957625971760673,1131,910,2041,-
chr6,170553285,1.2692980214001925,2862,2395,5257,-
chr6,170553296,0.9549632568731948,1157,763,1920,-
chr6,170553297,3.6457885672907695,932,649,1581,-
chr6,170553298,0.9549632568731948,1157,763,1920,-
chr6,170577285,3.133030502739565,885,548,1433,-
chr6,170577409,1.6592036464441366,7930,4175,12105,-
chr6,170577410,1.7362742671107512,4950,2897,7847,-
chr6,170577450,1.4705267605007448,1537,788,2325,-
chr6,170577523,2.135584677419355,1114,639,1753,-
chr6,170577548,0.4140005468963632,756,476,1232,-
chr6,170577551,1.740139211136891,629,430,1059,-
chr6,170577597,1.9926416482707876,676,452,1128,-
chr6,170578869,4.394642857142856,641,419,1060,-
chr6,170578908,3.4004758128469468,803,581,1384,-
chr6,170578910,3.4004758128469468,803,581,1384,-
chr6,170578963,1.1753245644815105,1218,875,2093,-
chr6,170580044,1.592954990215264,813,510,1323,-
chr6,170580065,1.3796126315339017,853,572,1425,-
chr6,170583175,0.5856639247943596,711,689,1400,-
chr6,170583178,2.4623724489795915,571,447,1018,-
chr6,170583525,0.5963480963480964,613,428,1041,-
chr6,170583581,2.005089450716263,1138,851,1989,-
chr6,170583602,2.222923976608187,558,474,1032,-
chr6,170583722,0.4264386799259944,664,566,1230,-
chr7,1567597,2.0167530913442357,631,435,1066,-
chr7,1567598,2.4551676284959667,1162,790,1952,-
chr7,1567600,2.4554455445544554,607,403,1010,-
chr7,1567846,2.376503804607643,683,480,1163,-
chr7,2730740,2.7720316322466863,936,836,1772,-
chr7,2730741,2.7720316322466863,936,836,1772,-
chr7,2730761,1.7914977580815863,801,601,1402,-
chr7,2730762,1.1753123853290675,730,561,1291,-
chr7,5527269,0.4994899000204041,1019,753,1772,-
chr7,5527273,0.5814034495590691,2608,2081,4689,-
chr7,5527274,0.5814034495590691,2608,2081,4689,-
chr7,5527275,0.54575916837627,3839,3202,7041,-
chr7,5527278,1.5900814211695045,933,771,1704,-
chr7,5527280,0.3376450056462376,597,572,1169,-
chr7,5527282,0.538726842727631,780,707,1487,-
chr7,5527553,1.3880026227917572,4465,2836,7301,-
chr7,5527742,1.0396808067054102,8473,6218,14691,-
chr7,5527758,0.7196148831066257,18151,12937,31088,-
chr7,5527759,0.7477194993753619,9051,7095,16146,-
chr7,5527793,1.3307495068571726,10800,7629,18429,-
chr7,5527803,1.352888602888603,2910,2015,4925,-
chr7,5527808,1.6035860655737704,2819,1951,4770,-
chr7,5527814,1.8027659574468091,2747,1879,4626,-
chr7,5527868,1.430083666768524,7056,5372,12428,-
chr7,5527869,1.3417013335123433,17201,12539,29740,-
chr7,5528040,1.5593400556451469,6469,3864,10333,-
chr7,5528052,2.0651727091064798,17837,14011,31848,-
chr7,5528053,1.8260007498528041,28104,20522,48626,-
chr7,5528073,1.5763734005931713,9906,6859,16765,-
chr7,5528076,0.6930398361963616,7602,4800,12402,-
chr7,5528098,1.4350130556356977,5814,3748,9562,-
chr7,5528159,1.3257841949254667,12007,7899,19906,-
chr7,5528161,1.2687198824751194,8791,5092,13883,-
chr7,5528163,1.3082542234987053,8206,5332,13538,-
chr7,5528372,1.2739261467772052,7146,4631,11777,-
chr7,5528462,1.3701904004724699,17982,13191,31173,-
chr7,5528463,1.3909775160003883,14685,10453,25138,-
chr7,5528510,1.2882733560705064,3108,2518,5626,-
chr7,5528585,1.2635884838675442,7583,5126,12709,-
chr7,5528588,1.6464793141932625,4847,3062,7909,-
chr7,5528700,1.4933535484004656,3202,2392,5594,-
chr7,5528706,1.526784869976359,2957,2114,5071,-
chr7,5528709,1.5171817911809469,5446,3762,9208,-
chr7,5528710,1.5171817911809469,5446,3762,9208,-
chr7,5528717,1.383837026806008,5140,3196,8336,-
chr7,5528719,1.1240067371626659,6522,4227,10749,-
chr7,5528720,0.9445066948150301,1586,1113,2699,-
chr7,5528721,0.8427734583022687,941,686,1627,-
chr7,5529251,1.1240096386973155,5673,4507,10180,-
chr7,5529274,0.7661568018916721,2253,1734,3987,-
chr7,5529342,1.3583081817440248,1958,1195,3153,-
chr7,5529347,0.6240485329516622,1036,808,1844,-
chr7,5529373,1.4751757937353505,1448,740,2188,-
chr7,5529650,0.532675072678169,1190,952,2142,-
chr7,5529651,1.4980537602820212,1989,1471,3460,-
chr7,5529654,1.6828050643752215,2808,2132,4940,-
chr7,5529659,1.560552961871205,5160,3376,8536,-
chr7,5530547,1.520267423242226,983,733,1716,-
chr7,5530560,1.7656706609781332,2882,1991,4873,-
chr7,5530569,1.6610618374696406,5648,3214,8862,-
chr7,5530571,1.6515832558513008,3152,1976,5128,-
chr7,5530574,2.1292046999135783,2782,1335,4117,-
chr7,5530584,2.5771743488331142,1970,816,2786,-
chr7,5530588,3.009753593429158,901,486,1387,-
chr7,5530593,2.151606110476384,6715,2851,9566,-
chr7,5530594,2.1931378678875766,7023,2879,9902,-
chr7,5530595,2.12127323067689,5340,2423,7763,-
chr7,5530596,2.3105201246715357,5395,2419,7814,-
chr7,5530597,2.4298128802784382,3417,1487,4904,-
chr7,5530600,0.7814440545170128,2558,890,3448,-
chr7,6023914,2.8999457700650764,712,460,1172,-
chr7,6023961,0.554232913397032,1319,1052,2371,-
chr7,6023992,1.114900572189254,1176,925,2101,-
chr7,6024246,1.7086743044189852,695,422,1117,-
chr7,6024480,1.8471337579617837,599,470,1069,-
chr7,6024511,2.45124716553288,704,440,1144,-
chr7,6024671,0.5983360783816885,1011,876,1887,-
chr7,6024675,11.044236157873172,5562,4460,10022,-
chr7,6024676,11.044236157873172,5562,4460,10022,-
chr7,6026902,0.4689327888754001,606,532,1138,-
chr7,6028628,1.5117777338045506,1425,942,2367,-
chr7,6028684,2.955854126679463,659,520,1179,-
chr7,6028991,1.6808050000573975,4021,3006,7027,-
chr7,6028996,1.949133261105092,3270,2129,5399,-
chr7,6028997,1.949133261105092,3270,2129,5399,-
chr7,6029005,1.4726385500174275,1520,905,2425,-
chr7,6037498,0.4237976163413763,869,580,1449,-
chr7,6038577,0.5214122262177182,637,482,1119,-
chr7,6038666,1.8153873489694383,600,468,1068,-
chr7,6040968,1.4768555953933982,2465,1875,4340,-
chr7,6040969,0.9569661200681384,1737,1305,3042,-
chr7,6041029,1.534926470588235,834,607,1441,-
chr7,6041143,0.6500611620795107,732,653,1385,-
chr7,6041151,0.5125044447078346,1080,766,1846,-
chr7,6041152,0.6050347222222222,614,479,1093,-
chr7,6041181,2.822730422730422,598,554,1152,-
chr7,6041190,1.85,1220,1055,2275,-
chr7,6041191,1.9065154516156466,1930,1556,3486,-
chr7,6041202,1.7214012036844615,1066,789,1855,-
chr7,6042974,1.794316644113667,1019,738,1757,-
chr7,6042975,1.794316644113667,1019,738,1757,-
chr7,6046088,0.4642070484581498,561,453,1014,-
chr7,6046103,0.44992620704195657,581,458,1039,-
chr7,6047076,1.6185389941495356,814,600,1414,-
chr7,6047077,1.4593404516117292,2078,1962,4040,-
chr7,6047081,1.7539708425342968,2368,1838,4206,-
chr7,6047082,1.8667253752037627,1486,1006,2492,-
chr7,6049971,2.1829893134240956,931,620,1551,-
chr7,6050023,1.5281831570491369,877,678,1555,-
chr7,6050024,0.49609751372435845,1757,1207,2964,-
chr7,6054579,0.5869373345101501,797,617,1414,-
chr7,6054582,1.6680118375033628,599,530,1129,-
chr7,6054583,3.0901287553648067,639,465,1104,-
chr7,6054668,1.054054054054054,856,856,1712,-
chr7,6054670,1.054054054054054,856,856,1712,-
chr7,6054685,0.5205800096534876,1034,1123,2157,-
chr7,6054686,0.9564309805857192,953,1073,2026,-
chr7,6059022,2.2818963359813567,618,834,1452,-
chr7,6059024,4.5875841815237965,1908,2182,4090,-
chr7,6059025,5.286644304687767,1590,1752,3342,-
chr7,6059026,4.725735894735893,825,1029,1854,-
chr7,6059030,4.091446872260256,978,722,1700,-
chr7,6059031,4.359836033885744,1084,818,1902,-
chr7,6161894,2.227626459143969,915,513,1428,-
chr7,6161895,2.227626459143969,915,513,1428,-
chr7,6161910,2.4774785790132077,732,374,1106,-
chr7,6163111,2.198127446851951,989,694,1683,-
chr7,6163112,2.280391841978481,709,478,1187,-
chr7,6410008,2.5145875611652055,598,483,1081,-
chr7,6413001,0.7612410746213562,735,404,1139,-
chr7,6461666,1.5839585858880034,708,523,1231,-
chr7,6462006,1.8209727112676055,870,567,1437,-
chr7,6462085,1.1150447833454369,736,611,1347,-
chr7,6462086,1.1150447833454369,736,611,1347,-
chr7,6462125,2.2268271041184238,1582,942,2524,-
chr7,6462126,1.3851607130566452,2299,1335,3634,-
chr7,6462128,1.318479019869231,2169,1238,3407,-
chr7,6462130,0.8308943089430895,1386,778,2164,-
chr7,6462324,2.3858661663539706,544,491,1035,-
chr7,6462359,4.8605874585927165,3870,2867,6737,-
chr7,6462360,4.8605874585927165,3870,2867,6737,-
chr7,6462415,2.213942307692308,920,575,1495,-
chr7,6462416,3.45892829725165,703,500,1203,-
chr7,6462417,2.7690639331333347,1623,1075,2698,-
chr7,6462602,1.8555366269165248,777,586,1363,-
chr7,6462786,0.5991723744292237,662,583,1245,-
chr7,6462970,1.9709734513274333,695,564,1259,-
chr7,6462988,1.953623188405797,673,494,1167,-
chr7,6463025,1.8069973087274127,563,458,1021,-
chr7,6463069,1.7876269621421979,967,721,1688,-
chr7,6463093,1.9534632034632036,1139,692,1831,-
chr7,6466171,1.7488262910798122,744,638,1382,-
chr7,6466240,2.233954451345756,663,482,1145,-
chr7,6474282,1.0016447368421053,1217,835,2052,-
chr7,6474283,1.0016447368421053,1217,835,2052,-
chr7,6484038,1.7776498239205238,4047,3029,7076,-
chr7,6484039,2.1805042016806726,2993,2274,5267,-
chr7,6484051,0.565252265982193,1214,684,1898,-
chr7,6484052,0.9546607959116911,3084,1916,5000,-
chr7,6484053,0.9389414217332066,5144,3288,8432,-
chr7,6484054,0.9389414217332066,5144,3288,8432,-
chr7,6484055,1.0390256642640407,4315,2638,6953,-
chr7,6484057,0.9858139484053537,1883,1232,3115,-
chr7,6484085,3.5017465636824134,682,356,1038,-
chr7,6814813,3.3857323380167696,780,519,1299,-
chr7,7636995,1.4674095878889821,996,811,1807,-
chr7,7637077,1.757097911375611,945,712,1657,-
chr7,7637907,1.4961805179326038,1082,838,1920,-
chr7,7637961,0.5966363055289229,1029,893,1922,-
chr7,7640362,2.8150183150183152,582,545,1127,-
chr7,7640364,1.833363309352518,702,555,1257,-
chr7,7640401,2.2880991796301666,1098,721,1819,-
chr7,7640424,1.0502265637121893,971,655,1626,-
chr7,10933606,1.4281657200133648,2059,1639,3698,-
chr7,10933658,1.585008554319932,1457,1168,2625,-
chr7,10933678,2.091527335456476,1881,1255,3136,-
chr7,10933681,1.6188710292490591,2634,1848,4482,-
chr7,10933684,1.8344025661587808,1463,927,2390,-
chr7,10933688,1.075005513912264,2125,1611,3736,-
chr7,10933691,0.9890626335127746,1388,845,2233,-
chr7,10933692,0.8192164256627887,1844,1205,3049,-
chr7,10938103,0.4811901504787962,1004,859,1863,-
chr7,10938105,0.5111624326404927,663,432,1095,-
chr7,10938114,1.658679706601467,635,408,1043,-
chr7,10938117,1.7984615384615386,1001,779,1780,-
chr7,10938118,2.1200378169958323,1652,961,2613,-
chr7,10938138,1.9149350649350645,982,769,1751,-
chr7,10938888,1.3397311882700336,1661,1402,3063,-
chr7,10938894,1.4937543954693728,4085,2863,6948,-
chr7,10940086,1.6958745165449076,1177,894,2071,-
chr7,10940124,0.6707150247844917,5697,3559,9256,-
chr7,10940125,0.649299973425636,6715,4242,10957,-
chr7,10940129,0.5870836192670587,3622,2309,5931,-
chr7,10940161,1.3464246830778104,2446,1757,4203,-
chr7,10940162,0.7512101463466552,3889,2827,6716,-
chr7,10940169,0.6559160305343511,981,654,1635,-
chr7,10940170,0.8674483892454616,2674,1737,4411,-
chr7,10940172,0.8038852036623532,4630,3092,7722,-
chr7,19698341,2.9790404019046495,664,479,1143,-
chr7,21220616,0.7345738659893432,1266,1248,2514,-
chr7,21220617,0.7345738659893432,1266,1248,2514,-
chr7,21220618,0.6546752216855309,1008,1260,2268,-
chr7,21220619,0.6546752216855309,1008,1260,2268,-
chr7,21220620,1.642524840618,723,756,1479,-
chr7,21220621,0.6124119987756351,1509,1088,2597,-
chr7,21220622,1.642524840618,723,756,1479,-
chr7,21220623,0.7993078683953139,2459,1891,4350,-
chr7,21220624,1.0761866895033032,950,803,1753,-
chr7,21221053,2.4487960200012537,710,666,1376,-
chr7,21901369,1.764842417971403,613,492,1105,-
chr7,21901370,3.389324394732723,700,418,1118,-
chr7,21903024,2.4372865106063064,1032,708,1740,-
chr7,21903027,1.8314342822081247,739,505,1244,-
chr7,21905516,2.7748314606741573,685,444,1129,-
chr7,21905518,2.7748314606741573,685,444,1129,-
chr7,22510349,1.2631725619628846,2866,2293,5159,-
chr7,22510352,0.871037440965279,15554,9861,25415,-
chr7,22510354,0.8239227051406286,14890,8939,23829,-
chr7,22510356,1.2949088599041996,1030,1105,2135,-
chr7,22510359,1.4243241569818614,6787,5687,12474,-
chr7,22510360,1.3724220645826644,7356,6146,13502,-
chr7,22510361,1.4053738304926253,6258,5267,11525,-
chr7,22510362,1.1343284702256504,5449,3942,9391,-
chr7,22510364,1.5700027130063654,2660,1928,4588,-
chr7,22510366,1.5016513528898834,4066,2786,6852,-
chr7,22510367,1.249987096707596,3094,1971,5065,-
chr7,22510368,1.3178445030470818,3636,2300,5936,-
chr7,22510369,1.0590255043119798,4523,2789,7312,-
chr7,22510370,1.2345410263594627,1877,1117,2994,-
chr7,22510406,1.4659009577042366,1592,961,2553,-
chr7,22510420,0.6092520997200372,913,576,1489,-
chr7,22813085,1.696931576710582,3143,2352,5495,-
chr7,22813163,1.5791501541171293,2944,2270,5214,-
chr7,22818024,2.3464260134651203,2641,2147,4788,-
chr7,22818042,2.0076092921163347,2385,1774,4159,-
chr7,22818045,1.5808535315481584,2051,1762,3813,-
chr7,22822763,0.7099371832253771,1960,1491,3451,-
chr7,22822813,1.7604267701260912,1209,1030,2239,-
chr7,22822814,1.5838498522852342,1518,848,2366,-
chr7,22822834,1.257181089604728,1513,1265,2778,-
chr7,22822835,1.5408720842161008,1798,1078,2876,-
chr7,22822841,1.075516005786295,1594,1164,2758,-
chr7,22822843,1.0507894736842105,1330,1063,2393,-
chr7,22822845,1.830479372592696,804,652,1456,-
chr7,23310582,2.253462026855311,643,428,1071,-
chr7,23311143,4.950272152465392,649,434,1083,-
chr7,23311144,1.7785779253786498,714,492,1206,-
chr7,23311438,0.4027504911591356,696,508,1204,-
chr7,23311439,0.4027504911591356,696,508,1204,-
chr7,23312106,7.730948532144185,936,260,1196,-
chr7,23312109,94.07276719629739,1667,297,1964,-
chr7,23312110,62.6104059217942,1947,281,2228,-
chr7,23312111,57.85372652976363,2185,267,2452,-
chr7,23312112,33.96591153349292,1994,170,2164,-
chr7,23312113,13.382018487321906,1799,125,1924,-
chr7,23312114,12.962962962962965,1199,71,1270,-
chr7,23312115,14.261904761904757,1197,71,1268,-
chr7,23312116,16.5,956,57,1013,-
chr7,23312222,2.3218697164882323,643,469,1112,-
chr7,23343817,1.1446698141793137,789,586,1375,-
chr7,23343831,1.0657819634703196,678,437,1115,-
chr7,23343833,1.4158590611383013,903,628,1531,-
chr7,23531888,1.5010443109066054,2466,1749,4215,-
chr7,23531890,1.0512485165911472,3064,1948,5012,-
chr7,23531891,0.958658011451906,2152,1348,3500,-
chr7,24698804,1.901879153072404,640,435,1075,-
chr7,24699242,2.761529659985116,599,465,1064,-
chr7,24702823,1.5461314323997635,690,576,1266,-
chr7,24719141,2.124277456647399,965,691,1656,-
chr7,24719143,2.5703051862947017,1403,980,2383,-
chr7,24719144,2.56421647819063,906,618,1524,-
chr7,24749616,2.4438897616504045,1393,1017,2410,-
chr7,24749617,2.1404552352048563,927,658,1585,-
chr7,24749626,1.8326895902556175,738,588,1326,-
chr7,25123328,1.3952442333785615,2538,1473,4011,-
chr7,25123583,1.6324453756360369,908,513,1421,-
chr7,25123592,2.6436170212765955,709,375,1084,-
chr7,25123600,1.7488815985684465,732,478,1210,-
chr7,25123770,0.8232173582933575,3273,2278,5551,-
chr7,25123797,1.3636629807833072,1862,1296,3158,-
chr7,25123801,1.3981350042035083,3761,3106,6867,-
chr7,25123809,1.1311228372305122,3863,3005,6868,-
chr7,25124020,1.6285238418357904,1599,1246,2845,-
chr7,25124054,0.7008467741935483,1336,991,2327,-
chr7,25124063,2.247105454721467,2085,1198,3283,-
chr7,25125226,1.6526880957449326,1425,828,2253,-
chr7,25125236,1.9694004625511479,819,510,1329,-
chr7,25125256,2.775543370354954,1490,792,2282,-
chr7,25125259,0.8495342812836378,1975,1216,3191,-
chr7,25125262,0.969232538746873,910,837,1747,-
chr7,25125263,1.048838390907556,1443,1269,2712,-
chr7,25125264,1.048838390907556,1443,1269,2712,-
chr7,26191107,0.35910522262312905,670,617,1287,-
chr7,26192245,1.33438947788964,9215,6653,15868,-
chr7,26192505,0.69254412211578,6641,7405,14046,-
chr7,26192526,5.819662485466374,8982,10234,19216,-
chr7,26192529,4.807000298188243,17142,16337,33479,-
chr7,26192530,4.807000298188243,17142,16337,33479,-
chr7,26192539,4.025591371290355,24698,17968,42666,-
chr7,26192540,4.186320856242866,29961,20755,50716,-
chr7,26192541,4.186320856242866,29961,20755,50716,-
chr7,26192542,4.980868899100849,16561,11221,27782,-
chr7,26192548,1.6220725817188466,7683,3825,11508,-
chr7,26192551,2.0479440078405604,3729,1706,5435,-
chr7,26193371,1.464962214735634,8592,9831,18423,-
chr7,26193373,1.2286787806702526,5472,6252,11724,-
chr7,26193586,0.7451664876476907,2885,2547,5432,-
chr7,26193591,1.8419092800445247,3563,3280,6843,-
chr7,26193593,2.896989988147516,10898,11464,22362,-
chr7,26193595,2.4488965254989226,4897,4217,9114,-
chr7,26193596,2.1916795534134024,8317,8177,16494,-
chr7,26193603,1.6543458781362008,1476,1115,2591,-
chr7,26193632,16.41854303907163,5906,5051,10957,-
chr7,26193635,10.482307526412573,5908,4007,9915,-
chr7,26193687,0.6427946208323387,1153,638,1791,-
chr7,26193689,2.6846136564181156,4551,2754,7305,-
chr7,26196443,1.7320669925099688,11938,8752,20690,-
chr7,26196444,1.60511069383282,6004,3982,9986,-
chr7,26196446,3.3067305134344243,1355,1073,2428,-
chr7,26196994,2.2523384148261445,6617,5361,11978,-
chr7,26197436,1.3196087114625077,3079,2186,5265,-
chr7,26197658,0.6948447543337327,25142,16322,41464,-
chr7,26197659,0.6876821565592145,20314,12920,33234,-
chr7,26197729,0.9330615666194322,10064,6780,16844,-
chr7,26197731,0.967204459120448,8198,5408,13606,-
chr7,26197733,0.7855025297159799,3975,2615,6590,-
chr7,26197858,2.8021557848058793,611,441,1052,-
chr7,26197863,1.1856224955851895,827,628,1455,-
chr7,26200588,1.3718531468531467,3716,2639,6355,-
chr7,26200604,1.5575699096313442,7729,5212,12941,-
chr7,26200675,1.5755642787046122,1182,1018,2200,-
chr7,26200698,1.4127998919881948,2743,2255,4998,-
chr7,26200699,1.5011222504863084,1823,1140,2963,-
chr7,26200702,1.5720797720797721,1690,1025,2715,-
chr7,26200745,1.422634212739013,1932,1488,3420,-
chr7,26200746,1.066064688340667,762,606,1368,-
chr7,26200771,1.042857142857143,802,384,1186,-
chr7,26200773,0.9521405117070753,1442,768,2210,-
chr7,26200774,0.8470722260195944,640,384,1024,-
chr7,27458450,0.5901856763925729,711,463,1174,-
chr7,27458463,2.1241708422810786,855,634,1489,-
chr7,27458464,2.1241708422810786,855,634,1489,-
chr7,27458622,1.5119952527621578,1091,822,1913,-
chr7,27458642,2.6331521739130435,740,623,1363,-
chr7,27458643,2.6331521739130435,740,623,1363,-
chr7,27458660,1.9216131360652908,926,651,1577,-
chr7,27458661,1.8808962264150944,637,423,1060,-
chr7,27538354,1.8786350575319424,677,525,1202,-
chr7,27538375,3.660313901345292,652,445,1097,-
chr7,27538376,3.107440243559357,1193,866,2059,-
chr7,27632367,2.79641838488073,2202,3164,5366,-
chr7,27632368,2.9214224706887184,874,1430,2304,-
chr7,27632371,1.9387094516569268,1244,1680,2924,-
chr7,27632373,1.9387094516569268,1244,1680,2924,-
chr7,27632377,2.2222222222222223,724,1014,1738,-
chr7,27632378,2.2222222222222223,724,1014,1738,-
chr7,27632381,2.7353080568720376,678,843,1521,-
chr7,27632382,2.7353080568720376,678,843,1521,-
chr7,28995855,1.765050459886962,1327,1014,2341,-
chr7,29066112,1.6260019893511204,793,632,1425,-
chr7,29071794,1.7450581395348843,666,515,1181,-
chr7,29071872,0.5048920176589906,650,492,1142,-
chr7,29071878,1.9048369308334645,779,576,1355,-
chr7,29071890,1.724740090968161,684,512,1196,-
chr7,29086536,1.684349476115832,703,526,1229,-
chr7,29096208,1.497543495929185,1134,853,1987,-
chr7,29112782,3.5159682637766805,1290,1027,2317,-
chr7,29112783,2.8656294200848653,1012,807,1819,-
chr7,29120934,1.8433515482695813,615,426,1041,-
chr7,29922609,1.8002611684066103,951,690,1641,-
chr7,29922610,2.0801355133477033,772,587,1359,-
chr7,30496813,0.5916993267008339,1023,641,1664,-
chr7,30496823,1.7072576940744144,952,621,1573,-
chr7,30496870,2.118055555555556,853,671,1524,-
chr7,30496965,1.574107142857143,860,734,1594,-
chr7,30497000,1.9462745325073816,861,750,1611,-
chr7,30497007,1.5449118683901293,912,574,1486,-
chr7,30497127,1.7492625368731565,592,451,1043,-
chr7,30497134,2.142143665143396,1243,869,2112,-
chr7,30497214,1.8788758782201405,646,426,1072,-
chr7,30498898,2.1377599041670234,1040,753,1793,-
chr7,30500610,1.1542977489354547,1004,739,1743,-
chr7,32487754,5.531233998975933,744,557,1301,-
chr7,32488638,1.9816978193146413,726,534,1260,-
chr7,32489330,1.804878048780488,665,368,1033,-
chr7,32490349,2.157697727290363,1051,564,1615,-
chr7,32490350,2.4644657258064515,888,495,1383,-
chr7,32870692,1.4815305710828095,546,468,1014,-
chr7,32870697,0.6222932602656315,583,460,1043,-
chr7,32870699,2.677678667925833,774,623,1397,-
chr7,32870703,2.8704663212435237,830,578,1408,-
chr7,32870704,2.8704663212435237,830,578,1408,-
chr7,32870716,2.7441834752174556,628,423,1051,-
chr7,32870833,1.737449773371085,981,718,1699,-
chr7,40132860,1.8654282933160284,792,535,1327,-
chr7,40133142,3.6882051282051287,743,449,1192,-
chr7,40133211,0.4176508183510712,834,678,1512,-
chr7,40133213,0.43458819603267895,1258,992,2250,-
chr7,40133240,0.5559359535645331,845,593,1438,-
chr7,40133247,0.7376670055235541,837,655,1492,-
chr7,40133249,1.3546812926499645,775,585,1360,-
chr7,40134617,1.349595703798035,631,487,1118,-
chr7,42917673,1.3516049997923674,1647,1395,3042,-
chr7,42921930,1.5644775428306839,900,681,1581,-
chr7,42923333,1.4325546065916963,2061,1401,3462,-
chr7,42924743,1.6583659806967772,1492,1256,2748,-
chr7,42924761,1.5719721905557074,1687,1020,2707,-
chr7,42924764,1.47828698935805,1624,970,2594,-
chr7,42924776,1.4163313609467456,1631,974,2605,-
chr7,42926663,1.6438196741394095,1141,906,2047,-
chr7,42927438,1.1302431725789919,2004,1316,3320,-
chr7,42927446,1.8285679374389048,1094,791,1885,-
chr7,42927449,2.480630165289256,1129,725,1854,-
chr7,42927451,1.680734536082474,986,678,1664,-
chr7,42932159,1.8034374999999998,795,511,1306,-
chr7,42932167,1.59393885531461,1054,579,1633,-
chr7,42932169,1.59393885531461,1054,579,1633,-
chr7,43639418,0.5661308001461455,1032,781,1813,-
chr7,43639593,1.3306740125081655,1107,933,2040,-
chr7,43640643,2.527357023531037,826,629,1455,-
chr7,43645313,2.576403583099043,876,641,1517,-
chr7,43645398,1.0412857228597883,1458,1117,2575,-
chr7,43647572,0.5227272727272728,597,415,1012,-
chr7,43647628,2.0488636363636363,600,439,1039,-
chr7,43866699,1.4159599983739175,1892,1446,3338,-
chr7,43866760,1.4102617648407523,2957,2185,5142,-
chr7,43866850,2.5005428881650382,657,613,1270,-
chr7,43866875,1.6493064005840838,752,586,1338,-
chr7,43866877,2.6656565656565654,545,494,1039,-
chr7,43866882,2.166015037593985,553,474,1027,-
chr7,43866921,1.7591327037773359,808,502,1310,-
chr7,43866922,0.681462016244625,838,643,1481,-
chr7,43868988,1.5228970932270833,1722,1286,3008,-
chr7,43868991,2.6744186046511627,599,429,1028,-
chr7,43869495,0.4951002096354079,715,598,1313,-
chr7,44115327,2.1089516891192868,943,668,1611,-
chr7,44115378,0.5356288857006217,719,458,1177,-
chr7,44115391,3.9372025956953403,696,538,1234,-
chr7,44115824,2.45,678,387,1065,-
chr7,44116138,1.83982683982684,747,461,1208,-
chr7,44116490,0.5375582479030755,720,434,1154,-
chr7,44116505,2.2066175707914115,966,621,1587,-
chr7,44116507,2.2066175707914115,966,621,1587,-
chr7,44116845,3.4511633576507528,593,512,1105,-
chr7,44116904,3.1912510516137678,819,581,1400,-
chr7,44117652,0.6525851197982346,1264,792,2056,-
chr7,44117653,1.794090202177294,823,642,1465,-
chr7,44117677,1.0923166380267655,1132,887,2019,-
chr7,44117711,1.5392594537815123,616,407,1023,-
chr7,44118018,2.99813258636788,675,475,1150,-
chr7,44122050,0.3809670781893004,528,485,1013,-
chr7,44122052,1.327315457232078,752,667,1419,-
chr7,44565905,1.2223725279543634,611,446,1057,-
chr7,44568974,3.427323465178355,855,633,1488,-
chr7,44568982,0.7293635679727156,1704,1062,2766,-
chr7,44569141,2.1524177949709857,855,469,1324,-
chr7,44569172,1.7207592339261286,693,343,1036,-
chr7,44569175,1.936121584917548,1068,558,1626,-
chr7,44569189,2.5586987270155586,602,403,1005,-
chr7,44569829,3.1925773195876284,1105,581,1686,-
chr7,44569831,3.1925773195876284,1105,581,1686,-
chr7,44569870,1.8253209434367106,842,567,1409,-
chr7,44578112,1.5698527239770124,788,503,1291,-
chr7,44578394,0.6472161741835148,866,642,1508,-
chr7,44578484,0.7920812184443612,1287,923,2210,-
chr7,44578485,1.0000463475587411,1670,1206,2876,-
chr7,44578639,0.5312858768096446,832,655,1487,-
chr7,44579064,3.5925155925155927,639,480,1119,-
chr7,44579065,3.260696040868455,949,695,1644,-
chr7,44579067,3.806060606060606,627,449,1076,-
chr7,44579388,2.795205662393163,1020,623,1643,-
chr7,44579390,2.795205662393163,1020,623,1643,-
chr7,44581176,0.6496862796718003,870,641,1511,-
chr7,44581198,1.179749742968812,962,779,1741,-
chr7,44581202,1.755458263836854,991,812,1803,-
chr7,44581477,0.5919000571568548,658,661,1319,-
chr7,44581487,0.3449197860962567,601,475,1076,-
chr7,44581494,3.3468693748994327,1545,1351,2896,-
chr7,44581506,1.9885008517887564,643,586,1229,-
chr7,44581508,1.9885008517887564,643,586,1229,-
chr7,44581790,1.0356368143786798,556,460,1016,-
chr7,44581792,1.0356368143786798,556,460,1016,-
chr7,44582072,1.9278462720751743,652,474,1126,-
chr7,44834387,1.6818793753365646,960,618,1578,-
chr7,44834405,1.6742919389978217,741,458,1199,-
chr7,44834463,1.6267746913580248,726,479,1205,-
chr7,44834534,2.591336504624564,984,737,1721,-
chr7,44834541,2.0487853698595635,1469,1028,2497,-
chr7,44834543,2.080161137749594,1539,1177,2716,-
chr7,44835642,3.1400658965726604,740,545,1285,-
chr7,45100329,1.5914878550081284,725,500,1225,-
chr7,45100392,1.7207706293000504,702,526,1228,-
chr7,45100398,3.2095079930378763,644,488,1132,-
chr7,45101265,1.3629869333511717,818,541,1359,-
chr7,45101581,1.893924546932835,846,519,1365,-
chr7,45102036,2.9920219528024785,788,506,1294,-
chr7,45104605,1.6750893337733104,641,443,1084,-
chr7,45109033,0.9417601276092611,1059,860,1919,-
chr7,45109285,1.5865302625944555,646,462,1108,-
chr7,45111651,31.066352639809917,841,606,1447,-
chr7,45912769,2.279589371980677,754,551,1305,-
chr7,45912808,2.4992236024844723,665,482,1147,-
chr7,45912821,1.5490196078431373,1026,577,1603,-
chr7,45912963,0.5502092050209205,1051,955,2006,-
chr7,45913040,1.7568251922103035,847,748,1595,-
chr7,45913073,4.1517626903387574,954,737,1691,-
chr7,45913153,0.6809612225951581,977,835,1812,-
chr7,45913221,1.2016352942932893,1778,1313,3091,-
chr7,45913392,2.1202340187909527,2261,1694,3955,-
chr7,45913808,1.9049912434325744,915,570,1485,-
chr7,45913809,0.6468273222276134,856,686,1542,-
chr7,45913817,1.9443394443394444,822,480,1302,-
chr7,45913820,0.5089315807212673,754,551,1305,-
chr7,45917235,1.4766498848690632,5112,3284,8396,-
chr7,45917249,1.7163045163576762,4557,3332,7889,-
chr7,45917257,1.2564032671681606,3796,2642,6438,-
chr7,45917264,1.3318734317725893,6066,3923,9989,-
chr7,45917282,1.851338966380544,2332,1397,3729,-
chr7,45917285,1.5729055258467022,2205,1308,3513,-
chr7,45917302,2.387619047619048,1961,1133,3094,-
chr7,45917315,1.5450115452079591,6908,4947,11855,-
chr7,45917316,1.4425041343349259,6205,4599,10804,-
chr7,45917321,2.181522270406306,2356,1686,4042,-
chr7,45917327,1.6229974986537763,3223,2095,5318,-
chr7,45917330,1.3969950990595494,1892,1228,3120,-
chr7,45917331,1.108776629203619,1549,1009,2558,-
chr7,45917351,1.2673955338609746,3099,1865,4964,-
chr7,45917353,0.972122189725972,2721,1749,4470,-
chr7,45917356,2.167666666666667,928,599,1527,-
chr7,45917420,1.4316036478563634,882,579,1461,-
chr7,45917430,1.3522184979053986,679,542,1221,-
chr7,45921221,2.6730388157127867,818,372,1190,-
chr7,45921223,2.580932105996342,1075,502,1577,-
chr7,47369491,0.4426647251547143,759,409,1168,-
chr7,47369492,0.4426647251547143,759,409,1168,-
chr7,47396844,3.3423340961098402,936,524,1460,-
chr7,47396845,3.4939569875200327,795,456,1251,-
chr7,48903080,1.0327300150829564,1001,779,1780,-
chr7,48903081,1.0085475193248625,2021,1326,3347,-
chr7,51027817,0.8415749158766462,768,571,1339,-
chr7,51027819,1.257294429708223,710,428,1138,-
chr7,51085232,1.0496992831861343,843,680,1523,-
chr7,54755808,1.4426767437452617,1764,1318,3082,-
chr7,54757519,1.8418327556325824,1440,1153,2593,-
chr7,54757567,2.0780722891566263,1231,829,2060,-
chr7,54759178,0.5411750218169482,3989,2768,6757,-
chr7,54759179,0.5459006338172153,1334,803,2137,-
chr7,54759197,1.0164008513984233,1894,1398,3292,-
chr7,54759207,0.4930233562274967,1084,814,1898,-
chr7,54759234,1.3056532746206746,957,743,1700,-
chr7,55470760,1.0238373221267054,675,475,1150,-
chr7,55470763,0.865140391333376,813,624,1437,-
chr7,55470764,0.865140391333376,813,624,1437,-
chr7,56021170,0.39781046869654463,645,394,1039,-
chr7,56021204,1.7643363472659845,590,455,1045,-
chr7,56034148,1.9120207851483075,716,491,1207,-
chr7,56101704,1.300610549132948,2352,1729,4081,-
chr7,56101710,1.3503117457763474,1964,1355,3319,-
chr7,56101749,1.6131114456866449,1706,1006,2712,-
chr7,56101849,1.5419734003999546,2975,2336,5311,-
chr7,56101850,1.2045731822970625,9651,7399,17050,-
chr7,56101851,1.1945251804561516,8918,6751,15669,-
chr7,56101852,1.4546568017657702,5068,3680,8748,-
chr7,56101853,1.5047013916392389,2670,1978,4648,-
chr7,56101855,1.9033848614072493,1241,937,2178,-
chr7,56101858,1.515578558983294,1299,886,2185,-
chr7,56101859,1.5588797340663167,3058,1958,5016,-
chr7,56101860,1.5923001040968374,1759,1072,2831,-
chr7,56102957,1.6866094808126408,3800,3100,6900,-
chr7,56102959,1.6866094808126408,3800,3100,6900,-
chr7,56102979,1.86096256684492,1799,1529,3328,-
chr7,56102990,1.5856462012895993,2423,1352,3775,-
chr7,56102994,1.3963614063777596,2276,1222,3498,-
chr7,56103001,1.529856386999244,2023,1028,3051,-
chr7,56103008,1.7709711103376262,1695,844,2539,-
chr7,56104238,1.7691737619886623,2402,1705,4107,-
chr7,56104336,1.5081602056114798,1466,804,2270,-
chr7,56104350,1.6800521512385918,1136,589,1725,-
chr7,56104353,0.3914423740510697,708,629,1337,-
chr7,56104358,2.0464441219158203,1229,688,1917,-
chr7,56104359,2.408467741935484,1809,991,2800,-
chr7,56104360,0.5643357576012638,1174,1103,2277,-
chr7,56104361,2.4791666666666665,1189,639,1828,-
chr7,56104362,1.7917995444191346,854,438,1292,-
chr7,56104434,1.8014621741894468,1317,714,2031,-
chr7,56104435,0.506418485237484,788,655,1443,-
chr7,56104438,2.6262939958592133,648,482,1130,-
chr7,56104453,2.0094482237339384,817,377,1194,-
chr7,56104458,1.979546091342113,1569,663,2232,-
chr7,56104459,1.9644519131334024,2337,966,3303,-
chr7,56104461,2.1066359582237966,2072,1003,3075,-
chr7,56106475,0.7597572331323442,8113,4135,12248,-
chr7,56106476,0.6230470788428816,1906,1074,2980,-
chr7,56106479,0.5607353309216664,821,635,1456,-
chr7,66423450,1.6723975707809424,610,432,1042,-
chr7,66423461,3.27741935483871,761,464,1225,-
chr7,66423465,1.5173368490441659,676,369,1045,-
chr7,66423472,1.3968530263808643,1182,891,2073,-
chr7,66423473,2.1421318658729716,1663,1072,2735,-
chr7,66423477,0.4362030905077262,623,452,1075,-
chr7,66423478,0.760844235210045,1011,759,1770,-
chr7,66554078,2.864043321182743,1059,759,1818,-
chr7,66554079,2.6994113318616626,666,452,1118,-
chr7,66554109,2.4256662208851005,880,592,1472,-
chr7,66606895,1.6384824878079676,994,830,1824,-
chr7,66606896,0.6847602151385794,3066,1912,4978,-
chr7,66606898,0.6660901404561694,6006,4196,10202,-
chr7,66606941,1.3772543293612776,1916,1407,3323,-
chr7,66606948,1.4372328706763606,693,444,1137,-
chr7,66606950,0.44382608695652165,637,574,1211,-
chr7,66606951,0.44382608695652165,637,574,1211,-
chr7,66606953,0.5366682855755222,662,434,1096,-
chr7,66606954,0.6424791629516712,1892,1526,3418,-
chr7,66606956,0.6306819761281377,1522,1292,2814,-
chr7,66991263,1.197658327255831,1367,935,2302,-
chr7,66993387,1.8367506856471205,878,588,1466,-
chr7,66994238,1.4732317470664928,2835,1887,4722,-
chr7,66994256,0.9161664736750648,7534,5213,12747,-
chr7,66994269,0.6348023549201011,2902,2174,5076,-
chr7,66994270,1.440476190476191,1693,1175,2868,-
chr7,66994295,1.0310177016083524,2222,1424,3646,-
chr7,66994302,1.6735983153461436,934,654,1588,-
chr7,66994322,2.267049533381192,1578,795,2373,-
chr7,66994323,1.9364989732540647,2758,1630,4388,-
chr7,66994327,1.6004063860667634,1020,688,1708,-
chr7,66994336,0.2688863209591218,1240,601,1841,-
chr7,66994337,0.2688863209591218,1240,601,1841,-
chr7,66994338,1.8501481365975363,790,582,1372,-
chr7,66994340,1.7295316624820731,1498,1028,2526,-
chr7,73307474,2.508211287023747,621,449,1070,-
chr7,73307708,23.318145518456934,736,386,1122,-
chr7,73307709,31.714398210006152,699,393,1092,-
chr7,73470413,2.3222203564782045,626,532,1158,-
chr7,73536992,1.7556390977443606,933,607,1540,-
chr7,73536996,0.5964357937310414,857,551,1408,-
chr7,73536998,2.2221562221562223,773,480,1253,-
chr7,73537038,1.1204892542374754,655,472,1127,-
chr7,73569755,2.143595863166269,633,418,1051,-
chr7,73569757,2.143595863166269,633,418,1051,-
chr7,74237404,2.1141323118771864,623,460,1083,-
chr7,74243204,1.09498020297638,801,510,1311,-
chr7,74243205,1.09498020297638,801,510,1311,-
chr7,74243206,1.0353732638888888,733,575,1308,-
chr7,74243207,1.0353732638888888,733,575,1308,-
chr7,75056044,2.9798695950368743,696,467,1163,-
chr7,75474728,2.8424337039081187,690,463,1153,-
chr7,76327034,1.9860335195530725,710,536,1246,-
chr7,76327112,1.2645968640498841,572,535,1107,-
chr7,76327419,0.5441176470588235,665,373,1038,-
chr7,76327628,0.31312536677112895,351,761,1112,-
chr7,76327634,0.3093903755346423,654,995,1649,-
chr7,76327636,0.39213898955483295,731,879,1610,-
chr7,76327638,0.1489261524428353,355,916,1271,-
chr7,76327639,0.20975870150075573,421,811,1232,-
chr7,76327642,0.3145340253272266,576,1275,1851,-
chr7,76327643,0.26274851215363776,945,2479,3424,-
chr7,76327644,0.24918727168268667,1625,3989,5614,-
chr7,76327645,0.2392795121106384,1207,2906,4113,-
chr7,76327646,0.23647529819347532,994,2868,3862,-
chr7,76327647,0.3640892354342646,491,1025,1516,-
chr7,76327648,0.25412342987455316,539,1748,2287,-
chr7,76327649,0.24942200298224015,574,1887,2461,-
chr7,76327652,2.0228910203851074,232,1102,1334,-
chr7,76327653,2.573479266876416,504,1896,2400,-
chr7,76327654,3.3506243969582936,292,1100,1392,-
chr7,76327942,1.5212525497546727,1970,1066,3036,-
chr7,76327944,2.5120065789473687,1696,959,2655,-
chr7,76327986,0.48673075470519395,3034,1795,4829,-
chr7,76327987,0.4124080987071826,1984,1138,3122,-
chr7,76328055,1.8753273965426926,715,497,1212,-
chr7,76329461,0.825083176064535,1292,2320,3612,-
chr7,76329463,1.0022311863803945,1108,1744,2852,-
chr7,76329478,8.048247067560547,1376,2167,3543,-
chr7,76329479,8.272571143758931,1533,2280,3813,-
chr7,76329482,16.495477333200572,673,385,1058,-
chr7,76329886,1.5133616805586845,2589,1543,4132,-
chr7,76329896,1.601735327849977,6587,4395,10982,-
chr7,76329897,1.5797096535553872,8733,5638,14371,-
chr7,76329898,1.601735327849977,6587,4395,10982,-
chr7,76329899,0.6326374115668134,1704,1188,2892,-
chr7,76329922,0.5730301427815971,1203,914,2117,-
chr7,76329931,2.574614065180103,1105,582,1687,-
chr7,76329935,1.969952691471679,993,473,1466,-
chr7,76329943,1.8367346938775508,971,566,1537,-
chr7,76329945,0.95935960591133,778,559,1337,-
chr7,76329946,1.4558697306725124,2427,1649,4076,-
chr7,88206448,0.6108818011257036,739,649,1388,-
chr7,88209440,0.46189427312775333,698,453,1151,-
chr7,88218890,0.9722222222222223,587,559,1146,-
chr7,88218891,0.9722222222222223,587,559,1146,-
chr7,88218904,0.6107064932822507,627,462,1089,-
chr7,88273374,1.9898989898989896,787,743,1530,-
chr7,88273375,1.9898989898989896,787,743,1530,-
chr7,88275063,2.072798188836211,1271,775,2046,-
chr7,88275064,1.7538955497029152,1143,622,1765,-
chr7,88276711,0.9300551200591431,14280,10359,24639,-
chr7,88276712,0.7998252956284794,12147,8879,21026,-
chr7,88276763,1.7429982254455674,1188,996,2184,-
chr7,88276764,1.3813488759367194,1658,1200,2858,-
chr7,88276985,1.4317517471010708,1848,1541,3389,-
chr7,88277097,1.23411952536586,4227,2613,6840,-
chr7,88277454,1.3886625597729911,7245,4793,12038,-
chr7,88277633,1.225790490916119,4379,3249,7628,-
chr7,88277705,1.5652195911758753,2689,1646,4335,-
chr7,88277709,1.6059080865827178,2392,1422,3814,-
chr7,88277715,1.4956506907726417,947,532,1479,-
chr7,88277740,1.7413806414758817,6912,3154,10066,-
chr7,88277741,1.398635988012515,7540,3398,10938,-
chr7,88277743,0.8163720033563768,5341,2446,7787,-
chr7,88277747,0.40643969438196437,3396,1536,4932,-
chr7,88277750,0.6272691718821816,3969,2002,5971,-
chr7,88277751,0.5707500052308363,6095,3117,9212,-
chr7,88277767,2.4003472222222224,668,479,1147,-
chr7,88278000,1.4699748340115657,1638,1287,2925,-
chr7,88278162,1.865479723046489,1747,1347,3094,-
chr7,88278163,1.9722382880277616,1429,1182,2611,-
chr7,88278630,1.86707005569281,2899,2170,5069,-
chr7,88278679,1.339191710518956,5009,3555,8564,-
chr7,88279064,1.359105718298923,3683,2994,6677,-
chr7,88279285,1.3223897723992761,8035,5260,13295,-
chr7,88279397,0.7432516034725359,3149,2080,5229,-
chr7,88279529,1.3557606490872212,2252,1699,3951,-
chr7,88279547,1.3424317617866006,2163,1611,3774,-
chr7,88281753,3.010233641152457,649,484,1133,-
chr7,88281884,0.28003456435164276,1131,742,1873,-
chr7,88282727,2.6734794537439504,3468,2948,6416,-
chr7,88282728,2.6734794537439504,3468,2948,6416,-
chr7,88282801,0.7803347751644589,4249,3287,7536,-
chr7,88283052,1.411628980156899,2393,1772,4165,-
chr7,88283105,1.4530594233242884,1958,1458,3416,-
chr7,88283146,1.475498934537272,5971,4607,10578,-
chr7,88283155,1.6403867102396512,1720,1223,2943,-
chr7,88283920,0.8336752245953498,6005,4076,10081,-
chr7,88284259,1.4052457126387088,1392,1027,2419,-
chr7,88284264,1.3674547279342557,4173,2898,7071,-
chr7,88284265,1.3674547279342557,4173,2898,7071,-
chr7,88290977,1.4358908120210112,724,473,1197,-
chr7,88306806,1.789443346508564,700,527,1227,-
chr7,88306810,2.078835386338186,662,469,1131,-
chr7,88306817,1.5684236272471566,1139,628,1767,-
chr7,88306832,1.7574334639701652,1393,1042,2435,-
chr7,88306871,1.9272926803089736,1195,584,1779,-
chr7,88306872,1.8212807881773398,1026,434,1460,-
chr7,92112422,1.6081471348229217,1057,730,1787,-
chr7,92113010,3.4263448969331316,704,350,1054,-
chr7,92113011,3.22957025161434,1035,498,1533,-
chr7,92113191,3.536701135835376,902,826,1728,-
chr7,92113193,3.154700849887371,2784,2204,4988,-
chr7,92113194,3.1543321201668966,1625,1260,2885,-
chr7,92113754,1.8560229149505139,934,629,1563,-
chr7,92117074,2.4185064935064933,641,481,1122,-
chr7,92127574,0.3146561195341683,715,554,1269,-
chr7,92127576,0.3146561195341683,715,554,1269,-
chr7,92127591,1.9105632144658424,1213,848,2061,-
chr7,92127593,2.089736338668337,1298,870,2168,-
chr7,92129017,3.1122194513715713,623,400,1023,-
chr7,92129019,3.1122194513715713,623,400,1023,-
chr7,92131869,1.1353352286188108,660,468,1128,-
chr7,92131870,1.1353352286188108,660,468,1128,-
chr7,92221939,1.9452887537993926,659,516,1175,-
chr7,92221940,1.7044289044289043,913,571,1484,-
chr7,92221972,1.466279123185286,1645,970,2615,-
chr7,92221973,1.107362935520531,1525,942,2467,-
chr7,92221974,1.3094855954320979,1425,844,2269,-
chr7,92609671,5.728092783505155,634,387,1021,-
chr7,92609673,5.728092783505155,634,387,1021,-
chr7,93886333,2.322198077518929,1060,702,1762,-
chr7,93886623,1.5661764705882353,851,594,1445,-
chr7,93886798,1.6399512789281363,1055,820,1875,-
chr7,93887283,3.7148755312689734,955,548,1503,-
chr7,93887285,0.5785261592187803,3252,1973,5225,-
chr7,93887286,0.5785261592187803,3252,1973,5225,-
chr7,93887350,0.6678927459299044,1101,810,1911,-
chr7,93887357,1.7094193548387098,735,464,1199,-
chr7,93887405,1.7198495510798348,809,633,1442,-
chr7,93889093,1.9467306812985825,654,485,1139,-
chr7,93889143,1.3438880706921943,624,484,1108,-
chr7,93890186,2.804989816700611,786,490,1276,-
chr7,93890187,2.0841874317590827,1123,720,1843,-
chr7,93890680,2.5091478290070937,975,652,1627,-
chr7,93993814,1.7620826607219202,779,616,1395,-
chr7,94629802,2.3169740230404337,624,541,1165,-
chr7,95405073,2.3087628609771857,928,648,1576,-
chr7,95405074,2.3087628609771857,928,648,1576,-
chr7,95405235,0.4174387655402446,1238,885,2123,-
chr7,95405362,1.9029391660970607,767,531,1298,-
chr7,95405460,1.6999999999999995,577,492,1069,-
chr7,95406210,1.3615002045664937,2422,1530,3952,-
chr7,95406211,1.6437636259323007,1746,1049,2795,-
chr7,95407065,0.49672084402623323,669,500,1169,-
chr7,95410062,1.7124427798585098,822,533,1355,-
chr7,95411762,0.46554530656538246,714,484,1198,-
chr7,95424557,2.1672268065119717,849,558,1407,-
chr7,95584834,1.9401430572690246,1329,960,2289,-
chr7,95584843,0.45201423702029425,1177,588,1765,-
chr7,95584844,0.6864343556846393,1483,869,2352,-
chr7,96709753,0.7409614545892048,15765,10947,26712,-
chr7,96709754,0.9070054734516825,33886,22342,56228,-
chr7,96709755,1.2607074941333878,9425,5225,14650,-
chr7,96709756,0.7718256184222829,13532,9695,23227,-
chr7,96709759,1.5535002627610979,5592,3192,8784,-
chr7,96709762,1.4508391380666068,6139,3675,9814,-
chr7,96709764,1.3938972683589836,17683,10955,28638,-
chr7,96709765,1.5518002322880373,3447,2099,5546,-
chr7,96709771,2.3211589917646203,5009,2763,7772,-
chr7,96709772,2.3211589917646203,5009,2763,7772,-
chr7,96709789,1.954638124362895,3775,2303,6078,-
chr7,96709795,1.4017116238513767,5654,3163,8817,-
chr7,96709797,1.4860474006116209,1554,871,2425,-
chr7,96709800,1.6747236180904523,1448,795,2243,-
chr7,96709808,1.7187351778656126,1552,758,2310,-
chr7,96709812,1.7481257366681409,4177,2062,6239,-
chr7,96709820,0.6635260568105569,878,525,1403,-
chr7,96709824,2.187604690117253,652,397,1049,-
chr7,96709827,2.722986696455773,2102,915,3017,-
chr7,96709829,2.4720665623219378,3935,1697,5632,-
chr7,96709833,2.0344861530234684,4400,1862,6262,-
chr7,96709834,1.9921123372948504,3312,1301,4613,-
chr7,96709835,2.1530249110320283,1088,561,1649,-
chr7,96709844,0.6419569123414718,3324,1312,4636,-
chr7,96709845,0.6200936402039722,4411,1818,6229,-
chr7,96709859,0.6174284841698058,1212,516,1728,-
chr7,96709860,0.7855013550135501,1682,737,2419,-
chr7,96709862,1.1942856667553898,1243,610,1853,-
chr7,97852187,5.781074989402912,6911,5046,11957,-
chr7,97852188,5.1602573866515815,5714,4086,9800,-
chr7,97852189,7.573830268122748,3306,2553,5859,-
chr7,97852283,1.5814963900070285,727,422,1149,-
chr7,97853164,1.5492610837438416,1331,1043,2374,-
chr7,97853361,1.515,1211,899,2110,-
chr7,97854641,1.7868156705173281,1922,1447,3369,-
chr7,97854667,0.6942094297271988,2865,1995,4860,-
chr7,97855428,1.579640384592068,1691,1230,2921,-
chr7,97856713,2.073018783387903,7092,4144,11236,-
chr7,97856803,1.3087209476567467,9156,5811,14967,-
chr7,97856804,1.4781184346401737,7115,4553,11668,-
chr7,97856805,1.4781184346401737,7115,4553,11668,-
chr7,97858341,1.3793934989429175,1346,945,2291,-
chr7,97858347,1.840233488271538,1215,840,2055,-
chr7,97858353,1.7782764457749631,2552,1876,4428,-
chr7,97858356,1.8545157941569037,914,612,1526,-
chr7,97858934,1.5190476190476192,1275,839,2114,-
chr7,97859258,1.7421456159566495,1285,912,2197,-
chr7,97859309,1.499887804751595,2918,2160,5078,-
chr7,97859358,2.556077203964528,979,638,1617,-
chr7,97864399,1.9729323308270676,1151,797,1948,-
chr7,97869001,1.8271954674220965,1049,705,1754,-
chr7,97869088,1.9367857142857143,985,799,1784,-
chr7,97869123,1.5122491638795987,1185,919,2104,-
chr7,97869790,1.8122881355932203,657,471,1128,-
chr7,97869793,0.6887727518471797,636,536,1172,-
chr7,97872398,2.5009870179067613,869,584,1453,-
chr7,98293413,0.637492993941216,978,759,1737,-
chr7,98293415,0.6565079323041169,1170,819,1989,-
chr7,98293470,2.901747106834571,910,558,1468,-
chr7,98293471,2.8180457176205542,849,487,1336,-
chr7,98304343,2.309768299104792,604,421,1025,-
chr7,98304344,2.820642236646203,884,605,1489,-
chr7,98307844,3.8313145994832034,771,562,1333,-
chr7,98310497,0.9405458089668616,771,512,1283,-
chr7,98310499,0.9405458089668616,771,512,1283,-
chr7,98310526,0.8048258416034249,563,570,1133,-
chr7,98310528,0.8048258416034249,563,570,1133,-
chr7,98312202,1.9694235596567085,682,584,1266,-
chr7,98312256,1.1747908239319227,850,669,1519,-
chr7,98315580,2.89718997542864,1159,836,1995,-
chr7,98317240,0.2446468126999754,567,477,1044,-
chr7,98317332,1.3788736931663303,3360,2650,6010,-
chr7,98317334,1.5425741017375583,2179,1448,3627,-
chr7,98317339,1.4046767824878772,3733,2638,6371,-
chr7,98317343,1.4251124401528217,5003,3648,8651,-
chr7,98317344,1.4000455941220058,8322,5949,14271,-
chr7,98317347,1.5638300121943487,2240,1558,3798,-
chr7,98317350,1.580449456249369,4676,3118,7794,-
chr7,98320066,1.684004884004884,1292,818,2110,-
chr7,98320079,2.0506172839506176,1056,629,1685,-
chr7,98320085,3.0068513262210046,990,600,1590,-
chr7,98320109,1.9438775510204085,1523,911,2434,-
chr7,98320126,0.5409963674104825,694,469,1163,-
chr7,98320127,1.7248908296943233,631,457,1088,-
chr7,98320258,2.8854842585916844,648,437,1085,-
chr7,98320263,2.387264982373678,1181,735,1916,-
chr7,98320265,2.2531451538321345,1609,1015,2624,-
chr7,98355124,2.015993527400518,5572,2772,8344,-
chr7,98362380,0.6171118854045684,796,491,1287,-
chr7,98362381,0.5780418458846687,880,472,1352,-
chr7,98362390,0.5515763697581879,1271,593,1864,-
chr7,98362394,0.3937071399757967,975,468,1443,-
chr7,98386073,1.7402767422457306,2554,1748,4302,-
chr7,98386074,1.7855762066067065,3431,2385,5816,-
chr7,98386075,0.5160440186616332,804,652,1456,-
chr7,98386076,1.754635557452459,2399,1561,3960,-
chr7,98386078,1.4812283631712866,3991,2656,6647,-
chr7,98386079,1.5909136403546473,2469,1411,3880,-
chr7,98386080,1.35148806152513,3204,2146,5350,-
chr7,98386245,1.4605742789537637,992,822,1814,-
chr7,98386270,0.5184311611294562,1098,835,1933,-
chr7,98386271,0.8162938231447183,6360,5494,11854,-
chr7,98386272,0.923383168311271,13006,9854,22860,-
chr7,98386273,0.9785100670100121,13627,10357,23984,-
chr7,98386274,1.0121557766365046,11142,8368,19510,-
chr7,98386275,1.0219090673636126,5062,4481,9543,-
chr7,98386276,1.3171435151885083,3230,2925,6155,-
chr7,98386277,1.3227019901617207,1954,1636,3590,-
chr7,98386579,0.7827244302977379,4274,2095,6369,-
chr7,98386583,0.8272510104515409,10015,4877,14892,-
chr7,98386585,0.5593525535746088,7066,3588,10654,-
chr7,98386589,0.8397183293212,10457,5974,16431,-
chr7,98386591,0.7536978531630562,9468,5866,15334,-
chr7,98386593,0.460242676736782,6935,3987,10922,-
chr7,98386599,0.6756218587613937,2840,2063,4903,-
chr7,98386601,0.6906072717840364,7920,4621,12541,-
chr7,98386602,0.5655525106272792,2701,1209,3910,-
chr7,98386603,0.7653767610565971,3145,1716,4861,-
chr7,98386604,0.6318059965953652,5388,3633,9021,-
chr7,98386605,0.647421920348303,4534,3245,7779,-
chr7,98386606,0.6375023657692549,5312,3700,9012,-
chr7,99396466,0.3263864077876905,989,1649,2638,-
chr7,99396467,0.3263864077876905,989,1649,2638,-
chr7,99396468,0.2681328613391579,711,1206,1917,-
chr7,99396469,0.4819813015832538,858,1039,1897,-
chr7,99396470,0.38652941997455875,1070,1653,2723,-
chr7,99396477,0.4079816980172852,534,842,1376,-
chr7,99396478,0.306563969683858,1008,1850,2858,-
chr7,99396479,0.35725403143498674,682,1103,1785,-
chr7,99396480,0.2732678339055409,687,1297,1984,-
chr7,99396483,0.24450759052742604,425,694,1119,-
chr7,99396489,11.702383339521498,1135,1803,2938,-
chr7,99396490,11.16400607210199,1350,2152,3502,-
chr7,99396491,12.724103192575857,1267,1923,3190,-
chr7,99400344,1.9154703554182757,1193,800,1993,-
chr7,99400357,1.8416196265740337,1043,751,1794,-
chr7,99400358,1.8416196265740337,1043,751,1794,-
chr7,99403416,1.7471334648642756,671,492,1163,-
chr7,99404937,2.132009803921569,712,679,1391,-
chr7,99404940,2.8205128205128207,649,584,1233,-
chr7,99404947,1.8056133056133057,578,480,1058,-
chr7,99408574,1.7637413720242288,682,403,1085,-
chr7,99408576,1.7637413720242288,682,403,1085,-
chr7,99458264,1.894058540847532,753,653,1406,-
chr7,99458267,0.5526336621123126,1125,760,1885,-
chr7,99458293,1.542658423493045,1108,646,1754,-
chr7,99458337,1.9364132036545831,1281,753,2034,-
chr7,99459226,1.8916967509025275,1309,1107,2416,-
chr7,99459242,1.4386508773641469,3567,2526,6093,-
chr7,99466142,1.1329314571713995,3719,2583,6302,-
chr7,99466143,0.8669456691921336,4496,2892,7388,-
chr7,99466154,0.661215783860647,1239,775,2014,-
chr7,99466163,1.070130538529921,877,579,1456,-
chr7,100093013,1.7139693468804529,1873,1247,3120,-
chr7,100093109,0.5828383155768261,1309,966,2275,-
chr7,100093112,1.584740214573214,2119,1587,3706,-
chr7,100093372,1.4949243388105358,1061,900,1961,-
chr7,100093391,1.3768609539335266,2985,2234,5219,-
chr7,100093392,1.068101619698347,1560,1262,2822,-
chr7,100094281,1.768852978453739,637,525,1162,-
chr7,100094317,1.7557932263814615,984,747,1731,-
chr7,100094318,1.7557932263814615,984,747,1731,-
chr7,100095458,1.886280646844027,903,496,1399,-
chr7,100095856,0.5679012345679012,965,629,1594,-
chr7,100095857,0.6229707792207791,613,559,1172,-
chr7,100095860,0.6873270614277808,827,555,1382,-
chr7,100095885,2.3684210526315788,809,512,1321,-
chr7,100095957,2.7806637806637804,1033,692,1725,-
chr7,100095963,1.6275891522528294,1029,668,1697,-
chr7,100096032,2.186081924775392,775,596,1371,-
chr7,100096160,2.167344694887301,703,534,1237,-
chr7,100097368,1.4220519551878872,846,696,1542,-
chr7,100097381,2.1283783783783785,734,591,1325,-
chr7,100097624,2.283147459727385,736,537,1273,-
chr7,100097729,1.427036119810141,8752,4541,13293,-
chr7,100097730,1.329967614414355,6999,4016,11015,-
chr7,100097731,0.667513884966582,7090,3540,10630,-
chr7,100097732,0.667513884966582,7090,3540,10630,-
chr7,100097735,1.055017378580936,4773,2560,7333,-
chr7,100097740,0.6301885412102156,12375,6510,18885,-
chr7,100097741,0.6301885412102156,12375,6510,18885,-
chr7,100097853,1.6904988878296792,1994,1048,3042,-
chr7,100097936,0.6239717978848414,1238,965,2203,-
chr7,100097943,3.384208937198068,772,551,1323,-
chr7,100098282,1.9854905504309879,4927,3383,8310,-
chr7,100098285,2.331067795544941,3605,2630,6235,-
chr7,100098287,1.6133628578420893,12270,7903,20173,-
chr7,100098289,1.394928502958968,9757,6261,16018,-
chr7,100098590,0.7732071350564252,1887,1147,3034,-
chr7,100098606,0.6779399986178761,3829,2675,6504,-
chr7,100098616,0.4579923095099998,1065,788,1853,-
chr7,100098618,2.568481848184818,848,605,1453,-
chr7,100098639,2.68361581920904,899,707,1606,-
chr7,100098702,1.5203252032520325,1308,860,2168,-
chr7,100099033,1.5866019818331958,808,691,1499,-
chr7,100099311,1.2063435235805275,1816,1321,3137,-
chr7,100099312,1.8234567901234568,843,647,1490,-
chr7,100099319,1.8683281904473295,1683,1249,2932,-
chr7,100099392,2.0530076335877863,861,654,1515,-
chr7,100099604,2.2384828862164663,980,704,1684,-
chr7,100099668,1.5065426997245182,1249,923,2172,-
chr7,100099669,0.517585809252476,1326,818,2144,-
chr7,100099690,1.6472167390446109,1158,744,1902,-
chr7,100100042,0.6264738598442714,1055,898,1953,-
chr7,100100088,2.2214556743704725,1103,668,1771,-
chr7,100100092,1.1128236076492053,1502,1055,2557,-
chr7,100101288,2.316484899328859,704,595,1299,-
chr7,100101354,1.6696969696969695,759,527,1286,-
chr7,100101361,1.8131868131868132,604,454,1058,-
chr7,100435339,0.29150966501992065,642,453,1095,-
chr7,100435403,2.393689903846154,1561,1559,3120,-
chr7,100435405,1.8185935470280516,2243,2190,4433,-
chr7,100435407,1.6529125768490482,1822,1691,3513,-
chr7,100435408,1.3136354199107234,1032,1013,2045,-
chr7,100435409,1.4508101143092416,1797,1552,3349,-
chr7,100435410,1.665934539190353,765,539,1304,-
chr7,100813182,3.389118457300276,664,604,1268,-
chr7,101210412,0.9627521259399815,720,458,1178,-
chr7,101210413,0.9627521259399815,720,458,1178,-
chr7,101216435,3.192377739207096,705,532,1237,-
chr7,101216513,4.627605301860332,1039,720,1759,-
chr7,101216514,4.723538951777759,777,532,1309,-
chr7,101216515,4.627605301860332,1039,720,1759,-
chr7,101239850,5.089021688623289,2534,1982,4516,-
chr7,101239851,5.089021688623289,2534,1982,4516,-
chr7,101240227,1.1510505869083922,834,646,1480,-
chr7,101240228,1.749611829694715,2071,1639,3710,-
chr7,101244044,1.3209998159850607,1058,685,1743,-
chr7,101244124,1.4336388971098646,908,656,1564,-
chr7,101245035,2.393022858234886,853,673,1526,-
chr7,102473503,4.265940173651301,947,752,1699,-
chr7,102474388,1.7776806368638902,570,453,1023,-
chr7,103141707,1.477729737823841,2493,2125,4618,-
chr7,103141709,1.4805032744857793,4854,4181,9035,-
chr7,103141711,1.301689268922521,5769,4548,10317,-
chr7,103141712,0.9345764413102302,2440,1670,4110,-
chr7,103141713,0.9345764413102302,2440,1670,4110,-
chr7,103141716,1.3060444547448953,1507,1029,2536,-
chr7,103141718,1.6294738492753036,1663,1153,2816,-
chr7,103141719,1.7588740373270304,1095,762,1857,-
chr7,103315843,0.3537668798862829,542,468,1010,-
chr7,103315844,1.1699897217294912,676,590,1266,-
chr7,103316867,2.4276502044668136,734,747,1481,-
chr7,103316869,2.4276502044668136,734,747,1481,-
chr7,103316889,1.3166065525674562,1134,754,1888,-
chr7,103323609,1.184170645070187,3543,3075,6618,-
chr7,103323611,1.8375897845171585,1534,1431,2965,-
chr7,103323617,1.6597402597402595,851,604,1455,-
chr7,103323626,1.7659721536486623,1051,778,1829,-
chr7,103323627,1.7659721536486623,1051,778,1829,-
chr7,103324535,1.999708114419148,883,570,1453,-
chr7,103324544,3.380708929788685,762,488,1250,-
chr7,103337785,2.1566607239253717,1230,835,2065,-
chr7,105142461,1.2387566137566137,621,401,1022,-
chr7,105481113,2.1340828924162256,1668,1079,2747,-
chr7,105481117,1.6408648925281473,1538,976,2514,-
chr7,105481138,1.7727767049947716,2080,1320,3400,-
chr7,105481152,2.103341584158416,1853,908,2761,-
chr7,105481153,2.103341584158416,1853,908,2761,-
chr7,105481170,1.1423785594639866,1033,596,1629,-
chr7,105481171,1.1423785594639866,1033,596,1629,-
chr7,105506245,5.012510677520265,757,551,1308,-
chr7,105582248,1.4245668903945454,834,663,1497,-
chr7,105583031,2.3878296146044624,653,434,1087,-
chr7,105583032,2.367041198501872,631,533,1164,-
chr7,105583033,2.367041198501872,631,533,1164,-
chr7,105583035,0.94896906839476,1223,808,2031,-
chr7,105583037,0.94896906839476,1223,808,2031,-
chr7,106092974,2.889385960546244,867,659,1526,-
chr7,106092975,3.1578590237141446,861,682,1543,-
chr7,106093129,2.619373717212983,781,481,1262,-
chr7,106099219,0.8805349719862643,695,502,1197,-
chr7,106099220,0.8805349719862643,695,502,1197,-
chr7,106250136,2.5292755991285403,742,431,1173,-
chr7,106250137,2.5292755991285403,742,431,1173,-
chr7,106250905,1.9714800214143184,987,760,1747,-
chr7,106251106,2.530729927007299,888,547,1435,-
chr7,106251108,2.5829686225057493,1313,792,2105,-
chr7,106251109,2.3663129065388566,863,507,1370,-
chr7,106251112,3.756395058389373,778,485,1263,-
chr7,106254464,0.40033382768989995,779,583,1362,-
chr7,106254465,1.3897780373831774,720,427,1147,-
chr7,106254466,1.3897780373831774,720,427,1147,-
chr7,106263547,2.08030612244898,1072,699,1771,-
chr7,106263552,0.4864280566898871,809,542,1351,-
chr7,106263568,1.8449877750611248,685,408,1093,-
chr7,106263583,2.3357664233576645,799,410,1209,-
chr7,106263584,2.3357664233576645,799,410,1209,-
chr7,106268552,1.3439145950252,2440,1705,4145,-
chr7,106268575,2.842451665981077,690,373,1063,-
chr7,106269186,2.0266084124451607,818,489,1307,-
chr7,106274999,1.802884615384615,674,467,1141,-
chr7,106275000,1.535029742233972,928,711,1639,-
chr7,106275027,2.2691908713692945,524,481,1005,-
chr7,106275029,2.2691908713692945,524,481,1005,-
chr7,106284860,2.117585848074922,989,557,1546,-
chr7,106284861,2.117585848074922,989,557,1546,-
chr7,106659737,1.4444845840628326,603,481,1084,-
chr7,107236502,2.0793697997860967,606,422,1028,-
chr7,107923935,2.1162162162162157,782,665,1447,-
chr7,107923978,2.379215035931454,806,602,1408,-
chr7,107923988,1.626922180801491,900,591,1491,-
chr7,107926275,1.7728365384615383,589,415,1004,-
chr7,107929150,3.803149606299213,620,507,1127,-
chr7,107929151,2.267399267399268,618,454,1072,-
chr7,107929521,1.7799178395851574,880,478,1358,-
chr7,107929570,1.7966260543580133,709,484,1193,-
chr7,107931383,1.5208543801414347,957,675,1632,-
chr7,107931417,1.8010384099269936,1603,1158,2761,-
chr7,107931421,1.744592649606064,1883,1203,3086,-
chr7,107931422,1.813090128755365,1206,931,2137,-
chr7,107931423,1.813090128755365,1206,931,2137,-
chr7,107932218,2.0830012818165176,740,510,1250,-
chr7,107935496,2.6771432719464157,689,603,1292,-
chr7,107940225,1.221713689768485,733,480,1213,-
chr7,107952214,2.2982914461294475,648,473,1121,-
chr7,107959748,2.3949569904735464,1559,1151,2710,-
chr7,107959749,2.788632326820604,784,562,1346,-
chr7,107960552,2.081632653061224,611,419,1030,-
chr7,107962926,0.31878253291025255,835,727,1562,-
chr7,107962954,2.5714117560642915,782,644,1426,-
chr7,107963031,1.6093608821011949,596,414,1010,-
chr7,107973047,2.577096085654879,700,530,1230,-
chr7,107975280,2.502164502164502,781,505,1286,-
chr7,107978126,1.7293444610642998,824,510,1334,-
chr7,107980680,1.9655172413793103,664,384,1048,-
chr7,107986223,0.5085104506570244,960,666,1626,-
chr7,107998460,0.3784801750903446,675,530,1205,-
chr7,107998484,1.2067245945446636,808,569,1377,-
chr7,107998486,3.0167632774557416,663,490,1153,-
chr7,107998487,3.0167632774557416,663,490,1153,-
chr7,108514570,2.4860138369853257,1037,771,1808,-
chr7,108514581,1.0036310820624543,690,458,1148,-
chr7,108514582,1.0036310820624543,690,458,1148,-
chr7,109959397,1.2776183644189385,701,737,1438,-
chr7,109959399,1.113725075368911,862,776,1638,-
chr7,111869647,2.2916884794532724,1047,766,1813,-
chr7,111869649,2.9947466531096425,751,561,1312,-
chr7,113117199,2.0314907883553364,875,620,1495,-
chr7,113117299,1.705843293492696,733,501,1234,-
chr7,123541260,1.6980648833238474,662,501,1163,-
chr7,123541666,2.1163537549407114,658,351,1009,-
chr7,123541948,2.291150915004126,1179,762,1941,-
chr7,123542133,1.0614672047083762,887,776,1663,-
chr7,123542195,0.507936507936508,549,494,1043,-
chr7,123545670,2.4578973190441604,841,520,1361,-
chr7,123550563,0.5603603603603603,621,419,1040,-
chr7,123550575,2.4765049343755154,679,562,1241,-
chr7,123748628,1.1336617744153379,1243,691,1934,-
chr7,123748654,0.874521072796935,746,347,1093,-
chr7,123748655,0.874521072796935,746,347,1093,-
chr7,124846968,2.2085231841329405,514,573,1087,-
chr7,124846980,0.932715152490464,817,638,1455,-
chr7,124846981,2.5223752864202305,1127,978,2105,-
chr7,124846982,1.5867555810653207,2013,1780,3793,-
chr7,124846983,2.5223752864202305,1127,978,2105,-
chr7,128338766,1.5722106360792492,814,684,1498,-
chr7,128338788,0.5303839308415966,595,413,1008,-
chr7,128338793,0.5511908444169502,857,688,1545,-
chr7,128339288,3.597384740528274,958,524,1482,-
chr7,128339289,2.692584742447174,924,545,1469,-
chr7,128570228,0.4780558195192342,798,461,1259,-
chr7,128570230,0.44813664596273295,1052,629,1681,-
chr7,128954328,5.616270902635198,3428,2452,5880,-
chr7,128954329,5.616270902635198,3428,2452,5880,-
chr7,128954404,4.097061561326741,1304,917,2221,-
chr7,128954405,4.3183908045977,662,434,1096,-
chr7,128954522,0.21745042601176562,457,558,1015,-
chr7,128954524,0.21433310671402062,432,626,1058,-
chr7,128954534,3.7252819815707494,516,944,1460,-
chr7,128954535,3.725281981570749,516,944,1460,-
chr7,128954910,2.678023603339784,724,435,1159,-
chr7,129830898,2.438921442902828,714,571,1285,-
chr7,129831043,1.5729228182661827,874,714,1588,-
chr7,129831044,1.4722323049001815,831,759,1590,-
chr7,129831045,1.4722323049001815,831,759,1590,-
chr7,129831046,1.522825681725932,826,667,1493,-
chr7,129831908,2.3929355066888918,594,444,1038,-
chr7,129831910,2.100587421447011,706,521,1227,-
chr7,129832638,1.7035246533641748,4764,3638,8402,-
chr7,129832640,1.7035246533641748,4764,3638,8402,-
chr7,129832645,1.3855302524540711,1600,1325,2925,-
chr7,129832651,1.5636660243633382,4019,2606,6625,-
chr7,129832652,1.6208695858888416,2253,1367,3620,-
chr7,129832657,2.09375,937,543,1480,-
chr7,129832704,1.4132290951255813,2319,1474,3793,-
chr7,129832726,3.163055453543885,637,388,1025,-
chr7,129833311,3.0571532249774074,1408,1075,2483,-
chr7,129833314,1.9161510272738203,1614,1147,2761,-
chr7,129833315,2.0814895163700196,2846,2069,4915,-
chr7,129833319,2.9575093384527142,2807,1789,4596,-
chr7,129833320,3.219904891304348,2988,1839,4827,-
chr7,129833321,3.219904891304348,2988,1839,4827,-
chr7,129833322,3.347479614529281,2229,1348,3577,-
chr7,129833405,2.3785365853658536,635,409,1044,-
chr7,129833457,0.320951449983708,787,557,1344,-
chr7,129833459,0.320951449983708,787,557,1344,-
chr7,129834266,1.7163158522494846,632,465,1097,-
chr7,129835057,1.296341430888433,965,757,1722,-
chr7,131662104,1.6750583794504337,1377,726,2103,-
chr7,131662125,1.5667567567567566,747,599,1346,-
chr7,131662128,1.738440303657695,686,377,1063,-
chr7,131662130,1.724784870922553,984,525,1509,-
chr7,132785209,2.154139496109309,895,673,1568,-
chr7,132785253,0.960602087720151,2588,1462,4050,-
chr7,132785295,2.146591970121382,725,356,1081,-
chr7,132785298,1.9366468842729967,686,336,1022,-
chr7,132796494,0.8071494800591537,918,551,1469,-
chr7,133034561,2.1025139424274317,3102,2335,5437,-
chr7,133034570,2.653439153439153,648,593,1241,-
chr7,133034598,1.7823113745156145,1116,641,1757,-
chr7,133034608,1.4757390168218194,2346,1883,4229,-
chr7,133034610,1.5463282218853283,3089,2260,5349,-
chr7,133034611,1.365206562781786,600,496,1096,-
chr7,133034613,1.5516741186086578,1369,1061,2430,-
chr7,133034629,0.5400497411451473,1021,581,1602,-
chr7,133034809,1.3489190138761595,16458,10456,26914,-
chr7,133034927,0.7798419041961053,8176,6417,14593,-
chr7,133034928,1.3749774351862631,13039,10003,23042,-
chr7,133034930,1.220260383956673,39123,29771,68894,-
chr7,133034931,1.3409682635576852,18004,13339,31343,-
chr7,133034932,1.3962536040701907,23211,16969,40180,-
chr7,133034934,1.439466051762817,15748,12176,27924,-
chr7,133034945,1.3673801106016743,9664,6956,16620,-
chr7,133034953,1.6718532328237456,14284,8400,22684,-
chr7,133034955,1.5041752538453803,9737,5683,15420,-
chr7,133034977,1.2563880886028536,3652,2848,6500,-
chr7,133035090,1.1439048928355484,23152,17887,41039,-
chr7,133035091,0.9568283411921391,16761,13887,30648,-
chr7,133035097,0.8794204106704105,5344,4311,9655,-
chr7,133035103,1.497282951829,4436,2766,7202,-
chr7,133035104,1.754784399224806,3049,2303,5352,-
chr7,133035120,1.3503884415087335,5140,3129,8269,-
chr7,133035128,1.6135328949777097,10538,6711,17249,-
chr7,133035129,1.7416482276495726,10010,5814,15824,-
chr7,133035131,2.152361371470037,3631,2156,5787,-
chr7,133035135,1.50602650029168,4879,2982,7861,-
chr7,133035165,1.0896628155885166,2174,992,3166,-
chr7,133035166,1.5300552060065655,6533,3949,10482,-
chr7,133035167,1.626239885539516,4553,3383,7936,-
chr7,133035168,1.735187106926905,5396,3439,8835,-
chr7,133035273,1.1725798106990433,20133,16361,36494,-
chr7,133035274,1.2174042252310546,9412,8475,17887,-
chr7,133035275,1.23720864482448,9920,7073,16993,-
chr7,133035276,1.219480772469878,8880,8037,16917,-
chr7,133035324,1.5758690994540048,2145,1377,3522,-
chr7,133035336,1.5173893500405975,5388,3402,8790,-
chr7,133035337,1.5173893500405975,5388,3402,8790,-
chr7,133035338,1.6049267057194165,6658,4232,10890,-
chr7,133035343,1.5934257549057567,3954,2363,6317,-
chr7,133035345,1.6497991967871486,2843,1659,4502,-
chr7,133035364,1.4872178719484108,860,667,1527,-
chr7,133035407,1.3260795148907036,5381,3717,9098,-
chr7,133035429,1.9787638093036315,6197,4430,10627,-
chr7,133035431,1.4888085573630856,9968,7390,17358,-
chr7,133035438,1.4232235737307632,9889,6874,16763,-
chr7,133035547,0.8519101637944558,10223,7564,17787,-
chr7,133035550,1.1419241507685445,27687,20043,47730,-
chr7,133035552,1.1453923532905144,20507,13969,34476,-
chr7,133035571,1.011939059823149,10234,8067,18301,-
chr7,133035579,1.6055871059041806,17573,13287,30860,-
chr7,133035586,1.6512887692806624,11405,7734,19139,-
chr7,133035589,1.666815210932858,3429,2243,5672,-
chr7,133035602,1.4596171802054156,4069,2309,6378,-
chr7,133035690,1.5729708065472852,10437,8378,18815,-
chr7,133035714,1.4015793571349129,8447,6479,14926,-
chr7,133035763,1.1749154783217508,14127,8848,22975,-
chr7,133035764,1.1806248685708203,22420,14661,37081,-
chr7,133035765,0.8658509771402314,4740,3503,8243,-
chr7,133035766,1.114441694733735,18629,13130,31759,-
chr7,133035767,1.2624435077576341,13132,8834,21966,-
chr7,133035768,1.2834578913245256,21636,13872,35508,-
chr7,133035769,1.293005608510553,17919,11297,29216,-
chr7,133035776,1.3781056768263087,8722,5707,14429,-
chr7,133035780,1.2818609086574484,2090,1661,3751,-
chr7,133035786,1.654751332149201,1798,1125,2923,-
chr7,133035810,1.4622030926191616,996,614,1610,-
chr7,133035818,1.5564435564435561,983,571,1554,-
chr7,133035939,0.7609011772673852,3833,2952,6785,-
chr7,134442571,1.7063321385902035,964,674,1638,-
chr7,134442583,1.8775212858959276,1435,1053,2488,-
chr7,134442585,3.011272275176129,772,634,1406,-
chr7,134442622,3.2481854620301163,936,542,1478,-
chr7,134442701,0.344386291941497,738,633,1371,-
chr7,134442753,2.3380156922298148,738,438,1176,-
chr7,134442758,4.304571428571428,557,499,1056,-
chr7,134447377,2.827130703962424,889,521,1410,-
chr7,134449036,0.9301954625210126,2165,1704,3869,-
chr7,134449038,0.9301954625210126,2165,1704,3869,-
chr7,134449046,2.13986013986014,781,597,1378,-
chr7,134449063,1.4738279697050074,1482,1027,2509,-
chr7,134449066,2.1345599257192447,1097,890,1987,-
chr7,134449069,0.5318553268765133,638,471,1109,-
chr7,134449787,1.9038461538461544,569,493,1062,-
chr7,134450853,2.476688550127963,717,472,1189,-
chr7,134451601,2.061756080731413,663,340,1003,-
chr7,134459056,2.8980248047772164,700,310,1010,-
chr7,134459057,2.8980248047772164,700,310,1010,-
chr7,135927001,3.8873239436619715,620,425,1045,-
chr7,135927217,2.35921875,718,399,1117,-
chr7,135928062,1.6327266483516485,770,545,1315,-
chr7,135928064,2.1374485596707817,741,485,1226,-
chr7,135928304,4.6123658455317615,498,522,1020,-
chr7,135928311,4.3803933641265145,534,489,1023,-
chr7,135928321,3.018198200335685,1523,975,2498,-
chr7,135928322,3.0631250269031693,1311,801,2112,-
chr7,135928407,0.46448215979513935,1404,1631,3035,-
chr7,135928482,42.641553427859975,4241,4135,8376,-
chr7,135928483,47.39417172393179,5762,4287,10049,-
chr7,135928484,39.856013551665725,1485,965,2450,-
chr7,135928485,48.30655141874429,6402,1303,7705,-
chr7,135928486,7.728592308259399,5768,608,6376,-
chr7,135928487,7.633411309726316,7485,810,8295,-
chr7,135928489,8.695387187081119,7123,806,7929,-
chr7,135928490,8.022391530399563,4554,523,5077,-
chr7,135928491,7.8877729559099015,3980,476,4456,-
chr7,135928586,0.32354328171370356,1232,807,2039,-
chr7,135928817,2.8601036269430047,643,385,1028,-
chr7,135928974,2.044785877737823,694,482,1176,-
chr7,135929355,2.336309523809524,627,419,1046,-
chr7,135929389,0.6553275109170306,1046,915,1961,-
chr7,135929398,1.0690569021048093,1405,1388,2793,-
chr7,135929402,3.2617845117845117,499,527,1026,-
chr7,135929446,1.3009257659154507,1140,824,1964,-
chr7,135929537,2.397541687801891,999,639,1638,-
chr7,135929641,1.8979526208596846,680,490,1170,-
chr7,135929738,1.0390792291220556,646,466,1112,-
chr7,135929740,1.0390792291220556,646,466,1112,-
chr7,135929842,2.823836865356939,757,557,1314,-
chr7,137875720,1.5599878638854783,744,549,1293,-
chr7,137877294,1.6689202240679928,809,500,1309,-
chr7,137877307,2.147899159663865,638,454,1092,-
chr7,137878155,0.9319506957266436,1823,1404,3227,-
chr7,137878157,0.9985866094105033,1569,1190,2759,-
chr7,137878441,3.693777911804028,636,480,1116,-
chr7,137879205,2.8458968893144205,728,499,1227,-
chr7,137879735,2.178490313961256,525,498,1023,-
chr7,137879738,2.5200991189427318,1016,907,1923,-
chr7,137879739,2.5200991189427318,1016,907,1923,-
chr7,139060898,2.4765623296516175,706,583,1289,-
chr7,139080232,2.280571489578497,1283,861,2144,-
chr7,139080234,2.7446704495155854,1021,704,1725,-
chr7,140453702,0.28905315937727905,1402,1076,2478,-
chr7,140453742,1.194354345522481,632,451,1083,-
chr7,143312849,0.33302778374175185,1316,929,2245,-
chr7,148826547,3.2413200674164817,870,611,1481,-
chr7,148829832,1.452803343559646,1306,917,2223,-
chr7,148829836,0.9583255416711198,4227,3161,7388,-
chr7,148829837,0.6899253510135354,4796,3317,8113,-
chr7,148829838,1.0587218799202418,5832,4456,10288,-
chr7,148829839,1.0266228056624647,4163,3181,7344,-
chr7,148829840,1.7445305108798486,1156,1056,2212,-
chr7,148987247,0.9801813066583309,602,456,1058,-
chr7,149003634,2.1703657670454546,842,511,1353,-
chr7,149003639,1.9373846988605528,540,484,1024,-
chr7,149003664,1.9362917398945514,1016,568,1584,-
chr7,149003666,1.9794406924207435,1282,755,2037,-
chr7,149003859,2.2273926210557167,936,748,1684,-
chr7,149003900,2.099271571324714,3751,2418,6169,-
chr7,149003921,1.238862642942293,2984,1594,4578,-
chr7,149003934,0.6590874848208048,5663,3110,8773,-
chr7,149003947,1.4596368315699173,5372,2689,8061,-
chr7,149003948,1.4596368315699173,5372,2689,8061,-
chr7,149003949,1.240588920027303,7691,4090,11781,-
chr7,149003965,1.8070192804513712,3069,1591,4660,-
chr7,149003986,1.8386533486058494,3232,1905,5137,-
chr7,149003987,1.590066366673171,3998,2503,6501,-
chr7,149004007,0.6667997781475319,883,600,1483,-
chr7,149004019,1.543597961867193,682,506,1188,-
chr7,149004020,1.6877770265194199,955,521,1476,-
chr7,149004023,0.5434858539993014,777,408,1185,-
chr7,149004103,2.3311781609195403,648,463,1111,-
chr7,149004104,1.5376407129455911,836,532,1368,-
chr7,149005187,2.169845268082044,1004,793,1797,-
chr7,149005188,2.169845268082044,1004,793,1797,-
chr7,149005244,2.6139403695719703,1451,1120,2571,-
chr7,149005366,1.8149284573718651,1182,778,1960,-
chr7,149005367,1.8149284573718651,1182,778,1960,-
chr7,149005907,1.8875192604006161,685,412,1097,-
chr7,149005976,5.607535321821039,1127,587,1714,-
chr7,149005977,5.607535321821039,1127,587,1714,-
chr7,149006031,1.9467287157062052,804,479,1283,-
chr7,149008261,1.6549106284835673,1012,725,1737,-
chr7,149008262,0.4614779874213837,586,529,1115,-
chr7,149008282,3.4452431289640586,581,472,1053,-
chr7,149008307,1.7597132616487456,721,464,1185,-
chr7,149011901,1.9407894736842104,589,417,1006,-
chr7,149011958,2.017485119047619,560,447,1007,-
chr7,149011996,1.8040455013171448,1231,854,2085,-
chr7,149012254,1.780315522630504,1095,990,2085,-
chr7,149012255,1.903338899463406,1612,1394,3006,-
chr7,149014916,2.5245676100628933,733,635,1368,-
chr7,149019036,1.0595262414577886,1331,955,2286,-
chr7,149019044,3.5747074707470747,610,403,1013,-
chr7,149019162,1.629123518735988,2179,1614,3793,-
chr7,149019163,1.629123518735988,2179,1614,3793,-
chr7,149019190,1.4230917681478248,2301,1577,3878,-
chr7,149021032,2.454810495626822,841,685,1526,-
chr7,149021056,0.5941326194014392,1963,1393,3356,-
chr7,149021065,0.5733654464834245,1669,1232,2901,-
chr7,149021080,2.4848786478353024,2044,1593,3637,-
chr7,149021134,2.2606859767470064,1331,896,2227,-
chr7,149021135,1.7993959510227064,1314,900,2214,-
chr7,151076708,12.328168217924077,571,488,1059,-
chr7,151218638,1.072192241115976,584,426,1010,-
chr7,151218640,1.072192241115976,584,426,1010,-
chr7,151219126,2.395368363501454,1477,1190,2667,-
chr7,151219150,1.8038963212236254,4165,2621,6786,-
chr7,151219151,1.6862793696161746,5015,3021,8036,-
chr7,151219153,1.5335709870775778,3232,1905,5137,-
chr7,151219154,2.05242718446602,905,617,1522,-
chr7,151221600,1.7317529631940112,693,457,1150,-
chr7,151221618,0.5446088794926004,827,494,1321,-
chr7,151221624,2.046998756562874,2036,1446,3482,-
chr7,151221635,1.6346153846153848,764,545,1309,-
chr7,151222555,2.568187739830896,968,704,1672,-
chr7,151222556,2.7168187288576635,878,598,1476,-
chr7,151226375,0.30326397844315145,753,701,1454,-
chr7,151466945,3.8101710203806496,747,416,1163,-
chr7,151467085,1.8671945851489749,1278,852,2130,-
chr7,151467148,2.0939244663382595,796,434,1230,-
chr7,151471576,2.123124677442747,682,400,1082,-
chr7,158631509,2.996386106545306,992,1324,2316,-
chr7,158631518,11.839238694809588,2804,2839,5643,-
chr7,158631519,11.767117511030408,3714,3326,7040,-
chr7,158631520,11.767117511030408,3714,3326,7040,-
chr7,158631521,12.871096807316636,2771,2241,5012,-
chr7,158631528,10.004280185875933,1474,563,2037,-
chr7,158631529,7.1037151702786385,1058,305,1363,-
chr7,158631530,7.1037151702786385,1058,305,1363,-
chr7,158631536,11.435607891660428,2437,717,3154,-
chr7,158631537,9.203431344928125,1733,535,2268,-
chr7,158631538,9.06227599668273,2271,654,2925,-
chr7,158652304,1.0476665337056243,617,435,1052,-
chr7,158652305,1.0476665337056243,617,435,1052,-
chr7,158655246,1.3400197445577695,1365,888,2253,-
chr7,158655359,3.954990925589837,907,579,1486,-
chr7,158655360,3.19343175628587,1520,987,2507,-
chr7,158656333,0.3327424350358096,919,667,1586,-
chr7,158656334,0.3266193853427896,627,469,1096,-
chr7,158656588,2.7285431911688454,675,421,1096,-
chr7,158733308,0.4319407008086253,640,423,1063,-
chr7,158733837,2.082615049628371,772,558,1330,-
chr7,158734159,2.368355844905377,725,631,1356,-
chr7,158737140,1.0424187725631768,769,553,1322,-
chr7,158737141,0.8985857897525917,992,752,1744,-
chr7,158741803,0.8742683947155881,708,455,1163,-
chr7,158743546,2.9021972693318046,573,472,1045,-
chr7,158743576,2.8894717450833958,632,398,1030,-
chr7,158749712,1.8741861904191577,890,602,1492,-
chr8,11844483,0.6685389982287577,5051,3573,8624,-
chr8,11844484,0.5917696761070255,2851,1908,4759,-
chr8,11844508,1.5167341040462428,1070,864,1934,-
chr8,11844610,0.6989641905889316,1686,1084,2770,-
chr8,11844631,1.6274131274131274,1123,839,1962,-
chr8,11844639,0.7016131390418636,1673,1206,2879,-
chr8,11844666,0.6196883852691217,874,705,1579,-
chr8,11844793,0.6388642413487133,929,712,1641,-
chr8,11844823,1.6666666666666667,763,572,1335,-
chr8,11844837,1.6695906432748535,570,512,1082,-
chr8,11844873,1.1326873291582429,1487,1112,2599,-
chr8,11844885,0.6617136727869265,838,586,1424,-
chr8,11844902,2.03197461557237,554,481,1035,-
chr8,11845006,0.6035406718006728,2738,2111,4849,-
chr8,11845125,0.6748574531631821,1656,1275,2931,-
chr8,11845197,0.5942475455618575,859,738,1597,-
chr8,11845209,1.4902184160905092,842,687,1529,-
chr8,11845217,1.9979237728014239,841,612,1453,-
chr8,11845218,0.4411177644710579,577,500,1077,-
chr8,11845681,1.7171938354088165,1282,1133,2415,-
chr8,11845704,1.7107279693486592,892,521,1413,-
chr8,11845705,0.4739495798319328,563,475,1038,-
chr8,11845719,2.0181147540983604,848,487,1335,-
chr8,11845785,2.2354976224486127,1296,906,2202,-
chr8,11847110,1.6203696966972896,2665,1907,4572,-
chr8,11847113,0.5952804569716265,977,723,1700,-
chr8,11847119,0.6615636960087479,1209,825,2034,-
chr8,11847163,2.355983772819473,1110,747,1857,-
chr8,11847722,0.8297247008143948,2915,2185,5100,-
chr8,11847729,1.7313308919167414,2807,2212,5019,-
chr8,11847747,1.6891559145080268,1049,780,1829,-
chr8,11847763,1.5304221483589755,1348,1068,2416,-
chr8,11847765,2.3800453514739233,1151,734,1885,-
chr8,11847793,1.7517730496453903,1063,657,1720,-
chr8,11847810,1.2934277343925655,1606,1169,2775,-
chr8,11847819,3.207439741886506,675,478,1153,-
chr8,11848079,3.214089912280701,1004,607,1611,-
chr8,11848080,1.9386466165413532,1171,759,1930,-
chr8,11848107,0.6030811382426455,1090,742,1832,-
chr8,11848148,2.1178045515394914,677,497,1174,-
chr8,11848149,2.1448562447131345,1071,719,1790,-
chr8,11849126,1.0410437618316597,1543,1031,2574,-
chr8,11849147,1.9844897959183676,747,391,1138,-
chr8,11850957,0.40899842022116906,1470,1054,2524,-
chr8,11850969,2.0810234541577826,1341,937,2278,-
chr8,11850975,1.8910715041700183,2350,1195,3545,-
chr8,11850977,2.1234440313411076,4575,2591,7166,-
chr8,11850979,1.803912467272588,3127,2105,5232,-
chr8,11852667,3.2519810977826245,1090,654,1744,-
chr8,11853356,0.5315679233991621,626,556,1182,-
chr8,11853399,1.6929230769230768,785,649,1434,-
chr8,11853463,1.210711773496085,967,759,1726,-
chr8,11853476,1.4972282565287967,711,454,1165,-
chr8,11868014,3.6814253323218145,1063,643,1706,-
chr8,11868091,2.5270581521781823,693,377,1070,-
chr8,17647048,2.2889310786348185,1057,780,1837,-
chr8,17647050,2.2889310786348185,1057,780,1837,-
chr8,17649946,2.9544703454958428,792,492,1284,-
chr8,17754736,1.5859822752995425,1641,1139,2780,-
chr8,17754769,2.0535714285714284,674,377,1051,-
chr8,17754770,2.0535714285714284,674,377,1051,-
chr8,17754771,1.944799114742935,702,533,1235,-
chr8,17754773,1.9763835140041208,1708,1088,2796,-
chr8,17754774,1.7756641076160065,725,358,1083,-
chr8,17754775,1.9970591414579641,1328,795,2123,-
chr8,18057488,1.5592389726409825,761,433,1194,-
chr8,18057490,1.3806741573033707,767,444,1211,-
chr8,18057491,3.239527277722323,1189,770,1959,-
chr8,18057582,1.298419120412536,6786,5250,12036,-
chr8,18057592,1.2431117267173972,10046,6842,16888,-
chr8,18057597,1.2923924927024155,9855,6454,16309,-
chr8,18057599,1.305142457023348,6315,4353,10668,-
chr8,18057610,1.3941012762376035,4637,2562,7199,-
chr8,18057612,1.1754888451452756,7060,4630,11690,-
chr8,18057615,1.4528475199020208,1824,1149,2973,-
chr8,18057616,0.6294042280589366,1702,891,2593,-
chr8,18057621,2.4927440086242645,1502,777,2279,-
chr8,18058854,1.8443237686966667,2853,1588,4441,-
chr8,18058869,0.4322864739115985,945,471,1416,-
chr8,18058872,1.6684595524956969,939,580,1519,-
chr8,18058879,2.146937119675456,1125,724,1849,-
chr8,18058884,1.864214992927864,658,403,1061,-
chr8,18058889,2.3442354635539995,1877,972,2849,-
chr8,18058890,2.77194421657096,980,476,1456,-
chr8,18067066,1.6212892309300442,3422,2250,5672,-
chr8,18067072,1.5869401804082923,2651,2271,4922,-
chr8,18067077,1.8147318269729704,4634,3654,8288,-
chr8,18067078,1.8147318269729704,4634,3654,8288,-
chr8,18067088,0.9753850080830424,3952,2414,6366,-
chr8,18067089,0.7587424425634824,4481,3307,7788,-
chr8,18067090,0.8561810869111947,8433,5721,14154,-
chr8,18067095,1.3472079851727599,1711,1322,3033,-
chr8,18067097,1.0463855092597678,2527,1690,4217,-
chr8,18067282,2.628843452230321,1242,910,2152,-
chr8,18075560,1.640250142465443,583,419,1002,-
chr8,19408673,2.3278431372549018,741,424,1165,-
chr8,19408674,2.3278431372549018,741,424,1165,-
chr8,19439840,1.188339010218393,658,433,1091,-
chr8,19439841,1.188339010218393,658,433,1091,-
chr8,19458467,2.6789429935130524,655,490,1145,-
chr8,19506031,2.601035218875521,573,455,1028,-
chr8,22140655,0.6021093000958773,627,446,1073,-
chr8,22140690,3.3499155114109542,595,415,1010,-
chr8,22221527,1.9983399550011398,873,552,1425,-
chr8,23021604,3.3464560747754533,852,556,1408,-
chr8,23021835,1.3105436534739772,610,397,1007,-
chr8,23022250,9.13524208566108,469,536,1005,-
chr8,23022251,17.47683014277977,1505,1329,2834,-
chr8,23022252,17.189059780396136,1434,1186,2620,-
chr8,23022253,27.53520361220761,1028,664,1692,-
chr8,23297357,0.7156172722084839,1088,750,1838,-
chr8,23297530,2.064143501126972,708,483,1191,-
chr8,23297811,4.476747787045974,1152,910,2062,-
chr8,23297812,4.512855209742897,869,738,1607,-
chr8,23297813,4.636998742242801,1747,1410,3157,-
chr8,23297814,4.93298555377207,646,533,1179,-
chr8,23298852,2.5325682382134,1064,935,1999,-
chr8,23298853,2.5325682382134,1064,935,1999,-
chr8,23302063,1.890303348612172,654,466,1120,-
chr8,23333426,1.056743120106113,746,614,1360,-
chr8,23333492,1.3039568101240055,704,461,1165,-
chr8,23341173,1.7861572810716944,959,555,1514,-
chr8,23341174,0.35294117647058826,614,409,1023,-
chr8,23341198,1.6430023999725603,964,619,1583,-
chr8,23360113,2.0905493093404055,947,647,1594,-
chr8,23360139,1.5249396494043892,586,419,1005,-
chr8,27598075,1.243236823221382,1055,903,1958,-
chr8,27598089,1.686612166018245,892,763,1655,-
chr8,27598115,1.2974758197688132,549,470,1019,-
chr8,27598117,1.2974758197688132,549,470,1019,-
chr8,27598492,2.3526934984520116,825,424,1249,-
chr8,27598523,0.625038315015107,792,556,1348,-
chr8,27598557,0.35221132679607764,703,525,1228,-
chr8,27599791,2.0535704141339544,976,606,1582,-
chr8,27599807,0.6218181818181818,737,549,1286,-
chr8,27599824,1.9363026819923366,621,463,1084,-
chr8,27599825,1.8236220472440945,578,507,1085,-
chr8,27599849,1.8429591174561968,567,468,1035,-
chr8,27599907,1.6677958446251129,843,491,1334,-
chr8,27599925,1.7088036117381493,756,442,1198,-
chr8,27599958,1.7438413213806734,548,456,1004,-
chr8,27604935,0.5693581780538303,769,482,1251,-
chr8,27605003,0.4282222868780913,668,490,1158,-
chr8,27605036,1.7688375350140058,1507,1019,2526,-
chr8,27605037,1.7688375350140058,1507,1019,2526,-
chr8,27605087,1.4111127006262407,1279,832,2111,-
chr8,27605258,3.987068965517242,591,463,1054,-
chr8,27605259,1.7548596112311015,844,462,1306,-
chr8,27605300,0.5206963249516441,672,516,1188,-
chr8,27605327,2.4596491228070176,700,449,1149,-
chr8,27606515,1.9466110812264659,964,571,1535,-
chr8,27609065,0.635369030390738,783,690,1473,-
chr8,27609068,1.5126258940300688,722,662,1384,-
chr8,27609083,2.0872690168700507,2459,1861,4320,-
chr8,27614671,3.0243497092939826,831,518,1349,-
chr8,27614672,2.9253231040728314,1077,634,1711,-
chr8,27748223,1.6893628538948735,2557,2029,4586,-
chr8,27748224,1.809167233945995,3751,2937,6688,-
chr8,27748226,1.6147589588963622,3063,2261,5324,-
chr8,27748229,1.5447072072072072,1275,739,2014,-
chr8,27748252,2.233242929097249,1440,800,2240,-
chr8,27748253,2.233242929097249,1440,800,2240,-
chr8,27748274,2.5184381778741867,782,460,1242,-
chr8,27748276,1.8498196741815178,1235,654,1889,-
chr8,27810397,0.35090828533451485,703,487,1190,-
chr8,27810411,1.6981595092024542,691,488,1179,-
chr8,27822414,2.064044457421269,1007,718,1725,-
chr8,29336003,2.325355757601021,786,617,1403,-
chr8,29336136,5.8595553437245345,427,670,1097,-
chr8,29336632,5.197341251652597,2621,2145,4766,-
chr8,29336633,5.197341251652597,2621,2145,4766,-
chr8,29336639,12.37258138597577,1316,903,2219,-
chr8,29338335,1.3395321575105237,1092,765,1857,-
chr8,29338336,1.3395321575105237,1092,765,1857,-
chr8,29338337,1.3395321575105237,1092,765,1857,-
chr8,29350433,5.6076370233994535,609,471,1080,-
chr8,30063304,1.8012979613075102,2525,1783,4308,-
chr8,30063305,1.7911706349206349,1726,1187,2913,-
chr8,30063396,2.1746970977740205,680,506,1186,-
chr8,30063817,0.5568715642178911,1012,666,1678,-
chr8,30063880,1.663062743707905,852,545,1397,-
chr8,30066007,2.269887505022097,728,523,1251,-
chr8,30066132,1.7922899884925203,622,394,1016,-
chr8,30066849,2.388738390092879,822,543,1365,-
chr8,30066851,0.6063829787234042,896,597,1493,-
chr8,30066892,2.082457983193277,792,475,1267,-
chr8,30066910,0.5434510784620193,731,456,1187,-
chr8,30069659,0.5055555555555555,714,494,1208,-
chr8,30069772,1.8179012345679009,835,593,1428,-
chr8,30069963,1.9202551834130785,687,626,1313,-
chr8,30069966,1.7310810810810813,853,739,1592,-
chr8,30069967,2.5396825396825395,989,593,1582,-
chr8,30069973,1.5862381852551986,616,528,1144,-
chr8,30070016,1.7576044164941926,1505,969,2474,-
chr8,30070038,1.854939125622579,864,555,1419,-
chr8,30070056,1.824144583206417,690,468,1158,-
chr8,30117647,0.9875766923027635,1086,948,2034,-
chr8,30117648,1.1492095422749056,1282,1181,2463,-
chr8,30117650,1.291718469014903,951,857,1808,-
chr8,30614628,2.0378344307448115,668,492,1160,-
chr8,30614630,2.047008454526751,665,492,1157,-
chr8,30678199,3.451886843238588,890,658,1548,-
chr8,30679574,5.768259112265628,652,452,1104,-
chr8,30679638,5.4017857142857135,659,503,1162,-
chr8,30679639,5.598027127003698,944,678,1622,-
chr8,30679645,1.2494640379984587,635,379,1014,-
chr8,30794024,2.8109891866104135,548,499,1047,-
chr8,38163783,1.7013103406645536,534,497,1031,-
chr8,38176313,0.5469034758590617,4031,2142,6173,-
chr8,38176318,0.9800891758917588,2507,1083,3590,-
chr8,38176319,1.6373411534701858,1339,791,2130,-
chr8,38176320,0.9800891758917588,2507,1083,3590,-
chr8,38176332,0.5316587030716724,2433,1464,3897,-
chr8,38176333,1.0224825238987865,3757,2039,5796,-
chr8,38176334,1.0224825238987865,3757,2039,5796,-
chr8,38176374,2.03194484047231,1616,780,2396,-
chr8,38176375,2.1475119714600157,2296,1151,3447,-
chr8,38176377,2.409110889110889,1255,714,1969,-
chr8,38176379,2.6510565705480955,1174,648,1822,-
chr8,38176381,2.8459038142620234,1128,602,1730,-
chr8,38176382,3.822454308093995,731,382,1113,-
chr8,38321133,2.3697153909919866,803,516,1319,-
chr8,38321134,2.3697153909919866,803,516,1319,-
chr8,38347601,1.8064923227932412,990,838,1828,-
chr8,38347612,1.8593438751627291,1846,1411,3257,-
chr8,38347622,3.089430894308943,759,491,1250,-
chr8,38347624,1.733494851605088,794,634,1428,-
chr8,38347634,1.9267604586478364,2635,1791,4426,-
chr8,38347635,1.8918172492701015,1917,1333,3250,-
chr8,38347641,2.372619291419209,798,513,1311,-
chr8,38347671,1.6853002070393377,813,482,1295,-
chr8,38347693,3.6270396270396272,777,329,1106,-
chr8,38347695,1.634090344998759,1144,473,1617,-
chr8,38347697,1.7517150780907897,1090,441,1531,-
chr8,38347698,1.5175018886930247,1047,417,1464,-
chr8,42342449,0.9793327675853357,1782,1173,2955,-
chr8,42342450,0.6948438626277846,2438,1552,3990,-
chr8,42342451,0.5909862502121881,1476,902,2378,-
chr8,47737073,1.6497640325333869,1059,865,1924,-
chr8,47737148,1.9152342830233102,829,684,1513,-
chr8,47737172,0.5757649724748901,1481,1103,2584,-
chr8,47737198,1.3706142111601765,793,529,1322,-
chr8,47737199,0.7393370119839334,903,645,1548,-
chr8,47737219,1.1477112794048656,684,346,1030,-
chr8,47737221,1.5181072963631166,1192,645,1837,-
chr8,47737518,1.4311202609113856,688,517,1205,-
chr8,47830686,2.6559322729803916,870,471,1341,-
chr8,47837372,3.4297679272049164,712,546,1258,-
chr8,51819742,2.0260147033865485,913,773,1686,-
chr8,52642439,2.8930157551183524,1296,1008,2304,-
chr8,52642440,3.002397014122948,1431,1124,2555,-
chr8,52642441,2.827300303336704,681,429,1110,-
chr8,52668135,2.6724293064956095,683,400,1083,-
chr8,54047203,1.5475599274185847,830,565,1395,-
chr8,54048037,1.2601280523919292,672,541,1213,-
chr8,54051086,3.807174887892377,565,445,1010,-
chr8,54051087,3.807174887892377,565,445,1010,-
chr8,54051112,0.7301517859385076,782,609,1391,-
chr8,54052740,0.46889457937705104,574,444,1018,-
chr8,54052750,5.0079635607941855,647,623,1270,-
chr8,54063351,2.5749840779606785,759,578,1337,-
chr8,54523011,0.5347905282331512,733,487,1220,-
chr8,54523012,1.9834710743801651,869,637,1506,-
chr8,54523018,0.45763554966008957,689,488,1177,-
chr8,54523036,1.4292971526272649,1239,855,2094,-
chr8,54523037,1.5015258576548898,631,464,1095,-
chr8,56050173,1.8824404761904765,758,503,1261,-
chr8,56050175,2.0164171897634,695,435,1130,-
chr8,56050499,3.196534696625022,781,650,1431,-
chr8,56050501,4.155851063829787,600,469,1069,-
chr8,56050517,1.4523469744707256,763,521,1284,-
chr8,56050519,1.512561888528848,623,429,1052,-
chr8,56050775,0.8923259964306961,749,532,1281,-
chr8,56050777,0.8923259964306961,749,532,1281,-
chr8,56050792,0.9279796048438496,615,522,1137,-
chr8,56051013,1.8441277168804888,999,667,1666,-
chr8,56074074,1.1859698245010657,16927,11465,28392,-
chr8,56074075,0.5549881953852297,18997,14198,33195,-
chr8,56074106,0.7473997844052599,13050,10327,23377,-
chr8,56074138,1.1110179859707878,15087,10897,25984,-
chr8,56074140,1.0823018183427202,12894,10672,23566,-
chr8,56074141,0.9796964835881348,8325,6912,15237,-
chr8,56074149,1.289028792616746,12634,9894,22528,-
chr8,56074150,1.3251350722931399,8475,6580,15055,-
chr8,56074151,1.3251350722931399,8475,6580,15055,-
chr8,56074152,1.0352632832406594,7728,5197,12925,-
chr8,56074157,1.3428674901178157,3383,1936,5319,-
chr8,56074416,1.0869860222740522,7672,5078,12750,-
chr8,56074470,1.04102751761011,9317,7462,16779,-
chr8,56074472,0.9053081594969188,5330,4509,9839,-
chr8,56074474,0.7788006029285098,1701,1547,3248,-
chr8,56074485,1.3325473338619702,2424,1466,3890,-
chr8,56074493,1.4037162162162158,1938,1399,3337,-
chr8,56074496,0.748319236608111,1441,1536,2977,-
chr8,56074498,0.7065821376321338,2003,2172,4175,-
chr8,56074499,0.7072250639386188,1228,1359,2587,-
chr8,56074505,1.2036591236902996,2167,1795,3962,-
chr8,56074506,1.1605763350915443,1420,1350,2770,-
chr8,60938569,1.7714573971914216,635,537,1172,-
chr8,61501716,2.446640114379085,1368,1087,2455,-
chr8,61501717,2.446640114379085,1368,1087,2455,-
chr8,61501730,1.7269969666329625,731,644,1375,-
chr8,61501731,1.0734083282744444,1689,1214,2903,-
chr8,61501778,1.940578158458244,579,466,1045,-
chr8,61502426,5.772488373338444,587,430,1017,-
chr8,61502529,0.8254190876911776,726,482,1208,-
chr8,61502530,0.8254190876911776,726,482,1208,-
chr8,61518111,1.9910361842105264,780,379,1159,-
chr8,61518112,1.9910361842105264,780,379,1159,-
chr8,61525996,3.641521143844216,668,363,1031,-
chr8,61526014,2.1669202114276724,673,502,1175,-
chr8,61548097,2.091895430252585,646,481,1127,-
chr8,61567287,0.6352758334624116,1098,755,1853,-
chr8,61576837,2.217686471136353,979,726,1705,-
chr8,61576853,1.6902623068630973,671,483,1154,-
chr8,61583959,1.732344834141241,700,500,1200,-
chr8,61583961,1.5615975422427035,781,629,1410,-
chr8,61584026,1.88865203113564,1595,1082,2677,-
chr8,61625394,1.5593850662906283,3980,3077,7057,-
chr8,61625395,1.5593850662906283,3980,3077,7057,-
chr8,61625556,1.930943583145427,4204,3247,7451,-
chr8,61625567,1.448116046707596,1472,922,2394,-
chr8,61625599,0.6729561018969313,1040,838,1878,-
chr8,61625602,1.8305038335158819,1145,663,1808,-
chr8,61625603,1.3750592311415688,3550,2308,5858,-
chr8,61626070,1.5035052338423125,1853,1156,3009,-
chr8,61626162,1.661446580032682,1797,1447,3244,-
chr8,61626193,1.3718263718263721,1674,1294,2968,-
chr8,61626213,1.6575425274062199,3358,2331,5689,-
chr8,61626277,1.4098916055499524,2027,1398,3425,-
chr8,61638001,1.5171849427168576,1853,1409,3262,-
chr8,61638002,1.4762027465832914,3090,2145,5235,-
chr8,61638361,1.7387695819068367,837,713,1550,-
chr8,61644620,1.387398169144201,3886,2645,6531,-
chr8,61646853,1.4536338740257002,1326,1009,2335,-
chr8,61646856,1.093565280545407,3134,2197,5331,-
chr8,61651069,1.4829113924050632,1561,1263,2824,-
chr8,61651096,1.9415088728065826,1631,1440,3071,-
chr8,61651107,1.948535233570863,1497,1262,2759,-
chr8,61653642,1.478595283601533,4613,3525,8138,-
chr8,61681020,1.3189181654302213,4902,3634,8536,-
chr8,61684066,1.5535834300727072,1452,1258,2710,-
chr8,61684083,1.4102088948787062,2282,1483,3765,-
chr8,61684112,1.5685612600116836,3619,2665,6284,-
chr8,61684140,1.76431718061674,800,680,1480,-
chr8,61684141,1.3386466527808858,1993,1350,3343,-
chr8,61684154,1.6411764705882357,647,509,1156,-
chr8,61684157,0.5829321663019693,591,456,1047,-
chr8,61684166,1.494487850399985,1658,1253,2911,-
chr8,61684171,0.8765197568389057,1537,986,2523,-
chr8,61684172,0.8765197568389057,1537,986,2523,-
chr8,61684174,1.2162056313309118,1066,841,1907,-
chr8,61684185,1.1094965427830596,892,711,1603,-
chr8,61684187,0.9186404387342397,1383,1025,2408,-
chr8,61714357,1.5153238546603476,871,632,1503,-
chr8,61714413,1.3174190580559344,948,826,1774,-
chr8,63015293,1.3904203448761656,3823,2708,6531,-
chr8,63015301,2.821302117205,907,658,1565,-
chr8,63015406,2.158709436777322,925,765,1690,-
chr8,63015443,0.5950639853747716,650,546,1196,-
chr8,63015444,0.5117693731816979,644,397,1041,-
chr8,63017533,0.4968703526233116,2249,1376,3625,-
chr8,63017541,0.4490123186821197,1119,806,1925,-
chr8,63017557,0.5667076029920732,845,688,1533,-
chr8,63017623,0.4591624591624592,772,480,1252,-
chr8,63023945,2.025586353944563,607,468,1075,-
chr8,63024099,2.706079087153256,654,390,1044,-
chr8,63026276,2.329629172149632,1292,912,2204,-
chr8,63027224,1.0144165000526149,963,730,1693,-
chr8,63027225,1.0144165000526149,963,730,1693,-
chr8,63030207,0.4786151889954918,636,421,1057,-
chr8,63035758,1.9629906917378197,742,545,1287,-
chr8,65602672,2.591160220994475,669,542,1211,-
chr8,65602673,3.9994279650777376,1223,886,2109,-
chr8,66767734,0.41310992238305017,648,487,1135,-
chr8,66767737,1.4797831721579375,647,602,1249,-
chr8,66922087,1.061601300366145,6529,5275,11804,-
chr8,66922716,1.4812324332016935,1342,1040,2382,-
chr8,66922718,1.2971831664098614,4504,2949,7453,-
chr8,66922719,1.3754789269231875,5717,3873,9590,-
chr8,66922720,1.3688906706374206,5690,3675,9365,-
chr8,66922721,0.6929544358727098,1313,975,2288,-
chr8,66922722,1.5784153088176305,3740,2307,6047,-
chr8,66922723,2.1149422726526703,3165,2135,5300,-
chr8,66925451,1.5263375573055982,2503,1565,4068,-
chr8,66925495,2.0842105263157893,881,664,1545,-
chr8,66925512,1.6586400177004204,1550,1042,2592,-
chr8,66925513,1.6352591099075564,7572,4214,11786,-
chr8,66925514,1.6593143267182247,4190,2136,6326,-
chr8,66925515,1.850205970317702,2622,1610,4232,-
chr8,66925516,2.053781512605042,1858,1104,2962,-
chr8,66925517,2.01384464634538,3652,1914,5566,-
chr8,66925539,0.7036342118176832,830,342,1172,-
chr8,66925540,0.7530949762131328,2824,1126,3950,-
chr8,67045907,0.579520697167756,626,458,1084,-
chr8,67045917,0.4871873509166496,985,803,1788,-
chr8,67045919,0.4871873509166496,985,803,1788,-
chr8,67051337,1.7775104170925575,824,516,1340,-
chr8,67056586,1.0116381203337723,812,593,1405,-
chr8,67056587,1.0116381203337723,812,593,1405,-
chr8,67057430,2.5719633158546076,904,568,1472,-
chr8,67059423,1.3722882485307932,4862,3017,7879,-
chr8,67059430,1.7129368381343602,13930,8776,22706,-
chr8,67059431,1.7129368381343602,13930,8776,22706,-
chr8,67059434,1.3899671447697692,7646,4859,12505,-
chr8,67061869,1.6814011676396998,2143,1198,3341,-
chr8,67061883,1.6096455627705628,1795,923,2718,-
chr8,67061885,1.6403193326016376,4096,2404,6500,-
chr8,67061886,1.574281735419006,4782,2568,7350,-
chr8,67061899,1.1791947028091427,1800,1055,2855,-
chr8,67061902,0.5355336704817674,1005,577,1582,-
chr8,67061908,1.6666371410962852,4036,2793,6829,-
chr8,67061910,1.925406511416038,3710,2619,6329,-
chr8,67061916,1.5815665606588654,5379,3413,8792,-
chr8,67061917,1.7336561743341403,1431,867,2298,-
chr8,67061918,1.52774735335585,3948,2546,6494,-
chr8,67061947,1.8620341819583663,1041,632,1673,-
chr8,67061965,1.3729988934735038,806,464,1270,-
chr8,70573630,3.828308207705192,652,397,1049,-
chr8,70573631,3.215205869204784,913,816,1729,-
chr8,70573708,1.5066969624491748,585,451,1036,-
chr8,70573832,1.8102223774595412,675,408,1083,-
chr8,70573854,2.386014344262295,620,487,1107,-
chr8,70573855,2.386014344262295,620,487,1107,-
chr8,70573964,2.11231884057971,582,455,1037,-
chr8,70574109,1.547892596157265,2286,1619,3905,-
chr8,70574254,2.0580544560393426,745,396,1141,-
chr8,70574329,3.264691358024692,600,404,1004,-
chr8,70574420,2.4932330827067672,828,699,1527,-
chr8,70574422,2.4932330827067672,828,699,1527,-
chr8,70575003,1.569929036073329,776,533,1309,-
chr8,70596292,0.4610526315789474,656,474,1130,-
chr8,70596307,1.9875751503006012,683,498,1181,-
chr8,70596320,0.5763413242009132,576,437,1013,-
chr8,70598009,0.4696574410163339,636,463,1099,-
chr8,70598240,0.5332446808510638,801,607,1408,-
chr8,70608291,2.217125382262997,1536,653,2189,-
chr8,70608292,2.051927838916469,3131,1733,4864,-
chr8,70608293,1.9167437557816838,1595,1080,2675,-
chr8,70638611,4.382392721726,681,436,1117,-
chr8,70657823,3.4541175047903856,785,578,1363,-
chr8,73292772,1.3367580145134674,3337,2098,5435,-
chr8,73292786,1.4080828445747802,1755,1407,3162,-
chr8,73292788,1.1847968545216252,2103,1525,3628,-
chr8,73292790,0.9060495247102778,4002,2986,6988,-
chr8,73292792,0.9332694739503233,8865,6083,14948,-
chr8,73292793,1.014433417578555,6662,4452,11114,-
chr8,73292794,1.1712383159319917,3394,1989,5383,-
chr8,73292796,0.6349973944762897,543,474,1017,-
chr8,73293631,1.655970397268356,789,603,1392,-
chr8,73946675,1.5796387520525452,649,608,1257,-
chr8,73946676,0.423913043478261,818,551,1369,-
chr8,73956043,1.1102897467794977,640,456,1096,-
chr8,74603335,0.8013434841021047,1555,1231,2786,-
chr8,74603336,2.1017747193046,828,752,1580,-
chr8,74603342,1.192079505123532,3227,2391,5618,-
chr8,74603343,1.6595855019878576,2863,2111,4974,-
chr8,74603499,0.47745113129136524,527,583,1110,-
chr8,74603500,0.5197291038219491,958,873,1831,-
chr8,74604010,1.3356922656651617,2250,1233,3483,-
chr8,74604011,1.3356922656651617,2250,1233,3483,-
chr8,74604012,0.9196001518397106,2196,1280,3476,-
chr8,74604164,1.7577162653975364,2666,2255,4921,-
chr8,74604189,1.825909973079397,5169,4130,9299,-
chr8,74604190,1.7667787926641036,6933,5236,12169,-
chr8,74604204,2.533875530410184,1326,807,2133,-
chr8,74604212,1.180849994044942,3162,1941,5103,-
chr8,74604213,0.84132292827945,2263,1287,3550,-
chr8,74604215,1.414855072463768,780,551,1331,-
chr8,74604217,0.7225171873936423,922,707,1629,-
chr8,74604226,2.6598184424271385,1171,597,1768,-
chr8,74604228,2.6598184424271385,1171,597,1768,-
chr8,74604232,2.032317364749402,942,589,1531,-
chr8,74604266,2.809171792425447,719,532,1251,-
chr8,79572027,0.4633116326925591,629,463,1092,-
chr8,79919047,0.5564827049432548,1707,1093,2800,-
chr8,79919049,2.0540638606676342,1886,2013,3899,-
chr8,79919054,1.4400138339345785,6965,6288,13253,-
chr8,79919055,1.763123880002655,4840,4635,9475,-
chr8,79919057,2.000859162743062,3111,2904,6015,-
chr8,79919060,0.6736570312992002,1125,803,1928,-
chr8,79919068,1.2724782397384349,2303,1740,4043,-
chr8,79919072,1.4843340721337897,1864,1417,3281,-
chr8,79919074,1.5581749822172544,901,756,1657,-
chr8,79919077,1.3806935817805384,1454,1103,2557,-
chr8,79919096,0.4278044444444444,767,674,1441,-
chr8,79919102,1.5214660579518595,1708,1376,3084,-
chr8,79919103,1.6315028901734103,1128,799,1927,-
chr8,80036932,4.133504263873544,572,477,1049,-
chr8,80037311,0.36026666666666673,771,374,1145,-
chr8,80037320,0.4528116156023133,735,386,1121,-
chr8,80037337,0.3359280882216662,724,395,1119,-
chr8,80037766,1.7667405764966742,663,450,1113,-
chr8,80053420,2.187990877171234,717,538,1255,-
chr8,85217423,1.565879808144456,924,685,1609,-
chr8,85217488,4.491869918699186,679,491,1170,-
chr8,85220331,1.9930889423076923,602,415,1017,-
chr8,85220354,0.8163584485916989,1552,840,2392,-
chr8,85220355,0.8737992890829103,1361,759,2120,-
chr8,85220356,0.9609057418699188,1148,575,1723,-
chr8,91069665,1.9665354330708662,702,507,1209,-
chr8,91069693,2.17459782378593,685,497,1182,-
chr8,92886366,1.385185647685648,619,481,1100,-
chr8,92954440,2.46824913406081,737,497,1234,-
chr8,93957530,0.6770449419660048,723,741,1464,-
chr8,93957534,0.6174560280661832,1055,710,1765,-
chr8,93957535,1.5804141563548468,494,522,1016,-
chr8,96231018,4.494095574439909,946,696,1642,-
chr8,96231105,2.000015339305436,1464,1123,2587,-
chr8,96231117,2.6927632529250327,1433,988,2421,-
chr8,96231481,3.06731969971977,1286,902,2188,-
chr8,96235523,1.5883490073145243,706,659,1365,-
chr8,96235529,1.971549404075356,640,577,1217,-
chr8,96235531,1.6152579582875959,1592,910,2502,-
chr8,96235533,1.210431000250182,3515,2359,5874,-
chr8,96235534,1.9892958892958892,1320,701,2021,-
chr8,96235535,1.5995680435279214,3711,2292,6003,-
chr8,96235536,1.6504585739100686,4005,2767,6772,-
chr8,96235537,1.6185738789512374,1634,1324,2958,-
chr8,96235542,1.190269197035629,1198,907,2105,-
chr8,96235543,0.5750405425328026,1613,815,2428,-
chr8,96235544,0.688927194173506,2150,1248,3398,-
chr8,98042707,1.6134247117431009,8734,6446,15180,-
chr8,98045044,1.3192835661762576,10348,9082,19430,-
chr8,98045045,1.1263113194986154,18438,14969,33407,-
chr8,98045053,1.336958885910539,17965,14072,32037,-
chr8,98045066,1.1709645112127152,6859,4592,11451,-
chr8,98045087,0.7621789543928433,8002,6651,14653,-
chr8,98045368,1.2378252974835433,16088,10606,26694,-
chr8,98045369,1.2473919120267507,12873,7832,20705,-
chr8,98045372,1.287176979664306,6370,5402,11772,-
chr8,98045521,1.4872492462273788,21032,12112,33144,-
chr8,98045522,1.5687280413208102,4768,3589,8357,-
chr8,98045523,1.7043842679705021,22424,10964,33388,-
chr8,98045524,1.8420443620221825,12483,4990,17473,-
chr8,98045525,1.989019966667756,16386,6464,22850,-
chr8,98045527,2.1950839881389532,11734,4416,16150,-
chr8,98045528,2.333291995645763,7696,2845,10541,-
chr8,98045534,2.344387061701549,3449,1131,4580,-
chr8,98045537,2.3532668740798197,10594,4282,14876,-
chr8,98045538,2.8139608936662057,8045,2965,11010,-
chr8,98045539,2.2145620337109704,1643,1033,2676,-
chr8,98045541,1.8009990111066707,13842,4742,18584,-
chr8,98045542,0.970548091606379,15342,5243,20585,-
chr8,98045543,0.9842187371790477,23324,9078,32402,-
chr8,98045544,0.9437506331726582,17626,6918,24544,-
chr8,98045545,0.8167374701277121,5634,1473,7107,-
chr8,99887595,1.0314500823791946,5775,4358,10133,-
chr8,99887597,0.8872185335839866,17057,12205,29262,-
chr8,99887599,0.784096332903917,11749,8513,20262,-
chr8,99887601,0.7696714255833785,7406,5443,12849,-
chr8,99887603,1.4400234386813848,2058,1555,3613,-
chr8,99887604,1.4228570609894124,4317,2816,7133,-
chr8,99887606,1.4181268454521878,6161,4174,10335,-
chr8,99891961,1.418782885292009,5984,3667,9651,-
chr8,99891962,1.3339767054908485,4191,2403,6594,-
chr8,99891963,1.3339767054908485,4191,2403,6594,-
chr8,99893658,0.7365661858038844,1952,1489,3441,-
chr8,99893667,0.2731029301277235,726,604,1330,-
chr8,99893672,0.7852581673779465,1750,1394,3144,-
chr8,99893673,1.5850434782608696,650,574,1224,-
chr8,99893674,0.4461381503930865,1061,876,1937,-
chr8,99893680,0.43174507671302614,690,546,1236,-
chr8,99893681,0.43174507671302614,690,546,1236,-
chr8,100703104,1.3171180151741708,2876,2314,5190,-
chr8,100703306,0.7582014163846182,6844,4942,11786,-
chr8,100703342,0.7131393984799345,1981,1662,3643,-
chr8,100703344,1.0496187529910708,4846,3458,8304,-
chr8,100703356,1.3931779784301401,5130,3719,8849,-
chr8,100704337,1.5122235375913708,1828,1457,3285,-
chr8,100704369,1.59523560319022,1953,1425,3378,-
chr8,100705035,1.6512624191049132,1940,1430,3370,-
chr8,100705054,1.5456799259944496,1415,1149,2564,-
chr8,100705630,1.0985999428364028,3333,2556,5889,-
chr8,100705642,1.866633295194508,1242,911,2153,-
chr8,100705645,1.7444756214276294,2214,1427,3641,-
chr8,100705649,1.8232255263729111,2023,1354,3377,-
chr8,100705650,1.8232255263729111,2023,1354,3377,-
chr8,100705655,2.079400274522225,915,573,1488,-
chr8,100705661,1.1212147897587388,1583,1127,2710,-
chr8,100705662,2.0406568762207917,655,600,1255,-
chr8,100705667,1.4590670789084557,602,518,1120,-
chr8,100706680,2.0631410256410256,784,623,1407,-
chr8,100706791,1.1017793056374814,3324,2462,5786,-
chr8,100706799,1.7220316529062478,1347,1030,2377,-
chr8,100706987,1.2919667741034253,1895,1452,3347,-
chr8,100706989,1.3086939973901697,1586,967,2553,-
chr8,100706994,2.3438687392055266,1323,771,2094,-
chr8,100709188,1.6596140350877187,1630,1139,2769,-
chr8,100709222,0.5910342036025097,1006,809,1815,-
chr8,100709591,1.3504982107089971,5096,3957,9053,-
chr8,100709612,2.0866429765886285,1330,919,2249,-
chr8,100709615,2.150880865166579,1253,818,2071,-
chr8,100709636,1.8382066276803117,735,431,1166,-
chr8,100709637,1.6472363704961326,943,588,1531,-
chr8,100709649,2.1388116308470293,768,564,1332,-
chr8,100709727,1.6032154340836011,1384,932,2316,-
chr8,100712430,1.3291829552333754,2670,1910,4580,-
chr8,100713098,1.4943976307304363,5776,4422,10198,-
chr8,100713099,1.4943976307304363,5776,4422,10198,-
chr8,100717873,1.4893768657172295,2834,2172,5006,-
chr8,100718206,1.579420147579868,4185,3342,7527,-
chr8,100718230,1.3970273863812168,3647,2777,6424,-
chr8,100718245,0.6671892722011338,2878,2242,5120,-
chr8,100721411,1.7476383265856954,1553,1196,2749,-
chr8,100721446,1.6113399623545182,2794,2158,4952,-
chr8,100721447,1.5201308604243466,5214,4116,9330,-
chr8,100721449,1.708845289998679,2722,2087,4809,-
chr8,100721491,4.400592672413794,1187,927,2114,-
chr8,100721494,1.0015074781076916,1555,1372,2927,-
chr8,100721495,1.0015074781076916,1555,1372,2927,-
chr8,100721503,2.534263392857143,840,447,1287,-
chr8,100721530,2.431346153846154,1344,649,1993,-
chr8,100721531,2.431346153846154,1344,649,1993,-
chr8,100721533,1.9329334787350052,708,523,1231,-
chr8,100721542,1.8180137791967736,697,540,1237,-
chr8,100721580,0.933201525208304,1231,1066,2297,-
chr8,100721581,0.933201525208304,1231,1066,2297,-
chr8,100721582,1.2252581220029506,1777,1416,3193,-
chr8,100721584,1.8559299781181624,588,456,1044,-
chr8,100721629,2.0407094172284364,619,454,1073,-
chr8,100721725,1.9773210489014883,629,580,1209,-
chr8,100721757,2.601558903139125,1873,1329,3202,-
chr8,100721758,2.994432846207377,1323,957,2280,-
chr8,100721834,1.8273248289887225,705,600,1305,-
chr8,100721837,1.7615763546798036,744,608,1352,-
chr8,100721840,1.8604352364891996,723,592,1315,-
chr8,100721844,1.6151721206969825,690,542,1232,-
chr8,100721845,1.896875,606,399,1005,-
chr8,100722012,1.5306182613955788,2099,1553,3652,-
chr8,100722032,1.6247557003257331,811,613,1424,-
chr8,100722039,1.959140911471975,679,497,1176,-
chr8,100722061,0.6816211071165822,1314,993,2307,-
chr8,100722062,0.8258803052617486,948,678,1626,-
chr8,100722069,1.2964262508122155,687,341,1028,-
chr8,100722071,1.2964262508122155,687,341,1028,-
chr8,100722077,1.9195854958589003,636,467,1103,-
chr8,100918877,1.8312943410982627,885,662,1547,-
chr8,100918895,2.5018141836173724,733,534,1267,-
chr8,100918967,2.3326205287713844,922,642,1564,-
chr8,100918969,2.3326205287713844,922,642,1564,-
chr8,100919383,1.7249298849679235,1203,862,2065,-
chr8,100919527,1.8040792540792543,672,428,1100,-
chr8,100919790,1.8383838383838385,769,494,1263,-
chr8,100919796,1.892146017699115,932,677,1609,-
chr8,100919819,0.9325312322544008,1050,586,1636,-
chr8,100919820,1.239944214685741,1397,818,2215,-
chr8,100919992,0.9406099518459068,1171,889,2060,-
chr8,100919993,0.9406099518459068,1171,889,2060,-
chr8,100919997,1.6384076856252239,942,592,1534,-
chr8,100920044,1.882407407407408,855,539,1394,-
chr8,100920202,1.6040868454661557,1098,608,1706,-
chr8,100920215,2.2113740959894805,1084,584,1668,-
chr8,100920218,1.5632535885167462,1020,549,1569,-
chr8,100920221,0.5703106654116787,1666,1297,2963,-
chr8,100920401,0.6599131693198264,797,690,1487,-
chr8,100920482,1.4604388297872342,763,511,1274,-
chr8,100920498,1.551056338028169,880,567,1447,-
chr8,100920500,1.8104993597951349,706,425,1131,-
chr8,100920647,1.7894028461444806,1764,1466,3230,-
chr8,100920649,1.87105382693618,1062,951,2013,-
chr8,100920653,2.5665866036992018,1466,937,2403,-
chr8,100920654,2.4072815197924475,1601,1087,2688,-
chr8,100924974,2.1101819970486964,649,534,1183,-
chr8,100948669,2.002652235029255,1118,854,1972,-
chr8,100948740,1.6690652532556425,950,918,1868,-
chr8,100948744,0.5850285769640609,1420,1115,2535,-
chr8,100948745,0.5850285769640609,1420,1115,2535,-
chr8,100948767,3.1399904443382707,635,482,1117,-
chr8,100948783,2.0651858545809567,1158,935,2093,-
chr8,100948784,2.121992481203008,851,664,1515,-
chr8,101199235,0.2471527502684661,786,537,1323,-
chr8,102649084,34.40376430371579,1276,1119,2395,-
chr8,102649085,38.01063300919177,1001,881,1882,-
chr8,102650199,1.7312918562918567,690,454,1144,-
chr8,102827480,26.810598332284684,668,465,1133,-
chr8,102838808,1.1283227724401081,594,447,1041,-
chr8,102838913,1.3979453728007485,702,493,1195,-
chr8,102843560,1.833960113960114,2540,1949,4489,-
chr8,102843562,1.811921125865726,4888,3640,8528,-
chr8,102843563,1.7667902580879682,3594,2624,6218,-
chr8,102843564,1.7667902580879682,3594,2624,6218,-
chr8,102843592,2.180826346095565,770,520,1290,-
chr8,102843600,2.278096330275229,684,435,1119,-
chr8,102843604,2.6224066390041494,631,481,1112,-
chr8,102863846,0.9346056240810876,550,461,1011,-
chr8,102863847,1.3390821968888553,606,455,1061,-
chr8,103401628,2.3728191000918266,815,593,1408,-
chr8,103401630,2.3728191000918266,815,593,1408,-
chr8,105787474,3.4436974789915964,682,509,1191,-
chr8,105787475,6.030603561450008,614,430,1044,-
chr8,106697558,0.6142391810144253,879,613,1492,-
chr8,106697567,1.8165392746788094,1378,945,2323,-
chr8,106697568,1.8165392746788094,1378,945,2323,-
chr8,106697582,2.3855003940110318,687,704,1391,-
chr8,106697693,1.8526690391459082,547,561,1108,-
chr8,106697697,0.5059017367936142,2618,1991,4609,-
chr8,106697698,2.2679963319578174,760,726,1486,-
chr8,106697699,0.777564937552678,1415,1262,2677,-
chr8,106697700,1.6126450127041265,1635,1527,3162,-
chr8,106697704,0.5421291787634747,968,739,1707,-
chr8,108201883,1.4930911349169385,3259,2259,5518,-
chr8,108203056,1.4962432463410682,3537,2090,5627,-
chr8,108203062,1.4334130781499204,2875,1671,4546,-
chr8,108203069,1.3945631773324454,2093,1193,3286,-
chr8,108203070,1.4778644213268979,3910,2694,6604,-
chr8,108203073,1.4219989295137925,3315,1968,5283,-
chr8,108203076,1.4464516568007078,1393,851,2244,-
chr8,108203082,1.9014348097317528,1269,686,1955,-
chr8,108203087,1.5921936383221391,1046,606,1652,-
chr8,108203097,1.0956054433561586,1579,1078,2657,-
chr8,108203099,1.0956054433561586,1579,1078,2657,-
chr8,108203107,1.5860703470766362,618,476,1094,-
chr8,108216434,0.8150270314339144,4293,3427,7720,-
chr8,108216513,0.46539069832393165,756,577,1333,-
chr8,108228277,1.7840935829775793,4824,3770,8594,-
chr8,108228329,1.196622425794352,5079,3727,8806,-
chr8,108229179,1.2932342353440371,5307,3478,8785,-
chr8,108235083,1.0967397265231906,7039,5737,12776,-
chr8,108235084,1.0967397265231906,7039,5737,12776,-
chr8,108235085,1.0967397265231906,7039,5737,12776,-
chr8,108235098,1.4192118226600985,1504,1224,2728,-
chr8,108236170,1.2990356791320377,1772,1392,3164,-
chr8,108236185,1.384766155535586,4290,3133,7423,-
chr8,108240065,1.644508161376496,5322,4133,9455,-
chr8,108241882,1.252470575206266,5328,3316,8644,-
chr8,108248681,1.4173840503574135,9990,7043,17033,-
chr8,108248684,1.5955837811431361,3950,2224,6174,-
chr8,108248688,1.7130747612480155,2460,1851,4311,-
chr8,108248694,1.601980824037899,3172,1681,4853,-
chr8,108248703,1.7068852213142092,5338,2652,7990,-
chr8,108248704,1.6935512129359185,6825,3789,10614,-
chr8,108248709,1.6924019290662662,4745,2186,6931,-
chr8,108248711,1.6924019290662662,4745,2186,6931,-
chr8,108248714,1.1046468228108504,13620,7196,20816,-
chr8,108248715,1.031831440394535,14623,7692,22315,-
chr8,108248716,0.896278697790927,10106,5312,15418,-
chr8,108248717,1.134751227329804,3476,1980,5456,-
chr8,108248722,0.7050971427835302,1138,921,2059,-
chr8,108248723,0.6677526270812456,1330,1049,2379,-
chr8,108248724,0.3170675830469645,518,484,1002,-
chr8,108248728,0.7171679573952223,650,470,1120,-
chr8,109242974,2.3203481735159817,706,437,1143,-
chr8,109243110,0.34886366338013003,675,530,1205,-
chr8,109245365,1.3338978932889092,681,466,1147,-
chr8,109245429,1.00431344356578,634,534,1168,-
chr8,109245430,1.00431344356578,634,534,1168,-
chr8,109289816,1.885385248149164,763,520,1283,-
chr8,109289918,0.3566018752117155,807,586,1393,-
chr8,109296407,2.3777777777777778,748,559,1307,-
chr8,109296408,2.3777777777777778,748,559,1307,-
chr8,109296439,0.40289855072463765,833,674,1507,-
chr8,109296440,0.40289855072463765,833,674,1507,-
chr8,109296533,3.8259168704156483,651,408,1059,-
chr8,109296534,3.8259168704156483,651,408,1059,-
chr8,116645094,1.303125,2501,1919,4420,-
chr8,116645095,0.5366522596206824,1947,1540,3487,-
chr8,116645096,1.4095619523631688,6527,4625,11152,-
chr8,116645097,0.7392109004103746,2119,1620,3739,-
chr8,116645098,1.4815481548154814,6583,4443,11026,-
chr8,116645099,1.5268558209158332,4233,2839,7072,-
chr8,116646555,1.7440206851971556,1367,1070,2437,-
chr8,116648904,1.2748757849833612,7230,5256,12486,-
chr8,116655992,1.3306787788246066,6204,4414,10618,-
chr8,116655999,0.8119547255637093,5473,3840,9313,-
chr8,116656002,1.3102148065427317,3216,2341,5557,-
chr8,116657306,1.6341509657542364,3902,2618,6520,-
chr8,116657309,1.3238179197626745,2823,2323,5146,-
chr8,116658854,1.656286468890117,3103,2411,5514,-
chr8,116658907,1.4403394548647426,5704,3848,9552,-
chr8,116726133,1.7421819190919667,11067,7186,18253,-
chr8,116726142,1.4320762734804908,8844,5468,14312,-
chr8,116726157,0.7063630266656458,9304,5143,14447,-
chr8,116726158,0.8674047809489491,21087,12107,33194,-
chr8,116755678,1.0901332131846337,7967,5153,13120,-
chr8,116755699,0.9179250824295948,4842,3528,8370,-
chr8,116755700,0.9179250824295948,4842,3528,8370,-
chr8,116755702,0.6795372050816696,2642,1823,4465,-
chr8,116755714,1.4853854705021579,4025,2732,6757,-
chr8,116755766,1.4469271684903728,3140,2503,5643,-
chr8,116755800,0.4170640452573917,1294,1138,2432,-
chr8,116755802,1.5155655482531996,761,471,1232,-
chr8,116755806,1.886491108071135,680,679,1359,-
chr8,116755807,1.886491108071135,680,679,1359,-
chr8,116755809,2.0897832817337463,620,390,1010,-
chr8,116755812,1.8066227418955705,1516,897,2413,-
chr8,116755813,1.8066227418955705,1516,897,2413,-
chr8,116755814,1.9458361011598995,2356,1491,3847,-
chr8,116755816,1.1472960397063383,568,508,1076,-
chr8,116755817,0.6989092727888365,765,677,1442,-
chr8,116846295,2.8251121076233185,944,668,1612,-
chr8,116846441,2.8914682539682546,1120,1007,2127,-
chr8,116846484,1.5100962189998643,1012,627,1639,-
chr8,116846499,0.9789010315487428,1914,1222,3136,-
chr8,116846506,1.725327812284334,749,566,1315,-
chr8,116847001,1.631298162418494,1151,722,1873,-
chr8,116847239,1.9194803288314741,1515,1047,2562,-
chr8,116847286,1.7501770322076524,1174,802,1976,-
chr8,116847329,2.2935632183908052,906,724,1630,-
chr8,116847403,0.7115559599636033,1529,1098,2627,-
chr8,116847454,1.5845410628019325,983,620,1603,-
chr8,116847660,1.4814535322458933,1085,748,1833,-
chr8,116848979,1.6137402329352792,1262,968,2230,-
chr8,116850635,2.3317868790879874,17432,13034,30466,-
chr8,116850636,2.25546684725881,25850,19095,44945,-
chr8,116850638,2.2610976619004,25344,18241,43585,-
chr8,116850639,2.2580377850850373,16662,11827,28489,-
chr8,116850696,1.3000582020057307,3190,1744,4934,-
chr8,116850731,1.3938946785944848,2518,1548,4066,-
chr8,116850734,2.026175666290828,3550,2076,5626,-
chr8,116850743,1.4452520788509624,1155,592,1747,-
chr8,116850755,1.868388972243061,1076,687,1763,-
chr8,116852085,2.08225051975052,640,480,1120,-
chr8,116856250,1.5783227848101269,854,631,1485,-
chr8,116856733,1.8236536430834211,1412,946,2358,-
chr8,116856734,1.8236536430834211,1412,946,2358,-
chr8,116857395,1.3974880420174245,11348,7333,18681,-
chr8,116857402,1.4626918026299218,3902,2416,6318,-
chr8,116857405,1.3949027262105602,17753,10539,28292,-
chr8,116857406,1.3599624913270196,23340,15046,38386,-
chr8,116857409,1.6708184858951867,6198,3534,9732,-
chr8,116857410,1.6235043968935305,10907,6202,17109,-
chr8,116857421,1.2952856804427886,4295,2360,6655,-
chr8,116857448,1.1385989419767224,5516,3543,9059,-
chr8,116857456,2.2449624825439956,3485,2198,5683,-
chr8,116857471,1.5087326388888893,2020,1199,3219,-
chr8,116861917,1.6513130427468852,2197,1524,3721,-
chr8,116863146,2.0659540502568907,5595,3702,9297,-
chr8,116863147,2.0659540502568907,5595,3702,9297,-
chr8,116863203,1.4525208032252725,5044,3095,8139,-
chr8,116863218,0.476179220893275,4347,2568,6915,-
chr8,116866602,1.6136313726305045,3009,1854,4863,-
chr8,116866652,2.263719512195122,890,655,1545,-
chr8,116866654,2.038923487544484,2402,1685,4087,-
chr8,116866655,2.038923487544484,2402,1685,4087,-
chr8,116866656,2.038923487544484,2402,1685,4087,-
chr8,116866721,1.379709691054834,1058,702,1760,-
chr8,116866752,2.3328185328185334,635,517,1152,-
chr8,116866753,2.3328185328185334,635,517,1152,-
chr8,116874771,1.1595347990111802,919,779,1698,-
chr8,117799666,12.630804511858559,910,1219,2129,-
chr8,117799667,11.760222452171826,1767,1690,3457,-
chr8,117799668,11.760222452171826,1767,1690,3457,-
chr8,117799669,16.99298510146185,1458,1218,2676,-
chr8,117799678,4.575335721840132,774,295,1069,-
chr8,117799680,3.380630920023062,802,263,1065,-
chr8,119842818,0.6916035353535354,625,395,1020,-
chr8,119842819,0.6916035353535354,625,395,1020,-
chr8,119847014,3.5154066985645933,655,474,1129,-
chr8,119847015,2.305250073722664,1006,784,1790,-
chr8,119853146,1.8815604827392647,837,508,1345,-
chr8,119853151,2.2002002002002,1098,674,1772,-
chr8,119853152,1.6735849056603775,886,635,1521,-
chr8,119853153,2.2002002002002,1098,674,1772,-
chr8,119853161,0.567987567987568,730,494,1224,-
chr8,120414040,1.399065279662295,1623,1385,3008,-
chr8,120414088,0.5980137509549274,823,594,1417,-
chr8,120419892,0.5394715593595111,1550,1018,2568,-
chr8,120419904,2.093788172203188,1377,958,2335,-
chr8,120432088,2.6421606864274576,796,640,1436,-
chr8,120443265,1.795526097763049,1547,1206,2753,-
chr8,120443266,1.795526097763049,1547,1206,2753,-
chr8,120445087,0.5895799967003326,2160,1407,3567,-
chr8,120445095,0.9913875598086124,2071,1253,3324,-
chr8,120445096,0.856560303033904,2691,1738,4429,-
chr8,120445097,0.5915278438838649,955,763,1718,-
chr8,120693798,2.605497466675774,1320,890,2210,-
chr8,120693799,3.1411764705882352,711,439,1150,-
chr8,120693826,0.9117697542170877,1017,644,1661,-
chr8,120693827,0.48061914672216444,738,495,1233,-
chr8,123014105,2.6356609808102345,898,535,1433,-
chr8,123014107,2.5832294394362436,1240,799,2039,-
chr8,123014401,1.7746088334323624,639,373,1012,-
chr8,123014410,2.272227066474801,1158,765,1923,-
chr8,123014411,0.439392346509672,642,463,1105,-
chr8,123014413,2.980657640232109,602,422,1024,-
chr8,123014480,3.3324230010620535,645,506,1151,-
chr8,123014481,3.3324230010620535,645,506,1151,-
chr8,123014711,3.808495174340948,618,475,1093,-
chr8,123022770,0.4335548172757475,1043,773,1816,-
chr8,123022771,1.4566416807088858,1510,1158,2668,-
chr8,123025002,1.7643186306780783,669,433,1102,-
chr8,123030687,1.4850686037126717,1103,884,1987,-
chr8,123030688,1.203214768286813,1642,1225,2867,-
chr8,123030689,1.4850686037126717,1103,884,1987,-
chr8,123030704,3.1119901547116737,570,473,1043,-
chr8,123030705,2.050870804628308,998,774,1772,-
chr8,123041981,0.4977356807959211,660,525,1185,-
chr8,123042114,2.7697382153742103,652,476,1128,-
chr8,123231729,2.7995534879318824,630,482,1112,-
chr8,123231730,2.2410784535270687,556,478,1034,-
chr8,123320609,2.459540425076093,716,608,1324,-
chr8,123320919,2.0842166569598137,616,504,1120,-
chr8,123321050,1.9378698224852071,654,506,1160,-
chr8,123328380,2.793833952897317,1208,868,2076,-
chr8,123328467,1.9916602316602319,2495,1849,4344,-
chr8,123328485,1.5088062856553481,3487,2204,5691,-
chr8,123328511,1.6842348056740863,1216,666,1882,-
chr8,123328516,1.9436298468556528,1192,743,1935,-
chr8,123328555,1.6677536926913483,643,400,1043,-
chr8,123333922,2.2310520361990953,1126,883,2009,-
chr8,123333923,2.2310520361990953,1126,883,2009,-
chr8,123333990,2.450053475935829,1493,1274,2767,-
chr8,123333991,2.450053475935829,1493,1274,2767,-
chr8,123333995,0.5952039352326296,725,475,1200,-
chr8,123334006,1.7484892434131012,628,393,1021,-
chr8,123334247,3.004966887417219,824,603,1427,-
chr8,123334254,2.0788558616811996,1255,933,2188,-
chr8,123336511,2.1411411411411407,681,406,1087,-
chr8,123337773,2.2567287784679086,871,689,1560,-
chr8,123337774,2.2567287784679086,871,689,1560,-
chr8,123346117,3.0741583257506826,698,470,1168,-
chr8,123346118,3.0741583257506826,698,470,1168,-
chr8,123346145,3.0173057346454017,683,420,1103,-
chr8,123346146,3.0173057346454017,683,420,1103,-
chr8,123346731,2.1343050494534097,655,451,1106,-
chr8,123347160,1.5325493482118022,702,558,1260,-
chr8,123348253,1.5334506807471042,686,517,1203,-
chr8,123357608,2.606250634252972,1397,1069,2466,-
chr8,123361554,1.1151196101445784,1417,979,2396,-
chr8,123361577,1.7837905236907732,621,400,1021,-
chr8,123361591,1.958726214659394,992,684,1676,-
chr8,123369157,3.329325712025774,857,599,1456,-
chr8,123369863,2.473783783783784,677,369,1046,-
chr8,123369933,2.795273631840796,660,535,1195,-
chr8,123369935,2.795273631840796,660,535,1195,-
chr8,123380566,1.8000315620760203,1497,1101,2598,-
chr8,123380616,1.8272841051314144,583,469,1052,-
chr8,124312113,13.712692900226568,572,960,1532,-
chr8,124312114,13.506196932589349,914,1496,2410,-
chr8,124312115,15.281560099508575,689,811,1500,-
chr8,124488694,1.6503972743346382,658,507,1165,-
chr8,124508657,1.7318366843468609,2144,1330,3474,-
chr8,124508660,1.4157641467754067,1881,1008,2889,-
chr8,124508667,0.7189581916628747,2510,1492,4002,-
chr8,124508681,2.0079683924540133,3648,2173,5821,-
chr8,124508687,1.5790555555555554,1321,749,2070,-
chr8,124516018,2.95713141025641,670,415,1085,-
chr8,124523001,3.062446919170833,877,481,1358,-
chr8,124539064,2.2579264573976223,1071,676,1747,-
chr8,124539065,2.2579264573976223,1071,676,1747,-
chr8,125024523,4.485913750802434,1130,744,1874,-
chr8,127086581,2.5737731038878264,556,522,1078,-
chr8,127086583,2.6152079417431593,920,718,1638,-
chr8,127086593,2.876588021778584,633,493,1126,-
chr8,127179796,0.4736434108527132,610,515,1125,-
chr8,127179821,2.040137614678899,592,435,1027,-
chr8,127179823,1.8802671281269423,943,784,1727,-
chr8,127205103,3.0769945924922566,721,631,1352,-
chr8,127205266,1.1055464439609635,950,699,1649,-
chr8,127205474,1.073603347883385,861,660,1521,-
chr8,127206345,0.6010733452593917,671,515,1186,-
chr8,127206499,4.768762564382665,2154,1362,3516,-
chr8,127206718,1.3766696229406865,3865,2825,6690,-
chr8,127206720,2.022816303340212,7334,5651,12985,-
chr8,127206721,2.022816303340212,7334,5651,12985,-
chr8,127206725,1.5868241439002861,6499,4698,11197,-
chr8,127206739,1.3717227442080069,5994,4514,10508,-
chr8,127206742,1.6304420041604246,5141,3888,9029,-
chr8,127206745,2.0079035497881565,4474,2860,7334,-
chr8,127206754,1.7470236311337628,4258,2626,6884,-
chr8,127206776,2.163006251047829,1703,970,2673,-
chr8,127206778,2.878048780487805,1997,1106,3103,-
chr8,127206781,1.8730754200859712,1562,852,2414,-
chr8,127206787,1.3116651498643945,7098,4367,11465,-
chr8,127206788,1.3116651498643945,7098,4367,11465,-
chr8,127206792,2.7000568343279343,1838,1172,3010,-
chr8,127206841,1.8377584216601952,1193,732,1925,-
chr8,127206885,3.160676532769556,649,429,1078,-
chr8,127207253,2.1197398921777535,579,555,1134,-
chr8,127207286,2.084261902482829,641,527,1168,-
chr8,127207392,0.924512839191404,922,577,1499,-
chr8,127207393,0.924512839191404,922,577,1499,-
chr8,127207450,1.6976343196082488,793,536,1329,-
chr8,127207474,1.7924324324324328,828,628,1456,-
chr8,127207524,0.5574502276582447,1337,973,2310,-
chr8,127207573,1.8470145991782496,1111,737,1848,-
chr8,127207587,1.6083990689253846,1156,813,1969,-
chr8,127207614,1.9097744360902256,1269,769,2038,-
chr8,127207721,2.08316041500399,1262,1073,2335,-
chr8,127207870,2.0969011313330053,734,534,1268,-
chr8,127207916,0.5581120943952802,730,564,1294,-
chr8,127207965,2.1216931216931214,801,449,1250,-
chr8,127208077,1.7888207822533568,720,570,1290,-
chr8,127208097,1.879223469040774,1146,788,1934,-
chr8,127208098,1.879223469040774,1146,788,1934,-
chr8,127208189,1.7162516382699868,872,762,1634,-
chr8,127208240,1.3391057120703025,941,741,1682,-
chr8,127208289,1.9867809698318173,1264,825,2089,-
chr8,127208290,1.9867809698318173,1264,825,2089,-
chr8,127208335,1.8988294314381269,756,467,1223,-
chr8,127208371,2.369230175560837,1134,790,1924,-
chr8,127208391,1.2203273956766862,1040,627,1667,-
chr8,127208563,1.9184067469389827,943,728,1671,-
chr8,127208715,1.9213649851632049,874,673,1547,-
chr8,127208871,2.0753570583129486,796,550,1346,-
chr8,127208873,2.2507088846880907,634,528,1162,-
chr8,127208883,1.7608517608517609,687,443,1130,-
chr8,127208887,1.1723813664880314,1254,941,2195,-
chr8,127209074,1.0597502877227962,1296,1047,2343,-
chr8,127209077,0.6688130642591609,805,537,1342,-
chr8,127209080,0.4857749469214437,571,470,1041,-
chr8,127209083,2.392747805345334,1068,896,1964,-
chr8,127209230,1.6613333333333336,622,499,1121,-
chr8,127209334,1.713254013612511,1318,1012,2330,-
chr8,127209466,1.816266666666667,972,624,1596,-
chr8,127209495,1.6316496887379741,658,588,1246,-
chr8,127209523,2.5625052087673974,1254,922,2176,-
chr8,127209524,2.5625052087673974,1254,922,2176,-
chr8,127209532,1.215976573245813,962,695,1657,-
chr8,127209553,1.760955580169997,654,437,1091,-
chr8,127209707,1.6982565579014717,684,520,1204,-
chr8,127218878,1.7617442184452494,1192,969,2161,-
chr8,127218930,0.5255144619267643,992,672,1664,-
chr8,127218940,1.4902583979328166,1176,859,2035,-
chr8,127218942,0.672815945716709,834,785,1619,-
chr8,127218943,1.030149923267619,1211,984,2195,-
chr8,127218944,1.030149923267619,1211,984,2195,-
chr8,127218945,1.4752833078101069,668,652,1320,-
chr8,127218983,2.461034482758621,792,434,1226,-
chr8,127218984,2.461034482758621,792,434,1226,-
chr8,127228903,0.9052034661707218,52011,40421,92432,-
chr8,127228961,1.3641875332398923,119948,99247,219195,-
chr8,127228963,1.6055418243139117,128750,105284,234034,-
chr8,127228964,1.4079562080139003,123082,98521,221603,-
chr8,127229095,1.1775711507471778,9571,7868,17439,-
chr8,127229096,0.8979337334323324,11099,7924,19023,-
chr8,127229115,1.3597599148771522,13336,10337,23673,-
chr8,127229117,1.3597599148771522,13336,10337,23673,-
chr8,127229124,1.2913720146532877,11529,8350,19879,-
chr8,127229202,1.3400076234893157,3621,3030,6651,-
chr8,127229229,1.3395298008304672,6879,4687,11566,-
chr8,127229254,1.4786005868095422,1305,1205,2510,-
chr8,127229272,1.0446291965592416,3874,3047,6921,-
chr8,127229273,0.9641583749963166,2453,1668,4121,-
chr8,127229274,1.1630650021523892,1421,1379,2800,-
chr8,127229275,1.4964534547375306,1468,957,2425,-
chr8,127229276,1.5003518648838847,935,608,1543,-
chr8,127229283,0.3938484621155289,909,558,1467,-
chr8,127229287,0.4839325485205218,701,448,1149,-
chr8,127229288,1.0585871404399323,909,590,1499,-
chr8,127229289,1.0585871404399323,909,590,1499,-
chr8,127229290,1.2994600373998577,811,632,1443,-
chr8,129841772,2.5632441505423507,720,548,1268,-
chr8,129841929,1.154174489899967,778,609,1387,-
chr8,129852181,2.288613981145789,1793,1192,2985,-
chr8,129852212,3.333,605,399,1004,-
chr8,129852242,1.979933110367893,776,545,1321,-
chr8,129852264,2.3721328638050823,803,552,1355,-
chr8,129852268,1.7717168109990176,734,486,1220,-
chr8,129855689,3.001412449529897,684,618,1302,-
chr8,129862283,2.173597378557652,719,549,1268,-
chr8,130128071,2.702572366306316,1384,934,2318,-
chr8,130128072,3.3335784313725494,937,679,1616,-
chr8,130128073,2.702572366306316,1384,934,2318,-
chr8,130187277,0.77888599048642,986,930,1916,-
chr8,130187279,0.77888599048642,986,930,1916,-
chr8,133237909,4.948463913620105,578,971,1549,-
chr8,133237910,7.529323889231042,1124,1709,2833,-
chr8,133237911,8.824379332417665,992,1552,2544,-
chr8,133238341,4.027374895455975,827,739,1566,-
chr8,133238342,3.7985591314499043,987,905,1892,-
chr8,133238352,3.8859674049818116,1060,854,1914,-
chr8,133238353,2.8281788631034206,689,556,1245,-
chr8,133238638,1.7082919130303489,709,541,1250,-
chr8,140658631,1.2780454384587445,672,467,1139,-
chr8,143579792,0.6309118541033435,1886,1691,3577,-
chr8,143580087,1.2544422398451016,6369,4224,10593,-
chr8,143580124,1.2473992415852884,3404,2078,5482,-
chr8,143580159,1.4982404692082112,1964,1363,3327,-
chr8,143580160,1.1219139120117425,4079,3003,7082,-
chr8,143580180,1.3352481956105464,2330,1313,3643,-
chr8,143580187,1.5426403198023988,1608,1060,2668,-
chr8,143580555,1.4688002570479892,4561,3086,7647,-
chr8,143580689,1.087792100467404,4642,3840,8482,-
chr8,143580690,1.1248749105110005,5675,4174,9849,-
chr8,143580707,2.0199243492051666,2675,2122,4797,-
chr8,143580717,1.6428276623406688,3554,2266,5820,-
chr8,143580723,0.8563096914022964,5990,3572,9562,-
chr8,143580725,0.7545320202052233,8262,5320,13582,-
chr8,143581096,1.4848360115911483,1306,948,2254,-
chr8,143581126,1.4571350000090235,3558,2265,5823,-
chr8,143581268,0.6186967063502874,2570,1561,4131,-
chr8,143581290,1.844441125324059,2434,1398,3832,-
chr8,143581292,0.6689456092373138,1257,1096,2353,-
chr8,143586288,2.4415164961212232,2310,1226,3536,-
chr8,143586834,1.3237787406180908,2321,1902,4223,-
chr8,143586835,1.7168158571003034,3207,1922,5129,-
chr8,143586837,1.337151248164464,5180,4085,9265,-
chr8,143586838,1.3197810865882194,8141,5835,13976,-
chr8,143586839,1.1770687096365153,7717,5887,13604,-
chr8,143586846,1.4018230158468068,4728,3108,7836,-
chr8,143586847,0.6251008064516129,1377,1119,2496,-
chr8,143586848,1.5851953735542357,2437,1827,4264,-
chr8,143586849,1.5306476846057566,3105,1503,4608,-
chr8,143586850,1.5306476846057566,3105,1503,4608,-
chr8,143586851,1.5306476846057566,3105,1503,4608,-
chr8,143597405,1.9666905374179586,2918,1561,4479,-
chr8,143597407,2.0581220681205474,5349,2543,7892,-
chr8,143597409,1.3309466511006232,5058,2324,7382,-
chr8,143597411,0.702401425522657,2824,1155,3979,-
chr8,143597412,0.5981876598805462,2325,996,3321,-
chr8,143816652,0.6058052434456929,646,533,1179,-
chr8,143816670,0.49822284036470404,805,718,1523,-
chr8,143816697,2.109526722117748,1490,1149,2639,-
chr8,143816721,2.0814883488957476,944,746,1690,-
chr8,143816734,1.8679497882302116,1121,777,1898,-
chr8,143816797,1.945133178566109,1043,719,1762,-
chr8,143816815,1.2367346751099313,658,545,1203,-
chr8,143817362,4.128654970760233,705,341,1046,-
chr8,143817364,4.128654970760233,705,341,1046,-
chr8,143817413,1.7294982787723165,796,452,1248,-
chr8,143817415,1.5210366173538978,762,352,1114,-
chr8,143817757,1.4613415621274697,761,543,1304,-
chr8,143817773,1.3024877679914646,977,652,1629,-
chr8,143817974,1.7053484150258347,1135,681,1816,-
chr8,143817977,1.5688073394495414,1106,653,1759,-
chr8,143817992,1.3690696812453667,984,567,1551,-
chr8,143818503,2.577956989247312,547,495,1042,-
chr8,143818505,2.707526117492415,758,649,1407,-
chr8,143821682,1.24691257884991,1255,773,2028,-
chr8,143821683,1.13074645925238,998,583,1581,-
chr8,143824333,3.1636541100665627,812,902,1714,-
chr8,143824334,3.319792692366321,1067,1051,2118,-
chr8,143919160,2.435660736094636,1791,1307,3098,-
chr8,143919162,2.4123503102005484,879,716,1595,-
chr8,143919181,1.8709532579274066,687,508,1195,-
chr8,143919190,0.8176838478734414,811,527,1338,-
chr8,143919192,1.5481171548117154,739,477,1216,-
chr8,143932412,5.300168067226892,583,424,1007,-
chr8,143932414,2.7718151815181518,856,605,1461,-
chr8,144262292,2.4463734567901234,745,575,1320,-
chr8,144262305,1.806568966754026,1752,1200,2952,-
chr8,144262307,1.923302967969439,1154,746,1900,-
chr8,144262408,1.193312693498452,583,424,1007,-
chr8,144262409,1.193312693498452,583,424,1007,-
chr8,144393512,1.7571330671368488,988,897,1885,-
chr8,144430507,2.2014093629831084,781,523,1304,-
chr8,144453409,1.675527950310559,561,482,1043,-
chr8,144453416,0.6319444444444444,584,431,1015,-
chr8,144453440,2.919035235845381,630,414,1044,-
chr8,144789896,1.2320324162934526,11553,6695,18248,-
chr8,144789964,6.905495492045838,803,610,1413,-
chr8,144790430,1.1968610323130005,29311,22362,51673,-
chr8,144790447,0.8386379256650093,8139,6421,14560,-
chr8,144790448,1.4318355323479492,6816,5041,11857,-
chr8,144791345,1.405914940674299,8663,6775,15438,-
chr8,144791445,1.4123859515472275,7708,5906,13614,-
chr8,144791459,1.1869961446722972,9952,5991,15943,-
chr8,144791485,1.00787381608785,19261,14788,34049,-
chr8,144791486,0.7687526725216736,12941,10546,23487,-
chr8,144791843,1.2268242307706263,16049,12642,28691,-
chr8,144791847,1.295442080915554,13203,10452,23655,-
chr8,144791854,1.2160989769041946,5800,4555,10355,-
chr8,144791907,1.0222478326487852,13101,7758,20859,-
chr8,144791909,1.1574289177277024,31564,23128,54692,-
chr8,144791910,1.3589047523585835,12634,10108,22742,-
chr8,144791912,1.1815305985142124,12735,10436,23171,-
chr8,144791914,1.1656780395144086,8485,7051,15536,-
chr8,144792010,1.3294504177543285,9933,8131,18064,-
chr8,144792031,1.518438289751921,21456,11867,33323,-
chr8,144792032,1.518438289751921,21456,11867,33323,-
chr8,144792033,1.506291914243387,26730,15972,42702,-
chr8,144792068,0.8094652350672366,5032,3800,8832,-
chr8,144792104,1.3862091721928662,5449,3861,9310,-
chr8,144792118,1.5094864105241428,24263,16423,40686,-
chr8,144792141,1.2050072946461754,758,670,1428,-
chr8,144792385,0.8661138140169745,10650,6519,17169,-
chr8,144792388,0.9212708728945526,21665,14549,36214,-
chr8,144792389,0.9858121891106998,13488,9681,23169,-
chr8,144792390,0.8978549177305215,5523,3874,9397,-
chr8,144792391,1.3088167596619305,7595,5432,13027,-
chr8,144792394,1.5123135731294648,1556,807,2363,-
chr8,144792396,0.5712151967356538,2131,1394,3525,-
chr8,144792415,1.2951828205093068,3059,1840,4899,-
chr8,144792418,0.8335520070180539,5642,3245,8887,-
chr8,144792419,0.6908020825230726,5121,2876,7997,-
chr8,144792420,0.7114715879921316,4092,2247,6339,-
chr9,2811408,1.9592592765659096,644,612,1256,-
chr9,2811418,2.206697493336474,936,826,1762,-
chr9,2812274,3.387507009083772,1735,1204,2939,-
chr9,2812275,2.7330283360390477,2971,1899,4870,-
chr9,2812280,1.52971485028089,2162,1262,3424,-
chr9,2812293,0.6283539590406308,674,396,1070,-
chr9,2812332,2.707390757689772,959,497,1456,-
chr9,2812343,1.9132275132275132,677,404,1081,-
chr9,2812352,2.5916713827579705,917,571,1488,-
chr9,2823794,1.4251525054629137,749,523,1272,-
chr9,2827137,2.6017069793549457,723,524,1247,-
chr9,2827148,0.9971915043005092,597,421,1018,-
chr9,2827150,0.9971915043005092,597,421,1018,-
chr9,4712241,3.23895719014115,834,455,1289,-
chr9,4712502,3.063815939308741,698,444,1142,-
chr9,4712503,3.160572167690859,783,474,1257,-
chr9,4712777,2.0604612450271196,769,492,1261,-
chr9,4719296,1.6938381301912304,947,667,1614,-
chr9,4719299,0.41341069330199753,865,591,1456,-
chr9,4719305,1.1912753141088501,1133,820,1953,-
chr9,6748770,1.4414895764639384,1390,1108,2498,-
chr9,6748771,1.4101163537261894,2093,1590,3683,-
chr9,6748775,0.6319909844496142,1690,1106,2796,-
chr9,6748777,0.5588035931860748,1805,1135,2940,-
chr9,6748781,0.5878312412831241,732,477,1209,-
chr9,6748782,0.789356184079492,882,605,1487,-
chr9,7477496,1.1814660590169954,204339,159966,364305,-
chr9,7477497,1.1721721826013554,357685,273500,631185,-
chr9,7477499,1.184331113937586,317030,247830,564860,-
chr9,7477500,1.070697763525772,405366,298952,704318,-
chr9,7477501,1.1134229056982274,355329,269993,625322,-
chr9,7477502,0.9459052763694062,411941,283019,694960,-
chr9,7477503,1.0218440783670053,412398,300174,712572,-
chr9,7477504,0.9848377899223731,413397,298241,711638,-
chr9,7477505,1.221098247288425,148092,117422,265514,-
chr9,7477506,1.0360936197405957,222375,167355,389730,-
chr9,7477507,1.0362504239365873,190069,141798,331867,-
chr9,7477508,1.1349392976277024,100359,77073,177432,-
chr9,7477510,1.0524863137806517,67731,50832,118563,-
chr9,7477512,0.8691531564489196,80572,59175,139747,-
chr9,7477513,0.9948945990405819,87967,66111,154078,-
chr9,7477514,0.9914041746172078,147420,109584,257004,-
chr9,7477515,1.1126536506490925,157558,117569,275127,-
chr9,7477517,0.987467101127422,97143,71586,168729,-
chr9,7477518,0.8796188719407175,118694,88811,207505,-
chr9,7477519,0.8332143097580931,85561,64969,150530,-
chr9,7477520,0.8285862597689603,73482,56561,130043,-
chr9,7477521,0.8285496672888536,44508,36308,80816,-
chr9,7477522,0.8358272945937724,32008,26619,58627,-
chr9,7477523,0.9729906367168262,48779,40011,88790,-
chr9,7477524,1.1163615496519643,23560,17821,41381,-
chr9,7477525,1.0677496219369815,47233,36426,83659,-
chr9,7477526,1.1285980547943102,20289,15059,35348,-
chr9,7477527,1.0963763583416992,24259,17280,41539,-
chr9,7477529,0.9909179043369448,9378,6499,15877,-
chr9,7477778,0.7799596294187672,2483,2084,4567,-
chr9,7477779,1.2322681651145295,7971,5760,13731,-
chr9,7477780,0.886793372319688,1760,1538,3298,-
chr9,7477781,1.202524823439142,18674,12927,31601,-
chr9,7477782,1.2119277427727475,17366,11566,28932,-
chr9,7477783,1.0331066464740528,7980,4951,12931,-
chr9,7477784,1.1187425353211422,13366,8201,21567,-
chr9,7477785,0.9880854810374073,8803,5407,14210,-
chr9,7477786,1.076825241013456,6795,3960,10755,-
chr9,7477788,0.9133631682192054,970,777,1747,-
chr9,7798429,0.6026420293378718,675,456,1131,-
chr9,7798552,0.5481818181818181,602,499,1101,-
chr9,7799531,6.969826847381191,742,550,1292,-
chr9,7799540,3.587430621972366,891,424,1315,-
chr9,7799544,21.159174610669975,1036,424,1460,-
chr9,7799545,15.28742485983469,1181,399,1580,-
chr9,7799547,35.70657276995305,1112,212,1324,-
chr9,7799548,24.715678385876195,1200,267,1467,-
chr9,7799549,24.715678385876195,1200,267,1467,-
chr9,7799552,21.08169004085541,861,190,1051,-
chr9,12972939,0.7779634556971647,1766,1492,3258,-
chr9,12972940,0.41620710784313725,835,511,1346,-
chr9,12972964,1.6285714285714288,626,692,1318,-
chr9,12972965,1.2759016159927383,1123,1012,2135,-
chr9,12972974,0.5187590711175617,492,529,1021,-
chr9,12972976,0.5065020961830834,1110,1083,2193,-
chr9,14921818,1.5637000225886606,709,465,1174,-
chr9,14921863,1.7348484848484849,686,527,1213,-
chr9,14921924,0.7050635386119257,2253,1704,3957,-
chr9,14921927,1.76381299332119,2099,1619,3718,-
chr9,14921929,1.5925027626688095,1320,1180,2500,-
chr9,14921931,1.6496970253396992,2177,1555,3732,-
chr9,14921932,0.7125898246622593,1906,1419,3325,-
chr9,14921933,0.5963744944982602,1690,1301,2991,-
chr9,14921939,0.6693362917854366,2709,2175,4884,-
chr9,14921940,0.8791330514796446,3585,2900,6485,-
chr9,14921942,0.5952733947544918,1162,851,2013,-
chr9,14921952,1.3465909090909092,789,659,1448,-
chr9,14922165,1.6751269035532996,983,787,1770,-
chr9,14922213,1.119933424465485,4247,3014,7261,-
chr9,14922214,0.9725984312255115,3933,3094,7027,-
chr9,14922216,0.7815792881782968,1206,1081,2287,-
chr9,15464472,4.364023313431843,602,517,1119,-
chr9,15468726,1.8900078816008408,653,600,1253,-
chr9,15472731,1.4465601972196431,4830,3053,7883,-
chr9,15472733,1.6074428364604032,2562,1536,4098,-
chr9,15472746,1.6054216867469877,983,746,1729,-
chr9,15472747,0.5892746049520965,887,512,1399,-
chr9,15474020,2.285862863085952,904,640,1544,-
chr9,15474021,1.6734931009440814,822,458,1280,-
chr9,15474180,6.1294843049327365,809,445,1254,-
chr9,15474181,6.1294843049327365,809,445,1254,-
chr9,19102600,1.1953061246997347,2361,1590,3951,-
chr9,19102601,1.4967370698036164,1746,1183,2929,-
chr9,19102602,0.3314203730272597,615,407,1022,-
chr9,19102615,1.8701340655790661,826,452,1278,-
chr9,19102616,1.8701340655790661,826,452,1278,-
chr9,19200434,0.8049883747189148,1371,1185,2556,-
chr9,19200435,0.8016389532506473,668,695,1363,-
chr9,19200587,0.7951509994154113,2111,1504,3615,-
chr9,19200588,0.7560011028338511,2987,2321,5308,-
chr9,19200589,0.7933509932360373,1988,1594,3582,-
chr9,19200913,1.5399427626941626,4744,3223,7967,-
chr9,19200914,1.5399427626941626,4744,3223,7967,-
chr9,19200917,1.103654257851803,3487,2344,5831,-
chr9,19200918,1.1034624410732041,2300,1384,3684,-
chr9,19200919,1.0865260513804083,4468,2847,7315,-
chr9,19376309,1.410498486676733,108516,110500,219016,-
chr9,19376322,1.3874077830228408,26228,24950,51178,-
chr9,19376362,1.3482054128889556,81442,68123,149565,-
chr9,19376364,1.1408065988122351,23919,17724,41643,-
chr9,19376365,1.382394446205086,20549,17064,37613,-
chr9,19376607,1.5230935172231366,12918,10080,22998,-
chr9,19376623,1.3894880760427646,19774,14430,34204,-
chr9,19376624,1.1723214316052002,47263,32644,79907,-
chr9,19376631,1.5307752684615052,16382,11142,27524,-
chr9,19376632,1.4728908297978023,28167,17835,46002,-
chr9,19376639,1.782897305739945,6848,4484,11332,-
chr9,19376647,1.361343157790717,27329,15732,43061,-
chr9,19376648,1.361343157790717,27329,15732,43061,-
chr9,19378775,0.8960369552305629,20493,14970,35463,-
chr9,19378782,1.2340121706055125,31694,21336,53030,-
chr9,19378783,1.3107634759450697,18009,12859,30868,-
chr9,19378786,0.8416990007849579,13721,10685,24406,-
chr9,19378853,1.358461972509715,16585,10615,27200,-
chr9,19378869,1.27872282375685,9087,7009,16096,-
chr9,19378913,1.207908236785982,7749,5782,13531,-
chr9,19379541,1.9521083194570328,15944,12938,28882,-
chr9,19379544,1.8712550994390622,15249,11839,27088,-
chr9,19379583,1.5155517203594129,11770,6551,18321,-
chr9,19379586,1.1913493514055307,31116,21021,52137,-
chr9,19379607,1.3904051279640994,15948,9669,25617,-
chr9,19379616,1.5113947532995866,11200,5891,17091,-
chr9,19380232,1.224548595802539,20722,10636,31358,-
chr9,19380233,0.611392317638009,19078,8369,27447,-
chr9,19380235,0.7338601280819858,34962,22136,57098,-
chr9,19380236,0.8360823493953948,17992,14360,32352,-
chr9,19380238,0.9499071445412294,4503,4202,8705,-
chr9,21968143,1.7080051930689686,3759,2732,6491,-
chr9,21968227,1.3584954013496968,1766,1210,2976,-
chr9,21968230,2.0396354604979576,1628,1132,2760,-
chr9,21968239,0.5091354178257483,1115,945,2060,-
chr9,21970921,1.6872768581629343,842,710,1552,-
chr9,21970923,1.7285176194860634,1306,918,2224,-
chr9,21970924,0.6335336517484715,1649,1576,3225,-
chr9,21970925,0.6335336517484715,1649,1576,3225,-
chr9,21970933,1.911045943304008,1019,681,1700,-
chr9,21970936,1.7510096930533117,666,618,1284,-
chr9,21970946,1.6815183666070723,1505,1120,2625,-
chr9,21971022,2.1780038303906633,971,632,1603,-
chr9,21974702,1.2752148211347432,929,537,1466,-
chr9,21974704,1.076314995782803,1148,790,1938,-
chr9,21974738,3.2893947443123106,1272,993,2265,-
chr9,21974808,7.952313223096526,1400,1387,2787,-
chr9,21974809,7.321672637385788,2256,1943,4199,-
chr9,21974810,7.180121647828666,2031,1789,3820,-
chr9,21974832,2.3754646840148697,638,537,1175,-
chr9,21974833,4.466175652994822,1861,1314,3175,-
chr9,21974834,4.466175652994822,1861,1314,3175,-
chr9,21994179,0.5408196305273547,711,497,1208,-
chr9,26841602,0.4419642857142857,560,447,1007,-
chr9,26841603,0.4419642857142857,560,447,1007,-
chr9,32553915,1.5441933582236198,1033,726,1759,-
chr9,32571023,1.8309580726289023,1235,762,1997,-
chr9,32571037,1.7420212765957446,654,375,1029,-
chr9,32572930,2.4058164509200672,920,748,1668,-
chr9,32572932,1.4687363009604273,1364,1090,2454,-
chr9,32572933,1.1879582111436948,893,703,1596,-
chr9,32573037,3.848688353865593,662,544,1206,-
chr9,33110750,1.7684691546077682,773,706,1479,-
chr9,33110776,2.1423728813559317,631,589,1220,-
chr9,33110974,0.9025467602043197,3891,3715,7606,-
chr9,33110975,0.7518755189959905,5339,4699,10038,-
chr9,33110976,0.7284537445619135,6060,5420,11480,-
chr9,33110977,0.5911919404646279,4103,3769,7872,-
chr9,33110978,0.5972073390987619,2304,2245,4549,-
chr9,33110982,0.9322708773258224,1903,2049,3952,-
chr9,33110983,0.5093555093555093,1224,1364,2588,-
chr9,33111022,1.8089802039044343,1853,1841,3694,-
chr9,33111041,9.675205997311597,3437,3101,6538,-
chr9,33111042,9.852791684636857,2848,2589,5437,-
chr9,33111050,4.384833376558646,1003,675,1678,-
chr9,33111125,1.8035865326822795,1256,893,2149,-
chr9,33111197,1.0292849830271027,1414,1107,2521,-
chr9,33111198,0.5238063835399631,610,445,1055,-
chr9,33111199,1.0292849830271027,1414,1107,2521,-
chr9,33111522,0.4511775362318841,878,719,1597,-
chr9,33111585,1.4375894874160806,778,592,1370,-
chr9,33111602,3.1493212669683257,695,492,1187,-
chr9,33111616,2.1610054075174334,1147,728,1875,-
chr9,33111718,1.3463171370588571,700,547,1247,-
chr9,33111728,2.085366208852752,754,509,1263,-
chr9,33111868,1.5686856738012658,761,573,1334,-
chr9,33111969,0.5224032586558045,809,490,1299,-
chr9,33112006,0.6302435031716801,769,542,1311,-
chr9,33112496,2.0489713774597496,832,558,1390,-
chr9,33112508,2.099726775956284,635,548,1183,-
chr9,33112691,1.858653311074012,1001,598,1599,-
chr9,33112839,2.4242133077107857,840,542,1382,-
chr9,33112949,1.566818205952803,817,529,1346,-
chr9,33113137,0.6916402116402116,945,944,1889,-
chr9,33113142,1.6274047899489594,828,848,1676,-
chr9,33113152,3.2402266288951838,816,705,1521,-
chr9,33113157,2.50231124807396,811,648,1459,-
chr9,33113190,1.560609443018194,716,577,1293,-
chr9,33113241,1.7714199772307084,1580,1120,2700,-
chr9,33113290,1.7598343685300204,679,551,1230,-
chr9,33113367,1.9348437500000002,1217,959,2176,-
chr9,33113368,1.9348437500000002,1217,959,2176,-
chr9,33113385,1.6647133757961785,593,470,1063,-
chr9,33113423,1.2367855910421093,1395,922,2317,-
chr9,33113426,0.9851673427991886,1226,815,2041,-
chr9,33113427,0.9851673427991886,1226,815,2041,-
chr9,33113796,1.0395122412326308,1570,1191,2761,-
chr9,33113798,1.0860618937881792,2899,2282,5181,-
chr9,33113855,1.7363851617995265,659,542,1201,-
chr9,33116034,1.9283482937245442,1317,1330,2647,-
chr9,33116065,1.547804054054054,1121,959,2080,-
chr9,33116104,2.1616915422885574,868,602,1470,-
chr9,33120451,4.237628613424793,960,627,1587,-
chr9,33120484,0.6385630498533724,870,681,1551,-
chr9,33120555,1.8382461311717024,1662,1179,2841,-
chr9,33120556,1.8382461311717024,1662,1179,2841,-
chr9,33120593,0.6201523545706371,596,455,1051,-
chr9,33135247,0.6258922198429693,1402,933,2335,-
chr9,33135249,1.452204665423947,1262,940,2202,-
chr9,33135255,1.7088285229202038,791,495,1286,-
chr9,33166771,2.3800383877159312,619,520,1139,-
chr9,33166772,2.3800383877159312,619,520,1139,-
chr9,33166835,2.0187403504846007,851,601,1452,-
chr9,33255109,1.6782628676470588,986,679,1665,-
chr9,33255151,0.6438152011922503,863,670,1533,-
chr9,33255186,1.521597183515973,2123,1588,3711,-
chr9,33255187,0.5913604766633564,793,635,1428,-
chr9,33255207,1.2675793784945266,2963,2305,5268,-
chr9,33255208,1.086687898089172,1814,1569,3383,-
chr9,33255209,1.531738437001595,685,569,1254,-
chr9,33255875,0.3873066767257638,1368,963,2331,-
chr9,33255876,2.119035907525824,717,534,1251,-
chr9,33256873,1.824014425340639,5670,4153,9823,-
chr9,33256902,1.4791165896250642,5267,2949,8216,-
chr9,33256905,1.6003216316924884,9456,5098,14554,-
chr9,33256906,1.6003216316924884,9456,5098,14554,-
chr9,33258943,1.2965920146224976,2964,1681,4645,-
chr9,33258946,0.6400958930502108,6397,3436,9833,-
chr9,33258947,1.7266604094037723,6747,4519,11266,-
chr9,33258971,1.4630738917229218,10972,6285,17257,-
chr9,33258972,1.4630738917229218,10972,6285,17257,-
chr9,33258974,1.4285690961337514,1482,1055,2537,-
chr9,33261153,1.4044824260964983,1481,985,2466,-
chr9,33261166,1.5111126261248975,1208,771,1979,-
chr9,33262821,1.8375,587,447,1034,-
chr9,33262823,0.6572200988160717,704,630,1334,-
chr9,33262826,1.38183540295952,1262,895,2157,-
chr9,33262827,0.7627401841440479,1680,1071,2751,-
chr9,33264261,1.8996174882914052,1116,706,1822,-
chr9,33264421,2.506290668132607,875,655,1530,-
chr9,33441248,1.6875079425594104,812,548,1360,-
chr9,33441377,0.6067266736317608,718,540,1258,-
chr9,33441405,0.5225460345077569,635,626,1261,-
chr9,33441442,23.25106329052981,4107,3729,7836,-
chr9,33441443,17.453517926644775,5471,4406,9877,-
chr9,33441444,17.453517926644775,5471,4406,9877,-
chr9,33441445,19.145344142584317,4099,2996,7095,-
chr9,33441448,10.357662867949161,1820,647,2467,-
chr9,33441450,12.727272727272727,1743,435,2178,-
chr9,33441451,12.152731953777023,2267,637,2904,-
chr9,33441452,15.786563805850205,1753,365,2118,-
chr9,33441454,23.812740424420756,2427,379,2806,-
chr9,33441455,13.963186077643908,1813,248,2061,-
chr9,33441456,18.937976344120216,3958,600,4558,-
chr9,33441457,17.08123030399852,4782,778,5560,-
chr9,33441458,15.652963639497212,4702,716,5418,-
chr9,33441459,19.078926343878603,2926,530,3456,-
chr9,33441460,12.652531158906708,3790,502,4292,-
chr9,33441461,11.149270956835647,4112,539,4651,-
chr9,33441462,11.976718799130376,2343,240,2583,-
chr9,33441464,6.188932644768729,1464,157,1621,-
chr9,33441598,0.6003430531732419,545,582,1127,-
chr9,33441613,0.5069602755008004,870,777,1647,-
chr9,33441615,0.4555892013513445,1075,1003,2078,-
chr9,33441633,3.1059867071379577,821,1035,1856,-
chr9,33441634,3.157924003707136,630,829,1459,-
chr9,33441651,3.287832682672847,587,665,1252,-
chr9,33441680,6.63966745192654,941,1013,1954,-
chr9,33441694,0.4120805848928509,615,592,1207,-
chr9,33441697,0.39267660664266135,602,704,1306,-
chr9,33441698,0.3827330907265655,487,612,1099,-
chr9,33441699,0.320191906549854,613,798,1411,-
chr9,33441703,5.7069960959427535,1122,1072,2194,-
chr9,33441704,10.107958506725776,996,886,1882,-
chr9,33441705,10.107958506725776,996,886,1882,-
chr9,33442136,1.7666671001525873,646,386,1032,-
chr9,33442142,1.4137526557169413,648,388,1036,-
chr9,33442998,0.49105275877023136,854,1235,2089,-
chr9,33443023,3.8606858922188887,1033,1360,2393,-
chr9,33443037,53.793727614393106,2556,1671,4227,-
chr9,33443038,53.15740349242992,2824,1711,4535,-
chr9,33443039,60.04237298907101,1996,1365,3361,-
chr9,34087254,3.7604227769063403,568,435,1003,-
chr9,34087255,3.7604227769063403,568,435,1003,-
chr9,34224123,0.39461394769613933,779,583,1362,-
chr9,34224124,1.6324038636777842,688,707,1395,-
chr9,34224133,0.6251162790697674,607,474,1081,-
chr9,34224136,0.5089430894308944,938,614,1552,-
chr9,34224137,1.7667645198734658,916,804,1720,-
chr9,34224139,0.6731572185643167,620,478,1098,-
chr9,34224140,1.2839954163483576,580,475,1055,-
chr9,34224141,1.0839214621787912,740,613,1353,-
chr9,34224142,0.7368633735012289,632,479,1111,-
chr9,34224143,0.6124228266310695,553,460,1013,-
chr9,34634801,2.2325091388110496,832,705,1537,-
chr9,34634803,2.445761349939735,486,523,1009,-
chr9,34635182,3.5144942552182306,1129,789,1918,-
chr9,34635240,3.420732177114921,2128,1481,3609,-
chr9,34635241,3.2281357882623705,686,473,1159,-
chr9,34635391,1.874405154801353,1077,739,1816,-
chr9,34635550,2.5549450549450547,774,454,1228,-
chr9,34637058,2.6845520734409627,626,544,1170,-
chr9,34637319,1.5717957840601482,663,402,1065,-
chr9,35059193,3.5874999999999995,860,434,1294,-
chr9,35059195,3.038005252533629,1321,819,2140,-
chr9,35059676,0.9513980480084409,686,445,1131,-
chr9,35059678,0.9513980480084409,686,445,1131,-
chr9,35060327,2.2669789227166275,725,426,1151,-
chr9,35060328,2.359275903204575,910,578,1488,-
chr9,35061614,1.5015682250938198,636,459,1095,-
chr9,35063037,2.090787716955941,809,534,1343,-
chr9,35063039,2.090787716955941,809,534,1343,-
chr9,35074482,1.5672271418977777,1892,1295,3187,-
chr9,35074487,1.7066200058326042,835,507,1342,-
chr9,35074492,1.8667251054069534,1881,1222,3103,-
chr9,35100079,3.3819501875240308,564,453,1017,-
chr9,35100964,3.802269655444709,720,508,1228,-
chr9,35101946,1.3609214498152005,1624,1128,2752,-
chr9,35102135,1.9050104384133613,729,478,1207,-
chr9,35102189,2.012516420483252,661,523,1184,-
chr9,35657812,1.4457113855523602,1525,1284,2809,-
chr9,35657825,1.897163120567376,1069,563,1632,-
chr9,35657826,1.994736842105263,1515,759,2274,-
chr9,35657828,1.9671500875997665,973,466,1439,-
chr9,35684263,2.23370786516854,851,533,1384,-
chr9,35684758,1.0803090082819673,1120,903,2023,-
chr9,35684759,0.81870781099325,848,670,1518,-
chr9,35685079,1.7478947368421052,614,474,1088,-
chr9,35685507,0.5842176388758762,1254,888,2142,-
chr9,35689179,1.831262939958592,670,461,1131,-
chr9,35689803,0.37169430145876947,604,513,1117,-
chr9,35689829,0.9069558795058265,624,484,1108,-
chr9,35972062,1.9836349160393747,2468,1255,3723,-
chr9,35972063,1.9836349160393747,2468,1255,3723,-
chr9,35972093,1.6559988518943742,1048,535,1583,-
chr9,35972096,1.25796676089814,1321,788,2109,-
chr9,35972128,0.3421588594704684,615,490,1105,-
chr9,35972129,0.3421588594704684,615,490,1105,-
chr9,36233974,1.7887640449438205,795,444,1239,-
chr9,36233980,1.3732870970903144,733,477,1210,-
chr9,37588548,1.6012534273403842,1021,827,1848,-
chr9,37588603,2.4545170365739293,603,456,1059,-
chr9,37588817,2.0166776387974545,918,650,1568,-
chr9,37588826,3.5200522069292832,898,601,1499,-
chr9,37588879,1.6682735670077442,1191,868,2059,-
chr9,37588914,1.890577308484059,1562,1122,2684,-
chr9,37588919,0.6612616877737011,754,594,1348,-
chr9,37588926,0.5128424657534246,598,510,1108,-
chr9,37592455,0.690790040492806,843,635,1478,-
chr9,37592484,1.7033604366861885,1032,817,1849,-
chr9,37592486,1.7033604366861885,1032,817,1849,-
chr9,37592547,2.544230769230769,881,467,1348,-
chr9,37592548,2.544230769230769,881,467,1348,-
chr9,37780817,1.0414561718241133,710,535,1245,-
chr9,37974789,1.9234039899019266,1712,1250,2962,-
chr9,37974790,1.9234039899019266,1712,1250,2962,-
chr9,37974791,2.35543369890329,1349,1002,2351,-
chr9,37974797,2.8829215896885065,731,440,1171,-
chr9,37974799,2.886885929352242,1016,620,1636,-
chr9,69713000,1.861997081509277,637,532,1169,-
chr9,69713002,1.5449627313567784,1235,933,2168,-
chr9,69714625,2.2826086956521743,783,551,1334,-
chr9,69714626,1.9748195554923997,1511,931,2442,-
chr9,70384898,0.3697869498333076,820,515,1335,-
chr9,70386139,0.47966249759507573,770,555,1325,-
chr9,70387392,0.4008432992563796,860,1064,1924,-
chr9,70387419,4.107554946755493,516,738,1254,-
chr9,70387714,1.3249372673113842,1199,849,2048,-
chr9,70387715,0.9833333333333332,825,584,1409,-
chr9,70387716,0.9833333333333332,825,584,1409,-
chr9,71683733,1.6208551483420592,742,572,1314,-
chr9,71683820,0.47169462422401276,1151,1129,2280,-
chr9,71683821,0.47169462422401276,1151,1129,2280,-
chr9,71683861,5.048507358921668,1340,1637,2977,-
chr9,71683862,5.762593675005314,1942,2341,4283,-
chr9,71683865,28.224051765887463,2412,1608,4020,-
chr9,71683866,28.22405176588746,2412,1608,4020,-
chr9,71683931,0.9607743076818398,910,638,1548,-
chr9,71683932,1.3452697252815322,1079,731,1810,-
chr9,71684127,2.584257206208426,517,491,1008,-
chr9,71684198,1.634354571177676,858,553,1411,-
chr9,71684431,2.51779593257723,875,662,1537,-
chr9,71684859,0.3317422434367542,833,837,1670,-
chr9,71684861,0.28554947559272736,1082,1128,2210,-
chr9,71684867,18.38857700756651,1083,963,2046,-
chr9,71684868,23.661581981741662,3652,3209,6861,-
chr9,71684869,24.965500798767483,3891,3251,7142,-
chr9,71684870,26.014525127886934,3528,2882,6410,-
chr9,71684871,33.641148325358856,711,303,1014,-
chr9,71684873,13.326640560350949,1382,307,1689,-
chr9,71684874,14.087719298245617,1021,227,1248,-
chr9,71684875,13.178705229527496,1284,281,1565,-
chr9,71698142,2.1373352855051246,810,682,1492,-
chr9,71698171,3.0235431235431234,762,571,1333,-
chr9,71700722,0.9356535589906729,1192,800,1992,-
chr9,71718057,0.5385980479148181,606,440,1046,-
chr9,71722485,1.9314064451064323,1114,826,1940,-
chr9,71725612,2.7347726873793223,778,632,1410,-
chr9,71725613,2.7347726873793223,778,632,1410,-
chr9,71725615,0.5084606986899564,620,457,1077,-
chr9,71730783,3.4282022627578,599,436,1035,-
chr9,71730828,2.4379044684129436,878,589,1467,-
chr9,71730830,2.4379044684129436,878,589,1467,-
chr9,71732492,1.206175881913624,783,578,1361,-
chr9,71740205,2.0529980942427812,982,690,1672,-
chr9,71740206,2.5636424061149885,797,530,1327,-
chr9,71740217,2.5657684178743962,698,452,1150,-
chr9,71745045,0.6944067541082467,657,602,1259,-
chr9,71745093,1.8992971827109633,1082,745,1827,-
chr9,71745095,1.0416585932958728,671,396,1067,-
chr9,72354689,1.7849787711678295,1015,660,1675,-
chr9,72354994,2.1282729436656966,618,397,1015,-
chr9,72355547,1.162419564334,1250,910,2160,-
chr9,72355590,2.486544517606642,598,498,1096,-
chr9,72355676,2.360341151385928,573,468,1041,-
chr9,72356067,2.7220266040688577,604,425,1029,-
chr9,72356947,2.356189631743043,971,778,1749,-
chr9,72357017,0.545676429567643,625,477,1102,-
chr9,76385692,2.686040195545899,644,525,1169,-
chr9,76385698,3.3975460122699386,638,488,1126,-
chr9,76385961,1.519558859371192,977,745,1722,-
chr9,76386229,2.049556035517159,550,462,1012,-
chr9,76386312,1.3883739406779658,698,471,1169,-
chr9,76386429,1.906832298136646,613,482,1095,-
chr9,76386458,2.8550925925925927,880,539,1419,-
chr9,76386505,1.608421052631579,763,474,1237,-
chr9,76386567,1.654142145767315,1217,751,1968,-
chr9,76386872,0.5131380684046484,1129,768,1897,-
chr9,76386905,1.5420900531369444,918,630,1548,-
chr9,76386925,2.1581732108047897,749,566,1315,-
chr9,76386943,1.9394736842105256,736,512,1248,-
chr9,76386965,0.7541333545158332,1463,922,2385,-
chr9,76392530,1.6786820265081135,846,597,1443,-
chr9,76392543,2.0490610725765523,756,513,1269,-
chr9,76392565,1.3444044861075517,973,712,1685,-
chr9,76392566,2.2303304193213807,668,396,1064,-
chr9,76392567,2.2303304193213807,668,396,1064,-
chr9,83660625,0.21271665251680333,558,716,1274,-
chr9,83661002,1.852534562211981,602,433,1035,-
chr9,83661104,2.1552926011296645,662,455,1117,-
chr9,83677874,2.3326910716384406,684,486,1170,-
chr9,83679996,2.6667548916313,796,543,1339,-
chr9,83788664,2.269418426124185,1420,989,2409,-
chr9,83788667,1.7367088607594936,685,394,1079,-
chr9,83788668,2.180900900900901,1245,924,2169,-
chr9,83788669,2.180900900900901,1245,924,2169,-
chr9,83968453,2.4912067919951486,789,484,1273,-
chr9,83968629,1.5494461470664822,1501,1160,2661,-
chr9,83968630,1.8167656146620315,1837,1487,3324,-
chr9,83968644,2.052132009345794,610,427,1037,-
chr9,83968857,2.109979272494753,938,739,1677,-
chr9,83968858,1.8462677263518776,676,413,1089,-
chr9,83969016,2.2249742002063986,783,611,1394,-
chr9,83969017,2.390958011753877,3116,1947,5063,-
chr9,83969019,2.366198643381964,6581,4871,11452,-
chr9,83969022,6.472734920023409,4827,3583,8410,-
chr9,83969120,0.7152035329782058,2547,2257,4804,-
chr9,83969158,0.7604260654565906,1827,1398,3225,-
chr9,83969174,101.00457303491174,14788,6162,20950,-
chr9,83969175,101.00457303491174,14788,6162,20950,-
chr9,83969181,7.2478991596638656,1494,237,1731,-
chr9,83969302,1.463358440407621,1435,1109,2544,-
chr9,83970179,1.3414153948954144,3065,1948,5013,-
chr9,83970219,2.278503560837446,3837,2910,6747,-
chr9,83970287,1.2953355611250348,3000,2159,5159,-
chr9,83970318,0.7982004178992058,7908,5977,13885,-
chr9,83970324,1.2620671516303124,15124,11273,26397,-
chr9,83970325,1.2620671516303124,15124,11273,26397,-
chr9,83970754,1.4221889928654463,7596,5476,13072,-
chr9,83970755,1.4221889928654463,7596,5476,13072,-
chr9,83970762,2.188817598533456,3183,2181,5364,-
chr9,83970769,1.7707594472300354,1181,883,2064,-
chr9,83970778,0.6059535660383417,1109,835,1944,-
chr9,83970788,0.3868868868868868,772,665,1437,-
chr9,83970790,1.7447453954496208,1341,922,2263,-
chr9,83970791,0.6844056740207392,1434,941,2375,-
chr9,83970792,1.8159396233818461,1398,1137,2535,-
chr9,83970809,0.9948303896869837,1613,1254,2867,-
chr9,83970810,0.8280512082770246,1675,1217,2892,-
chr9,83970812,1.1026548672566372,1067,790,1857,-
chr9,83970813,1.7772483621203097,745,510,1255,-
chr9,83970815,0.6556178343425374,1036,754,1790,-
chr9,83971703,1.767901234567901,715,524,1239,-
chr9,83971704,1.6093354430379745,1452,1263,2715,-
chr9,83971706,1.6093354430379745,1452,1263,2715,-
chr9,83971725,2.276105810008482,1485,873,2358,-
chr9,83971991,1.5977532332672522,1353,962,2315,-
chr9,83972005,1.59823677581864,1221,793,2014,-
chr9,83972153,0.5166273190253441,5287,3700,8987,-
chr9,83973921,1.557593009400238,1704,1078,2782,-
chr9,83974587,2.0452842194570136,1230,883,2113,-
chr9,83978230,0.3576174430071989,54867,39605,94472,-
chr9,83978232,0.3576174430071989,54867,39605,94472,-
chr9,83978241,1.2388645874098234,16087,12082,28169,-
chr9,83978245,1.2070907354639508,54644,41521,96165,-
chr9,83978246,1.3030417409585529,39423,31087,70510,-
chr9,83978247,0.9433797474528662,15221,10434,25655,-
chr9,83978255,1.241800776951095,9383,6736,16119,-
chr9,83978256,1.2728095569729596,20073,14087,34160,-
chr9,83978257,1.3005148130658837,10690,7351,18041,-
chr9,83978260,1.2715585735402808,3876,2705,6581,-
chr9,83978262,0.5788982259570494,1983,1511,3494,-
chr9,83978273,1.4599416650187858,2982,1944,4926,-
chr9,83978393,2.3415107447126244,5159,3502,8661,-
chr9,83978412,1.4757436096766432,2277,1333,3610,-
chr9,83978430,1.4832470892626133,996,772,1768,-
chr9,83978440,1.6353156647274296,1058,713,1771,-
chr9,83980167,2.1189008610117805,865,576,1441,-
chr9,83980563,2.12406015037594,677,607,1284,-
chr9,86033316,1.7079797684236928,2723,2035,4758,-
chr9,86033319,1.6609567172880981,5069,3619,8688,-
chr9,86033320,1.459653592250418,6290,4472,10762,-
chr9,86033324,0.6782024854933454,2881,1885,4766,-
chr9,86033329,1.3437720880368105,4474,3043,7517,-
chr9,86033343,1.42928242536651,4527,2867,7394,-
chr9,86033345,1.4720000423760238,2806,1780,4586,-
chr9,86033347,1.5637256719184431,4148,2489,6637,-
chr9,86033348,1.5637256719184431,4148,2489,6637,-
chr9,86033349,1.5637256719184431,4148,2489,6637,-
chr9,86033358,1.4801654272823774,3535,2306,5841,-
chr9,86033359,1.2488650580875782,2138,1118,3256,-
chr9,86033366,2.050993138391128,1239,763,2002,-
chr9,86033367,0.6139037433155079,819,424,1243,-
chr9,86033369,1.881612090680101,746,396,1142,-
chr9,86033385,2.3189655172413794,806,579,1385,-
chr9,86033389,2.178787007760851,757,496,1253,-
chr9,86033392,1.759819256169621,663,410,1073,-
chr9,86040810,0.5897084048027443,572,529,1101,-
chr9,86040811,1.4566126304314235,733,651,1384,-
chr9,86040812,0.5001335470085471,748,701,1449,-
chr9,86040814,0.29835144485072945,592,514,1106,-
chr9,86265741,1.817434210526316,844,623,1467,-
chr9,86265742,1.817434210526316,844,623,1467,-
chr9,86265774,1.0093896713615025,644,425,1069,-
chr9,86265775,1.0093896713615025,644,425,1069,-
chr9,91410003,4.649936779860471,889,506,1395,-
chr9,92031578,1.381440281030445,2177,1463,3640,-
chr9,92031581,1.5494709702258092,3540,2270,5810,-
chr9,92031584,1.7678571428571428,3464,2199,5663,-
chr9,92031585,1.7678571428571428,3464,2199,5663,-
chr9,92031594,1.4691908498193165,2662,1574,4236,-
chr9,92031635,2.26653883029722,787,446,1233,-
chr9,92031640,1.6008762322015333,1217,663,1880,-
chr9,92031653,3.0067124167270634,1648,869,2517,-
chr9,92032352,3.966830167133811,621,393,1014,-
chr9,92059244,2.174638989169675,1342,1107,2449,-
chr9,92059271,1.6365248226950355,1348,892,2240,-
chr9,92059272,1.9707333482843687,949,636,1585,-
chr9,92059274,2.1129316181448883,995,632,1627,-
chr9,92059277,1.9379973474801064,1168,753,1921,-
chr9,92059281,1.497093699139735,821,505,1326,-
chr9,92059282,1.497793263646922,991,614,1605,-
chr9,92059286,1.826269561071262,1598,974,2572,-
chr9,92068051,1.2141989389920425,688,472,1160,-
chr9,92210708,1.9445100354191263,731,483,1214,-
chr9,92210881,1.6803633217993081,665,577,1242,-
chr9,92210888,2.411672278338945,631,494,1125,-
chr9,92222538,1.8157345346665201,660,478,1138,-
chr9,92222593,2.231060606060606,588,439,1027,-
chr9,92223488,0.349095587088726,596,582,1178,-
chr9,92229035,2.2986741102582,1646,1432,3078,-
chr9,92229036,2.2986741102582,1646,1432,3078,-
chr9,92229037,0.6121988845377951,937,635,1572,-
chr9,92229076,0.9784747847478473,1405,1083,2488,-
chr9,92229077,0.9784747847478473,1405,1083,2488,-
chr9,92229106,1.798784515788083,777,521,1298,-
chr9,92240871,2.3138832997987926,735,567,1302,-
chr9,92240941,1.856853203568532,722,547,1269,-
chr9,92240947,1.781200301330878,1329,918,2247,-
chr9,92240949,2.059959053929983,1937,1335,3272,-
chr9,92242292,1.7329579118335907,1853,1259,3112,-
chr9,92242309,3.1906191369606005,772,614,1386,-
chr9,92242321,1.8056370518478408,1453,1154,2607,-
chr9,92243269,0.5636856368563685,714,494,1208,-
chr9,92250271,0.4819700683782737,878,673,1551,-
chr9,92250272,1.7431225437656306,951,621,1572,-
chr9,92250285,0.6075869001640125,637,460,1097,-
chr9,92250809,1.5782143932550436,598,491,1089,-
chr9,92250817,4.682251082251082,623,494,1117,-
chr9,92251879,1.542142857142857,634,499,1133,-
chr9,92253384,2.124534783853421,723,498,1221,-
chr9,92253441,1.6559697970740916,637,488,1125,-
chr9,92256747,1.1122572807213496,1334,1095,2429,-
chr9,92258881,1.4721850589098442,831,492,1323,-
chr9,92260188,0.5372023809523809,664,559,1223,-
chr9,92260194,1.1385109851784838,1260,1012,2272,-
chr9,92263050,1.9959234936671246,1410,922,2332,-
chr9,92263052,2.0139231811684337,1465,912,2377,-
chr9,92263053,2.1214645308924487,945,574,1519,-
chr9,92265002,2.4490899498812984,598,445,1043,-
chr9,92265503,1.3427986419257827,1002,771,1773,-
chr9,92268273,1.7935615738375068,649,514,1163,-
chr9,92268278,0.4075235194216932,1036,770,1806,-
chr9,92269906,1.8014888337468984,659,402,1061,-
chr9,92269929,2.927154772937905,657,414,1071,-
chr9,92269967,1.7707073647210743,1214,904,2118,-
chr9,92271556,1.7770046388336649,691,502,1193,-
chr9,92271629,2.248787248787249,648,480,1128,-
chr9,92274443,1.0619747899159666,1010,713,1723,-
chr9,92274444,1.0619747899159666,1010,713,1723,-
chr9,92277904,2.0318083795440542,712,540,1252,-
chr9,92277922,1.7700831024930748,638,455,1093,-
chr9,92278229,1.7184193478730296,691,420,1111,-
chr9,92280875,0.5452300785634119,693,494,1187,-
chr9,92285766,1.7260135754907358,606,473,1079,-
chr9,92287857,1.6309869375907111,579,423,1002,-
chr9,92287894,1.7484987636877427,593,446,1039,-
chr9,92287905,2.640391109344025,1031,734,1765,-
chr9,92288251,2.5100063734862967,678,522,1200,-
chr9,92289423,1.9035294117647061,808,599,1407,-
chr9,92289424,1.9035294117647061,808,599,1407,-
chr9,92299980,0.9559526805940096,632,410,1042,-
chr9,92299981,0.9559526805940096,632,410,1042,-
chr9,92836877,0.752663338362302,5432,3596,9028,-
chr9,92836878,0.7239211753005914,7726,5161,12887,-
chr9,92836879,0.69964304336412,7303,5040,12343,-
chr9,92836881,0.5496063352262387,5106,3919,9025,-
chr9,92836882,0.5755627057126169,4072,3651,7723,-
chr9,92836883,0.5404443202553209,2044,1731,3775,-
chr9,92836884,0.9824911553735276,2454,2814,5268,-
chr9,92836885,0.9829584948103649,4336,4407,8743,-
chr9,92836886,1.00846796802785,3853,3985,7838,-
chr9,92836887,1.01241272000027,2347,2539,4886,-
chr9,96386963,2.1494130743272755,1287,1089,2376,-
chr9,96386964,2.0684492904119067,901,855,1756,-
chr9,96651464,1.4403727523961476,554,508,1062,-
chr9,97687148,6.1747430249632895,579,453,1032,-
chr9,99982666,2.7959870974550567,1301,984,2285,-
chr9,99982669,1.8553507785532972,1233,874,2107,-
chr9,99982670,2.501118568232662,558,446,1004,-
chr9,100022204,2.62453468397595,636,408,1044,-
chr9,101390376,3.705523132905514,809,604,1413,-
chr9,101390586,2.038752052545156,775,434,1209,-
chr9,101390602,1.6551724137931032,815,441,1256,-
chr9,108879454,3.097031617802259,690,483,1173,-
chr9,108879455,2.9876770045071943,675,443,1118,-
chr9,108942822,2.4882226980728053,580,466,1046,-
chr9,108943776,1.1735218276374675,917,665,1582,-
chr9,108948214,0.9846732215153268,680,531,1211,-
chr9,108948215,2.092372662699586,1015,838,1853,-
chr9,108952319,0.6443347029811812,1479,806,2285,-
chr9,108952492,1.418958070307438,841,582,1423,-
chr9,108972795,0.5216909362963803,1210,838,2048,-
chr9,108977033,1.1438481945980767,1155,795,1950,-
chr9,108979474,2.1458678509178393,901,667,1568,-
chr9,108983223,2.62406015037594,697,447,1144,-
chr9,108984407,1.9072289199907015,946,675,1621,-
chr9,108990812,2.317306831710332,938,606,1544,-
chr9,108992798,0.5695931477516061,721,466,1187,-
chr9,108999231,2.453465346534653,825,504,1329,-
chr9,108999232,2.453465346534653,825,504,1329,-
chr9,109013343,1.1976992502445953,889,733,1622,-
chr9,109013344,0.2869981497253958,697,430,1127,-
chr9,109013345,0.49362262114448846,1729,1153,2882,-
chr9,109013346,0.4941801145236856,878,564,1442,-
chr9,110251414,1.4445142069237207,3784,2900,6684,-
chr9,110251428,1.1749288804021667,5045,3829,8874,-
chr9,110251429,1.2137424547283702,5728,3549,9277,-
chr9,110256424,1.2334368027936753,3632,2805,6437,-
chr9,110256480,1.0786640192430064,29933,18093,48026,-
chr9,110256504,1.1218439514334386,60085,40092,100177,-
chr9,110256506,1.3039881986662327,108280,67623,175903,-
chr9,110256507,1.5291551646298842,81822,49174,130996,-
chr9,110256508,1.4390811114135902,57131,34848,91979,-
chr9,110256509,1.4893634795933297,20784,10122,30906,-
chr9,110256519,1.4910361433438355,10621,4549,15170,-
chr9,110256520,1.5254159951144433,24088,11707,35795,-
chr9,110256523,1.4119396146806313,15752,8202,23954,-
chr9,110256525,1.3548041930986743,14361,7263,21624,-
chr9,110256527,1.4524477871290256,14468,7271,21739,-
chr9,110256534,0.7588366519719612,30275,13407,43682,-
chr9,110256535,0.8230546083967173,36770,16442,53212,-
chr9,110256536,0.8422379063576506,22780,10362,33142,-
chr9,110256537,0.7493196325467174,22170,9917,32087,-
chr9,110256538,0.8451853447356581,10691,6082,16773,-
chr9,110256540,0.7192819272607007,10572,5414,15986,-
chr9,110256543,1.180414574206646,2454,1145,3599,-
chr9,110256545,1.308609465291493,3577,1673,5250,-
chr9,110256546,1.47458094407562,5653,3074,8727,-
chr9,110256547,1.767231030616128,4123,2469,6592,-
chr9,110256548,1.7373283375679414,3349,2005,5354,-
chr9,110256553,2.379292929292929,672,395,1067,-
chr9,110256554,1.3592093441150046,975,529,1504,-
chr9,110256558,1.7961844197138317,806,369,1175,-
chr9,110256561,0.9209431677309129,2693,1222,3915,-
chr9,110256563,0.846770804267675,4250,2014,6264,-
chr9,110256565,0.8770121859485482,1601,827,2428,-
chr9,110256566,2.4379358437935843,873,477,1350,-
chr9,110256578,1.6048812299573838,750,341,1091,-
chr9,110256589,0.7399861363382287,885,442,1327,-
chr9,111373984,0.8671619464281771,3867,2710,6577,-
chr9,111373986,0.49860438171476723,2704,1817,4521,-
chr9,111373987,0.6080168776371307,1047,631,1678,-
chr9,111374010,0.5673758865248227,639,375,1014,-
chr9,111374019,1.8835051546391752,811,484,1295,-
chr9,111374020,2.3653791130185984,1180,698,1878,-
chr9,111374022,2.7953026928528044,766,448,1214,-
chr9,111570104,1.7106242638398117,1251,848,2099,-
chr9,111570127,0.7499465926084169,1651,1207,2858,-
chr9,111570128,2.0492353739399283,2820,2116,4936,-
chr9,111570138,1.5234487734487734,720,587,1307,-
chr9,111570190,1.8822298325722984,760,583,1343,-
chr9,111570197,1.4585263798042816,1109,712,1821,-
chr9,111578895,0.2963525835866261,909,783,1692,-
chr9,111578916,0.6120291810612816,2356,1865,4221,-
chr9,111578918,1.513605176984251,946,582,1528,-
chr9,111583487,1.6004796163069546,851,555,1406,-
chr9,111583528,2.2666666666666666,645,569,1214,-
chr9,111583567,2.3460949464012253,765,652,1417,-
chr9,111586154,1.5959965867880253,1150,685,1835,-
chr9,111592968,2.438858695652174,1076,767,1843,-
chr9,111597413,1.1902955940664444,1234,909,2143,-
chr9,111599363,1.8444578621904715,1160,774,1934,-
chr9,111599366,1.254248310567905,1118,643,1761,-
chr9,111599395,1.6445388242602283,1332,810,2142,-
chr9,111599397,2.058657178356773,873,482,1355,-
chr9,112223608,3.2564848484848485,706,549,1255,-
chr9,112223609,0.4913113503433076,827,501,1328,-
chr9,112223612,1.5503721765913758,652,486,1138,-
chr9,112223613,1.752569169960474,738,459,1197,-
chr9,112223619,0.5609867519415258,613,397,1010,-
chr9,112223632,2.197140852398295,876,681,1557,-
chr9,112223634,1.8914285714285717,661,509,1170,-
chr9,113407422,1.7941227014951024,695,505,1200,-
chr9,113407475,1.7648565573770492,688,487,1175,-
chr9,113407557,4.150119776417354,581,420,1001,-
chr9,113407585,2.496928746928747,812,517,1329,-
chr9,113407587,2.496928746928747,812,517,1329,-
chr9,113408007,0.8434306117542585,1464,1171,2635,-
chr9,113408008,1.073395939352605,929,777,1706,-
chr9,113408630,1.3405425663472967,1642,1144,2786,-
chr9,113408673,1.8108377961332485,569,478,1047,-
chr9,113408958,2.4102265348601533,5593,4483,10076,-
chr9,113408959,2.4102265348601533,5593,4483,10076,-
chr9,113408967,1.4170068914405527,9283,6723,16006,-
chr9,113409623,1.7671110565847408,2566,1481,4047,-
chr9,113409626,1.741283446166676,4014,2351,6365,-
chr9,113409635,2.065694626474443,1400,762,2162,-
chr9,113409636,1.6362660944206007,1829,1397,3226,-
chr9,113409641,1.5343454454952712,1232,655,1887,-
chr9,113409651,0.5569151269926388,1087,561,1648,-
chr9,113409658,1.9704285981658245,1503,958,2461,-
chr9,113409669,2.75514403292181,1338,773,2111,-
chr9,113409671,2.070686070686071,995,517,1512,-
chr9,113409680,0.5330526315789473,632,374,1006,-
chr9,113409703,0.4294493916969773,855,468,1323,-
chr9,113409711,1.8798527566177026,998,596,1594,-
chr9,113409724,0.42391033623910335,850,510,1360,-
chr9,113409725,0.8677027920542267,1554,902,2456,-
chr9,118082991,1.4501067245160713,2436,1980,4416,-
chr9,118083048,0.44109763300168103,1021,666,1687,-
chr9,118083053,2.1608179054987557,781,516,1297,-
chr9,118083059,4.0972874282733445,682,425,1107,-
chr9,118083094,1.1858030196247198,3668,2789,6457,-
chr9,118083095,1.3489593710566512,2940,2150,5090,-
chr9,118083096,0.6200048881828181,1528,1077,2605,-
chr9,118083097,0.6191578504096702,2597,2072,4669,-
chr9,118083098,1.0305213485989617,2126,1704,3830,-
chr9,118083114,1.0448210167419845,2498,1910,4408,-
chr9,118083115,0.5971679439679236,1907,1291,3198,-
chr9,118083116,1.0673244731860498,2762,2153,4915,-
chr9,118083117,2.0278969957081547,755,698,1453,-
chr9,118083122,1.2583479245809386,634,489,1123,-
chr9,120605048,1.482365904192169,999,913,1912,-
chr9,120605051,2.652766272218109,1935,1609,3544,-
chr9,120605052,2.9887688069506253,1719,1572,3291,-
chr9,120605054,2.737182874960868,1971,1653,3624,-
chr9,120605056,2.1096835859620433,3383,2431,5814,-
chr9,120605057,2.4639146103762637,1845,1372,3217,-
chr9,120605058,2.826864535768645,1563,1167,2730,-
chr9,120605102,2.1285363901091863,853,650,1503,-
chr9,120833353,1.3888324904386358,1691,994,2685,-
chr9,120833354,1.7373146748146748,1882,1241,3123,-
chr9,120833375,1.2929320214418678,803,554,1357,-
chr9,120874652,2.0881424740888224,837,613,1450,-
chr9,121179504,5.542784163473819,619,521,1140,-
chr9,121179505,5.542784163473819,619,521,1140,-
chr9,121179866,2.085016147231625,1306,658,1964,-
chr9,121179867,2.085016147231625,1306,658,1964,-
chr9,121180457,1.8067618798829377,973,731,1704,-
chr9,121183371,2.3358158429248475,599,421,1020,-
chr9,121183397,0.38742624315411917,672,519,1191,-
chr9,121190685,2.8056037933257754,624,495,1119,-
chr9,121193397,0.9902606656655552,807,582,1389,-
chr9,121339194,1.823161597534289,2164,1508,3672,-
chr9,121339372,1.6292514453037015,1084,700,1784,-
chr9,121340330,1.3049454591938403,6184,4696,10880,-
chr9,121340406,1.4270919635459816,2596,1665,4261,-
chr9,121340407,1.4270919635459816,2596,1665,4261,-
chr9,121340415,1.3258546299369398,3328,2299,5627,-
chr9,121340482,1.8590051405177448,2278,1325,3603,-
chr9,121340483,1.8590051405177448,2278,1325,3603,-
chr9,121340484,0.6820363906366187,6858,4288,11146,-
chr9,121340485,0.6949826660204231,6052,3637,9689,-
chr9,121340496,0.6094351597207531,1107,814,1921,-
chr9,121340513,0.633066415449835,959,771,1730,-
chr9,121340553,0.6251960280706489,1227,941,2168,-
chr9,121340561,0.9901160266041934,1366,1035,2401,-
chr9,121340631,1.767272727272727,728,399,1127,-
chr9,121340632,1.062122144369989,1735,1159,2894,-
chr9,121340647,0.3686823104693141,816,553,1369,-
chr9,121340648,0.3686823104693141,816,553,1369,-
chr9,121340871,1.5217651075452372,1697,1211,2908,-
chr9,121340875,2.9541778975741235,684,529,1213,-
chr9,121340885,1.891734972677596,572,487,1059,-
chr9,121341169,1.566077003121748,804,712,1516,-
chr9,121341207,1.9873887678018358,2128,1423,3551,-
chr9,121341284,0.6030287984111221,693,635,1328,-
chr9,121341335,1.468848152577971,2908,2361,5269,-
chr9,121341341,1.9615270350564469,694,611,1305,-
chr9,121341364,0.6441029682164434,790,704,1494,-
chr9,121341366,1.9334893048128343,1156,747,1903,-
chr9,121341388,2.1092034766043577,1383,1134,2517,-
chr9,121341389,1.907240030038939,2327,1702,4029,-
chr9,121341406,1.3658334792718005,2113,1677,3790,-
chr9,121349138,2.400553064901328,1060,822,1882,-
chr9,121349240,0.9062524510444718,2272,1662,3934,-
chr9,121349241,0.8321235910495867,3114,2347,5461,-
chr9,121349264,1.4991105769230766,1056,799,1855,-
chr9,121349276,1.5329636263433453,1034,763,1797,-
chr9,121353291,1.6288729739917076,1053,757,1810,-
chr9,121354641,0.6359033704614494,1098,891,1989,-
chr9,121354662,1.6905777742334225,985,808,1793,-
chr9,121356070,0.6334546133034797,969,793,1762,-
chr9,121356120,1.7994966442953022,1364,1042,2406,-
chr9,121356121,0.9798225423225424,1954,1183,3137,-
chr9,121356122,1.3356110845102496,3318,2225,5543,-
chr9,121356147,1.572973837054404,719,382,1101,-
chr9,121370247,0.3006664773581439,719,456,1175,-
chr9,121370248,0.8623261439225962,743,725,1468,-
chr9,121370249,0.6991557622508293,2274,1845,4119,-
chr9,121370250,0.9192143224742461,1205,1108,2313,-
chr9,122144190,2.5978062157221204,811,546,1357,-
chr9,122144204,0.5975973789588642,1025,614,1639,-
chr9,122144245,0.4641014300457024,786,645,1431,-
chr9,122144257,1.6098771409550323,949,532,1481,-
chr9,122144259,1.1939298871063575,1806,1374,3180,-
chr9,122144260,1.1939298871063575,1806,1374,3180,-
chr9,122144273,1.8785006462731582,653,421,1074,-
chr9,122144291,2.1863755811602994,675,581,1256,-
chr9,122148123,2.9803191489361702,1292,704,1996,-
chr9,122148133,1.9409566697926477,4276,2666,6942,-
chr9,122148221,1.6198080329086442,1382,760,2142,-
chr9,122148223,1.7598778392823058,921,675,1596,-
chr9,122148243,1.6532976827094472,741,560,1301,-
chr9,122152278,1.8777543366150962,865,710,1575,-
chr9,122152307,1.8247298919567827,1044,832,1876,-
chr9,122152310,1.7160736196319015,776,651,1427,-
chr9,122152312,1.5879166666666666,926,719,1645,-
chr9,122152347,1.7200787401574802,770,634,1404,-
chr9,122152350,2.319377990430622,830,527,1357,-
chr9,122152385,2.0324626865671642,837,669,1506,-
chr9,122152398,0.625550894706101,560,508,1068,-
chr9,122159638,0.5095432856169053,574,488,1062,-
chr9,122159639,0.497620338574613,589,502,1091,-
chr9,122159645,0.4307479224376731,621,721,1342,-
chr9,122159647,0.4307479224376731,621,721,1342,-
chr9,122159667,2.552483128182057,2008,1805,3813,-
chr9,122159668,2.753671562082777,674,641,1315,-
chr9,122159669,2.4465732840749927,1334,1164,2498,-
chr9,122159688,9.13242178151735,1306,1045,2351,-
chr9,122890501,3.389773944616451,886,452,1338,-
chr9,124353541,2.417094017094017,706,584,1290,-
chr9,124353626,1.8098205014092865,914,748,1662,-
chr9,124353627,1.4173609409458463,1360,1165,2525,-
chr9,124353628,1.3496719656825635,1944,1320,3264,-
chr9,124353658,1.5149824819850402,3441,2369,5810,-
chr9,124353661,1.5719725455088036,1803,1116,2919,-
chr9,124353662,1.562112351586036,859,626,1485,-
chr9,124353688,2.0437965260545905,866,619,1485,-
chr9,124356817,1.6023387400980762,1901,1204,3105,-
chr9,124356818,0.5070753064798599,1400,1141,2541,-
chr9,124356865,1.3645504274698872,4602,3405,8007,-
chr9,124356901,1.3374408537199234,2165,1418,3583,-
chr9,124405420,1.587636049321738,2068,1365,3433,-
chr9,124412401,1.508792305074324,4066,3308,7374,-
chr9,124412444,3.123385012919896,966,773,1739,-
chr9,124413983,0.6507365486044085,1627,1178,2805,-
chr9,124413990,1.7386792452830186,872,635,1507,-
chr9,124414874,1.4547852389594675,2282,1424,3706,-
chr9,124414934,0.6105691056910569,750,599,1349,-
chr9,124415376,1.5865911497904868,1751,1142,2893,-
chr9,124415395,1.6007938463554896,1811,1273,3084,-
chr9,124415408,1.7881639222483594,1312,787,2099,-
chr9,124415415,2.2841530054644807,846,670,1516,-
chr9,124415433,1.9022556390977443,758,398,1156,-
chr9,124415438,0.631985054438662,1392,792,2184,-
chr9,124415439,0.5888270714996575,1554,1030,2584,-
chr9,124415441,0.958859649122807,642,449,1091,-
chr9,124857975,1.4218280754194867,48923,35720,84643,-
chr9,124857976,1.4218280754194867,48923,35720,84643,-
chr9,124857981,1.7250655919005673,18542,15005,33547,-
chr9,124857982,1.694841131138673,18166,13920,32086,-
chr9,124857984,1.9162839921308656,18270,14515,32785,-
chr9,124857990,1.175287129498178,8805,6882,15687,-
chr9,124858032,1.2569433085142663,43211,31173,74384,-
chr9,124858033,1.265902729617329,35777,24772,60549,-
chr9,124858054,1.2986386229630587,52293,35776,88069,-
chr9,124858055,1.2986386229630587,52293,35776,88069,-
chr9,124858056,1.2986386229630587,52293,35776,88069,-
chr9,124858057,0.8011731011239206,5274,4111,9385,-
chr9,124858059,1.349002563868275,27249,17970,45219,-
chr9,124858060,1.3672812568524073,38445,25049,63494,-
chr9,124858061,0.76815540063184,3809,3061,6870,-
chr9,124858062,1.3951637708012863,31067,19142,50209,-
chr9,124858063,1.480759404352195,14496,7897,22393,-
chr9,124858066,1.3331187344799045,3344,1493,4837,-
chr9,124860250,1.2905655910335871,64185,43403,107588,-
chr9,124860251,1.2905655910335871,64185,43403,107588,-
chr9,124860252,1.2905655910335871,64185,43403,107588,-
chr9,124860261,1.0779674243137907,12963,10259,23222,-
chr9,124861434,1.85587313295224,8386,4784,13170,-
chr9,124861454,1.0907358663232531,11074,7010,18084,-
chr9,124861524,1.3263353587041848,16405,13294,29699,-
chr9,124861531,0.856967072998208,12372,8297,20669,-
chr9,124861548,1.1818240803253899,28554,20127,48681,-
chr9,124861550,1.217840554499466,41005,28722,69727,-
chr9,124861551,1.241802185214955,32521,22753,55274,-
chr9,124861950,0.7631240017357104,2874,2433,5307,-
chr9,124861952,1.2407717450219269,5185,3394,8579,-
chr9,124861953,1.2169905363261058,4998,2995,7993,-
chr9,124861954,1.0293258944144574,11292,7742,19034,-
chr9,124861955,0.8558209730981994,6107,4348,10455,-
chr9,124861956,1.172184163190325,7219,4027,11246,-
chr9,124861957,1.1587149187610997,10149,6080,16229,-
chr9,124861958,1.1864354097176044,9349,5665,15014,-
chr9,124861964,0.9174041297935104,932,338,1270,-
chr9,124861965,0.8884053437591467,1125,418,1543,-
chr9,125236368,8.862727183249392,11899,9486,21385,-
chr9,125236378,0.9629450459166851,6250,3992,10242,-
chr9,125236379,1.1506649317476214,11684,7544,19228,-
chr9,125236385,3.9965596298121255,10487,6999,17486,-
chr9,125236393,1.5167100561704716,4951,3238,8189,-
chr9,125236399,2.454746136865342,3335,2264,5599,-
chr9,125236400,2.84163369400527,5473,3730,9203,-
chr9,125236754,1.8863086066475896,2363,1651,4014,-
chr9,125236789,1.491959097256633,2069,1123,3192,-
chr9,125236992,1.925063442304821,2975,1826,4801,-
chr9,125238300,1.715859173541143,3424,2328,5752,-
chr9,125239058,0.7093919805479529,5913,4606,10519,-
chr9,125239079,1.349708299599897,8400,6035,14435,-
chr9,125239255,4.503432297415098,6601,4889,11490,-
chr9,125239271,1.7920991507585105,1618,1197,2815,-
chr9,125239283,1.6775871766029244,1454,1015,2469,-
chr9,125239284,1.480842733289829,2117,1261,3378,-
chr9,125239286,1.439000693962526,1343,916,2259,-
chr9,125240255,1.5559236854350862,2063,1534,3597,-
chr9,125240299,1.0291083401919565,3546,2960,6506,-
chr9,125240302,1.5197028257661769,3097,2236,5333,-
chr9,125240303,1.5197028257661769,3097,2236,5333,-
chr9,125240692,0.6831648002674242,1720,1543,3263,-
chr9,125240717,1.7161983590545171,6365,5065,11430,-
chr9,125240718,1.7161983590545171,6365,5065,11430,-
chr9,125240788,1.4845826687931951,1116,1044,2160,-
chr9,125240835,1.4497324697268374,1143,937,2080,-
chr9,125240877,1.57424188580905,1002,803,1805,-
chr9,125240892,1.63263178157785,1474,877,2351,-
chr9,125240893,1.4505784331355271,967,746,1713,-
chr9,125240895,1.5634984025559104,869,625,1494,-
chr9,125240897,1.7935079105291871,1314,751,2065,-
chr9,125241056,1.516136082173818,967,741,1708,-
chr9,125241059,1.3954248366013071,825,707,1532,-
chr9,125241128,1.1025248546134254,2499,1801,4300,-
chr9,125241194,1.2292257315869153,3759,3053,6812,-
chr9,125241195,1.1030707151646968,2546,2104,4650,-
chr9,125241309,2.351164254247955,933,680,1613,-
chr9,125241318,0.7324166399490758,1460,1243,2703,-
chr9,125241319,1.5641067538126363,610,611,1221,-
chr9,125241321,0.5776991150442478,815,564,1379,-
chr9,125241334,2.039374944822107,699,481,1180,-
chr9,125438429,1.7286665121361635,1683,1312,2995,-
chr9,125438430,1.2050600291393054,3407,2231,5638,-
chr9,125438433,1.7694793536804314,769,556,1325,-
chr9,125438489,1.1068178905549149,750,458,1208,-
chr9,125438490,1.1068178905549149,750,458,1208,-
chr9,125438559,1.5647570983398447,873,535,1408,-
chr9,125438956,3.6235652950154056,677,478,1155,-
chr9,125468083,1.32692188406345,554,455,1009,-
chr9,125484530,2.654526740450233,620,559,1179,-
chr9,125657686,2.4224505928853755,651,574,1225,-
chr9,125657689,2.3835080041460333,795,456,1251,-
chr9,125657698,0.5209895052473763,694,405,1099,-
chr9,125657718,1.8682875320443086,1246,880,2126,-
chr9,125657723,2.681585253456221,1346,874,2220,-
chr9,125657725,1.5440344124971699,1979,1261,3240,-
chr9,125657727,1.3511111111111112,1295,809,2104,-
chr9,127447725,0.6709217515990087,8413,6575,14988,-
chr9,127447976,1.1822123371929336,18188,10875,29063,-
chr9,127447980,0.8111123158111342,34360,26027,60387,-
chr9,127447982,0.9855601100115104,78226,54490,132716,-
chr9,127447983,1.1167313986746625,81696,56871,138567,-
chr9,127448419,1.0880370205050953,42028,28028,70056,-
chr9,127448420,0.7484676957472922,36403,23831,60234,-
chr9,127448421,1.149863321628152,26032,20042,46074,-
chr9,127449294,0.9049146778852246,22016,17319,39335,-
chr9,127449295,0.9686440814342137,19569,16266,35835,-
chr9,127449298,1.129864080740445,11273,9166,20439,-
chr9,127449302,0.6907866199532867,8716,8639,17355,-
chr9,127449304,0.7141871202694815,12950,12817,25767,-
chr9,127449305,0.9757960170625735,19493,15528,35021,-
chr9,127449308,1.5768337022289138,10080,6292,16372,-
chr9,127449311,1.377760234514744,9670,5886,15556,-
chr9,127449314,1.3073151433696184,12513,8743,21256,-
chr9,127449315,1.2718317882197407,16810,9993,26803,-
chr9,127449316,1.2558530937555827,12140,8113,20253,-
chr9,127449321,1.9398300462710467,3801,2011,5812,-
chr9,127449324,1.5562999800463535,2721,2412,5133,-
chr9,127449325,0.8081807752454109,11854,6453,18307,-
chr9,127449327,1.1416833037748888,16729,10649,27378,-
chr9,127449328,1.8147547170467608,4875,4196,9071,-
chr9,127449333,1.770300198348609,5120,3278,8398,-
chr9,127449337,1.8516941495369328,2446,1164,3610,-
chr9,127449343,1.6530283611028955,2011,1448,3459,-
chr9,127449361,0.9510713185797879,1912,1336,3248,-
chr9,127449362,0.7936808967996025,3140,2014,5154,-
chr9,127449697,1.0504968184407129,9996,8588,18584,-
chr9,127449699,1.094735054631862,22963,18228,41191,-
chr9,127449701,0.9561318180873154,34848,26002,60850,-
chr9,127449702,0.9987267350093207,19919,14181,34100,-
chr9,127449703,1.0139104991950716,22649,16727,39376,-
chr9,127451091,3.7908729245176707,618,396,1014,-
chr9,127451400,0.7626291804866785,19268,18314,37582,-
chr9,127451402,0.971578909487117,29351,27767,57118,-
chr9,127451404,0.9863289799044155,34494,28969,63463,-
chr9,127451405,1.0182426134881544,6095,4873,10968,-
chr9,127505450,0.6543715846994536,957,731,1688,-
chr9,127505834,0.5407533248606942,1029,873,1902,-
chr9,127505860,3.6966019417475726,1522,1235,2757,-
chr9,127505861,4.582397603151356,3544,2607,6151,-
chr9,127505862,4.759572415497125,3824,2829,6653,-
chr9,127505965,4.194235229010917,1700,1185,2885,-
chr9,127505980,2.406868686868687,965,549,1514,-
chr9,127505981,2.406868686868687,965,549,1514,-
chr9,127506196,2.2936806791118878,1141,1237,2378,-
chr9,127506197,2.464301554447917,875,1085,1960,-
chr9,127506235,2.8436934952315074,1410,1268,2678,-
chr9,127506237,3.738442041013226,3163,2662,5825,-
chr9,127506238,4.524455640158289,2444,2007,4451,-
chr9,127506248,5.920988011988013,907,523,1430,-
chr9,127506249,6.65,734,349,1083,-
chr9,127506265,3.6288132508752176,745,435,1180,-
chr9,127506293,7.233920962468258,1500,868,2368,-
chr9,127506294,4.556462585034013,590,440,1030,-
chr9,127506295,9.734425966181606,1839,1005,2844,-
chr9,127506319,3.1584287961585567,2351,1292,3643,-
chr9,127506320,3.1895955187166876,2152,1164,3316,-
chr9,127506562,2.3371598639455784,716,391,1107,-
chr9,127506630,0.6413281773006106,2051,1476,3527,-
chr9,127506676,1.5772629310344828,713,639,1352,-
chr9,127506687,0.522768670309654,573,548,1121,-
chr9,127506689,0.4537549407114624,614,574,1188,-
chr9,127506694,0.6181423961274707,532,535,1067,-
chr9,127506702,3.787150760711587,1137,1174,2311,-
chr9,127506725,20.27010914604528,2629,2301,4930,-
chr9,127506727,18.099565654904872,3943,3070,7013,-
chr9,127506728,22.625731461219726,2630,1877,4507,-
chr9,127506733,5.073954993088026,1813,846,2659,-
chr9,127506734,4.6169250645994815,1020,386,1406,-
chr9,127507035,3.626889506800218,854,483,1337,-
chr9,127507046,2.218856548971717,719,388,1107,-
chr9,127507244,2.3230490018148817,863,512,1375,-
chr9,127507245,2.3230490018148817,863,512,1375,-
chr9,127507246,1.1363154035410135,643,467,1110,-
chr9,127508141,0.5065406976744186,614,515,1129,-
chr9,127508198,2.413419913419913,668,593,1261,-
chr9,127508199,2.413419913419913,668,593,1261,-
chr9,127508530,2.0986410660657913,985,799,1784,-
chr9,127509070,2.1459186889379143,618,500,1118,-
chr9,127509129,2.0553179355574565,635,500,1135,-
chr9,127510329,2.225055510646968,668,525,1193,-
chr9,127516894,2.3780684764852054,1622,1167,2789,-
chr9,127516907,1.2741571940044731,957,707,1664,-
chr9,127517005,3.0440251572327037,604,476,1080,-
chr9,127517006,3.0440251572327037,604,476,1080,-
chr9,127517850,2.356857854920229,1404,882,2286,-
chr9,127517871,2.421052631578948,643,436,1079,-
chr9,127517889,0.5118445029358171,631,448,1079,-
chr9,127517900,1.6143212788259955,600,476,1076,-
chr9,127517929,2.7148734674513366,793,629,1422,-
chr9,127523788,2.58178033778425,1428,916,2344,-
chr9,127523799,2.5488060326770006,1013,650,1663,-
chr9,127523801,2.292101763064593,1678,1174,2852,-
chr9,127523834,1.737556942544129,1235,832,2067,-
chr9,127525114,1.248340386907824,1227,830,2057,-
chr9,127527251,1.679144385026738,627,492,1119,-
chr9,127527253,2.0676539797565496,962,677,1639,-
chr9,127531729,1.4083447461440413,4580,3335,7915,-
chr9,127531734,1.5269570306784372,2301,2029,4330,-
chr9,127531735,1.5456946136071072,4174,3160,7334,-
chr9,127531739,1.0492414636693168,1850,1558,3408,-
chr9,127531741,1.4463490279723157,3432,2482,5914,-
chr9,127531742,2.5981515711645105,752,540,1292,-
chr9,127531744,1.4727241732015,1466,837,2303,-
chr9,127531765,1.334079656515593,2785,1993,4778,-
chr9,127531766,1.6892769965964176,1183,1002,2185,-
chr9,127531775,0.913084331688983,675,515,1190,-
chr9,127531776,1.4883886478747201,2117,1470,3587,-
chr9,127531778,1.4307675486551497,718,537,1255,-
chr9,127568955,1.9380811386421488,454,620,1074,-
chr9,127568956,2.522166797722241,734,790,1524,-
chr9,127568957,6.923300806564728,660,805,1465,-
chr9,127873039,1.3397746891453517,4763,3142,7905,-
chr9,127873040,1.4095852604251995,2867,2173,5040,-
chr9,127873051,1.067981684773282,1768,1130,2898,-
chr9,127873054,1.9074965924579736,655,354,1009,-
chr9,127873058,0.5777307825785181,2926,2039,4965,-
chr9,127873059,0.5777307825785181,2926,2039,4965,-
chr9,127873060,0.5777307825785181,2926,2039,4965,-
chr9,127874634,1.906265356265356,1051,879,1930,-
chr9,127874636,1.9844557958423177,1440,1142,2582,-
chr9,127912472,1.5406013257575757,684,351,1035,-
chr9,127912473,1.734615384615385,901,454,1355,-
chr9,127912474,1.734615384615385,901,454,1355,-
chr9,127912475,2.8251879699248126,667,335,1002,-
chr9,128122431,0.7673983719361871,609,392,1001,-
chr9,128123765,2.9044894913567965,864,472,1336,-
chr9,128123767,2.9044894913567965,864,472,1336,-
chr9,128124523,2.913235294117648,848,713,1561,-
chr9,128124524,2.913235294117648,848,713,1561,-
chr9,128124525,2.913235294117648,848,713,1561,-
chr9,128169455,0.640342106564481,671,416,1087,-
chr9,128180483,1.848361416351744,598,412,1010,-
chr9,128256157,3.691482226693495,515,496,1011,-
chr9,128256158,3.691482226693495,515,496,1011,-
chr9,128260478,0.5973831775700934,751,534,1285,-
chr9,128260483,2.113618550028434,1171,901,2072,-
chr9,128260488,2.1297489823609226,1298,1071,2369,-
chr9,128260489,2.0868719762027776,1869,1465,3334,-
chr9,128262647,0.5963068824732902,780,599,1379,-
chr9,128633724,5.24383912742062,1161,847,2008,-
chr9,128633725,6.517824074074074,760,539,1299,-
chr9,128633876,1.7650106837606838,892,519,1411,-
chr9,128633945,0.6422712337186488,1044,716,1760,-
chr9,128633958,0.5882798304058147,924,634,1558,-
chr9,128633959,0.47954762429316294,652,533,1185,-
chr9,128634715,1.1487573153948092,1063,710,1773,-
chr9,128634747,0.9446022727272728,664,571,1235,-
chr9,128634749,1.462479678995847,896,737,1633,-
chr9,128634890,3.003916838320484,736,418,1154,-
chr9,128640793,0.5870535714285714,525,503,1028,-
chr9,128640800,1.8589285714285717,693,479,1172,-
chr9,129098646,2.43559510567297,643,434,1077,-
chr9,129098647,2.43559510567297,643,434,1077,-
chr9,129098648,2.0391947748759884,778,533,1311,-
chr9,129177957,2.638655462184874,627,461,1088,-
chr9,129177958,2.638655462184874,627,461,1088,-
chr9,129813688,1.9868659420289858,748,482,1230,-
chr9,129813690,1.5546988667202164,952,666,1618,-
chr9,129814054,1.3393885772192295,732,550,1282,-
chr9,129818629,0.37839547279331776,562,478,1040,-
chr9,129818801,2.9690721649484533,575,581,1156,-
chr9,129818802,3.03827421589388,945,814,1759,-
chr9,129830937,2.2824748990327697,661,477,1138,-
chr9,129831001,2.6516624040920718,767,459,1226,-
chr9,129831003,2.6516624040920718,767,459,1226,-
chr9,132376055,3.3965995836224843,501,523,1024,-
chr9,132376056,3.3965995836224843,501,523,1024,-
chr9,132401628,0.49934277785891634,788,500,1288,-
chr9,132401629,2.248563828598252,1377,1077,2454,-
chr9,132401630,1.7571288743882545,815,612,1427,-
chr9,132401631,2.2699549070042626,2614,1936,4550,-
chr9,132401632,2.293543543543544,1879,1331,3210,-
chr9,132401633,2.293543543543544,1879,1331,3210,-
chr9,132401664,0.5145352804694964,579,430,1009,-
chr9,132612147,1.6660558041588462,1716,1463,3179,-
chr9,132612148,1.777451237719481,2487,2082,4569,-
chr9,132612151,3.2740157480314966,615,507,1122,-
chr9,132612170,1.6732710280373833,745,534,1279,-
chr9,132612183,1.3334383429463241,757,562,1319,-
chr9,133351942,1.013720358474106,580,466,1046,-
chr9,133351944,1.013720358474106,580,466,1046,-
chr9,133352486,1.2157819225661262,673,458,1131,-
chr9,133361618,6.390253536371004,4051,9309,13360,-
chr9,133361622,28.556848202703716,8196,7266,15462,-
chr9,133361623,28.556848202703712,8196,7266,15462,-
chr9,133361624,16.79176755447942,2773,2182,4955,-
chr9,133361629,1.5916244331821816,917,488,1405,-
chr9,133361631,1.8675382782112104,2214,1125,3339,-
chr9,133361632,2.6014644121462656,2571,1245,3816,-
chr9,133361633,2.2589655496432397,4785,2370,7155,-
chr9,133361634,3.7147811363379573,5863,2975,8838,-
chr9,133361636,4.727356603164238,4131,2125,6256,-
chr9,133361655,1.095932690681549,1057,647,1704,-
chr9,133361656,1.406589308309861,1647,966,2613,-
chr9,133361778,0.6163316341252284,711,561,1272,-
chr9,133362040,1.835224884405212,1035,792,1827,-
chr9,133362075,1.4713225549960245,1290,769,2059,-
chr9,133362076,1.4767487684729064,1152,874,2026,-
chr9,133362107,3.204752604166667,894,575,1469,-
chr9,133362365,0.7328850855745721,1634,1226,2860,-
chr9,133362499,2.199760109772804,1098,683,1781,-
chr9,133362504,6.5375647668393775,720,385,1105,-
chr9,133362507,2.660377358490566,704,370,1074,-
chr9,133363015,1.8123936816524908,1016,822,1838,-
chr9,133363127,0.6675471698113207,975,847,1822,-
chr9,133363142,2.1555285540704743,886,822,1708,-
chr9,133363151,1.4865853658536583,1218,819,2037,-
chr9,133363202,1.4884639668128656,1097,938,2035,-
chr9,133363229,1.8214988381725352,1700,1165,2865,-
chr9,133363413,2.4827777777777778,871,719,1590,-
chr9,133363420,1.4996065573770492,1451,999,2450,-
chr9,133363464,1.7406365014072314,803,595,1398,-
chr9,133363484,1.4046922548345933,1153,834,1987,-
chr9,133363649,1.8966763005780347,874,864,1738,-
chr9,133363704,0.7233146067415731,1544,1031,2575,-
chr9,133363708,1.5319655439763566,2266,1675,3941,-
chr9,133363758,0.6739966254529361,1238,926,2164,-
chr9,133364861,1.9985565193829165,2194,1844,4038,-
chr9,133364913,2.875595152214688,1626,955,2581,-
chr9,133364922,1.219659350666604,2001,1497,3498,-
chr9,133364943,1.846681439274032,945,701,1646,-
chr9,133364967,1.0959680424141018,2158,1319,3477,-
chr9,133364973,0.5553268765133171,833,559,1392,-
chr9,133364986,0.6006683375104428,718,503,1221,-
chr9,133367276,0.5061312450676865,724,577,1301,-
chr9,133367335,1.8710045662100452,1638,875,2513,-
chr9,133367336,1.8710045662100452,1638,875,2513,-
chr9,133367394,1.6431797651309843,748,573,1321,-
chr9,133375952,2.6345776031434185,595,508,1103,-
chr9,133375954,2.6345776031434185,595,508,1103,-
chr9,135933467,1.4010790679353222,1016,734,1750,-
chr9,135933469,1.7082374552890764,1493,1069,2562,-
chr9,135933470,2.0095904189235156,1302,955,2257,-
chr9,135938269,0.6809801020743094,545,459,1004,-
chr9,135953708,1.253734386238064,657,553,1210,-
chr9,135955385,2.0300439067444707,681,495,1176,-
chr9,136207562,1.8087999999999997,645,499,1144,-
chr9,136208647,2.0037735849056597,707,317,1024,-
chr9,136208666,1.3282826906491192,868,434,1302,-
chr9,136209202,0.8551645163288603,664,560,1224,-
chr9,136219085,2.9362227328606836,690,557,1247,-
chr9,136223788,0.955621301775148,594,454,1048,-
chr9,136223789,0.955621301775148,594,454,1048,-
chr9,136223799,4.801935192206733,646,460,1106,-
chr9,136402815,2.982499906120182,1457,908,2365,-
chr9,136402817,3.4799160671462825,892,555,1447,-
chr9,136402853,2.7284467158496124,607,412,1019,-
chr9,136410126,2.1805049648221146,1078,817,1895,-
chr9,136410127,2.1805049648221146,1078,817,1895,-
chr9,136410150,4.510050251256281,717,397,1114,-
chr9,136410151,4.510050251256281,717,397,1114,-
chr9,136724788,1.5101587770723548,3500,2496,5996,-
chr9,136724822,1.4580912575202607,1255,930,2185,-
chr9,136724823,2.6101101101101096,595,443,1038,-
chr9,136724838,0.6035870708850228,880,716,1596,-
chr9,136724863,2.3189953610635077,1130,717,1847,-
chr9,136724864,2.142070484581498,777,453,1230,-
chr9,136726406,0.5907126733311835,1277,885,2162,-
chr9,136726407,0.5772025318346837,1810,1278,3088,-
chr9,136726409,0.5013418040418424,1591,1177,2768,-
chr9,136726411,0.492356932531046,1406,1094,2500,-
chr9,136726412,0.4522534187571261,1149,953,2102,-
chr9,136727975,10.372982637789061,622,590,1212,-
chr9,136727977,4.1844744730329415,743,745,1488,-
chr9,136728025,16.63264794785532,822,480,1302,-
chr9,136862269,1.6917277486910995,1153,954,2107,-
chr9,136862288,2.046203022084464,1624,1245,2869,-
chr9,136862289,2.046203022084464,1624,1245,2869,-
chr9,136862922,1.6864864864864868,857,739,1596,-
chr9,136862997,1.6798225238090791,2683,2014,4697,-
chr9,136863321,0.63923796119433,941,685,1626,-
chr9,136863375,1.4396769494588164,3717,3090,6807,-
chr9,136863378,1.22546540987256,9064,6063,15127,-
chr9,136863381,1.408984574298298,5725,4106,9831,-
chr9,136863383,1.408984574298298,5725,4106,9831,-
chr9,136863395,1.2984311535892972,2371,1790,4161,-
chr9,136863428,1.6957060539576145,2835,2182,5017,-
chr9,136863429,1.6957060539576145,2835,2182,5017,-
chr9,136863435,1.4493668771507802,1221,906,2127,-
chr9,136863839,1.6548563764390296,1345,1166,2511,-
chr9,136863854,0.5225091439100183,949,712,1661,-
chr9,136863863,1.4846308610742618,3678,2826,6504,-
chr9,136866191,1.7018177597170094,2098,1689,3787,-
chr9,136866209,1.6402777777777775,1180,703,1883,-
chr9,136866217,1.7247823513286495,3493,2243,5736,-
chr9,136866218,1.8480910763569456,1460,1086,2546,-
chr9,136866219,1.6263672999424297,2033,1157,3190,-
chr9,136866266,1.8412745681953546,686,437,1123,-
chr9,136866270,0.6337890085082869,1525,797,2322,-
chr9,136866276,6.1273209549071606,629,376,1005,-
chr9,136866296,2.6891668721323843,899,503,1402,-
chr9,136866300,0.7516184230630593,1154,495,1649,-
chr9,136942100,2.6612103174603177,724,503,1227,-
chr9,136942101,2.438976035366921,1313,843,2156,-
chr9,136942559,3.770556392338373,641,507,1148,-
chr9,136942560,3.770556392338373,641,507,1148,-
chr9,136942855,3.5696023470564997,687,364,1051,-
chr9,136943384,1.847984322508399,1885,987,2872,-
chr9,136943385,1.8650913482182194,4255,2462,6717,-
chr9,136943386,1.7496606314898715,1945,1298,3243,-
chr9,136943388,1.6822930913905838,1909,1135,3044,-
chr9,136943396,0.5314797794117647,1284,679,1963,-
chr9,136943397,0.9552709014473566,1803,981,2784,-
chr9,136943406,0.41098796288998873,645,372,1017,-
chr9,137112184,1.849745328672393,941,704,1645,-
chr9,137113089,2.508639136171686,753,516,1269,-
chr9,137113229,3.36483390607102,749,581,1330,-
chr9,137113231,3.36483390607102,749,581,1330,-
chr9,137113273,2.130865319100613,822,594,1416,-
chr9,137113275,2.130865319100613,822,594,1416,-
chr9,137114020,1.7165006495972635,591,443,1034,-
chr9,137114263,1.4554865671727975,656,435,1091,-
chr9,137114348,1.5936047594651928,627,391,1018,-
chr9,137114495,1.4084603353497371,647,460,1107,-
chr9,137114512,1.3471575003618987,624,478,1102,-
chr9,137204964,1.6525630165535172,718,551,1269,-
chr9,137205068,0.9306130718900597,650,499,1149,-
chr9,137582251,18.385727819002174,1856,1439,3295,-
chr9,137582252,18.38572781900217,1856,1439,3295,-
chr9,137582599,1.0912264641599358,903,637,1540,-
chr10,825264,1.6657921133228264,998,709,1707,-
chr10,825271,1.6672054680644717,949,733,1682,-
chr10,825273,1.6672054680644717,949,733,1682,-
chr10,1040235,2.0328601472134595,835,633,1468,-
chr10,1040288,0.5943287037037036,1026,782,1808,-
chr10,1040307,1.6545939933259177,906,724,1630,-
chr10,1040325,1.9141440776289413,697,498,1195,-
chr10,1040326,1.7378472222222223,714,383,1097,-
chr10,1040762,1.4767998219650609,1105,816,1921,-
chr10,1040842,1.660853432282004,1118,615,1733,-
chr10,1040940,1.5204301075268818,1211,929,2140,-
chr10,1041320,2.7657199378267627,850,673,1523,-
chr10,1041400,1.6135349626880404,972,816,1788,-
chr10,1041483,0.4904093335969943,619,388,1007,-
chr10,1043315,1.3919451838706496,1660,1287,2947,-
chr10,1043327,1.8598530103906448,1092,836,1928,-
chr10,1044096,0.5432595573440644,593,496,1089,-
chr10,1044129,1.9225589225589224,570,485,1055,-
chr10,1044141,2.147542857142857,873,699,1572,-
chr10,1044142,2.147542857142857,873,699,1572,-
chr10,1044145,1.1370897473133894,782,625,1407,-
chr10,1044146,1.1370897473133894,782,625,1407,-
chr10,1044151,2.3522051923678453,751,416,1167,-
chr10,1044152,2.3522051923678453,751,416,1167,-
chr10,5765523,1.4854215918045706,1304,845,2149,-
chr10,5765605,1.7978486646884273,916,673,1589,-
chr10,5765712,1.3989881956155144,1585,1185,2770,-
chr10,5765765,1.991647331786543,1072,861,1933,-
chr10,5765766,1.991647331786543,1072,861,1933,-
chr10,5765966,1.634917601087326,2594,1743,4337,-
chr10,5766018,1.5786833328794514,4031,3007,7038,-
chr10,5766080,3.02767134951043,1015,782,1797,-
chr10,5766145,1.5946640380664086,3848,2566,6414,-
chr10,5766146,1.5766318996835813,2945,1854,4799,-
chr10,5766147,0.5046525954025224,1131,893,2024,-
chr10,5766149,1.920575865415723,765,561,1326,-
chr10,5766604,1.5887809187279152,871,565,1436,-
chr10,5766631,2.2142420018746387,1646,1100,2746,-
chr10,5768383,1.5963355318009003,16761,10416,27177,-
chr10,5773859,1.400422632768179,14840,9037,23877,-
chr10,5773878,1.318596082993989,4749,2564,7313,-
chr10,5773883,1.7449856033231428,17217,11149,28366,-
chr10,5773890,1.4426524014265238,3970,2054,6024,-
chr10,5773896,1.7722086720867207,4218,2459,6677,-
chr10,5773904,1.6084355731391655,5240,3476,8716,-
chr10,5773907,0.7551659443341001,3166,1825,4991,-
chr10,5773928,1.6338187595344738,7290,3910,11200,-
chr10,5773929,1.6338187595344738,7290,3910,11200,-
chr10,5773931,1.6087783176778983,2601,1553,4154,-
chr10,5773937,1.451992945157655,4291,2052,6343,-
chr10,5785152,1.6618115942028986,1206,689,1895,-
chr10,5785186,0.4978810663021189,1820,1044,2864,-
chr10,5786032,1.5788096306265889,1029,742,1771,-
chr10,5796780,2.18086487566164,752,526,1278,-
chr10,5800614,2.4173690932311622,844,674,1518,-
chr10,5800685,1.930274209486166,892,505,1397,-
chr10,5800687,1.8885815602836884,858,563,1421,-
chr10,5800701,1.6693712220382233,3452,2160,5612,-
chr10,5800702,1.2075252016769595,3186,1873,5059,-
chr10,5800704,0.5748576434515988,1157,760,1917,-
chr10,5813238,1.5161162513552258,1545,1072,2617,-
chr10,5813421,3.66969696969697,864,329,1193,-
chr10,5813423,3.5607942765988856,1106,464,1570,-
chr10,5952520,1.097458833368061,835,629,1464,-
chr10,12167710,2.4320524835988757,1037,872,1909,-
chr10,12167747,1.0700592606293098,1976,1352,3328,-
chr10,12167794,1.8185307017543861,1497,895,2392,-
chr10,12167795,1.9281300344297354,2615,1666,4281,-
chr10,12167797,1.183934392828036,2112,1226,3338,-
chr10,12167798,0.9567635903919093,1375,790,2165,-
chr10,12167799,0.558295287829758,821,669,1490,-
chr10,12173761,0.6280011166945839,817,596,1413,-
chr10,12173767,1.9628365566932118,646,585,1231,-
chr10,12173794,0.6233696486113242,649,531,1180,-
chr10,12177863,2.081159420289856,717,551,1268,-
chr10,12177890,2.2171976704350813,808,555,1363,-
chr10,12184924,1.6911764705882353,850,628,1478,-
chr10,12184940,1.9027149321266967,840,577,1417,-
chr10,12186259,1.6129515814720432,1075,952,2027,-
chr10,12186280,1.7379139703083366,1190,851,2041,-
chr10,12186292,1.4987261146496815,904,784,1688,-
chr10,12186327,2.9829545454545454,804,703,1507,-
chr10,12186329,2.396170958955866,2144,1675,3819,-
chr10,12195786,0.7093444018731374,774,579,1353,-
chr10,13322905,1.0541899730832784,690,448,1138,-
chr10,13322906,1.0541899730832784,690,448,1138,-
chr10,13333948,2.2621839456712918,590,485,1075,-
chr10,14521993,2.2037819185645278,1173,804,1977,-
chr10,14521994,2.2037819185645278,1173,804,1977,-
chr10,14522000,2.4391566725231075,862,688,1550,-
chr10,14522001,2.4391566725231075,862,688,1550,-
chr10,14530435,2.8516013565558462,747,513,1260,-
chr10,16752927,2.385741085532804,1027,699,1726,-
chr10,16782045,2.322013309566597,594,523,1117,-
chr10,17604005,3.3813494765741634,702,531,1233,-
chr10,17617100,0.5678446462405138,614,468,1082,-
chr10,17617127,2.2397903195862345,615,437,1052,-
chr10,24585031,5.165855241804611,1037,710,1747,-
chr10,24585882,2.836046251148847,713,542,1255,-
chr10,24600917,1.871603368822501,603,433,1036,-
chr10,24600918,1.871603368822501,603,433,1036,-
chr10,24607509,1.7779954682522103,1753,1485,3238,-
chr10,24607510,1.7779954682522103,1753,1485,3238,-
chr10,24607519,1.7490257752045872,1380,1011,2391,-
chr10,24607521,1.7490257752045872,1380,1011,2391,-
chr10,24607595,2.888612836438924,871,524,1395,-
chr10,24607596,2.888612836438924,871,524,1395,-
chr10,24607776,0.47301665185101766,792,606,1398,-
chr10,24607787,2.090798040645103,753,587,1340,-
chr10,27110603,2.358583834335337,678,498,1176,-
chr10,27110851,3.4434058467379525,943,603,1546,-
chr10,27111239,0.6043158949645181,914,582,1496,-
chr10,27111682,2.0950570342205324,782,525,1307,-
chr10,27114571,2.12625,629,399,1028,-
chr10,27116113,2.4552665559859803,604,416,1020,-
chr10,27116250,2.1208107796844407,634,456,1090,-
chr10,27116286,0.5543309128630706,674,481,1155,-
chr10,27119384,1.662378640776699,760,514,1274,-
chr10,27120507,1.6399302528334787,968,628,1596,-
chr10,27120542,0.7188139569709978,1349,896,2245,-
chr10,27120543,0.5944469905302017,2130,1317,3447,-
chr10,27120544,0.5918989611882465,3859,2451,6310,-
chr10,27122931,1.7441291585127199,712,437,1149,-
chr10,27131883,2.44618223354714,869,598,1467,-
chr10,27131924,2.2959140112055088,781,577,1358,-
chr10,27142405,1.7306845696676207,628,412,1040,-
chr10,27154207,0.8506937076678156,859,586,1445,-
chr10,27154208,1.6234132569084023,865,577,1442,-
chr10,27154309,6.833716204712136,809,554,1363,-
chr10,28523550,1.5727669710786183,578,457,1035,-
chr10,29470353,2.624532115653521,712,447,1159,-
chr10,30313893,1.5642990082545092,858,626,1484,-
chr10,32009366,1.9252635032823886,848,637,1485,-
chr10,32009528,1.78518895287206,937,651,1588,-
chr10,32009913,3.70725448538795,832,771,1603,-
chr10,32009915,3.70725448538795,832,771,1603,-
chr10,32010159,2.7143292682926825,613,409,1022,-
chr10,32010160,2.7143292682926825,613,409,1022,-
chr10,32010475,2.572087912087912,995,519,1514,-
chr10,32010476,2.48051191885038,1214,736,1950,-
chr10,32010596,3.531068296278188,589,415,1004,-
chr10,32017257,3.7630867052112853,1076,774,1850,-
chr10,32017258,4.334855403348554,622,510,1132,-
chr10,32019937,2.405845604640785,2103,1493,3596,-
chr10,32019949,0.6650798652017864,3272,1920,5192,-
chr10,32019950,0.93096635743834,4897,2919,7816,-
chr10,32019956,0.9781093463237982,2678,1589,4267,-
chr10,32021038,1.9953431372549024,1162,679,1841,-
chr10,32021056,1.692486306263396,916,493,1409,-
chr10,32021248,2.4842541436464094,781,361,1142,-
chr10,32021253,2.7129294755877043,705,315,1020,-
chr10,32021256,1.639603524304684,1068,604,1672,-
chr10,32032765,2.387271689497717,955,875,1830,-
chr10,32032767,2.1899872839448027,1394,1248,2642,-
chr10,32032768,1.8531802479170902,896,776,1672,-
chr10,32188584,3.8042225308418516,691,353,1044,-
chr10,32900880,1.4899846017329579,2260,1647,3907,-
chr10,32900895,1.5739564929328622,1628,1131,2759,-
chr10,32900912,1.568192623609802,5120,3359,8479,-
chr10,32900924,1.8666842893647018,1114,581,1695,-
chr10,32900932,2.5691056910569112,868,450,1318,-
chr10,32900955,0.8246317849088609,1611,922,2533,-
chr10,32900956,0.8027156137472786,1555,978,2533,-
chr10,32900958,1.0663265306122451,989,629,1618,-
chr10,32900959,1.8378680500930142,1802,1074,2876,-
chr10,32900961,1.7497725711527394,1385,882,2267,-
chr10,32900967,1.5527428176282823,808,543,1351,-
chr10,32900972,0.4336901121304791,687,403,1090,-
chr10,32901518,1.3824357220217218,2993,2118,5111,-
chr10,32901529,1.4691837883429917,3569,2547,6116,-
chr10,32901532,1.515519334142535,1310,710,2020,-
chr10,32901537,1.7065092165898617,789,495,1284,-
chr10,32901541,1.5686098654708522,953,668,1621,-
chr10,32901546,1.6922722029988466,1047,764,1811,-
chr10,32901548,1.5869391559046733,768,517,1285,-
chr10,32901553,2.44756711409396,1166,595,1761,-
chr10,32901555,2.0808930434838233,2132,1106,3238,-
chr10,32901557,2.751213729253698,1082,520,1602,-
chr10,32901569,2.632027257240204,1029,586,1615,-
chr10,32901570,2.632027257240204,1029,586,1615,-
chr10,32911596,1.3830419644048677,2999,2371,5370,-
chr10,32912075,0.7223829513652522,2064,1871,3935,-
chr10,32912093,1.386302291617284,2947,2197,5144,-
chr10,32920059,1.952148354901463,2146,1688,3834,-
chr10,32922340,1.3667869682599632,4179,3041,7220,-
chr10,32923636,1.3591898528318238,2791,1746,4537,-
chr10,32923638,0.7597943552617774,2262,1764,4026,-
chr10,32923692,0.7838012541227248,3241,2395,5636,-
chr10,32925886,1.6218761603647915,5377,3765,9142,-
chr10,32928203,1.319927536231884,3642,2552,6194,-
chr10,32929864,1.3115718382539046,253417,188200,441617,-
chr10,32929866,1.2260558715117957,335257,251073,586330,-
chr10,32929867,1.1423544490988,167514,129520,297034,-
chr10,32929871,1.6064189200087142,24961,21403,46364,-
chr10,32929886,1.105828889655084,40710,24906,65616,-
chr10,32929888,1.0407191412632033,71821,48328,120149,-
chr10,32929898,1.3100017594651228,12999,9903,22902,-
chr10,32929918,1.1489698598932565,97681,69136,166817,-
chr10,32929919,1.1528386694628876,107710,75432,183142,-
chr10,32929920,1.1658022214941044,129226,91285,220511,-
chr10,32929921,1.0779858976195882,92379,64900,157279,-
chr10,32929954,1.5017364793892347,5908,4336,10244,-
chr10,32929983,1.3717811320754718,4226,2499,6725,-
chr10,32929996,1.3298309730470534,2664,2188,4852,-
chr10,32930005,1.728911319394376,2397,1880,4277,-
chr10,32932577,1.291549495379981,5516,4236,9752,-
chr10,32932584,1.6938149197355998,1721,1411,3132,-
chr10,32935521,1.4638724418347542,1567,1312,2879,-
chr10,32935526,1.451219512195122,1478,1188,2666,-
chr10,32935555,0.74152361600592,2461,1770,4231,-
chr10,32935557,1.6444444444444446,951,594,1545,-
chr10,32958160,2.1206928838951318,780,444,1224,-
chr10,32958196,1.0904276240165294,882,735,1617,-
chr10,33213489,6.981766249295924,6484,4232,10716,-
chr10,33213490,6.981766249295924,6484,4232,10716,-
chr10,33213501,2.120045623039635,1486,667,2153,-
chr10,33213503,2.120045623039635,1486,667,2153,-
chr10,33213504,2.2884979702300403,1207,738,1945,-
chr10,33213506,2.2884979702300403,1207,738,1945,-
chr10,33213515,1.2891741683944837,1069,528,1597,-
chr10,33213558,2.284375,730,319,1049,-
chr10,34331136,3.365937859608746,1169,947,2116,-
chr10,34331160,0.8895460358056266,1430,815,2245,-
chr10,34331161,1.1577556619770464,2199,1329,3528,-
chr10,34331188,1.8402366863905326,932,506,1438,-
chr10,34331190,1.8402366863905326,932,506,1438,-
chr10,35063048,3.3756597038321,612,420,1032,-
chr10,36522938,1.8180015255530129,700,436,1136,-
chr10,36522939,1.8180015255530129,700,436,1136,-
chr10,36523247,1.791094361234008,1081,766,1847,-
chr10,36523354,2.006593602423594,1125,773,1898,-
chr10,36523413,0.6050000000000001,582,423,1005,-
chr10,36523423,0.44989076464746763,808,474,1282,-
chr10,36523424,0.44989076464746763,808,474,1282,-
chr10,36523880,2.0718114874815905,616,484,1100,-
chr10,36523882,2.0718114874815905,616,484,1100,-
chr10,43386566,1.6242308138859862,1141,956,2097,-
chr10,43386637,0.5130780498012136,1225,1061,2286,-
chr10,43386696,2.1887824897400816,639,429,1068,-
chr10,43386718,2.0059875328083994,660,507,1167,-
chr10,43386801,2.0314733081126524,942,731,1673,-
chr10,43386979,1.7184801381692574,1591,1157,2748,-
chr10,43386989,0.6291479083413425,1950,1491,3441,-
chr10,43386991,1.126375298516881,2636,1936,4572,-
chr10,43387015,3.0639764486249734,1015,732,1747,-
chr10,43387033,1.6679447852760738,1304,977,2281,-
chr10,43387061,1.5683111954459203,1217,867,2084,-
chr10,43387120,1.9010560146923785,1182,659,1841,-
chr10,43387150,1.6451839785771603,1797,1092,2889,-
chr10,43387165,2.3577860169491527,613,471,1084,-
chr10,43387228,1.1945087637380838,2217,1426,3643,-
chr10,43387345,2.8244514106583067,847,637,1484,-
chr10,43387411,1.7861343790367912,5835,4343,10178,-
chr10,43387412,2.1121894215011845,3465,2772,6237,-
chr10,43387435,1.5374921235034658,1359,1057,2416,-
chr10,43387507,1.4118412491867274,1518,1112,2630,-
chr10,43387517,1.9790090771558244,896,660,1556,-
chr10,43387681,1.5017304438781598,1909,1382,3291,-
chr10,43387744,1.4735755242792414,1096,977,2073,-
chr10,43387801,1.4391751145674208,1268,757,2025,-
chr10,43387883,1.821493154223715,640,552,1192,-
chr10,43394685,0.5487996080352768,973,784,1757,-
chr10,43396480,1.2839683680805176,1367,855,2222,-
chr10,43396525,1.6092531623635418,752,596,1348,-
chr10,43396580,1.5784077211804162,1633,1188,2821,-
chr10,43396582,1.7258616153643778,655,542,1197,-
chr10,43396585,1.5559082892416227,801,539,1340,-
chr10,43407739,1.9379675236796507,652,443,1095,-
chr10,43407782,1.6888752541369965,752,432,1184,-
chr10,43407783,1.292792792792793,692,406,1098,-
chr10,43407784,1.292792792792793,692,406,1098,-
chr10,46005406,2.65393567498942,864,555,1419,-
chr10,46005731,1.714285714285714,759,524,1283,-
chr10,46005750,1.7139868499701139,739,477,1216,-
chr10,46005826,1.7796730632551527,625,535,1160,-
chr10,46005961,1.5854870775347911,1507,1005,2512,-
chr10,46006050,2.6475802702583553,886,701,1587,-
chr10,46006213,0.5300896286811779,620,567,1187,-
chr10,46006336,1.6563667851608788,648,476,1124,-
chr10,46009540,0.5616703539823009,676,451,1127,-
chr10,46009549,0.4742935564159137,728,508,1236,-
chr10,46010408,3.1683109118086703,756,445,1201,-
chr10,46010413,2.017132934508752,722,592,1314,-
chr10,46010660,1.8261964735516367,624,396,1020,-
chr10,46010661,0.6309772343175266,576,478,1054,-
chr10,46011150,2.242562929061785,734,436,1170,-
chr10,46011187,0.32927818329278186,608,410,1018,-
chr10,46013025,1.5027194807605262,1107,693,1800,-
chr10,46015218,2.3762081784386617,798,537,1335,-
chr10,46015224,3.705898491083676,613,404,1017,-
chr10,46015261,0.3985925404644616,943,579,1522,-
chr10,46015262,0.3509345414851968,1207,798,2005,-
chr10,46016638,3.97215777262181,641,430,1071,-
chr10,46016639,3.97215777262181,641,430,1071,-
chr10,50519871,3.2562191001746883,782,653,1435,-
chr10,51697470,0.18879069767441856,450,859,1309,-
chr10,51697471,0.18879069767441856,450,859,1309,-
chr10,51697474,0.24133811230585425,403,836,1239,-
chr10,51697475,0.2473304351496223,585,1246,1831,-
chr10,51697477,0.18327272727272728,377,824,1201,-
chr10,51697504,77.92753937061646,1161,1296,2457,-
chr10,51697505,78.46792489470295,1069,1068,2137,-
chr10,51698310,1.5521008168442099,1970,1571,3541,-
chr10,51698315,2.185555555555556,1404,1124,2528,-
chr10,51698316,1.4654070125576457,2410,1849,4259,-
chr10,51698321,2.6552287581699345,649,475,1124,-
chr10,51698344,0.4070149253731343,908,499,1407,-
chr10,51698345,0.4070149253731343,908,499,1407,-
chr10,51698415,1.266403909692196,592,415,1007,-
chr10,56357892,0.8506944444444445,594,543,1137,-
chr10,56357893,0.8506944444444445,594,543,1137,-
chr10,56357935,5.920300995922632,602,432,1034,-
chr10,63902454,0.3729672835716165,1118,876,1994,-
chr10,63902457,3.0079320467178814,859,592,1451,-
chr10,63902468,1.790725675235926,1078,877,1955,-
chr10,63902470,1.790725675235926,1078,877,1955,-
chr10,67805678,2.87133368958723,654,465,1119,-
chr10,67823326,0.4452816205533597,720,551,1271,-
chr10,67823389,1.7391650099403575,728,502,1230,-
chr10,67838012,1.9698331193838254,681,655,1336,-
chr10,67838025,1.7070135746606334,502,519,1021,-
chr10,67838065,1.8865624210337477,721,508,1229,-
chr10,67838094,0.3882544670837714,651,515,1166,-
chr10,67838126,1.1801712591842668,678,473,1151,-
chr10,67925157,3.0898526251065,796,546,1342,-
chr10,67955029,3.8362649294245386,802,613,1415,-
chr10,67955031,3.511533283382325,1076,786,1862,-
chr10,67988791,0.5761886631550573,1548,1021,2569,-
chr10,67988815,2.1526918202895344,1322,1097,2419,-
chr10,67988832,1.36727227131195,1219,910,2129,-
chr10,67990221,1.7251913833111099,1117,811,1928,-
chr10,67990235,0.35540540540540544,788,554,1342,-
chr10,67990236,0.8998101279823969,1152,808,1960,-
chr10,67990242,2.8936255720450825,963,619,1582,-
chr10,67990244,3.0396721922145646,679,412,1091,-
chr10,68544743,1.8299205143357458,852,522,1374,-
chr10,70116754,3.9522770691269855,690,525,1215,-
chr10,70150933,4.339441124945184,1152,806,1958,-
chr10,70152192,1.9198526498397541,783,596,1379,-
chr10,70161658,1.731432422676482,3757,2669,6426,-
chr10,70161659,2.017962884428109,2944,2095,5039,-
chr10,70161661,1.935927220672087,6701,4116,10817,-
chr10,70161662,1.8508444582972663,4486,2637,7123,-
chr10,70161663,2.0071086807928915,2446,1462,3908,-
chr10,70161901,2.6083876173175202,1101,760,1861,-
chr10,70203180,1.0496884048722086,2318,1929,4247,-
chr10,70204882,1.8700995973723247,705,571,1276,-
chr10,70204886,1.7291599821912274,1355,1065,2420,-
chr10,70204892,1.5651194672933804,1452,850,2302,-
chr10,70204893,1.5651194672933804,1452,850,2302,-
chr10,70204899,1.6561520643139394,656,357,1013,-
chr10,70204912,0.8154761904761905,958,440,1398,-
chr10,70204913,0.9617473758688583,1479,815,2294,-
chr10,70213573,1.6375572897312027,660,597,1257,-
chr10,70213574,0.6803840877914952,1239,809,2048,-
chr10,70214513,0.5604879139258035,939,739,1678,-
chr10,70214525,0.466000951022349,832,700,1532,-
chr10,70214526,0.4679529496868708,1086,887,1973,-
chr10,70214545,5.157739448531888,756,480,1236,-
chr10,70218793,1.6124233681932922,1714,1315,3029,-
chr10,70218799,1.6395859003443154,3163,2346,5509,-
chr10,70218800,1.7509904013652358,4255,3153,7408,-
chr10,70230353,1.7075035063113606,1872,1149,3021,-
chr10,70230392,0.6894043199880415,1152,901,2053,-
chr10,70230393,0.5717438699432078,816,700,1516,-
chr10,70230397,0.6584462219520073,911,720,1631,-
chr10,70233311,0.5541322314049587,744,604,1348,-
chr10,70233314,1.7029514083716757,606,468,1074,-
chr10,70233325,0.8820005989817311,1177,953,2130,-
chr10,70233327,0.8820005989817311,1177,953,2130,-
chr10,70233363,0.46913976767838983,625,478,1103,-
chr10,70233364,0.46913976767838983,625,478,1103,-
chr10,71816366,1.696259029927761,1528,1519,3047,-
chr10,71816465,9.239976402663734,25138,16702,41840,-
chr10,71816466,9.239976402663734,25138,16702,41840,-
chr10,71816467,9.239976402663734,25138,16702,41840,-
chr10,71816735,0.5788490241647484,12925,17350,30275,-
chr10,71816737,0.5932398240160563,18916,25534,44450,-
chr10,71816738,0.6468370711190654,12223,16658,28881,-
chr10,71816747,14.741305080454861,37208,50902,88110,-
chr10,71816748,14.741305080454861,37208,50902,88110,-
chr10,71816754,20.193333284288883,50910,26944,77854,-
chr10,71816755,20.792769326020718,54589,27724,82313,-
chr10,71816756,20.715698869048804,46480,21135,67615,-
chr10,71816757,5.886497064579254,11185,2554,13739,-
chr10,71816763,5.795402735562309,10168,1959,12127,-
chr10,71816764,4.077116433002851,32036,6420,38456,-
chr10,71816765,3.5150492429317977,16788,3511,20299,-
chr10,71816766,3.79710362734286,34942,7365,42307,-
chr10,71816987,1.2177581327977425,4796,3997,8793,-
chr10,71817027,1.553914436610268,11024,7891,18915,-
chr10,71817092,1.3741708934841979,3521,2562,6083,-
chr10,71817256,1.9099227295288441,12079,8932,21011,-
chr10,71817420,1.26914082983958,10669,7610,18279,-
chr10,71818722,1.417315444273651,7204,5358,12562,-
chr10,71819076,1.4045612412931197,11936,9024,20960,-
chr10,71819542,1.1768753429459822,5910,3775,9685,-
chr10,71819543,1.2401972673619532,4247,3533,7780,-
chr10,71819576,1.3195500152021888,6075,4927,11002,-
chr10,71819577,1.3195500152021888,6075,4927,11002,-
chr10,71819614,0.7726843670378492,3511,2803,6314,-
chr10,71820289,1.197869371663972,5594,4400,9994,-
chr10,71820336,1.0124147630801452,873,692,1565,-
chr10,71821915,1.2833599864494085,9962,7313,17275,-
chr10,71821916,1.2448149778461794,3854,3496,7350,-
chr10,71821990,0.7965855059972706,4582,2974,7556,-
chr10,71825864,1.3024433877666548,9962,7201,17163,-
chr10,71825885,0.8271706145460298,5661,4388,10049,-
chr10,71825888,0.8268553075952975,9837,7891,17728,-
chr10,71825889,0.8268553075952975,9837,7891,17728,-
chr10,71828062,1.4816618399894659,7403,5762,13165,-
chr10,71828125,1.4445999563425314,4017,3313,7330,-
chr10,71828154,1.4137097413483082,15021,10455,25476,-
chr10,71828155,1.4137097413483082,15021,10455,25476,-
chr10,71828980,1.4091252197435045,11461,8907,20368,-
chr10,71829024,1.640225685849395,3881,3082,6963,-
chr10,71829027,1.2624115156110838,7947,5636,13583,-
chr10,71829037,1.5564601083777885,3103,2137,5240,-
chr10,71831246,1.280148954454311,4222,3490,7712,-
chr10,71831919,1.3489875705260148,9167,6581,15748,-
chr10,71834396,1.1237229439361185,13357,9335,22692,-
chr10,71834405,1.2849490236737515,3431,2571,6002,-
chr10,71834413,1.336875044630719,9896,6738,16634,-
chr10,71834444,1.1865539644438607,7926,6053,13979,-
chr10,71834476,1.127487685961289,8514,6555,15069,-
chr10,71834477,1.2044387415678655,21706,16421,38127,-
chr10,71834478,1.2356704454479972,22943,18022,40965,-
chr10,71834479,1.2626616576987513,22216,17291,39507,-
chr10,71834480,1.273229766135877,16770,12933,29703,-
chr10,71834481,1.4370382647037157,12380,8142,20522,-
chr10,71834482,1.0795693687182186,7691,4702,12393,-
chr10,71834485,1.937644313436502,1996,1379,3375,-
chr10,71834489,1.5597478991596636,1613,1274,2887,-
chr10,71851220,1.691334397138497,4006,2528,6534,-
chr10,71851234,1.2818908585331945,1843,1232,3075,-
chr10,71851248,0.921928641518249,5134,3299,8433,-
chr10,71851249,0.9065438215199971,3648,2455,6103,-
chr10,71851251,0.995681571025548,1329,946,2275,-
chr10,71851272,1.4976008480923269,879,691,1570,-
chr10,71851284,0.46981481703822076,759,503,1262,-
chr10,72161637,1.3973385539387515,1223,1053,2276,-
chr10,72161638,1.8758548632218845,680,657,1337,-
chr10,72196871,3.45844364265209,707,460,1167,-
chr10,72213244,3.1387896291100073,676,460,1136,-
chr10,72477237,1.4912442603310383,778,546,1324,-
chr10,73007771,0.6187350835322196,609,418,1027,-
chr10,73053368,2.5763779527559056,817,634,1451,-
chr10,73053369,2.5763779527559056,817,634,1451,-
chr10,73073785,0.3962196001856192,1492,1422,2914,-
chr10,73073800,0.4509322033898305,625,589,1214,-
chr10,73073811,2.454595544555337,1081,927,2008,-
chr10,73074817,2.482996957905965,965,815,1780,-
chr10,73242947,0.38083510429638506,987,742,1729,-
chr10,73243152,14.676492814060452,1796,1110,2906,-
chr10,73243153,16.316739561686486,1457,963,2420,-
chr10,73243363,2.3186208846166245,859,602,1461,-
chr10,73243431,3.7786866090208004,702,388,1090,-
chr10,73243432,3.7786866090208004,702,388,1090,-
chr10,73243513,2.9757619314100614,910,553,1463,-
chr10,73246149,1.5147852846059386,784,493,1277,-
chr10,73250897,1.5833067856005096,1064,656,1720,-
chr10,73250979,1.5210792580101182,778,592,1370,-
chr10,73251849,0.5153807988092285,830,555,1385,-
chr10,73251875,1.883395651571804,849,497,1346,-
chr10,73251941,1.6077922077922078,618,384,1002,-
chr10,73251957,2.882358999444019,781,491,1272,-
chr10,73252624,1.2077471359589393,569,508,1077,-
chr10,73376159,1.9160324708269911,580,437,1017,-
chr10,73378977,2.042207792207792,628,447,1075,-
chr10,73379933,0.39909440796921,677,630,1307,-
chr10,73379948,2.351618398637138,608,586,1194,-
chr10,73380088,1.4276716234087194,1785,1306,3091,-
chr10,73380157,1.5956830744932875,865,654,1519,-
chr10,73380166,1.8383561643835615,731,583,1314,-
chr10,73380179,3.150439793751896,610,470,1080,-
chr10,73383236,1.746891747052519,880,621,1501,-
chr10,73383294,1.5955223880597014,1068,803,1871,-
chr10,73383300,0.5880827335797186,906,581,1487,-
chr10,73383324,1.8070893505289982,779,562,1341,-
chr10,73383646,2.0297218741367176,1918,1318,3236,-
chr10,73387705,1.8793079584775085,875,577,1452,-
chr10,73387737,3.4810878399499843,695,456,1151,-
chr10,73387778,1.6716507177033493,644,417,1061,-
chr10,73414053,1.0668300225750147,1249,1020,2269,-
chr10,73422284,1.6953221535745808,685,514,1199,-
chr10,73422285,1.9501176470588235,591,424,1015,-
chr10,73422286,1.9501176470588235,591,424,1015,-
chr10,73471500,1.9553727250062327,1011,572,1583,-
chr10,73471537,0.946836038579158,804,544,1348,-
chr10,73471539,1.2473769490264828,1173,800,1973,-
chr10,73471540,0.9471516815374056,758,516,1274,-
chr10,73812721,0.5025462342535513,624,454,1078,-
chr10,74121941,1.8625187092215516,623,444,1067,-
chr10,74122606,2.692292907937728,823,472,1295,-
chr10,74122607,1.9616320778700858,1123,736,1859,-
chr10,74122782,1.148912642910763,583,435,1018,-
chr10,74122987,3.4824094735892106,685,497,1182,-
chr10,74134054,0.4468636631546816,643,478,1121,-
chr10,75400360,1.6506620972795547,1702,1274,2976,-
chr10,75400367,1.1650838320789079,1069,749,1818,-
chr10,77841917,1.8252319561915948,2007,1528,3535,-
chr10,77841918,2.095332462657744,3954,2776,6730,-
chr10,77841920,1.9538650444665076,3871,2645,6516,-
chr10,77841921,2.023204365079365,1870,1343,3213,-
chr10,77841927,1.8378708574859295,1298,788,2086,-
chr10,77841966,1.7704541567247456,738,402,1140,-
chr10,77842016,6.834637195968832,691,436,1127,-
chr10,80157757,1.1657634269774866,885,580,1465,-
chr10,80158023,1.38911704312115,659,486,1145,-
chr10,80158024,1.553334190892116,872,636,1508,-
chr10,80159143,2.7508797038545847,694,498,1192,-
chr10,80164111,0.6086798839458414,529,516,1045,-
chr10,80166179,1.591967579991532,657,500,1157,-
chr10,80166916,0.45657894736842103,693,493,1186,-
chr10,80166936,1.9549549549549547,650,443,1093,-
chr10,80166941,1.7217479909617481,787,685,1472,-
chr10,80166965,2.7032948327386745,906,577,1483,-
chr10,80167235,1.112728543146617,636,553,1189,-
chr10,80167236,1.556742332262406,1192,844,2036,-
chr10,86499988,2.4505552617662607,661,426,1087,-
chr10,86499989,0.45666356011183595,769,406,1175,-
chr10,86499990,1.4148246033029765,1430,832,2262,-
chr10,87050696,0.5084512578616353,596,476,1072,-
chr10,87050928,1.7522269104547583,597,473,1070,-
chr10,87051168,2.1060299819969535,1388,952,2340,-
chr10,87051170,2.1976656626506026,897,663,1560,-
chr10,87051500,0.5701836290071585,686,458,1144,-
chr10,87051670,2.088340763713898,844,736,1580,-
chr10,87051671,2.088340763713898,844,736,1580,-
chr10,87051843,2.730829826180828,1105,880,1985,-
chr10,87051845,2.8403465346534653,809,605,1414,-
chr10,87057703,0.7953914003878186,797,579,1376,-
chr10,87062740,3.4892631747062133,639,388,1027,-
chr10,87753274,2.0027527682501094,4947,4151,9098,-
chr10,87753275,1.6242822050939423,5730,4761,10491,-
chr10,87753316,1.6856566011235958,1037,711,1748,-
chr10,87753598,2.6131687242798347,888,503,1391,-
chr10,87753599,2.665860957642725,1310,723,2033,-
chr10,87753601,3.301587301587302,857,461,1318,-
chr10,87753612,2.064430819243394,783,488,1271,-
chr10,87753852,1.8643031784841075,609,408,1017,-
chr10,87753922,1.5776930776930778,952,665,1617,-
chr10,87754147,3.1815696993361966,678,393,1071,-
chr10,87754235,1.1333333333333335,798,704,1502,-
chr10,87754236,1.984986963084946,1127,955,2082,-
chr10,87754413,1.6536293164200142,721,472,1193,-
chr10,87754506,0.47685707834725666,703,411,1114,-
chr10,87754666,1.7151465733264388,1690,1621,3311,-
chr10,87754691,1.5416289100728553,1371,1173,2544,-
chr10,87754744,1.6371829105473965,1089,855,1944,-
chr10,87754747,2.1591469490041364,2004,1482,3486,-
chr10,87754748,2.1591469490041364,2004,1482,3486,-
chr10,87754751,2.2013541251736144,1727,1140,2867,-
chr10,87754777,1.6222222222222222,729,449,1178,-
chr10,87754791,1.7281728172817281,639,403,1042,-
chr10,87756865,2.0844759977911087,1019,814,1833,-
chr10,87756898,2.5563909774436087,679,433,1112,-
chr10,87756899,2.5563909774436087,679,433,1112,-
chr10,87756919,1.234810545737766,821,523,1344,-
chr10,87776376,1.8535714285714282,691,447,1138,-
chr10,87784541,1.6082091765772197,1625,1130,2755,-
chr10,87784547,1.9771105094757568,553,477,1030,-
chr10,87784593,2.1666666666666665,935,527,1462,-
chr10,87784594,2.1666666666666665,935,527,1462,-
chr10,87790382,1.7024074074074076,633,539,1172,-
chr10,87792677,1.5472385428907167,1196,850,2046,-
chr10,87792700,1.1580360057666417,1780,1435,3215,-
chr10,87792735,1.7989130434782608,661,463,1124,-
chr10,87792743,1.7754189944134076,680,536,1216,-
chr10,87814476,4.267968056787933,554,482,1036,-
chr10,87814579,0.3547817715019255,736,491,1227,-
chr10,87814601,1.9966277862416344,865,637,1502,-
chr10,87814608,0.911842105263158,566,455,1021,-
chr10,87814610,0.911842105263158,566,455,1021,-
chr10,89214450,1.1079545454545454,584,439,1023,-
chr10,89214452,1.1079545454545454,584,439,1023,-
chr10,91807316,1.5326516700749833,1021,814,1835,-
chr10,91807395,1.5693753454947486,667,602,1269,-
chr10,91807428,1.76781515061257,686,431,1117,-
chr10,93306821,0.3957438865036401,635,486,1121,-
chr10,93310157,2.9313380281690145,665,496,1161,-
chr10,93310159,2.9313380281690145,665,496,1161,-
chr10,93313040,3.0672699849170435,655,509,1164,-
chr10,93313041,3.0672699849170435,655,509,1164,-
chr10,93316754,1.7243409729142132,809,580,1389,-
chr10,93323086,1.9950387122279283,926,786,1712,-
chr10,93323158,2.2942946666841646,605,436,1041,-
chr10,93323298,1.3511111111111112,607,449,1056,-
chr10,93323300,1.3511111111111112,607,449,1056,-
chr10,93329801,3.52,975,609,1584,-
chr10,93329803,2.0577179028220307,2547,1715,4262,-
chr10,93329804,2.2295280265755233,1375,885,2260,-
chr10,93333280,0.5896917325488753,565,440,1005,-
chr10,93333282,2.0139322742630412,772,687,1459,-
chr10,93333767,1.986492374727669,581,458,1039,-
chr10,93333768,2.2791067213741587,1319,1069,2388,-
chr10,93333770,2.7170531674208145,1097,883,1980,-
chr10,93333771,3.8028169014084505,719,567,1286,-
chr10,93333844,0.9918774148226203,778,583,1361,-
chr10,93333845,0.9918774148226203,778,583,1361,-
chr10,93336016,0.4701918503250357,658,370,1028,-
chr10,93349865,3.803563967007161,848,602,1450,-
chr10,93356692,0.4677272727272728,1028,759,1787,-
chr10,93356693,0.4629516732651931,1448,1047,2495,-
chr10,93356695,2.282426854267043,920,662,1582,-
chr10,93356732,3.1897557497363827,1277,916,2193,-
chr10,93359946,2.8980465578247143,916,576,1492,-
chr10,93361473,2.0214729794356767,982,696,1678,-
chr10,93361475,2.1178643124364775,1408,959,2367,-
chr10,93361550,2.92105068349033,704,461,1165,-
chr10,93366417,3.0310933699530658,848,624,1472,-
chr10,93366548,1.995376003893892,910,586,1496,-
chr10,93366549,1.995376003893892,910,586,1496,-
chr10,93372967,2.615810327762016,683,470,1153,-
chr10,93373050,2.8374543899877684,645,479,1124,-
chr10,93374826,2.1453515156679845,755,527,1282,-
chr10,93374877,2.2821930503891226,2786,2157,4943,-
chr10,93374893,1.6185925863944441,2358,1614,3972,-
chr10,93374905,1.7353265996735134,4082,2266,6348,-
chr10,93374906,1.5880557445101426,5989,3294,9283,-
chr10,93374908,1.5868934599156117,3914,2132,6046,-
chr10,93377338,0.7536098098649766,3294,1899,5193,-
chr10,93377339,1.1133883995277263,6147,3753,9900,-
chr10,93377340,1.2010630334269492,7491,4611,12102,-
chr10,93377342,1.57326423018497,2750,1766,4516,-
chr10,93377345,1.4655232568815764,1246,766,2012,-
chr10,93377352,1.9115890083632021,959,650,1609,-
chr10,93387841,0.5171410499683745,583,464,1047,-
chr10,93389151,1.8225206333026087,584,444,1028,-
chr10,93396172,2.4503733772286553,904,706,1610,-
chr10,93397434,1.9974564053462198,1213,847,2060,-
chr10,93399464,1.2401318979730385,672,490,1162,-
chr10,93399466,1.2401318979730385,672,490,1162,-
chr10,93402262,1.666577825159915,1520,1205,2725,-
chr10,93402263,1.666577825159915,1520,1205,2725,-
chr10,93408874,2.1227876436922064,662,434,1096,-
chr10,93409591,0.8452246049348852,810,623,1433,-
chr10,93482162,2.461547709151655,823,628,1451,-
chr10,93959517,0.7952064938973933,2499,1837,4336,-
chr10,93959518,1.0078138980017894,1407,957,2364,-
chr10,93960594,1.853603603603604,822,702,1524,-
chr10,93960598,1.4964680084579842,1425,1129,2554,-
chr10,93960599,0.6972174651574009,2064,1067,3131,-
chr10,93960600,1.0065145837688627,3865,2413,6278,-
chr10,93960606,1.8273602008088128,1007,706,1713,-
chr10,93960608,1.8273602008088128,1007,706,1713,-
chr10,93960620,0.9550850975508508,718,364,1082,-
chr10,93960621,1.1915979914252326,953,506,1459,-
chr10,93960623,1.1775859573863867,1389,851,2240,-
chr10,93960624,0.2554308904273096,748,496,1244,-
chr10,93961077,0.7703269730919501,800,523,1323,-
chr10,93961079,0.8920185274603432,626,400,1026,-
chr10,94337870,2.668976148889576,1299,775,2074,-
chr10,94352368,1.6099416910540558,1513,1194,2707,-
chr10,94352383,2.5976827094474153,1234,934,2168,-
chr10,94352384,2.5976827094474153,1234,934,2168,-
chr10,94352392,0.9803200666808068,1614,1087,2701,-
chr10,94352394,0.5701694154585348,1629,1228,2857,-
chr10,94352397,1.8995493358633775,842,495,1337,-
chr10,94352398,1.8995493358633775,842,495,1337,-
chr10,94352400,4.138888940236886,878,715,1593,-
chr10,95247294,2.157344421018293,741,663,1404,-
chr10,95247295,0.7410179640718563,539,500,1039,-
chr10,95247310,1.032783132359546,645,532,1177,-
chr10,95271712,1.5552460716505125,702,440,1142,-
chr10,95606055,2.073440285204991,726,560,1286,-
chr10,95610223,4.5372262773722625,776,547,1323,-
chr10,95614015,0.4244468513778635,761,552,1313,-
chr10,95614104,0.48507766585484924,940,653,1593,-
chr10,95621135,3.141446949413681,619,442,1061,-
chr10,95621209,3.3312361433669575,608,486,1094,-
chr10,95627455,1.5189570437077222,943,623,1566,-
chr10,95627543,1.5410589975837734,784,615,1399,-
chr10,95633046,0.4047777040477771,731,410,1141,-
chr10,95633047,0.4047777040477771,731,410,1141,-
chr10,95637405,0.3550942365473915,649,522,1171,-
chr10,95637407,0.3550942365473915,649,522,1171,-
chr10,95653362,1.2906064126505592,798,508,1306,-
chr10,96521132,8.730009868725503,1794,1343,3137,-
chr10,96521314,2.0177794771304307,2221,1714,3935,-
chr10,96521319,1.92291109425526,3931,2707,6638,-
chr10,96521321,1.92291109425526,3931,2707,6638,-
chr10,96521341,6.0583816361661365,6834,4189,11023,-
chr10,96521360,1.7958288593073026,3760,2103,5863,-
chr10,96521362,1.6854277527629962,2439,1395,3834,-
chr10,96521407,0.5809118236472945,772,498,1270,-
chr10,96521424,1.3586752784726603,1392,854,2246,-
chr10,96521644,1.5298485730926032,1105,807,1912,-
chr10,96527240,2.100577657862884,1606,1119,2725,-
chr10,96527241,2.0332795482049213,1185,803,1988,-
chr10,96544179,2.494178256433217,831,571,1402,-
chr10,96562034,2.2623990182782094,2458,1556,4014,-
chr10,96562118,1.7076836016096584,822,567,1389,-
chr10,96576718,1.9897686701358845,895,654,1549,-
chr10,97677561,1.8752377329783183,679,477,1156,-
chr10,97677601,1.9050000000000002,634,499,1133,-
chr10,97677940,3.4299065420560737,733,534,1267,-
chr10,97677942,3.4299065420560737,733,534,1267,-
chr10,97677977,3.1984361889217117,835,603,1438,-
chr10,97686932,1.4995111357231325,1037,799,1836,-
chr10,97687154,4.56408345752608,874,487,1361,-
chr10,97687156,5.283495806113767,727,440,1167,-
chr10,99397409,1.0455580865603644,764,438,1202,-
chr10,99397410,1.0455580865603644,764,438,1202,-
chr10,99397658,4.463773645423082,744,516,1260,-
chr10,99402718,2.318799263150658,708,562,1270,-
chr10,99405809,2.2333432523031376,606,455,1061,-
chr10,99899969,1.856902985074627,806,669,1475,-
chr10,99899970,1.6878306878306883,1187,728,1915,-
chr10,99899972,1.7646776046175412,2285,1533,3818,-
chr10,99899981,2.6185106859367986,839,574,1413,-
chr10,100150974,0.28720701627889156,933,662,1595,-
chr10,100151288,1.852978681982693,722,509,1231,-
chr10,100183805,2.8552486187845303,645,361,1006,-
chr10,100183806,2.8552486187845303,645,361,1006,-
chr10,100183828,0.7193609603248157,651,580,1231,-
chr10,100185582,3.1275958017679675,1366,951,2317,-
chr10,100185583,2.8991637045532586,1079,787,1866,-
chr10,100280946,2.0738000293247296,2157,1322,3479,-
chr10,100280954,1.9311888719843517,1505,1069,2574,-
chr10,100280955,1.9311888719843517,1505,1069,2574,-
chr10,100280973,2.150528750826173,684,355,1039,-
chr10,100280982,0.6313846153846154,911,519,1430,-
chr10,100281020,2.512084649861536,962,594,1556,-
chr10,100523807,2.067934782608696,760,643,1403,-
chr10,100523891,2.080301805443277,1350,1236,2586,-
chr10,100523905,1.5285049936645718,3663,2662,6325,-
chr10,100523909,1.8319469559975894,1571,1105,2676,-
chr10,100523926,2.001,689,499,1188,-
chr10,100526443,0.6955767846626971,1118,898,2016,-
chr10,100526486,1.868726532979829,1451,1144,2595,-
chr10,100526515,1.8413618254255704,655,501,1156,-
chr10,100526525,2.2570459290187888,557,478,1035,-
chr10,100526526,1.2007418479482936,1266,806,2072,-
chr10,100526534,1.7586255456977888,891,525,1416,-
chr10,100526990,1.9584849975405805,710,534,1244,-
chr10,100526994,0.5680579773321709,694,495,1189,-
chr10,100527066,1.8857428381079282,628,473,1101,-
chr10,100529425,0.4061112641988917,828,572,1400,-
chr10,100529434,0.5232091945830364,782,487,1269,-
chr10,100529454,1.0848241945477075,1302,806,2108,-
chr10,100529455,1.2551632245169886,1883,1158,3041,-
chr10,100529457,0.9266047297297295,1218,739,1957,-
chr10,100529868,1.3021181716833892,583,574,1157,-
chr10,100987131,2.8180507223018934,793,567,1360,-
chr10,100987156,1.9257286586276954,636,461,1097,-
chr10,101781463,0.4161819554670246,1435,1784,3219,-
chr10,101781464,0.35300714556725143,1887,2859,4746,-
chr10,101781465,0.36677686914648167,1674,2470,4144,-
chr10,101781512,2.9148411388115103,658,877,1535,-
chr10,101781519,15.546202047195258,2198,2017,4215,-
chr10,101781520,17.84583286674163,3035,2115,5150,-
chr10,101781522,16.766895007149074,3328,371,3699,-
chr10,101781523,24.716556056593976,3668,287,3955,-
chr10,101781524,25.978728730873136,4397,315,4712,-
chr10,101781525,33.59530300326806,3473,187,3660,-
chr10,101781526,30.194641599092545,2640,114,2754,-
chr10,101781527,31.620027363623738,1816,79,1895,-
chr10,101781757,2.2948718702430715,656,437,1093,-
chr10,101782280,1.1601617247765652,964,642,1606,-
chr10,101782316,2.216943231441048,667,457,1124,-
chr10,101782318,2.216943231441048,667,457,1124,-
chr10,101782325,2.247170344637452,678,444,1122,-
chr10,101782553,2.8363526570048307,670,413,1083,-
chr10,101782555,3.18686284788201,975,648,1623,-
chr10,102108234,0.35541934729462943,558,521,1079,-
chr10,102108241,0.41873301703575894,603,611,1214,-
chr10,102108274,7.515689512799339,500,518,1018,-
chr10,102108275,7.515689512799339,500,518,1018,-
chr10,102423558,2.636942611549025,741,478,1219,-
chr10,102424061,3.1842542881592792,630,409,1039,-
chr10,102424140,2.7343357514866398,800,599,1399,-
chr10,102485704,0.7265682782035345,729,543,1272,-
chr10,102699391,2.721905048076924,670,511,1181,-
chr10,102699418,1.6092129667174206,1136,857,1993,-
chr10,103392393,1.2966520228558305,2440,1481,3921,-
chr10,103392399,1.6386955415784688,3157,1879,5036,-
chr10,103392404,1.4630404135338344,1753,1329,3082,-
chr10,103392463,1.6645091316212999,1729,921,2650,-
chr10,103396441,1.6829714467509742,1057,761,1818,-
chr10,103396451,0.6919787881035377,2317,1111,3428,-
chr10,103396452,0.6589842992152255,5023,3286,8309,-
chr10,103396453,0.5330318657405663,2131,1842,3973,-
chr10,103396455,0.4377759381898455,500,603,1103,-
chr10,103396461,1.7527571406793374,632,490,1122,-
chr10,103600849,4.752507552893682,405,669,1074,-
chr10,103602486,2.570744680851064,715,469,1184,-
chr10,103900179,2.280573543015726,1384,1174,2558,-
chr10,103900181,1.9710708728573785,2445,1941,4386,-
chr10,103900183,1.9387287024901705,1951,1525,3476,-
chr10,103900185,1.583545923032016,1637,1231,2868,-
chr10,103900192,1.6769409704501745,1041,721,1762,-
chr10,104313312,1.748163983574216,600,461,1061,-
chr10,104313313,1.5851947937736348,600,496,1096,-
chr10,104313700,3.9324148381622015,664,466,1130,-
chr10,104314120,2.5174211617057076,752,569,1321,-
chr10,104314139,1.2310698583292623,719,533,1252,-
chr10,104314141,1.2310698583292623,719,533,1252,-
chr10,109868701,1.9859841583452733,751,542,1293,-
chr10,109868702,1.4795672076570954,612,444,1056,-
chr10,109868703,1.4795672076570954,612,444,1056,-
chr10,109884140,1.5989227942333826,611,428,1039,-
chr10,110298770,2.258002997040296,594,462,1056,-
chr10,110303514,1.8240645783453047,599,457,1056,-
chr10,110900447,2.5673912323929002,710,521,1231,-
chr10,112438381,2.3447281472671864,735,412,1147,-
chr10,112442211,2.554768341568006,944,630,1574,-
chr10,112442213,2.554768341568006,944,630,1574,-
chr10,114433002,1.1915735394656544,5267,3432,8699,-
chr10,114433003,1.1014991768978473,4173,2566,6739,-
chr10,114433033,0.5666005492828806,1060,677,1737,-
chr10,114433034,2.494243122045813,1371,891,2262,-
chr10,114433035,2.3888568516052664,1793,1189,2982,-
chr10,114433056,1.6976146788990825,770,435,1205,-
chr10,116921456,2.37625250501002,557,498,1055,-
chr10,116921458,2.37625250501002,557,498,1055,-
chr10,116940508,2.158874730796841,1118,795,1913,-
chr10,116940509,1.8026982503652684,2085,1415,3500,-
chr10,116940511,2.024966078697422,1091,736,1827,-
chr10,117873739,0.9825507590883116,874,449,1323,-
chr10,118730381,3.1230561234033463,605,547,1152,-
chr10,118754416,0.6623819025954368,1163,714,1877,-
chr10,118754418,2.0922105962464705,817,668,1485,-
chr10,118754419,1.9594594594594597,1184,947,2131,-
chr10,118754421,1.8710421925712224,762,589,1351,-
chr10,118754430,2.0288915094339623,650,370,1020,-
chr10,118754431,2.355305397568464,825,480,1305,-
chr10,118872338,1.317189447444952,1280,1159,2439,-
chr10,118872339,1.5223062719637857,1965,1466,3431,-
chr10,118872346,0.6373759517036358,5057,4378,9435,-
chr10,118872347,1.0224861852910387,6423,5004,11427,-
chr10,118872348,0.8285632087044796,13332,10963,24295,-
chr10,118872349,1.03170355627179,8209,6387,14596,-
chr10,118872350,0.8381612680354295,6068,4843,10911,-
chr10,118872351,1.55465798704803,2059,1743,3802,-
chr10,118872352,1.2598066530297758,3228,2484,5712,-
chr10,118872356,1.415983606557377,690,487,1177,-
chr10,118872357,1.576866657662213,1364,1114,2478,-
chr10,118872358,2.1105417276720346,960,682,1642,-
chr10,118872360,1.7500889046941683,634,591,1225,-
chr10,119035343,1.6912286359238955,616,442,1058,-
chr10,119035738,2.1234025559105434,817,625,1442,-
chr10,119035739,2.1646354985294183,1064,770,1834,-
chr10,119035740,2.289306104523496,718,505,1223,-
chr10,119036005,1.9030579643998173,1302,938,2240,-
chr10,119036050,0.8942020665901264,1262,1004,2266,-
chr10,119036051,0.8942020665901264,1262,1004,2266,-
chr10,119036108,2.3561878109452734,865,535,1400,-
chr10,119036240,0.6082718776550552,1720,1176,2896,-
chr10,119036242,0.7795982242662323,2440,1703,4143,-
chr10,119036243,0.8661992123715301,1502,1076,2578,-
chr10,119036245,3.1767109295199183,621,444,1065,-
chr10,119037136,1.6487603305785126,664,549,1213,-
chr10,119037225,2.3791116552603095,2326,1518,3844,-
chr10,119037268,1.63239192029979,759,520,1279,-
chr10,119037276,1.8468665551409087,623,408,1031,-
chr10,119038369,2.329218028742162,6201,4412,10613,-
chr10,119038371,2.329218028742162,6201,4412,10613,-
chr10,119038386,1.5146087763781069,4977,3101,8078,-
chr10,119038412,1.7221476259744135,1678,992,2670,-
chr10,119038417,2.064792722934685,1628,957,2585,-
chr10,119038419,1.602660373310448,1659,947,2606,-
chr10,119038420,1.802511847354897,5662,3662,9324,-
chr10,119038421,1.8002956427742782,7416,4720,12136,-
chr10,119038422,1.8002956427742782,7416,4720,12136,-
chr10,119038423,1.8001062485387125,5454,3412,8866,-
chr10,119038426,1.6977459016393441,1656,975,2631,-
chr10,119042058,2.0559202528567955,603,456,1059,-
chr10,119042094,1.1425681909180119,886,688,1574,-
chr10,119042138,1.828472739064225,690,585,1275,-
chr10,119042296,1.7529378442807722,662,457,1119,-
chr10,119042354,4.57196029776675,669,402,1071,-
chr10,119042355,3.2697368421052637,993,591,1584,-
chr10,119042357,3.019519597213893,1403,903,2306,-
chr10,119042358,3.6892620232172475,961,535,1496,-
chr10,119044072,1.8672083374493726,1542,763,2305,-
chr10,119044085,2.9672511603919554,932,553,1485,-
chr10,119044100,1.6758974358974361,816,449,1265,-
chr10,119049817,1.3597409443482191,6343,3793,10136,-
chr10,119049818,1.6286638139236804,9332,6023,15355,-
chr10,119049827,1.6131099802019755,5314,3648,8962,-
chr10,119049828,1.6131099802019755,5314,3648,8962,-
chr10,119049832,1.6441948019456567,4634,2886,7520,-
chr10,119049867,1.7315289257398843,2374,1438,3812,-
chr10,119049892,1.2509162301295524,2738,1647,4385,-
chr10,119049912,1.7515243902439026,765,491,1256,-
chr10,119049930,2.0411960132890363,767,429,1196,-
chr10,119049954,0.6352807714123653,767,491,1258,-
chr10,119050654,1.5607369423317388,2566,1778,4344,-
chr10,119050656,2.553011828935396,2191,2197,4388,-
chr10,119050660,1.6534162303664919,2053,1909,3962,-
chr10,119050665,2.0654139032178827,3577,2949,6526,-
chr10,119050666,2.0654139032178827,3577,2949,6526,-
chr10,119051226,1.6201495726495727,1242,935,2177,-
chr10,119051285,1.7246456692913383,1042,634,1676,-
chr10,119051297,1.9999112688553677,682,489,1171,-
chr10,119051314,1.507218045112782,770,524,1294,-
chr10,119051315,2.3676171079429733,774,490,1264,-
chr10,119056999,1.6586898987371768,3024,2530,5554,-
chr10,119057002,1.7357233291130807,1183,1046,2229,-
chr10,119057003,1.6281108694901798,1407,1072,2479,-
chr10,119057016,1.4762878983120236,2649,1774,4423,-
chr10,119058034,0.6329327992879396,1093,748,1841,-
chr10,119058070,2.9342881213142373,1246,1186,2432,-
chr10,119058071,2.3207085579899314,3419,2972,6391,-
chr10,119058073,2.0711856409228835,2793,2359,5152,-
chr10,119058196,1.9611528822055135,625,503,1128,-
chr10,119059349,1.7788461538461537,774,519,1293,-
chr10,119059354,0.6417729204614451,754,548,1302,-
chr10,119059631,3.0337309749074453,589,441,1030,-
chr10,119059676,1.679023038281656,717,501,1218,-
chr10,119059706,1.9261744966442949,614,446,1060,-
chr10,119059708,0.2892344497607656,805,759,1564,-
chr10,119059710,0.2892344497607656,805,759,1564,-
chr10,119060773,1.3541803433484114,2762,1837,4599,-
chr10,119060774,1.2640092328256738,4262,3203,7465,-
chr10,119060775,1.3541803433484114,2762,1837,4599,-
chr10,119060777,1.7914854582817332,1370,1233,2603,-
chr10,119060782,1.5124210300888747,688,565,1253,-
chr10,119060816,1.901496259351621,609,400,1009,-
chr10,119065446,2.6197429906542054,584,427,1011,-
chr10,119065449,1.121840963081259,1516,1112,2628,-
chr10,119065471,2.4310018903591684,642,528,1170,-
chr10,119069512,1.6885179483024064,905,601,1506,-
chr10,119069536,0.6344696969696969,937,703,1640,-
chr10,119069630,2.5911474087517647,828,521,1349,-
chr10,119071048,2.219005273498087,739,508,1247,-
chr10,119072931,0.555013611615245,698,463,1161,-
chr10,119073463,0.5654059973045822,1073,741,1814,-
chr10,119073535,0.91990171990172,935,813,1748,-
chr10,119073536,0.91990171990172,935,813,1748,-
chr10,119073561,2.133103787857029,1205,849,2054,-
chr10,119073569,1.9943181818181817,701,431,1132,-
chr10,119073799,1.8272247054043076,802,534,1336,-
chr10,119073919,1.3076316330232103,1430,1069,2499,-
chr10,119073920,2.110894009864408,1271,972,2243,-
chr10,119080649,0.8670727564019172,1131,782,1913,-
chr10,119080650,1.0870080045469614,764,490,1254,-
chr10,119167929,1.7810807374443738,1892,1429,3321,-
chr10,119168461,1.4500041823504808,2113,1593,3706,-
chr10,119168524,1.6351469463563857,1617,1016,2633,-
chr10,119169263,0.7250780437044746,1406,1084,2490,-
chr10,119169310,1.8083061668025,1132,817,1949,-
chr10,119169333,1.8488715277777776,1120,719,1839,-
chr10,119174547,2.1300280636108515,1550,1068,2618,-
chr10,119174548,1.128140679270574,3844,2593,6437,-
chr10,119174549,2.1300280636108515,1550,1068,2618,-
chr10,119174550,0.958394898926508,2700,1670,4370,-
chr10,119177080,1.7594805194805194,1128,824,1952,-
chr10,119177083,2.7711340206185566,575,484,1059,-
chr10,119177098,0.4637071054981503,726,602,1328,-
chr10,119177105,1.6779317359979105,1357,965,2322,-
chr10,119177142,2.105823033880588,1488,833,2321,-
chr10,119177144,2.105823033880588,1488,833,2321,-
chr10,119178791,1.335856091248592,1457,1141,2598,-
chr10,119178793,1.335856091248592,1457,1141,2598,-
chr10,119500253,0.49020838818121065,930,736,1666,-
chr10,119500254,0.49020838818121065,930,736,1666,-
chr10,119575634,1.8845639804799799,1397,1044,2441,-
chr10,119575704,1.4129201922482444,1278,928,2206,-
chr10,119575705,1.2228506787330318,704,509,1213,-
chr10,119577710,0.5764510779436153,868,602,1470,-
chr10,119582192,1.8260264439805152,655,478,1133,-
chr10,119588226,2.3555403452734045,658,486,1144,-
chr10,119588227,1.67333982177961,1010,729,1739,-
chr10,119831484,0.5161843328684332,934,716,1650,-
chr10,119831574,3.8036520714706454,667,462,1129,-
chr10,119831575,3.8036520714706454,667,462,1129,-
chr10,119835606,2.3908073929961087,677,513,1190,-
chr10,119835688,3.3178048610975397,762,519,1281,-
chr10,119837022,3.088963217799362,920,767,1687,-
chr10,119837024,2.8185696361355084,863,796,1659,-
chr10,119837025,3.781474233529028,560,510,1070,-
chr10,119840851,2.1133006048708305,1420,1017,2437,-
chr10,119843365,2.7893921723632817,789,520,1309,-
chr10,119847704,2.0125687352710133,731,535,1266,-
chr10,119857351,1.0757765134205464,1047,776,1823,-
chr10,121478713,4.447145593648964,689,436,1125,-
chr10,121479579,2.131124913733609,771,689,1460,-
chr10,121479581,2.131124913733609,771,689,1460,-
chr10,121479587,1.9332275445167224,886,716,1602,-
chr10,121479588,1.5466666666666666,637,527,1164,-
chr10,121593896,0.9844444444444445,885,519,1404,-
chr10,121593898,0.7742988394584139,1280,751,2031,-
chr10,121593900,0.33260764392839864,824,476,1300,-
chr10,121965325,2.7137864775098524,682,597,1279,-
chr10,124397467,1.9394128021579,718,458,1176,-
chr10,124397875,0.5822306238185255,692,528,1220,-
chr10,124397951,2.4112085460570096,748,594,1342,-
chr10,124400973,0.5541395752058951,939,768,1707,-
chr10,124400975,0.9163678679090306,1175,951,2126,-
chr10,124412168,2.993678396255013,735,455,1190,-
chr10,125812267,0.7171623789657832,800,479,1279,-
chr10,125880989,3.15751503006012,605,498,1103,-
chr10,131968048,1.9454242457976794,899,707,1606,-
chr10,131968189,2.296037230212209,953,668,1621,-
chr10,131968326,2.21,857,659,1516,-
chr10,131968346,1.7043399638336347,753,552,1305,-
chr10,131968416,2.3670033670033668,873,620,1493,-
chr10,131968417,2.2267044495026256,1372,943,2315,-
chr10,131968421,0.6747510331278369,663,508,1171,-
chr10,131970945,1.6505613305613305,826,924,1750,-
chr10,131970952,1.5673844773441004,712,742,1454,-
chr10,131970961,1.8930531597930065,1005,910,1915,-
chr10,131970962,1.6209726289531954,1968,1741,3709,-
chr10,131970964,2.0941305152085437,1384,1172,2556,-
chr10,131970965,2.1538461538461537,895,740,1635,-
chr10,131973047,1.1102012370415542,1179,882,2061,-
chr10,131973049,1.4003218345933024,1613,1142,2755,-
chr10,133288956,1.7964912280701753,1023,493,1516,-
chr10,133288959,2.315109849679386,1649,811,2460,-
chr10,133289008,1.35642464032926,2816,2256,5072,-
chr10,133289009,1.35642464032926,2816,2256,5072,-
chr10,133289010,1.444040746263747,4329,3234,7563,-
chr10,133289012,1.7618459900295245,1548,1163,2711,-
chr10,133289016,0.4163244644230255,1457,840,2297,-
chr10,133289018,0.4105143721633888,1205,660,1865,-
chr10,133289851,1.2537910433242014,1606,926,2532,-
chr10,133289853,0.9547872340425532,1076,563,1639,-
chr10,133366035,0.9428864569083448,918,747,1665,-
chr10,133366036,1.2836495641834416,1164,925,2089,-
chr11,319801,2.1099702380952383,2577,1919,4496,-
chr11,319885,1.4541925237493016,3155,2528,5683,-
chr11,319906,1.4037606264308318,4753,2715,7468,-
chr11,319907,1.4037606264308318,4753,2715,7468,-
chr11,319913,1.3313103448275865,2285,1565,3850,-
chr11,319919,1.4626029914921934,5963,3640,9603,-
chr11,319920,1.4954439640838046,4087,2634,6721,-
chr11,319922,1.9048236696347192,1621,838,2459,-
chr11,319928,1.6523076923076925,1610,948,2558,-
chr11,319931,1.5765213977228112,1180,565,1745,-
chr11,319943,1.8061386888973092,992,454,1446,-
chr11,320623,1.583320383320383,1971,1187,3158,-
chr11,320673,1.3755056865888102,1566,1190,2756,-
chr11,320679,1.6759662019683985,5358,4066,9424,-
chr11,320847,0.9519613413305343,21204,12663,33867,-
chr11,320857,1.0957949795337096,2190,1979,4169,-
chr11,320858,1.0519543326942675,936,918,1854,-
chr11,320859,1.1309053722941094,1254,1061,2315,-
chr11,320876,1.8717850972710763,1193,1054,2247,-
chr11,320877,2.4712460813813455,1106,885,1991,-
chr11,320878,2.126230152583881,979,834,1813,-
chr11,494591,1.9824424428426755,998,898,1896,-
chr11,494651,1.0305305305305306,780,593,1373,-
chr11,494652,1.0305305305305306,780,593,1373,-
chr11,494961,1.6479640123634782,874,736,1610,-
chr11,498057,1.6459893048128342,728,509,1237,-
chr11,498126,1.6090670295203544,1097,786,1883,-
chr11,498127,2.1371560596513337,824,528,1352,-
chr11,498617,2.2725375952276328,661,544,1205,-
chr11,498837,2.8845291479820627,829,445,1274,-
chr11,498838,3.1708359133126933,1248,645,1893,-
chr11,498840,3.2862369828314097,833,417,1250,-
chr11,499081,1.1701826881252717,1265,835,2100,-
chr11,499083,1.1701826881252717,1265,835,2100,-
chr11,499134,1.49536976653189,684,423,1107,-
chr11,499918,2.3331749762171428,597,424,1021,-
chr11,502151,2.0363403146363424,1083,793,1876,-
chr11,502152,3.201059900433595,642,478,1120,-
chr11,506767,0.6000245843908534,1012,518,1530,-
chr11,691526,1.1828644501278769,739,459,1198,-
chr11,691528,1.445371689515276,1435,810,2245,-
chr11,691529,0.8816954267592448,1107,636,1743,-
chr11,840447,3.3270954812641547,749,604,1353,-
chr11,842497,1.9615770946939848,800,587,1387,-
chr11,842506,2.1136523929471034,616,396,1012,-
chr11,842507,1.7376283155849634,760,510,1270,-
chr11,1752858,20.090253593614428,3004,1998,5002,-
chr11,1752859,20.6379699864646,5027,3441,8468,-
chr11,1752860,20.6379699864646,5027,3441,8468,-
chr11,1752861,27.374035087719303,1695,949,2644,-
chr11,1752866,5.080749670564412,3950,2162,6112,-
chr11,1752867,4.7724184369157125,4400,2388,6788,-
chr11,1752868,4.8504615384615395,1125,649,1774,-
chr11,1752869,4.573028237585199,908,473,1381,-
chr11,1753003,2.4319123539749308,934,599,1533,-
chr11,1753027,1.256229907992462,820,513,1333,-
chr11,1753090,0.7287226330288532,717,417,1134,-
chr11,1753091,0.7287226330288532,717,417,1134,-
chr11,1753247,1.5806658130601792,822,496,1318,-
chr11,1753315,0.5521978021978022,1004,909,1913,-
chr11,1753317,0.5521978021978022,1004,909,1913,-
chr11,1753363,0.29916168444205876,666,559,1225,-
chr11,1753408,0.9550592776399227,865,402,1267,-
chr11,1753410,0.6603671119800152,1279,593,1872,-
chr11,1753412,0.8356125356125356,837,389,1226,-
chr11,1753561,2.4016081252644943,680,416,1096,-
chr11,1753897,1.8577863437255335,945,645,1590,-
chr11,1754968,0.5501477832512316,697,405,1102,-
chr11,1755020,2.406448202959831,784,472,1256,-
chr11,1757350,2.0945781852624443,1530,1147,2677,-
chr11,1757461,2.6429942418426107,815,520,1335,-
chr11,1759069,1.9725961072915654,1566,897,2463,-
chr11,1759071,2.098323832052651,2022,1282,3304,-
chr11,1759086,2.1531713249894007,1316,963,2279,-
chr11,1759541,0.6077271145144448,775,441,1216,-
chr11,1761399,1.9064224233061136,616,393,1009,-
chr11,1763926,0.6342725857224434,592,469,1061,-
chr11,2335446,0.9183471072241395,711,714,1425,-
chr11,2929168,2.0442974255716964,617,408,1025,-
chr11,2929191,1.9247604147641426,1237,757,1994,-
chr11,2929196,1.3190286967413072,838,437,1275,-
chr11,2929197,2.4520123839009282,1033,645,1678,-
chr11,2929198,2.4520123839009282,1033,645,1678,-
chr11,2929221,2.0954545954846213,794,407,1201,-
chr11,2944553,0.6582902039034731,620,552,1172,-
chr11,2944568,2.872640949925397,1033,857,1890,-
chr11,2944605,5.959552275448815,3789,2625,6414,-
chr11,2944606,5.959552275448815,3789,2625,6414,-
chr11,2944735,1.144360585930159,920,649,1569,-
chr11,2944766,2.8992251809357072,652,468,1120,-
chr11,2944972,2.3884007029876977,905,568,1473,-
chr11,2944981,1.5027289266221953,589,484,1073,-
chr11,2944984,1.915648854961832,716,523,1239,-
chr11,2945114,0.6419672131147541,978,724,1702,-
chr11,2945163,1.4377094121230585,1179,870,2049,-
chr11,2945189,0.49691651835602835,666,652,1318,-
chr11,2945212,0.56,615,549,1164,-
chr11,2945244,0.5875956463907329,797,875,1672,-
chr11,2945275,9.791129032258064,638,495,1133,-
chr11,2945284,1.9079848119077776,805,658,1463,-
chr11,2945293,13.961278587518969,4471,2897,7368,-
chr11,2945294,13.961278587518969,4471,2897,7368,-
chr11,2945295,15.320174198986427,3607,2323,5930,-
chr11,2945299,17.341450256161192,1211,536,1747,-
chr11,2945499,0.7512366714301418,1138,826,1964,-
chr11,2945528,1.6826569800490805,1394,912,2306,-
chr11,2945529,1.6826569800490805,1394,912,2306,-
chr11,2945549,9.048918660949308,1240,876,2116,-
chr11,2951291,2.6223740325383043,1252,973,2225,-
chr11,2951292,2.8873687462548427,2506,1899,4405,-
chr11,2951794,1.90248471701834,1134,921,2055,-
chr11,2951795,1.90248471701834,1134,921,2055,-
chr11,2954633,1.4273443627974935,2598,1775,4373,-
chr11,2958517,2.0796862097440134,875,691,1566,-
chr11,2959813,1.9760080414406023,2975,2074,5049,-
chr11,2964731,1.3225427436998622,2014,1504,3518,-
chr11,2969904,1.643356643356643,1409,857,2266,-
chr11,2969922,1.6100250626566417,802,569,1371,-
chr11,2972123,1.4328048766746668,4487,3286,7773,-
chr11,2972135,1.3530532999450282,18115,13317,31432,-
chr11,2972136,1.411157947477916,7620,5150,12770,-
chr11,2972139,1.739065421102936,6930,4433,11363,-
chr11,2972140,1.739065421102936,6930,4433,11363,-
chr11,2972169,0.6624344265274227,2102,1398,3500,-
chr11,2972224,2.8560019167798103,893,658,1551,-
chr11,2972227,0.6385295233724859,3404,2410,5814,-
chr11,2972228,0.6444174394005225,4445,3182,7627,-
chr11,2978325,2.7488584474885838,601,437,1038,-
chr11,2979221,1.85508486663814,928,512,1440,-
chr11,2979227,2.8260185185185187,1326,799,2125,-
chr11,2992269,2.501845827450424,1022,534,1556,-
chr11,2992272,0.5286000741648363,2224,1264,3488,-
chr11,2992284,2.021263288508259,727,520,1247,-
chr11,3001030,1.5477548261732774,915,606,1521,-
chr11,3001056,2.130434782608696,734,620,1354,-
chr11,3001165,1.6585508029373506,2120,1926,4046,-
chr11,3001166,1.7096250592303581,3101,2780,5881,-
chr11,3001168,1.77254299848248,2950,2566,5516,-
chr11,3001187,1.8597012138188609,1878,1529,3407,-
chr11,3001188,1.8597012138188609,1878,1529,3407,-
chr11,3001196,0.6251564455569463,665,563,1228,-
chr11,3001211,1.817632850241546,601,482,1083,-
chr11,3002030,1.7186974789915967,605,475,1080,-
chr11,3002031,1.554925818749713,1484,1004,2488,-
chr11,3002033,1.7629208155523943,571,443,1014,-
chr11,3002034,2.074709124311084,725,425,1150,-
chr11,3002036,1.718667371760973,1249,929,2178,-
chr11,3002037,1.718667371760973,1249,929,2178,-
chr11,3002555,2.156255205730468,808,521,1329,-
chr11,3012253,1.6025815217391306,673,735,1408,-
chr11,3012259,1.6997002378547457,1256,1305,2561,-
chr11,3012261,1.9454926624737947,1855,1907,3762,-
chr11,3012262,2.0972503725982357,2813,2388,5201,-
chr11,3012264,1.9677008780147336,3685,2880,6565,-
chr11,3012265,1.7022487438561424,1999,1732,3731,-
chr11,3012266,1.8998573901244482,2545,1927,4472,-
chr11,3012271,2.8285613454772434,880,593,1473,-
chr11,3017127,2.946214457005824,687,416,1103,-
chr11,3017139,1.7584415584415585,676,384,1060,-
chr11,3017225,3.9166666666666665,657,461,1118,-
chr11,3017934,1.4561755366139006,1717,1213,2930,-
chr11,3017943,2.4894329896907217,742,581,1323,-
chr11,3018423,1.6260263157894737,1260,949,2209,-
chr11,3018448,1.6397493908806124,672,441,1113,-
chr11,3018632,1.7833876221498373,729,613,1342,-
chr11,3019158,2.1985583224115333,914,762,1676,-
chr11,3019160,2.1985583224115333,914,762,1676,-
chr11,3019175,2.664358242669117,764,531,1295,-
chr11,3020316,0.6468248380737821,734,535,1269,-
chr11,3026744,1.7765843969544268,1049,876,1925,-
chr11,3026747,1.5392233225770555,1043,835,1878,-
chr11,3026770,1.7011455525606465,917,741,1658,-
chr11,3026773,0.8995034300895589,2871,2037,4908,-
chr11,3026774,0.5952048788265306,1990,1343,3333,-
chr11,3029064,1.8215436810856658,766,654,1420,-
chr11,3029065,0.5938380702173394,1035,789,1824,-
chr11,3029072,2.7363860762681984,1357,1017,2374,-
chr11,3029073,2.7363860762681984,1357,1017,2374,-
chr11,3029360,2.365867007206057,700,576,1276,-
chr11,3029401,1.6420386904761908,760,559,1319,-
chr11,3038162,0.4925986842105263,598,479,1077,-
chr11,3039272,2.414824542198976,1540,1054,2594,-
chr11,3039907,1.2340804576152917,2354,1893,4247,-
chr11,3040959,1.5121732533278156,876,536,1412,-
chr11,3042184,1.5396688264938805,577,462,1039,-
chr11,3042198,1.7258780420548474,872,656,1528,-
chr11,3057361,2.140495867768595,591,483,1074,-
chr11,3057409,1.1590671613538277,822,561,1383,-
chr11,3057410,1.1590671613538277,822,561,1383,-
chr11,3057416,1.4688170649616608,838,422,1260,-
chr11,3087492,2.8257842438229512,577,646,1223,-
chr11,3676604,2.8716155419222904,1150,814,1964,-
chr11,3676605,2.0771202228599024,1788,1199,2987,-
chr11,3691469,1.1725806451612903,726,495,1221,-
chr11,3691470,1.4239062140528256,1060,795,1855,-
chr11,3695470,1.2603502392754586,622,454,1076,-
chr11,3699227,3.8134387351778662,602,459,1061,-
chr11,3699247,0.46545620834985874,1672,1065,2737,-
chr11,3699248,0.4853378665533362,1141,723,1864,-
chr11,3699290,2.639132679401136,638,446,1084,-
chr11,3699291,2.639132679401136,638,446,1084,-
chr11,3700806,0.9143635344067932,877,656,1533,-
chr11,3700807,1.0719166992469735,1593,1194,2787,-
chr11,3706491,2.1879526003949965,577,433,1010,-
chr11,3712727,2.09260029717682,977,672,1649,-
chr11,3713857,2.9210280082340465,1088,696,1784,-
chr11,3713937,2.2759909719283398,1402,833,2235,-
chr11,3713961,3.8236019736842106,1093,767,1860,-
chr11,3713986,1.1978959679227943,1860,1201,3061,-
chr11,3719441,2.0224003259219594,1599,1031,2630,-
chr11,3719459,2.0417365042031888,1434,884,2318,-
chr11,3720755,0.31822660098522165,645,405,1050,-
chr11,3723378,2.6017251563623844,656,537,1193,-
chr11,3735265,1.3599027037140992,631,508,1139,-
chr11,3735267,1.3599027037140992,631,508,1139,-
chr11,3744644,2.9935817805383023,760,459,1219,-
chr11,3753342,0.5352577319587629,648,484,1132,-
chr11,3753376,2.721515448063749,926,621,1547,-
chr11,3753378,2.721515448063749,926,621,1547,-
chr11,3762984,3.746735074626865,830,535,1365,-
chr11,3762985,3.746735074626865,830,535,1365,-
chr11,3775943,1.4428792898694103,716,485,1201,-
chr11,3775976,0.4022935515472829,536,468,1004,-
chr11,3775977,1.0918820023155285,904,717,1621,-
chr11,6476637,36.707977961544806,948,845,1793,-
chr11,6476638,29.358435659930954,1329,1042,2371,-
chr11,6476639,7.826432313619727,831,497,1328,-
chr11,6476647,37.899631701846516,1018,423,1441,-
chr11,6476648,51.34390696579212,748,266,1014,-
chr11,6477048,3.608427023212596,963,735,1698,-
chr11,6477199,3.041452991452992,646,389,1035,-
chr11,6477200,3.041452991452992,646,389,1035,-
chr11,6477254,2.518886486561736,628,482,1110,-
chr11,6477758,5.016218833212297,796,458,1254,-
chr11,6477769,1.3431091454626227,977,694,1671,-
chr11,6610979,1.9718683651804672,742,470,1212,-
chr11,6611264,1.7243225524475523,733,571,1304,-
chr11,6611270,2.2065217391304346,713,551,1264,-
chr11,6611302,1.7237268743670764,1060,932,1992,-
chr11,6611446,1.0675471698113206,1310,1059,2369,-
chr11,6611447,1.3291086100338774,1807,1461,3268,-
chr11,6611678,1.8141549334454894,1049,872,1921,-
chr11,6614244,2.4206828097529742,602,444,1046,-
chr11,6617033,1.5870052943979933,660,498,1158,-
chr11,6617728,1.5856001602140009,637,387,1024,-
chr11,6682078,1.9929368892659216,1976,1580,3556,-
chr11,6682079,2.091102232369356,1198,875,2073,-
chr11,6682184,0.6119733924611973,735,450,1185,-
chr11,6682211,2.269850187265918,712,444,1156,-
chr11,6682329,1.9685442486119877,1469,1143,2612,-
chr11,6682352,0.5835584869675778,772,571,1343,-
chr11,6682355,2.240138067061144,825,506,1331,-
chr11,6682391,2.2651113467656416,800,491,1291,-
chr11,6682401,1.8413882116735985,641,366,1007,-
chr11,6683212,1.117139935593131,945,596,1541,-
chr11,6683258,0.27961039191067777,820,469,1289,-
chr11,6683306,1.347998891440242,1535,862,2397,-
chr11,6683308,1.4570599199079135,1699,1074,2773,-
chr11,8947904,10.50317609042815,634,1065,1699,-
chr11,8947910,25.618608677099477,771,854,1625,-
chr11,8947911,29.686356682028837,557,562,1119,-
chr11,9169944,2.052606484424666,944,725,1669,-
chr11,9170650,1.3965425531914892,800,563,1363,-
chr11,9170656,1.9611112681231102,1284,862,2146,-
chr11,9170657,0.6467982279500604,802,381,1183,-
chr11,9170658,1.9611112681231102,1284,862,2146,-
chr11,10797301,1.877425614489004,2024,1545,3569,-
chr11,10797560,1.6909113764927717,1200,924,2124,-
chr11,10799105,1.6514305062775572,2206,1470,3676,-
chr11,10799270,0.7771969339639704,3951,2678,6629,-
chr11,10799335,2.492488404920347,1008,683,1691,-
chr11,10799399,1.6854427899686522,929,703,1632,-
chr11,10800199,1.7003866088569013,9121,7246,16367,-
chr11,10800200,1.7003866088569013,9121,7246,16367,-
chr11,10800210,0.8531268235751799,5210,3179,8389,-
chr11,10800213,0.6749554242321841,6339,4147,10486,-
chr11,10800225,1.4124789079052538,3008,2115,5123,-
chr11,10800236,1.3880315336837077,2994,1819,4813,-
chr11,10800274,1.4117657644687591,3201,2207,5408,-
chr11,10800284,1.3425258700181004,2153,1315,3468,-
chr11,10800291,0.7664773336191191,2383,1504,3887,-
chr11,10800614,0.63379355687048,1204,1052,2256,-
chr11,10800623,1.5669482902852039,4904,3665,8569,-
chr11,10800771,0.5197965556331623,2040,1655,3695,-
chr11,10800774,2.5819444444444444,844,799,1643,-
chr11,10800800,1.7055113792157937,621,520,1141,-
chr11,10801685,1.8070175438596496,720,569,1289,-
chr11,10801754,1.4731323722149412,842,653,1495,-
chr11,10801757,1.9001953124999997,1080,639,1719,-
chr11,10802092,1.670158065130451,1753,1067,2820,-
chr11,10802093,1.670158065130451,1753,1067,2820,-
chr11,10803041,1.827758887171561,777,646,1423,-
chr11,10803110,1.5262662398794953,1350,790,2140,-
chr11,10803934,1.1018542598947558,3683,2733,6416,-
chr11,10803940,1.909307101934926,1038,840,1878,-
chr11,10804036,1.9126444159178435,1385,819,2204,-
chr11,10804148,0.6546600013695816,1194,858,2052,-
chr11,10804299,1.8587962962962965,1313,809,2122,-
chr11,10804389,1.619732785200411,787,555,1342,-
chr11,10805009,0.6567556677199754,1105,772,1877,-
chr11,10805942,1.6854510392114848,827,717,1544,-
chr11,10805958,0.5643035268970431,923,801,1724,-
chr11,10806010,2.232846805953318,1614,1067,2681,-
chr11,10806011,0.46238227146814415,641,474,1115,-
chr11,10806022,5.565756602426838,1176,933,2109,-
chr11,10806023,5.565756602426838,1176,933,2109,-
chr11,10806031,0.4860804242156429,599,437,1036,-
chr11,10806032,2.3016559473645297,1705,1001,2706,-
chr11,10806033,2.3016559473645297,1705,1001,2706,-
chr11,10806854,3.4125385957846683,819,572,1391,-
chr11,10807313,1.65912343470483,686,429,1115,-
chr11,10852907,2.9348738170977304,603,967,1570,-
chr11,10852908,3.1722260040844112,465,677,1142,-
chr11,10852910,3.421580928481806,605,796,1401,-
chr11,10852911,3.5061071501227086,641,736,1377,-
chr11,10852912,3.6730657358929615,450,572,1022,-
chr11,14461226,1.684618914004224,700,513,1213,-
chr11,14465022,2.237337497439029,1179,826,2005,-
chr11,14486468,3.5846489786631612,779,565,1344,-
chr11,14490608,1.7107478628364579,1886,1245,3131,-
chr11,14490611,0.6442381285148581,879,566,1445,-
chr11,14490616,1.8697496966019416,1567,993,2560,-
chr11,14490619,1.7961284615354762,1930,1380,3310,-
chr11,14490620,1.8794037115911164,1187,864,2051,-
chr11,14493732,2.0782624304433672,826,618,1444,-
chr11,14493733,2.0782624304433672,826,618,1444,-
chr11,14505103,1.6096117904629683,1837,1534,3371,-
chr11,14505209,1.5428853511045293,1063,875,1938,-
chr11,14507666,1.860174781523096,893,711,1604,-
chr11,14507676,1.5988005050505054,1012,575,1587,-
chr11,14507679,1.7414204843905734,2714,1943,4657,-
chr11,14507680,1.9007374826377406,1618,1162,2780,-
chr11,14507719,1.7896579277805258,870,640,1510,-
chr11,14513656,1.177140428587198,1793,1505,3298,-
chr11,14513662,1.701704909626971,884,806,1690,-
chr11,14514487,1.6480342322605381,1730,1233,2963,-
chr11,14517897,1.8808903365906626,1018,613,1631,-
chr11,14517969,2.9862586768664108,679,542,1221,-
chr11,14519030,0.6486823639482301,799,604,1403,-
chr11,14520337,0.4999578479239915,2014,1368,3382,-
chr11,16974718,1.137478540089569,75806,55487,131293,-
chr11,16974719,1.166752220330777,81958,59505,141463,-
chr11,16974720,0.9177442380531924,33929,24371,58300,-
chr11,16974721,1.314792171707096,44809,32017,76826,-
chr11,16974723,1.2779631030637622,42095,29420,71515,-
chr11,16974724,1.1610470757304667,36353,25462,61815,-
chr11,16974727,1.293050113439977,31954,21827,53781,-
chr11,16974728,1.3077192226098568,30109,20534,50643,-
chr11,16974747,1.6516924935529589,14294,7094,21388,-
chr11,16974748,1.6516924935529589,14294,7094,21388,-
chr11,16974861,0.6098771961892316,12714,9435,22149,-
chr11,16974933,1.39161286292282,43559,25437,68996,-
chr11,16974934,1.430399872691467,74613,44223,118836,-
chr11,16974936,1.4675198143295485,41539,23774,65313,-
chr11,16974939,1.3183041489175955,28455,16746,45201,-
chr11,16974948,1.5125019957678567,23853,11812,35665,-
chr11,16974950,1.4882798387265428,34152,15493,49645,-
chr11,16974951,1.2684321244762569,44435,23806,68241,-
chr11,16974952,1.2247742513985314,38754,20521,59275,-
chr11,16974964,1.7390397154712507,4583,2409,6992,-
chr11,16975027,1.9275914634146345,9272,3519,12791,-
chr11,16975029,1.5995340132636655,3488,2487,5975,-
chr11,16975030,1.435297717196663,12940,6019,18959,-
chr11,16975039,0.7808023353232671,14332,4653,18985,-
chr11,16975040,0.798667963731491,5561,3972,9533,-
chr11,16975041,0.7798144975226211,32421,16602,49023,-
chr11,16975042,0.7471704993476707,26425,15365,41790,-
chr11,16975043,0.6361122853009649,10098,4307,14405,-
chr11,16975044,0.7284981938243597,5423,3778,9201,-
chr11,17075468,1.2518699125491353,15190,11058,26248,-
chr11,17075496,1.175664838832854,69724,47641,117365,-
chr11,17075497,1.1873616419969995,54248,35707,89955,-
chr11,17075510,0.9111259178144033,45888,31606,77494,-
chr11,17075608,1.2402437976320886,22741,18113,40854,-
chr11,17075609,0.9011788585028514,15295,11419,26714,-
chr11,17075619,1.1615150302323771,9760,6102,15862,-
chr11,17077193,1.2373381300521191,39064,27132,66196,-
chr11,17077194,1.2373381300521191,39064,27132,66196,-
chr11,17077206,1.489363330690796,5921,3139,9060,-
chr11,17077209,0.7799938609639311,15697,12735,28432,-
chr11,17077210,0.7805106614810347,26370,20434,46804,-
chr11,17077211,0.7799938609639311,15697,12735,28432,-
chr11,17077239,1.2626311948954008,4013,3020,7033,-
chr11,17077643,1.6741349611043914,7776,5008,12784,-
chr11,17077654,1.5063341156938628,11612,5741,17353,-
chr11,17077659,1.932170334839232,18868,7836,26704,-
chr11,17077660,2.2902831633361944,17131,5033,22164,-
chr11,17077661,2.141091757795153,20630,7386,28016,-
chr11,17077662,2.3773254195722657,12640,3641,16281,-
chr11,17077665,0.9758625,1963,1279,3242,-
chr11,17077666,0.8381456807284231,11010,4825,15835,-
chr11,17077667,0.8254896050389212,10749,5114,15863,-
chr11,17077669,0.8205453371556353,2565,1444,4009,-
chr11,17087927,6.230814210077654,1132,964,2096,-
chr11,17087928,4.836265294999803,1199,934,2133,-
chr11,17087929,6.018207590526854,1442,1195,2637,-
chr11,18291667,1.186513394880439,625,485,1110,-
chr11,18480491,0.5263609779492838,1242,923,2165,-
chr11,18483921,1.8574967511371019,2588,1823,4411,-
chr11,18483922,0.5667944533664888,3454,1745,5199,-
chr11,18483929,2.272839923397544,6304,4034,10338,-
chr11,18483930,2.272839923397544,6304,4034,10338,-
chr11,18483931,2.014013572490605,8206,5173,13379,-
chr11,18483933,1.7513363800027697,3951,2406,6357,-
chr11,18483935,0.34759615384615383,1445,639,2084,-
chr11,18483938,0.5644257703081232,1949,1070,3019,-
chr11,18483942,1.365066841989919,1373,844,2217,-
chr11,18483944,0.9582648107824152,2637,1442,4079,-
chr11,18483978,1.9857240281882251,715,414,1129,-
chr11,18514788,1.8600374064837903,662,400,1062,-
chr11,18526789,0.9696071163825057,653,425,1078,-
chr11,18526790,0.9696071163825057,653,425,1078,-
chr11,18612429,2.4764247642476427,603,541,1144,-
chr11,18612430,2.4764247642476427,603,541,1144,-
chr11,18612435,2.852403590234621,803,625,1428,-
chr11,27366357,2.527906825004996,989,707,1696,-
chr11,27367674,3.154964581338306,1020,693,1713,-
chr11,27367684,2.9287671371840664,642,501,1143,-
chr11,27367915,2.15933750498405,995,700,1695,-
chr11,27368666,2.132234320600233,697,486,1183,-
chr11,27368819,1.8738475177304963,918,751,1669,-
chr11,27368835,1.6971441078986476,1723,1391,3114,-
chr11,27368847,2.46839852692346,774,590,1364,-
chr11,27368850,1.9117215339117755,1498,1212,2710,-
chr11,27368854,1.7867141085237215,1415,1092,2507,-
chr11,27368865,2.80925970581143,931,637,1568,-
chr11,27368866,2.766171965512678,1488,1101,2589,-
chr11,27369123,0.32652449842135584,604,482,1086,-
chr11,27372330,3.030609984713341,728,556,1284,-
chr11,27372334,1.4821567370901725,644,428,1072,-
chr11,27384383,3.4597302035143045,615,506,1121,-
chr11,27889287,1.6290617848970252,790,574,1364,-
chr11,27889288,1.7476240190078478,1228,816,2044,-
chr11,27889291,1.5394012163608362,1215,841,2056,-
chr11,27889292,1.0939894302981263,1663,1113,2776,-
chr11,27889294,0.8156105184910013,2776,2015,4791,-
chr11,27889296,0.6553856446453034,1055,882,1937,-
chr11,27889560,1.3594335469879,996,710,1706,-
chr11,27889703,1.8571428571428568,701,575,1276,-
chr11,27889705,0.9701273922177037,1597,1165,2762,-
chr11,27889707,0.8260897784913434,2191,1632,3823,-
chr11,27889710,0.6653701227665006,594,432,1026,-
chr11,27889732,0.4656688049417914,559,487,1046,-
chr11,27889733,0.4767158205391245,839,711,1550,-
chr11,27889897,0.5906402513585769,3694,2465,6159,-
chr11,27889898,0.624228028503563,1970,1262,3232,-
chr11,27889906,1.4049795615013003,1389,974,2363,-
chr11,27889909,1.8536585365853664,1253,860,2113,-
chr11,27889913,3.5708542713567843,626,596,1222,-
chr11,27889914,2.857803468208092,926,864,1790,-
chr11,27889916,2.4516129032258065,611,557,1168,-
chr11,27889921,1.4083324216015913,2756,1904,4660,-
chr11,27889922,1.140641700363725,2505,1696,4201,-
chr11,27889923,1.140641700363725,2505,1696,4201,-
chr11,27890065,2.017964545742324,592,467,1059,-
chr11,27890074,1.0476504040706376,2034,1284,3318,-
chr11,27890075,1.0476504040706376,2034,1284,3318,-
chr11,27890079,1.6232086228337945,1200,806,2006,-
chr11,27890084,0.32133762593622156,1247,858,2105,-
chr11,27890090,0.9441196549867598,766,576,1342,-
chr11,27890228,1.7730819560897593,1613,1316,2929,-
chr11,27890232,1.7891573038443012,2134,1645,3779,-
chr11,27890254,0.7320691097286842,1976,1738,3714,-
chr11,27890260,2.045880861850444,1152,788,1940,-
chr11,27890263,0.9886544883549636,2494,2011,4505,-
chr11,27890266,2.384631047173077,1331,872,2203,-
chr11,27890270,1.6075663466967816,1559,919,2478,-
chr11,27890271,1.6075663466967816,1559,919,2478,-
chr11,27890273,1.8507004922377883,1320,694,2014,-
chr11,27890275,1.2248669072882234,2302,1638,3940,-
chr11,27890287,1.7135997521685251,850,806,1656,-
chr11,27890297,2.0356535126813062,1271,1147,2418,-
chr11,27890298,1.7659736648139335,1606,1327,2933,-
chr11,27890874,1.3519015231344,1128,948,2076,-
chr11,27890878,0.6022671944791379,1458,973,2431,-
chr11,27890879,1.8063233903220741,1662,1288,2950,-
chr11,27890915,0.5519252035789685,914,608,1522,-
chr11,27890931,1.7045454545454546,626,417,1043,-
chr11,27890935,0.9074930619796484,1089,704,1793,-
chr11,27890937,0.9074930619796484,1089,704,1793,-
chr11,27891011,0.1494656802301685,1038,810,1848,-
chr11,27891013,0.22604018824232466,1512,1216,2728,-
chr11,27891014,0.2875267641565304,970,812,1782,-
chr11,27891039,0.9007557483701384,1704,1425,3129,-
chr11,27891041,1.0277230971128608,1252,1015,2267,-
chr11,28083242,1.150452699566125,780,496,1276,-
chr11,33099090,1.9814876033057849,647,549,1196,-
chr11,33099091,1.9814876033057849,647,549,1196,-
chr11,33105577,2.2000648041474653,1152,895,2047,-
chr11,33105580,2.320746103176156,1111,806,1917,-
chr11,33105609,1.5980724343046455,757,465,1222,-
chr11,33105612,2.7797706556895028,651,357,1008,-
chr11,33105644,2.913292433537832,837,651,1488,-
chr11,33105656,2.6429464285714293,758,559,1317,-
chr11,33105662,1.8997376311844079,653,463,1116,-
chr11,33705793,3.677808345188125,645,447,1092,-
chr11,33706411,3.2823344216381973,692,562,1254,-
chr11,33706512,1.8088439788634467,541,468,1009,-
chr11,33706524,1.2042254665849923,1050,687,1737,-
chr11,33706551,1.230636429019144,809,590,1399,-
chr11,33706553,1.2120176354984642,838,585,1423,-
chr11,33708385,0.33538906728792567,495,771,1266,-
chr11,33708392,0.46026427954658194,491,834,1325,-
chr11,33708435,0.2137337160521086,439,1293,1732,-
chr11,33708436,0.20911748527516724,723,2160,2883,-
chr11,33708451,3.037563451776649,271,1181,1452,-
chr11,33708452,5.953273610115773,595,1865,2460,-
chr11,33708453,7.048586673591134,1041,2872,3913,-
chr11,33708826,1.7382541881849098,551,466,1017,-
chr11,33709133,1.560449961775092,3383,2112,5495,-
chr11,33709245,1.6006533991720284,1210,977,2187,-
chr11,33709379,1.6637885751805648,1876,1522,3398,-
chr11,33709395,1.8418820588366591,2062,1571,3633,-
chr11,33709520,1.3105611766761438,3928,2806,6734,-
chr11,33709619,1.7022549760645,1080,881,1961,-
chr11,33709753,1.4325165882047668,1309,1017,2326,-
chr11,33709806,0.8104513743475551,2783,2082,4865,-
chr11,33709886,1.24832936612889,4264,2849,7113,-
chr11,33717399,0.7930092365204959,3802,2812,6614,-
chr11,33717442,1.3330509605409577,7192,4987,12179,-
chr11,33722440,1.4071282699601284,2018,1581,3599,-
chr11,33722447,1.308526518149949,2690,1433,4123,-
chr11,33722450,1.1650464471245356,12189,7531,19720,-
chr11,33722451,1.0530698962143679,13203,7592,20795,-
chr11,33722452,1.2739287852249537,12174,7034,19208,-
chr11,33722453,1.1764197424150749,6804,3520,10324,-
chr11,33722456,1.4675839692363155,1953,978,2931,-
chr11,33722457,0.6177109280194162,1333,920,2253,-
chr11,33722460,1.8401100133158428,1909,1400,3309,-
chr11,33736393,2.9342767295597483,867,529,1396,-
chr11,33736409,1.7953376801329923,2165,1274,3439,-
chr11,33736411,1.9983047255774529,942,725,1667,-
chr11,33736416,2.268293448225757,2180,1021,3201,-
chr11,33736418,2.16374269005848,1738,892,2630,-
chr11,33736419,1.631685200872449,2672,1462,4134,-
chr11,33736421,1.1244547977810404,4546,2131,6677,-
chr11,33736422,0.9831157783164024,2975,1215,4190,-
chr11,33736423,1.0002544600218906,1978,750,2728,-
chr11,34888837,1.2912546517809675,618,397,1015,-
chr11,36274074,1.866362320026363,584,427,1011,-
chr11,36274604,2.339828521232462,550,451,1001,-
chr11,46428770,1.0651822750515492,48475,35013,83488,-
chr11,46428774,1.3568820671494635,25975,20540,46515,-
chr11,46428776,1.2455146685743135,57689,41093,98782,-
chr11,46428777,1.234667483881696,40560,31417,71977,-
chr11,46428778,1.2153154447532153,66175,47577,113752,-
chr11,46428782,1.4627084582025878,6100,4519,10619,-
chr11,46428832,1.2495020596816493,16936,13104,30040,-
chr11,46428833,1.379889609270568,25388,18194,43582,-
chr11,46428834,1.379889609270568,25388,18194,43582,-
chr11,46428843,1.317667651254905,8698,5844,14542,-
chr11,46428848,1.384467129126553,7030,5010,12040,-
chr11,46428849,1.301729137648092,11134,7563,18697,-
chr11,46428850,1.3604625145478233,9440,6757,16197,-
chr11,46428852,1.086902740079459,7697,4590,12287,-
chr11,46428853,1.0335127392058527,9593,5987,15580,-
chr11,46428854,1.2221264284165465,12166,7291,19457,-
chr11,46428855,1.488545378812422,2555,1580,4135,-
chr11,46428856,1.5146082703855486,7228,4383,11611,-
chr11,46428857,1.1940721437719097,5003,3115,8118,-
chr11,46428860,1.456209694195964,1399,758,2157,-
chr11,46428861,1.6043417366946773,1026,662,1688,-
chr11,46428865,1.9170370370370367,646,374,1020,-
chr11,46428868,1.8856476100365656,1404,770,2174,-
chr11,46428871,1.8375367010464505,677,358,1035,-
chr11,46428875,3.6936090225563913,654,398,1052,-
chr11,46428878,2.0742055932438186,919,642,1561,-
chr11,46428886,1.2078212290502794,689,357,1046,-
chr11,46428887,1.2078212290502794,689,357,1046,-
chr11,46429005,1.362463659126645,18913,13154,32067,-
chr11,46429007,1.4449975704326612,10614,7756,18370,-
chr11,46429013,1.5352789330273915,8423,5871,14294,-
chr11,46429014,1.3999398991154857,26050,19337,45387,-
chr11,46429016,1.4763257113919668,15650,12496,28146,-
chr11,46429018,1.456293654241232,9682,5926,15608,-
chr11,46429019,1.491943997099075,17449,10678,28127,-
chr11,46429021,1.458829423060867,9195,5509,14704,-
chr11,46429059,1.5699680511182108,2573,1251,3824,-
chr11,46429062,1.8030844850677232,2331,1080,3411,-
chr11,46429065,1.7262455544015356,4284,1868,6152,-
chr11,46429067,1.7262455544015356,4284,1868,6152,-
chr11,46429079,3.2500294880868132,1644,1255,2899,-
chr11,46429080,1.6488718633584032,1202,693,1895,-
chr11,46429104,1.8478038485889163,5106,3201,8307,-
chr11,46429105,1.7547390358448733,4155,2685,6840,-
chr11,46429106,1.7547390358448733,4155,2685,6840,-
chr11,46429114,1.8130696141167344,747,381,1128,-
chr11,46429116,0.5751201923076923,1130,675,1805,-
chr11,46429118,1.6475306700220194,837,288,1125,-
chr11,46429134,1.1511993537527074,1310,482,1792,-
chr11,46429135,0.746228516637942,1484,658,2142,-
chr11,46429138,0.47256117691232363,1223,741,1964,-
chr11,46429143,0.4576779489441706,668,513,1181,-
chr11,46750298,10.174767991169226,2253,1608,3861,-
chr11,46750299,6.775757575757575,844,714,1558,-
chr11,46750370,1.757744874715262,670,438,1108,-
chr11,46751137,3.026113671274961,787,464,1251,-
chr11,46751139,3.026113671274961,787,464,1251,-
chr11,46751524,2.8842556291246733,796,492,1288,-
chr11,46751525,3.2091074724304747,627,445,1072,-
chr11,46754992,2.3618181818181814,865,549,1414,-
chr11,46754994,2.3618181818181814,865,549,1414,-
chr11,46758971,1.2111098407601548,1440,975,2415,-
chr11,46758977,1.7152447552447552,656,428,1084,-
chr11,46760748,2.5691926302474375,574,475,1049,-
chr11,46763129,2.8629441624365484,751,590,1341,-
chr11,46763131,2.8629441624365484,751,590,1341,-
chr11,46763165,1.3490041329960565,613,441,1054,-
chr11,46763615,3.5279040675874,656,498,1154,-
chr11,46770931,2.0365704997968304,1431,1283,2714,-
chr11,46770933,2.0365704997968304,1431,1283,2714,-
chr11,46770939,2.327091633466136,648,501,1149,-
chr11,46770952,2.7985754985754983,1044,674,1718,-
chr11,46770954,2.343144750254842,1553,980,2533,-
chr11,46770955,2.1915939877528303,1026,633,1659,-
chr11,46770959,1.4141392209097765,1253,867,2120,-
chr11,46770961,0.7974960339578957,1115,842,1957,-
chr11,46770963,0.8011682193182543,988,768,1756,-
chr11,46770965,0.42255434782608703,621,479,1100,-
chr11,46776338,2.4099974448473502,907,689,1596,-
chr11,46777482,0.4258278825843971,830,570,1400,-
chr11,46780211,1.6790165451846872,895,675,1570,-
chr11,46783346,3.3046100818612665,589,421,1010,-
chr11,46783347,3.3046100818612665,589,421,1010,-
chr11,46784649,4.270925110132159,553,453,1006,-
chr11,46784650,4.270925110132159,553,453,1006,-
chr11,46808088,1.7583511363074298,909,690,1599,-
chr11,47177610,0.5149451393132407,785,629,1414,-
chr11,47177614,29.06121247059523,2930,1963,4893,-
chr11,47177615,29.06121247059523,2930,1963,4893,-
chr11,47177616,25.615163704874604,2059,1512,3571,-
chr11,47177657,0.3204047495590695,785,486,1271,-
chr11,47177743,5.8980377216804865,873,1019,1892,-
chr11,47177758,5.605368053647756,1111,856,1967,-
chr11,47177759,5.4226767757012455,705,539,1244,-
chr11,47177763,6.855054984033354,759,538,1297,-
chr11,47177776,15.970039484804989,1001,620,1621,-
chr11,47177777,17.56141815185973,1265,735,2000,-
chr11,47180229,0.5130559279626007,606,431,1037,-
chr11,47180325,1.959579772079772,3099,2879,5978,-
chr11,47180326,1.9165708386692104,4045,3687,7732,-
chr11,47180327,1.8473961745934646,5336,4667,10003,-
chr11,47180328,1.8565835717635406,2985,2672,5657,-
chr11,47180468,0.6819517930629042,799,566,1365,-
chr11,47180470,1.2507121333586755,1848,1557,3405,-
chr11,47180471,0.9305382593053826,1344,1187,2531,-
chr11,47180481,0.4745663363434873,761,708,1469,-
chr11,47180483,0.4745663363434873,761,708,1469,-
chr11,47180487,0.5334040296924708,502,532,1034,-
chr11,47180488,0.5334040296924708,502,532,1034,-
chr11,47180508,0.2528581163507304,558,470,1028,-
chr11,47420290,1.67551100412097,1582,1071,2653,-
chr11,47420318,1.1375665753439608,1082,875,1957,-
chr11,47420338,1.573631998243171,1175,700,1875,-
chr11,47420724,2.1017970185466184,1218,771,1989,-
chr11,47422678,1.6336169473866988,587,442,1029,-
chr11,47422684,1.7152617397998458,712,432,1144,-
chr11,47422949,0.49364896073903,569,432,1001,-
chr11,47424160,1.7768765856860498,1905,1348,3253,-
chr11,47424175,2.152654867256637,833,564,1397,-
chr11,47424176,2.4147885050048434,1225,814,2039,-
chr11,47424177,0.9833960251515832,1556,975,2531,-
chr11,47424178,1.4637728628115292,2360,1499,3859,-
chr11,47424699,1.5918680475642502,1327,868,2195,-
chr11,47425155,1.4827721863423269,1458,1033,2491,-
chr11,47425169,1.123273852588342,2211,1520,3731,-
chr11,47425906,1.340566207442265,38216,25221,63437,-
chr11,47425907,1.408414220733379,55469,35924,91393,-
chr11,47425909,1.5287153438214722,35912,22429,58341,-
chr11,47425913,2.412334686395181,3203,2181,5384,-
chr11,47425918,1.6391881009208755,5939,3712,9651,-
chr11,47425919,1.7231101457893172,8702,5371,14073,-
chr11,47425921,1.8924894149345648,5676,3463,9139,-
chr11,47425925,1.4289558997454381,7614,4090,11704,-
chr11,47425927,1.5881010562734181,15398,8638,24036,-
chr11,47425933,1.553739835910239,7457,3863,11320,-
chr11,47425934,1.7319095253832268,4224,2263,6487,-
chr11,47425942,1.665871392865258,1891,977,2868,-
chr11,47425947,1.6950324509400123,3807,1855,5662,-
chr11,47426215,1.5191488184182855,1338,633,1971,-
chr11,47426235,1.364687536548283,1861,1134,2995,-
chr11,47426237,1.7293993677555322,745,364,1109,-
chr11,47426238,0.6289102707540837,1080,544,1624,-
chr11,47426249,0.6057362090772149,2557,1409,3966,-
chr11,47426255,1.387780040030771,1885,1118,3003,-
chr11,47426256,1.373471281939288,1622,963,2585,-
chr11,47618785,2.0046,770,499,1269,-
chr11,47618838,0.5923898531375167,782,534,1316,-
chr11,47618901,2.143138283914983,1209,823,2032,-
chr11,47618902,2.143138283914983,1209,823,2032,-
chr11,47625693,2.259664607237424,752,514,1266,-
chr11,47631708,1.7746376811594204,631,479,1110,-
chr11,47638734,4.259461618504421,3009,2253,5262,-
chr11,47638735,4.400942212178624,1953,1408,3361,-
chr11,47638755,1.105653021442495,708,512,1220,-
chr11,47638756,0.8121516319515099,1157,826,1983,-
chr11,47639012,0.42637768325858266,876,706,1582,-
chr11,47639013,0.51252017283565,894,673,1567,-
chr11,47639015,0.51252017283565,894,673,1567,-
chr11,47639025,2.2037414965986395,588,419,1007,-
chr11,47639044,0.9499372790512032,594,473,1067,-
chr11,47639046,0.9499372790512032,594,473,1067,-
chr11,47717440,2.0731575327438616,1034,843,1877,-
chr11,47722996,0.5367680108223352,655,450,1105,-
chr11,47722997,0.5318052428675285,665,464,1129,-
chr11,47736660,2.8664772727272725,1008,703,1711,-
chr11,47736662,2.8664772727272725,1008,703,1711,-
chr11,47778780,3.0051107177520846,648,390,1038,-
chr11,47778912,0.4233571807101219,580,443,1023,-
chr11,47778913,0.4233571807101219,580,443,1023,-
chr11,47779006,2.039965871839777,1107,1141,2248,-
chr11,47779008,2.039965871839777,1107,1141,2248,-
chr11,47779018,2.389303482587065,1242,1071,2313,-
chr11,47779019,1.6911341668257482,1995,1643,3638,-
chr11,47779020,2.389303482587065,1242,1071,2313,-
chr11,47779171,0.3620667979717555,719,486,1205,-
chr11,47779172,0.3620667979717555,719,486,1205,-
chr11,47788224,0.45452793512392786,672,423,1095,-
chr11,47798063,0.41077735772202495,666,538,1204,-
chr11,47807107,1.3210606036606698,725,519,1244,-
chr11,47815984,5.546637280352962,746,553,1299,-
chr11,47819439,4.8585814217343595,672,491,1163,-
chr11,47847904,2.204599342707247,589,419,1008,-
chr11,57326152,0.5398032762012773,2004,2094,4098,-
chr11,57326164,0.5459244033830726,1404,1347,2751,-
chr11,57326177,17.362215624825296,4539,3722,8261,-
chr11,57326178,17.3622156248253,4539,3722,8261,-
chr11,57326210,0.3395508184240579,668,425,1093,-
chr11,57326323,1.8268551236749115,791,565,1356,-
chr11,57326336,1.9636121666446318,1059,731,1790,-
chr11,57326347,0.5356354300385109,672,474,1146,-
chr11,57326348,0.5112326420070248,1126,809,1935,-
chr11,57326353,0.8166174398007536,849,651,1500,-
chr11,57326460,0.5847383973579002,840,522,1362,-
chr11,57326469,2.5464285714285717,681,439,1120,-
chr11,57326844,1.7928692699490663,863,588,1451,-
chr11,57326845,2.5737825271229298,927,532,1459,-
chr11,57326865,1.8886930256721708,1207,861,2068,-
chr11,57326883,2.941787941787942,565,480,1045,-
chr11,57327460,1.005559532331186,1138,761,1899,-
chr11,57327461,1.005559532331186,1138,761,1899,-
chr11,57327470,3.509681881051176,524,481,1005,-
chr11,57327474,2.2127017299431087,732,593,1325,-
chr11,57327476,1.7168285961645946,1588,1233,2821,-
chr11,57327819,0.7151590923298118,1545,940,2485,-
chr11,57327842,1.56805356288857,1170,614,1784,-
chr11,57327850,1.9753705318221446,1006,743,1749,-
chr11,57327851,1.4931237721021609,968,508,1476,-
chr11,57327867,1.7145075421472935,1047,783,1830,-
chr11,57327868,2.126355140186916,710,534,1244,-
chr11,57327877,1.910518053375196,1216,636,1852,-
chr11,57327878,1.910518053375196,1216,636,1852,-
chr11,57330343,3.6829379562043796,620,547,1167,-
chr11,57330424,0.5159172019985725,555,466,1021,-
chr11,57331766,0.6619718309859155,610,425,1035,-
chr11,57331802,1.9726980728051393,736,466,1202,-
chr11,57331808,1.4410473457787771,1330,920,2250,-
chr11,57331814,2.161764705882353,650,371,1021,-
chr11,57332178,1.8589211618257264,531,481,1012,-
chr11,57332186,0.5510923185341791,551,515,1066,-
chr11,57332268,1.7177489177489178,619,461,1080,-
chr11,57332276,2.8109917355371903,790,604,1394,-
chr11,57332277,2.7896081022110444,1324,979,2303,-
chr11,57332436,2.814062248024512,697,476,1173,-
chr11,57332793,2.220832480045382,708,566,1274,-
chr11,57334516,1.667488823801449,745,498,1243,-
chr11,57528787,0.48143626570915615,837,556,1393,-
chr11,57528789,0.48143626570915615,837,556,1393,-
chr11,57528911,3.5278730383748673,573,441,1014,-
chr11,57530710,2.5175612493835073,738,493,1231,-
chr11,57576599,0.4969400244798042,811,569,1380,-
chr11,57576600,0.49197305973731653,1055,741,1796,-
chr11,57576608,0.4444640756888403,784,702,1486,-
chr11,59608594,0.3210252973697437,870,634,1504,-
chr11,59608595,0.3210252973697437,870,634,1504,-
chr11,59637083,50.26897648084656,720,677,1397,-
chr11,59806335,0.3771796167508881,1004,813,1817,-
chr11,59806384,1.4109411187614178,1424,1015,2439,-
chr11,59806385,1.886193110247001,983,588,1571,-
chr11,59806555,1.4570422535211267,2068,1419,3487,-
chr11,59806558,1.1955017801657404,2125,1565,3690,-
chr11,59806559,0.9898127022868362,1065,801,1866,-
chr11,59806566,2.24296875,869,511,1380,-
chr11,59806582,2.120229483661761,679,421,1100,-
chr11,59806597,0.9598353200248936,801,632,1433,-
chr11,59806598,1.3295484906318724,1388,975,2363,-
chr11,59806795,3.46768060836502,626,525,1151,-
chr11,59806796,3.1053557391893567,1196,902,2098,-
chr11,59806799,2.4223308626399622,639,372,1011,-
chr11,59806800,2.4223308626399622,639,372,1011,-
chr11,59809888,2.9223527060271683,659,572,1231,-
chr11,60890773,6.652081611042599,1907,1573,3480,-
chr11,60890774,6.453352214957979,1230,979,2209,-
chr11,60890782,13.091136079900124,855,533,1388,-
chr11,60890784,9.18782433976893,2394,1654,4048,-
chr11,60890785,10.637085766874897,1397,983,2380,-
chr11,60890851,2.4617508558160983,779,599,1378,-
chr11,60890998,0.15573881915809507,490,760,1250,-
chr11,60891000,0.15573881915809507,490,760,1250,-
chr11,60891042,0.3771062288461068,709,733,1442,-
chr11,60891043,0.4310597690157005,562,779,1341,-
chr11,60891046,0.1793686303753418,327,744,1071,-
chr11,60891047,0.27279379197743864,849,1519,2368,-
chr11,60891049,0.25030536502865736,295,733,1028,-
chr11,60891051,1.9936491769762419,711,898,1609,-
chr11,60891052,3.2725400457665907,314,873,1187,-
chr11,60891053,3.225733361951949,1189,2006,3195,-
chr11,60891054,3.9030069377050074,767,1463,2230,-
chr11,60898225,1.037292693859256,550,484,1034,-
chr11,60898226,1.037292693859256,550,484,1034,-
chr11,60901532,2.788600548768637,903,620,1523,-
chr11,60901535,2.1428095512662106,822,553,1375,-
chr11,60903752,0.9902777777777776,650,539,1189,-
chr11,60903753,0.8032621460093133,1016,808,1824,-
chr11,60903855,1.168389881781645,671,529,1200,-
chr11,60906532,1.7540489833745863,649,481,1130,-
chr11,60906584,0.2718616544387113,814,523,1337,-
chr11,61299663,0.6215720175555259,1015,1029,2044,-
chr11,61299692,9.789704721386315,5097,4277,9374,-
chr11,61299693,9.789704721386315,5097,4277,9374,-
chr11,61299700,12.427808302808304,1521,1007,2528,-
chr11,61299701,18.79597379919432,5597,3162,8759,-
chr11,61299702,18.79597379919432,5597,3162,8759,-
chr11,61299707,5.007666102256337,2190,1129,3319,-
chr11,61299708,3.7764487094507393,3776,1605,5381,-
chr11,61299709,4.447104981264225,3886,1728,5614,-
chr11,61299974,0.522231257114978,668,558,1226,-
chr11,61300869,6.043531827515401,565,486,1051,-
chr11,61300906,1.9551282051282048,1036,701,1737,-
chr11,61302313,2.0141925988225404,832,655,1487,-
chr11,61302322,1.6636108091275266,1610,1054,2664,-
chr11,61302329,1.1076388888888888,1913,1133,3046,-
chr11,61302331,1.3563913997470267,2595,1567,4162,-
chr11,61302350,2.00610399091499,1318,735,2053,-
chr11,61302352,1.6325043148309226,1765,1027,2792,-
chr11,61303142,2.207628011519281,897,618,1515,-
chr11,61303877,3.5348241323084086,606,476,1082,-
chr11,61303890,1.616161616161616,989,593,1582,-
chr11,61309055,1.4326730625027715,1320,1006,2326,-
chr11,61309075,2.0867983367983367,802,480,1282,-
chr11,61309930,1.7436391959053483,1021,792,1813,-
chr11,61309931,1.0120407990519722,1912,1610,3522,-
chr11,61309932,1.0120407990519722,1912,1610,3522,-
chr11,61309935,0.6502411407003565,885,752,1637,-
chr11,61310320,1.9301309762177405,1866,1347,3213,-
chr11,61310322,2.155172413793103,964,771,1735,-
chr11,61310346,0.5779534475186648,751,620,1371,-
chr11,61310363,0.5954545454545455,654,549,1203,-
chr11,61313521,0.6919302071973826,1916,993,2909,-
chr11,61313522,1.6393324134305802,1635,1067,2702,-
chr11,61313560,0.5708844565912661,934,592,1526,-
chr11,61313576,1.8667223481684765,893,577,1470,-
chr11,61313588,2.5598235806964458,845,526,1371,-
chr11,61314093,1.4858343890360477,548,456,1004,-
chr11,61316321,2.5621286489279256,683,552,1235,-
chr11,61316335,1.8293125810635533,655,513,1168,-
chr11,61316380,1.1086203980754437,1690,1201,2891,-
chr11,61316541,1.5902225578939853,1378,899,2277,-
chr11,61321671,1.1990471672792116,886,743,1629,-
chr11,61321678,3.050580604868421,1027,860,1887,-
chr11,61323064,1.5386702849389418,998,736,1734,-
chr11,61323089,2.423439604849573,770,523,1293,-
chr11,61324075,1.6445056523902637,5722,3584,9306,-
chr11,61324077,1.2870786903905607,9224,5534,14758,-
chr11,61324092,0.739089116012193,2630,1520,4150,-
chr11,61324101,1.4040278384830045,2609,1213,3822,-
chr11,61324117,1.4838571367319813,1853,842,2695,-
chr11,61325630,1.3853490290822936,2325,1506,3831,-
chr11,61325638,0.6110855777185403,830,505,1335,-
chr11,61325641,1.651315789473684,1003,607,1610,-
chr11,61325642,1.4869658472199303,2099,1101,3200,-
chr11,61325644,1.4915441841863009,2966,1599,4565,-
chr11,61325653,2.0108108108108107,836,449,1285,-
chr11,61325665,3.178486435030938,635,381,1016,-
chr11,61326872,1.1160460313506007,2134,1333,3467,-
chr11,61326874,0.9607555851546893,1652,994,2646,-
chr11,61329461,2.3089683773976155,916,642,1558,-
chr11,61329466,0.5648009756849681,1520,1107,2627,-
chr11,61329476,1.7414826148634464,1201,866,2067,-
chr11,61329532,2.102219443576117,806,456,1262,-
chr11,61329553,1.8506396631153492,1900,1322,3222,-
chr11,61331574,1.6518218623481782,815,569,1384,-
chr11,61331627,0.6143533608019187,998,643,1641,-
chr11,61331670,2.1872177055103887,744,491,1235,-
chr11,61331687,2.4615499401052614,1045,654,1699,-
chr11,61332939,0.40245061265316334,618,464,1082,-
chr11,61349166,19.50299604114757,1126,1205,2331,-
chr11,61349167,19.50299604114757,1126,1205,2331,-
chr11,61349171,10.68472647665227,870,481,1351,-
chr11,61349172,11.94673935043993,735,413,1148,-
chr11,61411060,2.276831239895535,795,730,1525,-
chr11,61411067,2.1171445865487923,1382,970,2352,-
chr11,61411076,1.1950159668481588,1004,550,1554,-
chr11,61429205,1.6489338555265451,658,382,1040,-
chr11,61429206,1.6489338555265451,658,382,1040,-
chr11,61429207,1.6489338555265451,658,382,1040,-
chr11,61789212,1.8447303153507815,2751,1941,4692,-
chr11,61789864,1.8406814780706804,1598,1240,2838,-
chr11,61789882,0.7164331276795984,1826,1459,3285,-
chr11,61790567,1.5186745762641904,2690,1962,4652,-
chr11,61790580,0.5823045267489712,848,728,1576,-
chr11,61790583,1.4594478156883675,1523,1273,2796,-
chr11,61790586,1.7332412389123162,768,597,1365,-
chr11,61799808,2.75143560295324,1031,847,1878,-
chr11,61799879,0.6317103620474407,1517,917,2434,-
chr11,61799918,0.7202258238537309,4950,3774,8724,-
chr11,61799919,1.0276315789473685,1484,1349,2833,-
chr11,61799947,2.386024844720497,590,459,1049,-
chr11,61800019,2.01044733981471,1365,912,2277,-
chr11,61800143,1.6134751773049645,701,563,1264,-
chr11,61800163,2.3207457883778155,790,586,1376,-
chr11,61800191,1.1298170443194364,1282,826,2108,-
chr11,61800192,1.1298170443194364,1282,826,2108,-
chr11,61800193,1.1298170443194364,1282,826,2108,-
chr11,61800199,1.222701348980009,1335,987,2322,-
chr11,61800201,1.3906191938736936,2183,1515,3698,-
chr11,61800202,0.7512777496933645,1274,897,2171,-
chr11,61800203,1.0288309862142164,2178,1556,3734,-
chr11,61800204,1.005787037037037,868,575,1443,-
chr11,61800326,2.887832699619772,881,525,1406,-
chr11,61800533,1.5921929887447128,1032,753,1785,-
chr11,61800568,1.5557074504442925,1137,846,1983,-
chr11,61800630,1.6073563218390807,873,599,1472,-
chr11,61800738,1.4805693559693986,1011,762,1773,-
chr11,61801216,1.5606062446109563,1976,1228,3204,-
chr11,61801270,1.60317666600938,2328,1585,3913,-
chr11,61801409,1.4299136488838569,1566,1002,2568,-
chr11,61801456,1.3976721919693615,1353,982,2335,-
chr11,61801473,2.19308012120358,818,616,1434,-
chr11,61801632,1.7194581280788177,715,579,1294,-
chr11,61801652,1.6638680659670164,894,574,1468,-
chr11,61801775,0.6314156431803492,4069,2974,7043,-
chr11,61801776,0.6314156431803492,4069,2974,7043,-
chr11,61801777,0.6314156431803492,4069,2974,7043,-
chr11,61801790,2.5396353547364248,1164,840,2004,-
chr11,61801844,2.0655239748318506,594,418,1012,-
chr11,61801871,1.6286554538545417,807,570,1377,-
chr11,61801872,1.6286554538545417,807,570,1377,-
chr11,61801887,2.478712013230842,797,512,1309,-
chr11,61801988,0.42797298210966556,675,497,1172,-
chr11,61802156,0.5714044753296702,1601,1358,2959,-
chr11,61802171,0.6581494386372435,679,573,1252,-
chr11,61802177,4.981143042432033,5217,4131,9348,-
chr11,61802178,4.981143042432032,5217,4131,9348,-
chr11,61802292,3.864419345969747,5275,4164,9439,-
chr11,61802293,3.864419345969747,5275,4164,9439,-
chr11,61802337,2.1063709011451786,1166,860,2026,-
chr11,61802414,0.5343379446640316,720,527,1247,-
chr11,61802419,1.6771027288459994,1497,1053,2550,-
chr11,61802458,1.8621553884711783,1485,923,2408,-
chr11,61802459,1.8621553884711783,1485,923,2408,-
chr11,61802900,0.5566191078201191,669,564,1233,-
chr11,61803049,2.1233275159976728,729,572,1301,-
chr11,61803094,1.6973354231974924,832,579,1411,-
chr11,61803095,0.5533854166666666,594,447,1041,-
chr11,61803099,1.5959225579348784,701,486,1187,-
chr11,61803392,2.406048387096774,701,619,1320,-
chr11,61810797,0.5836398668768611,587,518,1105,-
chr11,61810804,0.4997152619589977,584,438,1022,-
chr11,61810830,0.4904247660187185,785,462,1247,-
chr11,61811003,0.5218069786383894,1082,799,1881,-
chr11,61811018,0.3923406969258857,1232,822,2054,-
chr11,61812555,1.7066712223456049,739,508,1247,-
chr11,61812570,2.243801246850353,1131,764,1895,-
chr11,61812666,1.8254423648260136,1036,807,1843,-
chr11,61813309,1.6604014598540149,1010,684,1694,-
chr11,61813310,1.0894852255121301,1222,1026,2248,-
chr11,61813327,0.9918016470689818,1028,896,1924,-
chr11,61813333,1.9873869171885876,736,478,1214,-
chr11,61816628,1.4789585656401076,1166,874,2040,-
chr11,61816630,1.4631787275374657,922,779,1701,-
chr11,61876158,1.8440894568690092,1183,625,1808,-
chr11,61876160,1.5978059102680344,5159,2855,8014,-
chr11,61876161,1.873140090750557,2539,1458,3997,-
chr11,61876164,2.3199934393964243,942,468,1410,-
chr11,61876169,1.6041104110411042,1155,605,1760,-
chr11,61876177,1.9775971451229186,797,387,1184,-
chr11,61876386,1.7586206896551724,662,347,1009,-
chr11,61876398,0.577091976497779,1716,907,2623,-
chr11,61876434,1.6194981729913736,4511,2510,7021,-
chr11,61876437,1.7973494902135738,3140,2242,5382,-
chr11,61876440,1.7394576199494345,2853,2464,5317,-
chr11,61876441,1.5520158819540544,6624,4663,11287,-
chr11,61876442,0.9495270546946061,4520,2323,6843,-
chr11,61876443,1.8919137622102769,3723,3001,6724,-
chr11,61876445,1.5676342568219428,5064,3572,8636,-
chr11,61876446,0.3900387382401771,880,416,1296,-
chr11,61876447,1.6410628818519428,3876,2854,6730,-
chr11,61876448,1.6688701391487768,3528,2469,5997,-
chr11,61876449,1.6688701391487768,3528,2469,5997,-
chr11,61876450,1.8150863277650924,2529,1726,4255,-
chr11,61876451,0.9126922759362138,1780,911,2691,-
chr11,61876452,1.2335739279798328,2249,1118,3367,-
chr11,61876455,0.8778787734640179,795,408,1203,-
chr11,61876879,0.4628750888292874,1261,785,2046,-
chr11,61876880,0.48829898749478745,1685,997,2682,-
chr11,61878771,0.4582822405449965,868,580,1448,-
chr11,61964785,1.1985384742244671,44791,29654,74445,-
chr11,61964806,1.2556897919360972,38745,23830,62575,-
chr11,61964815,1.3533820960250886,22265,12472,34737,-
chr11,61964837,1.2078653573253324,33173,18446,51619,-
chr11,61964838,1.2601708412465036,17449,10237,27686,-
chr11,61964875,1.299042657340086,11680,7845,19525,-
chr11,61965080,1.1114036408873171,18731,13829,32560,-
chr11,61965109,1.3279744555720792,40182,24896,65078,-
chr11,61965110,1.332963160130065,42191,26351,68542,-
chr11,61965112,1.2536213578407327,14741,8952,23693,-
chr11,61965384,1.5828139283636669,9843,5347,15190,-
chr11,61965390,1.5924030636243423,9543,4898,14441,-
chr11,61965402,1.4426963461302758,5397,3027,8424,-
chr11,61965408,1.2774581196882586,18971,11385,30356,-
chr11,61965507,0.7892218604379108,2810,2154,4964,-
chr11,61967391,1.366451415455241,3282,2613,5895,-
chr11,61967435,1.3937448531757248,23748,13870,37618,-
chr11,61967436,1.3799617327054476,23905,11963,35868,-
chr11,61967438,1.3173147905991147,18097,9465,27562,-
chr11,61967442,0.7864339690536165,3853,3175,7028,-
chr11,61967444,0.8120299105797365,10115,6077,16192,-
chr11,61967449,1.5297903406432958,1586,1330,2916,-
chr11,61967452,1.5645344504367698,10441,5982,16423,-
chr11,61967453,1.239760250802153,5921,3969,9890,-
chr11,61967456,0.7363728470111448,1287,979,2266,-
chr11,61967459,1.8663311663136053,6275,3290,9565,-
chr11,61967577,1.3048403215613658,2710,2451,5161,-
chr11,61967582,1.6523791910532843,2489,2241,4730,-
chr11,61967588,1.3439752832131822,4407,3883,8290,-
chr11,61967590,1.4535338321759501,12091,8991,21082,-
chr11,61967591,1.3840793528505395,6141,5279,11420,-
chr11,61967593,1.4368062368096035,3994,3420,7414,-
chr11,61967599,1.9325830653804927,1481,1243,2724,-
chr11,61967600,1.5708388079891888,6708,4612,11320,-
chr11,61967621,1.4340427606718835,996,725,1721,-
chr11,61967624,0.570651659888395,1096,969,2065,-
chr11,61967625,1.5349067502888267,743,497,1240,-
chr11,61967626,1.006714060807634,4204,3162,7366,-
chr11,61967627,1.1028715935102302,4175,3111,7286,-
chr11,62516320,15.568329123065483,1081,1254,2335,-
chr11,62516321,15.568329123065483,1081,1254,2335,-
chr11,62517386,3.0115922517340774,850,640,1490,-
chr11,62559790,1.2540402328150506,21904,14900,36804,-
chr11,62559803,1.401134622842313,17743,10401,28144,-
chr11,62559805,1.3866082710380878,37589,25483,63072,-
chr11,62559808,1.0439273283778914,26629,17825,44454,-
chr11,62559809,1.1761219077157197,44468,29224,73692,-
chr11,62559811,1.3719355181354262,35308,22964,58272,-
chr11,62559812,1.3158931780529406,19988,13820,33808,-
chr11,62559814,1.4562329009223869,20375,12564,32939,-
chr11,62559815,1.6010512312186984,9384,5989,15373,-
chr11,62559817,1.5177986241400876,5275,2869,8144,-
chr11,62559826,1.1163702823916462,16328,8830,25158,-
chr11,62559827,1.044758997074824,12517,6576,19093,-
chr11,62559828,1.0877213782900719,16019,9260,25279,-
chr11,62559834,1.4433764363317574,3226,1680,4906,-
chr11,62560093,1.7384927528544336,2221,1032,3253,-
chr11,62560112,1.4109438430311232,1742,738,2480,-
chr11,62560113,1.3962863857741536,1914,1295,3209,-
chr11,62560121,1.6255101561601848,5436,2928,8364,-
chr11,62560123,1.6255101561601848,5436,2928,8364,-
chr11,62560125,1.4275450762829405,970,514,1484,-
chr11,62560126,1.4623648738997295,1802,1046,2848,-
chr11,62560129,1.501292075271667,1006,615,1621,-
chr11,62560133,1.4814225941422592,842,477,1319,-
chr11,62560142,1.0190438887284603,1711,949,2660,-
chr11,62560143,0.9138295712669448,1158,719,1877,-
chr11,62560144,1.0458423958507614,986,555,1541,-
chr11,62567003,1.276126793107366,39176,28585,67761,-
chr11,62567004,1.4266875981161695,17891,13376,31267,-
chr11,62567007,1.413316792099924,36542,24150,60692,-
chr11,62567008,1.4044634643168377,36749,24359,61108,-
chr11,62567010,1.4533308630706268,7869,5654,13523,-
chr11,62567522,1.390685923589004,25728,17669,43397,-
chr11,62567523,1.5289873341850422,15310,10943,26253,-
chr11,62567528,1.1331659776099514,2538,1867,4405,-
chr11,62567529,1.1234950120399037,1632,1206,2838,-
chr11,62570995,1.3420240137221269,4799,2914,7713,-
chr11,62570997,1.2052836743349964,4013,3214,7227,-
chr11,62570998,1.3934054659568564,4191,2480,6671,-
chr11,62571002,1.2967704686306682,10295,6676,16971,-
chr11,62571004,1.248665852475306,13720,8618,22338,-
chr11,62571012,1.484538567493113,2268,1814,4082,-
chr11,62571014,1.4369198347875296,4692,2518,7210,-
chr11,62571016,1.4190655942278012,6822,3622,10444,-
chr11,62571018,1.447187195286777,6293,3769,10062,-
chr11,62571036,1.3724941724941726,2943,1429,4372,-
chr11,62571037,1.5133377049180332,1802,1249,3051,-
chr11,62571038,1.030049840998043,4243,2043,6286,-
chr11,62571039,0.7601183773515837,4084,2081,6165,-
chr11,62571045,0.6820728291316526,973,713,1686,-
chr11,62571048,0.6844605059370161,946,595,1541,-
chr11,62571050,1.3884466848245862,2246,1446,3692,-
chr11,62571052,1.3101747103754484,3208,2026,5234,-
chr11,62571053,1.3676850215896486,2845,1732,4577,-
chr11,62571055,1.4411333797184085,2509,1460,3969,-
chr11,62571056,1.7193072388414925,1547,880,2427,-
chr11,62571059,1.3884964248506502,1419,816,2235,-
chr11,62571061,1.3671341341095207,1385,767,2152,-
chr11,62572652,2.373363398808549,13175,10766,23941,-
chr11,62572686,1.2061906409194265,42230,29154,71384,-
chr11,62572687,1.231161197091099,29874,19532,49406,-
chr11,62572691,1.3203185657059269,13228,8351,21579,-
chr11,62572698,1.467911195235071,22906,14148,37054,-
chr11,62572699,1.3907425140598877,13968,7309,21277,-
chr11,62572703,1.4719765408134418,11650,8446,20096,-
chr11,62572705,1.4393871446940716,11460,8077,19537,-
chr11,62572707,1.4703353380069775,23491,14420,37911,-
chr11,62572708,1.4962571817628056,21089,11657,32746,-
chr11,62572710,1.4503634544707384,9307,4572,13879,-
chr11,62572719,2.119397715472482,2488,1604,4092,-
chr11,62572720,0.9346828319231172,6784,3190,9974,-
chr11,62572721,0.8330771446027041,11174,6426,17600,-
chr11,62572723,1.163591159478253,3900,2458,6358,-
chr11,62572724,1.2918102197512482,10128,6476,16604,-
chr11,62572731,1.3254847645429364,1217,721,1938,-
chr11,62572732,1.821054400806768,3106,1372,4478,-
chr11,62572734,1.4237040793055429,5838,2482,8320,-
chr11,62572735,1.3324664918711953,5468,2275,7743,-
chr11,62572736,1.3189575773531181,7696,3958,11654,-
chr11,62572737,1.3508811330507593,9597,5220,14817,-
chr11,62572738,1.4543066525444803,4656,2906,7562,-
chr11,62572739,1.7023394591693621,4371,2326,6697,-
chr11,62572740,1.9250317589521602,3038,1310,4348,-
chr11,62572741,2.4688959962491,1519,670,2189,-
chr11,62573862,0.5830757402864214,1207,528,1735,-
chr11,62596494,2.12259815168671,746,528,1274,-
chr11,62596673,1.9121517378854977,681,443,1124,-
chr11,62597701,1.9710083116871022,743,520,1263,-
chr11,62600679,0.19034243463174846,511,562,1073,-
chr11,62617072,11.506041572253299,545,509,1054,-
chr11,62624900,0.5336169140954641,1911,2679,4590,-
chr11,62624901,0.45375612480641797,1464,1654,3118,-
chr11,62624918,10.763264852735235,6988,9175,16163,-
chr11,62624919,10.763264852735235,6988,9175,16163,-
chr11,62624926,10.524488163668932,6891,5798,12689,-
chr11,62624927,10.524488163668932,6891,5798,12689,-
chr11,62624932,1.9741499870753776,3783,1831,5614,-
chr11,62624933,1.988956132656902,5317,2049,7366,-
chr11,62624934,2.541761544974963,6972,2597,9569,-
chr11,62624935,2.6748447204968944,3131,1149,4280,-
chr11,62624936,3.888232668432339,5976,2418,8394,-
chr11,62624937,7.588219940838698,1761,820,2581,-
chr11,62624939,10.282256293985698,7797,1864,9661,-
chr11,62624940,13.329415675815227,9518,1849,11367,-
chr11,62624941,13.276131282409711,11824,2044,13868,-
chr11,62624942,15.775552042574345,9341,1277,10618,-
chr11,62624943,13.188036308870176,8218,866,9084,-
chr11,62624945,8.554769211685306,4996,369,5365,-
chr11,62624946,10.106434775001404,6746,443,7189,-
chr11,62624947,11.847861547162275,10031,659,10690,-
chr11,62624948,13.508091780470506,9819,620,10439,-
chr11,62624949,15.286218598177149,7978,487,8465,-
chr11,62624950,21.396298293201692,3116,207,3323,-
chr11,62625117,0.6888888888888889,2428,1734,4162,-
chr11,62625254,1.4701347240330291,2140,1474,3614,-
chr11,62625401,0.4813408056737178,15335,10885,26220,-
chr11,62625402,0.4735679680095823,12393,9020,21413,-
chr11,62625497,1.759712667272761,5569,3833,9402,-
chr11,62625498,1.7110244109701511,4026,2618,6644,-
chr11,62625648,0.7559591523479445,4265,3093,7358,-
chr11,62625777,14.730557575164676,18910,14877,33787,-
chr11,62625778,14.730557575164676,18910,14877,33787,-
chr11,62625779,14.73055757516468,18910,14877,33787,-
chr11,62625783,13.31688224458661,9528,4311,13839,-
chr11,62625784,14.348156323004538,6481,2611,9092,-
chr11,62625837,0.6760064184670227,3533,2126,5659,-
chr11,62625916,0.7060106096025894,1281,1071,2352,-
chr11,62625918,1.3583723459592378,1573,1006,2579,-
chr11,62626144,1.33565973559235,2005,1483,3488,-
chr11,62626443,1.8231506825732928,1794,1138,2932,-
chr11,62626614,1.4496710934591035,1459,1150,2609,-
chr11,62626617,1.4768233387358187,1631,1233,2864,-
chr11,62626621,1.3339233938778563,4635,3238,7873,-
chr11,62626622,1.6457462019660412,3018,2237,5255,-
chr11,62626908,1.4619984500965801,1579,1252,2831,-
chr11,62626920,1.4684204843991795,1942,1501,3443,-
chr11,62626923,1.3778904022806462,1449,1147,2596,-
chr11,62627062,1.7031710914454272,1489,1129,2618,-
chr11,62627307,0.7595484526944235,2080,1267,3347,-
chr11,62627318,1.7123307656395892,1066,1007,2073,-
chr11,62627329,1.5950000000000002,1231,895,2126,-
chr11,62627338,1.841210359477617,2085,1655,3740,-
chr11,62628996,4.175459232315286,3431,2609,6040,-
chr11,62628998,8.44046967361152,4907,3882,8789,-
chr11,62629001,6.429711419481939,3910,2632,6542,-
chr11,62629002,4.0480938416422285,1427,1022,2449,-
chr11,62629008,2.2710573476702507,684,464,1148,-
chr11,62629011,3.8348820696183084,1379,825,2204,-
chr11,62629255,1.4367078189300413,1090,728,1818,-
chr11,62629274,1.0375305351987565,1167,868,2035,-
chr11,62629276,1.2499920881844053,1794,1394,3188,-
chr11,62629631,1.9812795996783128,904,721,1625,-
chr11,62629833,1.6736625514403294,995,809,1804,-
chr11,62630222,1.9920634920634919,1254,1049,2303,-
chr11,62630252,1.803989361702128,1189,939,2128,-
chr11,62630267,2.3466666666666667,1359,849,2208,-
chr11,62630421,1.433461703038083,1049,860,1909,-
chr11,62630423,1.4051724137931034,1303,959,2262,-
chr11,62630425,1.5597826086956519,901,735,1636,-
chr11,62630440,3.357647230108466,886,722,1608,-
chr11,62630482,1.8682170542635657,963,644,1607,-
chr11,62630491,1.677743271221532,852,643,1495,-
chr11,62630782,1.674144838212635,1180,884,2064,-
chr11,62630793,1.6880591868158008,2162,1585,3747,-
chr11,62630799,1.5645514223194747,1143,913,2056,-
chr11,62631167,1.551688757391216,2560,2000,4560,-
chr11,62631169,1.551688757391216,2560,2000,4560,-
chr11,62631170,1.5503172297813792,1474,843,2317,-
chr11,62632619,1.0858490529052467,2187,1813,4000,-
chr11,62632646,1.864012518625483,2056,1673,3729,-
chr11,62632703,1.48997542997543,1122,924,2046,-
chr11,62632721,1.8834082411149295,1060,912,1972,-
chr11,62632732,1.5921780585295866,2442,1851,4293,-
chr11,62633242,1.6140839836492007,1240,827,2067,-
chr11,62633245,1.262582191895494,5649,4468,10117,-
chr11,62633246,1.262582191895494,5649,4468,10117,-
chr11,62633247,0.6576127320954908,1032,724,1756,-
chr11,62633469,2.0310032173150043,991,788,1779,-
chr11,62634937,1.7765513377223696,1625,1209,2834,-
chr11,62634938,1.4066482419775832,2007,1335,3342,-
chr11,62634992,1.7428382644446074,1603,1284,2887,-
chr11,62638999,1.7210450845892726,5225,3863,9088,-
chr11,62639051,1.7260273972602742,1619,1313,2932,-
chr11,62639377,1.4707905457672714,3907,3141,7048,-
chr11,62639659,0.7728668512459098,2361,1739,4100,-
chr11,62639660,1.5601974081551655,1390,1232,2622,-
chr11,62639666,1.3384615384615384,1420,1224,2644,-
chr11,62639683,1.325096525096525,1715,1294,3009,-
chr11,62639704,1.4644893572558737,1021,816,1837,-
chr11,62639706,0.5402515999589942,1084,842,1926,-
chr11,62639712,1.7344922580032298,960,725,1685,-
chr11,62639729,2.5796108794917605,1998,1094,3092,-
chr11,62639730,2.6431415335307475,2767,1607,4374,-
chr11,62646600,1.5992647058823528,869,696,1565,-
chr11,62646601,1.3534267322983715,1116,555,1671,-
chr11,62646610,0.5324384481278772,3921,2350,6271,-
chr11,62646611,0.5499669263516773,5752,3827,9579,-
chr11,62646612,0.5292107695415363,5419,3497,8916,-
chr11,62646613,0.6032719233603537,757,589,1346,-
chr11,62646614,0.4125380838718441,1036,578,1614,-
chr11,62662914,2.3244931871053507,1248,1002,2250,-
chr11,62662928,0.7642055959571058,1859,1097,2956,-
chr11,62662934,0.5577718773412631,2786,1765,4551,-
chr11,62662935,0.5991260502354813,5011,3276,8287,-
chr11,62662938,0.5311445508435932,1819,1274,3093,-
chr11,62662939,0.5726875483659686,2394,1735,4129,-
chr11,62662946,1.3822341857335128,1026,742,1768,-
chr11,62662947,1.0886570492100769,1630,1219,2849,-
chr11,62664962,3.401197919010629,844,539,1383,-
chr11,62676601,2.583333333333333,681,461,1142,-
chr11,62676622,2.411057427748808,1400,1018,2418,-
chr11,62676624,2.543698748381528,1024,661,1685,-
chr11,62676877,1.2736061875604252,740,641,1381,-
chr11,62676879,1.2736061875604252,740,641,1381,-
chr11,62676903,3.9775365053630174,792,627,1419,-
chr11,62676906,2.0037593984962405,901,626,1527,-
chr11,62676907,2.0037593984962405,901,626,1527,-
chr11,62677950,2.2599382538892825,30396,24206,54602,-
chr11,62677951,2.2599382538892825,30396,24206,54602,-
chr11,62677952,2.689281351723487,13469,11956,25425,-
chr11,62677983,1.4586573793452984,2877,2070,4947,-
chr11,62677988,1.269346817430651,9757,6293,16050,-
chr11,62677989,1.3252681574730398,3399,1838,5237,-
chr11,62677998,1.7566844919786098,1313,679,1992,-
chr11,62678017,1.794687961975785,5325,3410,8735,-
chr11,62678019,1.6324830817282667,1791,1129,2920,-
chr11,62678020,1.4103121817913393,6348,3913,10261,-
chr11,62678021,1.4103121817913393,6348,3913,10261,-
chr11,62678031,2.8602451541756797,1465,812,2277,-
chr11,62678079,1.0662308031019154,1582,970,2552,-
chr11,62678402,0.5964075008566178,1367,1011,2378,-
chr11,62715116,0.1920987654320988,388,629,1017,-
chr11,62715117,0.1920987654320988,388,629,1017,-
chr11,62720147,0.47762843752763284,830,525,1355,-
chr11,62720149,2.0280801015831487,1603,1106,2709,-
chr11,62720157,0.5894145950280674,832,492,1324,-
chr11,62720181,1.8149447278911568,682,447,1129,-
chr11,62721348,2.1583102611674043,709,411,1120,-
chr11,62721377,0.37557679002047284,926,495,1421,-
chr11,62722706,3.222408904623851,647,422,1069,-
chr11,62794427,2.3757575757575764,719,674,1393,-
chr11,62794429,2.3757575757575764,719,674,1393,-
chr11,62794432,3.4028849379402883,633,541,1174,-
chr11,62794433,3.4028849379402883,633,541,1174,-
chr11,62794963,1.209197470823176,1082,822,1904,-
chr11,62794964,0.696274118429807,597,500,1097,-
chr11,62824476,2.399367751428596,622,397,1019,-
chr11,62833111,2.588144074930835,812,600,1412,-
chr11,62833654,2.23859649122807,637,379,1016,-
chr11,62834467,1.6143223294775753,790,601,1391,-
chr11,62834488,3.3874619844352845,815,607,1422,-
chr11,62852113,1.8425101130103112,1589,1150,2739,-
chr11,62852289,1.6492829204693609,1149,884,2033,-
chr11,62852561,1.4160914581535806,1312,911,2223,-
chr11,62852618,2.3793831854668355,703,525,1228,-
chr11,62852640,1.9995939043339186,1297,890,2187,-
chr11,62853110,1.7525546643226018,637,478,1115,-
chr11,62853570,1.839121613557704,669,440,1109,-
chr11,62853830,2.6227414926897783,1026,680,1706,-
chr11,62853831,2.6227414926897783,1026,680,1706,-
chr11,62853966,0.9878735956223685,10071,7680,17751,-
chr11,62853967,0.9817717834968149,32512,26475,58987,-
chr11,62853968,0.9857720169724298,31401,25568,56969,-
chr11,62854039,2.4187866927592947,617,510,1127,-
chr11,62854694,0.9249617124575397,55489,42325,97814,-
chr11,62854695,0.9162097287249631,20638,17618,38256,-
chr11,62854916,0.590180487189196,667,416,1083,-
chr11,62854932,1.5399863294600136,750,531,1281,-
chr11,62855081,0.9679478531348533,9963,6573,16536,-
chr11,62855082,0.9929610353698415,11213,7356,18569,-
chr11,62855083,0.9929610353698415,11213,7356,18569,-
chr11,62855215,0.5787000514491509,887,594,1481,-
chr11,62855363,0.9031640571282636,7329,5449,12778,-
chr11,62855364,1.1228382735823097,1148,1185,2333,-
chr11,62855365,0.9549692703071269,9678,7597,17275,-
chr11,62855366,1.0346471095650784,2582,2413,4995,-
chr11,62855881,0.8245434736126224,859,521,1380,-
chr11,63574941,2.3983649201040507,921,701,1622,-
chr11,63590216,0.9768674500780672,950,565,1515,-
chr11,63590218,0.9768674500780672,950,565,1515,-
chr11,63590252,3.883459759371105,696,463,1159,-
chr11,63629348,1.430673007756396,2458,1960,4418,-
chr11,63629354,2.4535166479610924,708,593,1301,-
chr11,63629357,1.7319979096496996,1753,1391,3144,-
chr11,63629386,2.6005434782608696,758,528,1286,-
chr11,63629387,2.6005434782608696,758,528,1286,-
chr11,63629394,0.8984758460346163,1033,868,1901,-
chr11,63629395,1.3905878702253014,2201,1598,3799,-
chr11,63629397,1.8834777321781426,1168,730,1898,-
chr11,63629401,3.1072517997806526,1470,1001,2471,-
chr11,63646554,2.2071797190165623,606,475,1081,-
chr11,63999400,1.2400088165995473,603,433,1036,-
chr11,64000309,1.5529483515611167,741,611,1352,-
chr11,64152321,1.7309725158562366,654,429,1083,-
chr11,64152376,2.0571698967612733,641,571,1212,-
chr11,64165707,1.8544548956584095,840,715,1555,-
chr11,64223942,3.5232888448247937,1210,1105,2315,-
chr11,64223944,3.3982654680602797,1014,919,1933,-
chr11,64244566,1.7558578987150415,605,440,1045,-
chr11,64316808,0.8424388587547993,3775,2647,6422,-
chr11,64316862,1.5205100898115531,4713,3767,8480,-
chr11,64316865,0.7219925808161102,1702,1274,2976,-
chr11,64316866,1.594691864739035,1706,1165,2871,-
chr11,64316867,0.6132107767621786,1432,1283,2715,-
chr11,64316878,1.7935445705623545,1154,730,1884,-
chr11,64316879,1.7825677083943796,2807,2249,5056,-
chr11,64316880,1.7104470840551018,2090,1795,3885,-
chr11,64316883,0.4709661477637757,952,780,1732,-
chr11,64316897,2.0596837526402965,1866,1219,3085,-
chr11,64317100,2.2873358533539716,2089,1725,3814,-
chr11,64317133,0.9811758787149613,2118,1586,3704,-
chr11,64317139,1.5582063485690971,2556,1622,4178,-
chr11,64317308,1.7739796670104613,1504,1233,2737,-
chr11,64317337,0.5657200353190004,949,772,1721,-
chr11,64317361,1.7559730342271245,1576,1229,2805,-
chr11,64317523,1.4246361507736103,1069,946,2015,-
chr11,64317524,0.6401963840399002,1059,801,1860,-
chr11,64317525,1.501673245086826,2069,1362,3431,-
chr11,64317540,0.9329298119661378,5935,4471,10406,-
chr11,64317541,1.042814108328076,6007,4313,10320,-
chr11,64317543,1.3394470660139968,1610,940,2550,-
chr11,64769519,6.356075851393189,850,612,1462,-
chr11,64769520,7.220768879567901,1025,752,1777,-
chr11,64855431,0.9648184405423187,711,457,1168,-
chr11,64860215,1.8575882279585985,783,728,1511,-
chr11,64860216,1.9192345436702647,1112,1018,2130,-
chr11,64860218,2.247113825016697,1023,891,1914,-
chr11,64860219,2.773036487322201,943,783,1726,-
chr11,64860221,3.3198380566801617,614,493,1107,-
chr11,64860223,1.6454696651682732,681,533,1214,-
chr11,65077707,3.1625,626,379,1005,-
chr11,65077708,3.1625,626,379,1005,-
chr11,65078022,1.3072625698324023,782,536,1318,-
chr11,65078024,0.840232310982203,1385,1055,2440,-
chr11,65078212,1.546274784619078,809,662,1471,-
chr11,65078234,2.206453708023431,742,628,1370,-
chr11,65078235,2.206453708023431,742,628,1370,-
chr11,65078594,1.1205767674538365,895,590,1485,-
chr11,65078595,1.386835336184896,1471,1075,2546,-
chr11,65083516,1.16306710061427,657,513,1170,-
chr11,65120706,1.4115712612048064,7245,5079,12324,-
chr11,65120708,1.535624178107571,8733,6904,15637,-
chr11,65120709,1.5313727376910309,15534,11532,27066,-
chr11,65120780,1.3612532100667694,8303,6599,14902,-
chr11,65120781,1.3612532100667694,8303,6599,14902,-
chr11,65120786,1.208205915171982,8432,6292,14724,-
chr11,65120787,1.2905574043261234,3138,2403,5541,-
chr11,65120790,1.280566279994816,17066,12100,29166,-
chr11,65120792,1.3122419016460036,15932,11499,27431,-
chr11,65120795,1.5721108490566038,2343,1695,4038,-
chr11,65120798,1.4988231832892027,2214,1544,3758,-
chr11,65120799,0.7247115598037747,4849,3813,8662,-
chr11,65120801,1.4922118380062304,1915,1283,3198,-
chr11,65120991,1.753507593162541,1866,1172,3038,-
chr11,65120997,1.4889698471863888,4080,2428,6508,-
chr11,65121003,0.5844091017723492,3797,2538,6335,-
chr11,65121608,1.2636908820680504,7869,4931,12800,-
chr11,65121790,1.3718820861678005,3629,2645,6274,-
chr11,65122114,1.3594070560781506,13428,8933,22361,-
chr11,65122117,1.3449873676288773,4467,2384,6851,-
chr11,65122120,1.612704918032787,1573,1219,2792,-
chr11,65122124,1.838935574229692,3938,1988,5926,-
chr11,65122129,1.4757500147640703,3601,1651,5252,-
chr11,65122131,0.8625394090302301,2495,1658,4153,-
chr11,65122133,0.679771070756961,8890,5125,14015,-
chr11,65122134,0.6606718444953739,6138,3167,9305,-
chr11,65122135,0.6645215277512839,7502,4184,11686,-
chr11,65122138,1.3851598843948505,1317,726,2043,-
chr11,65122152,2.004078605858361,1080,557,1637,-
chr11,65122158,1.6629638944779788,1830,851,2681,-
chr11,65122159,1.6629638944779788,1830,851,2681,-
chr11,65122176,2.103252713102203,1666,840,2506,-
chr11,65122177,2.4004324373832,1834,815,2649,-
chr11,65122179,2.4126528340094584,1240,506,1746,-
chr11,65122184,1.662670836215353,915,343,1258,-
chr11,65127526,4.812950957023739,556,453,1009,-
chr11,65662016,0.5926489880059971,936,735,1671,-
chr11,65662041,0.23562885802469136,697,575,1272,-
chr11,65662057,1.437664327928906,1332,952,2284,-
chr11,65662058,1.8125173289687386,1216,862,2078,-
chr11,65662063,3.326525678492495,808,507,1315,-
chr11,65662194,1.8375600610652052,851,401,1252,-
chr11,65719766,4.043798108424656,748,677,1425,-
chr11,65719767,2.4707195378151257,606,543,1149,-
chr11,65854986,0.971649689824861,5532,4262,9794,-
chr11,65854993,0.7700260604953083,3370,2926,6296,-
chr11,65855043,1.6478620221228517,7349,4422,11771,-
chr11,65855044,1.6478620221228517,7349,4422,11771,-
chr11,65855115,0.7637344118638354,3501,2966,6467,-
chr11,65855159,1.3320388349514565,1721,1544,3265,-
chr11,65855165,1.4218882466281308,970,864,1834,-
chr11,65855168,1.661286466727846,1682,1456,3138,-
chr11,65855169,1.5886821337346841,2838,2466,5304,-
chr11,65855173,1.2759501276851437,2479,1679,4158,-
chr11,65855174,1.2060163146526188,3394,2320,5714,-
chr11,65855176,1.0191366266132622,915,641,1556,-
chr11,65855177,0.5013618859772706,627,506,1133,-
chr11,65855179,1.217363541474796,1548,914,2462,-
chr11,65855180,1.217363541474796,1548,914,2462,-
chr11,65855194,1.9051175379966203,1906,1108,3014,-
chr11,65855196,1.713309878461117,1414,705,2119,-
chr11,65855217,39.4265354258881,5906,2145,8051,-
chr11,65855218,39.09398440883812,5326,1934,7260,-
chr11,65855357,1.6527952150545218,2189,1557,3746,-
chr11,65855384,1.2644048208684169,3603,2018,5621,-
chr11,65856017,1.2280935687287737,21257,17054,38311,-
chr11,65856027,1.626039034117833,7985,6330,14315,-
chr11,65856028,1.4776869668426975,13926,10293,24219,-
chr11,65856111,1.2265577065029432,13222,10128,23350,-
chr11,65856114,1.2611497242533596,4414,3685,8099,-
chr11,65856147,1.3887674286054563,5609,4797,10406,-
chr11,65856148,1.3703816552743444,9805,8170,17975,-
chr11,65856156,1.352496192266999,5097,4280,9377,-
chr11,65856157,1.352496192266999,5097,4280,9377,-
chr11,65858121,1.8110936446557566,3622,3160,6782,-
chr11,65858132,1.9177464291179438,5748,4416,10164,-
chr11,65858142,1.5661187982570142,2133,1269,3402,-
chr11,65858144,1.113539510532083,1910,1336,3246,-
chr11,65858146,1.113539510532083,1910,1336,3246,-
chr11,65858152,1.7825518400896694,1467,807,2274,-
chr11,65858156,1.6396954674220965,1322,705,2027,-
chr11,65858157,1.7504202965000766,880,726,1606,-
chr11,65858161,1.6626553821740282,1142,596,1738,-
chr11,65858169,1.1801886792452831,1806,909,2715,-
chr11,65858171,1.1801886792452831,1806,909,2715,-
chr11,65884019,2.4260826210826214,629,379,1008,-
chr11,66284667,1.882422729793778,1025,778,1803,-
chr11,66284693,1.1887620076941372,1236,832,2068,-
chr11,66284694,0.8524432103050639,960,602,1562,-
chr11,66284963,1.6644906939888862,3246,2570,5816,-
chr11,66284964,1.6462944885190252,2932,2382,5314,-
chr11,66285420,2.6302339011919167,873,678,1551,-
chr11,66285450,1.0441176470588236,780,527,1307,-
chr11,66285452,1.0441176470588236,780,527,1307,-
chr11,66287606,0.9331260452735968,1365,953,2318,-
chr11,66287607,0.9331260452735968,1365,953,2318,-
chr11,66287659,0.5559284116331096,709,446,1155,-
chr11,66287849,1.5680580762250453,791,550,1341,-
chr11,66287879,2.157358905035485,1760,1075,2835,-
chr11,66287881,2.157358905035485,1760,1075,2835,-
chr11,66288099,2.1028571428571428,551,489,1040,-
chr11,66288133,2.1278195488721803,565,455,1020,-
chr11,66288170,0.4497864719658355,652,426,1078,-
chr11,66288206,1.3354441126274952,1414,997,2411,-
chr11,66288208,0.9334175084175084,852,659,1511,-
chr11,66288257,1.8632189672087804,733,445,1178,-
chr11,66289040,0.7961177696717039,678,605,1283,-
chr11,66289041,0.7961177696717039,678,605,1283,-
chr11,66289129,0.4621923694064287,871,608,1479,-
chr11,66289130,0.4857335629645029,1013,722,1735,-
chr11,66340140,2.4070455001451943,661,401,1062,-
chr11,66340146,2.697641509433962,601,423,1024,-
chr11,66342229,0.6023837002078252,680,494,1174,-
chr11,66345626,9.640676106941166,933,803,1736,-
chr11,66345630,6.792258224581038,960,698,1658,-
chr11,66346806,2.356181692450574,512,517,1029,-
chr11,66435878,1.7234042553191489,758,516,1274,-
chr11,66436014,1.9865168539325846,779,533,1312,-
chr11,66436024,1.7524729698642745,585,482,1067,-
chr11,66436090,1.9415160642570282,594,497,1091,-
chr11,66436107,2.368484987428309,989,778,1767,-
chr11,66437145,1.7764775341795633,4086,2713,6799,-
chr11,66437148,1.9626583713256596,1512,1072,2584,-
chr11,66437156,0.9819835944484003,3688,2582,6270,-
chr11,66437158,1.2145659844742416,1817,1089,2906,-
chr11,66437159,1.5808889173600578,3972,2678,6650,-
chr11,66437160,1.524599715161193,2140,1362,3502,-
chr11,66437196,1.101353176649721,1318,830,2148,-
chr11,66437197,1.101353176649721,1318,830,2148,-
chr11,66437198,1.6948863029785417,881,645,1526,-
chr11,66437221,1.733821733821734,851,545,1396,-
chr11,66438176,1.930353713166242,4099,3281,7380,-
chr11,66438201,1.6816192560175054,1159,913,2072,-
chr11,66438209,1.9445059288537552,1756,1374,3130,-
chr11,66438210,1.4302062374245474,1560,993,2553,-
chr11,66438227,1.5642946317103619,715,533,1248,-
chr11,66438239,0.7100685292567211,897,812,1709,-
chr11,66438245,2.0387624466571834,727,702,1429,-
chr11,66438252,1.6715397110370185,610,556,1166,-
chr11,66438652,1.7521297884880473,984,708,1692,-
chr11,66438653,1.8347567857348386,873,532,1405,-
chr11,66438823,0.7296550834161166,727,534,1261,-
chr11,66567994,1.5454130225344322,3181,2040,5221,-
chr11,66568000,0.9727921863139606,4203,2374,6577,-
chr11,66568001,0.5589859645536315,3631,1852,5483,-
chr11,66568005,2.923886441507587,918,453,1371,-
chr11,66568008,0.48528641285365,854,408,1262,-
chr11,66568014,1.7315363881401618,729,370,1099,-
chr11,66568025,0.4922019561194819,664,484,1148,-
chr11,66568029,2.3195309823093035,1115,656,1771,-
chr11,66848582,16.858639217949342,1909,1708,3617,-
chr11,66848583,16.858639217949342,1909,1708,3617,-
chr11,66849007,2.568359941944848,631,529,1160,-
chr11,66849008,2.568359941944848,631,529,1160,-
chr11,66849065,1.0562651309607796,762,551,1313,-
chr11,66849775,1.9774406640788125,846,535,1381,-
chr11,66850078,1.490975867724786,951,829,1780,-
chr11,66850086,2.576184037591198,575,501,1076,-
chr11,66852556,1.2173913043478262,1000,571,1571,-
chr11,66852557,1.2173913043478262,1000,571,1571,-
chr11,66852558,1.4400811160905966,1262,781,2043,-
chr11,66853378,2.7026337135751164,685,430,1115,-
chr11,66870879,0.714961091861901,492,575,1067,-
chr11,66871064,13.802876245738508,558,464,1022,-
chr11,66871865,2.0373711340206184,713,387,1100,-
chr11,66871867,2.442455602495413,1214,711,1925,-
chr11,66872076,1.7593628404669261,572,456,1028,-
chr11,67398851,1.988814336283747,680,445,1125,-
chr11,67400768,1.9205443371378406,624,535,1159,-
chr11,67401120,2.7334465195246183,699,619,1318,-
chr11,67401121,2.7334465195246183,699,619,1318,-
chr11,67401173,2.7828244047166795,854,762,1616,-
chr11,67401174,2.2130379075027737,928,756,1684,-
chr11,67442566,3.4696077025158067,691,374,1065,-
chr11,67682765,0.7613641315691091,5501,4232,9733,-
chr11,67682839,1.0395547095653637,5499,4037,9536,-
chr11,67682840,1.08011576945075,7953,5603,13556,-
chr11,67682841,1.140494166845144,4587,3021,7608,-
chr11,67682842,0.8421721269030276,1543,1046,2589,-
chr11,67683082,0.8258642386557109,612,473,1085,-
chr11,67683084,0.8437561033839207,852,615,1467,-
chr11,68053824,2.381566713156672,660,477,1137,-
chr11,68053835,1.7364746945898777,994,572,1566,-
chr11,68053848,0.4523809523809524,645,363,1008,-
chr11,68053858,2.2490391465651998,917,621,1538,-
chr11,68053865,3.6370903277378095,699,416,1115,-
chr11,68053866,3.6370903277378095,699,416,1115,-
chr11,68460215,1.6211458125282707,1670,997,2667,-
chr11,68460216,1.6211458125282707,1670,997,2667,-
chr11,68892950,1.7857324431060595,1732,1283,3015,-
chr11,68892957,1.9058798980470135,1328,902,2230,-
chr11,68893433,1.8379292843850445,775,513,1288,-
chr11,68896611,1.5924907705600502,653,438,1091,-
chr11,68897972,2.3351351351351357,809,554,1363,-
chr11,68898001,0.4969811320754717,1316,953,2269,-
chr11,68898002,0.4969811320754717,1316,953,2269,-
chr11,69673257,8.528834203075133,856,645,1501,-
chr11,71434656,2.6449430338025106,607,523,1130,-
chr11,71434688,2.0699904122722907,761,446,1207,-
chr11,71434689,2.5720212670172318,1008,651,1659,-
chr11,71434942,0.923347280334728,612,477,1089,-
chr11,71434943,0.923347280334728,612,477,1089,-
chr11,71435153,1.1656904000936565,1198,954,2152,-
chr11,71435187,0.4643264189651243,678,534,1212,-
chr11,71435226,1.9544383346425769,621,401,1022,-
chr11,71435265,0.918727272727273,651,499,1150,-
chr11,71435266,0.918727272727273,651,499,1150,-
chr11,71435303,4.996684350132626,684,376,1060,-
chr11,71435304,3.716337522441652,1034,556,1590,-
chr11,71435306,2.9960753532182105,693,363,1056,-
chr11,71439057,1.8657909765848084,593,411,1004,-
chr11,71444037,2.342270698472303,870,607,1477,-
chr11,71447653,0.495472287275566,576,426,1002,-
chr11,71448303,6.398896146523179,1537,1215,2752,-
chr11,71448304,6.398896146523179,1537,1215,2752,-
chr11,72014257,3.5054252199413485,612,619,1231,-
chr11,72014259,3.5054252199413485,612,619,1231,-
chr11,72014271,0.4617021276595745,557,469,1026,-
chr11,72014273,0.4617021276595745,557,469,1026,-
chr11,72016522,3.4340277777777777,644,359,1003,-
chr11,72016524,3.4340277777777777,644,359,1003,-
chr11,72018203,1.3653236816364815,1483,1003,2486,-
chr11,72018204,1.7286791060510227,978,743,1721,-
chr11,72018248,1.0870480197029873,1034,639,1673,-
chr11,72018297,2.400098551827063,1601,856,2457,-
chr11,72018298,2.4116757410768304,1138,608,1746,-
chr11,72018299,2.4116757410768304,1138,608,1746,-
chr11,72097438,0.4166796503265326,1167,1036,2203,-
chr11,72097440,0.4244225543478261,734,639,1373,-
chr11,72097508,7.607429644725249,1436,1403,2839,-
chr11,72097516,7.1432113629856095,1403,1052,2455,-
chr11,72097529,2.4402091951057368,801,514,1315,-
chr11,72097598,8.685509748680781,3590,2334,5924,-
chr11,72097599,9.87841473290186,3679,2334,6013,-
chr11,72097600,9.26784814114084,4213,2651,6864,-
chr11,72097601,11.91044880279371,1879,1158,3037,-
chr11,72097627,3.784090909090909,924,439,1363,-
chr11,72097629,3.784090909090909,924,439,1363,-
chr11,72098385,2.4173928726544704,810,620,1430,-
chr11,72099182,1.3757433300670407,1059,694,1753,-
chr11,72099183,0.9938112627330388,833,472,1305,-
chr11,72578940,1.753210824655146,1053,814,1867,-
chr11,72578942,2.2733405936638977,632,525,1157,-
chr11,72578943,1.927616050354052,783,495,1278,-
chr11,72578945,1.927616050354052,783,495,1278,-
chr11,73676289,2.8972487366647948,644,410,1054,-
chr11,73676761,1.3417217851984802,9246,6641,15887,-
chr11,73676791,0.662249423265319,2027,1608,3635,-
chr11,73676792,1.5428620218579234,1667,975,2642,-
chr11,73676796,0.4107158769634568,1689,1386,3075,-
chr11,73676810,2.2952251552795033,1074,735,1809,-
chr11,73676815,1.7098727759775552,2120,1573,3693,-
chr11,73676829,1.8421885995777625,848,587,1435,-
chr11,73676837,1.62410394265233,724,495,1219,-
chr11,73677167,3.73974609375,850,511,1361,-
chr11,73677220,2.3873883830793945,1245,822,2067,-
chr11,73677233,1.0797184604000913,970,779,1749,-
chr11,73677256,0.3457843417841911,908,737,1645,-
chr11,73677257,2.6044005388414906,695,392,1087,-
chr11,73677416,1.3472098254677447,885,700,1585,-
chr11,73677795,0.60258728613159,721,552,1273,-
chr11,73707463,2.6273770772657192,638,448,1086,-
chr11,73707471,1.8826899025481338,1222,752,1974,-
chr11,73716317,2.101095287283284,804,531,1335,-
chr11,73730807,2.6547723847790246,768,582,1350,-
chr11,73872892,2.589641434262948,849,752,1601,-
chr11,73872929,2.647887323943662,610,496,1106,-
chr11,73872990,0.6643679277354184,1139,697,1836,-
chr11,73873037,1.8829539255071168,925,610,1535,-
chr11,73873038,1.734181920378233,1209,1102,2311,-
chr11,73873046,2.0236893203883497,578,514,1092,-
chr11,73873192,2.257099236641221,879,654,1533,-
chr11,73873193,2.257099236641221,879,654,1533,-
chr11,73873265,2.487320658514417,894,526,1420,-
chr11,73876833,0.5351650925948758,1114,598,1712,-
chr11,73876835,0.49365499314454364,1217,774,1991,-
chr11,74745788,1.4661173801416616,3233,2322,5555,-
chr11,74745790,1.4657346694099234,3719,2390,6109,-
chr11,74745791,1.383455257696972,2263,1394,3657,-
chr11,74745885,1.4467297169676254,9869,6056,15925,-
chr11,74745886,0.6615231695922709,3752,2804,6556,-
chr11,74745887,1.2031286542407709,9140,6072,15212,-
chr11,74745986,1.1263768898141062,12733,7655,20388,-
chr11,74745987,1.2033954588151174,13732,8053,21785,-
chr11,74745988,1.2246268432486391,8395,4588,12983,-
chr11,74745989,1.1144305911300783,13026,8152,21178,-
chr11,74745990,1.0160139251523064,3591,2680,6271,-
chr11,74745995,0.9064187294155991,3249,2006,5255,-
chr11,74745996,0.9238817163348192,8959,5876,14835,-
chr11,74745997,0.9223544000186207,5368,3677,9045,-
chr11,74745998,1.147186030167054,3440,2225,5665,-
chr11,74745999,1.6164568182640469,2065,1331,3396,-
chr11,74746175,0.5141050644590264,4039,3218,7257,-
chr11,74746176,1.5188171914052566,2573,2148,4721,-
chr11,74746191,0.6244158329577592,7105,5679,12784,-
chr11,74746193,0.53234811939892,3524,2766,6290,-
chr11,74746196,0.9970041941282204,2078,1668,3746,-
chr11,76350893,0.5456819525843336,805,591,1396,-
chr11,76352382,1.950393356643357,1070,623,1693,-
chr11,76352383,2.2524427223719674,1572,895,2467,-
chr11,76352385,2.5403707953378825,1025,570,1595,-
chr11,76352406,2.532916666608857,1214,641,1855,-
chr11,76352416,2.9482498648949287,1218,641,1859,-
chr11,76352581,2.0874330665289405,802,537,1339,-
chr11,77616432,1.5430464206016161,3353,2320,5673,-
chr11,77616471,2.915233030966531,1164,833,1997,-
chr11,77616614,1.3122963449443028,2308,1341,3649,-
chr11,77619628,1.5482041587901705,1301,712,2013,-
chr11,77619629,2.102857142857143,781,594,1375,-
chr11,77619655,1.7489202983165877,1718,1306,3024,-
chr11,77622581,0.5970719164939751,1681,1211,2892,-
chr11,77622614,0.6833824070666176,1060,835,1895,-
chr11,77622672,2.368275862068965,807,579,1386,-
chr11,77624984,1.2319214841410735,1901,1407,3308,-
chr11,77625743,1.809429190751445,1112,864,1976,-
chr11,77625807,1.8566429932444137,1623,1254,2877,-
chr11,77629853,0.6277689873417721,827,631,1458,-
chr11,77629854,1.6342857142857143,1325,849,2174,-
chr11,77637601,0.9492337164750958,990,869,1859,-
chr11,77637602,0.9492337164750958,990,869,1859,-
chr11,77637603,0.32022684310018895,769,574,1343,-
chr11,77637604,1.9219106957424719,660,534,1194,-
chr11,77637605,1.9200892857142862,781,479,1260,-
chr11,77637749,1.3799861336479713,815,607,1422,-
chr11,77637770,2.2373519382394385,832,635,1467,-
chr11,77637772,2.4588359788359786,627,377,1004,-
chr11,77700889,2.647695939519372,1251,908,2159,-
chr11,77700891,2.647695939519372,1251,908,2159,-
chr11,77903595,1.063842393719449,1025,627,1652,-
chr11,77903597,1.063842393719449,1025,627,1652,-
chr11,77903599,1.97123745819398,841,597,1438,-
chr11,77903600,1.97123745819398,841,597,1438,-
chr11,78069979,1.5278323088640728,1950,1350,3300,-
chr11,78073083,1.589186915172994,2186,1723,3909,-
chr11,78073085,1.4628414578903777,3997,3043,7040,-
chr11,78073118,1.5249457700650761,1405,921,2326,-
chr11,78073125,1.886981211102037,1924,1427,3351,-
chr11,78073128,1.536435312586758,1840,1317,3157,-
chr11,78073137,2.9754044239022783,720,465,1185,-
chr11,78079614,1.4742773259242081,2157,1424,3581,-
chr11,78079641,1.6356014188971295,633,442,1075,-
chr11,78079700,3.7700854700854696,801,389,1190,-
chr11,78079762,2.3053489702517163,596,436,1032,-
chr11,78079787,1.6211128178773395,1897,1297,3194,-
chr11,78079839,1.1323265928254167,1476,1054,2530,-
chr11,78104387,1.951242462514915,861,613,1474,-
chr11,78109454,3.0268416517593413,660,497,1157,-
chr11,78127424,1.4491900703155751,953,705,1658,-
chr11,78443699,1.9774358974358974,963,779,1742,-
chr11,78443700,1.9774358974358974,963,779,1742,-
chr11,78469307,3.7972173356788734,741,480,1221,-
chr11,82824542,4.146823848717074,739,670,1409,-
chr11,82824876,1.8800458144720442,1120,767,1887,-
chr11,82825084,2.3195704499166823,863,490,1353,-
chr11,82825085,3.119437985009303,1108,661,1769,-
chr11,82838493,2.207674403986645,918,640,1558,-
chr11,82849117,0.4217802228805192,597,416,1013,-
chr11,82853255,2.2244646954793263,854,531,1385,-
chr11,82900305,2.6784757222099036,772,641,1413,-
chr11,82976255,2.5322092935671834,956,587,1543,-
chr11,83261742,2.654791592447453,1619,801,2420,-
chr11,83261805,2.116179520873845,1985,1180,3165,-
chr11,83261834,2.0576998050682263,909,512,1421,-
chr11,83273960,1.5836776395411385,2101,1206,3307,-
chr11,83273964,2.010882782101167,944,513,1457,-
chr11,83273975,2.334533607681756,777,431,1208,-
chr11,83469339,2.172892443467505,879,600,1479,-
chr11,85663322,1.4088117849069037,604,430,1034,-
chr11,85663750,0.9268876685875667,574,463,1037,-
chr11,85957838,5.462636004326735,1546,1362,2908,-
chr11,85958002,0.6852272727272727,1205,1011,2216,-
chr11,85958015,3.3119810825013136,1691,1383,3074,-
chr11,85958017,18.63084952256678,9456,7618,17074,-
chr11,85958018,19.865196177454234,9209,7201,16410,-
chr11,85958019,19.865196177454234,9209,7201,16410,-
chr11,85958020,19.159058084772372,1837,1224,3061,-
chr11,85958162,0.5173422232512332,2218,1633,3851,-
chr11,85958224,1.768124630141982,2157,1453,3610,-
chr11,85958446,2.743622828784119,1083,649,1732,-
chr11,85958975,0.6186742694226657,1175,853,2028,-
chr11,85974737,0.5767952127659575,693,511,1204,-
chr11,85974769,1.6475250278086764,696,495,1191,-
chr11,85981178,0.6430963735166907,762,634,1396,-
chr11,85981907,1.7154854189737911,640,515,1155,-
chr11,85981957,1.8178064516129036,586,464,1050,-
chr11,85981977,1.975941230486685,741,494,1235,-
chr11,85996870,0.4277819990329488,562,466,1028,-
chr11,86000661,3.0637274549098192,587,498,1085,-
chr11,86001109,1.8671679197994981,744,626,1370,-
chr11,86001120,2.3109229702972325,1340,1148,2488,-
chr11,86001140,1.7388954187028285,1648,1117,2765,-
chr11,86001154,1.3206831159642507,1362,1056,2418,-
chr11,86011051,1.577021310559502,918,736,1654,-
chr11,86011057,1.6549354435651813,882,685,1567,-
chr11,86011084,1.8280745248290888,1186,782,1968,-
chr11,86014932,1.5360054347826089,1070,735,1805,-
chr11,86014946,2.089621087314662,754,606,1360,-
chr11,86026342,1.8603745318352063,886,533,1419,-
chr11,86026356,1.5838494132985657,588,471,1059,-
chr11,86031606,1.4950684059815462,761,448,1209,-
chr11,86031610,1.9607873935752962,1146,748,1894,-
chr11,86068664,2.7425139910020198,1071,820,1891,-
chr11,86068792,3.392478116081501,797,798,1595,-
chr11,86068832,3.0997765108276174,532,514,1046,-
chr11,86068993,7.1426148609282345,2216,1826,4042,-
chr11,86068994,7.1426148609282345,2216,1826,4042,-
chr11,86069000,14.187163267263934,2766,1728,4494,-
chr11,86069001,14.495096516512218,3102,1868,4970,-
chr11,86069002,17.929003021148038,1143,661,1804,-
chr11,86069003,52.16045845272206,665,348,1013,-
chr11,86069080,0.9387725834522149,1049,587,1636,-
chr11,88293984,2.3724724264705883,1399,1023,2422,-
chr11,88293986,0.6049661399548533,602,442,1044,-
chr11,88294121,1.8848823586205112,1823,1255,3078,-
chr11,88294210,2.5672564854840685,1541,1279,2820,-
chr11,88294445,1.8488764948785328,1013,642,1655,-
chr11,88294461,1.726014469959107,707,577,1284,-
chr11,88294472,2.102311400174325,1431,1078,2509,-
chr11,88296193,1.7152542372881354,758,530,1288,-
chr11,88296195,0.4361397917530724,1109,750,1859,-
chr11,88300597,1.5565308481433318,1050,768,1818,-
chr11,88300617,0.5404383975812547,909,755,1664,-
chr11,88300640,0.4247269116186693,657,529,1186,-
chr11,88312443,2.4040691038822755,3000,2664,5664,-
chr11,88312454,0.5128623188405798,744,551,1295,-
chr11,88312475,12.047832413269333,2506,2038,4544,-
chr11,88326279,1.9012207496560425,1226,1003,2229,-
chr11,88326280,1.948051090795076,867,738,1605,-
chr11,88326412,1.335004723528428,1075,763,1838,-
chr11,88335069,1.2256380377448384,3405,2605,6010,-
chr11,88335070,1.387780377290481,6777,5051,11828,-
chr11,88335071,0.8472509182736456,2361,1583,3944,-
chr11,88335075,0.5524359484932961,860,728,1588,-
chr11,88337515,1.3621560083932476,1304,1029,2333,-
chr11,88337520,1.9307511737089205,845,567,1412,-
chr11,88337533,2.017391304347826,823,514,1337,-
chr11,88337596,2.2964669738863286,779,433,1212,-
chr11,88408769,1.0878270190459112,4028,2776,6804,-
chr11,88408770,1.0952950090703952,2986,1939,4925,-
chr11,88408771,1.0265876676867058,4894,3417,8311,-
chr11,88408772,1.0324626420343477,2006,1258,3264,-
chr11,90201702,1.6206382650701476,875,670,1545,-
chr11,90205521,0.9456521739130436,1055,735,1790,-
chr11,90205523,0.9456521739130436,1055,735,1790,-
chr11,90214037,1.5572763109116847,1027,727,1754,-
chr11,90218175,1.17756454758602,815,489,1304,-
chr11,93730373,0.9653453478174615,2764,2095,4859,-
chr11,93730375,1.9838609075315763,726,582,1308,-
chr11,93730390,2.29775,706,499,1205,-
chr11,93730398,2.416491963661775,664,476,1140,-
chr11,93731211,2.827287853577371,1061,600,1661,-
chr11,93731212,2.827287853577371,1061,600,1661,-
chr11,93733373,0.4705828696524674,736,576,1312,-
chr11,93733503,0.4195783834148614,654,476,1130,-
chr11,93735236,1.2244633587489098,956,785,1741,-
chr11,93736723,1.6013206749797837,1160,830,1990,-
chr11,93737196,1.9530981067125648,800,580,1380,-
chr11,93738207,1.7822913360837829,701,410,1111,-
chr11,93738243,1.5185185185185184,942,689,1631,-
chr11,93738245,1.9579104796496103,631,406,1037,-
chr11,93738246,1.8909216253740633,1753,1184,2937,-
chr11,93738432,3.0715532286212923,769,572,1341,-
chr11,93738436,3.317172897196261,630,427,1057,-
chr11,93738437,2.005000671613223,1410,1025,2435,-
chr11,93739298,0.3814355885266115,1109,810,1919,-
chr11,93739300,0.3814355885266115,1109,810,1919,-
chr11,93741363,1.1549403121971438,1204,1103,2307,-
chr11,93741365,0.7509612919764163,836,663,1499,-
chr11,93741386,1.2390025934056903,874,989,1863,-
chr11,93741423,14.158741346583158,1018,817,1835,-
chr11,93741426,26.142968772975248,1462,771,2233,-
chr11,93741427,30.260404689457946,865,502,1367,-
chr11,93741430,7.156508453217082,1073,370,1443,-
chr11,94188621,0.6043555277690944,724,456,1180,-
chr11,94188640,0.5882673226471357,668,530,1198,-
chr11,94188738,1.0432496876851145,708,528,1236,-
chr11,94188744,0.8194130925507901,725,442,1167,-
chr11,94435878,2.4386506543521747,829,538,1367,-
chr11,94437230,0.4857220931821287,789,562,1351,-
chr11,94437232,1.284924699558846,723,532,1255,-
chr11,94437233,2.482739964580874,652,448,1100,-
chr11,94447263,2.939128050452427,793,520,1313,-
chr11,94459507,1.5962428817597243,670,524,1194,-
chr11,94467824,3.0859292664197437,671,377,1048,-
chr11,94467834,2.390965930840883,693,460,1153,-
chr11,94467836,2.982359723864976,966,625,1591,-
chr11,94467854,0.10183728093081179,1220,748,1968,-
chr11,94963461,0.6019082957858468,756,538,1294,-
chr11,94966344,0.9577265372168284,946,720,1666,-
chr11,94966346,0.9577265372168284,946,720,1666,-
chr11,94966408,1.3368216363062093,808,626,1434,-
chr11,94966411,1.3973558607747985,704,504,1208,-
chr11,94971038,2.0332857397822592,734,430,1164,-
chr11,94971059,2.7567588508504577,1028,681,1709,-
chr11,94971062,2.0362173038229376,1011,638,1649,-
chr11,94971064,2.0362173038229376,1011,638,1649,-
chr11,94971396,1.9405637271106446,1019,695,1714,-
chr11,94971422,2.0050632911392405,647,394,1041,-
chr11,95835147,2.4932456959266274,664,465,1129,-
chr11,95835436,2.6510638297872338,622,469,1091,-
chr11,95835438,2.6510638297872338,622,469,1091,-
chr11,95847736,5.172867969301998,646,485,1131,-
chr11,95850669,2.1478015448603687,2282,1529,3811,-
chr11,95850671,2.1478015448603687,2282,1529,3811,-
chr11,95850686,1.6624875124875125,1603,1000,2603,-
chr11,95850687,1.6624875124875125,1603,1000,2603,-
chr11,95850692,2.959299959299959,660,377,1037,-
chr11,95857578,1.78252427184466,611,411,1022,-
chr11,95857596,0.8905547226386807,879,579,1458,-
chr11,95857598,0.8905547226386807,879,579,1458,-
chr11,102396551,2.555086372360844,623,520,1143,-
chr11,102396571,1.595588235294118,811,543,1354,-
chr11,102397351,2.798796726493907,1630,1220,2850,-
chr11,102397903,1.6122540250447228,720,515,1235,-
chr11,102397907,2.007175925925926,666,479,1145,-
chr11,102397908,1.7441498599580376,2043,1402,3445,-
chr11,102397909,1.7441498599580376,2043,1402,3445,-
chr11,102397936,1.9322680995475112,910,543,1453,-
chr11,102397972,3.0212922173274595,822,453,1275,-
chr11,102398438,1.4095640858815874,1237,847,2084,-
chr11,102398508,3.3977695167286246,913,537,1450,-
chr11,102398636,2.1883378016085793,652,372,1024,-
chr11,102401604,0.6935771214252227,1137,789,1926,-
chr11,102401665,1.9529795158286778,838,536,1374,-
chr11,102401948,2.1382827324478177,600,495,1095,-
chr11,102401953,0.5177434030937216,568,470,1038,-
chr11,102402048,1.7820131030375221,747,510,1257,-
chr11,102402051,0.5886860491322965,652,521,1173,-
chr11,102402069,1.9070442992011616,706,458,1164,-
chr11,102448832,1.2661570946881509,614,542,1156,-
chr11,103062380,1.579045996592845,805,586,1391,-
chr11,103066506,1.5552326617935457,2101,1579,3680,-
chr11,103066509,1.4814327070443325,1918,1114,3032,-
chr11,103066516,1.4177876989954767,1608,1173,2781,-
chr11,103066529,1.7227249874308697,2491,1631,4122,-
chr11,103066531,1.7227249874308697,2491,1631,4122,-
chr11,103066537,1.600378787878788,1013,575,1588,-
chr11,103082771,1.7775922178728303,1088,760,1848,-
chr11,104942945,0.5062099155044284,662,516,1178,-
chr11,104944814,2.033544303797468,611,394,1005,-
chr11,104947140,2.0853426395939088,625,393,1018,-
chr11,104947145,2.2548262548262548,583,517,1100,-
chr11,104947152,1.9950440845963235,576,468,1044,-
chr11,104948586,1.7606151271125419,1212,838,2050,-
chr11,104949653,2.9204059829059834,780,623,1403,-
chr11,104950942,0.5885217391304348,751,574,1325,-
chr11,104951049,2.2072092159048684,957,584,1541,-
chr11,104951943,2.831491819803055,3396,1432,4828,-
chr11,104951945,1.569125622167744,6443,4486,10929,-
chr11,104951951,0.6867848970251716,4801,2279,7080,-
chr11,104951952,0.5733126961981164,1546,975,2521,-
chr11,104951959,1.0401588923063256,3862,1593,5455,-
chr11,104951960,1.1857300142276506,7808,4157,11965,-
chr11,104951966,1.3558859958526122,9357,5503,14860,-
chr11,104951967,1.3654135172778272,6526,4081,10607,-
chr11,104951970,1.6551528878822197,2922,1765,4687,-
chr11,104951997,1.5894977168949769,1651,875,2526,-
chr11,104954764,0.7348319200753738,1758,1102,2860,-
chr11,104954779,2.097357873847231,1224,828,2052,-
chr11,104954987,2.1443559145200397,2036,1592,3628,-
chr11,104954989,2.295610895105026,2452,1864,4316,-
chr11,104954990,2.8890858944050435,837,563,1400,-
chr11,104968566,3.136685739056235,1000,456,1456,-
chr11,104968578,1.3880449830847696,875,436,1311,-
chr11,105026852,3.256869772998805,927,836,1763,-
chr11,105026856,2.1395375134279417,900,768,1668,-
chr11,105034259,4.41895656959901,826,504,1330,-
chr11,105034260,4.41895656959901,826,504,1330,-
chr11,105041642,1.4896466467497682,1445,1141,2586,-
chr11,105041669,1.4307273262661957,1494,1131,2625,-
chr11,105041700,2.03184165232358,786,580,1366,-
chr11,105044441,1.1333502983398094,2679,1829,4508,-
chr11,105044457,1.6607985837922894,865,655,1520,-
chr11,105044482,2.384568527918782,1100,590,1690,-
chr11,105044599,1.5546648964124692,2112,1544,3656,-
chr11,105044636,1.8271597676641427,1411,1014,2425,-
chr11,105044642,1.5170670037926677,1199,790,1989,-
chr11,105044657,1.7847396268448896,883,531,1414,-
chr11,105045304,1.673021621045905,1495,915,2410,-
chr11,105045305,1.8102871016906097,2566,1786,4352,-
chr11,105045307,1.9806320081549442,1071,871,1942,-
chr11,105045309,2.811821970762368,1071,590,1661,-
chr11,105045331,2.3484773122435803,1685,1020,2705,-
chr11,105045332,1.005578093306288,660,390,1050,-
chr11,105045333,0.9526732750589929,2085,1213,3298,-
chr11,105045334,0.7630041133504813,1431,803,2234,-
chr11,106008524,8.496259855047766,1139,1028,2167,-
chr11,106008525,10.142537084195581,806,654,1460,-
chr11,106009843,3.395616241466044,755,505,1260,-
chr11,106009844,3.3668758858068437,722,448,1170,-
chr11,107805466,0.5854284981744297,621,453,1074,-
chr11,110229625,1.9517257646041355,855,552,1407,-
chr11,110229963,1.0793169322734062,964,651,1615,-
chr11,110230530,0.8881308411214952,730,534,1264,-
chr11,110230531,0.7445603869707382,938,761,1699,-
chr11,110230535,1.3510627024443338,1042,872,1914,-
chr11,110230536,2.134070796460177,688,451,1139,-
chr11,110231819,2.019770237777184,629,393,1022,-
chr11,110247776,1.3989387125216435,3999,2997,6996,-
chr11,110247777,2.03841381170758,2098,1684,3782,-
chr11,110247800,1.7721109087229308,1591,1097,2688,-
chr11,110247801,1.7721109087229308,1591,1097,2688,-
chr11,110254001,1.9824516129032257,1001,774,1775,-
chr11,110254025,2.094777562862669,721,516,1237,-
chr11,110254038,2.8971937029431896,813,486,1299,-
chr11,110254075,1.9212653288740245,810,623,1433,-
chr11,110254081,1.127223831622944,1178,840,2018,-
chr11,110257832,1.3024365732325096,737,490,1227,-
chr11,111889371,1.8725319844222728,985,789,1774,-
chr11,112085279,2.5008309380647766,1076,645,1721,-
chr11,112085298,1.860369817991074,697,562,1259,-
chr11,112085431,1.2568517045463732,836,594,1430,-
chr11,112085454,2.119935606292687,1030,705,1735,-
chr11,112085455,2.119935606292687,1030,705,1735,-
chr11,119017512,1.5215927480959226,7682,4465,12147,-
chr11,119017528,1.419847328244275,6509,3536,10045,-
chr11,119018031,1.5863158769408858,5952,5208,11160,-
chr11,119018037,1.470363125328172,5556,4714,10270,-
chr11,119018301,1.3937024120381947,26476,18273,44749,-
chr11,119018325,1.2065659874414967,20676,13580,34256,-
chr11,119018331,1.4697372409130125,3485,2957,6442,-
chr11,119018338,1.6048914980212692,6111,2881,8992,-
chr11,119018340,0.911553202202077,8021,6662,14683,-
chr11,119018341,0.8753708659181955,32999,21099,54098,-
chr11,119018342,0.8661956923738336,35777,23560,59337,-
chr11,119018343,0.8618921079921206,24978,14437,39415,-
chr11,119018346,0.3319764177428411,1418,958,2376,-
chr11,119045436,6.5835681294650055,1059,898,1957,-
chr11,119045437,6.692199164212298,875,700,1575,-
chr11,119048827,2.566371681415929,608,451,1059,-
chr11,119048829,2.566371681415929,608,451,1059,-
chr11,119308692,2.186498223450454,1203,744,1947,-
chr11,119308744,2.1791744840525324,1615,1247,2862,-
chr11,119308745,2.1791744840525324,1615,1247,2862,-
chr11,119308902,3.2536231884057965,897,735,1632,-
chr11,119308932,1.6388243335611756,998,626,1624,-
chr11,119308938,1.9610899182561308,946,733,1679,-
chr11,119308976,1.418970189701897,1121,737,1858,-
chr11,119308980,0.445863900834809,704,535,1239,-
chr11,119308981,1.9743689320388347,655,514,1169,-
chr11,119308999,1.8023553507424481,879,557,1436,-
chr11,119309009,2.2190875475682184,1390,897,2287,-
chr11,119309164,0.3794815223386652,687,517,1204,-
chr11,119309183,0.4870493981654019,1356,1074,2430,-
chr11,119309572,2.8187675070028013,693,509,1202,-
chr11,119309587,1.951004193334805,779,590,1369,-
chr11,119309691,0.37209466121989015,586,457,1043,-
chr11,119309894,0.6496255291436015,734,517,1251,-
chr11,119309905,0.9480490523968784,1062,779,1841,-
chr11,119309907,1.3890426185455345,2135,1604,3739,-
chr11,119309908,1.8958943976717602,1470,1068,2538,-
chr11,119309910,2.0809667964057468,1396,990,2386,-
chr11,119309912,2.1131535216471966,1780,1269,3049,-
chr11,119309914,2.5088235294117647,852,577,1429,-
chr11,119310426,1.7099080694586313,619,444,1063,-
chr11,119310427,1.91875,613,447,1060,-
chr11,119310446,0.8089196837781848,1346,1022,2368,-
chr11,119310447,0.9685337196201512,829,653,1482,-
chr11,119310798,1.6197210636079251,856,547,1403,-
chr11,119310809,1.5580448065173116,764,490,1254,-
chr11,119310810,0.9339785772746538,1613,1301,2914,-
chr11,119310811,0.594080190329578,1131,921,2052,-
chr11,119310900,1.8776553894571208,887,655,1542,-
chr11,119310901,1.8776553894571208,887,655,1542,-
chr11,119311306,0.4863106532935754,896,713,1609,-
chr11,119311308,0.9833198886257772,1691,1388,3079,-
chr11,119311309,1.3034188034188037,1219,1025,2244,-
chr11,119311310,1.4311921164538919,1678,1323,3001,-
chr11,119311403,1.7064833935639303,1618,893,2511,-
chr11,119311404,2.306554767522436,2205,1365,3570,-
chr11,119311409,0.47199170124481327,664,481,1145,-
chr11,119311410,1.8600160901045857,577,451,1028,-
chr11,119311415,2.35498046875,688,383,1071,-
chr11,119311548,0.5406349622254247,618,448,1066,-
chr11,119311592,0.2866980790141356,564,444,1008,-
chr11,119312131,2.1923803526448364,632,396,1028,-
chr11,119312169,2.423871993639436,840,558,1398,-
chr11,119312306,0.5212444444444445,732,624,1356,-
chr11,119312334,1.1153623188405797,1849,1149,2998,-
chr11,119312335,1.1153623188405797,1849,1149,2998,-
chr11,119312349,0.6281951658418878,767,498,1265,-
chr11,119312353,3.3770459475448633,684,460,1144,-
chr11,119312583,2.949579831932773,779,475,1254,-
chr11,119312639,1.9995387453874536,866,541,1407,-
chr11,119312640,1.779706790123457,658,431,1089,-
chr11,119312861,2.54014598540146,724,684,1408,-
chr11,119312925,2.489217498459643,807,540,1347,-
chr11,119312942,1.5765086311726333,1249,932,2181,-
chr11,119314526,2.3934431960169267,1214,837,2051,-
chr11,119314692,1.6527777777777777,594,434,1028,-
chr11,123057736,1.319818897887285,5793,4308,10101,-
chr11,123057738,1.33376616582515,12803,9850,22653,-
chr11,123057739,1.3138713163307358,5425,3958,9383,-
chr11,123057748,1.4598276810724289,2406,1665,4071,-
chr11,123057919,0.5477355966899722,701,448,1149,-
chr11,123058361,1.7123392478196862,16969,15548,32517,-
chr11,123058364,1.3737136383588153,26074,24402,50476,-
chr11,123058390,1.5549955976320506,21903,15810,37713,-
chr11,123058391,1.4324799773514303,16596,11335,27931,-
chr11,123058417,1.5993127472769977,4706,3590,8296,-
chr11,123058828,1.252561784207354,4155,2764,6919,-
chr11,123059132,1.2398817527907622,3846,2909,6755,-
chr11,123059231,1.2222161302702998,5572,3587,9159,-
chr11,123059603,0.9963338060888595,18863,13723,32586,-
chr11,123059610,1.3936731107205629,3964,2844,6808,-
chr11,123059703,1.5093108831400537,3530,2831,6361,-
chr11,123059711,1.3632847764987266,9528,6624,16152,-
chr11,123059718,1.519005083452633,3028,2200,5228,-
chr11,123059942,1.1620896055752132,13427,9077,22504,-
chr11,123060019,1.3869119019059046,3783,2744,6527,-
chr11,123060162,1.151125615787019,9352,6732,16084,-
chr11,123060168,0.8007343043938083,4594,3466,8060,-
chr11,123060617,1.3044253047184349,9572,6169,15741,-
chr11,123060669,1.3206202466173542,8830,7205,16035,-
chr11,123060767,1.5984972881524604,2569,1913,4482,-
chr11,123060774,1.498190173796791,4330,2719,7049,-
chr11,123061202,1.7832246931125242,3368,2677,6045,-
chr11,123061250,1.3599660008499783,2559,1990,4549,-
chr11,123061281,1.2810027332254212,5572,3620,9192,-
chr11,123062128,1.3615326387921751,10902,6997,17899,-
chr11,123062129,1.3246813844975276,8432,4979,13411,-
chr11,123062130,0.9192884229258652,15426,9967,25393,-
chr11,123062131,0.9411534373776359,4037,3231,7268,-
chr11,123062132,0.8413688828991609,12263,8425,20688,-
chr11,123062133,0.8226828754399972,2865,2278,5143,-
chr11,123062135,0.8453360874368735,4147,3249,7396,-
chr11,123062137,0.9623633976727944,4782,3747,8529,-
chr11,123062138,0.9830345421093051,1842,1365,3207,-
chr11,123070450,2.372615641392465,750,698,1448,-
chr11,123070846,2.319036621577037,780,432,1212,-
chr11,123070847,2.319036621577037,780,432,1212,-
chr11,123070883,3.6046799003333603,623,486,1109,-
chr11,123070884,4.038643459125228,820,571,1391,-
chr11,123072315,1.2649184664411108,614,403,1017,-
chr11,123073168,3.856238715446854,1481,1124,2605,-
chr11,123073365,1.724116359086644,688,555,1243,-
chr11,123073387,2.06031746031746,648,489,1137,-
chr11,123073399,1.176621835443038,1321,947,2268,-
chr11,123073401,1.176621835443038,1321,947,2268,-
chr11,123083201,3.3653945757414667,977,559,1536,-
chr11,123083203,3.2988255763375385,710,362,1072,-
chr11,123084682,1.0468540829986617,781,414,1195,-
chr11,123084684,1.0468540829986617,781,414,1195,-
chr11,126263414,1.1378156346836357,628,500,1128,-
chr11,126263635,0.2824916943521595,772,699,1471,-
chr11,126263636,0.2824916943521595,772,699,1471,-
chr11,126263926,2.8005115089514065,729,390,1119,-
chr11,126263928,2.8005115089514065,729,390,1119,-
chr11,126265418,2.243394321064224,652,481,1133,-
chr11,126266055,0.34594585195956334,567,496,1063,-
chr11,126268073,1.91585446839305,744,446,1190,-
chr11,126268074,3.4040040765626207,871,552,1423,-
chr11,134168084,2.244618473888598,854,620,1474,-
chr11,134204066,2.4957538373843504,959,822,1781,-
chr11,134204068,0.9983184849566881,808,693,1501,-
chr11,134209344,4.474820143884892,621,416,1037,-
chr11,134209345,4.474820143884892,621,416,1037,-
chr11,134249867,1.8540733643080702,5003,3823,8826,-
chr11,134249869,1.8631505486195115,7355,5517,12872,-
chr11,134249870,2.079426311603855,5778,4023,9801,-
chr11,134249873,1.7009595202398802,1718,1333,3051,-
chr11,134249874,1.715441191715969,3777,2713,6490,-
chr11,134249876,1.8389306780535928,2440,1594,4034,-
chr11,134249887,1.1927347011279863,2065,1250,3315,-
chr11,134249888,1.0559778396950439,2731,1541,4272,-
chr11,134249904,1.5943881529958648,1267,654,1921,-
chr11,134249905,1.6926178660049631,641,402,1043,-
chr11,134249906,1.0712394067796611,808,353,1161,-
chr11,134250310,2.58812351543943,680,420,1100,-
chr11,134250311,2.1008512606292196,882,531,1413,-
chr12,1757952,2.0863077860317265,612,389,1001,-
chr12,3211930,0.7932618573096663,8067,6500,14567,-
chr12,3211933,1.1703940891014293,15143,11733,26876,-
chr12,3211951,0.9979882039148029,12927,10411,23338,-
chr12,6330683,0.6008492569002123,565,470,1035,-
chr12,6330875,2.7840354090354094,628,467,1095,-
chr12,6330920,1.71019809244314,850,666,1516,-
chr12,6330921,1.4798959623755843,1801,1353,3154,-
chr12,6330924,2.2683175033921303,742,535,1277,-
chr12,6330925,2.2683175033921303,742,535,1277,-
chr12,6334122,0.48231598331798736,684,498,1182,-
chr12,6342035,0.6720282435416661,644,380,1024,-
chr12,6342038,1.687977768727691,665,375,1040,-
chr12,6492324,2.1764707941947554,4069,2815,6884,-
chr12,6492356,1.3977481617647058,1737,1023,2760,-
chr12,6492398,1.4200042896975764,1627,984,2611,-
chr12,6492426,1.9630848520599835,1192,1038,2230,-
chr12,6492444,1.7843971631205675,679,563,1242,-
chr12,6492445,0.5587122617016542,1075,792,1867,-
chr12,6493072,1.6,835,569,1404,-
chr12,6493247,0.3736361679781209,746,499,1245,-
chr12,6493250,0.7943426436577121,569,461,1030,-
chr12,6493251,0.7126036304549233,924,839,1763,-
chr12,6563649,4.632671022528186,665,440,1105,-
chr12,6566282,1.0661817251473984,958,565,1523,-
chr12,6566283,1.7445587066636257,898,514,1412,-
chr12,6566284,1.5252860018411063,843,487,1330,-
chr12,6578096,1.5063860808436,738,565,1303,-
chr12,6583355,2.743489591063776,520,491,1011,-
chr12,6591531,3.1294172632300845,824,606,1430,-
chr12,6592452,5.747553287966888,648,501,1149,-
chr12,6592453,5.747553287966888,648,501,1149,-
chr12,6593528,2.26469511554085,617,519,1136,-
chr12,6599808,2.1633086166359616,783,456,1239,-
chr12,6602096,7.542611226320878,726,551,1277,-
chr12,6602098,7.1828099073746765,909,679,1588,-
chr12,6602108,5.610456793196814,910,494,1404,-
chr12,6602110,5.733634163842022,735,391,1126,-
chr12,6651364,0.6067392853507075,595,417,1012,-
chr12,6679501,0.1731793492590835,820,440,1260,-
chr12,6679513,0.4566636794264498,1188,748,1936,-
chr12,6679514,0.4566636794264498,1188,748,1936,-
chr12,6679521,1.3891434815225545,800,533,1333,-
chr12,6748079,0.5838709677419355,542,495,1037,-
chr12,6748086,1.303854097936803,936,798,1734,-
chr12,6748087,1.7018584420719651,806,561,1367,-
chr12,6748120,0.5934195064629847,605,413,1018,-
chr12,6748385,2.01768396582563,1948,1382,3330,-
chr12,6748425,1.0874591698788219,1719,1126,2845,-
chr12,6748426,0.8716820891599929,1369,830,2199,-
chr12,6748472,0.5439024399752369,1081,804,1885,-
chr12,6748862,10.279039759746103,962,567,1529,-
chr12,6748863,9.688640085087508,1395,889,2284,-
chr12,6749986,1.7613445378151258,654,424,1078,-
chr12,6750213,2.145707694883208,1374,1117,2491,-
chr12,6750241,0.4964577167966999,691,530,1221,-
chr12,6750249,0.6188003220611916,808,539,1347,-
chr12,6750726,0.5864135864135864,586,428,1014,-
chr12,6750746,1.8410819949281487,659,454,1113,-
chr12,6750747,2.5199615199615204,675,395,1070,-
chr12,6751670,2.7482837712293073,746,472,1218,-
chr12,6752950,2.368563685636856,873,491,1364,-
chr12,6752951,2.368563685636856,873,491,1364,-
chr12,6753054,5.374254588984979,935,642,1577,-
chr12,6753059,6.470688251998019,647,452,1099,-
chr12,6965402,3.151621551428251,1639,1170,2809,-
chr12,6965504,0.4768860212226492,4921,3532,8453,-
chr12,6965553,1.5593843449166178,2627,1917,4544,-
chr12,6965565,1.8140151430047853,1467,946,2413,-
chr12,6965586,1.6470396270396273,720,549,1269,-
chr12,6965642,0.7157727768414791,1443,916,2359,-
chr12,6965672,2.146685192536721,617,457,1074,-
chr12,6965680,1.963728838728839,1489,961,2450,-
chr12,6965682,1.963728838728839,1489,961,2450,-
chr12,6966470,1.471782003873921,1995,1261,3256,-
chr12,6966474,1.3840083965459662,1986,1232,3218,-
chr12,6967186,0.7168040331006119,1800,1282,3082,-
chr12,6967216,1.7704531599268436,946,702,1648,-
chr12,6967239,2.4836601307189543,854,611,1465,-
chr12,6967242,1.1703311908123724,1964,1493,3457,-
chr12,6967713,1.7407839434168375,1620,1058,2678,-
chr12,6967718,1.2341071554965048,3098,2472,5570,-
chr12,6967744,0.6039783001808318,1335,783,2118,-
chr12,6967745,2.2713864306784664,769,564,1333,-
chr12,6967907,1.4804381846635364,859,709,1568,-
chr12,6967908,1.7965550469766327,784,592,1376,-
chr12,6967981,2.2730957342798424,1543,1161,2704,-
chr12,6968010,1.8047595520421607,706,551,1257,-
chr12,6968013,2.613574901600602,1819,1211,3030,-
chr12,6968444,1.794242424242424,763,599,1362,-
chr12,6968581,0.7080001510174803,2130,1214,3344,-
chr12,6969526,1.5939449064449065,1043,831,1874,-
chr12,6969547,1.5596064814814814,1154,971,2125,-
chr12,6969553,2.050335807705903,852,614,1466,-
chr12,6969562,1.066587826179086,1938,1480,3418,-
chr12,6969573,3.8228310502283103,643,437,1080,-
chr12,6970228,1.529042288557214,1068,803,1871,-
chr12,6970265,0.6041975832096671,949,800,1749,-
chr12,6970431,1.63550707915675,5909,5122,11031,-
chr12,6970432,1.6476989159337287,5683,4888,10571,-
chr12,6970433,1.6476989159337287,5683,4888,10571,-
chr12,6970434,1.667437236229296,6661,5480,12141,-
chr12,6970436,1.5399855199061943,2524,2016,4540,-
chr12,6970438,1.5412632877752468,1180,877,2057,-
chr12,6970445,1.718626971065226,2191,1556,3747,-
chr12,6970469,0.5882981882981883,618,454,1072,-
chr12,6970470,1.9404301605070893,2577,1497,4074,-
chr12,6970472,1.8982424008073446,2986,2012,4998,-
chr12,6970473,1.6674338319907942,1448,747,2195,-
chr12,6970475,1.8301979264844488,2087,1060,3147,-
chr12,6970477,1.979588673005374,1320,655,1975,-
chr12,6970532,0.5041420118343195,638,454,1092,-
chr12,6970533,1.4111111111111108,888,629,1517,-
chr12,6970551,0.5001203717078337,610,482,1092,-
chr12,6970553,0.3960160547049205,591,433,1024,-
chr12,6970652,0.401953125,685,383,1068,-
chr12,6970661,0.6790326050875933,1128,711,1839,-
chr12,7080589,1.1540969889442778,776,646,1422,-
chr12,7088887,2.8295128939828085,789,697,1486,-
chr12,7088889,2.8632378725891288,1172,1002,2174,-
chr12,7088891,3.289650128001951,770,630,1400,-
chr12,7091612,2.7767107342279758,559,456,1015,-
chr12,7921605,1.4203476764156375,681,452,1133,-
chr12,8941667,1.2503934972349506,1384,1072,2456,-
chr12,8943527,2.44915860420287,727,567,1294,-
chr12,8945475,3.366745366974644,1049,694,1743,-
chr12,8945477,0.7912364894835576,1242,803,2045,-
chr12,8945542,1.1097690271197411,864,518,1382,-
chr12,9072687,3.4843769800085416,740,526,1266,-
chr12,9106531,2.8487641390867204,679,340,1019,-
chr12,9106532,3.4528703047484046,1007,497,1504,-
chr12,9112462,0.9713085519537132,644,406,1050,-
chr12,9112463,1.6435678212985472,932,622,1554,-
chr12,9869249,2.1965670940524644,618,453,1071,-
chr12,10158450,2.0485312899106005,801,521,1322,-
chr12,10158712,2.5735294117647056,804,551,1355,-
chr12,10158795,1.866492877758123,715,466,1181,-
chr12,10158798,0.5345748322607148,1097,980,2077,-
chr12,10158799,0.5345748322607148,1097,980,2077,-
chr12,10158818,1.7153578129187885,639,573,1212,-
chr12,10158973,1.5238236164545724,1354,1089,2443,-
chr12,10159224,0.6456722020018197,840,627,1467,-
chr12,10159225,1.7153005464480875,802,670,1472,-
chr12,10159255,1.771366489618542,637,435,1072,-
chr12,10159256,1.4322072586167542,1067,673,1740,-
chr12,10159269,0.3663461538461538,634,399,1033,-
chr12,10159905,1.5532617671345992,1880,1383,3263,-
chr12,10159907,1.5532617671345992,1880,1383,3263,-
chr12,10159917,0.7045476594712587,1416,1084,2500,-
chr12,10159966,2.115576592082616,792,580,1372,-
chr12,10160001,1.367629562551565,1471,1154,2625,-
chr12,10160359,2.479466119096509,689,486,1175,-
chr12,10160362,2.6839021905247074,1284,754,2038,-
chr12,10160363,2.6839021905247074,1284,754,2038,-
chr12,10160864,2.5176157176157177,921,714,1635,-
chr12,10166776,2.0250704643228006,1240,748,1988,-
chr12,10166789,1.8061936609479499,1211,723,1934,-
chr12,10166905,1.6514851485148514,833,504,1337,-
chr12,10166929,1.9902597402597404,612,538,1150,-
chr12,10169104,1.9465457570502904,1315,1041,2356,-
chr12,10172057,1.6747123796517367,4242,2522,6764,-
chr12,10172058,1.7683080808080809,2800,1547,4347,-
chr12,10172087,1.9230769230769231,1713,856,2569,-
chr12,10172122,2.3517318408628514,3575,1499,5074,-
chr12,10172124,2.2820577472177384,4842,1992,6834,-
chr12,10172128,2.878885968831928,2003,715,2718,-
chr12,10172131,0.5910797922157366,3721,1356,5077,-
chr12,10172134,1.6817638670615647,1297,694,1991,-
chr12,10172135,1.3885424452064425,1863,966,2829,-
chr12,10172136,1.4146205659774667,2453,1259,3712,-
chr12,10172137,1.1055663460713423,1156,565,1721,-
chr12,10431182,2.5044087136929463,782,481,1263,-
chr12,10431183,2.5044087136929463,782,481,1263,-
chr12,10435324,1.043859649122807,611,455,1066,-
chr12,10435325,1.8514752791068576,773,580,1353,-
chr12,10435391,1.6297100876576747,731,525,1256,-
chr12,10606199,30.524218373184112,3238,2795,6033,-
chr12,10606200,30.524218373184112,3238,2795,6033,-
chr12,10606201,26.24147365338703,2587,2313,4900,-
chr12,10606220,4.2750779666967205,1073,450,1523,-
chr12,10699514,1.8037235905217692,882,658,1540,-
chr12,10699592,1.4785723821814785,1328,976,2304,-
chr12,10699598,1.4823383598430075,1195,823,2018,-
chr12,10701266,1.8593974175035868,593,450,1043,-
chr12,10702103,0.20074669714063154,587,469,1056,-
chr12,10713253,1.2076747967479675,843,409,1252,-
chr12,10713255,1.2076747967479675,843,409,1252,-
chr12,10715765,1.6109122613803233,1002,680,1682,-
chr12,10718101,2.404506371100957,832,617,1449,-
chr12,10718102,1.9941650134204687,711,450,1161,-
chr12,10723318,3.3694292118544613,761,397,1158,-
chr12,10723319,3.4860815501067037,810,497,1307,-
chr12,10723322,0.48793513515359166,1247,612,1859,-
chr12,14786753,0.4934210526315789,599,417,1016,-
chr12,14786875,1.6492993172835066,611,505,1116,-
chr12,14787118,2.0524870584369,2511,1622,4133,-
chr12,14787121,2.743621082699333,2102,1582,3684,-
chr12,14787122,2.359709781810894,4335,2893,7228,-
chr12,14787124,2.2333364149024684,2055,1491,3546,-
chr12,14787125,1.6186882300089849,1125,524,1649,-
chr12,14787129,1.7348046136074946,3569,2214,5783,-
chr12,14787131,2.1737843501734533,1799,1156,2955,-
chr12,14787133,3.619338422391857,888,392,1280,-
chr12,14787136,1.9686059394349105,3879,1931,5810,-
chr12,14787137,1.9261761075298311,2246,1267,3513,-
chr12,14787138,1.9686059394349105,3879,1931,5810,-
chr12,14787244,1.2410782537279792,760,507,1267,-
chr12,14791225,1.5380682632878069,839,617,1456,-
chr12,14793878,2.515767947476052,753,488,1241,-
chr12,14793879,2.8080339462517685,1127,706,1833,-
chr12,14793881,3.4251253132832082,753,455,1208,-
chr12,14794550,0.2909090909090909,847,549,1396,-
chr12,14794551,0.2909090909090909,847,549,1396,-
chr12,14794554,1.202825804052798,646,488,1134,-
chr12,14794556,1.202825804052798,646,488,1134,-
chr12,14794618,1.8997478866973159,731,612,1343,-
chr12,14794619,1.0905003702312157,732,610,1342,-
chr12,15108496,1.0341256444180849,1192,952,2144,-
chr12,15108498,1.0341256444180849,1192,952,2144,-
chr12,15109086,2.271062271062271,774,454,1228,-
chr12,15109087,1.7596042517575283,1009,658,1667,-
chr12,15109225,1.1134359467692805,730,461,1191,-
chr12,15109226,1.5234546354775982,930,616,1546,-
chr12,15109365,3.405328256423592,618,533,1151,-
chr12,15109472,8.998862140305201,921,889,1810,-
chr12,15109476,12.850219919939772,2526,1888,4414,-
chr12,15109477,12.135649638005246,2796,2018,4814,-
chr12,15109478,13.822872874778684,1962,1535,3497,-
chr12,15121105,0.9277286135693216,628,451,1079,-
chr12,15121107,0.9277286135693216,628,451,1079,-
chr12,15217551,1.064943820224719,676,533,1209,-
chr12,15217553,1.4045280651014864,913,682,1595,-
chr12,15217579,1.7984114368953212,602,429,1031,-
chr12,16400509,2.1547892720306514,676,629,1305,-
chr12,21469729,1.9174603174603173,603,454,1057,-
chr12,21470209,1.7606995230524642,838,628,1466,-
chr12,21471026,3.4160997732426304,654,440,1094,-
chr12,21471053,2.098574617894556,939,646,1585,-
chr12,21471055,1.6265083421748272,1281,909,2190,-
chr12,21471087,1.8575313807531384,682,477,1159,-
chr12,21471601,1.6733766233766234,858,494,1352,-
chr12,21474916,1.1103223174214607,1236,816,2052,-
chr12,21474917,1.1103223174214607,1236,816,2052,-
chr12,21474948,3.0805687203791465,599,421,1020,-
chr12,21475490,0.6124482600030661,798,592,1390,-
chr12,21483568,2.2099189318073442,985,698,1683,-
chr12,21483569,2.450576693899937,1225,853,2078,-
chr12,21491596,2.196377787756324,637,392,1029,-
chr12,21501189,0.4354162657020926,599,485,1084,-
chr12,21501577,0.9966628183456727,6024,4387,10411,-
chr12,21501583,1.5148362289146482,3953,3238,7191,-
chr12,21501584,1.171471574309646,7497,5729,13226,-
chr12,21501585,0.5208584518929347,1781,1130,2911,-
chr12,21501586,1.3186779913367817,3685,2912,6597,-
chr12,21501593,0.4934949733885275,1668,1067,2735,-
chr12,21501600,1.3906208917101752,1254,673,1927,-
chr12,21501604,1.5367197839052955,1072,680,1752,-
chr12,21501605,1.3354700854700854,624,467,1091,-
chr12,21501607,0.6375227686703097,699,365,1064,-
chr12,21635626,1.481186907311104,4841,3735,8576,-
chr12,21635704,1.2936538396168973,22371,15638,38009,-
chr12,21637195,0.8430663729171192,613,480,1093,-
chr12,21638412,1.2648695062152084,23459,18798,42257,-
chr12,21638448,1.3012431066685324,12553,8897,21450,-
chr12,21638451,1.504766475320802,11819,8337,20156,-
chr12,21642125,0.7943643792665203,589,462,1051,-
chr12,21644019,1.3736918994152898,78816,56045,134861,-
chr12,21644020,1.2846255943361875,94011,66943,160954,-
chr12,21644025,1.811465065716436,21892,20742,42634,-
chr12,21644047,1.4389920215986352,33680,27713,61393,-
chr12,21644049,1.3413747785735275,166493,119191,285684,-
chr12,21644050,1.3368534640361587,149170,104807,253977,-
chr12,21644070,1.3160704569824802,21238,13081,34319,-
chr12,21644084,1.2216691409191591,11555,8350,19905,-
chr12,21644108,1.1456252737625932,2525,1521,4046,-
chr12,21644109,1.0373512284995765,2983,2439,5422,-
chr12,21644110,1.0787053370064048,5774,4225,9999,-
chr12,21644111,0.9553007284476004,4027,3141,7168,-
chr12,21644112,0.9712648425784318,1765,1406,3171,-
chr12,21646960,1.2635715696925849,34962,24332,59294,-
chr12,21646977,0.8196114447191805,9667,7599,17266,-
chr12,21647004,1.6886287065519912,4865,3747,8612,-
chr12,21647017,0.9749438510165057,739,534,1273,-
chr12,21654672,1.2398606745675758,16939,11959,28898,-
chr12,21654673,0.9861755282695198,19640,15248,34888,-
chr12,21657795,1.3053493683352413,12657,10135,22792,-
chr12,21657796,1.2833281080098644,18143,13585,31728,-
chr12,21657799,1.302366763609114,3434,2733,6167,-
chr12,21657805,1.0964127803706398,5489,3636,9125,-
chr12,21657809,0.7358937513073772,9331,6584,15915,-
chr12,21657813,0.8256631341790615,4281,3088,7369,-
chr12,21657818,0.6848936757801711,929,764,1693,-
chr12,21657819,1.012816626975536,2069,1549,3618,-
chr12,21657820,1.3085002888152495,1458,1035,2493,-
chr12,21657821,1.1531773799003173,3203,2522,5725,-
chr12,21657830,1.5793725446799092,891,582,1473,-
chr12,21657835,0.9360821469709593,2611,1971,4582,-
chr12,21657836,0.8874789739276703,1480,927,2407,-
chr12,21657837,0.9898696584721992,1131,1044,2175,-
chr12,25227389,2.8087774294670846,895,956,1851,-
chr12,25227390,0.3870351345798233,896,784,1680,-
chr12,25227391,2.2238029756883098,2211,2141,4352,-
chr12,25227392,2.8558536128254595,1595,1489,3084,-
chr12,25227394,2.8464527027027025,1232,1109,2341,-
chr12,25227395,2.081021783419527,812,708,1520,-
chr12,26905309,2.1833989080312275,777,613,1390,-
chr12,26905521,0.6774367417939382,861,634,1495,-
chr12,26911258,4.336550358822074,673,448,1121,-
chr12,26911259,4.336550358822074,673,448,1121,-
chr12,26916118,2.6757685684904318,768,610,1378,-
chr12,26922631,4.711016628752234,1199,805,2004,-
chr12,26925836,1.197452369274169,607,422,1029,-
chr12,26925846,2.372448979591837,674,440,1114,-
chr12,26925847,2.2805202558757935,1002,680,1682,-
chr12,26936597,1.859568119356105,1443,1414,2857,-
chr12,26936598,1.859568119356105,1443,1414,2857,-
chr12,26936636,2.2982112547329936,676,665,1341,-
chr12,26936638,2.2982112547329936,676,665,1341,-
chr12,26936639,2.1479383936042282,1294,1162,2456,-
chr12,26936641,1.9104143337066068,852,845,1697,-
chr12,26973786,0.4867628012519676,847,613,1460,-
chr12,26973927,6.901584296706813,623,495,1118,-
chr12,26973968,3.4636556104446004,817,653,1470,-
chr12,26973970,3.4636556104446004,817,653,1470,-
chr12,26974210,1.553077093979116,1027,642,1669,-
chr12,26975537,1.833913043478261,702,599,1301,-
chr12,26975542,2.0907372400756143,631,528,1159,-
chr12,26979928,1.0873493688240687,728,474,1202,-
chr12,26990529,1.7007087769963307,693,472,1165,-
chr12,29343247,1.7414245014245016,825,584,1409,-
chr12,29343248,0.5867455896007429,1098,717,1815,-
chr12,29343251,2.198952879581152,1424,954,2378,-
chr12,29343252,2.198952879581152,1424,954,2378,-
chr12,29343253,0.4380781956918091,864,501,1365,-
chr12,29343272,0.4563596049183633,565,450,1015,-
chr12,29343278,1.6456189223876074,827,572,1399,-
chr12,29345482,2.2941521841245556,1154,819,1973,-
chr12,29349117,2.1469162995594715,721,453,1174,-
chr12,29349154,1.9901538205961131,1523,1115,2638,-
chr12,29350028,1.692990780232025,2229,1744,3973,-
chr12,29350038,1.7581736028087498,2598,2023,4621,-
chr12,29350039,1.7071038251366113,1703,1439,3142,-
chr12,29350063,1.9350357507660878,1279,978,2257,-
chr12,29350064,1.9350357507660878,1279,978,2257,-
chr12,29350065,1.8868905599622163,1288,840,2128,-
chr12,29356418,0.5758513931888545,650,398,1048,-
chr12,29357648,2.512492768628508,886,605,1491,-
chr12,29361659,3.145225464190982,764,579,1343,-
chr12,29361660,3.145225464190982,764,579,1343,-
chr12,29361682,1.2238458230089129,1020,649,1669,-
chr12,29503000,3.982580528774108,723,522,1245,-
chr12,29503002,3.689364230540701,721,560,1281,-
chr12,29505901,2.0859502986256984,1000,533,1533,-
chr12,30630621,2.135265700483092,1767,1655,3422,-
chr12,30630622,2.135265700483092,1767,1655,3422,-
chr12,30630623,2.135265700483092,1767,1655,3422,-
chr12,30630649,2.877300613496933,803,651,1454,-
chr12,30630650,2.877300613496933,803,651,1454,-
chr12,30630668,2.4186655770483543,970,881,1851,-
chr12,30630669,2.3782028148682786,658,651,1309,-
chr12,30661213,0.4277754415475189,625,463,1088,-
chr12,30661214,0.7285357291604687,906,685,1591,-
chr12,30661216,0.97,581,449,1030,-
chr12,31281134,1.0141012909632572,1331,1006,2337,-
chr12,31281135,1.0141012909632572,1331,1006,2337,-
chr12,31281454,4.170909090909091,836,494,1330,-
chr12,31281456,4.170909090909091,836,494,1330,-
chr12,31281844,1.9191507862052501,1130,768,1898,-
chr12,31281922,1.9121942934782612,833,511,1344,-
chr12,31282142,2.4692129660053985,660,422,1082,-
chr12,31282424,0.47020665352496027,1135,789,1924,-
chr12,31282459,2.297911741414289,657,391,1048,-
chr12,31287766,2.7431185023759697,727,449,1176,-
chr12,31293819,3.952506596306069,748,378,1126,-
chr12,31709310,2.9651567944250874,551,491,1042,-
chr12,31709312,2.9651567944250874,551,491,1042,-
chr12,32726653,1.63854911625516,1641,1120,2761,-
chr12,32726660,1.5877104402477809,2085,1542,3627,-
chr12,32726678,1.1131799194279683,1944,1318,3262,-
chr12,32726679,1.1131799194279683,1944,1318,3262,-
chr12,32726701,2.129190196562703,1420,874,2294,-
chr12,32726718,1.5567519953229498,1550,935,2485,-
chr12,32726719,2.1730812013348157,813,464,1277,-
chr12,32726720,0.9052185548617304,737,471,1208,-
chr12,32747332,0.27224776609175017,791,597,1388,-
chr12,32750091,2.547739983168233,683,481,1164,-
chr12,32750784,1.1822289225186966,692,497,1189,-
chr12,32750834,2.7291746333759255,605,421,1026,-
chr12,32868988,2.9165920581419837,619,391,1010,-
chr12,32868990,3.062479832203936,603,430,1033,-
chr12,39322818,1.3686803526851505,805,383,1188,-
chr12,42161634,2.4105366883250037,619,699,1318,-
chr12,42161643,1.3207470869643636,892,938,1830,-
chr12,42313015,1.9271255060728745,951,512,1463,-
chr12,42313109,0.6371962616822429,973,641,1614,-
chr12,42313180,1.6335632183908044,626,521,1147,-
chr12,42313190,1.8237867939538583,654,418,1072,-
chr12,42313901,1.816983062407639,591,462,1053,-
chr12,42313952,1.955400182252376,1275,904,2179,-
chr12,42313953,1.0808095551482968,1548,1165,2713,-
chr12,42313970,1.7693296089385475,1241,894,2135,-
chr12,42313971,1.7794959383218552,1961,1326,3287,-
chr12,42317433,2.267729009411984,784,510,1294,-
chr12,42324067,1.7968312677792928,1058,783,1841,-
chr12,42324076,1.0908573250728864,1018,783,1801,-
chr12,42324077,1.0908573250728864,1018,783,1801,-
chr12,42324092,3.2884536940916873,682,414,1096,-
chr12,42324102,1.0544811176865352,595,442,1037,-
chr12,42324103,1.0544811176865352,595,442,1037,-
chr12,42326025,2.4072452028358082,652,458,1110,-
chr12,42326081,1.0622854049541135,1140,898,2038,-
chr12,42326082,1.3179750802243353,970,662,1632,-
chr12,42326083,1.0622854049541135,1140,898,2038,-
chr12,42326093,0.3976346080948018,817,504,1321,-
chr12,43793977,1.9072311993432647,1147,766,1913,-
chr12,43793981,2.104353778815965,1199,835,2034,-
chr12,43794335,1.7163841807909606,881,589,1470,-
chr12,43794338,1.7452440033085197,843,557,1400,-
chr12,43794813,1.8888888888888888,611,404,1015,-
chr12,43795060,1.5113138686131389,908,684,1592,-
chr12,43795066,0.5764705882352942,804,574,1378,-
chr12,43795073,1.7054333183655142,843,523,1366,-
chr12,43795074,0.5595804051260851,1273,943,2216,-
chr12,43795075,0.5595804051260851,1273,943,2216,-
chr12,43795078,0.5299599771297885,805,529,1334,-
chr12,43795623,0.5030712530712531,692,483,1175,-
chr12,43795707,2.897998456271838,606,504,1110,-
chr12,43795736,4.046441621349454,627,420,1047,-
chr12,43797037,1.3319349246914853,6537,4248,10785,-
chr12,43797041,1.5475483494181064,9345,5656,15001,-
chr12,43797043,1.5475483494181064,9345,5656,15001,-
chr12,43797064,1.120201349171544,6096,3879,9975,-
chr12,43797075,1.829742465753425,2491,1249,3740,-
chr12,43797083,0.6948785123542405,1827,926,2753,-
chr12,43797088,0.6409326087663922,1458,777,2235,-
chr12,43797095,1.3063580971946913,4394,2681,7075,-
chr12,43797315,1.9774011299435028,944,530,1474,-
chr12,43797317,1.9064180594467524,3551,1881,5432,-
chr12,43797319,1.894804769174724,5510,2926,8436,-
chr12,43797321,2.2916334661354583,2875,1505,4380,-
chr12,43797323,2.397119161291137,5046,2542,7588,-
chr12,43797324,1.7805641333858364,3181,1581,4762,-
chr12,43797327,1.16149194093804,1262,838,2100,-
chr12,43797333,1.5888617926641118,1276,565,1841,-
chr12,43797345,0.6044191019244476,953,413,1366,-
chr12,43797356,0.5755041810132808,701,320,1021,-
chr12,45922998,1.5123410716421406,4816,3600,8416,-
chr12,45922999,1.6410894798276177,3329,2600,5929,-
chr12,45923000,1.5469469192392662,5555,4120,9675,-
chr12,45923002,2.0167348161187206,2919,2057,4976,-
chr12,45923003,1.7747622622622623,2116,1439,3555,-
chr12,45923004,1.8253045611021865,2687,1808,4495,-
chr12,45926418,2.8602069056592176,631,390,1021,-
chr12,45928559,3.5460449750747074,604,436,1040,-
chr12,45928634,2.767989539873592,607,403,1010,-
chr12,46183257,2.5247863247863247,632,539,1171,-
chr12,46183286,2.337890625,664,511,1175,-
chr12,46183297,1.7830882352941175,969,628,1597,-
chr12,46183338,2.7290029469548136,634,508,1142,-
chr12,46183449,0.6450304259634888,1483,951,2434,-
chr12,46183526,0.6558633455655506,917,580,1497,-
chr12,46183877,2.565359477124183,784,467,1251,-
chr12,46183916,1.1151596145597384,1270,856,2126,-
chr12,46183929,1.6926889714993805,682,537,1219,-
chr12,46184466,0.702716275497393,1251,856,2107,-
chr12,46184492,2.7064779489175996,1238,858,2096,-
chr12,46184879,2.1375312343828092,1155,689,1844,-
chr12,46184880,2.1375312343828092,1155,689,1844,-
chr12,46184930,1.4579356922625166,661,416,1077,-
chr12,46184932,0.4227707194262386,912,690,1602,-
chr12,46185129,2.7538062720241654,856,712,1568,-
chr12,46185365,2.7913950838272528,1167,797,1964,-
chr12,46185426,0.6575928779318609,834,530,1364,-
chr12,46185477,1.6813922356091031,627,497,1124,-
chr12,46185762,16.495894084723897,2890,2467,5357,-
chr12,46185763,19.639523215805447,3843,2923,6766,-
chr12,46185764,19.639523215805447,3843,2923,6766,-
chr12,46185765,38.92702273167935,2862,1918,4780,-
chr12,46185771,5.435296015365037,975,414,1389,-
chr12,46185777,4.09338382399592,864,361,1225,-
chr12,46185778,3.9767268120355714,1802,650,2452,-
chr12,46185780,4.866236165197786,753,267,1020,-
chr12,46186007,0.529114124631888,1433,1050,2483,-
chr12,46186075,2.7190475582321505,997,821,1818,-
chr12,46186203,1.8810383747178332,640,442,1082,-
chr12,46186567,1.7841082257813716,1615,1089,2704,-
chr12,46186568,1.734698957032429,2735,1817,4552,-
chr12,46186918,2.239395181761261,1330,1067,2397,-
chr12,46187151,0.5941802252816021,632,469,1101,-
chr12,46187248,1.9010631373399869,673,418,1091,-
chr12,46187458,1.920854021847071,666,529,1195,-
chr12,46187497,2.3073146784486993,751,387,1138,-
chr12,46187663,2.904858299595141,614,493,1107,-
chr12,46187664,2.904858299595141,614,493,1107,-
chr12,46188234,1.7028112449799198,847,580,1427,-
chr12,46188332,2.437231503579953,665,418,1083,-
chr12,46188400,2.092536614590032,1163,696,1859,-
chr12,46188925,1.8221280032303653,1082,761,1843,-
chr12,46188926,1.8221280032303653,1082,761,1843,-
chr12,46188953,1.0814757336616205,1166,856,2022,-
chr12,46188968,0.3473299013831173,699,700,1399,-
chr12,46188969,0.3473299013831173,699,700,1399,-
chr12,46189032,0.5094320584278301,1796,1891,3687,-
chr12,46189033,0.5094320584278301,1796,1891,3687,-
chr12,46197762,1.8324468085106385,987,892,1879,-
chr12,46197815,1.985381917118043,1577,1194,2771,-
chr12,46197816,2.1535326086956523,950,735,1685,-
chr12,46198716,1.6235299235136131,999,806,1805,-
chr12,46203029,0.5529680979943464,631,436,1067,-
chr12,46204398,2.044054580896686,748,512,1260,-
chr12,46207563,1.7008896797153028,868,561,1429,-
chr12,46239865,2.304085412859075,1277,819,2096,-
chr12,46243234,2.0822368421052637,632,436,1068,-
chr12,46358265,4.813548508950846,2887,2563,5450,-
chr12,46358423,1.4421561149249935,1417,1103,2520,-
chr12,46358706,1.675081675081675,2631,1553,4184,-
chr12,46358793,1.55533896469569,2170,1538,3708,-
chr12,46358901,0.7002800263194137,2691,1827,4518,-
chr12,46359029,1.475721784776903,1210,1015,2225,-
chr12,46359093,1.8963607594936709,798,631,1429,-
chr12,46359143,1.4998506036726262,3957,2918,6875,-
chr12,46359194,1.3630544647731075,2920,2083,5003,-
chr12,46359300,1.5427124492180981,1458,1056,2514,-
chr12,46359811,1.4865963478695907,1677,1431,3108,-
chr12,46360176,1.6190819081908188,1498,1110,2608,-
chr12,46360901,1.4522875816993464,2771,1784,4555,-
chr12,46360907,2.110091586939498,1568,1276,2844,-
chr12,46361077,1.8154933981147652,2991,2135,5126,-
chr12,46361104,2.4860557768924307,911,752,1663,-
chr12,46361114,1.6407183393070492,1597,991,2588,-
chr12,46362313,1.5960510742082423,1458,1137,2595,-
chr12,46363063,0.5148861646234676,1571,1141,2712,-
chr12,46363759,1.528535885167464,1376,1044,2420,-
chr12,46363938,1.3408348834532118,3479,2465,5944,-
chr12,46364480,2.083996532976125,1652,1294,2946,-
chr12,46364493,1.7518130539887184,1086,948,2034,-
chr12,46365176,1.4714917452830187,1405,1059,2464,-
chr12,46366918,1.4288887648601885,2585,1885,4470,-
chr12,46366942,1.4331374755177728,2022,1262,3284,-
chr12,46370585,1.5431331953071084,2235,1448,3683,-
chr12,46370591,0.6424446583253127,1334,1038,2372,-
chr12,46370593,1.6878213232195534,2107,1355,3462,-
chr12,46370841,1.6294473293810265,2950,2156,5106,-
chr12,46370854,1.944697879151661,1033,734,1767,-
chr12,46371279,1.3300914273023394,1690,1227,2917,-
chr12,46371289,1.5654862579281186,1096,945,2041,-
chr12,46371343,1.7185812290176616,1623,1325,2948,-
chr12,46371344,1.7274173776992507,2620,1909,4529,-
chr12,46371345,1.7185812290176616,1623,1325,2948,-
chr12,46372663,1.4849466875508195,1476,1008,2484,-
chr12,46372689,2.42262283035209,1805,1327,3132,-
chr12,46372742,1.0161790017211705,614,580,1194,-
chr12,46372743,1.0161790017211705,614,580,1194,-
chr12,47687924,1.7496570993141984,1012,634,1646,-
chr12,48065639,1.5762922492942195,1126,793,1919,-
chr12,48065640,1.7617869536567416,1458,1005,2463,-
chr12,48065673,2.363826815642458,676,357,1033,-
chr12,48148075,9.45536031396289,646,948,1594,-
chr12,48693743,3.214358115534836,903,603,1506,-
chr12,48693759,1.2134634634634631,745,431,1176,-
chr12,48693760,1.2134634634634631,745,431,1176,-
chr12,48830352,0.3980013937253801,1101,898,1999,-
chr12,48830353,0.4133537206931702,810,653,1463,-
chr12,48832098,2.8995700459644307,847,592,1439,-
chr12,48832183,1.2496368251938972,1155,795,1950,-
chr12,48832184,0.9398256100720687,1754,1343,3097,-
chr12,48832185,1.0176028237294539,881,720,1601,-
chr12,48833421,1.5405689146628003,2567,1686,4253,-
chr12,48833422,1.4919267243443057,5933,4699,10632,-
chr12,48833424,1.4381618655692727,3381,3299,6680,-
chr12,48833425,1.6396906213516669,3169,2964,6133,-
chr12,48833426,1.52601054940965,4406,3874,8280,-
chr12,48833427,1.3390562824236758,3615,2962,6577,-
chr12,48833452,1.6790186557628417,729,558,1287,-
chr12,48834359,1.6005612311221344,679,447,1126,-
chr12,48834470,2.2353664455589706,1211,882,2093,-
chr12,48834479,2.5122450797043374,909,590,1499,-
chr12,48834485,0.6228063943161635,973,562,1535,-
chr12,48834488,0.5046064237909889,900,532,1432,-
chr12,48834489,0.5587722712214109,2693,1702,4395,-
chr12,48834490,0.5400000938615748,2297,1433,3730,-
chr12,48834492,0.6449704142011834,653,402,1055,-
chr12,48836722,1.475639605050408,625,478,1103,-
chr12,48837034,3.2374208145017676,690,479,1169,-
chr12,48837605,3.33623858867616,2122,1547,3669,-
chr12,48837606,3.1197683109118084,848,668,1516,-
chr12,48838059,2.5159545611724456,971,670,1641,-
chr12,48838063,2.3253833049403747,909,586,1495,-
chr12,48838064,1.575335614741043,1501,1007,2508,-
chr12,48840026,1.0097902097902098,721,454,1175,-
chr12,48840027,1.0097902097902098,721,454,1175,-
chr12,48844028,2.2385347078517026,2482,2011,4493,-
chr12,48844032,1.6334942057165744,7050,5302,12352,-
chr12,48844034,1.6716273645228,8763,6767,15530,-
chr12,48844035,1.6770039058670103,6693,5129,11822,-
chr12,48844036,0.6310655117315617,937,516,1453,-
chr12,48844037,1.9234835924547187,3023,2458,5481,-
chr12,48844038,1.7823514225930053,1914,1501,3415,-
chr12,48844049,1.5383542538354251,1102,716,1818,-
chr12,48845587,1.501794893747381,2061,1345,3406,-
chr12,48845588,1.9905635182052883,1031,716,1747,-
chr12,48845589,0.9871000251952633,1030,629,1659,-
chr12,48852139,0.34347461799739215,1061,812,1873,-
chr12,48852140,0.2584556805553133,1104,854,1958,-
chr12,48936976,0.174822695035461,492,704,1196,-
chr12,48936977,0.174822695035461,492,704,1196,-
chr12,48936978,0.174822695035461,492,704,1196,-
chr12,48936990,11.630389135429365,1219,1589,2808,-
chr12,48936991,11.630389135429365,1219,1589,2808,-
chr12,48936992,9.837826961770627,842,709,1551,-
chr12,48937961,8.257597832703476,1090,1087,2177,-
chr12,48937962,8.257597832703476,1090,1087,2177,-
chr12,48937966,5.012321448785819,1183,889,2072,-
chr12,48937967,5.212382817160183,1921,1477,3398,-
chr12,48937968,5.212382817160182,1921,1477,3398,-
chr12,48938320,7.583211198596257,887,723,1610,-
chr12,48938529,5.762080902784123,618,485,1103,-
chr12,48938638,3.7993763820469115,755,489,1244,-
chr12,48938771,1.7761904761904763,1118,737,1855,-
chr12,48938827,2.241207009609274,1056,711,1767,-
chr12,48938904,1.2486658993407973,822,502,1324,-
chr12,48938906,1.2486658993407973,822,502,1324,-
chr12,48939713,1.4318590267242386,1251,778,2029,-
chr12,48939775,3.1838235294117645,1298,764,2062,-
chr12,48940007,1.7440129449838189,633,514,1147,-
chr12,48940038,1.075908171986112,1521,1175,2696,-
chr12,48940984,3.0014148980441115,1386,889,2275,-
chr12,48941081,1.2473243011857298,1694,1110,2804,-
chr12,48941088,0.4972043010752688,577,449,1026,-
chr12,48941099,2.168825991628464,1115,691,1806,-
chr12,48957381,2.581623117712649,605,435,1040,-
chr12,48957409,8.415984455450596,1336,1074,2410,-
chr12,48957410,10.660849756631512,731,604,1335,-
chr12,48957415,6.253107299629317,1498,855,2353,-
chr12,48957416,6.460971302654819,1397,742,2139,-
chr12,48957422,5.631968368866277,823,366,1189,-
chr12,48965405,8.211567500542968,938,771,1709,-
chr12,48965592,1.3850672121566334,776,579,1355,-
chr12,48965805,1.5274827014910826,728,661,1389,-
chr12,48965864,0.39224911781093297,527,556,1083,-
chr12,48965890,4.174214625483461,1307,1214,2521,-
chr12,48966042,3.735028248587571,600,530,1130,-
chr12,48966044,3.735028248587571,600,530,1130,-
chr12,48966067,3.144866385372715,1117,710,1827,-
chr12,48966068,3.376053147784525,1390,929,2319,-
chr12,48966408,2.0991882786573828,587,485,1072,-
chr12,48966419,8.711456237775122,939,723,1662,-
chr12,48966434,5.312054778430243,750,443,1193,-
chr12,48967965,0.9548133595284873,863,508,1371,-
chr12,48967967,0.9548133595284873,863,508,1371,-
chr12,48970347,2.6588459099556117,598,414,1012,-
chr12,48970348,2.6588459099556117,598,414,1012,-
chr12,48971702,0.44847935726304594,642,509,1151,-
chr12,48971734,0.3868955219607775,709,907,1616,-
chr12,48971755,6.5060422441043775,986,1116,2102,-
chr12,48971756,6.5060422441043775,986,1116,2102,-
chr12,48971757,7.425249169435215,446,601,1047,-
chr12,49002344,5.594252681707412,1983,2588,4571,-
chr12,49002347,9.519503260037407,1939,2182,4121,-
chr12,49002350,3.6369803268954675,1917,2047,3964,-
chr12,49002359,7.005970370745569,4288,3711,7999,-
chr12,49002360,6.376487001384972,3775,3075,6850,-
chr12,49002367,1.8006779661016947,663,471,1134,-
chr12,49002392,18.347678354833732,5193,3403,8596,-
chr12,49002393,18.34767835483373,5193,3403,8596,-
chr12,49002399,7.897832242193807,5829,2549,8378,-
chr12,49002400,8.441885182191376,7053,3167,10220,-
chr12,49002401,8.441885182191376,7053,3167,10220,-
chr12,49002404,6.40503785167447,1293,406,1699,-
chr12,49002688,0.567941751129564,1282,861,2143,-
chr12,49002690,0.3975442397977609,1375,974,2349,-
chr12,49002726,1.8630948419301168,902,600,1502,-
chr12,49002728,0.6335929108485501,1088,797,1885,-
chr12,49002734,1.5973639455782311,662,503,1165,-
chr12,49002735,0.5317679558011049,769,542,1311,-
chr12,49002738,3.178473514653223,1309,965,2274,-
chr12,49002791,2.018552875695733,815,538,1353,-
chr12,49002825,2.5009781089892877,838,564,1402,-
chr12,49002866,1.919005102040816,707,447,1154,-
chr12,49002911,2.632902298850574,732,463,1195,-
chr12,49003265,1.0401942336031638,1287,1120,2407,-
chr12,49003275,1.7068965517241383,560,492,1052,-
chr12,49003571,0.6409785932721712,654,544,1198,-
chr12,49003805,0.37661498708010327,847,515,1362,-
chr12,49003849,2.4455879550219177,801,476,1277,-
chr12,49003857,2.1345366103430616,724,433,1157,-
chr12,49003894,1.9922099220992207,1016,812,1828,-
chr12,49003914,2.126953125,626,511,1137,-
chr12,49004598,1.8322884012539187,834,659,1493,-
chr12,49005154,0.6410369715716601,815,656,1471,-
chr12,49005354,0.934299513315958,3895,2662,6557,-
chr12,49005356,0.7631171441982453,8141,5125,13266,-
chr12,49005771,1.660135582010582,933,755,1688,-
chr12,49005810,1.752848951150468,778,598,1376,-
chr12,49005837,1.532051282051282,955,687,1642,-
chr12,49005844,1.678424015009381,638,532,1170,-
chr12,49018741,0.4172271386430679,815,564,1379,-
chr12,49018743,0.43122408298523385,1188,903,2091,-
chr12,49127976,2.3250517447382326,16639,11461,28100,-
chr12,49128044,1.2406565010665176,12572,10513,23085,-
chr12,49128063,1.1786326187311653,12569,8579,21148,-
chr12,49128069,1.5652120316703402,14559,10409,24968,-
chr12,49128072,1.4180160370690347,17072,11983,29055,-
chr12,49128101,1.3367197169830496,6438,3634,10072,-
chr12,49128121,1.3116255829447034,2974,1500,4474,-
chr12,49128132,1.5224241215415266,4507,2110,6617,-
chr12,49128133,1.291345103120265,6009,3257,9266,-
chr12,49128198,0.673655456222506,1116,647,1763,-
chr12,49128204,1.585888470503855,1082,857,1939,-
chr12,49128344,1.4736694122103913,10457,6883,17340,-
chr12,49128360,1.422103775985229,9518,6548,16066,-
chr12,49128382,1.681441491942332,5382,2593,7975,-
chr12,49128384,1.730857885252085,4129,1925,6054,-
chr12,49128402,0.538659793814433,923,678,1601,-
chr12,49128404,1.5983317669172932,2720,1861,4581,-
chr12,49128406,1.5983317669172932,2720,1861,4581,-
chr12,49128419,0.5169844400613631,673,506,1179,-
chr12,49128531,1.8715790043583007,1502,900,2402,-
chr12,49128551,0.8294881038211969,1715,1386,3101,-
chr12,49128552,0.6715556318234001,4060,3053,7113,-
chr12,49128555,1.6093531468531466,1082,879,1961,-
chr12,49128558,1.2764550264550265,1157,647,1804,-
chr12,49128559,1.2764550264550265,1157,647,1804,-
chr12,49128563,1.6435522047865345,871,670,1541,-
chr12,49128567,1.8300739957716703,830,343,1173,-
chr12,49128570,0.507593236681704,736,408,1144,-
chr12,49128571,0.507593236681704,736,408,1144,-
chr12,49128577,2.5465849542588157,1023,416,1439,-
chr12,49128579,2.5465849542588157,1023,416,1439,-
chr12,49128585,1.7447701958776083,830,534,1364,-
chr12,49128586,1.7447701958776083,830,534,1364,-
chr12,49129275,1.4459436298417265,10880,6890,17770,-
chr12,49129278,1.2702420199849391,12889,8027,20916,-
chr12,49129296,1.2900258368194037,5873,4241,10114,-
chr12,49129385,1.2758886101963798,19525,12445,31970,-
chr12,49129386,1.346198266360913,23611,15426,39037,-
chr12,49129577,1.3714931442488911,5053,3817,8870,-
chr12,49129590,1.2622777675953079,8541,5119,13660,-
chr12,49129607,1.3094154964111362,16173,9307,25480,-
chr12,49129609,1.2610482911052054,12877,7137,20014,-
chr12,49129610,1.379049182547473,2962,1905,4867,-
chr12,49129613,0.8011803786138258,3751,3260,7011,-
chr12,49129614,1.4348797146740306,2630,1626,4256,-
chr12,49129621,1.3030594458135478,3096,2750,5846,-
chr12,49129654,1.3711216574811185,3705,1703,5408,-
chr12,49131313,1.3578662673015378,22008,15426,37434,-
chr12,49131314,1.3578662673015378,22008,15426,37434,-
chr12,49131370,1.8097412174508531,25167,11935,37102,-
chr12,49131371,2.2546376789096216,9714,4155,13869,-
chr12,49131373,1.7902099389712676,26778,12515,39293,-
chr12,49131375,1.7373975308893268,53092,23454,76546,-
chr12,49131376,1.8913997367266342,12581,5723,18304,-
chr12,49131377,1.7664591705332287,40955,17591,58546,-
chr12,49131382,4.843672763222936,2612,866,3478,-
chr12,49131384,2.4031279521821403,18635,6412,25047,-
chr12,49131385,2.2806897181696884,35118,12322,47440,-
chr12,49131386,2.2802037971442326,46427,16677,63104,-
chr12,49131387,2.235339182964121,40072,14404,54476,-
chr12,49131394,0.8777851753339764,14259,4805,19064,-
chr12,49131395,0.8276572527178518,9086,3010,12096,-
chr12,49558481,1.8550404060076446,895,781,1676,-
chr12,49558483,1.6831627286487594,555,548,1103,-
chr12,49558486,3.739048273039501,657,477,1134,-
chr12,49559502,2.3366038723181584,673,545,1218,-
chr12,49559503,2.653558590371777,934,704,1638,-
chr12,49559504,2.3366038723181584,673,545,1218,-
chr12,49564825,1.1003356635770598,586,434,1020,-
chr12,49989436,0.3561130182202271,612,540,1152,-
chr12,49989505,1.8417293233082703,638,398,1036,-
chr12,49989506,2.5737548431279667,812,677,1489,-
chr12,49989626,2.359408033826638,557,472,1029,-
chr12,49989651,0.5544113907958301,622,436,1058,-
chr12,49989698,0.3748361730013106,519,544,1063,-
chr12,49989779,0.5201624606179099,1060,1212,2272,-
chr12,49989821,27.920089158915744,3517,2508,6025,-
chr12,49989822,27.920089158915744,3517,2508,6025,-
chr12,49989826,171.80195276330016,4018,1063,5081,-
chr12,49989827,171.80195276330016,4018,1063,5081,-
chr12,49989828,143.75931034482758,1398,289,1687,-
chr12,49989836,11.274137931034485,1005,115,1120,-
chr12,49989837,9.084715496066591,2529,294,2823,-
chr12,49989839,7.556923076923077,1227,124,1351,-
chr12,49989970,4.203603013575915,4494,3100,7594,-
chr12,49989971,4.5630501933633685,5063,3614,8677,-
chr12,49989972,4.177863840483214,3032,2192,5224,-
chr12,49990027,0.48589751979582496,674,412,1086,-
chr12,49990226,1.6970969643383433,742,467,1209,-
chr12,49990303,2.0560002122051677,868,591,1459,-
chr12,49990695,2.142060810473803,954,691,1645,-
chr12,49990788,2.0297366407819735,763,579,1342,-
chr12,49992066,5.225120941237466,704,546,1250,-
chr12,49994321,2.3550459150023104,1332,1076,2408,-
chr12,49994490,3.0488506000540236,562,464,1026,-
chr12,49997191,11.0,623,415,1038,-
chr12,49997198,0.9683583959899748,1123,683,1806,-
chr12,49997199,0.9683583959899748,1123,683,1806,-
chr12,50001210,4.12510283923342,653,504,1157,-
chr12,50005333,3.11336717428088,639,393,1032,-
chr12,50006511,1.9543637039665385,3696,2881,6577,-
chr12,50006513,1.7905496139516168,7872,5764,13636,-
chr12,50006514,1.7389468985879288,6849,4870,11719,-
chr12,50006515,1.7436725098846402,9675,6731,16406,-
chr12,50006517,1.7554880504833512,2826,1861,4687,-
chr12,50006542,1.9756250906804664,1074,666,1740,-
chr12,50006544,1.7174586776859504,664,483,1147,-
chr12,50006548,2.2026920031670625,641,420,1061,-
chr12,50006597,0.46920863514645994,962,709,1671,-
chr12,50006598,0.42118226600985226,664,405,1069,-
chr12,50175925,1.9054732174116,627,450,1077,-
chr12,50176054,2.209223891025088,1029,798,1827,-
chr12,50177206,2.3581730769230766,653,467,1120,-
chr12,50177256,4.251552795031055,1183,643,1826,-
chr12,50177258,4.251552795031055,1183,643,1826,-
chr12,50177661,1.5000501108005477,1726,1008,2734,-
chr12,50177667,1.1108347449313123,2191,1450,3641,-
chr12,50177691,3.9015807560137468,886,484,1370,-
chr12,50177695,0.2971022727272728,746,399,1145,-
chr12,50177698,1.563231325402966,1399,775,2174,-
chr12,50177700,2.109353412544902,984,516,1500,-
chr12,50178033,1.424770386266094,603,562,1165,-
chr12,50182033,2.6903981264637005,717,426,1143,-
chr12,50182035,2.6903981264637005,717,426,1143,-
chr12,50200834,1.0655456463112394,755,503,1258,-
chr12,50222152,5.899296738685974,761,550,1311,-
chr12,50986671,2.107018894817741,734,479,1213,-
chr12,50987415,16.76566446727346,757,950,1707,-
chr12,50987436,5.542781806187289,1097,649,1746,-
chr12,50987437,5.542781806187289,1097,649,1746,-
chr12,50988421,1.1263674786313849,551,461,1012,-
chr12,51712898,0.2883406518452763,464,640,1104,-
chr12,51712899,0.5878729204857934,651,790,1441,-
chr12,52170650,1.3856028284076833,596,474,1070,-
chr12,52171431,3.9835266226461767,568,475,1043,-
chr12,52171443,1.0899219575305952,848,604,1452,-
chr12,52897293,2.0860839919417318,1416,716,2132,-
chr12,52897485,1.3194132048544711,9577,7349,16926,-
chr12,52897524,1.423403087291533,63484,37109,100593,-
chr12,52897527,0.9978439228506886,183359,113605,296964,-
chr12,52897528,0.9835091088166458,147711,97065,244776,-
chr12,52897531,1.0439338006170389,60805,40627,101432,-
chr12,52897551,1.0576189402274982,57499,36332,93831,-
chr12,52897555,0.9833861235404506,33574,24521,58095,-
chr12,52897557,2.014222726993528,31076,14107,45183,-
chr12,52897558,2.6405957113621814,64768,38886,103654,-
chr12,52897561,1.4008558462272065,13006,4984,17990,-
chr12,52897570,1.4997906412697408,11166,4042,15208,-
chr12,52897573,1.4030520825112027,64202,35053,99255,-
chr12,52897575,1.4095136536377273,61545,33245,94790,-
chr12,52897590,1.5080412112074382,4800,2273,7073,-
chr12,52897591,1.5818748163215002,34266,21429,55695,-
chr12,52897592,1.5818748163215002,34266,21429,55695,-
chr12,52897593,1.5818748163215002,34266,21429,55695,-
chr12,52897602,1.4134561908679557,4825,1374,6199,-
chr12,52897609,1.5227108868060566,4223,1177,5400,-
chr12,52897610,1.5894805227245303,11236,5792,17028,-
chr12,52897613,2.309880700897491,15976,7444,23420,-
chr12,52897614,2.3698371022893694,23406,10588,33994,-
chr12,52897616,2.6241600934169718,19498,8138,27636,-
chr12,52898488,0.8061567315454933,6351,2650,9001,-
chr12,52898490,1.4916524216524216,1276,674,1950,-
chr12,52898491,0.8367779182576689,5695,2448,8143,-
chr12,52898493,0.5998111574474783,2309,894,3203,-
chr12,52898494,0.948724277335441,5690,2595,8285,-
chr12,52898499,0.7091000308737265,7066,3484,10550,-
chr12,52898501,0.6981831018070314,9071,4477,13548,-
chr12,52898514,0.3691724975139376,4023,2688,6711,-
chr12,52898515,0.3691724975139376,4023,2688,6711,-
chr12,52898840,1.3683787499167428,5273,3312,8585,-
chr12,52898845,1.2814733369983509,2330,1176,3506,-
chr12,52898852,1.6202284527518174,2052,962,3014,-
chr12,52899947,1.5877581671981296,20303,16693,36996,-
chr12,52899948,1.3369110015806425,34508,26348,60856,-
chr12,52899949,1.2831893635078964,86905,55983,142888,-
chr12,52899950,1.5420988296488949,30751,23999,54750,-
chr12,52899951,1.4098698543346924,49727,32363,82090,-
chr12,52899952,1.208710709732315,34751,22571,57322,-
chr12,52899955,1.5816282101352137,5100,3591,8691,-
chr12,52899958,0.9870811955329709,21714,12878,34592,-
chr12,52899965,1.1489218139906643,13789,7899,21688,-
chr12,52899978,0.7111318065304363,7562,4393,11955,-
chr12,52899979,1.3526596622476486,4917,2400,7317,-
chr12,52899980,1.5641477675407514,4585,2719,7304,-
chr12,52899982,1.5641477675407514,4585,2719,7304,-
chr12,52899983,1.5287400076132467,4015,1916,5931,-
chr12,52899987,0.872502136123601,11122,6734,17856,-
chr12,52899988,1.1694005045832525,16707,9501,26208,-
chr12,52899989,0.6000464492155243,1010,691,1701,-
chr12,52899993,0.45799066743743433,5420,3404,8824,-
chr12,52899994,1.6641656518918735,4475,2113,6588,-
chr12,52900007,2.272009072009072,1465,714,2179,-
chr12,52900016,1.8282123621441395,1228,556,1784,-
chr12,52900025,1.4212671682566946,2965,1846,4811,-
chr12,52900031,1.5686439129560212,2728,1150,3878,-
chr12,52900036,0.6770671134218077,2068,1006,3074,-
chr12,52900048,2.191021296525884,2446,980,3426,-
chr12,52900049,1.8739875861516009,4096,1929,6025,-
chr12,52900056,0.6986680230155451,1331,757,2088,-
chr12,52900661,1.872973892016473,4130,2984,7114,-
chr12,52900663,1.8678712244528848,6122,4364,10486,-
chr12,52900664,2.03223633744317,4022,2837,6859,-
chr12,52901203,1.2316414470705592,9533,6607,16140,-
chr12,52901207,1.3820493589056753,5527,3293,8820,-
chr12,52901208,1.2616828996564124,6447,3946,10393,-
chr12,52901212,1.5043611460896154,5353,3131,8484,-
chr12,52901213,1.4786283220924514,6843,4200,11043,-
chr12,52901216,1.8384877962671473,3470,2065,5535,-
chr12,52901217,2.3728674203494347,1442,972,2414,-
chr12,52901875,2.26968023919243,4354,3056,7410,-
chr12,52901876,1.7522985397512167,2079,1117,3196,-
chr12,52902049,1.622951040292843,2709,1401,4110,-
chr12,52902050,1.7108225108225108,987,604,1591,-
chr12,52902052,1.4150928950470143,4537,2953,7490,-
chr12,52904754,1.6773496022858907,1447,1125,2572,-
chr12,52904786,1.344427885411492,2823,2195,5018,-
chr12,52904847,1.2355618811082798,4285,2407,6692,-
chr12,52904907,1.5372018083878416,3294,1839,5133,-
chr12,52904910,1.6366961858647635,3244,1743,4987,-
chr12,52904920,1.3731675429080086,1805,1562,3367,-
chr12,52905034,2.3612713493948654,613,420,1033,-
chr12,52905051,1.247032150823213,1537,729,2266,-
chr12,52905053,1.3806095673820895,1367,622,1989,-
chr12,52905056,0.6978688405405525,940,502,1442,-
chr12,53211810,0.17667686522379647,629,377,1006,-
chr12,53308502,4.3974293446798525,783,569,1352,-
chr12,53543183,1.5395848246241943,848,380,1228,-
chr12,53543192,2.8991109393119436,999,596,1595,-
chr12,53543193,2.8991109393119436,999,596,1595,-
chr12,53543205,0.5440677966101695,962,530,1492,-
chr12,53543240,1.529096823368649,923,505,1428,-
chr12,53665250,1.4745993862938969,2594,2094,4688,-
chr12,53665416,1.6796101908303676,4144,2936,7080,-
chr12,53665421,1.841047218326321,1968,1425,3393,-
chr12,53669187,4.5584068734170335,17067,12191,29258,-
chr12,53669188,4.628983652718808,15251,10839,26090,-
chr12,53669331,1.3658460959777974,2082,1740,3822,-
chr12,53669943,1.5888359428182441,2333,1694,4027,-
chr12,53672617,1.28256466816949,3996,2520,6516,-
chr12,53672618,1.28256466816949,3996,2520,6516,-
chr12,53676069,1.6121059268600249,1087,792,1879,-
chr12,53676077,1.6958588581230094,843,582,1425,-
chr12,53676081,0.6772671375075275,2541,1640,4181,-
chr12,54181686,2.0982126507758316,820,525,1345,-
chr12,54252129,1.7314143920595535,622,402,1024,-
chr12,55725860,1.4073905386200585,8444,5674,14118,-
chr12,55725862,1.5414915925137638,4385,3243,7628,-
chr12,55726153,1.3003708281829418,3155,2426,5581,-
chr12,55726220,1.4851633499958934,7907,5344,13251,-
chr12,55726743,1.2825794077385326,11006,7997,19003,-
chr12,55726744,1.096688615715029,18095,13439,31534,-
chr12,55726751,1.1881443151441604,13089,8521,21610,-
chr12,55726752,1.1860236091131826,19051,12366,31417,-
chr12,55726754,1.1787906121221767,12399,8019,20418,-
chr12,55726779,0.7655310875353988,5211,3207,8418,-
chr12,55727283,0.7669275138689886,2504,1898,4402,-
chr12,55727322,1.3742618724490563,7148,5023,12171,-
chr12,55728309,1.5088637945178487,5897,4635,10532,-
chr12,55728310,1.4866489989532994,4107,3245,7352,-
chr12,55728319,0.7255639097744359,1736,1322,3058,-
chr12,55728322,1.4231589903721051,1242,944,2186,-
chr12,55728325,1.5787298525967766,1336,1036,2372,-
chr12,55728326,1.5011562004080707,1067,801,1868,-
chr12,55728344,1.5843586550435866,1538,802,2340,-
chr12,55728979,2.4292689932500364,994,632,1626,-
chr12,55728981,1.6694983604823357,2970,1303,4273,-
chr12,55728982,1.6890717378585098,4758,2557,7315,-
chr12,55728985,1.858604940301923,2105,1133,3238,-
chr12,55729004,1.833594886961285,3380,1384,4764,-
chr12,55729005,2.0687031581235793,4687,1847,6534,-
chr12,55729007,1.0418962136717742,5659,2626,8285,-
chr12,55729008,0.9728511343915437,3998,1955,5953,-
chr12,55757543,1.3854158486097834,1686,1098,2784,-
chr12,55757545,2.099397183455155,1758,1128,2886,-
chr12,55757547,2.4069565217391307,691,499,1190,-
chr12,55796041,0.6205801879662576,2371,2192,4563,-
chr12,55796064,2.7604297520661154,1056,1209,2265,-
chr12,55796065,2.2684226671294074,2962,3319,6281,-
chr12,55796067,2.4790378011450804,2912,3167,6079,-
chr12,55796069,3.0186345381526114,988,995,1983,-
chr12,55800620,1.691941391941392,744,454,1198,-
chr12,55800621,0.2820861678004535,621,503,1124,-
chr12,55800622,2.069870238275914,1346,1197,2543,-
chr12,55800623,2.069870238275914,1346,1197,2543,-
chr12,55800624,2.085292648225695,2051,1720,3771,-
chr12,55803663,3.757860962566845,731,424,1155,-
chr12,55817703,0.7535881888675126,967,953,1920,-
chr12,55817705,1.127958638130745,814,871,1685,-
chr12,55901573,5.205913038981648,632,461,1093,-
chr12,55901781,5.062722007757512,499,595,1094,-
chr12,55901782,4.762493605463841,542,572,1114,-
chr12,55902040,1.8635941942199636,608,440,1048,-
chr12,55980524,3.1464546521874817,1355,1050,2405,-
chr12,55980623,3.779967421706581,787,639,1426,-
chr12,55980926,0.6333612133377942,3512,2134,5646,-
chr12,55980927,0.7663369139621607,2237,1576,3813,-
chr12,55980928,0.6333612133377942,3512,2134,5646,-
chr12,55980932,1.1962057050143164,2340,1511,3851,-
chr12,55980933,1.4303449020348682,749,572,1321,-
chr12,55980934,1.2335598021687297,2150,1359,3509,-
chr12,55980936,0.5204644202230612,2079,1322,3401,-
chr12,55980938,0.5933053359683794,1021,703,1724,-
chr12,56181757,1.2220900025532022,739,548,1287,-
chr12,56205681,0.6127484151285114,707,530,1237,-
chr12,56205756,8.892039271087677,2245,2214,4459,-
chr12,56205757,10.384137982537418,2409,2371,4780,-
chr12,56205758,10.384137982537418,2409,2371,4780,-
chr12,56205759,15.514869888475836,490,537,1027,-
chr12,56205772,18.64104797037161,1177,744,1921,-
chr12,56271882,1.695361513936028,633,462,1095,-
chr12,56271963,2.286158438005224,592,472,1064,-
chr12,56272363,5.103832155855279,744,518,1262,-
chr12,56272371,1.6901311249137336,710,482,1192,-
chr12,56272633,1.3860671172975205,772,631,1403,-
chr12,56272640,1.6096071672953887,679,514,1193,-
chr12,56272777,1.1957582464819596,834,540,1374,-
chr12,56272921,2.0898666260758043,692,513,1205,-
chr12,56272924,2.9194516547696296,836,535,1371,-
chr12,56272925,2.6381492689184314,1518,945,2463,-
chr12,56272926,2.6381492689184314,1518,945,2463,-
chr12,56272929,1.8152345512016912,668,461,1129,-
chr12,56272944,0.6342538798896105,663,420,1083,-
chr12,56273082,2.1067577666275223,597,550,1147,-
chr12,56273096,2.7818181818181817,764,549,1313,-
chr12,56273098,2.7818181818181817,764,549,1313,-
chr12,56273253,2.2668590720707633,765,565,1330,-
chr12,56273677,0.5382110579479,622,455,1077,-
chr12,56273769,3.010633702526306,940,742,1682,-
chr12,56274855,2.3922122665904744,774,506,1280,-
chr12,56276133,0.4915524305731195,844,745,1589,-
chr12,56276140,2.6930232558139533,771,644,1415,-
chr12,56276168,0.5394934333958725,638,519,1157,-
chr12,56276186,2.1180294565769433,1202,894,2096,-
chr12,56276188,2.1180294565769433,1202,894,2096,-
chr12,56276192,2.056530214424951,1054,702,1756,-
chr12,56276193,1.5849672024975066,1452,1036,2488,-
chr12,56286632,2.411764705882353,614,389,1003,-
chr12,56286634,2.411764705882353,614,389,1003,-
chr12,56286641,1.761707620109452,671,521,1192,-
chr12,56286642,0.8861003861003862,611,443,1054,-
chr12,56286644,0.3221977659164695,606,463,1069,-
chr12,56310501,1.4703558345275791,2537,2272,4809,-
chr12,56310502,1.634355024086922,3049,2716,5765,-
chr12,56310503,1.4703558345275791,2537,2272,4809,-
chr12,56310521,1.9023331910655852,1137,851,1988,-
chr12,56311258,1.4870695746384663,1237,922,2159,-
chr12,56311311,2.0851117248305293,754,568,1322,-
chr12,56311353,0.6486297783208239,928,673,1601,-
chr12,56311367,1.3750000000000002,1386,911,2297,-
chr12,56311408,1.7758346581875992,1116,628,1744,-
chr12,56314932,1.5698529411764708,1280,815,2095,-
chr12,56314940,1.5787746170678336,545,456,1001,-
chr12,56314943,1.825533021320853,1002,640,1642,-
chr12,56314946,1.542643480325242,683,580,1263,-
chr12,56315218,1.1350184307530278,828,632,1460,-
chr12,56315219,1.1350184307530278,828,632,1460,-
chr12,56315872,1.8088888888888888,813,485,1298,-
chr12,56316011,0.5612702033927405,664,431,1095,-
chr12,56417326,0.7659468659924367,792,439,1231,-
chr12,56603696,1.7996210373022052,994,910,1904,-
chr12,56603697,1.8612531666317869,1229,1051,2280,-
chr12,56638420,1.3507130863815089,11393,7606,18999,-
chr12,56639218,0.6255883255409995,5229,4225,9454,-
chr12,56639243,1.4944160587775916,3307,2526,5833,-
chr12,56639284,1.3668123553461518,11174,7766,18940,-
chr12,56639289,1.3187891228719246,5261,3253,8514,-
chr12,56639290,1.461361691724728,2598,1817,4415,-
chr12,56639305,1.0350966214791486,4667,2794,7461,-
chr12,56639307,0.998576342402456,5013,3071,8084,-
chr12,56640082,1.1510674214841443,8413,6793,15206,-
chr12,56640184,1.3147043928982802,3922,2961,6883,-
chr12,56642471,1.2610050123371568,10461,8586,19047,-
chr12,56642495,1.6299557242251739,8052,5099,13151,-
chr12,56642497,1.3894862545826248,3578,2865,6443,-
chr12,56642570,1.3235472203009309,5257,4101,9358,-
chr12,56642571,1.278975964306275,2986,2315,5301,-
chr12,56642811,1.2363691226499118,3577,2757,6334,-
chr12,56643867,1.2186156512312578,8389,5434,13823,-
chr12,56644951,1.4911722776620244,2091,1657,3748,-
chr12,56645099,0.7236831263755661,1142,806,1948,-
chr12,56645232,1.1629187139391222,6669,4458,11127,-
chr12,56645251,0.9828589519387324,6629,5767,12396,-
chr12,56645253,1.079894918411256,8846,7519,16365,-
chr12,56645260,1.5791238060122554,4507,3593,8100,-
chr12,56645265,1.411245173745174,2564,2071,4635,-
chr12,56645318,1.6241902965651367,3799,2934,6733,-
chr12,56645333,0.5919791650411029,3631,2840,6471,-
chr12,56645334,0.5279124615785475,5393,4253,9646,-
chr12,56645879,1.466790180639185,1623,1269,2892,-
chr12,56645905,1.6535303776683088,1006,782,1788,-
chr12,56645906,1.4813477936915307,2293,1284,3577,-
chr12,56645915,2.5919322888528717,2333,1850,4183,-
chr12,56645917,2.7656485416591003,5162,3585,8747,-
chr12,56645962,0.638660801093538,1353,792,2145,-
chr12,56663687,2.1115738498789347,990,825,1815,-
chr12,56663958,2.1828103683492497,1039,732,1771,-
chr12,56664062,1.3935934081357124,3887,2783,6670,-
chr12,56664249,1.6887393906207224,1027,690,1717,-
chr12,56664472,1.0478826109429829,2030,1490,3520,-
chr12,56664475,0.6710111177884615,1190,831,2021,-
chr12,56664483,1.1146909902570554,1101,804,1905,-
chr12,56664490,2.1158892826357634,1051,590,1641,-
chr12,56664491,2.1158892826357634,1051,590,1641,-
chr12,56664496,0.3982871283452156,847,591,1438,-
chr12,56670359,2.1603498542274053,740,489,1229,-
chr12,56672766,3.016363636363636,552,449,1001,-
chr12,56672780,2.1793103448275857,710,434,1144,-
chr12,56672786,1.7955828692145188,898,634,1532,-
chr12,56672794,1.984855543029167,1069,719,1788,-
chr12,56673041,1.7993730407523512,755,521,1276,-
chr12,56688115,3.121317559730921,840,478,1318,-
chr12,56688117,3.121317559730921,840,478,1318,-
chr12,56688121,2.4918836880978823,630,402,1032,-
chr12,56712854,1.4135555555555557,6360,3749,10109,-
chr12,56712874,1.274462071480671,4203,2284,6487,-
chr12,56712887,1.2760075794951953,3722,1965,5687,-
chr12,56713190,0.20473956987858433,641,465,1106,-
chr12,56713572,1.520420793745888,86085,59946,146031,-
chr12,56713579,1.6063450190211266,155108,103904,259012,-
chr12,56713580,1.6141971386744227,227259,150292,377551,-
chr12,56713582,1.6451416134150751,148387,96918,245305,-
chr12,56713590,1.5176720552832672,29344,19203,48547,-
chr12,56713605,1.0312280666384817,79887,47392,127279,-
chr12,56713617,1.311050414071392,59369,31630,90999,-
chr12,56713618,1.311050414071392,59369,31630,90999,-
chr12,56713619,1.1342806826760543,119075,69020,188095,-
chr12,56713679,1.4000798060911015,16932,9406,26338,-
chr12,56713683,0.9951837651059346,4192,1648,5840,-
chr12,56713684,0.9951837651059346,4192,1648,5840,-
chr12,56714375,1.1959472026679843,26685,15438,42123,-
chr12,56714402,0.7611495615107554,13651,9827,23478,-
chr12,56714422,1.3831973165225768,16392,11454,27846,-
chr12,56714424,1.2634771879764624,4610,3315,7925,-
chr12,56714669,1.5298498387014183,5252,2647,7899,-
chr12,56714676,1.2434976665030377,24672,13674,38346,-
chr12,56714678,1.3832929526782325,12645,5776,18421,-
chr12,56714679,1.6420005254432124,22345,10431,32776,-
chr12,56714681,1.6836908818502936,18226,8562,26788,-
chr12,56724503,0.7449272772959974,11824,7943,19767,-
chr12,56724522,0.7739697253052541,3775,2732,6507,-
chr12,56725058,2.030027149321267,1900,1699,3599,-
chr12,56725060,4.853490325689794,2725,2311,5036,-
chr12,56725118,1.883506343713956,780,577,1357,-
chr12,56725119,1.883506343713956,780,577,1357,-
chr12,56725282,1.2122278911781297,10730,7291,18021,-
chr12,56725286,0.7718223390804959,3228,1746,4974,-
chr12,56725298,0.6611661805709877,9791,6535,16326,-
chr12,56725300,0.8087082003481277,11464,7924,19388,-
chr12,56725301,0.9985807603762329,5048,3953,9001,-
chr12,56725308,1.6720779220779218,720,538,1258,-
chr12,56725339,0.8395743563830724,1179,912,2091,-
chr12,56725340,1.0516909259465688,1162,898,2060,-
chr12,56738471,2.2610474631751227,920,704,1624,-
chr12,56738483,6.420731707317072,818,573,1391,-
chr12,56739319,1.7778945542575721,1271,918,2189,-
chr12,56739320,1.158610812746151,808,512,1320,-
chr12,56739323,0.45555656648652904,672,438,1110,-
chr12,56751142,1.1883029498824174,1042,1029,2071,-
chr12,56751145,2.130979019759544,760,746,1506,-
chr12,56751149,1.3755656108597285,683,662,1345,-
chr12,56751151,1.3755656108597285,683,662,1345,-
chr12,56751152,2.6319906620987625,581,471,1052,-
chr12,56751169,2.5038601761309107,590,560,1150,-
chr12,57517730,1.5151728649791154,771,640,1411,-
chr12,57517731,3.4199604978761644,688,618,1306,-
chr12,57530637,1.521332637057303,1143,851,1994,-
chr12,57530638,0.8859205776173286,817,553,1370,-
chr12,57530645,1.4575495367137432,940,704,1644,-
chr12,57530646,1.1856303418803418,578,467,1045,-
chr12,57530660,2.315773981526228,577,451,1028,-
chr12,57532293,0.24324931699775232,783,519,1302,-
chr12,57532623,1.3754350884026918,580,475,1055,-
chr12,57535783,2.4614708145542483,932,826,1758,-
chr12,57535789,2.113658418243571,849,686,1535,-
chr12,57535810,2.266901822457378,722,566,1288,-
chr12,57535816,0.49499072356215207,666,489,1155,-
chr12,57535821,2.0964962976494967,931,638,1569,-
chr12,57535833,1.2762306860605832,860,575,1435,-
chr12,57546068,1.8675889328063238,755,505,1260,-
chr12,57546069,1.8675889328063238,755,505,1260,-
chr12,57546077,2.367164595839732,627,376,1003,-
chr12,57546078,2.771795921188441,1204,753,1957,-
chr12,57748405,1.7717245089792728,1276,840,2116,-
chr12,57748588,1.3446507014667477,1683,1271,2954,-
chr12,57748603,1.5648110957950665,2039,1547,3586,-
chr12,57748604,0.9024877149877151,1305,1055,2360,-
chr12,57749277,1.0560301507537688,1400,994,2394,-
chr12,57749279,0.8723171923606816,2028,1383,3411,-
chr12,57749464,1.9747706422018347,614,435,1049,-
chr12,57750715,1.6560866794136393,811,522,1333,-
chr12,57750719,1.8227424749163879,762,482,1244,-
chr12,57750736,0.6015625,769,671,1440,-
chr12,57750759,2.5127019304789306,1804,1208,3012,-
chr12,57750761,2.63623395149786,1055,700,1755,-
chr12,57750941,0.612908443869298,841,561,1402,-
chr12,57751069,2.0192530399536768,1130,627,1757,-
chr12,57751070,3.848948374760994,670,522,1192,-
chr12,57751083,0.8650681482203486,1132,866,1998,-
chr12,57751084,0.8167737930428485,2028,1574,3602,-
chr12,57751217,1.7940446650124071,963,571,1534,-
chr12,57751543,0.48768472906403953,647,405,1052,-
chr12,57751645,3.1937652900569207,1015,780,1795,-
chr12,57751685,2.0796049382716046,751,674,1425,-
chr12,57751686,0.25582648436311173,1253,849,2102,-
chr12,57751687,2.0796049382716046,751,674,1425,-
chr12,57751719,1.2755743278046772,654,488,1142,-
chr12,57752309,0.5357561733116365,908,586,1494,-
chr12,57752316,4.717519840235951,766,598,1364,-
chr12,62022151,2.435909090909091,931,1199,2130,-
chr12,62022156,1.606177606177606,857,1035,1892,-
chr12,62022162,0.4577719355898784,596,536,1132,-
chr12,62022167,0.6034239866904593,1284,1020,2304,-
chr12,62022168,0.6034239866904593,1284,1020,2304,-
chr12,62022171,0.5836122125484515,803,627,1430,-
chr12,64338629,0.2947368421052632,685,489,1174,-
chr12,64715187,2.7872438382422486,655,403,1058,-
chr12,64715264,1.1053747925835078,911,414,1325,-
chr12,64715265,1.2490167391136993,1119,522,1641,-
chr12,64715266,1.1053747925835078,911,414,1325,-
chr12,64716363,0.44222462203023755,755,462,1217,-
chr12,64716370,1.9137393861367367,1183,830,2013,-
chr12,66130749,1.0978259044562324,827,686,1513,-
chr12,75499902,2.638996732654238,831,588,1419,-
chr12,75503942,4.577674418604651,797,644,1441,-
chr12,75506528,1.9141945734197792,854,629,1483,-
chr12,75511568,2.791384615384616,755,389,1144,-
chr12,75511569,2.250003012209569,1226,716,1942,-
chr12,75511570,2.791384615384616,755,389,1144,-
chr12,76046879,2.4120698380566803,614,493,1107,-
chr12,76047712,2.369156837046745,956,653,1609,-
chr12,76048403,1.7350993377483444,785,452,1237,-
chr12,76048459,2.812523864070256,1269,872,2141,-
chr12,76048461,2.5414254132013903,1856,1238,3094,-
chr12,76048462,1.7742918313570488,742,505,1247,-
chr12,76048463,2.397821961884333,1210,781,1991,-
chr12,76050615,1.4342673761131408,2580,2372,4952,-
chr12,76050621,1.5354626796595787,2274,2046,4320,-
chr12,76050636,1.3935483870967742,1619,1349,2968,-
chr12,76050637,1.6186291739894556,1534,1137,2671,-
chr12,76050638,1.4290857558696235,1165,966,2131,-
chr12,76050641,1.456663645079737,2535,1952,4487,-
chr12,76050647,1.566211867663186,3832,2878,6710,-
chr12,76050648,1.5717591520781873,4684,3507,8191,-
chr12,76050650,1.3369277418474723,3316,2406,5722,-
chr12,76050651,1.270130762384092,3037,2123,5160,-
chr12,76050652,1.0999826210110752,3147,2200,5347,-
chr12,76053323,1.4453292496171517,3002,1958,4960,-
chr12,76053340,1.5328627450980392,2442,1699,4141,-
chr12,76053896,1.6758229336227166,2964,1842,4806,-
chr12,76053898,1.6706950614058007,2789,2063,4852,-
chr12,76060179,1.2925576467675528,3756,2580,6336,-
chr12,76060263,1.4191989748569127,3004,1978,4982,-
chr12,76060264,1.357523136265638,2079,1662,3741,-
chr12,76067418,1.3932105552501373,2696,1818,4514,-
chr12,76068979,1.3662195474027845,1952,1216,3168,-
chr12,76068981,1.535411159375992,2983,2292,5275,-
chr12,76068990,1.6352206322906155,4043,2634,6677,-
chr12,76068991,1.682142239711536,2670,1812,4482,-
chr12,76068992,0.5541775919495429,1563,1095,2658,-
chr12,76084577,1.8142493638676849,1022,785,1807,-
chr12,76084579,0.5433962264150943,671,529,1200,-
chr12,76084620,0.6055325797261281,1135,836,1971,-
chr12,76084628,0.5633963564322323,968,748,1716,-
chr12,76084651,4.819362455726092,784,384,1168,-
chr12,76084680,2.09660842754368,799,277,1076,-
chr12,76084682,1.1392163826681367,1632,711,2343,-
chr12,76084683,1.0211274697387769,974,286,1260,-
chr12,76084684,1.0211274697387769,974,286,1260,-
chr12,76371551,2.143087530676639,1697,994,2691,-
chr12,76371559,0.9849564349246688,2614,1573,4187,-
chr12,76371560,0.9849564349246688,2614,1573,4187,-
chr12,76371563,2.162095531587057,876,589,1465,-
chr12,76371580,2.100051440329218,709,431,1140,-
chr12,76373360,2.060411311053985,686,388,1074,-
chr12,76373373,1.0624795684864334,962,531,1493,-
chr12,76373374,1.163506307440709,2555,1556,4111,-
chr12,76373375,0.4515556204237516,976,578,1554,-
chr12,76373406,2.3926521239954073,732,412,1144,-
chr12,79590935,2.5368642925019054,772,529,1301,-
chr12,79689840,2.080693631503918,959,652,1611,-
chr12,79689842,2.3217462809299545,878,636,1514,-
chr12,79689843,2.1274234400184207,782,504,1286,-
chr12,80103342,1.120321844047767,5422,5003,10425,-
chr12,80103344,1.3360980839003442,2973,3226,6199,-
chr12,80103345,1.4981097550449691,1355,1092,2447,-
chr12,80103349,0.8387616814372909,1721,1233,2954,-
chr12,80103350,0.9345447885959366,2518,1884,4402,-
chr12,80103351,1.2958275922036573,1268,1266,2534,-
chr12,80103352,1.0223453311092772,4131,3463,7594,-
chr12,80103354,0.7907895939429029,1856,1609,3465,-
chr12,82353120,2.124468607074877,670,435,1105,-
chr12,82357144,1.4282988049030807,822,571,1393,-
chr12,82357200,1.759229322890006,1750,1551,3301,-
chr12,82357204,2.100440531639029,2936,2545,5481,-
chr12,82357205,1.974444444444444,1776,1763,3539,-
chr12,82357218,0.9723427510218532,1904,1555,3459,-
chr12,82357219,1.084726246192705,1536,1281,2817,-
chr12,82357224,0.595703125,609,511,1120,-
chr12,82357241,2.081481481481481,842,674,1516,-
chr12,82357243,2.027173155431572,1710,1303,3013,-
chr12,82357244,1.9630225080385846,813,621,1434,-
chr12,82357248,1.384538869618445,986,675,1661,-
chr12,82357249,1.5057206663098563,1172,833,2005,-
chr12,82357250,1.384538869618445,986,675,1661,-
chr12,89590780,6.552459441085364,1156,1352,2508,-
chr12,89590781,9.941981591215457,688,691,1379,-
chr12,89635046,2.2905259622359186,673,531,1204,-
chr12,92143473,0.5754927860191018,707,531,1238,-
chr12,92143570,2.3865689865689865,673,454,1127,-
chr12,92143812,2.5886210563629914,634,433,1067,-
chr12,92143816,7.771270509268598,2715,2038,4753,-
chr12,92143999,4.289088741211328,1496,960,2456,-
chr12,92144173,2.18892422098315,879,593,1472,-
chr12,92145465,1.0792552672366267,594,452,1046,-
chr12,92145686,0.797364209098899,584,449,1033,-
chr12,92778003,4.494209039548021,676,589,1265,-
chr12,92778004,4.494209039548021,676,589,1265,-
chr12,93409651,1.3384314782374345,684,361,1045,-
chr12,93409653,0.905445555268716,1332,797,2129,-
chr12,93410011,2.2370026848913844,704,481,1185,-
chr12,93410035,2.0852823056933616,678,497,1175,-
chr12,93410076,2.237481720574353,1248,854,2102,-
chr12,93411167,1.9691742081447963,632,415,1047,-
chr12,93411176,1.2054246466807172,757,615,1372,-
chr12,93441886,0.471695230665464,620,510,1130,-
chr12,94971506,2.124401913875598,887,550,1437,-
chr12,94971603,1.0966741804637732,1527,1033,2560,-
chr12,94994233,2.1589756592292093,654,492,1146,-
chr12,95002752,2.204841117509064,712,520,1232,-
chr12,95002817,0.46910094138262576,889,607,1496,-
chr12,95002820,0.4564586933505359,786,551,1337,-
chr12,95658501,2.4758021958656373,737,524,1261,-
chr12,95659123,2.1951265229615737,1672,1066,2738,-
chr12,95659176,2.9295774647887325,839,496,1335,-
chr12,95659184,1.6403387220939185,760,432,1192,-
chr12,95659186,0.4121411149901028,861,523,1384,-
chr12,95665914,1.5542310154547658,1248,859,2107,-
chr12,96000948,0.5828054298642534,755,662,1417,-
chr12,96001086,1.7287377491284615,772,660,1432,-
chr12,96001105,2.2055073395478413,663,548,1211,-
chr12,96002981,2.2152716390862177,1387,1190,2577,-
chr12,96002987,1.610318396226415,880,529,1409,-
chr12,96003848,1.9785575048732944,629,512,1141,-
chr12,96003898,0.5948037589828635,806,602,1408,-
chr12,96009105,1.6915111849174562,935,705,1640,-
chr12,96009129,0.7005187005187006,1282,850,2132,-
chr12,96013851,2.446451612903226,947,619,1566,-
chr12,96014948,0.47241254958528667,785,707,1492,-
chr12,96014983,4.206475261079512,3622,2756,6378,-
chr12,96015597,3.316993464052288,1014,611,1625,-
chr12,96015658,1.8846828609986503,900,569,1469,-
chr12,96017072,1.6649616368286446,650,543,1193,-
chr12,96017092,1.8477590273997464,598,500,1098,-
chr12,96017101,0.6186157517899762,647,418,1065,-
chr12,96018847,1.6737288135593218,789,471,1260,-
chr12,96019194,0.7057644141488474,11500,7124,18624,-
chr12,96019223,1.003300363820653,4797,3054,7851,-
chr12,96019224,1.4066183725398558,2233,1571,3804,-
chr12,96019226,0.9125289603349217,6650,4297,10947,-
chr12,96019227,0.8895230523012557,6966,4623,11589,-
chr12,96019237,1.7507036990228966,4286,2666,6952,-
chr12,96019238,1.7891186483419492,2404,1441,3845,-
chr12,96021117,2.6205927798848148,1695,1016,2711,-
chr12,96022156,1.5983564458140729,1555,943,2498,-
chr12,96024498,0.6471801925722146,940,726,1666,-
chr12,96024534,2.050812542916,639,513,1152,-
chr12,96027514,1.8726733547857908,847,586,1433,-
chr12,96029156,0.5605410064864096,1422,1125,2547,-
chr12,96029176,2.11046511627907,604,429,1033,-
chr12,96029178,1.1588050129966505,858,827,1685,-
chr12,96029183,1.4120345057686154,1201,1057,2258,-
chr12,96029184,1.098708960328317,658,687,1345,-
chr12,96035460,3.2261073843983867,715,550,1265,-
chr12,98613652,0.6354252683732452,1538,1037,2575,-
chr12,98614206,2.194589463692454,815,601,1416,-
chr12,98626500,1.613905242500701,4111,3566,7677,-
chr12,98626501,1.4280373671463245,5257,4327,9584,-
chr12,98626503,1.4026660012061472,2839,1780,4619,-
chr12,98626515,1.4363294048608737,2195,1351,3546,-
chr12,98626543,1.5597667638483963,1283,685,1968,-
chr12,98626570,0.34780835881753314,852,435,1287,-
chr12,98626571,0.4699248120300752,674,377,1051,-
chr12,98626582,2.1091062774536122,1895,1181,3076,-
chr12,98626608,2.336743215031315,860,478,1338,-
chr12,100009486,1.6653773344853038,2378,1647,4025,-
chr12,100009488,1.840191883666527,2804,1848,4652,-
chr12,100009489,1.9897258032851253,2026,1294,3320,-
chr12,100009490,1.9897258032851253,2026,1294,3320,-
chr12,100009526,0.4596018735362998,627,487,1114,-
chr12,100009581,1.8034860191317141,712,452,1164,-
chr12,100009582,1.5939248385463172,2010,1212,3222,-
chr12,100009583,1.4753975235796493,1298,760,2058,-
chr12,101395459,3.076555023923445,642,417,1059,-
chr12,101395617,1.3449614100687874,1042,816,1858,-
chr12,101396572,0.3896608767576509,672,619,1291,-
chr12,101396574,0.3896608767576509,672,619,1291,-
chr12,101401142,1.188291577913333,1181,931,2112,-
chr12,101405974,1.1090461262875055,761,637,1398,-
chr12,101405976,3.7048208049041755,1581,1346,2927,-
chr12,101405979,11.70440840218425,1586,1219,2805,-
chr12,101405980,11.1194087570569,1842,1427,3269,-
chr12,101407651,5.182984028370519,2089,1204,3293,-
chr12,101407652,5.638151001047686,2369,1394,3763,-
chr12,101407716,2.257247899159664,740,475,1215,-
chr12,101407718,1.6492317512139056,2599,2158,4757,-
chr12,101407719,1.3936463253283948,2100,1833,3933,-
chr12,101407736,0.3424122174122174,1004,890,1894,-
chr12,101407737,0.3424122174122174,1004,890,1894,-
chr12,101407743,1.7815334467120183,810,503,1313,-
chr12,101407745,1.7815334467120183,810,503,1313,-
chr12,102074316,0.5722670579603815,839,657,1496,-
chr12,102075069,1.1941814205261216,1094,700,1794,-
chr12,102077486,0.5910770105143507,639,390,1029,-
chr12,102085813,2.2529845741113346,645,496,1141,-
chr12,102112198,2.154104555952131,683,432,1115,-
chr12,102118500,1.786764705882353,755,475,1230,-
chr12,103951598,2.1420259676792424,624,440,1064,-
chr12,103989428,3.513716775509222,664,471,1135,-
chr12,104120457,1.6349264991833243,610,430,1040,-
chr12,105039759,2.3754606672669323,1224,1035,2259,-
chr12,105039768,2.457649092480553,1033,889,1922,-
chr12,105039770,2.457649092480553,1033,889,1922,-
chr12,106238877,2.178978899452929,772,568,1340,-
chr12,106240081,2.3566286998215973,2022,1663,3685,-
chr12,106240083,2.3525593471810087,1474,1347,2821,-
chr12,106240087,2.713767438725691,1637,1066,2703,-
chr12,106240089,2.8442115187779895,1284,770,2054,-
chr12,106240090,1.895650214108632,646,492,1138,-
chr12,106240322,1.5771544929975838,600,493,1093,-
chr12,106992884,0.5994419320696623,622,546,1168,-
chr12,106992983,2.179107057547643,537,502,1039,-
chr12,106997977,3.2207843137254906,572,509,1081,-
chr12,108522984,7.414026179381351,747,535,1282,-
chr12,108524412,1.5105145881687294,1531,1166,2697,-
chr12,108524414,1.7623998267273122,1235,971,2206,-
chr12,108524426,1.8840557590557594,1276,935,2211,-
chr12,108524427,1.8840557590557594,1276,935,2211,-
chr12,108549107,2.1332907727598704,1554,959,2513,-
chr12,108549108,2.3004917417591737,1338,903,2241,-
chr12,108549109,2.010465485906554,1645,1074,2719,-
chr12,108549130,2.818342151675485,798,431,1229,-
chr12,108549131,2.818342151675485,798,431,1229,-
chr12,108549132,2.818342151675485,798,431,1229,-
chr12,108646274,0.6470923373679408,675,557,1232,-
chr12,108646664,0.46565973211741235,816,637,1453,-
chr12,108646666,0.46565973211741235,816,637,1453,-
chr12,108646731,1.643255549231645,801,501,1302,-
chr12,108646741,0.37422578828828823,817,591,1408,-
chr12,108646744,0.6881628787878789,675,527,1202,-
chr12,108646747,0.8737514327820534,695,590,1285,-
chr12,108646748,0.6150121065375302,1015,867,1882,-
chr12,108646750,0.32955752212389383,664,564,1228,-
chr12,108647308,10.674019607843137,669,407,1076,-
chr12,108647309,8.69955299573455,1063,716,1779,-
chr12,108647310,10.674019607843137,669,407,1076,-
chr12,108648644,2.4551405949833804,849,506,1355,-
chr12,108658865,1.023335474202526,716,518,1234,-
chr12,108658867,1.412850516511112,967,707,1674,-
chr12,109090039,2.7837890542395214,776,710,1486,-
chr12,109090041,2.3778580024067395,623,553,1176,-
chr12,109561090,2.4412132843119556,884,522,1406,-
chr12,109561091,1.5675074088081908,1137,704,1841,-
chr12,109561093,2.175247524752475,675,504,1179,-
chr12,109561094,2.175247524752475,675,504,1179,-
chr12,109565154,2.242604292719526,873,625,1498,-
chr12,109565165,0.26475811182174486,819,616,1435,-
chr12,109568840,2.4603725072215203,604,425,1029,-
chr12,109571677,1.1763409564576655,652,463,1115,-
chr12,110387762,1.2670807453416149,594,489,1083,-
chr12,110387763,1.2670807453416149,594,489,1083,-
chr12,110434976,27.590437240846274,10801,8885,19686,-
chr12,110434977,35.85150765911315,5422,4810,10232,-
chr12,110435000,5.777038269550749,895,600,1495,-
chr12,110435021,1.9379986323227716,1307,641,1948,-
chr12,110435105,1.4564113380387627,21409,15681,37090,-
chr12,110435111,1.1114925558465736,64999,47941,112940,-
chr12,110435112,1.2421406066890446,50738,35056,85794,-
chr12,110435113,1.115837301873144,61369,46416,107785,-
chr12,110435114,1.2411974174536855,30816,21773,52589,-
chr12,110435115,1.0770861330243113,29337,20003,49340,-
chr12,110435127,1.3976000532779669,10677,6777,17454,-
chr12,110435133,1.4695447163795867,9297,5647,14944,-
chr12,110435140,1.618748385430121,3885,2211,6096,-
chr12,110435158,1.352493463426598,10104,6693,16797,-
chr12,110435159,1.3924449258510012,6672,3747,10419,-
chr12,110435169,1.5062490728378581,2800,2246,5046,-
chr12,110435176,1.8504775271283331,2415,1783,4198,-
chr12,110435178,1.4005619257346795,1739,1012,2751,-
chr12,110436123,2.140274765003615,739,460,1199,-
chr12,110436128,1.1809731198959514,1757,1216,2973,-
chr12,110436145,0.5060526315789474,640,474,1114,-
chr12,110436657,1.6148936170212764,1264,939,2203,-
chr12,110436673,1.9312086092715235,1137,754,1891,-
chr12,110437151,1.7747126436781608,771,434,1205,-
chr12,110440373,0.5595886267392619,1479,1101,2580,-
chr12,110440383,0.7577105575326216,1021,842,1863,-
chr12,110440384,2.095671981776765,689,438,1127,-
chr12,110445523,1.6853591559473915,1013,813,1826,-
chr12,110445524,0.6816675719717544,1320,1051,2371,-
chr12,110445549,1.7150537634408602,695,495,1190,-
chr12,110450279,0.649597943383254,700,530,1230,-
chr12,110450298,1.5193023022016685,774,405,1179,-
chr12,110450308,2.5490196078431366,909,475,1384,-
chr12,110450310,2.5490196078431366,909,475,1384,-
chr12,110450316,1.3205591978730122,1037,726,1763,-
chr12,110450317,0.9567522141056304,739,498,1237,-
chr12,110450318,1.4358577505855634,679,413,1092,-
chr12,110452803,3.410980439733956,1048,669,1717,-
chr12,110457624,2.54690855765911,555,452,1007,-
chr12,110492098,2.010593220338983,583,471,1054,-
chr12,110496119,0.44687696170747016,1138,884,2022,-
chr12,110496145,1.8071428571428567,758,559,1317,-
chr12,110496192,1.2664758459040584,862,600,1462,-
chr12,110502099,0.5037701725097384,738,598,1336,-
chr12,110502100,0.5037701725097384,738,598,1336,-
chr12,110502107,1.5273802294404484,718,613,1331,-
chr12,110535113,6.076723889492565,623,714,1337,-
chr12,110535114,7.845698495989648,572,684,1256,-
chr12,110536486,1.9816358741831233,1739,1182,2921,-
chr12,110536491,1.6571549355316002,783,497,1280,-
chr12,110536597,0.7829824146618902,1031,628,1659,-
chr12,110536598,0.8058435539075871,1137,616,1753,-
chr12,110720356,1.7960812772133523,692,370,1062,-
chr12,110720495,1.0188847750423093,1186,712,1898,-
chr12,110720689,1.7850151640474223,892,557,1449,-
chr12,110721082,2.4124211547792336,903,686,1589,-
chr12,110721083,2.4124211547792336,903,686,1589,-
chr12,110722260,2.3739870308131317,932,790,1722,-
chr12,110722261,2.5790633608815425,603,483,1086,-
chr12,110722489,1.0678816126884398,1355,1001,2356,-
chr12,110722564,1.917296575263126,1202,867,2069,-
chr12,110722606,0.6146356589147286,900,644,1544,-
chr12,110722612,1.762516705690726,825,550,1375,-
chr12,110730593,0.4310639279944611,848,618,1466,-
chr12,110730743,1.7792463442069741,702,507,1209,-
chr12,110731825,0.44380927634143164,731,536,1267,-
chr12,110742673,0.4202439441252421,628,613,1241,-
chr12,110742685,0.5388619540895563,513,521,1034,-
chr12,110742695,0.4362075696067921,685,857,1542,-
chr12,110742696,0.4362075696067921,685,857,1542,-
chr12,110742712,11.79709590522223,925,707,1632,-
chr12,110742713,12.355972427931409,834,576,1410,-
chr12,111644430,4.376187404434251,552,472,1024,-
chr12,111658753,4.41489388292078,995,669,1664,-
chr12,111658755,4.869274809160307,728,523,1251,-
chr12,112072049,2.0621929652191002,2264,2180,4444,-
chr12,112072051,2.0621929652191002,2264,2180,4444,-
chr12,112072057,2.2128216062544426,1913,1574,3487,-
chr12,112072058,2.283836899988089,2805,2263,5068,-
chr12,112072060,2.302452036524059,1831,1443,3274,-
chr12,112074691,1.9268319791311768,1607,1133,2740,-
chr12,112074694,1.6392250647511943,1529,1030,2559,-
chr12,112074697,1.8856289051888075,630,408,1038,-
chr12,112074706,2.264018691588785,1614,962,2576,-
chr12,112074707,2.264018691588785,1614,962,2576,-
chr12,112074708,2.54307610540573,2118,1240,3358,-
chr12,112074710,3.079761258817147,1031,581,1612,-
chr12,112074714,3.0279720279720284,865,428,1293,-
chr12,112074716,3.0279720279720284,865,428,1293,-
chr12,112074762,2.2130438066643054,755,396,1151,-
chr12,112406002,1.3035234773950364,39314,29711,69025,-
chr12,112406004,1.1824299709140078,67466,49529,116995,-
chr12,112406005,1.2521670003233314,14018,10381,24399,-
chr12,112406006,1.0932321749351968,31598,23840,55438,-
chr12,112406008,1.0945471857093096,25682,19091,44773,-
chr12,112406011,1.2102312330603635,13595,9992,23587,-
chr12,112406012,1.2461817002386588,14709,9304,24013,-
chr12,112406014,1.2461817002386588,14709,9304,24013,-
chr12,112406022,1.041649298307405,17041,10627,27668,-
chr12,112406023,1.145183819240856,39107,27123,66230,-
chr12,112406024,1.1487206402929717,44887,31587,76474,-
chr12,112406025,1.2896151674062122,10873,7399,18272,-
chr12,112406027,1.40806933918896,8787,5234,14021,-
chr12,112406029,1.4643674403399805,12647,7447,20094,-
chr12,112406030,1.6411042944785277,4493,3422,7915,-
chr12,112406031,1.422795084157093,8142,4749,12891,-
chr12,112406304,0.6050917297861064,7077,5316,12393,-
chr12,112406306,0.802006191503561,12873,9124,21997,-
chr12,112406307,1.3255811340377688,9525,6892,16417,-
chr12,112406308,0.7379289184943905,9080,7002,16082,-
chr12,112406309,1.1194368475659546,15194,11308,26502,-
chr12,112406310,1.3801711840228248,3998,2102,6100,-
chr12,112406311,1.3801711840228248,3998,2102,6100,-
chr12,112406314,1.4288185051217364,4253,3339,7592,-
chr12,112406315,1.4288185051217364,4253,3339,7592,-
chr12,112406322,1.3504358931645288,1139,666,1805,-
chr12,112406325,1.3003663003663004,1419,1091,2510,-
chr12,112406328,0.5683606141352621,778,443,1221,-
chr12,112406329,1.4389386867279539,2229,1617,3846,-
chr12,112406331,1.8247970892807168,651,396,1047,-
chr12,112406332,1.249943296783895,2961,2072,5033,-
chr12,112406333,1.1571665744327615,1393,694,2087,-
chr12,112406334,1.0989498961951703,3479,2140,5619,-
chr12,112406882,1.1582496959571515,5189,3044,8233,-
chr12,112406883,1.1585711743772242,6935,3999,10934,-
chr12,112406884,1.339611278401314,2038,1404,3442,-
chr12,112406885,1.2620329411674711,5537,3072,8609,-
chr12,112406886,1.3246954239074094,7267,4453,11720,-
chr12,112406888,1.4549793854913127,2107,1335,3442,-
chr12,112406889,1.6521851142963508,3051,1750,4801,-
chr12,112408328,1.236548548428087,35510,25543,61053,-
chr12,112408329,1.487613160705625,21432,16350,37782,-
chr12,112408330,1.310565189838432,28346,22208,50554,-
chr12,112408331,1.2892591384798378,31838,22713,54551,-
chr12,112408334,1.519524203435595,12266,7972,20238,-
chr12,112408463,1.2373590273805857,5373,2864,8237,-
chr12,112408475,1.2045128591469758,7259,5226,12485,-
chr12,112408529,1.6126313140844182,1971,1513,3484,-
chr12,112408535,1.6306692042876465,2996,2008,5004,-
chr12,112408550,1.4913022843110957,1313,988,2301,-
chr12,112408553,1.593826699245837,3360,2460,5820,-
chr12,112408554,1.6575773857496792,2362,1717,4079,-
chr12,112408557,2.3416666666666663,842,431,1273,-
chr12,112408567,2.486740454019525,1548,1028,2576,-
chr12,112408571,0.9291445451279388,1011,610,1621,-
chr12,112408572,1.308518105619555,1473,896,2369,-
chr12,112408574,1.1151346847550083,3217,2027,5244,-
chr12,112408575,0.8829674011588948,1599,1102,2701,-
chr12,112408580,0.5801255801255801,624,494,1118,-
chr12,112408655,0.7752604665861911,2319,1537,3856,-
chr12,112408656,0.7752604665861911,2319,1537,3856,-
chr12,112409591,1.7866311216429702,1315,843,2158,-
chr12,112409602,1.6375439156818907,1798,1514,3312,-
chr12,112409603,0.7564115646258504,1125,671,1796,-
chr12,112409604,1.5807192701558617,3277,2578,5855,-
chr12,112409608,0.5346767852937686,2072,1490,3562,-
chr12,112409613,0.9174519569738226,3481,2868,6349,-
chr12,112409614,0.9174519569738226,3481,2868,6349,-
chr12,112409615,0.8985714285714287,813,769,1582,-
chr12,113158934,2.057372268586355,1533,993,2526,-
chr12,113158936,2.7403494514425026,1123,641,1764,-
chr12,113161984,2.40484429065744,694,577,1271,-
chr12,113161985,2.40484429065744,694,577,1271,-
chr12,113161986,1.7173635952469062,907,736,1643,-
chr12,113162964,3.429656435624008,882,616,1498,-
chr12,113162974,3.404632074388704,836,559,1395,-
chr12,113172483,0.4964539007092199,699,449,1148,-
chr12,113172484,0.4964539007092199,699,449,1148,-
chr12,113172499,0.42342596773558333,679,456,1135,-
chr12,113176893,1.878934938783495,924,634,1558,-
chr12,113176895,2.3855271366188395,716,457,1173,-
chr12,119685957,2.528391683820182,902,623,1525,-
chr12,119685980,1.4308641975308642,731,404,1135,-
chr12,120096426,36.598655847517676,1291,605,1896,-
chr12,120096427,36.598655847517676,1291,605,1896,-
chr12,120096435,33.43065892280765,914,316,1230,-
chr12,120127680,1.7218202651825176,1118,744,1862,-
chr12,120127683,2.3277656741709034,1201,764,1965,-
chr12,120127697,2.546128290314337,971,601,1572,-
chr12,120196766,0.7457835110488553,29261,21884,51145,-
chr12,120196773,0.9065722121434792,38833,29167,68000,-
chr12,120196774,1.231670636869504,54989,40564,95553,-
chr12,120196776,1.7670341197482062,18786,15233,34019,-
chr12,120196777,1.4363022956588636,38672,29395,68067,-
chr12,120196779,1.4640042883218067,27317,19508,46825,-
chr12,120196799,1.1926834543398532,27422,20088,47510,-
chr12,120196800,1.1791461599946922,14952,10824,25776,-
chr12,120196820,0.8159069309516178,9009,5865,14874,-
chr12,120196821,1.5891750892263108,7618,5078,12696,-
chr12,120196824,1.2644259735328331,19774,12482,32256,-
chr12,120196825,0.9996669145442152,8555,5867,14422,-
chr12,120196831,1.6127130453424805,4129,1963,6092,-
chr12,120196836,1.6097482512250774,4177,1994,6171,-
chr12,120197346,1.1923679453705562,10859,5744,16603,-
chr12,120197373,1.1415515701229988,8530,4850,13380,-
chr12,120197380,1.2989531691623832,7528,4192,11720,-
chr12,120198608,1.1758021058641657,54024,41201,95225,-
chr12,120198662,1.2004684755026351,9224,6579,15803,-
chr12,120198668,1.3941156221213222,21834,13332,35166,-
chr12,120198669,1.3884278283146496,46394,29205,75599,-
chr12,120198671,1.3250559928468102,41957,27892,69849,-
chr12,120198677,1.455056795573474,7942,4592,12534,-
chr12,120198680,1.4450864892333475,17679,11801,29480,-
chr12,120198692,1.2631984901812843,20754,12971,33725,-
chr12,120198694,1.3857262877339358,12634,6275,18909,-
chr12,120198696,1.440491522286126,11448,6603,18051,-
chr12,120198722,1.6144877271637839,1846,998,2844,-
chr12,120198724,1.0620719990739669,3501,1629,5130,-
chr12,120198725,1.3271064975657338,10128,6116,16244,-
chr12,120198727,1.5214949127745883,3331,2289,5620,-
chr12,120198731,1.5703170447934844,1233,572,1805,-
chr12,120198735,0.3824862216778935,1040,459,1499,-
chr12,120198864,1.4052636886155083,1071,632,1703,-
chr12,120198873,1.83371298405467,594,438,1032,-
chr12,120198874,1.568063362289218,1157,514,1671,-
chr12,120198875,1.5565098343373207,1553,762,2315,-
chr12,120198879,0.9110768312101912,1076,627,1703,-
chr12,120198880,0.6942346481797818,1864,959,2823,-
chr12,120198882,0.3645183645183645,788,332,1120,-
chr12,120198883,0.5763325858202518,1027,681,1708,-
chr12,120198884,0.5763325858202518,1027,681,1708,-
chr12,120198885,0.5763325858202518,1027,681,1708,-
chr12,120199193,1.7121577822219156,12413,8529,20942,-
chr12,120199204,1.3120218671497765,31366,20022,51388,-
chr12,120199463,0.8503101528513173,21857,16034,37891,-
chr12,120199472,1.000758500272234,39483,25479,64962,-
chr12,120199473,1.1144531135397504,53800,36408,90208,-
chr12,120199479,0.8338814375039321,24568,18450,43018,-
chr12,120199480,0.8338814375039321,24568,18450,43018,-
chr12,120199481,1.244823011127359,28474,17709,46183,-
chr12,120199482,1.3494574857733983,39541,25416,64957,-
chr12,120200741,1.2842785057392092,12018,7166,19184,-
chr12,120200745,1.197041839667566,26420,18181,44601,-
chr12,120200746,1.2831265162003858,38170,23283,61453,-
chr12,120200748,1.3663773606320575,29481,16836,46317,-
chr12,120200749,1.4191559846421629,19214,10866,30080,-
chr12,120200754,1.0721088410786255,34245,24670,58915,-
chr12,120200755,1.2850788874807535,35051,24281,59332,-
chr12,120200772,1.4296381171037782,14513,8966,23479,-
chr12,120200798,0.8051111654651207,3770,2212,5982,-
chr12,120200832,0.6248630912575279,1980,1574,3554,-
chr12,120200851,0.5209154481881755,722,604,1326,-
chr12,120200852,1.5884686590848982,1091,795,1886,-
chr12,120200860,1.7878145047246778,1974,1229,3203,-
chr12,120200864,1.8619164619164617,1262,604,1866,-
chr12,120200871,1.8660130718954249,570,449,1019,-
chr12,120201102,1.3184797818517087,4416,3541,7957,-
chr12,120201106,0.8113829077917918,3180,1858,5038,-
chr12,120201107,1.8076827551949661,793,513,1306,-
chr12,120201110,0.8875152571222528,2508,1704,4212,-
chr12,120211420,12.671102197544133,674,506,1180,-
chr12,120444043,1.5376029002889382,683,479,1162,-
chr12,120444935,2.054272245574566,583,433,1016,-
chr12,120461888,2.8674242424242427,756,527,1283,-
chr12,120461953,0.7004160887656034,1009,720,1729,-
chr12,120461990,0.6384450165462785,1323,1024,2347,-
chr12,120464011,1.927957508450024,643,544,1187,-
chr12,120464012,1.8422939068100361,770,593,1363,-
chr12,120464019,0.5193755739210285,706,494,1200,-
chr12,120464075,1.7672909908967251,562,502,1064,-
chr12,120464087,1.7752052766186566,627,390,1017,-
chr12,120465674,4.097650970756857,1667,1302,2969,-
chr12,120465751,1.3258280811822245,1090,782,1872,-
chr12,120465778,2.8326144073085118,942,538,1480,-
chr12,120469472,1.2302631578947367,901,607,1508,-
chr12,120469473,0.9892128121391791,1251,961,2212,-
chr12,120503431,5.707904425352094,695,457,1152,-
chr12,120503825,3.5769458568343055,601,531,1132,-
chr12,120516693,1.0815509819218854,985,897,1882,-
chr12,121308510,3.5186746987951807,707,414,1121,-
chr12,121308512,3.5186746987951807,707,414,1121,-
chr12,121318293,1.8747661005792653,1178,744,1922,-
chr12,121318305,0.49562606813800847,1044,746,1790,-
chr12,121319789,1.628291723666211,928,687,1615,-
chr12,121320450,1.638632181031254,978,859,1837,-
chr12,121320452,1.1725274725274728,581,519,1100,-
chr12,121320454,2.4125874125874125,919,483,1402,-
chr12,121320455,2.5888407270026637,1099,610,1709,-
chr12,121327205,2.0764274306381383,821,519,1340,-
chr12,121331362,0.6238402915838304,885,502,1387,-
chr12,121331364,0.45397834274952936,1462,943,2405,-
chr12,121331365,0.45397834274952936,1462,943,2405,-
chr12,121331390,2.136363636363636,657,391,1048,-
chr12,121331396,2.7988259072451713,719,549,1268,-
chr12,121331397,0.9455499344200865,663,592,1255,-
chr12,121331398,0.9455499344200865,663,592,1255,-
chr12,121335567,1.1504830710532803,1071,743,1814,-
chr12,121335706,1.915451895043732,802,538,1340,-
chr12,121337304,0.5147229306747043,739,453,1192,-
chr12,121337378,0.5689069925322471,837,490,1327,-
chr12,121342018,0.6285477596888056,830,630,1460,-
chr12,121345859,2.2184750733137832,800,557,1357,-
chr12,121345975,1.9996319876347843,1131,936,2067,-
chr12,121345976,1.9996319876347843,1131,936,2067,-
chr12,121346999,1.7787722317842798,673,414,1087,-
chr12,121347850,2.1836850589358905,834,706,1540,-
chr12,121347852,3.4465741489218384,895,726,1621,-
chr12,121347872,1.2095316169014334,737,557,1294,-
chr12,121352240,3.1408812408731817,1211,644,1855,-
chr12,121352299,2.6442048517520216,653,370,1023,-
chr12,121444178,3.363240418118466,701,573,1274,-
chr12,121444180,3.363240418118466,701,573,1274,-
chr12,121778855,1.748033692467086,853,595,1448,-
chr12,121778861,1.6312050910925873,762,595,1357,-
chr12,121780885,2.5744476868437576,949,645,1594,-
chr12,121780886,1.6899502428732984,1056,757,1813,-
chr12,121793583,5.09183076170472,1193,524,1717,-
chr12,121793584,5.880204525418599,1376,606,1982,-
chr12,122208515,1.5371916752312436,2658,1945,4603,-
chr12,122208516,1.5371916752312436,2658,1945,4603,-
chr12,122208529,0.4529919873560122,2538,1743,4281,-
chr12,122208543,2.0398060656500663,1840,1114,2954,-
chr12,122208546,1.9842326393806353,1775,920,2695,-
chr12,122208547,0.4500817772931716,776,666,1442,-
chr12,122208548,1.9394137260857574,3344,1797,5141,-
chr12,122208549,0.4500817772931716,776,666,1442,-
chr12,122208550,1.8815609818054808,1645,817,2462,-
chr12,122208558,1.7925712302064138,1369,656,2025,-
chr12,122208560,1.2668321231532875,2604,1216,3820,-
chr12,122208561,1.1287514318442151,1894,872,2766,-
chr12,122208562,1.060376599157969,3251,1856,5107,-
chr12,122208563,1.3272140058265773,2123,1543,3666,-
chr12,122208572,1.4102120600865276,846,453,1299,-
chr12,122224608,0.7793970444703622,599,404,1003,-
chr12,122271879,1.9003105590062106,632,459,1091,-
chr12,122271888,2.832174462705436,617,451,1068,-
chr12,122271889,2.832174462705436,617,451,1068,-
chr12,122272305,2.331129618528808,658,505,1163,-
chr12,122272581,3.074862637362637,725,545,1270,-
chr12,122272582,3.074862637362637,725,545,1270,-
chr12,122278822,3.175007286888379,608,416,1024,-
chr12,122279040,3.480300187617261,741,409,1150,-
chr12,122279042,3.480300187617261,741,409,1150,-
chr12,122279063,1.9251693663196334,636,435,1071,-
chr12,122334661,1.422768370088526,752,486,1238,-
chr12,122334702,1.9496352757970659,864,580,1444,-
chr12,122334703,1.9496352757970659,864,580,1444,-
chr12,122340844,1.8158456706235466,933,583,1516,-
chr12,122341063,2.4468362687540766,1704,1532,3236,-
chr12,122341071,1.9085015226529718,2829,2082,4911,-
chr12,122341091,1.0679252635298173,2005,1421,3426,-
chr12,122341134,1.0400722156045266,886,735,1621,-
chr12,122341135,0.7688180791951056,2345,1642,3987,-
chr12,122341136,0.6792089142374313,886,525,1411,-
chr12,122364030,6.2298720584288425,578,522,1100,-
chr12,122377478,0.4509110460526968,591,428,1019,-
chr12,122377535,5.667886825684191,623,454,1077,-
chr12,122380530,3.3930299570165223,771,468,1239,-
chr12,122505667,2.748625905929277,729,517,1246,-
chr12,122505679,3.725555398308492,662,417,1079,-
chr12,122515141,3.0284615384615385,634,499,1133,-
chr12,122515144,1.8444549333635891,1267,1104,2371,-
chr12,122515145,1.9290457452041316,580,427,1007,-
chr12,122515150,2.0916981661064282,1182,981,2163,-
chr12,122515196,1.5707071122675256,796,628,1424,-
chr12,122515206,3.2435926967633506,671,450,1121,-
chr12,122517326,1.8422685124722478,924,805,1729,-
chr12,122517339,0.5854469854469855,703,554,1257,-
chr12,122517350,1.4919120025881594,801,561,1362,-
chr12,122517356,1.9669526383264624,1195,855,2050,-
chr12,122517362,0.5373913043478261,617,390,1007,-
chr12,122517369,1.0,659,527,1186,-
chr12,122517370,1.0,659,527,1186,-
chr12,122522266,2.448650141286106,858,627,1485,-
chr12,122868534,1.8018753781004235,850,550,1400,-
chr12,123261231,2.2008693361433087,1022,948,1970,-
chr12,123261533,2.77810650887574,625,506,1131,-
chr12,123261627,1.3693747510951808,1494,1214,2708,-
chr12,123261689,0.6579005201084169,1282,934,2216,-
chr12,123261703,1.8569269414285787,1630,1172,2802,-
chr12,123261762,1.6079391891891892,834,591,1425,-
chr12,123261780,1.78813723589843,737,468,1205,-
chr12,123261797,2.740213815398255,820,640,1460,-
chr12,123265269,3.663648558014756,949,425,1374,-
chr12,123265293,1.853582554517134,734,320,1054,-
chr12,123265295,1.824571722667451,751,468,1219,-
chr12,123265296,0.47386184670504744,1133,592,1725,-
chr12,123265307,0.493360494984935,939,507,1446,-
chr12,123317346,1.7895893580104103,572,454,1026,-
chr12,123319920,2.8893137879753565,849,522,1371,-
chr12,123319921,2.784365393061045,1267,758,2025,-
chr12,123319923,3.3107179226069254,838,490,1328,-
chr12,123621287,1.322304203880215,609,521,1130,-
chr12,123621389,2.191739430029094,751,429,1180,-
chr12,123621614,2.4716568451255494,616,450,1066,-
chr12,123624837,0.5073865092185412,934,605,1539,-
chr12,123624850,2.74981884057971,705,551,1256,-
chr12,123624852,2.74981884057971,705,551,1256,-
chr12,123630208,1.8473055428317184,771,556,1327,-
chr12,124332411,1.8860323350119266,592,538,1130,-
chr12,124332413,1.8860323350119266,592,538,1130,-
chr12,124777723,2.8942016190279243,1213,759,1972,-
chr12,124777724,3.450245614035088,792,474,1266,-
chr12,124778191,1.5181404384367674,957,612,1569,-
chr12,124778192,1.0846553610503282,720,456,1176,-
chr12,124782738,1.6831032215647599,559,506,1065,-
chr12,124795216,1.617495109458445,908,873,1781,-
chr12,124800232,1.237216728497943,853,550,1403,-
chr12,124810261,1.9301683372370535,958,590,1548,-
chr12,124814250,1.7018181818181817,527,483,1010,-
chr12,124815025,2.1908011978468154,702,579,1281,-
chr12,124815109,3.5318941155133197,748,410,1158,-
chr12,124817654,1.9013560072910674,864,753,1617,-
chr12,124863611,1.5073093876122652,599,559,1158,-
chr12,124863664,2.4370529618051444,758,588,1346,-
chr12,124911769,1.2662608751718358,6336,4295,10631,-
chr12,124911850,0.7615912059207662,2798,2296,5094,-
chr12,124911861,1.430541433401755,9653,7004,16657,-
chr12,124911862,1.5380623100139084,4073,3145,7218,-
chr12,124911870,1.8417582417582417,1675,1169,2844,-
chr12,124911873,1.0786478342163321,5422,4125,9547,-
chr12,124911874,0.7268384727841429,3886,3072,6958,-
chr12,124911875,0.7119219767996185,2756,2169,4925,-
chr12,124911876,0.7119219767996185,2756,2169,4925,-
chr12,124911880,1.7812527823439066,4298,2703,7001,-
chr12,124911882,1.9072352833971207,3275,1828,5103,-
chr12,124911883,1.4786598378147675,1013,638,1651,-
chr12,124911886,1.5458885941644562,1456,753,2209,-
chr12,124911896,1.853915925344497,732,440,1172,-
chr12,124911897,1.875688073394496,1127,544,1671,-
chr12,124911910,1.7954861578498675,975,436,1411,-
chr12,124911912,2.0860906862745097,618,383,1001,-
chr12,124911913,0.5875877253337004,609,506,1115,-
chr12,124911915,1.6125195618153365,804,354,1158,-
chr12,124911931,2.1107603237001773,1811,1043,2854,-
chr12,124911932,1.3086558111938822,1017,393,1410,-
chr12,124911934,1.4095238095238094,919,344,1263,-
chr12,124911936,1.6006563442412218,1336,579,1915,-
chr12,124911937,2.557598889659958,755,261,1016,-
chr12,124912600,1.2232756926704658,4710,2907,7617,-
chr12,124912614,1.305876349936363,9859,6985,16844,-
chr12,124912615,1.310337907950822,5596,4420,10016,-
chr12,124912620,1.26474775489245,6566,4266,10832,-
chr12,124912663,1.2773136405498369,7494,4936,12430,-
chr12,124912669,1.5546998319327732,8077,6124,14201,-
chr12,124912670,1.3051907151105224,15363,10190,25553,-
chr12,124912671,1.3051907151105224,15363,10190,25553,-
chr12,124912681,1.48234100135318,2210,1477,3687,-
chr12,124912761,1.507992477668077,2565,2126,4691,-
chr12,124912773,1.3080430125782447,5126,2774,7900,-
chr12,124912774,1.3009800496460422,3665,1824,5489,-
chr12,124912788,1.1735348212137031,2872,1892,4764,-
chr12,124912789,1.0466901684292989,1723,1331,3054,-
chr12,124912791,3.171336206896552,980,463,1443,-
chr12,124912798,1.6756042296072509,764,330,1094,-
chr12,124912801,2.734848484848485,569,439,1008,-
chr12,124912812,2.394332662316109,912,618,1530,-
chr12,124912828,1.6287445848409359,678,445,1123,-
chr12,124913001,1.2946632927306119,8550,6642,15192,-
chr12,124913076,1.4479671840883088,4762,2846,7608,-
chr12,124913136,1.4269980005173863,6360,4216,10576,-
chr12,124913137,1.506084113721627,9259,6078,15337,-
chr12,124913139,1.5001623682638952,6031,3920,9951,-
chr12,124913142,1.4093096218531758,6816,3926,10742,-
chr12,124913143,1.4078612360348293,9955,6051,16006,-
chr12,124913223,0.8006780935017374,5167,3803,8970,-
chr12,124913229,1.733349116161616,4774,3563,8337,-
chr12,124913230,1.240767802835815,5664,3616,9280,-
chr12,124913311,1.3491393023334592,18249,11606,29855,-
chr12,124913313,1.424336085627656,33507,22668,56175,-
chr12,124913314,1.5343114125773507,16595,10203,26798,-
chr12,124913343,2.401184811110032,1977,1470,3447,-
chr12,124913344,1.881472788616693,1748,801,2549,-
chr12,124913347,1.3067574137092854,1791,1209,3000,-
chr12,124913358,1.5120196361586147,3748,1895,5643,-
chr12,124913359,1.5611215707369555,2288,1000,3288,-
chr12,124913458,1.2748472085879856,4423,2745,7168,-
chr12,124913512,1.3782889229386421,5500,3462,8962,-
chr12,124913532,1.8168484177262665,5418,3223,8641,-
chr12,124913586,1.3375540633322074,5784,4252,10036,-
chr12,124913593,1.2220687465269509,2748,2222,4970,-
chr12,124913630,1.822774960870743,5989,4350,10339,-
chr12,124913631,1.822774960870743,5989,4350,10339,-
chr12,124913724,1.8653072629050078,10437,8158,18595,-
chr12,124913740,1.3611948946128716,19748,13343,33091,-
chr12,124913744,1.5594566528365803,18553,12113,30666,-
chr12,124913760,1.5081759661056864,8359,5185,13544,-
chr12,124913773,1.3354684169570659,7202,5373,12575,-
chr12,124914598,1.5582370685801863,49075,29693,78768,-
chr12,124914600,1.6255895420072202,38101,23901,62002,-
chr12,124914649,0.9459823138159931,15501,9007,24508,-
chr12,124914650,0.9113898357571101,18766,10661,29427,-
chr12,124914653,1.0106811587359472,908,631,1539,-
chr12,132728116,2.543193774183731,913,696,1609,-
chr12,132728117,2.4980991583859886,1190,886,2076,-
chr12,132728118,2.4383819379115708,1457,1062,2519,-
chr12,132728119,2.1173218673218672,1148,813,1961,-
chr12,132728120,2.257616139634325,982,694,1676,-
chr12,132734515,1.7897744360902257,540,474,1014,-
chr12,132741444,1.8247674872997264,2406,1705,4111,-
chr12,132741445,1.8247674872997264,2406,1705,4111,-
chr13,19305007,3.292922568820116,684,559,1243,-
chr13,19305073,0.7968687874128093,2032,1573,3605,-
chr13,19305074,1.0080318413651743,768,517,1285,-
chr13,19305075,0.9606609939573314,759,611,1370,-
chr13,19751319,3.3839557017969057,607,418,1025,-
chr13,21628569,1.436063936063936,1999,1143,3142,-
chr13,21628571,1.4950238764671755,2779,1539,4318,-
chr13,21628572,1.6271216874214434,2425,1253,3678,-
chr13,21628574,1.9237951590892766,1460,713,2173,-
chr13,21628602,2.3036177474402733,766,585,1351,-
chr13,21628603,2.3036177474402733,766,585,1351,-
chr13,21628649,0.32134929620517605,777,473,1250,-
chr13,22696488,1.1019314964589366,1095,899,1994,-
chr13,23358417,2.74418016194332,722,623,1345,-
chr13,23358419,2.5197890128816964,1063,898,1961,-
chr13,23358420,2.756556233484463,1759,1205,2964,-
chr13,23358422,2.636482939632546,983,761,1744,-
chr13,23358424,3.2021481916589747,953,700,1653,-
chr13,23358426,3.145,628,449,1077,-
chr13,24123215,1.6274577440496725,673,445,1118,-
chr13,24123674,1.2236584471189653,669,495,1164,-
chr13,24469924,1.3972001797239093,630,558,1188,-
chr13,24988661,0.5292307692307692,679,441,1120,-
chr13,24988663,0.5292307692307692,679,441,1120,-
chr13,26214695,1.0966781843745825,2064,1434,3498,-
chr13,26214696,1.3086510525144857,1535,1041,2576,-
chr13,26214748,3.010843373493976,713,414,1127,-
chr13,27435811,0.9901948051948052,662,549,1211,-
chr13,27435812,0.9901948051948052,662,549,1211,-
chr13,27435818,4.607100738348795,740,527,1267,-
chr13,27435819,3.29728910072188,853,659,1512,-
chr13,29510043,1.0957098230723017,570,432,1002,-
chr13,29512417,0.30627884393100624,2198,934,3132,-
chr13,29512418,0.2269260106788711,968,413,1381,-
chr13,30461000,2.3066167290886392,595,444,1039,-
chr13,30461020,3.4533333333333336,839,449,1288,-
chr13,30461022,3.4533333333333336,839,449,1288,-
chr13,30461211,1.7256894049346883,1188,688,1876,-
chr13,30461240,3.0365552814532406,676,342,1018,-
chr13,30461243,1.6317449775859207,935,633,1568,-
chr13,30461386,0.6458793872406439,756,572,1328,-
chr13,30461390,0.3285648889906157,637,513,1150,-
chr13,30461395,0.39546932865774964,879,1040,1919,-
chr13,30461401,3.9526071175391664,1357,1783,3140,-
chr13,30461402,4.9304670566745346,2078,2517,4595,-
chr13,30461405,2.857813074688886,1227,732,1959,-
chr13,30463339,0.4781931464174454,613,427,1040,-
chr13,30463348,1.7648056695227547,1115,813,1928,-
chr13,30463351,2.5177224736048265,606,407,1013,-
chr13,30463553,1.4196066447514863,1027,699,1726,-
chr13,30463554,1.1843298263621589,601,432,1033,-
chr13,30465904,0.49907401056313877,855,477,1332,-
chr13,30465910,1.4388003294114644,1317,960,2277,-
chr13,30465912,1.4388003294114644,1317,960,2277,-
chr13,30465934,0.5242807699390457,858,511,1369,-
chr13,31137454,2.4122055674518204,750,466,1216,-
chr13,31137456,2.4122055674518204,750,466,1216,-
chr13,31137494,1.0003631082062454,550,485,1035,-
chr13,31137496,1.0003631082062454,550,485,1035,-
chr13,31150109,2.791018998272885,807,578,1385,-
chr13,31150110,0.6175561947374028,1022,893,1915,-
chr13,31150111,2.181506849315068,545,583,1128,-
chr13,31150115,1.1990625,1278,831,2109,-
chr13,31150116,2.3701372395053255,1777,1312,3089,-
chr13,32521443,1.8599624885753592,641,417,1058,-
chr13,32536018,2.2061162897807542,2031,1190,3221,-
chr13,32536019,2.3668465831122494,1175,642,1817,-
chr13,32536026,1.4987273833047519,1455,890,2345,-
chr13,32536027,1.5360918972332016,1322,735,2057,-
chr13,32536029,2.367531442838239,2028,1225,3253,-
chr13,32538787,1.1196331007258842,843,764,1607,-
chr13,36304054,2.26572527264704,660,434,1094,-
chr13,36335460,4.647741520835294,761,492,1253,-
chr13,36335771,1.994562693952966,934,827,1761,-
chr13,36335777,2.2823801270941653,580,576,1156,-
chr13,36335779,2.2823801270941653,580,576,1156,-
chr13,36335829,2.2977444549052173,853,751,1604,-
chr13,40933605,2.4622601993800783,667,518,1185,-
chr13,40933607,3.410690734800351,1501,1134,2635,-
chr13,40933609,3.4904862579281186,634,472,1106,-
chr13,40933612,1.084478160148052,759,530,1289,-
chr13,44433852,1.5541493958902906,2013,1563,3576,-
chr13,44434172,0.7008777712243693,4697,3514,8211,-
chr13,44434173,1.3615716838760925,1589,1258,2847,-
chr13,44434174,0.7008777712243693,4697,3514,8211,-
chr13,44434175,2.015905688622755,1196,1001,2197,-
chr13,44434350,1.4799578503688091,2089,1624,3713,-
chr13,44434551,1.4777023546365666,2178,1648,3826,-
chr13,44434558,1.3648152081563296,2357,1711,4068,-
chr13,44434583,1.1372245062497386,3846,2647,6493,-
chr13,44434608,1.1548807616945094,1947,1583,3530,-
chr13,44434618,1.7077213707960837,1210,782,1992,-
chr13,44434619,0.6952004517221908,1025,758,1783,-
chr13,44434628,1.43392542202066,784,587,1371,-
chr13,44434636,0.5387900355871885,756,561,1317,-
chr13,44434637,1.8542987233282742,669,486,1155,-
chr13,44434654,2.0161290322580645,1174,681,1855,-
chr13,44434655,2.0359227130416504,2134,1397,3531,-
chr13,44434875,1.7420625447600857,2223,1887,4110,-
chr13,44436059,1.427379555156166,5654,3724,9378,-
chr13,44436530,1.3839824584256002,2601,1705,4306,-
chr13,44436646,2.6782210595160234,1637,1389,3026,-
chr13,44436691,1.5060781783631396,3329,2315,5644,-
chr13,44436750,1.4215248989872489,1289,1120,2409,-
chr13,44436788,1.5769628796400446,673,634,1307,-
chr13,44436824,1.35168863261944,886,606,1492,-
chr13,44436853,0.6276681312268392,1540,1127,2667,-
chr13,45337136,1.4315532555448742,2511,1908,4419,-
chr13,45337280,1.2053833572258073,18310,12039,30349,-
chr13,45337300,1.255743818950887,27111,22283,49394,-
chr13,45337359,1.132301901761975,14220,10914,25134,-
chr13,45338776,0.6502547493235782,2191,1557,3748,-
chr13,45338777,1.0141796968880408,823,696,1519,-
chr13,45340089,1.2266126091075789,78418,56404,134822,-
chr13,45340091,1.254534566478709,51280,35736,87016,-
chr13,45340159,1.2703433412504472,21615,15118,36733,-
chr13,45340161,1.287298485943764,18662,14591,33253,-
chr13,45340162,0.8951597560131909,9000,6735,15735,-
chr13,45340169,1.250996466328008,5577,4267,9844,-
chr13,45340184,0.8217033666939749,2856,2349,5205,-
chr13,45340185,0.9509128249483383,1754,1526,3280,-
chr13,45341058,1.413768505123648,39847,33509,73356,-
chr13,45341061,1.6843559022957266,10491,10005,20496,-
chr13,45341064,1.4216498125831363,29286,26115,55401,-
chr13,45341065,1.4267639917348065,38368,33920,72288,-
chr13,45341066,1.3349415648087366,74687,58448,133135,-
chr13,45341067,1.3740086955434678,36948,32014,68962,-
chr13,45341068,1.2533234584923516,65547,48987,114534,-
chr13,45341105,1.0553649970052676,19920,12878,32798,-
chr13,45341109,1.5121584575795586,5920,4548,10468,-
chr13,45341122,1.1191517583370085,46165,31994,78159,-
chr13,45341123,1.0969793068230553,35997,27090,63087,-
chr13,45341182,0.8439529674829153,20533,14149,34682,-
chr13,45341183,0.769820429326471,11727,7062,18789,-
chr13,45341184,0.8378179262844588,4365,3129,7494,-
chr13,45390464,0.5223509223509224,760,554,1314,-
chr13,45390466,1.7518057259111002,1921,1417,3338,-
chr13,45390468,1.576276067813886,2310,1687,3997,-
chr13,45390469,1.355186634239188,800,578,1378,-
chr13,45390666,0.7872418162454622,2469,1597,4066,-
chr13,45390672,1.4091154261057173,1899,1235,3134,-
chr13,45390697,1.4251758373476264,1188,866,2054,-
chr13,45390730,1.696639247943596,1503,850,2353,-
chr13,45390731,0.5065591397849463,672,464,1136,-
chr13,45390732,1.696639247943596,1503,850,2353,-
chr13,45390733,0.3348604748021658,669,342,1011,-
chr13,45390753,0.4106536502546689,644,371,1015,-
chr13,45390754,0.4106536502546689,644,371,1015,-
chr13,45390767,1.640385084084816,640,372,1012,-
chr13,45391101,0.9684556835271518,769,636,1405,-
chr13,45391103,1.205523012552301,587,477,1064,-
chr13,45967996,2.1803986189579407,750,471,1221,-
chr13,45967998,2.1756673992146127,1097,676,1773,-
chr13,45967999,2.3148355113561725,942,595,1537,-
chr13,45968004,2.183393666272656,745,430,1175,-
chr13,45975758,2.845919145690313,860,620,1480,-
chr13,45975759,2.845919145690313,860,620,1480,-
chr13,45975760,2.845919145690313,860,620,1480,-
chr13,46010429,3.4105731225296445,766,505,1271,-
chr13,46010457,2.5670072928058882,721,478,1199,-
chr13,46010461,2.3819977828099708,635,370,1005,-
chr13,46771416,2.16769580760481,666,542,1208,-
chr13,46771490,1.6693418940609952,831,444,1275,-
chr13,46777514,4.579672523961661,694,625,1319,-
chr13,46779992,0.5282936659223354,775,601,1376,-
chr13,46779994,2.1767337807606264,555,446,1001,-
chr13,46781513,1.1609854073840549,1355,955,2310,-
chr13,46781523,0.5790743584119324,659,387,1046,-
chr13,46791399,1.7187358916478557,563,442,1005,-
chr13,46791415,1.6665886392009992,688,533,1221,-
chr13,46793418,2.5241313760692785,770,556,1326,-
chr13,46797146,0.43259830853754366,1564,1128,2692,-
chr13,48328266,2.1146904272332647,2135,1458,3593,-
chr13,48328267,2.1146904272332647,2135,1458,3593,-
chr13,48328268,1.8603979960807144,2783,1861,4644,-
chr13,48328270,1.7734459605804636,1334,854,2188,-
chr13,48328339,1.828134389613226,1353,965,2318,-
chr13,48328351,2.634784605067758,965,664,1629,-
chr13,48328352,2.731631304572832,1113,704,1817,-
chr13,48328353,2.7102916729635793,731,508,1239,-
chr13,48328356,2.1839809055657624,923,508,1431,-
chr13,48328357,2.4149045566888727,903,564,1467,-
chr13,49661019,3.3755719369598367,680,561,1241,-
chr13,49661021,3.315014478134787,1104,805,1909,-
chr13,49663159,0.3985636319878114,759,469,1228,-
chr13,49706152,2.2304274360097627,809,550,1359,-
chr13,49706154,3.0083886905642654,1476,1111,2587,-
chr13,51369007,1.9536958068756927,1679,1180,2859,-
chr13,51376098,3.2604412923561856,661,422,1083,-
chr13,51376144,3.700221026330963,1452,945,2397,-
chr13,51376150,1.7055881819576768,2520,1462,3982,-
chr13,51376151,1.0917376659401623,1139,617,1756,-
chr13,51376152,1.569824414745208,4837,2730,7567,-
chr13,51376153,1.872921320426905,2386,1342,3728,-
chr13,51376157,1.2384755848849427,1595,851,2446,-
chr13,51378319,0.6288288585560893,917,464,1381,-
chr13,51378320,0.24829209301180857,793,424,1217,-
chr13,54440741,2.4609901753034102,1021,715,1736,-
chr13,54440743,2.4609901753034102,1021,715,1736,-
chr13,54440744,0.7395352412431361,1810,1276,3086,-
chr13,54440752,1.7900552486187846,647,361,1008,-
chr13,54440754,2.3811841038118406,733,410,1143,-
chr13,54440756,2.29557069846678,1077,586,1663,-
chr13,54440758,1.8763197141730685,1703,1126,2829,-
chr13,59879252,0.6876735164265493,1378,852,2230,-
chr13,59879253,1.5853457990130628,1289,843,2132,-
chr13,59879254,1.5403296743559292,1557,1053,2610,-
chr13,67267209,1.4890533456675916,1316,845,2161,-
chr13,67267212,1.0915976203410778,2169,1411,3580,-
chr13,67267213,0.5125370942443637,1531,962,2493,-
chr13,67267214,0.9474933271806387,4400,2749,7149,-
chr13,67267215,1.1224305805986297,1874,1174,3048,-
chr13,67267216,1.1224305805986297,1874,1174,3048,-
chr13,72709453,1.844511652730831,767,510,1277,-
chr13,72709778,3.6037100696529363,1339,932,2271,-
chr13,72709994,0.6024663107042969,676,413,1089,-
chr13,72710035,1.545167436640305,1183,890,2073,-
chr13,72710339,2.322404573490241,1512,1076,2588,-
chr13,72727549,1.5941936729635682,1047,667,1714,-
chr13,72762044,2.3239935472641147,591,485,1076,-
chr13,75286810,1.7183077852345134,844,533,1377,-
chr13,75526616,0.6236486486486487,1348,1183,2531,-
chr13,75530205,0.5926834253014511,811,698,1509,-
chr13,75530208,0.7283731379280062,2413,1708,4121,-
chr13,75530231,1.6463456284153004,621,487,1108,-
chr13,75530250,2.4999985389254324,727,571,1298,-
chr13,75530255,1.3124543023285782,1375,1081,2456,-
chr13,75530256,1.4794002431446711,887,672,1559,-
chr13,75530257,1.4794002431446711,887,672,1559,-
chr13,75530258,0.8706955678009406,966,672,1638,-
chr13,75530260,0.9234650967199326,731,491,1222,-
chr13,75530262,0.8443836771363141,717,513,1230,-
chr13,77005594,0.6601163741881304,801,536,1337,-
chr13,79377435,2.1369305856832974,638,460,1098,-
chr13,94574714,2.0362356999845987,600,475,1075,-
chr13,95020062,2.512061403508772,710,512,1222,-
chr13,95020145,1.4803552809752707,744,574,1318,-
chr13,95020657,2.090949227373068,591,452,1043,-
chr13,95053181,2.5165584185826986,1463,1102,2565,-
chr13,95053183,2.5165584185826986,1463,1102,2565,-
chr13,95161293,0.5862031970818581,682,477,1159,-
chr13,95164445,0.9881235154394299,701,420,1121,-
chr13,95164446,0.8274313265694987,890,581,1471,-
chr13,95178008,3.0581803101492864,709,529,1238,-
chr13,95186724,1.560735545470619,1357,721,2078,-
chr13,95186728,1.5725288831835684,1224,778,2002,-
chr13,95186731,0.6670304825758165,2138,1142,3280,-
chr13,95186732,0.6670304825758165,2138,1142,3280,-
chr13,95186737,2.565838050701452,833,477,1310,-
chr13,95186746,2.0351127745493947,1449,780,2229,-
chr13,95186747,2.0351127745493947,1449,780,2229,-
chr13,95186753,2.576216434484151,637,380,1017,-
chr13,95186764,1.3363743735504374,1103,617,1720,-
chr13,95194915,5.085178496562842,650,444,1094,-
chr13,95194917,3.2806294492319217,795,470,1265,-
chr13,98519373,0.4229136010090393,957,709,1666,-
chr13,98519375,0.8314340134204259,1342,955,2297,-
chr13,99215443,2.5984848484848486,853,670,1523,-
chr13,99215445,2.5984848484848486,853,670,1523,-
chr13,99215446,0.27362713518374315,937,638,1575,-
chr13,100625889,1.1766370691749586,1050,691,1741,-
chr13,100625891,1.6333005410723067,686,427,1113,-
chr13,102766557,3.0649565332098354,788,604,1392,-
chr13,102789070,2.594117647058824,566,509,1075,-
chr13,106544009,0.49540043520294513,1005,713,1718,-
chr13,106557217,0.3358488900657575,760,580,1340,-
chr13,106557316,40.7548272743674,1833,1747,3580,-
chr13,106557317,40.95271687016146,1715,1647,3362,-
chr13,106557343,2.57715296323992,675,360,1035,-
chr13,106557630,2.3331947524020693,952,655,1607,-
chr13,106557631,2.1670427619059933,1481,971,2452,-
chr13,106557641,3.249525510773697,1187,688,1875,-
chr13,106557642,3.249525510773697,1187,688,1875,-
chr13,106557643,3.249525510773697,1187,688,1875,-
chr13,106559098,2.892831695332133,1407,1463,2870,-
chr13,106559099,3.557859620017881,972,977,1949,-
chr13,106559105,20.20073072608316,711,635,1346,-
chr13,110523189,1.3420971325552564,1562,1168,2730,-
chr13,110523258,3.0179675916846556,648,455,1103,-
chr13,110523415,0.18913189901725594,324,874,1198,-
chr13,110523424,0.23740001127692953,726,1558,2284,-
chr13,110523429,0.21268520408517735,551,1096,1647,-
chr13,110523452,6.831288343558282,458,977,1435,-
chr13,110523453,9.311672295752352,1627,2274,3901,-
chr13,110523454,10.295462561755729,1786,2317,4103,-
chr13,110523455,15.733258928571429,665,511,1176,-
chr13,110523645,3.5327785207919407,595,492,1087,-
chr13,110523803,0.9612191071603008,655,352,1007,-
chr13,110523804,0.9612191071603008,655,352,1007,-
chr13,110523875,2.6265006002400955,760,391,1151,-
chr13,110523876,2.6265006002400955,760,391,1151,-
chr13,110524027,1.610737631579265,4120,3966,8086,-
chr13,110524028,1.610737631579265,4120,3966,8086,-
chr13,110524031,1.422824635053907,1728,1783,3511,-
chr13,110524032,1.4752443159154367,2474,2506,4980,-
chr13,110524034,1.4767894810858344,2321,2149,4470,-
chr13,110524049,0.4825366295708103,1184,1203,2387,-
chr13,110524051,0.4593141170651628,1320,1327,2647,-
chr13,110524055,2.2845301226930537,585,713,1298,-
chr13,110524070,3.5466179159049362,484,546,1030,-
chr13,110524071,3.717181457352158,1473,1465,2938,-
chr13,110524073,3.4828867816329865,1245,1178,2423,-
chr13,110524074,2.6036390387755937,662,670,1332,-
chr13,110644464,1.281394334264599,605,528,1133,-
chr13,110644466,0.5672608400666133,540,522,1062,-
chr13,110893061,1.5333726041053064,751,760,1511,-
chr13,110893080,2.1246525075058385,578,528,1106,-
chr13,110893081,1.8436049649217487,588,544,1132,-
chr13,110893137,0.4979207336848217,868,713,1581,-
chr13,110910648,1.652802371454374,551,503,1054,-
chr13,112516563,0.6980481059611344,574,450,1024,-
chr13,112545708,2.036438058163499,1673,1587,3260,-
chr13,112545709,2.036438058163499,1673,1587,3260,-
chr13,112545712,1.6570829589697516,1508,1322,2830,-
chr13,112545714,1.6570829589697516,1508,1322,2830,-
chr13,112545734,0.23594470046082952,639,464,1103,-
chr13,112545757,2.8746340165025286,599,441,1040,-
chr13,112545758,2.8746340165025286,599,441,1040,-
chr13,112554920,2.068709836875927,557,475,1032,-
chr13,112558348,1.8000290045376424,5307,4057,9364,-
chr13,112558354,1.0908506151975066,9639,6969,16608,-
chr13,112558355,1.433856516366632,4608,3724,8332,-
chr13,112558359,1.634053645123497,6943,5075,12018,-
chr13,112558361,2.01530877432349,3980,2978,6958,-
chr13,112558371,1.3677336509787026,3237,2320,5557,-
chr13,112558372,1.3817781823698985,1492,1013,2505,-
chr13,112558373,1.488823047934962,5869,3900,9769,-
chr13,112558374,1.6485794056951553,2632,1580,4212,-
chr13,112558377,1.7195121951219512,1259,839,2098,-
chr13,112558392,1.937868605129612,1790,950,2740,-
chr13,112558394,2.180654761904762,2585,1343,3928,-
chr13,112558396,2.5717429173925,1649,838,2487,-
chr13,112558401,2.0027266530334016,790,488,1278,-
chr13,112558406,1.8815673553199266,1044,649,1693,-
chr13,112559384,0.8957055214723928,729,325,1054,-
chr13,112559385,0.6919178794178795,1064,480,1544,-
chr13,112559387,0.2761075949367089,697,315,1012,-
chr13,112559394,1.0485414415804908,646,417,1063,-
chr13,112559396,1.0485414415804908,646,417,1063,-
chr13,113177829,1.9777703826955073,1747,1201,2948,-
chr13,113177979,1.5669783186910615,996,652,1648,-
chr13,113177992,1.7574842017915275,1474,1092,2566,-
chr13,113178000,2.4267799352750807,856,617,1473,-
chr13,113178116,2.4339594575764725,833,629,1462,-
chr13,113178121,3.5154883773670766,781,611,1392,-
chr13,113178231,1.2363413212130767,3104,2369,5473,-
chr13,113178979,1.509958071278826,1004,794,1798,-
chr13,113179949,1.3873726346433768,874,686,1560,-
chr13,113179956,0.5882352941176471,971,647,1618,-
chr13,113179991,1.5288080926550358,947,717,1664,-
chr13,113180199,1.4693795326349721,1562,1240,2802,-
chr13,113180203,1.5814814814814817,1280,845,2125,-
chr13,113184466,1.956895505510978,2587,2189,4776,-
chr13,113184483,0.7357197258187357,1931,1413,3344,-
chr13,113185537,1.564516129032258,1163,650,1813,-
chr13,113190922,0.5812021190599373,1737,1376,3113,-
chr13,113190929,1.855274629468178,1063,813,1876,-
chr13,113190949,1.7729257641921397,550,457,1007,-
chr13,113195103,2.0228018045873446,2525,1703,4228,-
chr13,113196192,1.7499483791038608,677,333,1010,-
chr13,113197199,1.5674386920980927,1061,733,1794,-
chr13,113197216,3.1825726141078836,648,481,1129,-
chr13,113198213,0.5978947368421053,851,512,1363,-
chr13,113200459,1.2360397072517446,1635,1299,2934,-
chr13,113200461,2.9628899835796387,693,405,1098,-
chr13,113979314,1.8954475308641976,1155,863,2018,-
chr13,113979315,2.0615983943063396,1513,1172,2685,-
chr13,113979359,1.8456478477660219,892,539,1431,-
chr14,20311645,1.5895976891361154,1946,1554,3500,-
chr14,20311682,1.741605899559181,918,836,1754,-
chr14,20311726,2.0569403714565007,885,681,1566,-
chr14,20313500,1.7304333764553688,1043,772,1815,-
chr14,20313545,1.6901709401709404,790,575,1365,-
chr14,20313715,1.8429677651719791,951,616,1567,-
chr14,20313744,2.0468227424749164,791,505,1296,-
chr14,20313798,1.6702253855278766,767,561,1328,-
chr14,20316275,1.6837603740079004,1009,672,1681,-
chr14,20316332,0.4250992063492063,856,755,1611,-
chr14,20316366,1.7075821441267585,933,678,1611,-
chr14,20316400,1.6529615016975723,1459,1017,2476,-
chr14,20316404,1.5734265734265735,674,450,1124,-
chr14,20316490,1.9517086146920404,752,542,1294,-
chr14,20316495,2.1379510745187678,1413,942,2355,-
chr14,20326789,2.06271312664132,1073,822,1895,-
chr14,20326792,0.6291034334302013,1335,977,2312,-
chr14,20329204,1.3725490196078431,1587,1190,2777,-
chr14,20329345,1.7053091397849462,524,495,1019,-
chr14,20329368,1.6248715792370474,1021,684,1705,-
chr14,20329370,1.6422346951294315,1237,713,1950,-
chr14,20329371,0.7600527034102712,802,533,1335,-
chr14,20333265,1.0674157303370786,699,355,1054,-
chr14,20333266,1.0674157303370786,699,355,1054,-
chr14,20343104,0.5842657342657344,556,454,1010,-
chr14,20343112,0.7300504263694135,1654,1080,2734,-
chr14,20343408,0.9210124548011248,5209,3039,8248,-
chr14,20343410,0.9210124548011248,5209,3039,8248,-
chr14,20458193,12.471531327813167,834,1024,1858,-
chr14,20458194,9.147428056856649,871,1005,1876,-
chr14,20458195,11.119623554592415,1027,1284,2311,-
chr14,21210648,4.15738188335168,563,442,1005,-
chr14,21210817,1.7579621076989562,2292,1542,3834,-
chr14,21210831,1.4822503253090435,1278,927,2205,-
chr14,21210836,1.4619210274627679,1048,562,1610,-
chr14,21211132,1.3518856143856144,1482,1143,2625,-
chr14,21211146,1.3926340147622394,3413,2383,5796,-
chr14,21211154,2.7222222222222214,937,669,1606,-
chr14,21211163,1.6195250029836497,1379,881,2260,-
chr14,21211164,0.6417746988258666,1171,993,2164,-
chr14,21211170,1.6887767812655703,985,891,1876,-
chr14,21211188,1.5940542697525937,928,715,1643,-
chr14,21211189,0.5792891619131197,860,644,1504,-
chr14,21211190,2.2425506555423125,1490,838,2328,-
chr14,21211192,2.2425506555423125,1490,838,2328,-
chr14,21211198,1.8370129870129868,737,527,1264,-
chr14,21211448,4.862028995140714,13868,7888,21756,-
chr14,21211450,5.082945431081578,8659,4628,13287,-
chr14,21211471,1.6883776792313376,2149,901,3050,-
chr14,21211893,1.5934131027129488,2151,1467,3618,-
chr14,21211917,1.4871708596473066,4136,2228,6364,-
chr14,21211918,1.5204572594506651,5960,3705,9665,-
chr14,21211919,1.7063567362428842,2397,1332,3729,-
chr14,21211921,1.50303901411256,6999,3706,10705,-
chr14,21211922,1.5168205771277725,5754,3005,8759,-
chr14,21213033,1.5599462130396657,8264,5496,13760,-
chr14,21213034,1.4116773271859475,1998,1620,3618,-
chr14,21213035,1.5599462130396657,8264,5496,13760,-
chr14,21213040,1.5151162790697674,1302,859,2161,-
chr14,21213052,0.3003663003663004,1680,1229,2909,-
chr14,21213053,1.5258976007580116,3665,2037,5702,-
chr14,21213054,1.5258976007580116,3665,2037,5702,-
chr14,21213055,2.272755905511811,1055,634,1689,-
chr14,21231031,1.7135452020981177,1156,925,2081,-
chr14,21231032,1.5852242893836832,1413,848,2261,-
chr14,21231034,1.7119405901895641,729,475,1204,-
chr14,21231043,1.618982048143615,906,515,1421,-
chr14,21231044,2.020826690051021,1388,783,2171,-
chr14,21231045,2.020826690051021,1388,783,2171,-
chr14,21231046,1.542347037233368,2022,1267,3289,-
chr14,21231068,1.2623041822917143,1632,892,2524,-
chr14,21231069,0.9442160892542573,803,376,1179,-
chr14,21234173,1.3330679482620946,5474,4162,9636,-
chr14,21234202,0.6640602234094221,1242,1159,2401,-
chr14,21234219,1.924945468966885,1411,983,2394,-
chr14,21234222,2.054054054054054,1171,878,2049,-
chr14,21234227,3.072133863550099,1628,1234,2862,-
chr14,21269324,2.28801867219917,1422,963,2385,-
chr14,21269326,2.28801867219917,1422,963,2385,-
chr14,21269327,1.899621212121212,1070,692,1762,-
chr14,21269334,1.8063485519942288,1030,625,1655,-
chr14,21269339,2.0095816389059102,1060,618,1678,-
chr14,21269418,0.614934976066858,2578,1712,4290,-
chr14,21269423,0.6586632057105775,1217,803,2020,-
chr14,21269424,0.6052659519520978,3716,2970,6686,-
chr14,21269425,0.6052659519520978,3716,2970,6686,-
chr14,21269426,0.5894819254690694,3129,2325,5454,-
chr14,21351790,1.8132816728877112,1969,1327,3296,-
chr14,21351792,1.6330296390266406,1179,666,1845,-
chr14,21351908,1.8245986862813963,13066,7744,20810,-
chr14,21351909,1.8857939422890455,14126,8274,22400,-
chr14,21351911,1.7572910893611324,12452,7110,19562,-
chr14,21351914,2.190007163323782,1746,1046,2792,-
chr14,21351946,0.9362514985909351,3616,2167,5783,-
chr14,21351947,1.075742295371856,4680,2715,7395,-
chr14,21352043,1.730769230769231,899,519,1418,-
chr14,21352055,2.3953076844675905,948,542,1490,-
chr14,21352446,1.0795187201720775,802,512,1314,-
chr14,21352448,1.0795187201720775,802,512,1314,-
chr14,21352789,1.536969180236026,760,588,1348,-
chr14,21353504,2.5402511469029068,832,627,1459,-
chr14,21357350,1.4344333666813998,590,431,1021,-
chr14,21358417,0.9951088285644412,625,563,1188,-
chr14,21358419,0.9951088285644412,625,563,1188,-
chr14,21361159,2.969402277039848,641,495,1136,-
chr14,21361160,3.2302328551314305,1026,859,1885,-
chr14,21363059,2.780172413793104,730,463,1193,-
chr14,21363062,1.829019607843137,582,449,1031,-
chr14,21363111,1.849898580121704,569,434,1003,-
chr14,21363262,1.6747647318974797,9902,7087,16989,-
chr14,21363264,1.785288764630838,9005,6414,15419,-
chr14,21363284,1.2103462506658313,6686,4332,11018,-
chr14,21363286,1.2103462506658313,6686,4332,11018,-
chr14,21363296,1.6021794255836512,2658,1661,4319,-
chr14,21363299,1.9180225533628676,1236,763,1999,-
chr14,21363459,1.8086025018670648,1408,823,2231,-
chr14,21363460,2.006175664285258,1997,1264,3261,-
chr14,21363468,1.6140976516559808,1012,612,1624,-
chr14,21363471,1.8759034020800285,938,548,1486,-
chr14,21363494,2.760536951501155,764,432,1196,-
chr14,21364872,1.9519604380077717,613,446,1059,-
chr14,21366485,0.4014051472517453,913,643,1556,-
chr14,21368435,2.0611373215594164,719,535,1254,-
chr14,21369893,2.1871446271914463,766,575,1341,-
chr14,21369894,2.2352711284807034,557,444,1001,-
chr14,21370472,1.8106361180963026,1278,1192,2470,-
chr14,21370486,1.8022367194780988,878,739,1617,-
chr14,21371886,0.5779986746189529,1245,1005,2250,-
chr14,21371896,3.1333333333333333,704,524,1228,-
chr14,21372027,2.755288126561071,912,617,1529,-
chr14,21383907,1.432895878849327,706,490,1196,-
chr14,21383910,3.388597290728901,876,571,1447,-
chr14,21428126,0.977043594469477,605,467,1072,-
chr14,21498330,2.531203353186656,982,687,1669,-
chr14,21499093,1.4935058305317124,592,439,1031,-
chr14,21499597,2.2142103394423227,672,494,1166,-
chr14,21500973,2.326857076198604,707,499,1206,-
chr14,21511191,5.098096543319419,715,663,1378,-
chr14,21511192,4.80439830208613,561,496,1057,-
chr14,22565101,1.4892623716153128,1594,1070,2664,-
chr14,22565109,1.656438957167365,1201,960,2161,-
chr14,22565116,1.8371090864319133,1040,785,1825,-
chr14,22575156,1.5020098948670375,1739,1231,2970,-
chr14,22575178,1.4741379310344829,1519,959,2478,-
chr14,22575212,0.5442007554683611,1238,922,2160,-
chr14,22588972,1.6513475619255336,1324,1178,2502,-
chr14,22589026,1.7065266316579144,1033,859,1892,-
chr14,22589084,2.3354767957728924,900,742,1642,-
chr14,22589119,2.0320121028744325,860,660,1520,-
chr14,22589156,1.695638126009693,819,618,1437,-
chr14,22589160,1.8878822862162759,1950,1278,3228,-
chr14,22589174,2.0014105744442823,1788,978,2766,-
chr14,22589175,2.0014105744442823,1788,978,2766,-
chr14,22905355,2.167227639909759,2312,1962,4274,-
chr14,22905357,2.167227639909759,2312,1962,4274,-
chr14,22905368,1.6232294617563738,954,705,1659,-
chr14,22905389,2.719951033594223,1060,723,1783,-
chr14,22905393,2.3738626964433416,614,402,1016,-
chr14,22905434,2.013577687358707,691,461,1152,-
chr14,22924951,2.9700483671255857,798,625,1423,-
chr14,22924972,0.4136923758780752,701,516,1217,-
chr14,22926267,2.4907604267815007,644,450,1094,-
chr14,22928147,0.4449672795896056,618,413,1031,-
chr14,22928205,2.7830295340333024,1011,730,1741,-
chr14,22928206,3.1360572012257406,713,444,1157,-
chr14,22929327,14.623635941490594,669,335,1004,-
chr14,22929364,0.6976164349089561,878,495,1373,-
chr14,22946387,2.6240409207161126,1025,764,1789,-
chr14,22946389,2.6240409207161126,1025,764,1789,-
chr14,22946568,1.1701754385964909,666,455,1121,-
chr14,22946570,1.1701754385964909,666,455,1121,-
chr14,22947615,1.9336928322602434,996,828,1824,-
chr14,22947890,0.3207791476664977,813,572,1385,-
chr14,22947892,0.3207791476664977,813,572,1385,-
chr14,22947973,2.454524880820344,785,498,1283,-
chr14,22952447,1.7946674537583631,628,483,1111,-
chr14,22952603,1.8557715973418656,579,477,1056,-
chr14,22952631,1.728997093023256,642,429,1071,-
chr14,22952650,1.398035810718926,1419,1034,2453,-
chr14,22952674,1.281000156714966,958,670,1628,-
chr14,22955112,2.520788732394365,951,709,1660,-
chr14,22955113,2.3344276752954696,1350,1030,2380,-
chr14,23026038,1.5661088911088912,1717,1429,3146,-
chr14,23026124,1.8337243307516788,1267,840,2107,-
chr14,23026146,1.6642185663924791,1132,735,1867,-
chr14,23026221,1.325060149423832,1525,1042,2567,-
chr14,23026276,1.5715401410580736,2939,2084,5023,-
chr14,23026369,2.127686462825532,2114,1413,3527,-
chr14,23033382,1.4976817822006108,945,716,1661,-
chr14,23033390,1.2206381884906368,2577,1685,4262,-
chr14,23033471,1.4317924153959527,1422,1195,2617,-
chr14,23033489,0.7027140278494071,1520,1107,2627,-
chr14,23033504,0.6152420948616601,1464,919,2383,-
chr14,23033545,1.7678571428571432,912,663,1575,-
chr14,23033657,1.4298649222979838,1459,858,2317,-
chr14,23034717,1.7474338929243252,3083,2155,5238,-
chr14,23034723,1.5973432959734328,935,656,1591,-
chr14,23034724,0.3560317632981618,1090,633,1723,-
chr14,23034791,0.6390288593678425,1022,813,1835,-
chr14,23034800,0.5189137134052388,708,589,1297,-
chr14,23034858,1.6376158403808172,850,636,1486,-
chr14,23034880,2.208609271523179,666,452,1118,-
chr14,23034882,1.3613983907386678,2322,1327,3649,-
chr14,23034884,1.5246442820291688,2737,1576,4313,-
chr14,23034885,2.4449851042701094,848,529,1377,-
chr14,23034893,3.3346957613677497,1016,512,1528,-
chr14,23034897,1.5635528059509272,871,491,1362,-
chr14,23034899,1.3492940385477363,786,484,1270,-
chr14,23059247,5.168004731548973,594,834,1428,-
chr14,23059271,26.156435772184334,4407,1407,5814,-
chr14,23059272,29.068141910293047,6047,1823,7870,-
chr14,23059273,29.48966206612947,5876,1777,7653,-
chr14,23059274,33.06571074650453,3413,1019,4432,-
chr14,23059304,4.670055702645998,2590,553,3143,-
chr14,23059305,4.798674209252381,2262,473,2735,-
chr14,23059382,3.2891264416262973,1269,930,2199,-
chr14,23062990,0.6545880799746551,669,433,1102,-
chr14,23069586,0.3908329799331604,657,535,1192,-
chr14,23080415,1.8819776714513559,707,398,1105,-
chr14,23080421,2.357760814249364,1242,654,1896,-
chr14,23080423,2.357760814249364,1242,654,1896,-
chr14,23080425,1.5790065815379422,801,612,1413,-
chr14,23080446,2.3090196078431373,643,424,1067,-
chr14,23080450,2.8142889808821727,920,515,1435,-
chr14,23080756,6.2685869988322285,670,733,1403,-
chr14,23080759,2.137031408308004,648,657,1305,-
chr14,23080762,2.4965683546651833,625,598,1223,-
chr14,23080768,2.290909090909091,566,494,1060,-
chr14,23081789,2.9274194621168306,944,656,1600,-
chr14,23081790,3.585714285714286,752,524,1276,-
chr14,23081814,2.171118093314952,631,430,1061,-
chr14,24144257,2.1819032761310453,998,640,1638,-
chr14,24144258,2.1819032761310453,998,640,1638,-
chr14,24144465,2.6160714285714284,585,447,1032,-
chr14,24146603,0.36132228115862997,591,490,1081,-
chr14,24217013,1.6560969151330598,806,580,1386,-
chr14,24217021,1.4959086259802252,1079,837,1916,-
chr14,24217114,1.492222222222222,1342,989,2331,-
chr14,24217115,2.0309597523219813,1311,911,2222,-
chr14,24217135,2.3070785597381342,1073,751,1824,-
chr14,24217137,2.3070785597381342,1073,751,1824,-
chr14,24218147,1.4688337178403916,2551,1794,4345,-
chr14,24218183,1.7763241056756414,802,585,1387,-
chr14,24218186,1.5160738705640497,1913,1398,3311,-
chr14,24232262,0.5453141091658085,1411,970,2381,-
chr14,24232271,1.7928936695468172,1742,1283,3025,-
chr14,24232272,1.7928936695468172,1742,1283,3025,-
chr14,24232275,2.702584318878668,1233,760,1993,-
chr14,24232278,2.1130434782608694,809,574,1383,-
chr14,24232280,0.5840143691064212,928,654,1582,-
chr14,24232300,1.1132910069161814,1754,1077,2831,-
chr14,24232336,0.6338220252301398,675,418,1093,-
chr14,24232337,2.3864420236869988,2758,1575,4333,-
chr14,24232338,2.6140819964349378,1675,747,2422,-
chr14,24232345,1.4870909742540148,1700,1203,2903,-
chr14,24232346,2.2846153846153845,659,519,1178,-
chr14,24232347,0.8638663878561578,1489,955,2444,-
chr14,24232360,2.1258907363420425,715,420,1135,-
chr14,24232361,2.1258907363420425,715,420,1135,-
chr14,24232364,1.0820245719398014,1080,310,1390,-
chr14,24232365,1.3242942317000697,1842,728,2570,-
chr14,24232366,1.0576241706119385,1542,512,2054,-
chr14,24241913,3.852676326549894,612,528,1140,-
chr14,31101034,2.5872302158273377,821,555,1376,-
chr14,31101035,2.5872302158273377,821,555,1376,-
chr14,31106768,1.6939312072442911,3218,2328,5546,-
chr14,31106783,1.4705457454965716,1202,840,2042,-
chr14,31106785,0.5141303798959789,1489,981,2470,-
chr14,31106816,2.898673920435226,774,518,1292,-
chr14,31109536,1.4817173840891078,704,363,1067,-
chr14,31133342,1.7851879560214705,739,481,1220,-
chr14,31168425,3.2042692939244666,886,1014,1900,-
chr14,31168426,3.2042692939244666,886,1014,1900,-
chr14,31387304,1.70672553963734,723,605,1328,-
chr14,34434718,47.45393856383318,17617,10402,28019,-
chr14,34434719,46.57618429521867,22548,11083,33631,-
chr14,34434720,43.11700691896696,24802,9211,34013,-
chr14,34434721,32.89743914069394,19784,3961,23745,-
chr14,34434722,6.449530316462534,17504,2412,19916,-
chr14,34434724,9.197689182326052,2682,357,3039,-
chr14,34434728,5.362808453764822,3488,515,4003,-
chr14,34434729,11.674004192872115,1590,211,1801,-
chr14,34434731,5.988826815642457,1071,178,1249,-
chr14,34434734,4.898968350610473,2495,391,2886,-
chr14,34434938,1.4851678376268538,1521,914,2435,-
chr14,34435204,0.6145217338291776,839,697,1536,-
chr14,34435213,1.4983726031274318,1032,672,1704,-
chr14,34435215,1.7059649122807017,662,512,1174,-
chr14,34435270,1.1841588639644454,1930,1404,3334,-
chr14,34435272,1.2150572997231477,2314,1626,3940,-
chr14,34435288,2.6178151260504197,648,424,1072,-
chr14,34462125,0.5126262626262627,695,527,1222,-
chr14,34462127,2.340118667275217,753,625,1378,-
chr14,34462128,2.340118667275217,753,625,1378,-
chr14,34462140,2.8459821428571432,560,447,1007,-
chr14,34462151,1.4824157142227874,1246,925,2171,-
chr14,34536114,3.229126418790109,735,505,1240,-
chr14,34562818,1.9473684210526319,702,455,1157,-
chr14,34563011,2.1927409261576973,656,422,1078,-
chr14,34563099,1.973845320282243,1149,918,2067,-
chr14,34563100,2.0006918021445865,722,412,1134,-
chr14,34567964,2.4559659090909087,664,439,1103,-
chr14,34568685,1.9973002969673332,1147,900,2047,-
chr14,34568686,1.9973002969673332,1147,900,2047,-
chr14,34568688,0.7142613762202498,1074,742,1816,-
chr14,34568689,1.4787978426761395,1042,855,1897,-
chr14,34568690,1.2169789542533955,890,657,1547,-
chr14,34568692,0.7128846153846153,673,499,1172,-
chr14,34568961,1.0132971559200983,2229,1588,3817,-
chr14,34568983,1.3032033654406325,1934,1415,3349,-
chr14,34568986,2.0857359079010256,1205,1003,2208,-
chr14,34568987,1.8638766805455045,2092,1568,3660,-
chr14,34568991,1.7682051693557645,938,651,1589,-
chr14,34568998,1.324644068719392,875,609,1484,-
chr14,34575836,2.8233262996355273,668,400,1068,-
chr14,34581581,1.7910052910052912,676,377,1053,-
chr14,34609724,2.608629247804505,853,484,1337,-
chr14,34609725,2.4633992678997956,1239,751,1990,-
chr14,34609730,2.4322508398656213,723,375,1098,-
chr14,34609732,2.4322508398656213,723,375,1098,-
chr14,34711242,1.7397744126863364,796,520,1316,-
chr14,34712237,2.049979347377117,708,537,1245,-
chr14,34712836,0.5272911051212938,625,423,1048,-
chr14,34712864,1.7514624384236452,614,447,1061,-
chr14,34792897,3.2741326306543703,724,426,1150,-
chr14,35401625,2.4855324074074074,858,575,1433,-
chr14,35401626,2.4855324074074074,858,575,1433,-
chr14,35401630,4.341336867209588,601,564,1165,-
chr14,35401741,2.113159472422062,612,416,1028,-
chr14,35401857,2.1899313501144158,989,873,1862,-
chr14,35401859,2.1899313501144158,989,873,1862,-
chr14,35401881,3.1570155902004458,566,448,1014,-
chr14,35401898,2.1618768328445745,775,619,1394,-
chr14,35401900,2.1618768328445745,775,619,1394,-
chr14,35402478,1.770938312128043,687,585,1272,-
chr14,35402516,2.6266433278189045,756,572,1328,-
chr14,35403768,0.656066296326118,564,437,1001,-
chr14,36314901,1.8328250401284107,1113,711,1824,-
chr14,36314904,2.2567762667660207,1845,1341,3186,-
chr14,36314906,2.2567762667660207,1845,1341,3186,-
chr14,36314910,1.5538461538461543,807,519,1326,-
chr14,36314913,0.6603260869565217,764,459,1223,-
chr14,36316766,2.3746829608189954,1327,746,2073,-
chr14,36316768,2.295555555555556,1032,599,1631,-
chr14,39032924,6.115438596491227,600,474,1074,-
chr14,39032926,6.115438596491227,600,474,1074,-
chr14,39033226,2.201068129330254,662,432,1094,-
chr14,39039076,0.9659542743538768,506,502,1008,-
chr14,39039078,0.9698748695260028,1269,1107,2376,-
chr14,39040764,1.5812332184941043,961,683,1644,-
chr14,39045243,0.6094830223309881,585,466,1051,-
chr14,39045256,1.846530612244898,701,524,1225,-
chr14,39055199,2.0119304666473123,1393,1033,2426,-
chr14,39055200,2.2679422275163788,742,583,1325,-
chr14,39055280,1.5702569019635757,622,493,1115,-
chr14,39063381,2.404162800812294,885,622,1507,-
chr14,39064945,1.6627530364372471,1368,831,2199,-
chr14,39064946,1.4528874365768374,2360,1410,3770,-
chr14,39064976,0.5940594059405941,599,403,1002,-
chr14,39074437,0.37551369863013695,730,583,1313,-
chr14,39074439,0.37551369863013695,730,583,1313,-
chr14,39074461,1.978947368421053,704,449,1153,-
chr14,39076026,1.9385593220338984,548,471,1019,-
chr14,39076054,2.0400916380297818,684,484,1168,-
chr14,39076062,0.3965439813623115,836,647,1483,-
chr14,39076092,2.722708907097714,687,534,1221,-
chr14,39085900,2.048201119138127,792,585,1377,-
chr14,39091527,1.7833033303330332,633,403,1036,-
chr14,45116031,4.565701559020044,573,448,1021,-
chr14,45116243,2.1970588235294115,912,679,1591,-
chr14,45118048,1.88622754491018,629,500,1129,-
chr14,45118065,1.7735323886639671,977,740,1717,-
chr14,45118071,2.144483599891569,585,433,1018,-
chr14,45121494,1.6046575010598991,2077,1671,3748,-
chr14,45121496,1.6046575010598991,2077,1671,3748,-
chr14,45121535,3.6899427433408016,846,617,1463,-
chr14,45121554,1.754433497536946,837,579,1416,-
chr14,45134367,1.6230071897467957,648,456,1104,-
chr14,45134400,2.236942552363633,852,487,1339,-
chr14,45134457,3.0152725507740814,1880,714,2594,-
chr14,45134470,5.236882322975038,1027,301,1328,-
chr14,45134472,3.9353291226078393,2363,759,3122,-
chr14,45134476,1.6423417965522942,1277,270,1547,-
chr14,45134477,1.6792986176054883,2971,750,3721,-
chr14,45134478,1.2654618508960225,3581,849,4430,-
chr14,45134480,0.9670195372297866,1245,221,1466,-
chr14,45237680,1.8019265232974908,1086,719,1805,-
chr14,45237690,1.4749910107681534,1298,996,2294,-
chr14,45237695,1.874208521807879,1840,1306,3146,-
chr14,45237699,2.6504065040650406,651,368,1019,-
chr14,49577809,1.8571589399500146,2795,1930,4725,-
chr14,49577811,1.833116252144969,4123,2803,6926,-
chr14,49577812,1.8998713447479798,2700,1807,4507,-
chr14,49577820,1.7216061631843118,1028,658,1686,-
chr14,49577827,1.584870979144574,1018,614,1632,-
chr14,49577831,2.0115107913669057,931,555,1486,-
chr14,49577832,1.0416073124406455,1525,935,2460,-
chr14,49577834,1.0416073124406455,1525,935,2460,-
chr14,49583675,0.7005711119635171,1314,1421,2735,-
chr14,49583679,0.9969948759613475,5567,4143,9710,-
chr14,49583680,1.0125694394540647,6100,4706,10806,-
chr14,49585977,1.2661007128626356,29290,21789,51079,-
chr14,49586373,0.8821812680239456,164358,77390,241748,-
chr14,49586375,0.9282641374203774,170125,83090,253215,-
chr14,49586376,0.8561265096636196,60250,27759,88009,-
chr14,49586379,0.35019055006576516,1092,595,1687,-
chr14,49586383,1.5214299082912222,1477,935,2412,-
chr14,49586384,1.5334742452857915,1625,1055,2680,-
chr14,49586403,1.8143788348615764,932,577,1509,-
chr14,49586410,0.9323450559848603,738,372,1110,-
chr14,49586411,0.7549162671113891,678,467,1145,-
chr14,49586412,0.8084063134298095,1615,963,2578,-
chr14,49586413,0.6744554112770553,1397,878,2275,-
chr14,49618815,0.7380290258103763,2579,1865,4444,-
chr14,49618922,1.7001089663760898,4853,3211,8064,-
chr14,49618923,1.7001089663760898,4853,3211,8064,-
chr14,49619025,1.5721146457660982,2406,2168,4574,-
chr14,49619030,1.7742787350630491,2149,1835,3984,-
chr14,49619054,2.128943821251513,1502,1182,2684,-
chr14,49619089,0.6135584278554471,1162,891,2053,-
chr14,49619127,0.6985322973079037,889,821,1710,-
chr14,49619130,1.1049432423305712,2577,1685,4262,-
chr14,49619131,1.2936854029031133,3619,2488,6107,-
chr14,49619134,0.6,989,769,1758,-
chr14,49619136,1.7750039252629928,594,578,1172,-
chr14,49620589,0.6117059586114177,979,705,1684,-
chr14,49620606,1.4697388632872503,597,433,1030,-
chr14,49620607,0.5098031980319803,1336,812,2148,-
chr14,49620608,0.5098031980319803,1336,812,2148,-
chr14,49620620,2.478701578011744,629,390,1019,-
chr14,49620624,0.4463289703591427,808,410,1218,-
chr14,49650292,1.2729614037560362,684,477,1161,-
chr14,49802532,1.9948853738464358,656,426,1082,-
chr14,49862594,1.7242267449867903,36414,32453,68867,-
chr14,49862598,1.1336237484966114,432268,332300,764568,-
chr14,49862599,1.1344854044010868,445783,344618,790401,-
chr14,49862618,1.0560627006472603,107898,86051,193949,-
chr14,49862623,1.2124812970098,131532,100864,232396,-
chr14,49862633,1.275933046274171,81031,49320,130351,-
chr14,49862634,1.2490007851612102,129134,82665,211799,-
chr14,49862636,1.2637643496887017,150625,93270,243895,-
chr14,49862637,1.2431269929681403,251769,177822,429591,-
chr14,49862638,1.247312249950206,304189,216025,520214,-
chr14,49862639,1.2523558186047252,330444,237731,568175,-
chr14,49862640,1.2750225246982514,215909,158354,374263,-
chr14,49862641,1.3065114324344862,182741,130192,312933,-
chr14,49862648,1.439823501393652,65211,42685,107896,-
chr14,49862649,1.6001749144578927,29146,15859,45005,-
chr14,49862651,1.3301348252744478,77151,51692,128843,-
chr14,49862652,1.0106624071403076,28653,14169,42822,-
chr14,49862653,1.357473514720143,49459,37022,86481,-
chr14,49862657,1.1714590222572616,21447,15623,37070,-
chr14,49862667,0.9345285398962067,14406,6746,21152,-
chr14,49862668,1.1890492975740845,33107,21023,54130,-
chr14,49862676,0.9643570486993326,62888,41949,104837,-
chr14,49862677,0.9686811354171021,54909,37518,92427,-
chr14,49862678,1.0334939129110552,71909,46886,118795,-
chr14,49862679,1.0352334140887067,9502,5365,14867,-
chr14,49862680,1.3764107834983534,17834,9352,27186,-
chr14,49862681,1.4933224692406568,25112,13320,38432,-
chr14,49862683,1.193675333770954,26592,15779,42371,-
chr14,49862685,1.5405070987613227,9457,3952,13409,-
chr14,49862686,1.7613249100800736,10173,4420,14593,-
chr14,49862688,1.7093062765455405,10652,4074,14726,-
chr14,49862689,1.1742368633602491,19712,12245,31957,-
chr14,49862690,1.2676928370327394,21915,12982,34897,-
chr14,49862691,1.8200038175224282,9534,3379,12913,-
chr14,49862692,1.77757986779874,9362,3721,13083,-
chr14,49862694,1.7340028816001356,2406,1310,3716,-
chr14,49862695,1.4677620199887278,3389,1382,4771,-
chr14,49862702,1.4016047469515929,2924,867,3791,-
chr14,49862719,0.6843696027633851,4754,1691,6445,-
chr14,49862720,0.6843696027633851,4754,1691,6445,-
chr14,49862848,0.9949071064776135,31315,22945,54260,-
chr14,49862849,0.9935196704728642,8546,6427,14973,-
chr14,50109072,2.0861445170388846,668,498,1166,-
chr14,50482404,1.619462560296994,598,459,1057,-
chr14,50665338,1.7551356666400917,1500,1016,2516,-
chr14,50665340,1.7728714373442185,2190,1456,3646,-
chr14,50665341,1.7185293753354527,1410,913,2323,-
chr14,50665351,2.386904761904762,801,511,1312,-
chr14,50665353,1.4759254281020138,1405,980,2385,-
chr14,50665477,1.4041470833367091,628,466,1094,-
chr14,50905265,20.96365216689034,1267,920,2187,-
chr14,50905411,1.9957932692307692,614,519,1133,-
chr14,50908945,1.3993888347492154,578,424,1002,-
chr14,50911758,3.0353725222146277,572,531,1103,-
chr14,50912187,2.044609114034359,797,600,1397,-
chr14,50913047,2.8145239305465197,590,470,1060,-
chr14,50915365,1.9110244317659963,866,705,1571,-
chr14,50915368,3.0389376911410677,1194,918,2112,-
chr14,50917071,2.484827593957641,683,462,1145,-
chr14,50931694,0.6029100858102227,605,472,1077,-
chr14,50937790,2.4017317687285185,978,654,1632,-
chr14,52646224,2.3182250197200367,1037,769,1806,-
chr14,52646232,1.8582712705935454,715,421,1136,-
chr14,52652257,1.7238577863577864,738,517,1255,-
chr14,52652260,0.5306122448979592,701,485,1186,-
chr14,52657994,1.1674289763576629,696,360,1056,-
chr14,52657995,1.1674289763576629,696,360,1056,-
chr14,52666488,2.391685594739988,628,412,1040,-
chr14,52671841,1.9014147431124349,607,394,1001,-
chr14,52682406,2.0021776409134864,683,449,1132,-
chr14,52683857,2.559471365638766,580,453,1033,-
chr14,52683871,1.0136701662292211,805,507,1312,-
chr14,52683872,1.4231529291770255,1174,746,1920,-
chr14,52683874,1.0906505510131532,766,484,1250,-
chr14,52778098,8.83075742405412,797,492,1289,-
chr14,52778099,8.319913595840047,978,610,1588,-
chr14,52780707,4.173342740052246,702,484,1186,-
chr14,52781873,2.2343528197186733,786,573,1359,-
chr14,52781874,2.165327712896655,1148,842,1990,-
chr14,52781877,5.922321428571428,736,479,1215,-
chr14,52781878,5.922321428571428,736,479,1215,-
chr14,52864538,1.811156462585034,623,524,1147,-
chr14,52864539,0.3708510638297872,1742,1127,2869,-
chr14,52864541,0.37067969754473934,2318,1467,3785,-
chr14,52864552,1.9674773209805057,702,470,1172,-
chr14,52864587,2.4700272479564034,961,733,1694,-
chr14,52864588,2.4700272479564034,961,733,1694,-
chr14,52875242,5.430484877645664,619,527,1146,-
chr14,52878623,4.203661691734404,655,521,1176,-
chr14,52878663,3.0516614115935,698,588,1286,-
chr14,52878664,3.0516614115935,698,588,1286,-
chr14,52919193,2.158782394076512,655,441,1096,-
chr14,52919194,2.158782394076512,655,441,1096,-
chr14,54427263,1.8538538538538536,925,702,1627,-
chr14,54427832,0.4633983180428135,1118,871,1989,-
chr14,54430337,1.6546771653543308,795,634,1429,-
chr14,54430396,1.951046290424857,640,414,1054,-
chr14,54430402,0.5856317310218019,685,422,1107,-
chr14,54432163,2.318840579710145,1034,620,1654,-
chr14,54436401,0.525728500355366,568,468,1036,-
chr14,54477551,1.8616600790513835,941,758,1699,-
chr14,54477601,1.772363053613054,838,527,1365,-
chr14,54477797,2.5555808455717264,2313,1459,3772,-
chr14,54477801,1.9056398582744212,3461,1937,5398,-
chr14,54477802,1.7225628320946256,2613,1346,3959,-
chr14,54477805,2.076943893198629,1534,963,2497,-
chr14,54477807,2.076943893198629,1534,963,2497,-
chr14,54477821,1.021527412025403,1911,949,2860,-
chr14,54477825,2.2797894736842106,832,379,1211,-
chr14,54477836,2.9958582666487388,1685,740,2425,-
chr14,54477877,2.5983695652173915,682,344,1026,-
chr14,55158637,3.0206172547162367,635,450,1085,-
chr14,55158654,3.173927842069435,745,451,1196,-
chr14,55158656,3.173927842069435,745,451,1196,-
chr14,55179650,2.1831983805668016,718,467,1185,-
chr14,55179652,2.1831983805668016,718,467,1185,-
chr14,55188995,2.7447427654178855,644,418,1062,-
chr14,58411962,2.9058874086807047,1126,715,1841,-
chr14,58411963,2.9058874086807047,1126,715,1841,-
chr14,58411964,2.7960702065900493,1494,975,2469,-
chr14,58427086,2.320053088659578,637,409,1046,-
chr14,60149375,2.8223741635146933,668,490,1158,-
chr14,60149377,2.8223741635146933,668,490,1158,-
chr14,60149475,1.5513145996237787,669,501,1170,-
chr14,60156063,0.2856830438821658,605,468,1073,-
chr14,60979558,2.0322181518231885,1213,876,2089,-
chr14,60979560,2.0322181518231885,1213,876,2089,-
chr14,63685039,1.7261159783062157,992,845,1837,-
chr14,63685043,1.6379585326953747,1105,626,1731,-
chr14,63685050,0.4429621036349574,1184,861,2045,-
chr14,63685051,2.178319623971798,1482,1183,2665,-
chr14,63685053,2.178319623971798,1482,1183,2665,-
chr14,63685054,0.6674402179396629,979,747,1726,-
chr14,63685056,1.9486107973797155,638,465,1103,-
chr14,65075699,15.212926214314603,359,773,1132,-
chr14,67338572,0.9417087036592202,618,542,1160,-
chr14,67338573,0.650058769753167,904,805,1709,-
chr14,67338575,0.2713432500461983,777,674,1451,-
chr14,67352981,3.3875236294896034,615,528,1143,-
chr14,67352983,3.3875236294896034,615,528,1143,-
chr14,67353026,1.9782378447776423,764,592,1356,-
chr14,67651233,0.41521292201793925,533,605,1138,-
chr14,67651240,8.000800086850147,548,601,1149,-
chr14,67651243,22.287303371717183,1232,1160,2392,-
chr14,67651442,1.09618926361369,756,522,1278,-
chr14,67656546,2.5433779145461,740,496,1236,-
chr14,67656547,2.5433779145461,740,496,1236,-
chr14,67662531,1.807504575960952,947,595,1542,-
chr14,67662533,2.1160224471619387,1728,1047,2775,-
chr14,67662534,2.0907911802853443,867,513,1380,-
chr14,67674421,0.34688701704996316,657,462,1119,-
chr14,67674424,1.5683789563277135,691,448,1139,-
chr14,67677234,2.260026298487837,624,506,1130,-
chr14,67677310,1.4703560432620195,1489,955,2444,-
chr14,67677349,1.0518299132642268,677,488,1165,-
chr14,67677351,1.0518299132642268,677,488,1165,-
chr14,67677352,1.1652787926352919,1002,693,1695,-
chr14,67677510,3.7503386004514674,638,442,1080,-
chr14,67677659,1.96059493915395,1159,667,1826,-
chr14,67677717,1.9003198294243067,574,468,1042,-
chr14,67677720,3.5120941020543417,730,502,1232,-
chr14,67677801,0.6368382448116667,819,538,1357,-
chr14,67677892,1.9174291938997823,676,458,1134,-
chr14,67678035,2.311273021655535,1141,731,1872,-
chr14,67678177,1.0758802431005219,1970,1420,3390,-
chr14,67678271,0.24624999999999997,590,479,1069,-
chr14,67678280,0.6269164111451806,854,576,1430,-
chr14,67678325,2.018823529411765,857,577,1434,-
chr14,67678393,0.34431818181818186,605,439,1044,-
chr14,67685031,0.5482040929973548,828,652,1480,-
chr14,67685072,4.1159221076746855,690,484,1174,-
chr14,67685113,1.5703598484848484,720,527,1247,-
chr14,67685135,1.7620712620712622,556,461,1017,-
chr14,67690250,2.0084721004966406,624,488,1112,-
chr14,67690338,2.1526918316831685,604,403,1007,-
chr14,67690392,0.5704171934260429,563,451,1014,-
chr14,67691216,1.6532298869961208,675,538,1213,-
chr14,67691240,2.086016888507228,1099,821,1920,-
chr14,67691242,2.086016888507228,1099,821,1920,-
chr14,67692477,0.4827602273786226,796,510,1306,-
chr14,67692581,1.6231643356643355,598,439,1037,-
chr14,67693027,0.4928624353279887,874,697,1571,-
chr14,67695697,2.063448325146016,730,605,1335,-
chr14,67695730,1.9420871136281637,1159,644,1803,-
chr14,67695732,2.329553508150248,691,331,1022,-
chr14,68874400,0.6375772066148635,639,477,1116,-
chr14,68874410,9.183240825262642,3042,2622,5664,-
chr14,68874412,9.183240825262642,3042,2622,5664,-
chr14,68874601,2.0264092373354003,1003,686,1689,-
chr14,68874709,1.5752800208687103,625,424,1049,-
chr14,68880822,2.691089958611315,1209,783,1992,-
chr14,68880823,2.0445544554455446,707,403,1110,-
chr14,68880965,1.8854779758738442,2746,1730,4476,-
chr14,68880966,1.8744697312579495,3827,2410,6237,-
chr14,68880972,0.6779588336192109,764,529,1293,-
chr14,68880985,1.6112206881437652,918,506,1424,-
chr14,68882513,1.1563285493092061,1531,702,2233,-
chr14,68882526,0.9647864882090504,1210,522,1732,-
chr14,68882527,0.9647864882090504,1210,522,1732,-
chr14,68882536,2.9033791021699686,1538,795,2333,-
chr14,68882538,3.2276570048309177,1068,575,1643,-
chr14,68882937,2.3766990291262133,815,514,1329,-
chr14,68882959,2.640987654320988,763,404,1167,-
chr14,68882960,2.290840823547012,1284,734,2018,-
chr14,68882978,3.364804382822809,662,362,1024,-
chr14,68885571,3.5470610795474675,740,495,1235,-
chr14,68902526,2.199636128235649,898,564,1462,-
chr14,68921049,2.6220355731225298,914,505,1419,-
chr14,68921050,2.6220355731225298,914,505,1419,-
chr14,68925671,1.783006535947712,681,594,1275,-
chr14,69380303,1.5448638893066626,1333,1089,2422,-
chr14,69380331,1.5078640569315,2936,2036,4972,-
chr14,69380454,0.5303071501168147,2308,2764,5072,-
chr14,69380503,24.766175477491842,17715,16967,34682,-
chr14,69380504,24.76617547749184,17715,16967,34682,-
chr14,69380505,25.357210873947178,23475,17801,41276,-
chr14,69380507,7.230989120006289,21674,3097,24771,-
chr14,69380508,7.922427859658332,17017,2296,19313,-
chr14,69380509,7.735798658664132,14343,1903,16246,-
chr14,69380510,14.560065938594684,3532,421,3953,-
chr14,69380512,9.867731146833533,4943,597,5540,-
chr14,69380513,8.874229100045682,6612,795,7407,-
chr14,69380514,7.530846040523256,13111,1704,14815,-
chr14,69380515,6.679767718317605,11478,1504,12982,-
chr14,69380516,6.201506588441409,11007,1468,12475,-
chr14,69380577,0.7071914226502045,3890,2530,6420,-
chr14,69380605,1.4860781146061008,2233,1237,3470,-
chr14,69380629,1.4715731707317077,1386,1024,2410,-
chr14,69380637,2.037357743691242,1646,845,2491,-
chr14,69387070,1.41515899122807,1769,1367,3136,-
chr14,69394842,1.1045275928916993,3295,2497,5792,-
chr14,69394848,1.4808317089018843,1461,1025,2486,-
chr14,69398243,1.669687295512681,2338,1362,3700,-
chr14,69398288,0.5569050906649977,8368,5670,14038,-
chr14,69398289,0.5219118091211115,3229,1891,5120,-
chr14,69398293,0.9509413329935155,2453,1657,4110,-
chr14,69885451,1.2553055757114069,7823,6618,14441,-
chr14,69885455,1.3359697515935265,18028,12951,30979,-
chr14,69885460,1.6340398596810304,15569,10870,26439,-
chr14,69885467,0.7879703139585393,6847,5277,12124,-
chr14,69885480,1.378668026242535,14374,9698,24072,-
chr14,69885481,1.1690753860317644,14599,9805,24404,-
chr14,69885495,1.7480202075368652,2844,1830,4674,-
chr14,69885505,1.39096142064461,7394,4534,11928,-
chr14,69885508,1.6451300446835018,9104,4665,13769,-
chr14,69885509,1.732795720548703,11132,5584,16716,-
chr14,69885511,1.9216478704405904,4315,1993,6308,-
chr14,69885517,1.5564929112475792,4105,2960,7065,-
chr14,69885518,1.5117387033375094,9345,5938,15283,-
chr14,69885520,1.4528776894137878,7263,4417,11680,-
chr14,69885527,1.4314685999804055,1537,1037,2574,-
chr14,69885528,1.7725306416726745,1191,583,1774,-
chr14,69885538,2.428909952606635,2049,843,2892,-
chr14,69885539,2.1216947707067697,3348,1677,5025,-
chr14,69885545,2.990196078431372,914,339,1253,-
chr14,69885554,1.612079175628997,1419,849,2268,-
chr14,69885561,0.8348552924807651,1725,842,2567,-
chr14,69885562,1.2474549576011182,3247,1329,4576,-
chr14,69885563,1.4076976200594986,1581,723,2304,-
chr14,69885564,1.3112728270402463,3052,1250,4302,-
chr14,69885565,0.9211367075836555,912,312,1224,-
chr14,69885569,0.4005755483641884,788,418,1206,-
chr14,69885574,1.550359460048593,1097,549,1646,-
chr14,69885575,1.1989597780859915,677,411,1088,-
chr14,69885873,2.535946712408841,774,411,1185,-
chr14,69886048,1.1982433931892416,6588,5081,11669,-
chr14,69886081,1.3536411449305252,18628,11867,30495,-
chr14,69886082,1.3536411449305252,18628,11867,30495,-
chr14,69886112,1.6196549718937778,3056,2813,5869,-
chr14,69886139,1.5920915712799166,2124,1921,4045,-
chr14,69886140,1.0476584502769548,4101,3192,7293,-
chr14,69886141,1.0026776302242602,5240,4041,9281,-
chr14,69886142,0.8465098126672616,3373,2241,5614,-
chr14,69886143,0.9735758419611226,6474,4636,11110,-
chr14,69886144,1.4380650496141123,1053,906,1959,-
chr14,69886161,0.2182163187855788,689,526,1215,-
chr14,70342709,2.1295238095238096,601,489,1090,-
chr14,70342711,1.7180962343096235,656,477,1133,-
chr14,70342724,1.923217441174688,1351,1006,2357,-
chr14,70359552,3.010079405215519,1160,820,1980,-
chr14,70359586,0.6066017316017316,648,461,1109,-
chr14,70359638,1.2429740745863256,926,775,1701,-
chr14,70359682,0.34010720494747115,816,531,1347,-
chr14,70366778,2.2434449377103287,963,599,1562,-
chr14,70366831,2.383740071933814,639,455,1094,-
chr14,70592932,2.256097560975609,1738,1691,3429,-
chr14,70592938,2.175143001096589,1612,1466,3078,-
chr14,70592955,0.6454236405927227,1279,890,2169,-
chr14,70592965,1.0621230256522198,2455,2108,4563,-
chr14,70592970,2.0427040303673105,988,688,1676,-
chr14,70592979,3.1750375939849627,781,474,1255,-
chr14,70593308,1.1672859634308288,1563,1303,2866,-
chr14,70593323,2.3029032258064515,648,619,1267,-
chr14,73276205,1.7572351112174118,4897,3502,8399,-
chr14,73276206,1.7572351112174118,4897,3502,8399,-
chr14,73276207,1.7572351112174118,4897,3502,8399,-
chr14,73276225,1.9311111111111112,1263,799,2062,-
chr14,73276229,1.9549931287219424,1190,707,1897,-
chr14,73276246,1.1382910032319138,2207,1488,3695,-
chr14,73276248,1.7986651835372638,832,526,1358,-
chr14,73276266,1.4444692239072257,634,379,1013,-
chr14,73276278,1.1981819856392626,1284,809,2093,-
chr14,73276285,3.331019522776573,697,460,1157,-
chr14,74480274,1.452125555018244,1158,988,2146,-
chr14,74480276,1.7420804107642234,949,660,1609,-
chr14,74480717,1.6917694333177595,2842,2148,4990,-
chr14,74484469,1.7996453900709217,1294,1127,2421,-
chr14,74484531,2.286269430051813,705,578,1283,-
chr14,74484575,1.4462748462748465,828,776,1604,-
chr14,74484585,1.950680272108844,665,587,1252,-
chr14,74486361,4.471428571428572,625,489,1114,-
chr14,74486365,1.7039925140361822,606,457,1063,-
chr14,74486418,1.0241469400680865,923,742,1665,-
chr14,74486420,1.0241469400680865,923,742,1665,-
chr14,74493204,2.4926861702127656,651,375,1026,-
chr14,74493255,1.8573791071666883,1190,774,1964,-
chr14,74493304,1.8580649586883604,698,522,1220,-
chr14,74493305,0.5744563918757467,828,464,1292,-
chr14,74493306,0.5744563918757467,828,464,1292,-
chr14,74493307,0.5597004165861579,1042,624,1666,-
chr14,75053526,2.409762565657314,696,468,1164,-
chr14,75117214,1.8284574468085104,1274,815,2089,-
chr14,75117215,1.466650032880781,1735,1116,2851,-
chr14,75117252,1.3584874791452954,725,438,1163,-
chr14,75132037,1.361936845138762,678,415,1093,-
chr14,75134690,1.5179853229119502,1864,1299,3163,-
chr14,75134754,1.7771203155818538,741,545,1286,-
chr14,75134765,0.6450472667488696,1120,810,1930,-
chr14,75134801,1.4823032223983097,1097,630,1727,-
chr14,75134841,1.6826772883473913,694,581,1275,-
chr14,75135001,1.8475256769374415,841,594,1435,-
chr14,75147678,1.5948598464085533,2099,1486,3585,-
chr14,75147709,1.6747114375655825,1063,952,2015,-
chr14,75152109,1.7807952068155717,1359,1162,2521,-
chr14,75152122,0.6260869565217392,674,574,1248,-
chr14,75176397,0.6191346739792809,761,546,1307,-
chr14,75176438,2.199275362318841,606,413,1019,-
chr14,75176466,1.9015481373971936,1122,847,1969,-
chr14,75176467,1.9015481373971936,1122,847,1969,-
chr14,75176468,0.581512522427311,909,666,1575,-
chr14,75176471,1.6340647578271341,1061,807,1868,-
chr14,75176517,1.6654977070407337,1028,673,1701,-
chr14,75176558,1.8351799264112567,1193,823,2016,-
chr14,75595859,1.3577925943773441,770,566,1336,-
chr14,75651318,3.0519991015274037,1086,847,1933,-
chr14,75651319,3.0519991015274037,1086,847,1933,-
chr14,75651320,3.0519991015274037,1086,847,1933,-
chr14,75651383,1.4736414524170378,675,500,1175,-
chr14,76886661,0.6034770309069414,3362,2673,6035,-
chr14,76886663,0.6090747797020287,4822,3910,8732,-
chr14,76886664,0.6549503564428938,3040,2540,5580,-
chr14,76886678,0.9819978783404144,2141,1720,3861,-
chr14,76886680,1.0573194907025292,3779,3120,6899,-
chr14,76886681,1.2757853410209654,4720,3815,8535,-
chr14,76886687,1.6233042981579324,811,595,1406,-
chr14,76886691,1.5784313725490198,965,764,1729,-
chr14,76886693,1.2402604941291349,2551,1991,4542,-
chr14,76886694,1.48915390957202,1331,1019,2350,-
chr14,76886695,1.0508715855067012,1564,1200,2764,-
chr14,76886697,1.2996488764044942,1193,889,2082,-
chr14,76886698,0.9440313720352889,1113,763,1876,-
chr14,76886699,1.726806689879908,626,419,1045,-
chr14,77338582,1.2435998372268535,619,393,1012,-
chr14,77717978,2.0495409590442284,853,610,1463,-
chr14,77718011,2.4231640813579527,714,435,1149,-
chr14,77718144,2.5387323943661966,720,496,1216,-
chr14,77718178,0.6071428571428571,611,455,1066,-
chr14,77720813,0.2176767327758966,524,498,1022,-
chr14,77720815,0.6603450385415391,770,742,1512,-
chr14,77732544,1.3688760806916427,1999,1387,3386,-
chr14,77732559,1.5848305430340164,3663,2430,6093,-
chr14,77732561,1.415179679001508,1453,858,2311,-
chr14,77732565,1.758520946607769,3211,2074,5285,-
chr14,77732582,1.7477592829705508,1889,1064,2953,-
chr14,77732584,1.6691409562082746,4684,2674,7358,-
chr14,77732586,1.8719808182635254,6760,3866,10626,-
chr14,77732587,2.1323619081779053,2556,1359,3915,-
chr14,77732588,1.9104174170851729,4368,2398,6766,-
chr14,77732593,2.229458017925937,2635,1462,4097,-
chr14,77732595,1.8360744801699014,1486,793,2279,-
chr14,77734991,0.5797101449275363,839,440,1279,-
chr14,77737061,2.2196859338486172,766,563,1329,-
chr14,77751409,3.101351351351352,611,443,1054,-
chr14,77751410,3.101351351351352,611,443,1054,-
chr14,81246575,0.5649748417756028,700,450,1150,-
chr14,89931573,1.9975999999999998,680,449,1129,-
chr14,89931574,1.8842012910606307,1053,635,1688,-
chr14,91458845,2.4359269718042182,1383,1126,2509,-
chr14,91458847,2.5529556650246303,1381,1014,2395,-
chr14,91458848,2.0680881455608646,1324,1007,2331,-
chr14,91462750,2.048567970956031,2115,1664,3779,-
chr14,91462751,2.048567970956031,2115,1664,3779,-
chr14,91462752,2.048567970956031,2115,1664,3779,-
chr14,91462754,3.0354759395855284,595,437,1032,-
chr14,91787528,0.9096714301817068,1677,1159,2836,-
chr14,91787536,1.0631905674928945,565,458,1023,-
chr14,92117605,2.7692821368948253,753,598,1351,-
chr14,92117606,2.5139130434782606,1120,873,1993,-
chr14,92117608,2.463326071169208,741,566,1307,-
chr14,92117618,2.315446717274638,869,648,1517,-
chr14,92117625,1.7010780448726153,984,722,1706,-
chr14,92117628,2.4075901328273246,1219,849,2068,-
chr14,92117629,2.4075901328273246,1219,849,2068,-
chr14,92117632,2.9154342506865483,1074,639,1713,-
chr14,92121685,1.1587713814256604,1258,648,1906,-
chr14,92121692,0.7316485853262343,1283,678,1961,-
chr14,92940739,2.230829596412556,736,445,1181,-
chr14,92940746,1.747709938801404,660,491,1151,-
chr14,92940774,3.1737037037037035,778,359,1137,-
chr14,94051457,2.6058078198271875,1111,794,1905,-
chr14,94051458,2.5577378717602612,1035,772,1807,-
chr14,94053097,1.2695443444025802,893,627,1520,-
chr14,94055015,1.7205534446913753,749,480,1229,-
chr14,94055065,2.799163105099923,1103,826,1929,-
chr14,94060598,2.7338413096953533,640,417,1057,-
chr14,94060950,1.321967259029393,980,792,1772,-
chr14,94062134,3.905004097653554,620,388,1008,-
chr14,94062613,2.759322033898305,850,589,1439,-
chr14,94079054,0.8371051300721716,910,714,1624,-
chr14,94079219,2.580718469224274,759,541,1300,-
chr14,94079263,2.3359127851929586,1201,805,2006,-
chr14,94079264,2.153311258278145,928,603,1531,-
chr14,94079516,1.8809041835357623,668,467,1135,-
chr14,94081201,0.7383535147937843,787,440,1227,-
chr14,98972936,1.1946863170822088,50889,39898,90787,-
chr14,98972937,1.4078240761252914,23581,19306,42887,-
chr14,98972939,1.4977757007213708,15236,12316,27552,-
chr14,98972951,0.9524261268146293,15463,11672,27135,-
chr14,98972972,1.317616882508559,13326,8267,21593,-
chr14,98973068,1.2105305710794003,21386,16850,38236,-
chr14,98973069,1.1965300358362683,25308,17564,42872,-
chr14,98973072,1.203016112848383,11981,9379,21360,-
chr14,98973073,0.5809674563481211,7265,5843,13108,-
chr14,98973075,1.2805983338240334,10880,8523,19403,-
chr14,98973170,1.2585314395067444,19701,14447,34148,-
chr14,98973173,1.1351917941550824,7447,4713,12160,-
chr14,98973177,1.2345207073980502,4178,3286,7464,-
chr14,98973187,1.0740144205423696,10361,7762,18123,-
chr14,98973188,0.9870363624675909,5757,4858,10615,-
chr14,98973190,1.1184371538774285,13605,9182,22787,-
chr14,98973191,1.0097275978265343,12300,8169,20469,-
chr14,98973192,1.156377522625096,12540,7737,20277,-
chr14,98973194,1.31173412713331,11977,7680,19657,-
chr14,98973195,1.2602549547572464,15183,10630,25813,-
chr14,98973196,1.3019045173622077,8926,5218,14144,-
chr14,98973197,1.273061992550218,9624,7843,17467,-
chr14,98973198,1.0932858565436494,5660,3206,8866,-
chr14,98973200,1.4601347629291115,6386,4367,10753,-
chr14,98973203,1.5302869606883123,3639,2435,6074,-
chr14,98973248,0.8848207423295303,6818,4801,11619,-
chr14,98973249,1.017504039687471,8756,5978,14734,-
chr14,98973251,1.0270908376391292,10455,7928,18383,-
chr14,98973252,0.8168250656024065,6455,5227,11682,-
chr14,98973275,1.8140324100394543,2766,2013,4779,-
chr14,98973278,0.7431050843857987,2260,1787,4047,-
chr14,98973281,0.5265151515151515,555,494,1049,-
chr14,98973285,0.7333333333333334,1097,914,2011,-
chr14,98973288,0.5211451373057195,1616,1423,3039,-
chr14,98973290,0.4856724708543298,1536,917,2453,-
chr14,98973291,0.46214095202814176,1879,1237,3116,-
chr14,98973294,0.6864,571,549,1120,-
chr14,100334197,2.0567685589519646,627,457,1084,-
chr14,100334330,1.6056938211160976,1287,1025,2312,-
chr14,100334518,0.5997938409998712,734,596,1330,-
chr14,100334521,2.7777777777777786,924,591,1515,-
chr14,100334561,2.21517022154776,1142,801,1943,-
chr14,100334916,2.049909956264472,995,597,1592,-
chr14,100334923,2.669476911285687,773,613,1386,-
chr14,100334926,2.104562322636979,621,508,1129,-
chr14,100334961,0.6050489156461655,803,621,1424,-
chr14,100334968,1.1517268321561824,1380,1100,2480,-
chr14,100335006,1.9238329238329241,809,554,1363,-
chr14,100337198,0.9549430996775032,1537,1017,2554,-
chr14,100337199,1.2024018243544203,2223,1470,3693,-
chr14,100342410,0.6393066640180529,1767,1541,3308,-
chr14,100342414,0.4117647058823529,657,516,1173,-
chr14,100342459,1.5423827744989946,1011,906,1917,-
chr14,100342464,1.789495056772924,1847,1488,3335,-
chr14,100342465,0.387887720238494,771,648,1419,-
chr14,100342466,1.789495056772924,1847,1488,3335,-
chr14,100342468,2.678728070175439,697,607,1304,-
chr14,100342494,1.7322117610742398,782,626,1408,-
chr14,100342517,2.3377551020408163,868,538,1406,-
chr14,100342518,2.317073170731708,797,573,1370,-
chr14,100342521,1.167605303296961,1530,946,2476,-
chr14,100342522,1.167605303296961,1530,946,2476,-
chr14,100342526,2.0802608477552043,637,442,1079,-
chr14,100342558,0.47382855439583144,1472,1083,2555,-
chr14,100343296,1.652533159382474,799,656,1455,-
chr14,100346792,2.63276332094176,1083,806,1889,-
chr14,100346826,1.7185714285714284,1202,769,1971,-
chr14,100353794,2.0695524968415446,1003,556,1559,-
chr14,100353815,1.800522648083624,688,573,1261,-
chr14,100354514,0.6082825570587628,1139,841,1980,-
chr14,100354522,2.030138612182612,1018,760,1778,-
chr14,100361809,1.6369028006589783,827,606,1433,-
chr14,100361882,1.5182670772676372,1032,607,1639,-
chr14,100369205,0.5773619598723704,627,450,1077,-
chr14,100369240,1.0052697827506107,1852,1350,3202,-
chr14,100369241,0.77316822500188,1401,972,2373,-
chr14,100369242,0.77316822500188,1401,972,2373,-
chr14,100375465,0.8462921453254878,658,497,1155,-
chr14,100375467,0.7457889338005632,916,663,1579,-
chr14,100375472,0.42697460951957955,720,512,1232,-
chr14,100375474,0.8565494799998237,1242,914,2156,-
chr14,100375475,1.1064575349398345,991,797,1788,-
chr14,102081326,1.6239867564790507,2942,2304,5246,-
chr14,102081389,1.5797722604042503,5369,4584,9953,-
chr14,102081522,0.8789546188786205,14249,10314,24563,-
chr14,102081528,1.5233469771901942,5417,5042,10459,-
chr14,102081547,1.4049515820290506,7393,5991,13384,-
chr14,102081548,1.364944260643528,14842,10889,25731,-
chr14,102081609,1.749757090518236,7899,6339,14238,-
chr14,102081614,1.4612004037580557,2067,1589,3656,-
chr14,102082133,1.366336633663366,1770,1312,3082,-
chr14,102082256,0.7083684108086421,12664,9079,21743,-
chr14,102082292,1.4755210070656166,6830,4762,11592,-
chr14,102083614,2.367377188029362,1972,1287,3259,-
chr14,102083843,1.1821212877011034,30951,18548,49499,-
chr14,102083855,1.7852821451768237,13654,8711,22365,-
chr14,102083879,0.8011055185766349,8234,4938,13172,-
chr14,102083904,1.8540063660815254,26724,15310,42034,-
chr14,102083938,1.5622605363984672,3494,2429,5923,-
chr14,102083942,0.6865070553630797,9603,5323,14926,-
chr14,102083946,1.8244240837696335,5360,3399,8759,-
chr14,102083948,1.8244240837696335,5360,3399,8759,-
chr14,102083964,1.7404202496219563,4701,2734,7435,-
chr14,102084461,1.4070359464207889,8238,5339,13577,-
chr14,102084522,1.243421532048853,4086,3015,7101,-
chr14,102084544,1.4623699726762858,2515,1813,4328,-
chr14,102084801,1.3620303298764915,5807,3713,9520,-
chr14,102085388,1.3316993464052287,3484,2600,6084,-
chr14,102085397,0.9745623914555945,10733,6689,17422,-
chr14,102085403,1.2840774226959843,2754,1914,4668,-
chr14,102085406,0.9224641618677212,16808,10261,27069,-
chr14,102085408,0.8035887379184761,16872,10324,27196,-
chr14,102085409,0.9237956872407231,15143,9696,24839,-
chr14,102085410,1.2473470527108923,8814,5802,14616,-
chr14,102085425,1.5964087934217153,1660,1110,2770,-
chr14,102085429,1.9847960258919157,1464,948,2412,-
chr14,102085898,1.2380780198220591,7891,5200,13091,-
chr14,102085900,1.1098531741407625,10719,7597,18316,-
chr14,102085926,1.5971946411813338,3850,2221,6071,-
chr14,102086091,1.208504526171627,12583,8159,20742,-
chr14,102086099,1.2730052189746366,31466,21691,53157,-
chr14,102086103,1.3629642780839395,23321,17012,40333,-
chr14,102086104,1.6038635175010976,10829,8225,19054,-
chr14,102086115,1.3427699955449537,15238,9271,24509,-
chr14,102086116,1.3065063674973905,19620,12441,32061,-
chr14,102086119,1.4839670299886982,18732,12847,31579,-
chr14,102086260,1.370387896651028,3753,1998,5751,-
chr14,102086355,1.5156880977683316,1702,940,2642,-
chr14,102086361,1.426660358860947,3972,1906,5878,-
chr14,102086368,1.6800299770883766,5762,3573,9335,-
chr14,102087043,0.9632778767583305,11498,5190,16688,-
chr14,102968507,1.3865249518607121,550,531,1081,-
chr14,103519801,1.540142276422764,1298,737,2035,-
chr14,103519824,0.45839365538950017,992,749,1741,-
chr14,103519867,1.5651260504201683,744,407,1151,-
chr14,103520012,3.3347978804826908,1827,1284,3111,-
chr14,103520035,1.8269332487041148,784,410,1194,-
chr14,103520308,2.552766393442623,603,487,1090,-
chr14,103520509,1.4829114737247848,1125,723,1848,-
chr14,103520529,1.8062714776632305,724,484,1208,-
chr14,103520579,0.5257787320469545,1865,1387,3252,-
chr14,103520581,0.5938755020080322,1351,995,2346,-
chr14,103520582,1.5873015873015874,995,746,1741,-
chr14,103520583,1.2647709614128875,2642,1682,4324,-
chr14,103520584,1.0473780772966557,1647,936,2583,-
chr14,103520587,0.4783144724823312,1140,755,1895,-
chr14,103521398,2.3240874407094245,682,372,1054,-
chr14,103521431,3.4366379310344826,937,463,1400,-
chr14,103521433,3.4366379310344826,937,463,1400,-
chr14,103521935,1.3363097588473263,730,509,1239,-
chr14,103522128,2.262865231018097,721,470,1191,-
chr14,103912635,1.0171900034768244,47434,27208,74642,-
chr14,103912636,1.227113090129699,92151,56884,149035,-
chr14,103912637,1.1835005244707908,126756,77091,203847,-
chr14,103912638,1.2381433079333393,120690,73823,194513,-
chr14,103912639,1.2082411242048132,112908,67932,180840,-
chr14,103912640,1.2610119625517102,96715,57357,154072,-
chr14,103912641,1.3422814847031377,56295,34265,90560,-
chr14,103912642,1.2387809778376369,54289,31948,86237,-
chr14,103912643,1.9249958484389047,11384,7858,19242,-
chr14,103912647,1.649208126699728,6533,3947,10480,-
chr14,103912648,1.649208126699728,6533,3947,10480,-
chr14,103912696,0.7085364158214911,913,718,1631,-
chr14,103912697,0.5747164920386144,621,508,1129,-
chr14,103915111,1.6125310962354915,2334,1612,3946,-
chr14,103915133,1.8473584996858239,1910,1216,3126,-
chr14,103921508,0.7511549250025202,3282,2498,5780,-
chr14,103921509,0.6803447317208784,1747,1307,3054,-
chr14,103921525,0.5137109766954429,1130,995,2125,-
chr14,103921527,0.8246268677273523,2365,2250,4615,-
chr14,103921528,0.9035190173101445,1330,1294,2624,-
chr14,104769473,3.8787313432835813,755,401,1156,-
chr14,104769738,2.9640742870649914,1083,1224,2307,-
chr14,104769751,4.241057764962405,1088,950,2038,-
chr14,104769753,3.715318114133287,633,507,1140,-
chr14,104769757,19.458141117414083,690,476,1166,-
chr14,104770798,0.7016002820135535,584,441,1025,-
chr14,104772998,2.342786817273188,562,590,1152,-
chr14,104773000,2.820908173468266,595,618,1213,-
chr14,104773290,2.6784067939703595,627,437,1064,-
chr14,105010225,1.6766118809689654,559,446,1005,-
chr14,105010437,1.935483870967742,1409,650,2059,-
chr14,105010438,1.935483870967742,1409,650,2059,-
chr14,105010443,0.4857594936708861,920,473,1393,-
chr14,105010447,0.5840896358543418,801,424,1225,-
chr14,105978514,1.5375056689342403,1473,979,2452,-
chr14,105978530,0.33521949881194696,992,661,1653,-
chr14,105978633,1.1894995898277276,637,582,1219,-
chr14,105978635,1.1675839861369008,1469,1322,2791,-
chr14,105978636,1.113923816972723,2295,1953,4248,-
chr14,105978638,1.1189445680177204,1014,860,1874,-
chr14,105978763,1.023749918631798,34906,29664,64570,-
chr14,105978764,0.9359048551274084,67055,56683,123738,-
chr14,105978765,0.9456555179349894,71489,60977,132466,-
chr14,105978766,0.9786323849038392,48854,41816,90670,-
chr14,105978767,1.0785504355666755,18316,17721,36037,-
chr14,105978768,1.1738259268864553,29182,24841,54023,-
chr14,105978772,0.9550739623967698,12481,9922,22403,-
chr14,105978773,1.028016918484712,8919,6530,15449,-
chr14,105978776,1.128782350202367,9506,8616,18122,-
chr14,105978777,1.1308719975729515,15509,13326,28835,-
chr14,105978778,1.0767453358491328,6011,4308,10319,-
chr14,105978779,1.0194774226642502,13460,10795,24255,-
chr14,105978781,1.055793650793651,2007,1799,3806,-
chr14,105978784,1.4380522128811992,2337,1917,4254,-
chr14,105978785,1.5367222828629348,656,582,1238,-
chr14,105978786,1.1596272144795352,1958,1737,3695,-
chr14,105978788,1.09999003389543,2298,2046,4344,-
chr14,105978789,0.9988270608414894,1409,1271,2680,-
chr14,105978790,1.062777618947714,2259,1825,4084,-
chr14,105978791,1.184427131456317,1973,1575,3548,-
chr15,22869552,1.9166666666666663,827,503,1330,-
chr15,23024825,2.0253241491085903,768,616,1384,-
chr15,23024826,2.0253241491085903,768,616,1384,-
chr15,24909347,1.5480078827863941,1456,1060,2516,-
chr15,24909354,1.9091918041413118,2260,1591,3851,-
chr15,24909359,1.4995726495726496,967,719,1686,-
chr15,24909362,1.7773544973544977,883,539,1422,-
chr15,24909363,0.5804651162790698,831,599,1430,-
chr15,24909365,1.4969230769230768,694,519,1213,-
chr15,24909385,2.2634361233480176,733,453,1186,-
chr15,24909386,2.2634361233480176,733,453,1186,-
chr15,24909389,2.0770931603773586,670,423,1093,-
chr15,24909390,2.135139829059876,1220,723,1943,-
chr15,24909392,1.6821538491825865,941,524,1465,-
chr15,25339234,2.035692307692308,826,624,1450,-
chr15,25339241,1.19546697901331,1926,1247,3173,-
chr15,25339243,1.468786808009423,1246,848,2094,-
chr15,25339246,1.5089264293261817,1163,736,1899,-
chr15,25339249,1.382009219515681,695,443,1138,-
chr15,25340189,0.6794503949003645,1014,638,1652,-
chr15,25340190,0.6794503949003645,1014,638,1652,-
chr15,25371039,2.064540719095413,624,462,1086,-
chr15,25438539,5.167497170970926,550,568,1118,-
chr15,25438540,4.788337620348155,588,853,1441,-
chr15,30407961,0.6091163738222561,1195,1070,2265,-
chr15,30407962,0.5889756328365271,1555,1408,2963,-
chr15,30407963,0.5889756328365271,1555,1408,2963,-
chr15,30407964,0.7276190476190476,1145,1049,2194,-
chr15,32518113,1.5999999999999999,747,769,1516,-
chr15,32518122,2.299472338148289,1012,778,1790,-
chr15,32518177,1.9996465650541193,741,502,1243,-
chr15,32518178,2.0865566565898335,949,606,1555,-
chr15,34084246,2.2150037792894937,1246,755,2001,-
chr15,34084278,1.6350563430375484,1664,1170,2834,-
chr15,34084306,2.203994866035617,784,541,1325,-
chr15,34084344,1.7933884297520657,657,516,1173,-
chr15,34084484,2.2198704103671707,570,462,1032,-
chr15,34101623,1.1536053759291125,1644,1278,2922,-
chr15,34101624,0.3976722628489031,701,510,1211,-
chr15,34101670,1.1395675670268197,29474,20400,49874,-
chr15,34101671,1.1914002021684427,32278,22706,54984,-
chr15,34101672,1.4009449510139502,38130,28199,66329,-
chr15,34101673,1.6528298032420803,20101,16675,36776,-
chr15,34101683,0.6309167734890566,3698,3008,6706,-
chr15,34101686,0.5955506815293653,5517,4809,10326,-
chr15,34101691,3.8722274499260654,2173,1383,3556,-
chr15,34101692,5.333935299429869,4700,4209,8909,-
chr15,34101702,0.605481162069191,10078,7803,17881,-
chr15,34101703,0.6193124270267786,10798,7906,18704,-
chr15,34101705,0.6284389700940861,3234,1983,5217,-
chr15,34101713,0.7444059001732044,3020,2516,5536,-
chr15,34101719,2.6409158762136,2995,2589,5584,-
chr15,34101723,28.195645799765497,12937,9094,22031,-
chr15,34101724,28.195645799765497,12937,9094,22031,-
chr15,34101725,28.195645799765497,12937,9094,22031,-
chr15,34101730,20.9071703461198,8281,2775,11056,-
chr15,34101731,20.907170346119802,8281,2775,11056,-
chr15,34101734,5.731452455590388,1096,260,1356,-
chr15,34101740,2.895384615384616,940,259,1199,-
chr15,34101742,3.012232805615824,3423,854,4277,-
chr15,34101777,0.4643756971298296,2953,1197,4150,-
chr15,34101780,0.5772985781990521,936,421,1357,-
chr15,34101818,1.2699111782813806,755,529,1284,-
chr15,34101820,1.8050872817955117,695,400,1095,-
chr15,34101823,3.2698412698412698,720,503,1223,-
chr15,34101825,3.2698412698412698,720,503,1223,-
chr15,34342051,2.4946236559139785,811,650,1461,-
chr15,34342087,2.315820865848203,895,648,1543,-
chr15,34342088,1.4583117043628724,1203,929,2132,-
chr15,34343083,1.5272983580915045,2875,1630,4505,-
chr15,34343084,1.5324583641332998,5000,3203,8203,-
chr15,34343100,0.6885428511754195,1379,1050,2429,-
chr15,34343102,1.5409207161125318,963,475,1438,-
chr15,34343126,0.6271666756311058,2028,1646,3674,-
chr15,34343157,1.0072867342429503,2095,1782,3877,-
chr15,34343158,1.0658668675421574,2243,1901,4144,-
chr15,34343159,1.0215655685050933,703,640,1343,-
chr15,34360189,2.372526851328434,1398,975,2373,-
chr15,34360190,1.9729292406798908,1769,1215,2984,-
chr15,34361441,1.6969936708860758,584,473,1057,-
chr15,34361442,1.6969936708860758,584,473,1057,-
chr15,34362216,2.7859223782962936,632,468,1100,-
chr15,34489965,2.8674429782780133,1142,656,1798,-
chr15,34489967,2.1665327978580997,713,414,1127,-
chr15,34490074,2.1576549003604706,720,506,1226,-
chr15,34490081,1.4028332696401533,3260,2171,5431,-
chr15,34490091,2.203552610012021,1762,1135,2897,-
chr15,34490093,2.642857142857143,924,594,1518,-
chr15,34490130,0.56,657,469,1126,-
chr15,34979641,7.3956843892285375,593,508,1101,-
chr15,34979642,6.175839826445684,775,780,1555,-
chr15,34979643,4.560850728114001,533,563,1096,-
chr15,40036333,0.2884760403098649,2103,1508,3611,-
chr15,40036359,1.3637937002422982,1969,1187,3156,-
chr15,40036368,1.4411732988245445,1027,842,1869,-
chr15,40036380,2.0767586567235075,1387,1137,2524,-
chr15,40036433,1.5807722616233253,1002,845,1847,-
chr15,40036437,1.6570682668329175,988,801,1789,-
chr15,40036492,1.7127396413110703,2100,1616,3716,-
chr15,40036494,1.7127396413110703,2100,1616,3716,-
chr15,40036499,1.437888198757764,1388,965,2353,-
chr15,40038342,2.0677795764198037,2712,2117,4829,-
chr15,40038366,1.7453750148781693,3698,2556,6254,-
chr15,40038367,1.6330763469577148,5375,3693,9068,-
chr15,40038371,1.5322314049586778,1647,1055,2702,-
chr15,40038374,0.4901074535220877,2462,1598,4060,-
chr15,40038917,1.8093577158802128,2135,1315,3450,-
chr15,40039136,2.092194888245464,1394,786,2180,-
chr15,40039137,2.4322513239903447,1163,676,1839,-
chr15,40039138,2.092194888245464,1394,786,2180,-
chr15,40039149,2.5064935064935066,1157,692,1849,-
chr15,40039150,1.7894853928726442,1792,1130,2922,-
chr15,40039151,2.5064935064935066,1157,692,1849,-
chr15,40039160,0.7439946246534409,2138,1227,3365,-
chr15,40039161,0.86948435171386,847,609,1456,-
chr15,40039162,0.701683162448883,876,469,1345,-
chr15,40736130,2.750987443657711,672,477,1149,-
chr15,40736480,16.617408240458087,1573,1083,2656,-
chr15,40776588,1.911286908267034,772,503,1275,-
chr15,40872293,5.048271900625574,602,524,1126,-
chr15,40872428,3.5139632853789298,567,562,1129,-
chr15,40872441,6.208679613453789,602,408,1010,-
chr15,40872646,1.8944688031007137,4489,3643,8132,-
chr15,40872647,2.5768564338262285,1856,1660,3516,-
chr15,40872654,3.2093586875466067,1564,1191,2755,-
chr15,40872656,3.2093586875466067,1564,1191,2755,-
chr15,40872667,2.1562046327407076,1411,953,2364,-
chr15,40872692,0.5901935606601038,729,488,1217,-
chr15,41309718,1.54940613730579,654,470,1124,-
chr15,41313317,4.1407942900101,774,736,1510,-
chr15,41313327,1.2252508406494484,874,605,1479,-
chr15,41313329,1.6511200137669355,997,722,1719,-
chr15,42159167,0.5199684115523465,837,553,1390,-
chr15,42159179,1.5988287072467875,1888,1217,3105,-
chr15,42159206,2.3457402073772595,601,424,1025,-
chr15,42159213,3.717039648334008,600,414,1014,-
chr15,42162349,4.365483407079646,684,416,1100,-
chr15,42162351,3.533598975823628,694,394,1088,-
chr15,43805453,3.0722229281954068,594,442,1036,-
chr15,43813063,1.5119695591033169,1548,1098,2646,-
chr15,43813066,1.7634225004742934,1429,1003,2432,-
chr15,43813082,2.7564652191951318,1811,1032,2843,-
chr15,43813084,2.7564652191951318,1811,1032,2843,-
chr15,43813098,2.3746170223814715,1428,916,2344,-
chr15,43813261,2.1856441430909515,983,657,1640,-
chr15,43813287,1.814297250124292,928,623,1551,-
chr15,43813288,0.5724540978325894,1243,700,1943,-
chr15,43813290,2.0017117353889553,984,695,1679,-
chr15,43813294,2.0237119437939106,668,426,1094,-
chr15,45198603,2.0887909319899247,641,396,1037,-
chr15,45200411,1.2716480920175823,585,615,1200,-
chr15,45200426,0.7421596244131455,607,425,1032,-
chr15,47730468,1.4294671482210792,4281,3586,7867,-
chr15,47730470,1.4148046815625477,1789,1547,3336,-
chr15,47730471,1.1213010045720087,2224,1856,4080,-
chr15,47730473,0.848524966864243,1998,1599,3597,-
chr15,48762549,2.501812688821752,636,661,1297,-
chr15,48762551,2.501812688821752,636,661,1297,-
chr15,48762557,2.979727304755539,523,486,1009,-
chr15,49127557,2.558219178082192,746,583,1329,-
chr15,49128092,1.9768837803320563,672,434,1106,-
chr15,49133793,1.5837104072398194,809,662,1471,-
chr15,49134068,0.5906513713080168,1155,767,1922,-
chr15,49134069,0.4981202213492164,736,606,1342,-
chr15,49134070,1.9216461288072544,854,560,1414,-
chr15,49134496,2.863013698630137,835,583,1418,-
chr15,49145020,1.996045627376426,771,525,1296,-
chr15,50286097,2.167557484450113,700,474,1174,-
chr15,51537675,1.7330424468477257,907,563,1470,-
chr15,51938220,2.107908775704957,563,466,1029,-
chr15,51965841,1.0874890911357686,942,616,1558,-
chr15,51965842,1.0874890911357686,942,616,1558,-
chr15,51966266,1.5182260371959944,1233,698,1931,-
chr15,51966272,1.8411343612334805,742,453,1195,-
chr15,51966316,0.4023357664233577,847,547,1394,-
chr15,51966318,0.7194623027469316,1230,811,2041,-
chr15,51966319,0.922842401500938,786,532,1318,-
chr15,51966331,1.7844101123595504,725,355,1080,-
chr15,52547652,2.0585856890297505,718,461,1179,-
chr15,52549756,3.0877697841726617,811,694,1505,-
chr15,52549759,2.4422844908154766,1528,1200,2728,-
chr15,52549760,2.4422844908154766,1528,1200,2728,-
chr15,52549767,3.5974842767295594,659,476,1135,-
chr15,52549771,2.062382797849732,610,420,1030,-
chr15,52549774,2.1975472323500167,764,430,1194,-
chr15,52551865,1.568717477808387,999,725,1724,-
chr15,52551950,2.3092779764751317,712,515,1227,-
chr15,52557171,1.239981578005759,1157,867,2024,-
chr15,52557201,2.653730880713606,723,559,1282,-
chr15,52568923,2.866654407758527,605,407,1012,-
chr15,55181451,1.3804341408694625,2191,1707,3898,-
chr15,55181611,1.5997118855873371,1462,1107,2569,-
chr15,55181612,1.4105693081635702,1887,1180,3067,-
chr15,55181638,1.550783334141728,1420,777,2197,-
chr15,55182144,1.3540603700097371,1805,1299,3104,-
chr15,55183333,1.4406779661016949,1257,707,1964,-
chr15,55185400,1.6389702468817178,20113,18044,38157,-
chr15,55185401,1.6582788552805916,19744,18679,38423,-
chr15,55185402,1.6582788552805916,19744,18679,38423,-
chr15,55185403,1.6752871451236016,14547,13605,28152,-
chr15,55185412,1.5721869657975094,7921,6311,14232,-
chr15,55185413,1.5721869657975094,7921,6311,14232,-
chr15,55191004,1.3774324546372152,2444,1468,3912,-
chr15,55191005,1.5390279823269517,2254,1357,3611,-
chr15,55191014,1.464661556550824,6362,3974,10336,-
chr15,55191015,1.5145141727685192,4061,2259,6320,-
chr15,55191017,1.335483870967742,2069,1549,3618,-
chr15,55191018,0.678576798480023,1772,981,2753,-
chr15,55191026,1.392605947293447,1690,1247,2937,-
chr15,55191028,1.3531324725011955,1644,1229,2873,-
chr15,55191029,1.6625914765389582,1412,1009,2421,-
chr15,55192811,1.6563436563436564,1657,1231,2888,-
chr15,55196849,1.529362302387383,3272,2772,6044,-
chr15,55196873,1.5333383054892602,1868,1256,3124,-
chr15,55196889,1.6412727272727272,1529,1099,2628,-
chr15,55196917,1.8521323700769048,934,612,1546,-
chr15,55196922,1.785349794238683,747,485,1232,-
chr15,55196930,1.0176672115363086,987,628,1615,-
chr15,55196932,1.1816464464128291,1361,860,2221,-
chr15,55196934,1.575873148140729,1489,910,2399,-
chr15,55196935,1.7539172120342978,1798,1179,2977,-
chr15,55196936,1.6278688524590164,1323,759,2082,-
chr15,55196937,1.602961432506887,949,527,1476,-
chr15,55359129,1.9024472008045592,680,470,1150,-
chr15,55359220,1.316171637574354,8745,4833,13578,-
chr15,55359222,1.356283392934317,5362,2952,8314,-
chr15,55359226,1.392077707913814,5082,2668,7750,-
chr15,55359231,1.371391878669276,2274,1167,3441,-
chr15,55359245,1.7099013518450858,1559,781,2340,-
chr15,55359391,1.6989234931782855,951,598,1549,-
chr15,55359490,1.59764786676968,1005,705,1710,-
chr15,55359526,1.4999534110294013,8426,4967,13393,-
chr15,55359543,1.3262586459628023,4711,3040,7751,-
chr15,55359577,1.5157682434910156,3542,1817,5359,-
chr15,55359839,3.1122495654560427,971,642,1613,-
chr15,55360038,1.0513343533201096,1589,1143,2732,-
chr15,55360105,3.118884540117417,749,583,1332,-
chr15,55360136,1.8631379962192816,769,574,1343,-
chr15,55360492,0.5856851491723188,1028,726,1754,-
chr15,55360504,2.085167958656331,916,773,1689,-
chr15,55360926,2.991452991452992,594,458,1052,-
chr15,55360935,2.0219899675250654,1399,984,2383,-
chr15,55365299,0.5326583528830721,718,622,1340,-
chr15,55371910,2.423175234308435,631,502,1133,-
chr15,55371933,1.7052036731810691,851,547,1398,-
chr15,55371994,1.5695390781563126,711,498,1209,-
chr15,55372012,2.0593869731800765,687,463,1150,-
chr15,55378344,2.5466956251939186,911,585,1496,-
chr15,55389400,1.8266250947873632,1024,754,1778,-
chr15,55389414,2.2862654511446254,745,560,1305,-
chr15,55545058,1.8475308785213258,752,625,1377,-
chr15,55545060,2.2721893491124256,575,506,1081,-
chr15,55873990,3.330087633885103,683,552,1235,-
chr15,55873999,1.3548387096774193,799,495,1294,-
chr15,55874005,2.6206967525995166,1396,953,2349,-
chr15,55874007,2.6206967525995166,1396,953,2349,-
chr15,55924663,2.401435406698565,716,417,1133,-
chr15,55924664,2.401435406698565,716,417,1133,-
chr15,58627747,0.8615618854497785,658,425,1083,-
chr15,58879681,2.3225806451612905,575,433,1008,-
chr15,58879683,2.3225806451612905,575,433,1008,-
chr15,58887508,2.8943811655867697,751,531,1282,-
chr15,58894138,2.296296296296296,650,440,1090,-
chr15,58899663,2.0146780373755147,741,644,1385,-
chr15,59136717,0.4691325292024299,468,568,1036,-
chr15,59136721,0.414463452437547,569,823,1392,-
chr15,59136722,0.38426584244391737,659,984,1643,-
chr15,59171932,2.4180125854459655,587,428,1015,-
chr15,59173910,2.3794189208530128,664,410,1074,-
chr15,59208798,1.3287841191066998,764,402,1166,-
chr15,59208799,1.3287841191066998,764,402,1166,-
chr15,59223098,4.237433688028114,672,447,1119,-
chr15,59638992,3.4804292929292937,1042,692,1734,-
chr15,59650725,1.629933211900425,766,487,1253,-
chr15,59671232,2.4239759036144584,648,414,1062,-
chr15,59671233,1.902210453281242,845,583,1428,-
chr15,59677927,2.678413073772223,843,550,1393,-
chr15,60347510,1.278548578943975,9938,7211,17149,-
chr15,60347603,1.3987176726921984,9581,5595,15176,-
chr15,60347604,1.3694134836024636,17175,11446,28621,-
chr15,60347605,1.4131576577928509,4084,3028,7112,-
chr15,60347666,1.345844995658377,8443,4838,13281,-
chr15,60347667,1.3159487045074778,8556,4995,13551,-
chr15,60347672,1.3838816385716874,2371,1838,4209,-
chr15,60347683,1.3569135508454395,2125,1104,3229,-
chr15,60347687,1.5490505614008794,2829,1573,4402,-
chr15,60349111,0.5526102464332037,801,513,1314,-
chr15,60349118,0.6766250596821499,1487,1085,2572,-
chr15,60351224,1.4371976647206006,2153,1634,3787,-
chr15,60351238,1.5225640595747059,1945,1358,3303,-
chr15,60351765,0.5780220404453533,1731,1466,3197,-
chr15,60351775,1.9269487750556797,720,448,1168,-
chr15,60351783,1.4827674897119345,1152,971,2123,-
chr15,60351795,1.8479130931961119,807,423,1230,-
chr15,60351800,1.4210581898827754,695,556,1251,-
chr15,60351801,1.2360528410454676,924,579,1503,-
chr15,60354169,1.4274065685164214,4109,2648,6757,-
chr15,60354175,1.5526607178489966,4834,3245,8079,-
chr15,60354177,1.3237012837620208,2551,2320,4871,-
chr15,60354182,1.172092494967984,5738,4268,10006,-
chr15,60354185,2.040517451793996,1044,722,1766,-
chr15,60354199,1.4506060754772538,1502,860,2362,-
chr15,60354201,1.6681420483787959,875,669,1544,-
chr15,60354206,2.0276052449965496,677,413,1090,-
chr15,60354207,1.5638032990974162,772,566,1338,-
chr15,60354208,1.0985915492957747,2414,1987,4401,-
chr15,60354209,1.8703071672354952,1095,585,1680,-
chr15,60354210,1.0985915492957747,2414,1987,4401,-
chr15,60355962,3.381040320098492,844,341,1185,-
chr15,60355964,3.381040320098492,844,341,1185,-
chr15,60355969,1.5909193804291994,1217,790,2007,-
chr15,60355971,1.452453788076022,1025,667,1692,-
chr15,60364496,1.1810351897207558,10971,8283,19254,-
chr15,60364518,1.4581741867785938,1417,952,2369,-
chr15,60382401,1.4538507641594245,938,851,1789,-
chr15,60382406,1.1075103063406404,9329,6933,16262,-
chr15,60382408,1.0403562106989088,6139,4468,10607,-
chr15,60382420,1.4035725782562711,3142,2406,5548,-
chr15,60382425,1.7693289890806616,854,667,1521,-
chr15,60382429,0.6071428571428572,883,571,1454,-
chr15,60382430,1.13654599189626,1195,935,2130,-
chr15,60397327,0.911426536533569,1020,863,1883,-
chr15,60448063,2.5164570083611437,637,496,1133,-
chr15,63154046,0.6512514439738161,1300,1112,2412,-
chr15,63157413,1.4962779156327544,1808,1247,3055,-
chr15,63157474,0.9078478002378122,1017,579,1596,-
chr15,64072653,2.130965909090909,576,439,1015,-
chr15,64072923,1.5533553355335532,1411,908,2319,-
chr15,64072942,1.9377526368607318,3241,2618,5859,-
chr15,64073014,1.906008010680908,1161,748,1909,-
chr15,64073025,0.6458360655737706,937,609,1546,-
chr15,64075532,2.735338345864662,962,629,1591,-
chr15,64088823,3.55194715838723,716,558,1274,-
chr15,64088825,0.6003911887314691,1457,1303,2760,-
chr15,64088826,0.5978765619723065,1132,986,2118,-
chr15,64093676,3.35938042200818,823,582,1405,-
chr15,64155903,0.6812580168536589,1997,1526,3523,-
chr15,64155905,1.766958741948587,1014,906,1920,-
chr15,64156006,0.7954230431953834,3275,2000,5275,-
chr15,64156062,1.3087371780754804,4745,3765,8510,-
chr15,64156099,1.270360869991175,11978,10433,22411,-
chr15,64156100,1.2212506515958652,26065,20676,46741,-
chr15,64156101,1.4027418596827337,11841,10891,22732,-
chr15,64156102,1.1711948054486936,17969,14640,32609,-
chr15,64156103,1.6880235453928003,4193,2523,6716,-
chr15,64156112,1.8791106630824375,2641,2231,4872,-
chr15,64156125,2.0152317301226836,10955,7771,18726,-
chr15,64156739,1.7064665703501432,2349,1810,4159,-
chr15,64156818,1.2926799282008408,4043,2427,6470,-
chr15,64156905,1.4226060485738867,1553,1241,2794,-
chr15,64156907,0.5490575211100742,1964,1408,3372,-
chr15,64160172,0.7136709133537597,9174,6392,15566,-
chr15,64162149,1.4318050218455545,2719,2177,4896,-
chr15,64162150,1.4539409513805523,2924,2351,5275,-
chr15,64162151,0.7594376387013094,2900,1846,4746,-
chr15,64162152,1.4539409513805523,2924,2351,5275,-
chr15,64162877,1.1345002054916329,6219,4488,10707,-
chr15,64162880,1.2676813632227646,2451,1569,4020,-
chr15,64162882,1.7343993267410058,1113,969,2082,-
chr15,64162963,1.4025,1835,999,2834,-
chr15,64162975,1.6902915632754345,1556,805,2361,-
chr15,64163001,2.9520420792079207,1826,807,2633,-
chr15,64163002,2.1946272201058723,1108,696,1804,-
chr15,64163003,2.5651320562678444,4349,2292,6641,-
chr15,64163004,2.1728359138488296,2552,1349,3901,-
chr15,64163006,1.8289967460373324,964,651,1615,-
chr15,64163008,1.6898832085786897,1985,998,2983,-
chr15,64163009,1.7503564482122076,2624,1397,4021,-
chr15,64163014,1.7742584964247936,1266,466,1732,-
chr15,64163016,0.8007054574818869,1502,435,1937,-
chr15,64163018,0.7091222693287579,1280,454,1734,-
chr15,64376861,1.7478617518247894,1672,1351,3023,-
chr15,64376897,0.4875166297117517,1046,819,1865,-
chr15,64380985,0.552512082426045,1260,990,2250,-
chr15,64380987,1.5783059110298598,1294,1093,2387,-
chr15,64381382,0.4938600556070436,1014,829,1843,-
chr15,64381406,1.0325955005893936,2150,1782,3932,-
chr15,64381410,0.6080555555555556,795,599,1394,-
chr15,64381411,1.853932584269663,549,533,1082,-
chr15,64381428,0.5949940958164642,972,740,1712,-
chr15,64381434,1.1345183486238533,760,544,1304,-
chr15,64381435,1.1345183486238533,760,544,1304,-
chr15,64381437,1.00811291733269,1237,933,2170,-
chr15,64381438,1.00811291733269,1237,933,2170,-
chr15,64381439,1.8783661666365439,546,502,1048,-
chr15,64687620,6.34191870614944,468,594,1062,-
chr15,64687629,18.258289376678576,958,580,1538,-
chr15,64687630,17.65351137562813,851,473,1324,-
chr15,64687881,0.67006838956826,776,586,1362,-
chr15,64687934,2.8242618568770688,602,495,1097,-
chr15,64687967,2.201673866090713,698,462,1160,-
chr15,64687969,2.201673866090713,698,462,1160,-
chr15,64688348,7.586496895536885,515,558,1073,-
chr15,64688349,5.324558365798583,619,589,1208,-
chr15,64688370,10.973056077694235,861,539,1400,-
chr15,64688371,9.728361221197096,1138,796,1934,-
chr15,64688372,6.683237696132328,858,617,1475,-
chr15,64688388,6.9593148050878515,657,350,1007,-
chr15,64688389,6.269548306440925,804,421,1225,-
chr15,64688573,5.161953799013097,556,475,1031,-
chr15,64689166,2.814908722109533,792,463,1255,-
chr15,64689167,2.814908722109533,792,463,1255,-
chr15,64690511,1.5570064444070082,657,471,1128,-
chr15,64703189,1.0694605809128628,788,722,1510,-
chr15,64703191,1.0694605809128628,788,722,1510,-
chr15,64703209,2.5977188021374946,703,411,1114,-
chr15,64963437,2.777167085427136,654,397,1051,-
chr15,64963473,2.3587443956303478,706,604,1310,-
chr15,64963656,1.8898583872410892,1661,1175,2836,-
chr15,64963657,0.9767019667170952,806,660,1466,-
chr15,64969355,2.0898811052280304,964,752,1716,-
chr15,65155012,1.5467760798947996,5673,3809,9482,-
chr15,65155015,1.8227996805598101,5257,3615,8872,-
chr15,65155017,1.6391738861692533,8464,5728,14192,-
chr15,65155045,1.9135236848564183,1230,718,1948,-
chr15,65155048,0.6653940011518119,2416,1679,4095,-
chr15,65155049,1.7001216333622935,2126,1150,3276,-
chr15,65155050,1.7001216333622935,2126,1150,3276,-
chr15,65155056,1.5277235277235277,2226,1286,3512,-
chr15,65155057,1.5934249861925274,3142,1739,4881,-
chr15,65155069,2.292553191489362,861,469,1330,-
chr15,65155074,0.5982596084118926,1499,787,2286,-
chr15,65155075,0.5982596084118926,1499,787,2286,-
chr15,65155741,0.5334103045172464,671,337,1008,-
chr15,65155808,0.34641430803959017,664,442,1106,-
chr15,65155809,0.34641430803959017,664,442,1106,-
chr15,65157798,4.438137472283813,555,450,1005,-
chr15,65157799,4.438137472283813,555,450,1005,-
chr15,65157842,3.2051364270833025,1022,704,1726,-
chr15,65157844,3.454493686742921,1493,1070,2563,-
chr15,65691244,2.1059069731462414,2007,1310,3317,-
chr15,65691245,1.923957304291256,1596,1077,2673,-
chr15,65691246,1.923957304291256,1596,1077,2673,-
chr15,66493921,0.9525094441446303,705,435,1140,-
chr15,66493922,2.2708664864573644,924,600,1524,-
chr15,66495394,2.8691817736403724,548,470,1018,-
chr15,66495396,2.8691817736403724,548,470,1018,-
chr15,66499459,1.2975926531879254,21481,17205,38686,-
chr15,66499463,1.2963253691230685,48909,37388,86297,-
chr15,66499475,1.3043304879100075,46380,33776,80156,-
chr15,66499476,1.2265428306491735,109546,78473,188019,-
chr15,66499477,1.2265428306491735,109546,78473,188019,-
chr15,66499494,1.078843226218719,52976,42215,95191,-
chr15,66499495,1.174893583250579,76947,56394,133341,-
chr15,66499512,1.3746888263472274,10151,4962,15113,-
chr15,66499513,1.4584283563296323,9013,5391,14404,-
chr15,66499633,1.622716005643924,94779,75483,170262,-
chr15,66499636,1.499828202470411,188931,136364,325295,-
chr15,66499637,1.499828202470411,188931,136364,325295,-
chr15,66499638,1.3600292404451078,70074,40563,110637,-
chr15,66499647,1.4016379360375546,102638,65591,168229,-
chr15,66499648,1.4811424104294786,116529,70839,187368,-
chr15,66499650,1.3478174291449523,115250,72142,187392,-
chr15,66499651,1.5402816467254186,40545,25952,66497,-
chr15,66500065,1.4210793589462423,38723,25458,64181,-
chr15,66500081,1.5275410116730053,11475,5301,16776,-
chr15,66500176,1.041146592338609,556,591,1147,-
chr15,66500319,1.2761057515799443,68670,49891,118561,-
chr15,66500331,1.2842952727989347,76109,47542,123651,-
chr15,66500997,1.1487514408388768,155026,100643,255669,-
chr15,66500998,1.0630478785006527,103763,61471,165234,-
chr15,66501001,1.1183128246960297,122543,83340,205883,-
chr15,66501005,1.0546660145841085,142004,93707,235711,-
chr15,66501006,0.8906941218834901,72072,43224,115296,-
chr15,66501022,1.4056619086873179,164092,100125,264217,-
chr15,66501023,1.4056619086873179,164092,100125,264217,-
chr15,66501024,1.3686911586439539,187224,114465,301689,-
chr15,66501030,1.2194829096120239,79227,44938,124165,-
chr15,66501031,1.2399346354780414,106186,61161,167347,-
chr15,66501038,1.374404837109808,74847,40052,114899,-
chr15,66501039,1.374404837109808,74847,40052,114899,-
chr15,66501047,1.2080551542967992,30050,15468,45518,-
chr15,66501072,0.9699481067626118,27953,17092,45045,-
chr15,66501077,1.3299402965615044,14500,7310,21810,-
chr15,66501104,0.6975886413466159,20429,12074,32503,-
chr15,66501105,0.6391656602254429,7713,5335,13048,-
chr15,66501895,1.300151685073953,58130,37217,95347,-
chr15,66501896,1.2704417326431898,41215,25351,66566,-
chr15,66501912,0.6186979931473323,575,453,1028,-
chr15,66502683,1.2348486655812327,15015,11437,26452,-
chr15,66502688,1.5216148181976117,13855,10572,24427,-
chr15,66502733,1.2425068000597916,10213,7453,17666,-
chr15,66502749,1.1947509229231208,33902,24602,58504,-
chr15,66503077,0.8853926561243634,9627,7539,17166,-
chr15,66503312,1.0222690399661472,903,644,1547,-
chr15,66503494,1.3126383425000943,36740,27799,64539,-
chr15,66503495,1.322755132314703,36289,25257,61546,-
chr15,66503503,1.2319165490344268,31390,22117,53507,-
chr15,66503510,1.2563524406569844,42737,26881,69618,-
chr15,66503511,1.2133775995630864,26382,15461,41843,-
chr15,66503512,1.2036931831452575,78259,53013,131272,-
chr15,66503514,1.2200198631903196,50426,33877,84303,-
chr15,66503515,1.401234943221177,18862,13836,32698,-
chr15,66503517,1.3288791422449222,11320,7441,18761,-
chr15,66503520,1.3698852511400537,25062,16840,41902,-
chr15,66503522,1.5611006297166274,14462,7703,22165,-
chr15,66503523,1.6022254038195332,14157,7854,22011,-
chr15,66504797,1.5415781018184176,7885,3878,11763,-
chr15,66504798,1.4989854378528176,11930,7394,19324,-
chr15,66504805,1.4150702980080785,3365,1558,4923,-
chr15,66504821,1.630334281650071,2248,987,3235,-
chr15,66504841,0.6628137533234194,1278,568,1846,-
chr15,66504843,0.7460168285216511,3084,2483,5567,-
chr15,66504844,0.8771611934779769,6332,4446,10778,-
chr15,66504845,0.9149448789448599,3310,1830,5140,-
chr15,66504846,1.0168769901027495,3918,3049,6967,-
chr15,67201889,0.2794987207420845,744,1357,2101,-
chr15,67201890,0.29948876471287605,457,646,1103,-
chr15,67201893,14.373882570518354,2150,2897,5047,-
chr15,67201894,14.373882570518354,2150,2897,5047,-
chr15,67201895,16.968540750205204,2112,2321,4433,-
chr15,67202548,1.6429163616177205,637,401,1038,-
chr15,68778997,1.874338001840636,1137,822,1959,-
chr15,68779031,2.116465863453816,645,497,1142,-
chr15,68779114,0.6294643862559532,1264,1041,2305,-
chr15,68779426,2.2838975769032483,885,758,1643,-
chr15,68779428,2.2017806192096936,1474,1150,2624,-
chr15,68779878,0.32115885881596795,565,775,1340,-
chr15,68779879,0.31100478468899523,449,569,1018,-
chr15,68779898,22.984577877858325,1741,1394,3135,-
chr15,68779899,23.478375077186953,2103,1508,3611,-
chr15,68779900,24.91884176773568,1911,1259,3170,-
chr15,68779901,54.641379675021376,1073,592,1665,-
chr15,68779912,22.09540023487517,1513,163,1676,-
chr15,68779913,21.104597672007753,1909,204,2113,-
chr15,68779914,32.405405405405396,980,73,1053,-
chr15,68779915,14.422970992970995,999,111,1110,-
chr15,68779916,10.215936958179418,1171,84,1255,-
chr15,68779992,0.4247812548017597,496,523,1019,-
chr15,68780137,0.5611152601443863,643,617,1260,-
chr15,68780464,0.4460623872820787,1112,1360,2472,-
chr15,68780465,0.5325673896620218,2237,3066,5303,-
chr15,68780468,13.096365073286178,4755,11193,15948,-
chr15,68780471,6.245683661928448,4399,3674,8073,-
chr15,68780473,5.313193761208039,3169,3168,6337,-
chr15,68782974,4.141993198799543,4296,1803,6099,-
chr15,68782977,2.259893543161305,929,297,1226,-
chr15,68782985,5.932970353202283,2517,1106,3623,-
chr15,68782989,4.727340754900891,3312,1323,4635,-
chr15,68782992,1.4904048501853893,1450,586,2036,-
chr15,68783036,1.7755328714232823,1118,510,1628,-
chr15,68783046,2.080885982417996,2965,1410,4375,-
chr15,68783047,2.0758802816901407,1813,799,2612,-
chr15,68784526,0.5954846727423363,749,567,1316,-
chr15,68784593,2.008534850640114,705,406,1111,-
chr15,68787487,1.7315256691931538,2019,1443,3462,-
chr15,68787496,1.706574675324675,724,559,1283,-
chr15,68787875,1.825020234722784,838,705,1543,-
chr15,68787897,2.015325077399381,830,509,1339,-
chr15,68787899,1.963438698903552,1232,800,2032,-
chr15,68820795,1.6893165088792632,8386,7311,15697,-
chr15,68820796,1.7531371047014435,11018,9485,20503,-
chr15,68820797,1.7531371047014435,11018,9485,20503,-
chr15,68820798,1.7234059940061148,10583,8857,19440,-
chr15,68820800,1.533724523471408,7390,5881,13271,-
chr15,68820802,1.1039945767987749,8403,6068,14471,-
chr15,68820807,2.2093240093240096,676,428,1104,-
chr15,68820826,1.8344050787048762,2962,2133,5095,-
chr15,68820828,1.7346348868795853,6548,4575,11123,-
chr15,68820830,1.8228249483310213,4023,2716,6739,-
chr15,68820832,1.5980722849452969,2593,1707,4300,-
chr15,68820836,0.7984635518777907,3425,2207,5632,-
chr15,68820838,0.9427581243622934,7117,4455,11572,-
chr15,68820839,1.217513177538771,2367,1426,3793,-
chr15,68820840,1.0795707560513035,3692,2248,5940,-
chr15,68820867,1.7650878984627894,1464,874,2338,-
chr15,68820872,2.0713635704579754,1355,636,1991,-
chr15,68820874,1.9859977255038477,1083,567,1650,-
chr15,70049933,3.1765540231863354,527,514,1041,-
chr15,70076155,2.4583633803268206,1234,857,2091,-
chr15,70076157,2.9915646258503403,955,699,1654,-
chr15,70094566,1.281364941505897,4787,2553,7340,-
chr15,70094567,1.281364941505897,4787,2553,7340,-
chr15,70094568,1.3842495217814408,7088,4314,11402,-
chr15,70094569,0.5522889481652369,1196,714,1910,-
chr15,70094570,1.749059844932448,3356,2533,5889,-
chr15,70094571,1.544789414980989,4328,2980,7308,-
chr15,70094573,1.9084593621106927,3887,2634,6521,-
chr15,70094574,1.7926545610061575,2832,1862,4694,-
chr15,70094575,1.7283555993140076,3752,2328,6080,-
chr15,70095608,2.1002826759994617,742,390,1132,-
chr15,70096174,1.3051406287995937,826,605,1431,-
chr15,71164799,0.43989717760671776,1608,1701,3309,-
chr15,71164800,0.44179104477611936,1295,1339,2634,-
chr15,71164805,0.5411420408580613,837,858,1695,-
chr15,71164806,0.5721305721305722,651,813,1464,-
chr15,71164808,0.49336953116842447,944,941,1885,-
chr15,71164809,0.4854989120082054,1970,2226,4196,-
chr15,71164812,0.5090545288343753,575,776,1351,-
chr15,71164814,4.794456035767512,968,1374,2342,-
chr15,71164815,8.318610201928617,1822,2486,4308,-
chr15,71164818,3.033056078393079,1189,779,1968,-
chr15,71164842,2.270086478542989,915,525,1440,-
chr15,71165130,1.5196911196911196,719,554,1273,-
chr15,71165138,1.725094659877269,1056,827,1883,-
chr15,71165141,0.644652122222679,1921,1336,3257,-
chr15,71165145,0.577158916771892,1308,860,2168,-
chr15,71165148,1.7794814368162633,625,493,1118,-
chr15,71165149,1.7247657425838714,724,478,1202,-
chr15,71165154,1.0720330936245408,918,659,1577,-
chr15,72199108,1.3299130010569966,6290,4015,10305,-
chr15,72199325,1.71640866873065,2575,1954,4529,-
chr15,72199375,1.32449611550548,10736,7148,17884,-
chr15,72199382,1.1918165552311897,6660,3884,10544,-
chr15,72199419,1.5930161993934666,6538,3731,10269,-
chr15,72199519,1.2153250188964473,4061,2645,6706,-
chr15,72199557,0.7755522859019851,27575,15449,43024,-
chr15,72199570,1.3162902923821198,7646,5340,12986,-
chr15,72199572,1.3162902923821198,7646,5340,12986,-
chr15,72199584,0.7760977379630651,7305,4073,11378,-
chr15,72199592,1.4233516357462948,5092,3321,8413,-
chr15,72199593,1.186895237397321,10329,6190,16519,-
chr15,72199594,1.4314773225948012,6523,4187,10710,-
chr15,72199595,1.3539444713290272,9730,6146,15876,-
chr15,72199596,1.0777252824440746,5007,2983,7990,-
chr15,72199598,1.292677777931588,2540,1536,4076,-
chr15,72199599,1.2572077409162716,2260,1265,3525,-
chr15,72199605,1.9664698593191925,1926,1075,3001,-
chr15,72199607,1.6492934307185594,2815,1603,4418,-
chr15,72199609,0.621419320520826,4281,2484,6765,-
chr15,72199610,0.626667123288822,5077,2921,7998,-
chr15,72199611,0.6261419304286604,4703,2760,7463,-
chr15,72199617,1.7731092436974791,843,594,1437,-
chr15,72199620,1.0089809384164223,1100,681,1781,-
chr15,72199622,1.0089809384164223,1100,681,1781,-
chr15,72199628,0.4918692891435652,793,586,1379,-
chr15,72199727,1.530106707317073,1594,1311,2905,-
chr15,72199753,1.3189398623075026,5024,3204,8228,-
chr15,72200493,1.3378399259741127,6645,4147,10792,-
chr15,72200611,1.6607531901649548,1655,1376,3031,-
chr15,72200613,1.6486828035384469,5119,3047,8166,-
chr15,72200633,1.4738002002646353,4244,3106,7350,-
chr15,72200634,1.4738002002646353,4244,3106,7350,-
chr15,72200635,1.2732894274763469,7569,6069,13638,-
chr15,72200651,1.7422193002892243,3682,1986,5668,-
chr15,72202533,1.4732688554824045,3434,2742,6176,-
chr15,72202588,1.3463086209565085,1932,1490,3422,-
chr15,72202591,1.2683070469512823,10911,7206,18117,-
chr15,72206861,1.4552047092673333,2154,1681,3835,-
chr15,72206866,1.8179991697799915,2125,1649,3774,-
chr15,72207213,1.1707654014068103,14179,11681,25860,-
chr15,72207214,1.2472746290140568,27553,21344,48897,-
chr15,72207222,0.845275542122096,5714,4613,10327,-
chr15,72207269,1.3060787516982413,7774,5198,12972,-
chr15,72208647,1.3041765432481138,10588,7587,18175,-
chr15,72208769,0.7482682092851949,11278,7768,19046,-
chr15,72208788,1.284120819848975,2245,1799,4044,-
chr15,72208830,1.6484008199135738,7963,5520,13483,-
chr15,72208862,1.1378021581316444,14980,11453,26433,-
chr15,72208864,1.001640473568366,7245,6075,13320,-
chr15,72209719,1.5183603757472246,2666,2341,5007,-
chr15,72209752,1.447674797745956,5805,4675,10480,-
chr15,72209753,1.3357503229838932,14586,10340,24926,-
chr15,72209790,1.2994570349386214,2524,2117,4641,-
chr15,72209815,1.3100255488446078,6510,4234,10744,-
chr15,72210424,1.6508563775606442,4646,4077,8723,-
chr15,72210459,1.3264674658864348,4181,3510,7691,-
chr15,72210467,1.538624909125068,2215,1676,3891,-
chr15,72219090,0.7827899452463911,2734,2295,5029,-
chr15,72231150,1.2874034749034748,2521,1923,4444,-
chr15,72231155,0.7447410853755507,3602,2739,6341,-
chr15,72231179,1.5915087067296467,4646,2954,7600,-
chr15,72231182,1.246169992948392,2656,1444,4100,-
chr15,72231185,1.1386072794230842,1877,1428,3305,-
chr15,72231187,0.9164439332530032,2250,1789,4039,-
chr15,72231189,0.9164439332530032,2250,1789,4039,-
chr15,72231190,2.2152994115610936,1599,855,2454,-
chr15,72231193,1.6351469387312354,2142,1275,3417,-
chr15,72231200,0.5388587674264714,2648,1715,4363,-
chr15,72231212,1.8440251838124204,541,522,1063,-
chr15,72343945,1.1243986608910768,701,503,1204,-
chr15,72344085,0.5513105716220137,599,421,1020,-
chr15,72345509,1.1723276304595174,2020,1515,3535,-
chr15,72345511,1.1457015526164462,965,751,1716,-
chr15,72346584,1.848364485981308,585,427,1012,-
chr15,72348056,1.9525899912203686,694,669,1363,-
chr15,72348059,2.3934837092731827,763,531,1294,-
chr15,72349107,0.6353228711088243,897,597,1494,-
chr15,72349182,2.1089902280130297,980,613,1593,-
chr15,72349220,2.6213386348575214,681,502,1183,-
chr15,72349248,0.4789867587795049,727,578,1305,-
chr15,72349258,1.0762973512651266,1040,775,1815,-
chr15,72353101,2.077162397889721,1310,894,2204,-
chr15,72353112,2.23368251410153,692,437,1129,-
chr15,72353168,2.030545112781955,744,531,1275,-
chr15,72353173,1.6874999999999998,782,608,1390,-
chr15,72355610,1.560353982300885,683,564,1247,-
chr15,72355612,1.0483692746391018,1367,904,2271,-
chr15,72355613,1.3613974167475429,1976,1384,3360,-
chr15,72356598,2.9433571069888536,1080,753,1833,-
chr15,72375880,1.6049274018146393,1372,897,2269,-
chr15,72375881,2.017338092809791,1011,582,1593,-
chr15,72375983,0.6645844704519449,865,698,1563,-
chr15,72751679,1.0077220077220077,854,664,1518,-
chr15,72751680,1.0077220077220077,854,664,1518,-
chr15,72751906,1.0557387872552473,707,492,1199,-
chr15,72752278,0.5635179153094463,864,613,1477,-
chr15,72752387,1.6025020177562552,721,530,1251,-
chr15,72760467,2.2424804570589747,715,507,1222,-
chr15,72774991,3.022026431718062,636,453,1089,-
chr15,72774992,2.941519205869658,950,661,1611,-
chr15,72774994,2.6577726218097446,631,430,1061,-
chr15,73560312,2.031620553359684,1027,758,1785,-
chr15,73560445,1.9039451114922807,739,423,1162,-
chr15,73561021,2.3648068669527897,550,465,1015,-
chr15,73561941,2.190318302387268,1100,753,1853,-
chr15,73561942,2.190318302387268,1100,753,1853,-
chr15,73570381,1.5579322638146167,4369,2991,7360,-
chr15,73570382,1.3627141856667728,10135,7626,17761,-
chr15,73570388,1.4292379471228616,2756,1928,4684,-
chr15,73570391,1.7279294454341616,6160,4567,10727,-
chr15,73570392,1.7478307032591283,7515,5705,13220,-
chr15,73570394,1.7801384474726805,4034,3344,7378,-
chr15,73570395,1.888762262295815,2617,2130,4747,-
chr15,73570397,1.6497524752475246,1332,807,2139,-
chr15,73570412,1.911369885169012,932,686,1618,-
chr15,73570417,2.2328773584905663,1526,1059,2585,-
chr15,73570419,1.9420135452516338,3042,1966,5008,-
chr15,73570421,1.84050622302309,1463,973,2436,-
chr15,73573684,2.5352112676056344,629,425,1054,-
chr15,73573723,2.2533254507833287,692,397,1089,-
chr15,73573743,1.9732472324723245,827,541,1368,-
chr15,73573755,1.4879526560518528,659,452,1111,-
chr15,73591978,2.254325086387536,712,490,1202,-
chr15,73591990,2.9341019582731565,749,496,1245,-
chr15,74451516,3.435446491924503,1480,824,2304,-
chr15,74451518,3.953051643192488,841,425,1266,-
chr15,74923741,1.4966887417218544,1581,1056,2637,-
chr15,74926883,0.6794258373205743,1277,989,2266,-
chr15,74926885,1.5874713521772348,1038,769,1807,-
chr15,74929137,1.6538913495435237,962,850,1812,-
chr15,74929188,1.9052390342695735,992,646,1638,-
chr15,74929206,2.0862745098039217,626,494,1120,-
chr15,74937947,4.660692388045843,910,546,1456,-
chr15,74937949,5.419196032276531,898,526,1424,-
chr15,74937975,1.7349511426987927,829,741,1570,-
chr15,74955375,2.8235294117647056,623,424,1047,-
chr15,74955377,2.8235294117647056,623,424,1047,-
chr15,75322229,1.980017534536035,720,490,1210,-
chr15,75411605,1.3215829881904568,1202,941,2143,-
chr15,75411606,1.3215829881904568,1202,941,2143,-
chr15,75621043,1.690079016681299,549,669,1218,-
chr15,75621046,1.6592140921409209,929,1106,2035,-
chr15,75621048,1.4557256211422713,3064,2925,5989,-
chr15,75621049,1.2938880754217743,2954,2598,5552,-
chr15,75621050,1.373578303484361,3324,2981,6305,-
chr15,75621051,0.911797265356192,1218,856,2074,-
chr15,75621052,1.9351473682349405,1099,1108,2207,-
chr15,75621053,1.9448619513937966,1118,973,2091,-
chr15,75621055,2.216139150270887,602,500,1102,-
chr15,75639172,0.35227202663542767,878,661,1539,-
chr15,75639173,0.35227202663542767,878,661,1539,-
chr15,75639310,3.628015564202335,665,513,1178,-
chr15,75639312,3.628015564202335,665,513,1178,-
chr15,75639404,0.46543509842391506,932,751,1683,-
chr15,76225885,1.4123965438835837,1870,1465,3335,-
chr15,76225914,1.7040427751695353,1653,1079,2732,-
chr15,76225925,1.9802566911000643,1438,912,2350,-
chr15,76274442,2.442518810904157,920,736,1656,-
chr15,76274459,2.0627494014365526,898,715,1613,-
chr15,76285685,0.628985274199688,3645,2615,6260,-
chr15,76285716,1.602861617312073,978,877,1855,-
chr15,76292482,1.8429164991288032,999,828,1827,-
chr15,76292662,1.213115975814296,3996,2981,6977,-
chr15,76292685,1.8183115139308492,921,661,1582,-
chr15,76292692,2.14176245210728,859,579,1438,-
chr15,76295689,1.65500306936771,673,542,1215,-
chr15,76295715,2.068977992513384,1197,954,2151,-
chr15,76295717,0.4320527629764877,772,570,1342,-
chr15,76311362,1.8035573122529645,701,439,1140,-
chr15,76311373,5.012019230769232,694,415,1109,-
chr15,76311417,0.6316727427948737,2342,1668,4010,-
chr15,76311442,1.0841101129349466,617,406,1023,-
chr15,77046288,1.4193853427895982,1263,939,2202,-
chr15,77046404,1.8338151260504199,1185,849,2034,-
chr15,77046422,1.9423476968796436,1031,672,1703,-
chr15,77046430,1.8226829645675384,759,561,1320,-
chr15,77046499,2.3239247311827955,740,495,1235,-
chr15,77046683,1.86096256684492,927,747,1674,-
chr15,77046884,1.0085521083789537,1608,1235,2843,-
chr15,77052428,1.9525578866283024,1050,760,1810,-
chr15,77052433,1.7555441549061643,1767,1165,2932,-
chr15,77052435,0.6343247532951487,765,673,1438,-
chr15,77052436,1.6374269005847952,944,512,1456,-
chr15,77052446,2.1038251366120218,846,426,1272,-
chr15,77052447,1.810479375696767,671,467,1138,-
chr15,77052865,0.5375160244325465,1583,1191,2774,-
chr15,77052872,1.7165358784022624,2403,1724,4127,-
chr15,77052873,1.7706458885389906,3787,2700,6487,-
chr15,77054239,1.668119266055046,1038,871,1909,-
chr15,77054250,1.8618964042779091,2136,1574,3710,-
chr15,77055855,1.8874773139745915,1039,645,1684,-
chr15,77056073,1.927551893376559,1156,672,1828,-
chr15,77056240,0.3819253438113949,566,508,1074,-
chr15,77056241,1.6650789011054499,1245,1015,2260,-
chr15,77070938,2.423148245506192,642,520,1162,-
chr15,77071002,2.2329438460846895,716,419,1135,-
chr15,77071045,0.48888154159457736,728,598,1326,-
chr15,77071064,8.933643893959834,2773,1603,4376,-
chr15,77071065,8.933643893959834,2773,1603,4376,-
chr15,77071066,8.933643893959834,2773,1603,4376,-
chr15,77071108,0.6088142671026204,1063,518,1581,-
chr15,78283386,2.5399659863945576,617,440,1057,-
chr15,78285331,2.031157894736842,602,474,1076,-
chr15,78289699,1.652411021814007,908,535,1443,-
chr15,78290062,0.5869473684210527,696,499,1195,-
chr15,78292628,1.8457863960207577,1018,929,1947,-
chr15,78292673,0.9506360619469024,1374,903,2277,-
chr15,78292674,0.9506360619469024,1374,903,2277,-
chr15,78292676,1.0020176063890185,750,680,1430,-
chr15,78292714,3.397186054893538,832,623,1455,-
chr15,78292720,2.7262888888150174,833,586,1419,-
chr15,78294959,2.007519151757168,843,651,1494,-
chr15,78299590,0.5789835164835165,842,363,1205,-
chr15,78299591,0.5502581388829574,1386,681,2067,-
chr15,79845196,3.211694408877507,601,425,1026,-
chr15,79845197,3.211694408877507,601,425,1026,-
chr15,79889323,2.941747572815534,605,514,1119,-
chr15,79889325,2.941747572815534,605,514,1119,-
chr15,80979139,0.725845147219193,639,654,1293,-
chr15,80979146,5.000321429874165,1548,1283,2831,-
chr15,80979147,5.000321429874165,1548,1283,2831,-
chr15,80989596,1.651615207486278,2032,1319,3351,-
chr15,80989615,1.674040670467115,786,510,1296,-
chr15,80989658,2.228951912022859,665,473,1138,-
chr15,82130491,1.7966063127503393,781,886,1667,-
chr15,82130499,1.9324228751214898,602,535,1137,-
chr15,82130514,2.739090877559322,631,685,1316,-
chr15,82130515,2.14799318350808,571,667,1238,-
chr15,82138764,0.5127700202888172,660,440,1100,-
chr15,82152332,1.7104025614103937,591,486,1077,-
chr15,82157831,2.330169651403258,663,627,1290,-
chr15,82372261,1.5037115588547192,1417,942,2359,-
chr15,82372265,1.1257373459385416,1826,1222,3048,-
chr15,82372283,1.7128049201851978,728,498,1226,-
chr15,82372286,1.7660573821515475,663,430,1093,-
chr15,82372577,1.2953393227915926,13620,8468,22088,-
chr15,82372616,1.5390290888075515,3163,1789,4952,-
chr15,82372617,1.274091420007493,2956,1569,4525,-
chr15,82372633,1.5538902406055692,2565,2054,4619,-
chr15,82372636,1.4342178841950075,1849,995,2844,-
chr15,82372638,1.3837614769949502,3911,2486,6397,-
chr15,82372646,1.9593959098070728,3332,2238,5570,-
chr15,82372650,1.3533670188332567,3026,2176,5202,-
chr15,82372652,1.4143607152360285,5466,3896,9362,-
chr15,82372653,1.4266666666666663,2781,1949,4730,-
chr15,82372656,1.6917197560139496,1688,1046,2734,-
chr15,82372669,1.496383690822996,926,478,1404,-
chr15,82536879,1.4697747049003278,20449,11834,32283,-
chr15,82536881,1.1385416456190558,11379,6191,17570,-
chr15,82538371,0.8114015419316196,3157,2372,5529,-
chr15,82538372,0.9720499728375438,1663,1422,3085,-
chr15,82538969,1.098824023630562,49293,36398,85691,-
chr15,82540005,0.9755120794093448,50925,38660,89585,-
chr15,82540044,1.2613555412327415,24788,13660,38448,-
chr15,82540079,1.265547097446894,35953,29844,65797,-
chr15,82540080,1.265547097446894,35953,29844,65797,-
chr15,82540083,1.214906061578056,43519,35035,78554,-
chr15,82540084,1.207114501113253,70907,52607,123514,-
chr15,82540085,1.2287478838540835,55788,44527,100315,-
chr15,82540086,1.1397609589230027,52364,40753,93117,-
chr15,82540091,1.4285312980026554,21792,13799,35591,-
chr15,82540094,0.8093243186351067,9288,7198,16486,-
chr15,82540116,0.7864070915893762,25815,21199,47014,-
chr15,82540117,0.7959922632934487,17517,14218,31735,-
chr15,82540444,1.075574979425384,17443,12211,29654,-
chr15,82540447,1.2109029768296131,12998,6925,19923,-
chr15,82540448,1.2105295230230062,26897,17649,44546,-
chr15,82540449,1.0909235889090345,36610,24980,61590,-
chr15,82540451,1.0208848812879876,19013,13239,32252,-
chr15,82540452,1.0468919635268796,11881,8447,20328,-
chr15,82540453,1.1959242438183049,7151,6183,13334,-
chr15,82540455,2.199594701019327,3090,1972,5062,-
chr15,82540456,1.0720873329568978,1423,923,2346,-
chr15,82540458,0.7580712936862861,1929,1072,3001,-
chr15,83016693,3.2082262210796912,623,388,1011,-
chr15,83017749,2.6549295774647885,584,425,1009,-
chr15,83041740,1.85246239439522,619,421,1040,-
chr15,83041792,2.497442455242967,629,390,1019,-
chr15,83041889,1.3918156423265169,681,452,1133,-
chr15,83139039,2.1285846438482885,766,422,1188,-
chr15,83139041,2.1285846438482885,766,422,1188,-
chr15,83139192,5.224314272431426,774,477,1251,-
chr15,83139193,5.224314272431426,774,477,1251,-
chr15,83164067,2.5525354730112135,655,431,1086,-
chr15,83164069,2.514841187294984,730,430,1160,-
chr15,84669662,1.893344863618348,1221,956,2177,-
chr15,84669743,1.8001526896875732,1056,945,2001,-
chr15,84669819,3.917944532050705,8877,6696,15573,-
chr15,84669820,4.4710156871493005,5541,3969,9510,-
chr15,84669992,1.4277777777777774,1798,1403,3201,-
chr15,84680795,1.8027634554101073,3026,2088,5114,-
chr15,84680828,1.7579908675799083,1154,656,1810,-
chr15,84687713,1.394613728236343,3961,3079,7040,-
chr15,84687725,1.4698222282027422,3586,2675,6261,-
chr15,84691569,1.592733712568423,1521,1330,2851,-
chr15,84691633,1.4721097615834458,1189,987,2176,-
chr15,84716058,1.7771701982228298,1039,835,1874,-
chr15,84716062,0.6214808362369338,1080,1024,2104,-
chr15,84716067,1.3522016814044229,2786,1983,4769,-
chr15,84716069,1.090479937057435,1583,1239,2822,-
chr15,84716110,1.3021071054518927,1915,1402,3317,-
chr15,84716111,1.0202972865732685,821,602,1423,-
chr15,88459754,2.2696713286371875,568,441,1009,-
chr15,88459783,1.7205005732642986,805,616,1421,-
chr15,88465722,1.1091076328500995,762,615,1377,-
chr15,88465723,1.3654421768707483,578,440,1018,-
chr15,89201726,1.0896526237989652,640,409,1049,-
chr15,89201727,1.0896526237989652,640,409,1049,-
chr15,89317427,2.913271540348552,597,409,1006,-
chr15,89319038,0.6121076627975605,660,513,1173,-
chr15,89319047,3.237365603412656,982,779,1761,-
chr15,89319049,4.237337328037561,947,719,1666,-
chr15,89322892,3.0136066831152193,1117,811,1928,-
chr15,89322894,2.7260940032414918,840,616,1456,-
chr15,89334736,4.910755148741418,1072,436,1508,-
chr15,89334740,2.377599089834423,1783,667,2450,-
chr15,89334754,0.4628384563003785,904,491,1395,-
chr15,89334814,0.8279631627460134,926,508,1434,-
chr15,90087183,3.245229371803679,718,473,1191,-
chr15,90087450,1.5481484273952373,5438,5031,10469,-
chr15,90087451,1.613588905314595,3512,3648,7160,-
chr15,90087456,2.455497011559349,1721,1620,3341,-
chr15,90087486,1.6937631153462451,1118,708,1826,-
chr15,90087496,2.032941176470588,971,764,1735,-
chr15,90087499,1.65262964890821,2749,1904,4653,-
chr15,90087501,1.6080536912751684,1796,1340,3136,-
chr15,90087502,0.7098418134377039,756,671,1427,-
chr15,90087511,1.7051162790697674,610,429,1039,-
chr15,90087526,1.1276627218934911,1088,675,1763,-
chr15,90087527,1.1276627218934911,1088,675,1763,-
chr15,90087564,0.43651779773264804,580,506,1086,-
chr15,90088376,8.251766233187356,566,487,1053,-
chr15,90230497,0.6437768240343348,635,465,1100,-
chr15,90230954,2.154970760233918,736,539,1275,-
chr15,90230988,2.028669410150892,642,404,1046,-
chr15,90231191,2.6465656609863,1066,794,1860,-
chr15,90231420,0.6697451274362819,697,574,1271,-
chr15,90231467,2.0181696824594493,822,752,1574,-
chr15,90232242,1.0152743350974744,865,648,1513,-
chr15,90232243,1.0152743350974744,865,648,1513,-
chr15,90233870,6.616257958327105,1238,837,2075,-
chr15,90233935,0.41999445238675065,1195,808,2003,-
chr15,90966195,2.329074719318621,639,614,1253,-
chr15,90966327,1.823187862895673,627,561,1188,-
chr15,90966399,0.6382928996117526,2741,1704,4445,-
chr15,90966401,1.5132534942429654,2978,1787,4765,-
chr15,90966402,1.5132534942429654,2978,1787,4765,-
chr15,90966406,1.6949452774087432,787,478,1265,-
chr15,90966413,0.6034440941062333,932,650,1582,-
chr15,90966422,0.6132218844984801,806,610,1416,-
chr15,90966495,2.6534012836800533,1247,801,2048,-
chr15,90966576,1.6666666666666663,769,461,1230,-
chr15,90966593,2.5561393805309733,710,451,1161,-
chr15,90967161,2.3556679308891697,779,677,1456,-
chr15,90967162,2.3556679308891697,779,677,1456,-
chr15,90969594,2.16013437849944,642,516,1158,-
chr15,90969595,2.16013437849944,642,516,1158,-
chr15,90974214,2.06414762741652,782,568,1350,-
chr15,90974229,2.5346129238643638,618,520,1138,-
chr15,90974232,1.5241090146750524,726,529,1255,-
chr15,90976713,1.6209024989512797,1103,813,1916,-
chr15,90976714,1.100601718416302,1687,1132,2819,-
chr15,90976770,1.7591240875912408,722,410,1132,-
chr15,90979237,1.821133633633634,938,591,1529,-
chr15,90979283,2.29671091384019,1589,1207,2796,-
chr15,90979284,2.489634408602151,997,749,1746,-
chr15,90980285,1.574630945872061,879,648,1527,-
chr15,90980303,1.8949019607843136,603,449,1052,-
chr15,90980356,1.929607195301028,724,453,1177,-
chr15,90980934,1.8879310344827587,1229,1159,2388,-
chr15,90980936,1.638683680322364,1707,1488,3195,-
chr15,90980940,1.6672115070284406,3059,2575,5634,-
chr15,90980941,1.6635444098928087,4072,3456,7528,-
chr15,90980944,1.5566290303806305,932,780,1712,-
chr15,90980952,1.387529439472445,2506,1929,4435,-
chr15,90980953,1.387529439472445,2506,1929,4435,-
chr15,90980973,1.789963942307692,643,511,1154,-
chr15,90981638,2.566101694915254,756,589,1345,-
chr15,90981910,1.852808722363829,2375,1760,4135,-
chr15,90981916,1.5939982347749335,1007,823,1830,-
chr15,90984123,1.6640545144804086,791,586,1377,-
chr15,90984774,2.2638308977035493,693,478,1171,-
chr15,90984779,1.7306451612903226,637,439,1076,-
chr15,90994433,3.563354530727605,851,676,1527,-
chr15,91006406,3.352255587549705,763,560,1323,-
chr15,91006409,2.1575492341356672,695,456,1151,-
chr15,101176002,1.8076134032368358,914,641,1555,-
chr15,101176003,1.8076134032368358,914,641,1555,-
chr15,101176044,5.159653465346535,757,403,1160,-
chr15,101176960,4.347211225477259,727,536,1263,-
chr15,101177414,2.195536994520906,777,572,1349,-
chr15,101177496,1.9446998198919354,829,501,1330,-
chr15,101178191,1.5111464968152863,948,627,1575,-
chr15,101178192,1.5111464968152863,948,627,1575,-
chr15,101178193,1.5111464968152863,948,627,1575,-
chr15,101272324,0.5925663716814159,743,564,1307,-
chr15,101272606,2.2986965076242005,602,427,1029,-
chr15,101274456,1.4128233634571101,639,418,1057,-
chr15,101275345,1.3434817756553639,1667,1173,2840,-
chr15,101275347,1.4772198249099797,2013,1365,3378,-
chr15,101281705,1.689957947027638,1998,1378,3376,-
chr15,101281709,1.6666666666666667,1975,1367,3342,-
chr15,101281710,1.6666666666666667,1975,1367,3342,-
chr15,101281720,1.9728652263374482,666,431,1097,-
chr15,101284979,1.658725765061344,21846,16481,38327,-
chr15,101284981,1.8488738337392647,13945,11181,25126,-
chr15,101284986,1.099905824539436,19313,12442,31755,-
chr15,101285005,1.0637916827470628,13327,8363,21690,-
chr15,101285037,1.916138572032108,2701,1840,4541,-
chr15,101285046,1.717460234533866,4774,2997,7771,-
chr15,101285048,1.5438707970749481,8311,4987,13298,-
chr15,101285049,1.6932439557128869,4587,2804,7391,-
chr15,101285737,1.6535420329947563,2561,1340,3901,-
chr15,101285748,1.3883084471760974,2891,1591,4482,-
chr15,101285776,1.1888179551698959,946,470,1416,-
chr15,101287677,1.1655720019613867,747,563,1310,-
chr15,101287679,1.6577915989945444,757,544,1301,-
chr15,101287686,1.3251562506178842,625,442,1067,-
chr15,101293096,1.207171314741036,605,501,1106,-
chr15,101293097,1.207171314741036,605,501,1106,-
chr15,101642030,0.4376576576576577,693,554,1247,-
chr15,101642031,0.4376576576576577,693,554,1247,-
chr15,101642434,4.571920202218716,720,549,1269,-
chr16,51631,1.3744510598373536,731,554,1285,-
chr16,53505,1.7620778040946108,1262,832,2094,-
chr16,53510,1.7396560708702449,2781,2019,4800,-
chr16,53512,1.748089220024172,3814,2650,6464,-
chr16,53518,1.9657483246463143,1199,789,1988,-
chr16,53535,2.7991577918353796,2312,1628,3940,-
chr16,53558,3.5882012724117978,845,398,1243,-
chr16,53560,3.5882012724117978,845,398,1243,-
chr16,53572,2.0706436499891576,834,576,1410,-
chr16,367762,2.2753050352294206,661,528,1189,-
chr16,367763,2.2753050352294206,661,528,1189,-
chr16,367776,2.291492339918906,624,480,1104,-
chr16,369101,6.083869164103997,701,510,1211,-
chr16,369103,6.083869164103997,701,510,1211,-
chr16,369952,1.3838042449641748,852,568,1420,-
chr16,369953,1.3838042449641748,852,568,1420,-
chr16,369954,3.386298851240886,1804,1209,3013,-
chr16,369964,1.801100162309171,694,430,1124,-
chr16,370072,1.3740743838439022,1140,674,1814,-
chr16,370073,0.9739865796488648,882,472,1354,-
chr16,370204,0.5856958762886598,605,484,1089,-
chr16,370509,0.4634098022901066,687,536,1223,-
chr16,636232,0.3399138340332305,708,502,1210,-
chr16,1350197,2.3960205831903947,918,582,1500,-
chr16,1350199,2.3960205831903947,918,582,1500,-
chr16,1350201,0.4355953658796288,633,516,1149,-
chr16,1420109,1.7632556568726783,907,422,1329,-
chr16,1420115,1.1577609900951962,1386,1026,2412,-
chr16,1420121,1.9458198051948048,891,703,1594,-
chr16,1420123,1.5404009304871376,1216,608,1824,-
chr16,1420135,2.230593607305936,976,437,1413,-
chr16,1420137,2.230593607305936,976,437,1413,-
chr16,1420191,2.9037416241847884,1210,709,1919,-
chr16,1420193,2.6869220681446357,1533,861,2394,-
chr16,1420195,2.70098531943687,832,412,1244,-
chr16,1566248,3.1814384725016462,606,395,1001,-
chr16,1772056,3.4487240450150582,988,700,1688,-
chr16,1772057,4.125656607246391,3151,2222,5373,-
chr16,1772058,4.124934305246969,3557,2575,6132,-
chr16,1772220,1.8308557653676174,650,523,1173,-
chr16,1772273,1.7437437437437433,870,628,1498,-
chr16,1772340,0.46720193910013624,770,482,1252,-
chr16,1772341,0.5090814737934614,653,469,1122,-
chr16,1772359,0.5561983471074381,672,483,1155,-
chr16,1772630,1.8608080463689052,1531,837,2368,-
chr16,1772638,1.5701149425287355,1365,695,2060,-
chr16,1772641,0.4720189835871071,650,388,1038,-
chr16,1772645,1.242923645683103,2980,1415,4395,-
chr16,1772647,1.242923645683103,2980,1415,4395,-
chr16,1772811,1.0600217916780343,2163,1202,3365,-
chr16,1772839,2.1475054229934925,719,460,1179,-
chr16,1772885,0.7875161770981536,1249,828,2077,-
chr16,1772886,0.9961884961884964,919,591,1510,-
chr16,1773081,2.1377317069743698,900,562,1462,-
chr16,1809251,2.2708333879634695,649,481,1130,-
chr16,1809781,0.8336174565291509,651,418,1069,-
chr16,1809782,1.2297258709308965,956,617,1573,-
chr16,1809784,2.5427872860635694,623,408,1031,-
chr16,1816953,1.4831959706959708,1564,1140,2704,-
chr16,1816954,1.8946666666666665,1101,749,1850,-
chr16,1817210,1.275,713,447,1160,-
chr16,1817212,1.275,713,447,1160,-
chr16,1962200,1.282264927829479,45787,32505,78292,-
chr16,1962243,1.153171815605095,15132,10349,25481,-
chr16,1962247,1.193693596747048,11189,7410,18599,-
chr16,1962249,1.1279209842598301,28184,18762,46946,-
chr16,1962250,1.2123935413801727,10292,6735,17027,-
chr16,1962254,1.3089804814744916,22808,13073,35881,-
chr16,1962255,1.3100157090532236,19123,10253,29376,-
chr16,1962256,1.3096098133426497,30695,17491,48186,-
chr16,1962257,1.2800997514937602,27695,17209,44904,-
chr16,1962260,1.3227643864515373,7203,3579,10782,-
chr16,1962261,1.3077069199819098,13046,7543,20589,-
chr16,1962266,1.5381679191921926,13303,7650,20953,-
chr16,1962267,1.4926303175554223,10898,5006,15904,-
chr16,1962268,1.5073477245802904,15835,8771,24606,-
chr16,1962269,1.458989359474955,9495,4889,14384,-
chr16,1962517,1.5918212524610298,1835,718,2553,-
chr16,1962520,1.7307692307692306,1727,671,2398,-
chr16,1962535,1.5374889738312258,1493,715,2208,-
chr16,1962537,1.659583605472,3434,2280,5714,-
chr16,1962538,1.659583605472,3434,2280,5714,-
chr16,1962656,0.6759014490028888,1352,923,2275,-
chr16,1962758,1.3316803719196417,11815,7138,18953,-
chr16,1962766,1.5866461581909137,23668,10250,33918,-
chr16,1962767,1.6374648652318553,18133,7149,25282,-
chr16,1962770,1.1803818224863094,5430,3628,9058,-
chr16,1962907,1.0623026471144768,87065,44457,131522,-
chr16,1962909,0.8798042641274444,23915,13352,37267,-
chr16,1963182,1.2472772568116457,67253,33751,101004,-
chr16,1963183,1.2649801184373886,40107,21896,62003,-
chr16,1963185,1.1964021228318913,66504,32052,98556,-
chr16,1963186,1.1871061011017592,24043,12778,36821,-
chr16,1963197,1.2712032917275458,31559,14568,46127,-
chr16,1963198,1.302305376133306,30571,14647,45218,-
chr16,1963199,0.9551143944194456,5817,4298,10115,-
chr16,1963200,1.240392089867062,15996,7894,23890,-
chr16,1963201,0.8707346657499596,43237,20283,63520,-
chr16,1963202,0.838281655652833,30829,12622,43451,-
chr16,1963203,1.065378933035935,49840,23421,73261,-
chr16,1963204,1.5911194861831612,16387,8879,25266,-
chr16,1963207,0.8804066994098145,18423,7709,26132,-
chr16,1963208,0.9196174150479972,15347,6480,21827,-
chr16,1963209,1.327319708173348,6115,3120,9235,-
chr16,1963213,1.3270909159013864,7625,3268,10893,-
chr16,1963215,1.192757415247304,21882,9251,31133,-
chr16,1963216,1.160160513576372,17917,7542,25459,-
chr16,1963223,0.6318829268292683,1407,624,2031,-
chr16,1963241,1.2937591418820091,2725,1315,4040,-
chr16,1963246,0.6523297491039427,727,557,1284,-
chr16,1963248,0.6523297491039427,727,557,1284,-
chr16,1963255,0.9297501549699979,1038,551,1589,-
chr16,1964617,1.3008923293715917,8276,4114,12390,-
chr16,1964619,1.2812631479647187,6258,2864,9122,-
chr16,1964626,1.2968973052826562,2203,1602,3805,-
chr16,1964627,1.1097803722753778,3877,2378,6255,-
chr16,1964815,1.3585076427996778,710,439,1149,-
chr16,1964816,0.7662378781723407,2029,1055,3084,-
chr16,1964821,1.3115958668197474,755,334,1089,-
chr16,1998454,1.851964817704639,966,797,1763,-
chr16,1998455,1.851964817704639,966,797,1763,-
chr16,2002371,2.2952029520295203,621,541,1162,-
chr16,2002372,2.123266912358101,1166,887,2053,-
chr16,2155104,0.9602891166466161,2303,1546,3849,-
chr16,2155294,1.4002582701739432,633,482,1115,-
chr16,2213815,1.5729166666666665,754,559,1313,-
chr16,2213822,1.1373981051858797,1550,1065,2615,-
chr16,2213956,0.45534725751014593,618,516,1134,-
chr16,2213991,0.9207633772194709,846,486,1332,-
chr16,2213992,0.9207633772194709,846,486,1332,-
chr16,2239987,1.07152946131936,1817,1611,3428,-
chr16,2239989,0.4707860445565363,1119,1091,2210,-
chr16,2239993,2.5824115044247793,643,451,1094,-
chr16,2240060,2.3933823529411766,650,431,1081,-
chr16,2240063,2.004218995290424,618,391,1009,-
chr16,2253249,1.4791720554971577,2889,1666,4555,-
chr16,2253258,2.0599024125779346,3916,2974,6890,-
chr16,2253313,2.317490494296578,741,525,1266,-
chr16,2253637,0.5830445225546266,668,502,1170,-
chr16,2253768,2.086005449820316,1272,879,2151,-
chr16,2253770,2.1344881889763783,752,507,1259,-
chr16,2253932,1.6899957805204395,1564,1295,2859,-
chr16,2253934,1.6899957805204395,1564,1295,2859,-
chr16,2262379,2.53448275862069,636,376,1012,-
chr16,2262381,2.53448275862069,636,376,1012,-
chr16,2262387,2.8457350272232307,783,434,1217,-
chr16,2262388,2.8457350272232307,783,434,1217,-
chr16,2264220,2.879291251384275,675,558,1233,-
chr16,2264221,2.0762276606413486,1303,1077,2380,-
chr16,2264624,1.476460565976527,613,499,1112,-
chr16,2772015,2.649158249158249,561,539,1100,-
chr16,2772070,1.4653887113951012,1633,938,2571,-
chr16,2772099,1.1341660724360718,2789,1909,4698,-
chr16,2772101,1.26506984424587,3966,2506,6472,-
chr16,2777052,0.5735221404241292,1346,957,2303,-
chr16,2777090,0.5673214984988905,914,651,1565,-
chr16,2777122,2.2060351224338364,990,621,1611,-
chr16,2777252,3.4058136221145627,702,637,1339,-
chr16,3022678,10.486858123193741,1349,1109,2458,-
chr16,3022681,5.216625563600732,718,697,1415,-
chr16,3022686,14.085361722092605,2452,1480,3932,-
chr16,3022687,14.610141533819126,2479,1556,4035,-
chr16,3022689,8.508064516129032,632,371,1003,-
chr16,3023941,0.677667140264203,1184,564,1748,-
chr16,3658214,0.5784946236559139,806,464,1270,-
chr16,3658228,1.0200855947864993,838,595,1433,-
chr16,3658229,0.4759266587521434,655,398,1053,-
chr16,3658230,1.0200855947864993,838,595,1433,-
chr16,3658850,0.9453385529940552,814,626,1440,-
chr16,3658851,1.1365016830635404,1457,1123,2580,-
chr16,3662034,1.7568891610532757,754,709,1463,-
chr16,3662040,1.692625835124895,1450,1312,2762,-
chr16,3662041,1.936980164425681,2121,1870,3991,-
chr16,3662043,2.1192398662425576,1391,1205,2596,-
chr16,3662085,2.1007006293789336,609,400,1009,-
chr16,3662100,1.9570152631325533,920,662,1582,-
chr16,3663443,1.8561187916026625,7974,7160,15134,-
chr16,3663444,1.7916131388289307,11690,10337,22027,-
chr16,3663446,1.8338668521735235,7646,6676,14322,-
chr16,3663463,0.9828888143766166,6178,4917,11095,-
chr16,3663485,0.5386488890366664,2399,2038,4437,-
chr16,3663500,1.7288546798029556,1776,1399,3175,-
chr16,3663510,0.7086463396671085,1414,1094,2508,-
chr16,3664287,0.7520775623268698,1447,1063,2510,-
chr16,3664289,1.764656671607599,2291,1623,3914,-
chr16,3664301,1.9950201110898296,867,680,1547,-
chr16,3664304,1.6995632707995714,997,742,1739,-
chr16,3664318,1.0637808025404394,1607,1097,2704,-
chr16,3664325,2.3791247143780194,1499,1003,2502,-
chr16,3664349,1.4723871544404008,886,453,1339,-
chr16,3664355,2.2766497461928936,779,393,1172,-
chr16,3666115,1.8079483412236308,1158,1080,2238,-
chr16,3666117,1.8079483412236308,1158,1080,2238,-
chr16,3671763,1.8090408067542207,934,532,1466,-
chr16,3671770,1.1171643281419672,1648,1128,2776,-
chr16,3674354,0.6696161353285622,663,579,1242,-
chr16,3674361,2.5175787728026537,798,602,1400,-
chr16,3674388,2.074021526418787,1086,729,1815,-
chr16,3674393,0.6604121911922665,786,607,1393,-
chr16,3674402,1.7205689993459776,618,555,1173,-
chr16,3674417,2.8529776674937968,656,495,1151,-
chr16,3675354,2.7722466960352423,608,453,1061,-
chr16,3676094,1.6551030668677726,822,662,1484,-
chr16,3676130,1.622299235014194,2618,1920,4538,-
chr16,3676131,1.5231638606991793,1917,1390,3307,-
chr16,3677549,1.5909871789278123,1481,1035,2516,-
chr16,3677602,1.466613247863248,968,701,1669,-
chr16,3677614,1.7567265061411954,1613,1189,2802,-
chr16,3677638,1.8987133862578707,866,561,1427,-
chr16,3679732,1.485842541489936,1926,1238,3164,-
chr16,3679774,1.7456999166765863,1804,1083,2887,-
chr16,3679782,2.182912648893931,3173,1762,4935,-
chr16,3679784,2.182912648893931,3173,1762,4935,-
chr16,3686018,0.5061562237212248,2627,1578,4205,-
chr16,3686047,1.4835470668485675,1181,732,1913,-
chr16,3686093,1.6848839731077858,913,635,1548,-
chr16,3686113,0.6217088729943939,1108,738,1846,-
chr16,3689101,1.5165632304344323,767,652,1419,-
chr16,3690839,1.9239852398523984,631,541,1172,-
chr16,3690854,2.811881188118812,780,504,1284,-
chr16,3690895,1.787941787941788,644,443,1087,-
chr16,3690933,1.9875747384155455,850,668,1518,-
chr16,3690934,1.9875747384155455,850,668,1518,-
chr16,3963195,3.4814685720924827,921,905,1826,-
chr16,3963196,2.8507424631879386,1448,1270,2718,-
chr16,3963205,2.0761666926798807,738,595,1333,-
chr16,3963206,1.5427827218639976,1115,881,1996,-
chr16,4114314,2.6128818061088976,786,501,1287,-
chr16,4114315,1.8240747407834097,1250,991,2241,-
chr16,4114316,1.4003430361676177,1867,1460,3327,-
chr16,4340979,1.6428003182179791,589,418,1007,-
chr16,4466217,1.5053263680954856,2813,2175,4988,-
chr16,4466221,2.5573188642297646,994,765,1759,-
chr16,4466266,1.2244760387302365,1377,795,2172,-
chr16,4466268,1.2244760387302365,1377,795,2172,-
chr16,4466292,1.9244791666666667,738,527,1265,-
chr16,4466310,1.5112920860401717,1403,841,2244,-
chr16,4466311,1.7058470164197037,1216,680,1896,-
chr16,4562908,2.0596707818930042,909,647,1556,-
chr16,4562909,3.5680842762387823,589,465,1054,-
chr16,4562911,1.011470352056126,1785,1194,2979,-
chr16,4562912,1.011470352056126,1785,1194,2979,-
chr16,4562913,5.486064659977703,531,597,1128,-
chr16,4562915,5.486064659977703,531,597,1128,-
chr16,4562934,0.37332140313872414,695,434,1129,-
chr16,4803567,4.60752882614966,432,779,1211,-
chr16,8854968,0.41339409615352574,473,622,1095,-
chr16,8854992,27.43909049320714,2721,1704,4425,-
chr16,8854993,27.413408959498565,2878,1749,4627,-
chr16,8854994,27.413408959498568,2878,1749,4627,-
chr16,8854999,8.45196829778118,2484,475,2959,-
chr16,8855000,8.774365584502924,1969,370,2339,-
chr16,8855001,9.20838141237083,1740,307,2047,-
chr16,8855314,1.2695518063183286,1152,794,1946,-
chr16,8858445,3.2615896480701507,795,506,1301,-
chr16,8858456,1.567191322640265,651,473,1124,-
chr16,8859180,1.7353299908860518,820,516,1336,-
chr16,10529465,0.9603873631443008,890,637,1527,-
chr16,10530381,4.525613173591116,638,506,1144,-
chr16,10533023,0.4474804031354983,665,469,1134,-
chr16,10533024,0.4474804031354983,665,469,1134,-
chr16,11548179,2.0500625782227786,1169,939,2108,-
chr16,11548217,0.7417031146905377,1879,1300,3179,-
chr16,11548226,1.9054441260744988,909,697,1606,-
chr16,11548229,1.73421926910299,869,644,1513,-
chr16,11548385,0.9596207812571766,4414,3249,7663,-
chr16,11548514,1.9463786865475277,7427,6514,13941,-
chr16,11548530,1.2573172774716135,26856,21701,48557,-
chr16,11548532,1.3058121301604049,21625,16780,38405,-
chr16,11548533,1.248797029862291,11645,8266,19911,-
chr16,11548534,1.2437702309771193,24366,18626,42992,-
chr16,11548535,1.2577110761497334,29792,21866,51658,-
chr16,11548536,1.1221455159228246,29810,22863,52673,-
chr16,11548539,1.076777806385548,13374,10588,23962,-
chr16,11548562,1.3559119983208194,11138,8541,19679,-
chr16,11548568,1.8365479060362737,4859,3893,8752,-
chr16,11548571,1.5986713282220348,4471,3515,7986,-
chr16,11548575,1.2360555592949887,5590,3441,9031,-
chr16,11548576,1.4509451584404118,6379,4348,10727,-
chr16,11548580,1.621309231266819,5497,3754,9251,-
chr16,11548587,1.7482613491701164,6629,4398,11027,-
chr16,11548588,1.626208054313751,4938,3440,8378,-
chr16,11548589,1.626208054313751,4938,3440,8378,-
chr16,11548591,1.835762736325588,794,532,1326,-
chr16,11548612,1.4118525896414342,1484,1003,2487,-
chr16,11548685,0.6009187607851597,2742,1951,4693,-
chr16,11548687,0.6009187607851597,2742,1951,4693,-
chr16,11548711,1.703804347826087,702,591,1293,-
chr16,11548755,0.3999214145383104,726,508,1234,-
chr16,11548759,0.4229377024195085,1849,1447,3296,-
chr16,11548760,0.4229377024195085,1849,1447,3296,-
chr16,11548761,1.1950799288403298,2484,1879,4363,-
chr16,11548816,2.9229008977292734,614,436,1050,-
chr16,11548969,1.5192424571646308,3445,2102,5547,-
chr16,11548970,1.6255063054548116,4687,3069,7756,-
chr16,11549025,1.6731203007518796,773,664,1437,-
chr16,11549260,1.5975301018832977,1231,789,2020,-
chr16,11549264,1.7853441894892672,1205,771,1976,-
chr16,11549338,0.6474195961106957,1622,954,2576,-
chr16,11549360,1.2785099279564225,883,812,1695,-
chr16,11549374,1.8320999074930615,698,563,1261,-
chr16,11549406,2.18586255259467,828,712,1540,-
chr16,11549470,0.5516783513915445,610,522,1132,-
chr16,11549517,0.4364079212114794,633,496,1129,-
chr16,11553608,1.5330851030260957,1184,736,1920,-
chr16,11553688,1.7668569537519652,1123,710,1833,-
chr16,11556522,0.6381210001979283,743,658,1401,-
chr16,11556528,2.7682085356503956,676,601,1277,-
chr16,11556546,1.7054421768707482,653,587,1240,-
chr16,11556547,1.7493421547252086,1107,848,1955,-
chr16,11556549,1.849938629882677,2172,1512,3684,-
chr16,11556636,1.797292780748663,716,543,1259,-
chr16,11556645,0.5836177474402731,949,585,1534,-
chr16,11837411,0.7489144225442719,761,522,1283,-
chr16,11837591,0.6790010659357393,1273,795,2068,-
chr16,11837613,1.2862662327925778,2102,1493,3595,-
chr16,11837623,1.5655111593372704,1388,868,2256,-
chr16,11837936,1.5866753190568896,1383,1004,2387,-
chr16,11839807,1.6958355868036776,1169,1074,2243,-
chr16,11841790,1.6115885515257062,1442,1123,2565,-
chr16,11846595,1.567289719626168,1676,1069,2745,-
chr16,11846601,1.9544564055543445,2531,1798,4329,-
chr16,11850413,0.545176756969475,1010,740,1750,-
chr16,11851426,1.0087750087750087,957,813,1770,-
chr16,11851427,1.0087750087750087,957,813,1770,-
chr16,11851518,0.9085599498136538,1071,782,1853,-
chr16,11851519,1.2193140498575032,1005,685,1690,-
chr16,11851521,1.3029442150078223,753,567,1320,-
chr16,11872824,1.6145444295680362,715,616,1331,-
chr16,11873003,3.5256132756132756,673,503,1176,-
chr16,11873062,1.8621084797555385,999,747,1746,-
chr16,11873168,1.860973623118745,1448,938,2386,-
chr16,11875904,1.7651293313811613,850,682,1532,-
chr16,11875909,1.7360025023459493,739,555,1294,-
chr16,11875912,1.7710891089108907,687,504,1191,-
chr16,11875924,1.730113636363636,869,549,1418,-
chr16,11876163,1.8451496497558904,914,672,1586,-
chr16,11877506,1.825515068959646,952,838,1790,-
chr16,11877534,2.0345984345195025,813,660,1473,-
chr16,11885249,1.7618394286434327,1776,1394,3170,-
chr16,11886502,1.6321083687225995,2083,1444,3527,-
chr16,11886929,1.8267025233211192,2356,1574,3930,-
chr16,11891079,2.0078740157480315,674,634,1308,-
chr16,11891136,2.289998712168134,1054,684,1738,-
chr16,11896640,1.3430966261793136,2065,1530,3595,-
chr16,11896641,1.7427154997976526,1324,1058,2382,-
chr16,11896729,1.7328684050939966,1142,678,1820,-
chr16,11897849,1.3385194671151972,1879,1851,3730,-
chr16,11897856,1.471680790960452,1602,1415,3017,-
chr16,11897863,1.9125744308231172,1495,1141,2636,-
chr16,11897866,1.5195955619183967,1257,1015,2272,-
chr16,11897875,1.1034212792609408,1943,1445,3388,-
chr16,11897877,0.8880857315696421,3299,2690,5989,-
chr16,11898007,1.522924868766404,1060,1015,2075,-
chr16,11898008,0.49953941308066857,583,446,1029,-
chr16,11898011,0.47169751313647534,1560,1297,2857,-
chr16,11898012,2.474407384099014,760,453,1213,-
chr16,11898018,1.7095997983996079,1929,1602,3531,-
chr16,11898019,1.9550029603315568,1015,562,1577,-
chr16,11898020,1.7095997983996079,1929,1602,3531,-
chr16,11898021,1.9550029603315568,1015,562,1577,-
chr16,11898026,2.4867469879518067,859,414,1273,-
chr16,11898027,2.421701502443295,1298,769,2067,-
chr16,11898030,2.585159940569713,708,407,1115,-
chr16,11915806,2.03517187687008,636,504,1140,-
chr16,14606508,1.741895516123054,751,577,1328,-
chr16,14606510,2.3982022471910107,666,444,1110,-
chr16,14989158,1.819115890083632,661,809,1470,-
chr16,14989159,2.14630288651641,943,1123,2066,-
chr16,14989161,2.100062813152782,1131,1200,2331,-
chr16,14989162,1.7203722016343181,1471,1315,2786,-
chr16,14989163,1.7203722016343181,1471,1315,2786,-
chr16,15041114,0.8140001293912144,698,532,1230,-
chr16,15041115,0.8140001293912144,698,532,1230,-
chr16,15061076,5.054875092630011,822,540,1362,-
chr16,15061078,5.2496152768340405,819,521,1340,-
chr16,15865849,1.879608146429492,633,430,1063,-
chr16,15865989,2.2187578911926304,1136,787,1923,-
chr16,15866840,0.5781515280135823,640,495,1135,-
chr16,15867504,1.9328441736102473,817,560,1377,-
chr16,15867505,2.111823925958278,805,551,1356,-
chr16,18531563,1.1315283400809717,770,379,1149,-
chr16,18531564,1.6301879428225043,1518,843,2361,-
chr16,18531566,2.1029271206690563,748,464,1212,-
chr16,18543679,1.7136829912727451,1149,875,2024,-
chr16,18561894,0.8362243473905372,1265,1065,2330,-
chr16,18561895,0.4871104270873413,632,564,1196,-
chr16,18784804,1.191918020625668,14316,11800,26116,-
chr16,18784824,0.9541260185941701,870,706,1576,-
chr16,18788123,1.270946312432951,35470,22453,57923,-
chr16,18788125,1.2701610843001265,66090,45223,111313,-
chr16,18788138,1.2600489273045337,9704,6331,16035,-
chr16,18789039,3.9653425091372867,10114,8653,18767,-
chr16,18789076,0.9578285024049549,28274,19866,48140,-
chr16,18789101,0.8735144191182421,10195,7802,17997,-
chr16,18789102,1.221380830791165,25950,17793,43743,-
chr16,18789103,1.208601234264277,30867,21701,52568,-
chr16,18789114,1.3565658046544835,7046,5317,12363,-
chr16,18789115,1.270284268875272,12775,8768,21543,-
chr16,18790282,1.6562107904642411,1319,796,2115,-
chr16,18790289,2.5220855707604364,727,501,1228,-
chr16,18790292,1.8163924794359576,686,443,1129,-
chr16,18790318,1.1901336073997943,4922,3828,8750,-
chr16,18790321,1.3487635927545603,6112,3810,9922,-
chr16,18790324,1.7423762648860746,3564,1989,5553,-
chr16,18790329,1.0453578090773292,8351,6249,14600,-
chr16,18790330,0.8112552244117213,9004,6583,15587,-
chr16,18790331,0.9526085418188461,7418,5475,12893,-
chr16,18790332,1.038172688940085,10266,7576,17842,-
chr16,18790333,1.1102073025248365,9180,6045,15225,-
chr16,18790334,1.1017122256551297,10254,6756,17010,-
chr16,18790335,1.161453400165851,7646,4853,12499,-
chr16,18790359,0.9919380722993509,1169,503,1672,-
chr16,18790361,0.9427421185212445,1516,635,2151,-
chr16,18791810,1.7619701726844583,1094,727,1821,-
chr16,18791814,2.139720558882236,1071,667,1738,-
chr16,18792711,1.763861003861004,1268,874,2142,-
chr16,18792966,1.5401151800237394,1321,988,2309,-
chr16,18793120,0.5352722772277227,1037,807,1844,-
chr16,18794633,1.5495049504950495,938,605,1543,-
chr16,18794635,1.9444444444444449,751,563,1314,-
chr16,18795532,1.7976014014283792,919,723,1642,-
chr16,18795533,1.289142642673285,1567,1271,2838,-
chr16,18798035,0.6694171348314607,737,533,1270,-
chr16,18798041,2.1689084390996496,1299,879,2178,-
chr16,18798749,1.744615384615385,971,649,1620,-
chr16,18798766,1.806170598911071,932,569,1501,-
chr16,18798770,1.7500838644750083,887,541,1428,-
chr16,18798828,0.3082353484228104,598,479,1077,-
chr16,18801454,2.053963119423894,1036,830,1866,-
chr16,18801527,4.365431489890647,1518,1153,2671,-
chr16,18801528,3.7129151291512916,773,541,1314,-
chr16,19503102,1.8211825860948667,636,404,1040,-
chr16,19503232,1.457182283640459,2752,3131,5883,-
chr16,19503233,1.7014865849061451,2117,2333,4450,-
chr16,19503238,2.006731234866828,726,825,1551,-
chr16,19503239,2.6855285799250925,890,873,1763,-
chr16,19503240,1.8518904823989568,1059,1179,2238,-
chr16,19503242,1.8714934172193964,1708,1600,3308,-
chr16,19503243,1.9526039940393491,1781,1748,3529,-
chr16,19503244,1.9526039940393491,1781,1748,3529,-
chr16,19503245,2.308333333333333,830,731,1561,-
chr16,19503336,0.28001288252305356,994,735,1729,-
chr16,19505062,2.2402243445437593,2384,1490,3874,-
chr16,19505069,2.1036143330571666,1874,1135,3009,-
chr16,19505071,2.1036143330571666,1874,1135,3009,-
chr16,19505080,0.5969284265430311,823,475,1298,-
chr16,19507709,1.8308152843810532,3057,1892,4949,-
chr16,19507715,1.6373935138326583,2566,1481,4047,-
chr16,19507746,2.085721023464214,1082,770,1852,-
chr16,19507749,1.1298635142456621,3126,1864,4990,-
chr16,19507753,1.7819356411506582,885,585,1470,-
chr16,19507756,1.707082521117609,820,512,1332,-
chr16,19507768,2.7270023790642353,654,387,1041,-
chr16,19510862,2.562938230383973,1009,598,1607,-
chr16,19510863,2.562938230383973,1009,598,1607,-
chr16,19510927,2.336455996833355,931,582,1513,-
chr16,19510928,2.336455996833355,931,582,1513,-
chr16,22374253,1.5938144851155267,642,439,1081,-
chr16,23581109,1.9251952035694369,788,651,1439,-
chr16,23587284,0.3605520414031053,683,563,1246,-
chr16,23587308,1.5722327441077442,694,575,1269,-
chr16,23596152,1.5727105409378093,1284,978,2262,-
chr16,23596195,1.9358876340270497,653,498,1151,-
chr16,23596274,2.9603040540540535,700,443,1143,-
chr16,23596275,2.9603040540540535,700,443,1143,-
chr16,23596295,4.706276603157836,725,419,1144,-
chr16,27225195,2.7508278782291216,633,444,1077,-
chr16,27234224,3.162790131307368,796,561,1357,-
chr16,27235281,2.4023018345448253,1206,855,2061,-
chr16,27235283,2.284571723426213,1770,1223,2993,-
chr16,27235284,2.1482803330738545,1431,981,2412,-
chr16,28104640,2.433637470040543,587,420,1007,-
chr16,28180991,2.1544079779015872,718,688,1406,-
chr16,28180992,1.9029213721599503,1240,1092,2332,-
chr16,28180993,2.337782547454557,941,876,1817,-
chr16,28180994,2.4354632587859433,692,625,1317,-
chr16,28180996,0.7602717567130379,704,561,1265,-
chr16,28180997,0.7602717567130379,704,561,1265,-
chr16,28180998,1.1861945637666131,1036,786,1822,-
chr16,28211466,5.647777155243931,715,664,1379,-
chr16,28211467,6.636332469058928,879,742,1621,-
chr16,28211468,7.296555555555556,676,499,1175,-
chr16,28537540,1.9809401709401708,945,935,1880,-
chr16,28537542,1.9809401709401708,945,935,1880,-
chr16,28537544,2.4642116113377734,733,625,1358,-
chr16,28537557,1.0102398331595408,722,684,1406,-
chr16,28537559,1.0102398331595408,722,684,1406,-
chr16,28538123,0.5206457796906422,728,690,1418,-
chr16,28538125,0.5206457796906422,728,690,1418,-
chr16,28538831,2.9435823092977924,685,502,1187,-
chr16,28538848,1.5640972339329582,867,619,1486,-
chr16,28538849,3.2361794724140025,691,475,1166,-
chr16,28842871,1.7922437673130194,646,493,1139,-
chr16,28842961,0.673877030901561,1281,729,2010,-
chr16,28842997,2.347953216374269,802,607,1409,-
chr16,28843021,1.6314404246777,891,772,1663,-
chr16,28843092,1.8086207577733,973,766,1739,-
chr16,28843116,1.9017857142857144,1064,727,1791,-
chr16,28843799,2.5142857142857142,607,569,1176,-
chr16,28844094,0.9822705119310228,1466,1183,2649,-
chr16,28844290,0.4905815423514538,596,451,1047,-
chr16,28844294,2.5456273764258555,617,525,1142,-
chr16,28844295,0.5837161037717088,1139,940,2079,-
chr16,28844305,1.6846784168212738,588,538,1126,-
chr16,28844308,1.722147147147147,790,554,1344,-
chr16,28844318,2.65283540802213,684,481,1165,-
chr16,28844779,1.598947266756809,848,667,1515,-
chr16,28844830,1.2452239718029385,2430,1864,4294,-
chr16,28844833,1.821050259184133,1009,764,1773,-
chr16,28844839,1.5752075919335706,1083,842,1925,-
chr16,28845050,1.6858833689155395,4023,2513,6536,-
chr16,28845051,1.6091638518187377,4449,2420,6869,-
chr16,28845053,1.0586969737015992,2412,1174,3586,-
chr16,28845055,0.8707931277947751,1257,606,1863,-
chr16,28845325,0.6139964788732395,1022,703,1725,-
chr16,28845447,1.7471590909090906,614,527,1141,-
chr16,28845475,2.039318358548411,1042,777,1819,-
chr16,28846006,2.3029107870378884,1184,760,1944,-
chr16,28846080,1.926239340459408,1037,802,1839,-
chr16,28846081,0.9679012345679012,559,449,1008,-
chr16,29860593,0.8065508765102055,686,503,1189,-
chr16,29895838,3.056927387246432,717,488,1205,-
chr16,30353385,2.7056775524756933,609,436,1045,-
chr16,30353386,2.7056775524756933,609,436,1045,-
chr16,30354036,0.9705301592185411,725,484,1209,-
chr16,30354039,1.132568282230785,699,459,1158,-
chr16,30423789,2.0899049566904995,888,676,1564,-
chr16,30423874,2.740689175078316,761,506,1267,-
chr16,30423893,0.2979876160990712,714,441,1155,-
chr16,30423896,1.9088406240440503,623,466,1089,-
chr16,30423903,1.0850979749583787,1244,839,2083,-
chr16,30423934,2.4670912951167727,663,470,1133,-
chr16,30423936,2.73219491878384,983,685,1668,-
chr16,30423937,3.0379984951091052,645,442,1087,-
chr16,30424088,1.05198409027842,668,568,1236,-
chr16,30424089,1.4845608864954618,1018,827,1845,-
chr16,30429126,0.25607490569093105,782,714,1496,-
chr16,30429938,11.042946526117298,2041,2027,4068,-
chr16,30429939,13.51033402944667,2593,2314,4907,-
chr16,30429940,12.591318067552637,2773,2415,5188,-
chr16,30429941,18.209713972257784,1831,1384,3215,-
chr16,30429948,8.383195331100014,868,349,1217,-
chr16,30429949,8.383195331100014,868,349,1217,-
chr16,30443869,1.0054347826086956,924,574,1498,-
chr16,30443871,1.0054347826086956,924,574,1498,-
chr16,30444040,2.334986772486773,613,431,1044,-
chr16,30444087,3.815396827712296,951,853,1804,-
chr16,30444104,2.071397756686799,581,487,1068,-
chr16,30445018,3.06621471966977,735,567,1302,-
chr16,30445019,3.3548336063728175,711,485,1196,-
chr16,31090960,1.8665936815764779,769,555,1324,-
chr16,31090980,1.7643784786641932,950,692,1642,-
chr16,31091026,1.653048525159088,1299,826,2125,-
chr16,31091101,1.6020671834625322,898,521,1419,-
chr16,31091164,1.9111002564415682,625,430,1055,-
chr16,31091239,0.5722084367245658,1152,898,2050,-
chr16,31091269,1.6262055204522778,977,775,1752,-
chr16,31093334,0.6653160053367595,747,685,1432,-
chr16,31093356,0.4334942457557037,1344,1130,2474,-
chr16,31093365,0.6217409412744689,621,489,1110,-
chr16,31093381,3.419651771031553,1439,1253,2692,-
chr16,31093382,5.3821733821733835,550,467,1017,-
chr16,31093394,3.559066537099886,867,650,1517,-
chr16,31094732,0.49059475916059575,751,540,1291,-
chr16,31094734,0.833302609610321,999,764,1763,-
chr16,31094741,1.3896987199321575,846,570,1416,-
chr16,31499363,3.035441835025467,696,564,1260,-
chr16,31569179,2.3796596508105723,1086,744,1830,-
chr16,31569183,0.5158562367864693,609,429,1038,-
chr16,31569245,1.2938291139240503,628,473,1101,-
chr16,31569247,0.5538564098420267,702,466,1168,-
chr16,31569249,0.5538564098420267,702,466,1168,-
chr16,35802607,0.7504474551667796,1041,886,1927,-
chr16,35802608,0.9054310344827586,777,579,1356,-
chr16,46618354,1.0968403825535176,707,502,1209,-
chr16,46659985,1.9375969396212953,1021,828,1849,-
chr16,46661807,1.6639723712249248,646,438,1084,-
chr16,46661814,1.674341077195541,1147,661,1808,-
chr16,46661815,1.674341077195541,1147,661,1808,-
chr16,46661827,3.203621448972031,1126,733,1859,-
chr16,46661829,2.7453210629717715,884,508,1392,-
chr16,46662326,0.3961810084337967,773,622,1395,-
chr16,46663060,1.9988207547169807,1129,847,1976,-
chr16,46663061,1.9988207547169807,1129,847,1976,-
chr16,46663143,1.8461538461538465,679,441,1120,-
chr16,46668977,2.688552928977708,1193,954,2147,-
chr16,46668978,2.8985420650095604,692,522,1214,-
chr16,46674396,1.8816147859922174,666,513,1179,-
chr16,46674636,2.0092879256965945,648,398,1046,-
chr16,46676659,1.5382236617487444,1042,735,1777,-
chr16,46680774,1.1744407168496942,1179,791,1970,-
chr16,46680783,2.1749813849590467,634,394,1028,-
chr16,46682135,0.735861339028137,936,676,1612,-
chr16,46683520,2.5194167863463406,649,467,1116,-
chr16,46956692,3.5304960693955003,813,433,1246,-
chr16,46956694,3.5304960693955003,813,433,1246,-
chr16,46956765,0.5947136563876653,593,453,1046,-
chr16,46956869,3.1025179856115113,620,416,1036,-
chr16,46959028,1.9892473118279568,850,557,1407,-
chr16,46959062,0.6319332712338047,596,481,1077,-
chr16,46959068,1.981568826909934,1100,721,1821,-
chr16,46959075,1.9565443772477293,1434,914,2348,-
chr16,46959076,2.057567886658796,926,604,1530,-
chr16,46964646,1.5625193486471427,1552,1041,2593,-
chr16,46964647,0.5818014705882353,632,415,1047,-
chr16,46964653,0.8639085478243309,4500,2510,7010,-
chr16,46964654,0.6192941176470589,3195,1699,4894,-
chr16,46964688,1.8433014354066986,803,417,1220,-
chr16,46964691,1.8047983780130656,762,385,1147,-
chr16,46964693,3.148456057007126,722,420,1142,-
chr16,46964711,4.714131607335491,759,411,1170,-
chr16,46964735,5.214673913043479,706,321,1027,-
chr16,46964789,0.3084491978609625,720,424,1144,-
chr16,46964791,0.8119453052739981,990,622,1612,-
chr16,46971426,2.3797905113986446,567,540,1107,-
chr16,46971427,2.7118101965912786,881,823,1704,-
chr16,46971456,3.6265068532166587,1339,927,2266,-
chr16,46971549,2.309725699211284,2257,1826,4083,-
chr16,46971553,1.7226722672267232,2119,1615,3734,-
chr16,46971559,1.6085206425680136,4071,2649,6720,-
chr16,46971910,1.4753778644563629,1423,878,2301,-
chr16,46971916,1.7748798361043256,1324,776,2100,-
chr16,46971917,2.1386637713753918,1198,696,1894,-
chr16,46971918,0.6236792452830189,1201,1059,2260,-
chr16,46971921,2.7530111633372503,1070,591,1661,-
chr16,46971929,1.486082355647573,968,482,1450,-
chr16,46971934,1.8342969733575392,1692,1211,2903,-
chr16,46971943,0.6477854518693393,2580,1330,3910,-
chr16,46971944,0.6477854518693393,2580,1330,3910,-
chr16,46971948,1.5574795215578316,2089,1533,3622,-
chr16,46971949,1.7883388089573655,1632,1260,2892,-
chr16,46971950,1.807734145752391,1895,1441,3336,-
chr16,46971953,2.2830764815529063,1175,791,1966,-
chr16,46971954,2.1783483922589273,1226,837,2063,-
chr16,46973507,2.417726499282677,1124,652,1776,-
chr16,46973508,2.4324970131421737,1017,557,1574,-
chr16,46973510,2.25847260909935,670,358,1028,-
chr16,47311252,2.5206394857046184,902,513,1415,-
chr16,47311254,2.5206394857046184,902,513,1415,-
chr16,47313753,1.827061773951011,2515,2123,4638,-
chr16,47313781,1.8121974074652507,1008,673,1681,-
chr16,47313801,1.8926522506619596,1409,1132,2541,-
chr16,47313802,1.8926522506619596,1409,1132,2541,-
chr16,47313806,0.6208736373407032,646,500,1146,-
chr16,47313810,1.695995423340961,548,459,1007,-
chr16,47598842,2.939904341259125,652,529,1181,-
chr16,54919031,2.043354058141489,759,540,1299,-
chr16,54919208,0.3375959079283887,626,436,1062,-
chr16,54920365,1.3529032274082533,608,421,1029,-
chr16,56430035,4.986022269604359,618,468,1086,-
chr16,56430036,4.986022269604359,618,468,1086,-
chr16,56430125,1.6240764660294498,805,552,1357,-
chr16,56430574,1.8557173403930352,674,426,1100,-
chr16,56431001,2.046936523688994,656,518,1174,-
chr16,56431020,3.1364328088204085,1412,1053,2465,-
chr16,56431098,1.1502307264305158,685,511,1196,-
chr16,56431845,2.733296400594568,966,747,1713,-
chr16,56431985,1.8797595190380765,736,498,1234,-
chr16,56432596,3.540884312537856,631,507,1138,-
chr16,56432692,1.7425110132158592,585,453,1038,-
chr16,56432726,1.539073189621789,863,634,1497,-
chr16,56434425,2.704442670923118,781,536,1317,-
chr16,56439725,0.6249011232399937,789,587,1376,-
chr16,56446643,0.5874116082055589,838,620,1458,-
chr16,56446673,2.177419354838709,1349,929,2278,-
chr16,56446674,2.177419354838709,1349,929,2278,-
chr16,56447850,1.9121243885394832,994,635,1629,-
chr16,56447854,1.7817568366187435,1591,1238,2829,-
chr16,56447887,1.9041082164328658,612,498,1110,-
chr16,56447918,2.122340425531915,854,469,1323,-
chr16,56447941,2.2671171171171176,718,369,1087,-
chr16,56447956,2.7903474903474907,656,369,1025,-
chr16,56447972,2.971089232692608,775,710,1485,-
chr16,56447974,1.6696099139600409,1745,1502,3247,-
chr16,56447975,0.5727331896025708,970,792,1762,-
chr16,56451146,2.6609708144045006,1039,722,1761,-
chr16,56451147,2.9367681498829037,626,426,1052,-
chr16,56451183,0.15725627213481821,662,444,1106,-
chr16,56500986,2.123597570312899,790,640,1430,-
chr16,57153959,2.5138386653132065,851,672,1523,-
chr16,57154136,2.408078994614004,788,556,1344,-
chr16,57154137,2.408078994614004,788,556,1344,-
chr16,57164061,3.0440506775730976,614,403,1017,-
chr16,57172323,4.710281411042215,707,444,1151,-
chr16,57172841,1.1484036585167088,634,427,1061,-
chr16,57428971,2.299031476997579,632,412,1044,-
chr16,57428972,2.299031476997579,632,412,1044,-
chr16,57432557,2.9559630738522946,676,500,1176,-
chr16,57432558,2.9559630738522946,676,500,1176,-
chr16,57434113,0.32075111865499367,704,535,1239,-
chr16,57440792,3.109760924407691,652,396,1048,-
chr16,57758345,2.6931752159593505,597,460,1057,-
chr16,57758346,2.930432690473916,987,855,1842,-
chr16,57758603,26.52460227227783,782,632,1414,-
chr16,57758604,26.52460227227783,782,632,1414,-
chr16,57761150,1.3029847982454617,692,595,1287,-
chr16,57761464,2.1734789809018706,725,482,1207,-
chr16,57762154,0.7840342124019957,599,487,1086,-
chr16,57762155,0.7840342124019957,599,487,1086,-
chr16,57765537,2.2811129396182754,980,648,1628,-
chr16,57766953,2.778429892930649,913,700,1613,-
chr16,57769712,3.0194454918794063,511,568,1079,-
chr16,57769948,0.7346275833793109,618,565,1183,-
chr16,57770697,5.436109422878991,677,456,1133,-
chr16,58116930,1.8142655892209172,749,605,1354,-
chr16,58160471,1.6704777671165745,655,483,1138,-
chr16,58160486,1.9191118160190328,549,484,1033,-
chr16,58160487,1.9191118160190328,549,484,1033,-
chr16,58160488,1.9191118160190328,549,484,1033,-
chr16,58520778,0.6682235055782407,601,488,1089,-
chr16,58526039,2.768416632365452,799,559,1358,-
chr16,58528641,3.6099019770726035,678,462,1140,-
chr16,58543740,2.092278291926972,774,532,1306,-
chr16,58546453,2.3755215218653865,1799,1153,2952,-
chr16,58546463,1.4392944386282165,855,552,1407,-
chr16,58551186,1.526315789473684,898,557,1455,-
chr16,58551194,0.7619480710260891,2395,1518,3913,-
chr16,58551196,0.45083483152833087,1746,1150,2896,-
chr16,58707208,1.4482179951373406,1351,1083,2434,-
chr16,58707588,1.5585919209977441,795,572,1367,-
chr16,58707624,2.56058527663466,699,485,1184,-
chr16,58707695,1.958628198149156,770,500,1270,-
chr16,58707738,3.765355602078152,1046,828,1874,-
chr16,58707903,1.590316989992732,861,576,1437,-
chr16,58707965,2.243478260869565,601,459,1060,-
chr16,58708145,0.9161873068695032,802,600,1402,-
chr16,58708147,0.9161873068695032,802,600,1402,-
chr16,58708252,0.6181318681318682,644,363,1007,-
chr16,58708282,1.1338379834235688,666,506,1172,-
chr16,58709478,1.3807706270298938,1456,1100,2556,-
chr16,58716106,0.5403720751822018,804,473,1277,-
chr16,58718297,1.206382570424193,2028,1659,3687,-
chr16,58718298,1.206382570424193,2028,1659,3687,-
chr16,58718299,1.0403878088927236,1859,1409,3268,-
chr16,58718578,2.031234807972776,618,483,1101,-
chr16,58722243,1.365537901169996,677,522,1199,-
chr16,61055452,2.4686868686868686,563,593,1156,-
chr16,61055454,1.8969764446792297,1886,1674,3560,-
chr16,61055456,1.6220607832179856,1323,1081,2404,-
chr16,61055461,0.5067176918138885,1366,911,2277,-
chr16,61055465,1.2306893106893109,1061,714,1775,-
chr16,61055466,1.2306893106893109,1061,714,1775,-
chr16,61055467,1.2306893106893109,1061,714,1775,-
chr16,61055598,1.4440419784725385,3006,2622,5628,-
chr16,61055599,1.2753147721397464,7435,5695,13130,-
chr16,61055602,0.6611655850304581,14780,10339,25119,-
chr16,61055603,0.7538946688420115,7189,5038,12227,-
chr16,61055604,0.6977582384285816,17561,12475,30036,-
chr16,61055606,0.7171191917975468,7671,5743,13414,-
chr16,61055607,0.753640065899664,1151,1038,2189,-
chr16,61055882,0.8285682826260943,12763,9433,22196,-
chr16,61055883,1.1694055187653756,11424,6355,17779,-
chr16,61055899,0.8576615396891895,5373,4091,9464,-
chr16,61055909,1.2736141416577822,15027,8824,23851,-
chr16,61055910,1.2909079526726588,16282,8546,24828,-
chr16,61055912,1.0539641389772656,14816,7654,22470,-
chr16,61055914,0.8337409699634375,26961,16186,43147,-
chr16,61055915,0.8393908090926651,18107,11048,29155,-
chr16,61055916,0.8662653035458732,27025,17691,44716,-
chr16,61055917,0.8459944751381214,1924,1447,3371,-
chr16,61055918,0.94465552533438,4990,3753,8743,-
chr16,61055924,1.5604235814762133,1762,998,2760,-
chr16,61055925,0.6070469299767084,1391,1186,2577,-
chr16,61055926,1.3087901725412237,1153,901,2054,-
chr16,61055928,1.49563767876913,3166,2682,5848,-
chr16,61055929,1.4894713268895623,3104,2621,5725,-
chr16,61055935,1.6016648128879476,1115,592,1707,-
chr16,66721475,0.3132756132756133,667,615,1282,-
chr16,66721476,0.3132756132756133,667,615,1282,-
chr16,66721528,5.377049329819379,941,955,1896,-
chr16,66721529,6.238711510119956,658,607,1265,-
chr16,66721535,4.913012172089115,775,548,1323,-
chr16,66721536,6.942253121893425,1029,771,1800,-
chr16,66722930,5.922953827520302,686,631,1317,-
chr16,66723218,7.939224159508668,793,820,1613,-
chr16,66809046,1.907547747439398,869,619,1488,-
chr16,66810754,2.2327453987730057,646,488,1134,-
chr16,66810762,0.3750261889796773,715,443,1158,-
chr16,66813615,6.113807531380753,561,477,1038,-
chr16,66813633,1.7435897435897438,764,584,1348,-
chr16,66817447,2.129165709032406,771,457,1228,-
chr16,66826758,1.648188773330328,1075,831,1906,-
chr16,66826760,0.8384861407249468,571,468,1039,-
chr16,66932156,2.8378148400272294,666,451,1117,-
chr16,66932169,4.052521008403361,642,475,1117,-
chr16,66932174,0.5458823529411765,637,424,1061,-
chr16,66932175,0.33358863932702565,1209,1034,2243,-
chr16,66932254,0.5956354300385109,637,450,1087,-
chr16,66932296,0.30561132590663465,1401,862,2263,-
chr16,66932297,0.30561132590663465,1401,862,2263,-
chr16,66932298,0.30561132590663465,1401,862,2263,-
chr16,66933651,0.30297690809607714,725,525,1250,-
chr16,66933725,0.574177698921796,600,430,1030,-
chr16,66934061,1.042207786953264,1381,1179,2560,-
chr16,66934062,0.6793997271487039,887,732,1619,-
chr16,66934325,0.6640813741035384,558,510,1068,-
chr16,66934326,0.6536710037174722,520,537,1057,-
chr16,66934328,0.7882131663965213,518,489,1007,-
chr16,67148378,2.0511695906432745,914,569,1483,-
chr16,67148450,0.3113610297934185,875,475,1350,-
chr16,67148454,5.695226226016183,1041,590,1631,-
chr16,68301202,0.737177177177177,968,554,1522,-
chr16,68301203,0.737177177177177,968,554,1522,-
chr16,68301204,1.2300187437421448,1261,787,2048,-
chr16,69118109,0.2684344868732603,512,934,1446,-
chr16,69118110,1.2560017806607522,394,952,1346,-
chr16,69118111,2.684255375034871,606,991,1597,-
chr16,69118112,3.6572674517591857,1389,2276,3665,-
chr16,69118113,5.958853094384257,652,966,1618,-
chr16,69118119,2.10016155088853,439,618,1057,-
chr16,69118120,11.617794101696777,1503,1510,3013,-
chr16,69118121,12.900292052765547,1702,1535,3237,-
chr16,69118122,17.56644706350496,1116,854,1970,-
chr16,69120242,2.6466259678587347,647,441,1088,-
chr16,69120248,2.3168534287268643,1128,698,1826,-
chr16,69120482,3.6349328121174866,542,468,1010,-
chr16,69385863,0.6321327881401819,1596,540,2136,-
chr16,69385864,0.6321327881401819,1596,540,2136,-
chr16,69711081,1.1273055902445834,4152,2890,7042,-
chr16,69711125,2.0980675507197097,1254,1037,2291,-
chr16,69711252,1.044281068826385,2043,1737,3780,-
chr16,69711267,2.5511036913374143,808,598,1406,-
chr16,69713124,1.72085508687691,2666,1731,4397,-
chr16,69714979,0.6061705989110708,1001,637,1638,-
chr16,69715041,3.3384344528710717,746,567,1313,-
chr16,69718195,1.3868450490022135,3179,2215,5394,-
chr16,69718232,1.4275862068965517,1632,1014,2646,-
chr16,69718251,3.7594125500667572,721,534,1255,-
chr16,69718485,1.64610974852989,1210,786,1996,-
chr16,69718521,1.958996328029376,872,515,1387,-
chr16,69718528,1.7224497062488873,674,410,1084,-
chr16,69726549,3.3718004068598337,713,391,1104,-
chr16,69741999,0.41168879056047203,608,451,1059,-
chr16,69742041,0.5899750605922232,883,580,1463,-
chr16,69742476,1.8430631717262893,661,442,1103,-
chr16,69754716,2.7325227963525838,869,469,1338,-
chr16,69756698,1.935587091043843,968,718,1686,-
chr16,69756699,2.4730201863354035,821,643,1464,-
chr16,69757011,1.7325520616173233,907,996,1903,-
chr16,69757014,1.4430508474576271,626,589,1215,-
chr16,69757015,1.4430508474576271,626,589,1215,-
chr16,69757016,1.2751680856587797,466,566,1032,-
chr16,69757017,1.2751680856587797,466,566,1032,-
chr16,69757207,1.0199172413793105,935,624,1559,-
chr16,69757208,1.0199172413793105,935,624,1559,-
chr16,69757209,0.9906397306397308,625,494,1119,-
chr16,69757210,0.9906397306397308,625,494,1119,-
chr16,70252370,1.128502302431992,1271,1071,2342,-
chr16,70252476,1.3894557823129254,1633,1371,3004,-
chr16,70252521,0.7574864458191025,1801,1404,3205,-
chr16,70252563,0.6638888888888889,1672,1259,2931,-
chr16,70252609,1.4765289571605764,1085,891,1976,-
chr16,70252641,1.578034112195603,1207,965,2172,-
chr16,70252647,1.5857920113239263,1194,961,2155,-
chr16,70252657,0.6729141767381907,2322,1787,4109,-
chr16,70252689,1.090224101694818,2060,1558,3618,-
chr16,70252695,1.841901603095633,685,602,1287,-
chr16,70252725,2.163763066202091,827,737,1564,-
chr16,70252729,0.6476735015772871,729,633,1362,-
chr16,70252761,3.9616252821670432,584,442,1026,-
chr16,70252885,1.6804672020022942,1150,668,1818,-
chr16,70252887,2.534044902465955,917,740,1657,-
chr16,70253308,1.6875621890547265,1536,1004,2540,-
chr16,70253352,1.5316857059428386,2913,2143,5056,-
chr16,70253373,1.5641025641025639,1158,740,1898,-
chr16,70253374,0.5592436286614652,1791,1404,3195,-
chr16,70253376,2.415406375802416,924,706,1630,-
chr16,70253970,1.4471288755047569,2642,2306,4948,-
chr16,70253971,1.4471288755047569,2642,2306,4948,-
chr16,70253980,1.4441008195453842,1414,1114,2528,-
chr16,70253999,0.6200314836678474,821,692,1513,-
chr16,70254000,1.2643433822627146,3274,2386,5660,-
chr16,70254003,2.1180463196514565,1003,622,1625,-
chr16,70254006,2.097904828852049,1342,1190,2532,-
chr16,70254007,2.5870451384860464,2210,1826,4036,-
chr16,70254639,1.5807385778905296,1375,888,2263,-
chr16,70254681,1.889657098959425,1955,1590,3545,-
chr16,70254706,1.0100282701711492,2298,1635,3933,-
chr16,70254707,1.0100282701711492,2298,1635,3933,-
chr16,70254727,0.49931473055205294,827,628,1455,-
chr16,70255808,1.7226295210166178,1006,791,1797,-
chr16,70255815,2.717574033363507,933,702,1635,-
chr16,70255825,1.8349894518375351,2611,1740,4351,-
chr16,70255827,1.7447916666666667,1749,1119,2868,-
chr16,70258095,1.497155561367946,953,745,1698,-
chr16,70259028,1.4346928403532178,1456,1187,2643,-
chr16,70259068,1.4593606204190308,12763,9118,21881,-
chr16,70259097,1.3651372042155498,5744,4279,10023,-
chr16,70259099,1.332105621594849,10958,8075,19033,-
chr16,70259100,1.3202159579646364,8024,5886,13910,-
chr16,70259101,1.1993239109646694,10196,7401,17597,-
chr16,70259108,1.5973174229556633,3832,2366,6198,-
chr16,70259109,1.5973174229556633,3832,2366,6198,-
chr16,70259161,0.6221452365089941,1296,949,2245,-
chr16,70259176,1.5780704538241828,1325,821,2146,-
chr16,70261104,1.6757173939836685,2443,1798,4241,-
chr16,70262394,1.131461387737877,2717,2173,4890,-
chr16,70262418,1.6856400566839869,914,729,1643,-
chr16,70262466,2.0073871409028725,1275,859,2134,-
chr16,70262479,1.5767576048995289,1297,858,2155,-
chr16,70262481,1.4931252322556672,1147,896,2043,-
chr16,70265050,1.4492008251180095,3145,2548,5693,-
chr16,70265051,1.4492008251180095,3145,2548,5693,-
chr16,70265062,0.6336921366484738,808,775,1583,-
chr16,70265070,3.095298890888201,4001,3181,7182,-
chr16,70265071,3.5877211190360443,5855,4748,10603,-
chr16,70265098,0.8413621923517912,3621,2563,6184,-
chr16,70265099,0.6308602247740539,2432,1787,4219,-
chr16,70265604,1.5449500554938955,927,741,1668,-
chr16,70267670,1.6769240070128768,1540,972,2512,-
chr16,70267693,0.6478188885689605,1755,1207,2962,-
chr16,70267806,1.584722222222222,1140,881,2021,-
chr16,70267807,1.5102827763496145,1174,777,1951,-
chr16,70268331,1.6511050523205335,2167,1581,3748,-
chr16,70268332,1.6511050523205335,2167,1581,3748,-
chr16,70268334,1.0363278547138808,2311,1584,3895,-
chr16,70268343,1.753763746674512,2007,1359,3366,-
chr16,70268360,1.6607820404721754,954,592,1546,-
chr16,70268362,0.5256690012972889,2265,1719,3984,-
chr16,70268364,0.5264418143257851,1709,1243,2952,-
chr16,70268376,0.6629418638621093,625,488,1113,-
chr16,70269649,2.1763698630136985,737,583,1320,-
chr16,70270305,1.5758447160316318,2328,1818,4146,-
chr16,70270306,1.5758447160316318,2328,1818,4146,-
chr16,70270321,2.3337053571428568,1393,895,2288,-
chr16,70271879,1.928958333333333,1378,839,2217,-
chr16,70271885,1.4644506178752756,1340,802,2142,-
chr16,70276497,0.4362745098039216,978,781,1759,-
chr16,70276622,1.7813538205980066,1491,1203,2694,-
chr16,70277052,1.5334974066841949,2181,1822,4003,-
chr16,70277055,2.0850846196763992,1318,848,2166,-
chr16,70277056,0.5606557377049181,854,731,1585,-
chr16,70277087,1.6974714640915975,2543,1787,4330,-
chr16,70277137,1.956274245235284,1030,846,1876,-
chr16,70277151,1.635667222354529,840,662,1502,-
chr16,70282748,1.3035475234270415,2469,2489,4958,-
chr16,70282754,1.6379848783694937,2097,2027,4124,-
chr16,70282770,1.0807315330941945,2503,2025,4528,-
chr16,70282772,0.6234163390126692,1426,1448,2874,-
chr16,70282779,1.3768883288875782,1283,1222,2505,-
chr16,70289437,7.612887767308924,9128,7444,16572,-
chr16,70289438,7.612887767308924,9128,7444,16572,-
chr16,70289439,8.529748185352094,3384,2835,6219,-
chr16,70289445,2.257451633523476,1811,1104,2915,-
chr16,70289448,2.22637550678602,3784,2498,6282,-
chr16,70289459,1.4212644220189254,852,460,1312,-
chr16,70289487,1.4506466280043617,1227,710,1937,-
chr16,70289508,0.4096877537551168,638,430,1068,-
chr16,70481781,4.392404316967048,667,418,1085,-
chr16,70501019,0.9471302412734797,801,560,1361,-
chr16,70510014,2.1803513071895426,853,611,1464,-
chr16,70512263,2.1112488379299656,756,460,1216,-
chr16,70512264,1.721975698719885,1785,1117,2902,-
chr16,70512266,1.7086908782456023,5461,3197,8658,-
chr16,70512267,1.7465890515433367,4541,2621,7162,-
chr16,70512268,1.7465890515433367,4541,2621,7162,-
chr16,70512272,1.6107554417413568,679,354,1033,-
chr16,70512299,0.5195629874991587,1035,496,1531,-
chr16,70800864,0.7517023045723321,735,424,1159,-
chr16,74453294,1.7365783486891397,1135,720,1855,-
chr16,74453295,1.8842364532019706,719,405,1124,-
chr16,74470036,1.8872023809523808,745,447,1192,-
chr16,74470037,1.8872023809523808,745,447,1192,-
chr16,74485900,3.394927189037298,600,429,1029,-
chr16,74485913,4.311828819941091,573,431,1004,-
chr16,74491016,2.5380838641188963,616,470,1086,-
chr16,74491017,2.8339340541983717,922,680,1602,-
chr16,74491019,3.3711948249619486,610,437,1047,-
chr16,74700527,2.5129999750195977,1256,846,2102,-
chr16,74700528,3.3537562831137078,632,432,1064,-
chr16,74700529,3.3537562831137078,632,432,1064,-
chr16,75627842,2.0175649663137634,1676,1038,2714,-
chr16,75627932,1.6833541927409263,1344,883,2227,-
chr16,75627956,2.0307692307692307,639,519,1158,-
chr16,75628610,2.3766414851368904,1856,1303,3159,-
chr16,75629450,0.5815374921235035,1677,1057,2734,-
chr16,75629529,1.639676113360324,620,493,1113,-
chr16,75629530,0.6274362818590704,809,689,1498,-
chr16,75630443,1.5126295059508523,802,686,1488,-
chr16,75630445,1.574909959369566,2948,1842,4790,-
chr16,75630446,1.574909959369566,2948,1842,4790,-
chr16,75630447,1.574909959369566,2948,1842,4790,-
chr16,75631225,2.7324649298597192,605,498,1103,-
chr16,75631451,2.8339517625231916,610,538,1148,-
chr16,75631465,1.6100874125874125,2273,1429,3702,-
chr16,75631466,1.6100874125874125,2273,1429,3702,-
chr16,75631476,1.4940618591934376,852,615,1467,-
chr16,75631488,2.052249134948097,658,509,1167,-
chr16,75631576,0.41885936061044604,848,690,1538,-
chr16,75631789,0.6214727073992281,994,878,1872,-
chr16,75631808,1.9146482122260668,663,577,1240,-
chr16,75631820,1.7171278757516708,3154,2275,5429,-
chr16,75631823,2.1547623535602467,1454,1191,2645,-
chr16,75634199,0.5981481481481481,626,494,1120,-
chr16,75634275,2.341463414634146,623,532,1155,-
chr16,75635773,1.5258124793903203,1435,1113,2548,-
chr16,75635786,1.6041613588110404,1452,941,2393,-
chr16,75635955,1.9396893906116033,2161,1744,3905,-
chr16,75636062,1.6291323364866237,2287,1468,3755,-
chr16,75636064,1.6291323364866237,2287,1468,3755,-
chr16,75636090,0.4926979966298446,830,653,1483,-
chr16,75636494,0.7363106796116505,1184,749,1933,-
chr16,75636544,2.9395607041699017,1049,799,1848,-
chr16,75640242,2.413346069868996,654,457,1111,-
chr16,75640296,0.6045204954667348,788,763,1551,-
chr16,75640337,1.6634199134199132,582,483,1065,-
chr16,75640338,1.7140009965122074,687,668,1355,-
chr16,75640340,1.6666666666666667,825,530,1355,-
chr16,75640348,1.9987683645640886,709,420,1129,-
chr16,75641603,2.469277757815308,858,505,1363,-
chr16,75647613,3.2425011536686665,610,393,1003,-
chr16,75647638,2.5277022558600932,2413,877,3290,-
chr16,75647640,2.5277022558600932,2413,877,3290,-
chr16,75647652,2.231768169668911,1499,814,2313,-
chr16,75647664,0.8179939154949382,2455,972,3427,-
chr16,80976172,1.015439856373429,706,556,1262,-
chr16,80976173,0.5970314576871953,538,487,1025,-
chr16,80976174,1.015439856373429,706,556,1262,-
chr16,80997395,0.8811819111356813,1554,1275,2829,-
chr16,80997397,0.505744973148495,1156,941,2097,-
chr16,81006779,3.3352049410443567,809,410,1219,-
chr16,81006780,3.3352049410443567,809,410,1219,-
chr16,84054092,0.35210345392044523,716,595,1311,-
chr16,84054094,0.378313585635826,1102,850,1952,-
chr16,84056126,1.3812536499902666,616,466,1082,-
chr16,84056127,3.3824530147189473,592,541,1133,-
chr16,84067717,1.4212951277942936,748,459,1207,-
chr16,84068358,0.9537184771143091,1022,752,1774,-
chr16,84068359,0.5092000818795915,771,570,1341,-
chr16,84069910,3.8130457348265527,568,465,1033,-
chr16,84074650,4.0175810135568755,596,467,1063,-
chr16,84091832,0.9541392243355785,2953,2357,5310,-
chr16,84091838,1.5812410080289598,830,742,1572,-
chr16,84091841,2.5034482758620693,1511,1217,2728,-
chr16,84091843,2.5034482758620693,1511,1217,2728,-
chr16,84093265,2.099630895508555,1106,727,1833,-
chr16,84093266,2.348749848749849,1282,824,2106,-
chr16,84101976,1.1095985691573926,858,543,1401,-
chr16,84101977,1.1095985691573926,858,543,1401,-
chr16,84565767,1.2274802583769109,1093,571,1664,-
chr16,84565768,1.728713768789728,835,487,1322,-
chr16,84590129,2.0614379174578796,754,416,1170,-
chr16,84590216,2.783319472596901,934,699,1633,-
chr16,84590217,2.504854368932039,730,514,1244,-
chr16,85677997,2.4559080590868447,735,602,1337,-
chr16,85678269,1.4638129270610565,617,459,1076,-
chr16,85678314,1.562537139150248,781,542,1323,-
chr16,85687555,0.3754681976390548,617,415,1032,-
chr16,85779546,1.074667344690228,633,436,1069,-
chr16,85779547,1.074667344690228,633,436,1069,-
chr16,85781248,1.5344640859835617,716,442,1158,-
chr16,85816539,0.5670250896057347,790,557,1347,-
chr16,85816541,1.1900690411096975,1759,1505,3264,-
chr16,85816543,1.360701755735006,1322,1209,2531,-
chr16,87407616,2.5826155655537533,925,565,1490,-
chr16,87830075,39.74622071109422,17676,14666,32342,-
chr16,87830076,43.05379032180698,19022,14976,33998,-
chr16,87830077,35.72937097096071,14666,7780,22446,-
chr16,87830078,21.677663870767322,4056,1072,5128,-
chr16,87830079,5.446585378092228,6384,948,7332,-
chr16,87830080,6.718898439582918,10574,1950,12524,-
chr16,87830082,6.003867284331137,15344,2874,18218,-
chr16,87830083,6.032953595310275,9715,1846,11561,-
chr16,87830125,0.4978248089359201,2189,944,3133,-
chr16,87830153,0.6286944326090045,3978,2346,6324,-
chr16,87830154,0.6286944326090045,3978,2346,6324,-
chr16,87830168,1.9741661579443917,1394,973,2367,-
chr16,87830193,1.3962278106508874,1316,1039,2355,-
chr16,87830290,1.2768516711733058,3413,2473,5886,-
chr16,87830516,0.8269275212310901,5101,4029,9130,-
chr16,87830517,0.7939452929386177,8896,6380,15276,-
chr16,87830518,0.8099508443617305,7561,5422,12983,-
chr16,87830520,0.5668167060212516,1137,846,1983,-
chr16,87830557,2.1331775700934577,1493,855,2348,-
chr16,87830586,1.0989407776760847,2350,1836,4186,-
chr16,87830591,1.4544043690083293,1104,908,2012,-
chr16,87830633,1.6281625697990978,2668,1756,4424,-
chr16,87830741,1.5269686411149823,1327,1147,2474,-
chr16,87830755,1.5197199383350464,1202,972,2174,-
chr16,87830890,0.4768939059881824,1029,781,1810,-
chr16,87830930,1.6183949795025372,4305,2649,6954,-
chr16,87830932,1.5451589889930697,3125,1783,4908,-
chr16,87830933,1.7886513157894743,2174,1503,3677,-
chr16,87830934,1.7886513157894743,2174,1503,3677,-
chr16,87830976,1.8246282591786327,2745,1664,4409,-
chr16,87830979,1.5971669907985253,1447,732,2179,-
chr16,87831102,0.5265159599696452,2650,2007,4657,-
chr16,87831103,0.5265159599696452,2650,2007,4657,-
chr16,87831104,0.64891846921797,1637,1201,2838,-
chr16,87831139,1.882566700439041,1908,1174,3082,-
chr16,87831148,1.430469788165403,1524,1162,2686,-
chr16,87831263,1.3800438596491231,1797,1439,3236,-
chr16,87831341,1.541751192499589,1849,1494,3343,-
chr16,87831360,0.7387057387057387,1231,1091,2322,-
chr16,87831365,1.5503667096855358,4533,3369,7902,-
chr16,87831366,1.6040270170662914,4146,3061,7207,-
chr16,87831368,1.6112201369693095,4266,3015,7281,-
chr16,87831374,1.792873853872816,5258,3489,8747,-
chr16,87831375,1.792873853872816,5258,3489,8747,-
chr16,87831392,1.5252546561388705,2353,1411,3764,-
chr16,87831393,1.624365209627336,3313,2079,5392,-
chr16,87831454,4.515708358032009,585,481,1066,-
chr16,87831481,1.8966044415835213,872,477,1349,-
chr16,87831607,1.9073456790123453,1165,899,2064,-
chr16,87831625,1.6495905900234866,2169,1735,3904,-
chr16,87831638,0.995495539456067,2127,1375,3502,-
chr16,87831652,2.336597828401107,877,426,1303,-
chr16,87831783,1.715553847631857,1940,1486,3426,-
chr16,87831789,1.3330220341456298,1802,1334,3136,-
chr16,87831814,1.4465830051889743,1267,936,2203,-
chr16,87831930,1.4166598954524523,1432,1190,2622,-
chr16,87831943,1.4512866385475354,3002,2011,5013,-
chr16,87831978,1.9596747967479675,1047,819,1866,-
chr16,87832074,1.6939078751857355,1439,672,2111,-
chr16,87832198,0.7701374373064419,2430,1740,4170,-
chr16,87832211,1.7892883345561263,1741,1362,3103,-
chr16,87832217,1.5375439994686857,1866,1194,3060,-
chr16,87832227,1.7263333598283126,1760,1093,2853,-
chr16,87832257,1.3819297972046911,1753,1006,2759,-
chr16,87832324,0.5879037143645633,6094,8601,14695,-
chr16,87832325,0.573226783252409,4715,6650,11365,-
chr16,87832370,9.595880495524947,9003,11452,20455,-
chr16,87832371,9.595880495524947,9003,11452,20455,-
chr16,87832379,4.606242787702289,3501,2658,6159,-
chr16,87832380,4.414157726423693,10274,6795,17069,-
chr16,87832382,4.250174033259491,8526,5431,13957,-
chr16,87832386,7.960256158849026,4055,1975,6030,-
chr16,87832387,16.69289256198347,2303,1209,3512,-
chr16,87832388,10.660057844903799,13442,5125,18567,-
chr16,87832389,11.534265169678402,11423,4100,15523,-
chr16,87832390,10.414474552982691,7195,2236,9431,-
chr16,87832568,2.5167375570331063,3361,2711,6072,-
chr16,87832578,1.3924980047885078,2180,1252,3432,-
chr16,87832654,1.7635385810014086,1459,1198,2657,-
chr16,87832717,1.459772558228812,6110,4659,10769,-
chr16,87832745,1.9932417565146323,1837,1096,2933,-
chr16,87832813,1.0926130137042578,2664,2050,4714,-
chr16,87832814,1.866484024293636,1853,1081,2934,-
chr16,87832917,1.4789473684210523,1123,1063,2186,-
chr16,87832926,1.5609790153993457,2114,1207,3321,-
chr16,87833003,1.3864718845524988,2052,1562,3614,-
chr16,87833024,1.5270614830586442,1873,1408,3281,-
chr16,87834444,0.6070665932856357,1531,1149,2680,-
chr16,87834447,1.2854638337396955,2088,1304,3392,-
chr16,87834466,0.5759259259259261,1243,989,2232,-
chr16,87834565,1.4352115618548449,4101,2897,6998,-
chr16,87834589,2.306130653266332,1638,994,2632,-
chr16,87836595,1.3008460236886634,2603,1772,4375,-
chr16,87836606,1.5596085409252671,1752,1404,3156,-
chr16,87836615,1.4553295362082996,1625,1228,2853,-
chr16,87836630,1.6800356506238858,1364,1070,2434,-
chr16,87837887,1.6216528162511543,1404,1082,2486,-
chr16,87837890,1.6779286658334778,3622,2939,6561,-
chr16,87837891,1.8602007041511184,3886,2909,6795,-
chr16,87837893,1.9052661419423693,2538,1873,4411,-
chr16,87838789,1.548561759729272,1572,1181,2753,-
chr16,87838806,1.8299467827769718,1512,1091,2603,-
chr16,87839729,1.3625094625283876,2056,1320,3376,-
chr16,87839753,1.1867310128529542,2975,2364,5339,-
chr16,87839754,1.7612442202606138,1256,1097,2353,-
chr16,87841081,1.416150229725398,2304,1909,4213,-
chr16,87841138,1.2581648762933777,6316,4894,11210,-
chr16,87851758,1.7247834989548174,5126,3693,8819,-
chr16,87851776,1.5276351566086153,8061,4886,12947,-
chr16,87851777,1.358359442917897,7752,4948,12700,-
chr16,87851794,1.8083398846960168,1809,953,2762,-
chr16,87851797,0.7335754236580683,1405,967,2372,-
chr16,87851830,1.2433373047436398,4302,2582,6884,-
chr16,87851831,1.6529266530169822,1892,1443,3335,-
chr16,87851832,0.9424936871694699,2825,1806,4631,-
chr16,87851833,1.7800463945320182,2696,2064,4760,-
chr16,87868951,2.4192665571975915,883,405,1288,-
chr16,87868952,2.5577697399046007,1359,674,2033,-
chr16,87869064,1.045880568487686,1509,1310,2819,-
chr16,87869066,1.2051738662095262,2911,2148,5059,-
chr16,87869088,1.5748839456276673,3429,2571,6000,-
chr16,87869090,1.6673093101514302,2113,1782,3895,-
chr16,87869117,1.5794238683127573,807,647,1454,-
chr16,87869121,3.89043271139341,783,457,1240,-
chr16,87869135,1.5266925005698655,727,534,1261,-
chr16,87869141,1.8729423575223418,1533,1038,2571,-
chr16,87869142,1.9100809298788768,1152,721,1873,-
chr16,87869264,1.811607554122524,873,667,1540,-
chr16,87869267,1.7272727272727275,824,604,1428,-
chr16,87869276,1.5927927927927927,747,554,1301,-
chr16,87869291,2.216761363636364,866,439,1305,-
chr16,87869292,0.48686197523406827,619,472,1091,-
chr16,87869334,1.898573536645352,918,534,1452,-
chr16,87869348,2.0121517486662714,656,481,1137,-
chr16,87869352,1.9032716927453768,668,554,1222,-
chr16,87869367,1.8379849449913144,1344,784,2128,-
chr16,87869369,1.8379849449913144,1344,784,2128,-
chr16,87869424,0.9632822830891458,3072,2417,5489,-
chr16,87869426,0.9632822830891458,3072,2417,5489,-
chr16,87869433,1.6915360501567398,1253,956,2209,-
chr16,87869443,1.596463982797754,1027,760,1787,-
chr16,87869446,1.7807948442534909,941,664,1605,-
chr16,87869450,1.9005426666512903,1381,911,2292,-
chr16,87869455,1.8158567774936056,780,505,1285,-
chr16,87869504,0.44065364284515235,1075,857,1932,-
chr16,87869506,0.4902632469980853,1433,1212,2645,-
chr16,88643354,2.3445306428513315,861,523,1384,-
chr16,88643384,1.0789303892752171,601,480,1081,-
chr16,88643386,1.0789303892752171,601,480,1081,-
chr16,88643409,0.5319314641744548,682,320,1002,-
chr16,88643551,1.868306783716609,24071,15630,39701,-
chr16,88643552,1.846884829267168,17096,7982,25078,-
chr16,88643554,2.020953143371353,15552,8692,24244,-
chr16,88643557,2.3642901425914444,4199,3225,7424,-
chr16,88646125,1.5430592317292262,4128,1845,5973,-
chr16,88646156,1.5666537367468318,2202,1288,3490,-
chr16,88646160,1.4637958532695377,2117,1187,3304,-
chr16,88646165,1.3729491348058451,1791,990,2781,-
chr16,88646778,1.7371802291931937,1304,977,2281,-
chr16,88646782,1.6373014258920298,2040,1340,3380,-
chr16,88646784,2.5922456414259694,1171,853,2024,-
chr16,88646785,1.3474047524226735,2029,1301,3330,-
chr16,88646805,1.8714585744288716,928,706,1634,-
chr16,88646829,1.4890243902439024,813,639,1452,-
chr16,88647145,1.87112016293279,637,490,1127,-
chr16,88648077,1.8144929726462147,648,508,1156,-
chr16,88650966,3.5008279391841035,683,510,1193,-
chr16,88650982,1.7518374489597512,1476,694,2170,-
chr16,88651005,1.5630199667221298,834,600,1434,-
chr16,88651037,2.1957511810132666,1521,666,2187,-
chr16,88651038,1.8144464149025807,3526,1401,4927,-
chr16,88651041,1.8235668088880874,7878,3531,11409,-
chr16,88651043,2.1083238736810763,5394,1852,7246,-
chr16,88651044,2.5383553308995603,3498,1186,4684,-
chr16,88651052,0.7924966245512762,5087,2308,7395,-
chr16,88651057,4.386887201326952,601,511,1112,-
chr16,88651068,0.6256782715452066,627,388,1015,-
chr16,88717168,1.5556625803624968,662,435,1097,-
chr16,88717208,3.48936170212766,737,422,1159,-
chr16,88717210,3.48936170212766,737,422,1159,-
chr16,88809557,2.3552971975083223,896,778,1674,-
chr16,88809651,2.043521617375579,1365,1094,2459,-
chr16,88810130,2.1425364758698096,829,659,1488,-
chr16,88810131,2.1425364758698096,829,659,1488,-
chr16,88810137,0.5407814668517135,920,645,1565,-
chr16,88810138,0.5407814668517135,920,645,1565,-
chr16,88810489,3.778264882325796,654,393,1047,-
chr16,89281806,2.3833333333333333,662,611,1273,-
chr16,89281808,2.524112356485105,1262,1082,2344,-
chr16,89281810,2.856749672346002,920,762,1682,-
chr16,89281811,2.4526785714285717,602,479,1081,-
chr16,89418297,1.664443851693785,831,651,1482,-
chr16,89418313,1.9463660510011407,778,489,1267,-
chr16,89418326,2.271752801959075,742,512,1254,-
chr17,1344638,1.5986105245997768,6101,4564,10665,-
chr17,1344714,1.1341398617388498,3039,2240,5279,-
chr17,1344727,1.9120111576900074,2850,2272,5122,-
chr17,1344728,1.5278892072588348,940,697,1637,-
chr17,1344731,1.4181463201692508,2370,1653,4023,-
chr17,1344732,0.5388679245283019,713,529,1242,-
chr17,1344734,2.4457509149733,2051,1670,3721,-
chr17,1344735,0.5684104177595997,2143,1481,3624,-
chr17,1344941,19.766195297685417,25962,18164,44126,-
chr17,1344942,19.766195297685417,25962,18164,44126,-
chr17,1345079,1.4343363889996013,2878,2122,5000,-
chr17,1345216,1.3226033769514347,5403,4105,9508,-
chr17,1345222,1.4637276785714284,1762,1147,2909,-
chr17,1345242,1.5547307996832938,1365,841,2206,-
chr17,1345244,1.3105509697150013,2014,1278,3292,-
chr17,1345255,1.4482758620689655,1055,637,1692,-
chr17,1345350,0.6609991138679663,1363,975,2338,-
chr17,1345418,1.8355784200907062,1178,868,2046,-
chr17,1345489,0.5731991363334977,2451,1795,4246,-
chr17,1361113,1.3563501849568431,2239,1621,3860,-
chr17,1361114,1.586978824932896,3970,2394,6364,-
chr17,1361199,1.6884600389863549,1882,1349,3231,-
chr17,1361215,1.3462429330459278,2764,1733,4497,-
chr17,1364956,1.6676150627615065,2255,1911,4166,-
chr17,1364998,1.3443160396688796,3421,2406,5827,-
chr17,1365002,1.4600334595403717,1763,1384,3147,-
chr17,1365039,1.0924837967192167,3062,2565,5627,-
chr17,1400087,1.4350180505415162,1430,1107,2537,-
chr17,1400205,1.0679363087926548,6890,5005,11895,-
chr17,1400208,0.6735730592799813,3660,2444,6104,-
chr17,1400219,0.9238312144877859,8844,6365,15209,-
chr17,1400220,0.9238312144877858,8844,6365,15209,-
chr17,1400221,0.9454166108805285,2536,2309,4845,-
chr17,1436680,0.970544644846365,675,504,1179,-
chr17,1436681,0.970544644846365,675,504,1179,-
chr17,1464546,2.1341895346569277,995,738,1733,-
chr17,1583289,2.541985599979167,660,493,1153,-
chr17,1591468,1.9210714140027187,1031,936,1967,-
chr17,1591469,1.9424153166421207,653,581,1234,-
chr17,1591470,1.9424153166421207,653,581,1234,-
chr17,1627741,2.599412953738785,617,552,1169,-
chr17,1653656,8.077001306444382,578,426,1004,-
chr17,1653987,0.580941245249927,1045,621,1666,-
chr17,1655456,1.0540674603174602,849,503,1352,-
chr17,1655458,1.0540674603174602,849,503,1352,-
chr17,1656515,2.0615767623343904,613,458,1071,-
chr17,1658268,2.8961683793696373,682,586,1268,-
chr17,1659370,0.4964302600472814,912,449,1361,-
chr17,1659379,1.460505517977928,1627,1324,2951,-
chr17,1659380,1.738076720438356,3236,2239,5475,-
chr17,1659417,2.330212606576361,1183,762,1945,-
chr17,1659432,2.4837783428316764,1010,639,1649,-
chr17,1659434,2.475633528265107,761,485,1246,-
chr17,1660824,2.5844242277657075,871,538,1409,-
chr17,1661650,2.6905128595634147,670,509,1179,-
chr17,1661766,1.9944981379336983,710,520,1230,-
chr17,1661924,2.458205463982566,1066,685,1751,-
chr17,1661925,3.0489974937343365,838,531,1369,-
chr17,1661926,3.0489974937343365,838,531,1369,-
chr17,1661948,2.699627600666026,643,427,1070,-
chr17,1673544,4.704408976534203,680,377,1057,-
chr17,1674466,3.840807174887893,570,445,1015,-
chr17,1684519,0.42727224939672676,2252,1475,3727,-
chr17,1684521,0.7412416252737067,3154,2155,5309,-
chr17,1684523,0.8906018334321179,1804,1325,3129,-
chr17,2325413,3.8589241166447827,673,506,1179,-
chr17,2332328,2.4493855135121105,677,449,1126,-
chr17,2334493,2.9553003330487515,689,510,1199,-
chr17,2334772,1.435324981261377,1410,848,2258,-
chr17,2334775,2.0268987341772147,1463,947,2410,-
chr17,2334784,2.1186398610076944,1163,710,1873,-
chr17,2334798,1.9074629579129172,2063,1157,3220,-
chr17,2334800,2.219198429747282,2824,1592,4416,-
chr17,2334830,1.4813755289349784,955,798,1753,-
chr17,2334838,2.0996543778801846,809,619,1428,-
chr17,2334849,2.103080909876188,1327,905,2232,-
chr17,2334850,2.103080909876188,1327,905,2232,-
chr17,2334859,0.947412071025958,837,600,1437,-
chr17,2689777,6.125166752890778,514,677,1191,-
chr17,2691857,2.8807501834662625,827,525,1352,-
chr17,3664269,0.48796992481203,707,455,1162,-
chr17,3664689,0.5458817386764131,696,488,1184,-
chr17,3664724,2.4478450264690936,698,525,1223,-
chr17,3673415,5.474150897202624,611,406,1017,-
chr17,3840113,0.5286103542234333,775,366,1141,-
chr17,4704919,0.9523653664067706,1215,846,2061,-
chr17,4704920,0.7882180851063829,1664,1174,2838,-
chr17,4704922,0.6253678662339013,1048,738,1786,-
chr17,4937707,2.902507360438569,724,540,1264,-
chr17,4938249,3.271736340098671,653,584,1237,-
chr17,4938358,2.3420074349442386,575,537,1112,-
chr17,4938359,2.3420074349442386,575,537,1112,-
chr17,4939198,0.30179461019368875,1283,966,2249,-
chr17,4939199,0.29272439699485964,672,561,1233,-
chr17,4939200,0.46730126069532546,929,773,1702,-
chr17,4945729,1.3009646497458172,9022,6506,15528,-
chr17,4945730,1.2997335109926715,5573,3554,9127,-
chr17,4945906,1.2644801489212365,3097,1985,5082,-
chr17,4945933,1.7700242341390666,2320,1330,3650,-
chr17,4945940,1.5522703273495249,1829,946,2775,-
chr17,4945943,1.5525577416595382,3360,1669,5029,-
chr17,4945944,1.5525577416595382,3360,1669,5029,-
chr17,4945945,0.6242350061199511,1019,816,1835,-
chr17,4945946,1.895320738137083,1014,568,1582,-
chr17,4946688,0.8085891825729224,3334,2705,6039,-
chr17,4946742,1.4843348329048844,2052,1555,3607,-
chr17,4946744,1.3280317085511892,3326,2694,6020,-
chr17,4946745,1.0183521312671702,4288,3327,7615,-
chr17,4946746,1.0183521312671702,4288,3327,7615,-
chr17,4946791,1.4071112141348578,3361,2156,5517,-
chr17,4946793,2.555689343768814,1414,1207,2621,-
chr17,4948282,1.4562281033128035,7839,5208,13047,-
chr17,4948284,1.4800184811280819,7199,4468,11667,-
chr17,4948320,1.3231373889268627,1957,1671,3628,-
chr17,4948321,1.513677811550152,1327,1033,2360,-
chr17,4948374,1.604998827603526,7801,5351,13152,-
chr17,4948375,1.4391348962033308,4797,2780,7577,-
chr17,4948377,1.7888017917133259,1140,939,2079,-
chr17,4948405,1.3630255613951268,1073,735,1808,-
chr17,4948416,1.6123971639639658,2001,1533,3534,-
chr17,4948426,1.615733736762481,800,660,1460,-
chr17,4948442,0.5759723137771918,698,491,1189,-
chr17,4948449,1.6430597090473769,3150,2089,5239,-
chr17,4948529,0.4723398637365582,2248,1545,3793,-
chr17,4948556,0.47825306852146154,1493,953,2446,-
chr17,4948560,1.4973886039617936,883,801,1684,-
chr17,4959465,2.026653938691505,744,487,1231,-
chr17,4959631,0.5686306445702186,734,598,1332,-
chr17,4959803,1.2241970451274409,564,442,1006,-
chr17,4960315,4.311083556379305,886,585,1471,-
chr17,4960523,1.987553904052107,8185,6532,14717,-
chr17,4960524,1.987553904052107,8185,6532,14717,-
chr17,4960527,1.4588688773832874,14727,10438,25165,-
chr17,4960528,1.5215329678710174,10940,7855,18795,-
chr17,4960529,1.5215329678710174,10940,7855,18795,-
chr17,4960542,1.7825388174578456,2648,1728,4376,-
chr17,4960798,0.7166389772759271,2544,2088,4632,-
chr17,4960807,1.3835556527443693,1775,1075,2850,-
chr17,4960812,1.980246913580247,3608,2915,6523,-
chr17,4960813,1.980246913580247,3608,2915,6523,-
chr17,4960815,1.9054390987164096,1447,832,2279,-
chr17,4960819,2.5438432835820897,908,535,1443,-
chr17,4960822,1.609325803232101,2194,1275,3469,-
chr17,4960825,1.442019518942596,1389,1000,2389,-
chr17,4960827,1.9107286288009182,723,414,1137,-
chr17,4960828,0.4231458363930092,1028,618,1646,-
chr17,4960831,1.5393828427485192,2421,1648,4069,-
chr17,4960833,1.744841197030248,4604,3060,7664,-
chr17,4960834,1.8724502651548447,3345,2201,5546,-
chr17,4960835,1.8724502651548447,3345,2201,5546,-
chr17,4960836,1.000331352068948,2022,1132,3154,-
chr17,4960838,1.2137118961153297,1344,698,2042,-
chr17,4960849,1.6379686697483309,822,471,1293,-
chr17,5387098,4.178004006895587,615,401,1016,-
chr17,5388899,2.961459246694145,791,550,1341,-
chr17,5408777,2.3073944692320847,706,469,1175,-
chr17,5408825,3.3661225571883047,652,452,1104,-
chr17,5432961,1.4987725040916529,2012,1585,3597,-
chr17,5433063,1.325029386114587,3614,2123,5737,-
chr17,5433709,1.2585845347313236,3491,2179,5670,-
chr17,5433745,1.9327714053991427,1258,958,2216,-
chr17,5434891,1.59625,1276,999,2275,-
chr17,5434909,1.660981513048228,2415,1378,3793,-
chr17,5434924,1.7987711213517663,1170,836,2006,-
chr17,5438241,1.6347731986653442,823,852,1675,-
chr17,5438265,1.8478455211871982,1559,951,2510,-
chr17,5438268,1.4600495274675294,1069,841,1910,-
chr17,5438269,0.6857597190704147,1379,826,2205,-
chr17,5438270,1.8741683135884502,1374,1206,2580,-
chr17,5438854,2.7412297246322144,558,481,1039,-
chr17,5438871,2.5743116980191854,1007,697,1704,-
chr17,5438873,2.5743116980191854,1007,697,1704,-
chr17,5438876,1.9791666666666667,588,464,1052,-
chr17,5438984,2.2506329113924046,761,394,1155,-
chr17,5439112,2.9571688712591637,1576,1317,2893,-
chr17,5439114,0.9307465982232794,1385,882,2267,-
chr17,5439115,0.7925540890444226,1902,1277,3179,-
chr17,5480532,1.3133766495451284,622,460,1082,-
chr17,7240553,1.6808588957055215,720,651,1371,-
chr17,7240795,1.7342536669542705,803,609,1412,-
chr17,7240796,1.382719355695354,2001,1326,3327,-
chr17,7240797,1.4760363309380136,2245,1488,3733,-
chr17,7240917,1.9605141882706845,981,660,1641,-
chr17,7241400,0.6232650363516193,737,533,1270,-
chr17,7241627,2.087007990529742,1031,653,1684,-
chr17,7241668,2.152275025278059,733,429,1162,-
chr17,7241670,0.6595881595881596,614,443,1057,-
chr17,7242312,1.64385733574979,1628,1044,2672,-
chr17,7242314,2.021637122002085,704,410,1114,-
chr17,7242326,0.5695674171515305,710,353,1063,-
chr17,7242342,1.320716282382221,901,496,1397,-
chr17,7242364,2.555498193082085,674,446,1120,-
chr17,7243713,0.3000104404452231,865,1319,2184,-
chr17,7243725,0.2648306735443128,663,1144,1807,-
chr17,7243738,2.352482395323399,1059,1444,2503,-
chr17,7243740,1.5535714285714286,698,931,1629,-
chr17,7243746,15.809634077366582,3001,3313,6314,-
chr17,7243747,16.31815805474485,3496,3386,6882,-
chr17,7243748,16.31815805474485,3496,3386,6882,-
chr17,7243749,24.782203758318417,1733,867,2600,-
chr17,7243757,10.224894566826686,1246,192,1438,-
chr17,7243758,10.224894566826686,1246,192,1438,-
chr17,7243759,9.198232565551006,1282,228,1510,-
chr17,7243850,0.5381048971312663,618,405,1023,-
chr17,7244136,9.469576315046565,1207,834,2041,-
chr17,7244137,7.088747338307641,949,711,1660,-
chr17,7246847,2.2072232645403376,712,532,1244,-
chr17,7246848,1.8181118892695771,1709,1312,3021,-
chr17,7246849,0.8530128137244519,536,496,1032,-
chr17,7246857,3.3663422203413735,627,416,1043,-
chr17,7246859,3.462977157749501,921,592,1513,-
chr17,7247135,0.9701458102620892,840,503,1343,-
chr17,7247136,0.9701458102620892,840,503,1343,-
chr17,7247315,3.4052401746724885,556,457,1013,-
chr17,7247317,3.2140365319696214,608,440,1048,-
chr17,7247327,0.7432203746625702,623,388,1011,-
chr17,7247329,0.668132805001481,771,514,1285,-
chr17,7314985,2.3172391814321167,678,561,1239,-
chr17,7315011,2.9222643154569257,755,408,1163,-
chr17,7403323,2.0670777749811218,729,547,1276,-
chr17,7403324,3.658781362007169,637,557,1194,-
chr17,7403373,1.9638316806509024,834,683,1517,-
chr17,7404083,3.400101158825525,1877,876,2753,-
chr17,7404084,4.904944586530263,932,413,1345,-
chr17,7404085,4.904944586530263,932,413,1345,-
chr17,7404087,3.5583333333333336,853,439,1292,-
chr17,7404096,0.7910534200327578,705,308,1013,-
chr17,7591375,11.952411780819896,1958,1054,3012,-
chr17,7591376,13.46611829179596,1735,953,2688,-
chr17,7591377,11.846266119426371,1041,549,1590,-
chr17,7594331,2.5397143780825213,631,559,1190,-
chr17,7601491,1.9445587923609715,752,573,1325,-
chr17,7602991,1.3740055736672943,698,510,1208,-
chr17,7603891,0.49971231300345215,578,473,1051,-
chr17,7603893,0.49971231300345215,578,473,1051,-
chr17,7626416,2.0444363102871597,837,533,1370,-
chr17,7626417,1.8630392156862745,612,407,1019,-
chr17,7626453,2.424826071925571,615,419,1034,-
chr17,7626455,1.9292650484626048,727,426,1153,-
chr17,7856785,2.845768929780182,1279,828,2107,-
chr17,7857105,0.8982450068868169,1101,802,1903,-
chr17,7857144,1.8925423671372534,1288,955,2243,-
chr17,7857148,2.743780378249123,1221,661,1882,-
chr17,7857175,0.570746946890088,627,502,1129,-
chr17,7857197,1.5025676406983701,1005,679,1684,-
chr17,7930685,2.5077962577962576,578,443,1021,-
chr17,7930686,2.588796889756519,871,640,1511,-
chr17,7931565,3.81396139623403,629,494,1123,-
chr17,7931945,0.693518202528628,704,300,1004,-
chr17,8206608,2.0235690235690242,600,494,1094,-
chr17,8206610,2.0235690235690242,600,494,1094,-
chr17,8206773,2.5179960570220477,1556,1027,2583,-
chr17,8206774,2.415354330708661,817,507,1324,-
chr17,8207193,0.7308331324098348,877,634,1511,-
chr17,8207194,1.1784320844869003,1137,807,1944,-
chr17,8207245,1.6859997827739766,816,681,1497,-
chr17,8207274,0.641740942238685,692,488,1180,-
chr17,8207595,3.82326764144946,581,428,1009,-
chr17,8207597,3.82326764144946,581,428,1009,-
chr17,8377652,1.2621750996900576,21872,14418,36290,-
chr17,8377674,0.7142915837046869,13943,10546,24489,-
chr17,8377675,1.3753297094721144,31284,22732,54016,-
chr17,8377686,1.1779401689441185,35221,21711,56932,-
chr17,8377687,1.2907848479142288,46661,29192,75853,-
chr17,8377688,1.3046291937674597,39848,23569,63417,-
chr17,8377692,0.7848925653688349,722,571,1293,-
chr17,8379809,1.4647573213410825,12416,6452,18868,-
chr17,8379810,1.4647573213410825,12416,6452,18868,-
chr17,8379827,1.4962636656435104,7658,5227,12885,-
chr17,8379834,1.3005974711685426,3342,2398,5740,-
chr17,8379839,1.356361365461196,2933,2037,4970,-
chr17,8379841,0.7845193123120809,2495,1416,3911,-
chr17,8379843,1.2780941745765866,2367,1790,4157,-
chr17,8379858,1.7245284143397799,3214,1458,4672,-
chr17,8379860,1.5835635934655765,8345,4437,12782,-
chr17,8379862,1.5730106205848597,6677,3679,10356,-
chr17,8379869,0.569183548189073,1158,904,2062,-
chr17,8379870,1.3434913793103451,1316,724,2040,-
chr17,8379871,1.54159378871269,1731,870,2601,-
chr17,8379874,0.97097289234201,3624,2174,5798,-
chr17,8379875,1.095683072291531,3973,2154,6127,-
chr17,8379877,1.0490906527562385,1430,864,2294,-
chr17,8382258,2.0202646005654663,38916,25957,64873,-
chr17,8382264,0.7359948260892416,25998,19935,45933,-
chr17,8382271,1.304150430487036,32055,21674,53729,-
chr17,8382272,1.2500705529517973,43056,24465,67521,-
chr17,8382273,1.2384442916388272,23546,12520,36066,-
chr17,8382301,1.243068406233263,30648,23113,53761,-
chr17,8382302,0.8538374945297924,6553,3946,10499,-
chr17,8382303,1.243068406233263,30648,23113,53761,-
chr17,8382306,1.0312814964106922,17483,11532,29015,-
chr17,8382308,1.0993780989375974,19477,13279,32756,-
chr17,8382309,1.2476661905144266,9409,7090,16499,-
chr17,8382311,0.8188140105297848,10258,6923,17181,-
chr17,8383176,1.6090301893095627,5514,3703,9217,-
chr17,8383183,1.5573716735807372,16913,8142,25055,-
chr17,8383184,1.5657809017658153,6371,3683,10054,-
chr17,8383185,1.3895427979408856,32198,15570,47768,-
chr17,8383186,1.3727835310476195,24583,11374,35957,-
chr17,8383187,1.4741466677625281,26733,12157,38890,-
chr17,8383188,1.198340508336722,24615,11026,35641,-
chr17,8383190,0.9260956666672033,14693,5425,20118,-
chr17,8383191,0.8913370248091437,10951,4124,15075,-
chr17,8383192,0.8875113950110065,12430,4907,17337,-
chr17,8383193,0.8816589258856501,8553,3503,12056,-
chr17,8604863,0.7138378766708998,797,566,1363,-
chr17,8604869,2.043089837646999,1683,1695,3378,-
chr17,8604870,0.3276239613739613,860,868,1728,-
chr17,8604871,4.04438839848676,843,914,1757,-
chr17,8604872,2.8012048192771077,557,580,1137,-
chr17,8604912,1.9709689416169605,512,536,1048,-
chr17,10686766,3.790273213807984,796,512,1308,-
chr17,12995048,1.0449647204956543,785,670,1455,-
chr17,13015810,1.2615988579586008,706,466,1172,-
chr17,13015811,1.2615988579586008,706,466,1172,-
chr17,14705535,1.341462126513421,2861,2046,4907,-
chr17,14705539,1.3239619254531558,9063,7129,16192,-
chr17,14705540,1.255619607664443,5154,4745,9899,-
chr17,14705541,1.3996221959858324,4004,3499,7503,-
chr17,14705542,0.8847783184731394,3356,2190,5546,-
chr17,14705544,0.9973358016795452,10083,7681,17764,-
chr17,14705545,0.9956286255650161,7318,5726,13044,-
chr17,14705559,1.450413390318283,2162,1326,3488,-
chr17,14705561,1.4202639421030223,2382,1304,3686,-
chr17,14705562,1.4648757764643683,2515,1409,3924,-
chr17,14705564,1.4634509638419624,1309,676,1985,-
chr17,14705566,0.5441729323308271,578,436,1014,-
chr17,14705568,1.4774226281075595,799,364,1163,-
chr17,14705569,1.7034051244363921,1361,743,2104,-
chr17,16101580,3.1432443703085906,602,435,1037,-
chr17,16349295,3.7089878644733614,638,426,1064,-
chr17,16617211,0.5029248318221702,542,525,1067,-
chr17,16617220,0.2470511140235911,1130,653,1783,-
chr17,16617222,0.8937852037676906,1641,1141,2782,-
chr17,17246973,0.5169181034482758,737,463,1200,-
chr17,17246979,2.4510166358595202,701,540,1241,-
chr17,17247119,2.1930213560508807,695,450,1145,-
chr17,17247124,0.43201451905626137,540,474,1014,-
chr17,17260409,2.682015085204832,995,768,1763,-
chr17,17264959,0.6143652266101245,731,538,1269,-
chr17,17264965,0.5186271633910238,727,486,1213,-
chr17,17267930,1.7609302325581395,630,429,1059,-
chr17,17270970,1.9764163730008133,633,433,1066,-
chr17,17276107,2.047524752475248,657,504,1161,-
chr17,17276109,2.047524752475248,657,504,1161,-
chr17,17281160,2.6974933095812235,849,530,1379,-
chr17,17383380,1.9728320886443185,2218,1618,3836,-
chr17,17383381,1.9728320886443185,2218,1618,3836,-
chr17,17383384,3.618781094527364,758,803,1561,-
chr17,17383385,3.618781094527364,758,803,1561,-
chr17,17383387,1.0861501572778212,2797,1916,4713,-
chr17,17383390,0.7266724399220611,1643,1191,2834,-
chr17,17383410,1.4780276459665773,795,654,1449,-
chr17,17383608,1.4596327796697737,6728,5665,12393,-
chr17,17383609,1.2294415100507217,10740,8846,19586,-
chr17,17383626,1.3692561983471074,2393,1924,4317,-
chr17,17383627,0.7243091106531037,2575,2135,4710,-
chr17,17383641,1.4343847744261249,2181,1450,3631,-
chr17,17383648,1.7982057572999515,4158,3027,7185,-
chr17,17383652,1.6914893617021276,1377,831,2208,-
chr17,17383656,1.6554802570328793,4392,2544,6936,-
chr17,17383657,1.688391164647235,5076,2982,8058,-
chr17,17383658,1.7266435617168754,5239,2749,7988,-
chr17,17383659,1.6271577328953806,4913,2442,7355,-
chr17,17383660,1.6365475631345063,3827,1865,5692,-
chr17,17383661,1.7267363997051768,3621,1704,5325,-
chr17,17383663,1.8953899711123614,4182,2577,6759,-
chr17,17383664,2.0601977772762767,1816,1393,3209,-
chr17,17383665,1.9874900186318871,1571,662,2233,-
chr17,17383671,0.9957871396895788,1496,573,2069,-
chr17,17383672,0.9957871396895788,1496,573,2069,-
chr17,17383673,2.6536,641,374,1015,-
chr17,17383769,0.7529541150885202,2460,1492,3952,-
chr17,17383772,0.7103913044099431,3452,2166,5618,-
chr17,17383773,1.0672190932435641,2111,2051,4162,-
chr17,17383774,0.8659929676103393,9134,7307,16441,-
chr17,17383776,1.0621066593501098,3804,3520,7324,-
chr17,17383777,1.0331314313187354,1746,1300,3046,-
chr17,17383778,1.3275280898876405,1806,1690,3496,-
chr17,17383779,1.4072727272727272,1031,939,1970,-
chr17,17383785,1.154847983818035,1657,1032,2689,-
chr17,17383786,0.9992138446755403,1239,939,2178,-
chr17,17383787,1.1964526701368807,1711,930,2641,-
chr17,17383788,1.1994620983037376,1819,1087,2906,-
chr17,17383917,1.2189448580066575,16726,13481,30207,-
chr17,17383918,1.19574230779787,27450,19472,46922,-
chr17,17383942,1.6148042112568957,5502,4213,9715,-
chr17,17383962,1.4627266621893888,4157,2977,7134,-
chr17,17383965,1.1867852566739865,8434,6259,14693,-
chr17,17383966,0.8850159247353078,7387,6012,13399,-
chr17,17383968,1.3737949167397023,6269,4237,10506,-
chr17,17383969,1.1700527638738865,18469,12059,30528,-
chr17,17383971,1.230574768235974,13046,7806,20852,-
chr17,17383977,1.6891149697850532,2830,1537,4367,-
chr17,17383983,1.5451293212295047,8679,5028,13707,-
chr17,17383985,1.510545825680545,10613,6225,16838,-
chr17,17383986,1.3602762749152577,3946,2462,6408,-
chr17,17383988,1.4091831557584982,1817,875,2692,-
chr17,17383989,1.8702912621359224,1679,1029,2708,-
chr17,17383990,0.6710733396285804,1065,1058,2123,-
chr17,17383995,1.548816221284576,1390,631,2021,-
chr17,17383997,1.6020499108734405,1437,1055,2492,-
chr17,17383998,1.4500890392981878,3911,2305,6216,-
chr17,17384001,1.9582540830443886,2205,1054,3259,-
chr17,17384004,1.955669224211424,1146,758,1904,-
chr17,17384005,1.955669224211424,1146,758,1904,-
chr17,17384015,1.6066610455311976,617,592,1209,-
chr17,17384019,2.7799227799227797,575,517,1092,-
chr17,17384035,0.46271500669481924,598,510,1108,-
chr17,17384047,0.5061876039933444,648,600,1248,-
chr17,17384048,0.38712513845128754,1564,1168,2732,-
chr17,17384049,0.2869971350843826,916,568,1484,-
chr17,17817086,1.4144302924660361,682,532,1214,-
chr17,17823551,22.532374100719426,782,277,1059,-
chr17,17823603,0.9245570397762635,2337,778,3115,-
chr17,17823604,1.0062303163083663,1632,602,2234,-
chr17,17823605,1.0062303163083663,1632,602,2234,-
chr17,18245639,2.1219093768151147,622,500,1122,-
chr17,18245648,2.890842935112189,680,484,1164,-
chr17,18245649,2.890842935112189,680,484,1164,-
chr17,18245793,5.342782130654602,618,469,1087,-
chr17,18248639,2.1556888633859868,2769,1595,4364,-
chr17,18248650,0.3862547160191699,946,466,1412,-
chr17,18248667,0.3844189016602809,687,347,1034,-
chr17,18248697,1.8966120761269305,1161,692,1853,-
chr17,18248698,1.9571342282333593,1037,643,1680,-
chr17,18329297,1.986097390309903,1921,1403,3324,-
chr17,18329298,0.22002074688796677,706,481,1187,-
chr17,18329299,2.1471077146204047,1781,1378,3159,-
chr17,18329300,2.0477968965363926,1165,881,2046,-
chr17,18329313,0.936368315163992,952,736,1688,-
chr17,18329314,1.1314096959140911,1427,1063,2490,-
chr17,19343275,3.61851500849275,612,440,1052,-
chr17,19446028,2.019598254238364,726,652,1378,-
chr17,19446481,0.5538538028036574,45545,32244,77789,-
chr17,19446482,0.5759919128083054,60866,43787,104653,-
chr17,19446483,0.5018193436702056,33060,24877,57937,-
chr17,19446484,0.5469799739387002,47825,35365,83190,-
chr17,19446486,0.6575138844132382,14466,10634,25100,-
chr17,19446510,1.3558609502636747,9645,8511,18156,-
chr17,19446511,1.2353004531573926,18673,16078,34751,-
chr17,19446513,1.3876839809501311,13127,11246,24373,-
chr17,19446514,1.4603681643140982,8440,7164,15604,-
chr17,19446525,1.3476104120348709,12995,9403,22398,-
chr17,19446527,1.1255093633659774,14674,11362,26036,-
chr17,19446528,1.0652825320117716,15969,12305,28274,-
chr17,19446529,0.920867130344356,18048,14135,32183,-
chr17,19446530,0.851770574425328,14276,11188,25464,-
chr17,19446531,1.7107683180065263,4379,3370,7749,-
chr17,19446532,1.7107683180065263,4379,3370,7749,-
chr17,19446535,1.3355759857795446,1940,1388,3328,-
chr17,19446536,1.2776538555909975,2361,1411,3772,-
chr17,19446537,1.3593836565096953,1891,1443,3334,-
chr17,19446540,1.0479978473897333,4549,3715,8264,-
chr17,19446541,0.6288821575854896,2871,2584,5455,-
chr17,19446544,1.4323823896831553,4618,3047,7665,-
chr17,19446569,1.644051478429936,2623,2220,4843,-
chr17,19446571,1.6093693196198893,2362,2194,4556,-
chr17,19446573,1.7074612878090243,2940,2450,5390,-
chr17,19446574,1.7602308261703703,1420,1248,2668,-
chr17,19446575,0.4740622505985634,659,357,1016,-
chr17,19446578,1.7224687567463837,1121,886,2007,-
chr17,19446579,1.7224687567463837,1121,886,2007,-
chr17,19446582,0.3115009746588693,798,512,1310,-
chr17,19446583,2.0185570308750598,1401,986,2387,-
chr17,19446584,1.2432786927114843,2612,1754,4366,-
chr17,19446585,1.642699115044248,1814,1242,3056,-
chr17,19446586,1.5785876993166286,1322,877,2199,-
chr17,19446875,0.9993082600210232,11692,7719,19411,-
chr17,19796236,4.232923653907632,831,628,1459,-
chr17,19958441,3.6580636434721017,512,495,1007,-
chr17,21002396,8.609541025329314,689,462,1151,-
chr17,28329188,0.38738154827817023,583,487,1070,-
chr17,28330454,0.3919100821106474,646,436,1082,-
chr17,28347308,2.500386440051465,732,573,1305,-
chr17,28347362,1.1281224110413774,760,585,1345,-
chr17,28347366,0.537040563702152,704,533,1237,-
chr17,28347368,0.4304267101523407,1340,982,2322,-
chr17,28347369,0.5296855921855922,630,503,1133,-
chr17,28347518,2.486127118315165,762,567,1329,-
chr17,28347969,6.652295264428776,1325,980,2305,-
chr17,28347972,3.4434776220282703,649,434,1083,-
chr17,28348188,1.401994390775943,4498,3208,7706,-
chr17,28348189,1.733218841797776,7962,6304,14266,-
chr17,28348191,1.6787159259443667,4927,4086,9013,-
chr17,28348192,0.6475474415214018,3757,2784,6541,-
chr17,28348195,1.423485107839781,3077,2412,5489,-
chr17,28348196,1.423485107839781,3077,2412,5489,-
chr17,28348202,1.8259023569193755,2561,1848,4409,-
chr17,28348204,1.7014586476307896,3847,2769,6616,-
chr17,28348216,1.5089590741128076,940,682,1622,-
chr17,28348219,1.766660624735665,859,612,1471,-
chr17,28349156,0.3520963251786525,793,684,1477,-
chr17,28349160,5.713509657907846,1131,974,2105,-
chr17,28351704,1.010347801092268,702,496,1198,-
chr17,28351706,1.010347801092268,702,496,1198,-
chr17,28351755,2.4914814814814816,960,719,1679,-
chr17,28351756,2.4914814814814816,960,719,1679,-
chr17,28351757,2.3873667777310974,1605,1146,2751,-
chr17,28351758,2.313729936153429,1011,763,1774,-
chr17,28353762,0.47312173049332307,693,412,1105,-
chr17,28355810,1.2253717472118961,585,537,1122,-
chr17,28355811,1.2253717472118961,585,537,1122,-
chr17,28554199,2.32209265679168,920,667,1587,-
chr17,28554200,2.23573131362437,2108,1301,3409,-
chr17,28554201,2.1605087825560267,1188,634,1822,-
chr17,28554204,2.566035854825721,921,508,1429,-
chr17,28554873,2.1256506172617535,971,734,1705,-
chr17,28573452,1.0165551250440297,665,500,1165,-
chr17,28573453,0.8523575617266418,901,649,1550,-
chr17,28574709,2.6288683672565862,661,470,1131,-
chr17,28574820,2.271446297922154,612,393,1005,-
chr17,28578260,1.7055299646536353,600,495,1095,-
chr17,28578474,3.956613879147459,611,405,1016,-
chr17,28578749,3.353578435882215,641,607,1248,-
chr17,28579168,2.3090992292859136,647,511,1158,-
chr17,28583624,2.1669710806697107,618,437,1055,-
chr17,28583645,2.498215066835724,2751,1732,4483,-
chr17,28583861,1.526631706851153,2723,1783,4506,-
chr17,28583863,1.8055804404628593,2173,1409,3582,-
chr17,28583868,1.7072106890459364,936,565,1501,-
chr17,28583891,2.5566347522739417,1334,763,2097,-
chr17,28583909,2.284449580375965,1177,638,1815,-
chr17,28586158,1.1592356687898089,701,470,1171,-
chr17,28586160,0.9169032379414999,1054,687,1741,-
chr17,28591829,2.09810721751472,614,434,1048,-
chr17,28592441,1.5389343348117082,638,453,1091,-
chr17,28592675,4.597380469975439,744,487,1231,-
chr17,28614988,16.514969647096528,749,581,1330,-
chr17,28614989,18.462188253431936,830,725,1555,-
chr17,28623802,0.8673170731707318,888,624,1512,-
chr17,28623803,0.8673170731707318,888,624,1512,-
chr17,28623804,2.0649282068046366,959,651,1610,-
chr17,28642956,1.932366488385267,1432,1087,2519,-
chr17,28642958,2.1978298937859018,1617,1246,2863,-
chr17,28642960,2.0195822454308097,1546,1148,2694,-
chr17,28642961,1.9471527178602244,1002,731,1733,-
chr17,28642971,0.8924731182795699,912,557,1469,-
chr17,28642972,0.788810683989083,1211,755,1966,-
chr17,28655332,2.8213202645405433,687,504,1191,-
chr17,28655432,2.7374970965380334,683,571,1254,-
chr17,28714514,2.0407418602196943,1020,637,1657,-
chr17,28714517,0.5953249759148257,1002,685,1687,-
chr17,28715875,1.141282235579051,858,597,1455,-
chr17,28880585,3.1786970442216065,681,455,1136,-
chr17,28924245,2.576312430383896,728,381,1109,-
chr17,29021429,1.3953879818212422,1657,1370,3027,-
chr17,29021431,1.3953879818212422,1657,1370,3027,-
chr17,29021446,0.5727037143679816,662,452,1114,-
chr17,29021449,2.1436813186813186,917,623,1540,-
chr17,29021451,2.1436813186813186,917,623,1540,-
chr17,29021459,0.6234567294313096,1108,765,1873,-
chr17,29204001,0.46577642869178615,702,533,1235,-
chr17,29204003,0.6894329792955786,991,726,1717,-
chr17,29263465,2.6878909249229475,686,459,1145,-
chr17,29263850,0.1983041831945318,669,1565,2234,-
chr17,29263851,0.07602339181286549,415,1139,1554,-
chr17,29263852,0.07375296450371294,541,1512,2053,-
chr17,29263854,5.640641553124542,1167,2537,3704,-
chr17,29263856,18.326133541851096,1747,3029,4776,-
chr17,29263857,34.67255528274434,1215,1940,3155,-
chr17,29263867,9.055727554179565,1052,170,1222,-
chr17,29286430,2.8569763413897564,709,440,1149,-
chr17,29287265,1.2786471362846892,599,418,1017,-
chr17,29287525,2.7741444866920157,1139,788,1927,-
chr17,29287526,2.7741444866920157,1139,788,1927,-
chr17,29287547,1.1195678416224046,686,435,1121,-
chr17,29287549,1.1195678416224046,686,435,1121,-
chr17,30904316,1.8922098448107925,1442,863,2305,-
chr17,31852182,3.00755739190486,824,592,1416,-
chr17,31852277,0.7831356919462883,621,545,1166,-
chr17,31880733,1.6034441136235618,971,577,1548,-
chr17,31880737,2.499308437067773,972,722,1694,-
chr17,31884443,1.8960851151740519,705,460,1165,-
chr17,31884497,1.2417604705405132,789,518,1307,-
chr17,31884498,1.2417604705405132,789,518,1307,-
chr17,31899702,0.986510890140502,941,652,1593,-
chr17,32228058,0.3280304985078962,669,516,1185,-
chr17,35423027,4.761710959147689,575,433,1008,-
chr17,35861434,0.9803394516550191,850,448,1298,-
chr17,35861435,0.9803394516550191,850,448,1298,-
chr17,35861441,0.6555515999233463,1274,831,2105,-
chr17,35861442,0.7933737834915295,865,573,1438,-
chr17,35861443,0.6555515999233463,1274,831,2105,-
chr17,36495966,0.7928853377942124,728,534,1262,-
chr17,36496192,3.8331562137809274,660,465,1125,-
chr17,37258329,2.2662805576133067,715,478,1193,-
chr17,37263784,2.1328127386141107,978,590,1568,-
chr17,37626036,1.8105112501664224,1264,811,2075,-
chr17,37626055,1.908938437253354,1758,1085,2843,-
chr17,37626056,1.908938437253354,1758,1085,2843,-
chr17,37626058,1.8803133855642609,1174,856,2030,-
chr17,37626059,1.8803133855642609,1174,856,2030,-
chr17,37626065,2.038837551895005,691,392,1083,-
chr17,37626069,0.6071222790299052,1413,890,2303,-
chr17,37626092,1.8244047619047616,612,405,1017,-
chr17,38850194,1.5394596168228516,7619,5671,13290,-
chr17,38850473,1.3175431516782061,53475,35675,89150,-
chr17,38850474,1.3175431516782061,53475,35675,89150,-
chr17,38852633,0.8396258185018537,7396,4996,12392,-
chr17,38852677,1.3619643156110377,11348,6735,18083,-
chr17,38852681,1.4057081830263904,19769,11449,31218,-
chr17,38852683,1.4376616327468081,34318,22027,56345,-
chr17,38853044,1.2427180282661152,7257,5801,13058,-
chr17,38853082,1.1594865087192774,10840,7016,17856,-
chr17,38853087,1.3796481813287198,4619,3818,8437,-
chr17,38853709,1.2494389771078915,21404,13807,35211,-
chr17,38853711,1.2355138017578873,16003,9460,25463,-
chr17,38853712,1.2696708693990115,8600,6783,15383,-
chr17,38853714,1.1653140819432102,12295,9613,21908,-
chr17,38853716,1.0723042796632778,7672,5944,13616,-
chr17,38853724,1.1764884516984764,11048,6626,17674,-
chr17,38853726,1.3192474213885108,19636,11074,30710,-
chr17,38853727,1.403655551226587,14979,7636,22615,-
chr17,38853728,1.2898173442629561,17935,9789,27724,-
chr17,38853729,1.549491384905952,14879,7609,22488,-
chr17,38853731,1.716941072229637,11294,4976,16270,-
chr17,38853732,1.7432640691745187,10533,4434,14967,-
chr17,38853733,1.0635845575316785,19446,10000,29446,-
chr17,38853734,0.989948290469697,15819,7870,23689,-
chr17,38853735,0.8777726510107722,17945,9933,27878,-
chr17,38853736,0.6685806786182364,9783,4901,14684,-
chr17,38853737,0.6154279348563637,7987,4469,12456,-
chr17,38853739,0.7018545837730946,2260,1967,4227,-
chr17,38853741,1.004754567609455,1546,1428,2974,-
chr17,38853746,2.2182600485618393,1186,907,2093,-
chr17,38853748,2.521212121212121,703,483,1186,-
chr17,38853763,0.5761253368255091,1500,1086,2586,-
chr17,38853765,0.4814569755516591,538,500,1038,-
chr17,38853770,0.36955280175824207,473,594,1067,-
chr17,38869441,1.7750607533414338,898,822,1720,-
chr17,38869447,1.4013543638221533,1892,1416,3308,-
chr17,38869453,2.2221901643090085,1177,907,2084,-
chr17,38869458,0.5178180140698881,897,666,1563,-
chr17,38869459,0.6384909494111464,1517,1010,2527,-
chr17,38869468,0.9586626565013637,622,492,1114,-
chr17,38869470,0.7791950010445509,1023,760,1783,-
chr17,38869477,2.973672055427252,665,432,1097,-
chr17,38869478,3.292489273742435,808,521,1329,-
chr17,39410536,2.2804491793838184,719,301,1020,-
chr17,39410537,2.2804491793838184,719,301,1020,-
chr17,39729561,2.126865671641791,854,535,1389,-
chr17,39729563,2.126865671641791,854,535,1389,-
chr17,39730255,2.017253278122844,631,503,1134,-
chr17,39730258,2.354486502177627,1530,975,2505,-
chr17,39730260,2.1653853595066463,1308,981,2289,-
chr17,39730263,1.849121858253883,1205,1170,2375,-
chr17,39730264,1.8539670468948033,670,788,1458,-
chr17,39730267,3.26641269012453,917,681,1598,-
chr17,39730268,1.6688056296351497,1547,1182,2729,-
chr17,39730269,0.8143614851081189,997,683,1680,-
chr17,39730270,0.8143614851081189,997,683,1680,-
chr17,40023152,1.8660089155505954,1273,916,2189,-
chr17,40023155,1.7948467480427235,1521,1093,2614,-
chr17,40023156,2.216679757690528,1775,1308,3083,-
chr17,40023158,1.914841615421822,1410,981,2391,-
chr17,40023169,2.6577434577434578,967,554,1521,-
chr17,40023170,2.6577434577434578,967,554,1521,-
chr17,40033075,3.876170817019562,600,487,1087,-
chr17,40388981,1.5108565477740172,1208,834,2042,-
chr17,40389328,2.5908096280087523,1183,913,2096,-
chr17,40389555,1.587639867069118,1210,840,2050,-
chr17,40389568,0.6285991874227168,1293,917,2210,-
chr17,40389583,2.0644518272425247,716,601,1317,-
chr17,40389646,3.088500903070439,569,452,1021,-
chr17,40390049,1.6688767550702028,777,640,1417,-
chr17,40390056,0.7183059348007803,1288,998,2286,-
chr17,40390096,0.5775401069518716,620,505,1125,-
chr17,40390117,1.6993984430290163,564,470,1034,-
chr17,40390131,2.26201335782489,1263,896,2159,-
chr17,40390146,3.127289377289377,682,419,1101,-
chr17,40391579,1.6599985263778363,1098,695,1793,-
chr17,40392103,0.6295087910096067,754,612,1366,-
chr17,40392647,1.6974542857214818,7627,8017,15644,-
chr17,40392648,1.8150731412242456,5215,5556,10771,-
chr17,40392651,1.753172213584423,4645,4372,9017,-
chr17,40392656,1.592159043913567,7839,6573,14412,-
chr17,40392658,1.592159043913567,7839,6573,14412,-
chr17,40392662,1.767152181033984,4869,3842,8711,-
chr17,40392663,1.8218290113679156,3383,2452,5835,-
chr17,40392668,2.4443739843842893,1622,1096,2718,-
chr17,40392731,1.7566278847987793,920,748,1668,-
chr17,40395533,1.5061162079510702,984,653,1637,-
chr17,40396385,1.4367280766396462,632,574,1206,-
chr17,40396390,1.5541380590090923,858,633,1491,-
chr17,40396393,2.4320997280547934,2123,1630,3753,-
chr17,40396394,2.0006517358416884,2090,1578,3668,-
chr17,40398616,2.166459111664591,920,656,1576,-
chr17,40398620,0.6657355679702049,1209,715,1924,-
chr17,40399965,0.6774847870182555,1001,815,1816,-
chr17,40400388,1.9150838842930515,2041,1429,3470,-
chr17,40400395,1.6675231658732865,2121,1439,3560,-
chr17,40400572,1.9572879950238438,943,741,1684,-
chr17,40400579,1.614833759590793,923,689,1612,-
chr17,40400635,1.7073707370737072,775,605,1380,-
chr17,40400966,1.558736538753223,1110,693,1803,-
chr17,40401030,1.656056056056056,751,554,1305,-
chr17,40402917,0.5464948639394485,1212,894,2106,-
chr17,40402956,1.9795012679628063,968,545,1513,-
chr17,40402994,1.528700906344411,850,661,1511,-
chr17,40404197,2.4892966360856272,776,653,1429,-
chr17,40404212,1.9229334328199117,901,646,1547,-
chr17,40404394,1.7358540280613926,1097,798,1895,-
chr17,40406443,1.7011764705882353,963,679,1642,-
chr17,40406669,0.6206684727822581,1064,991,2055,-
chr17,40406679,2.021955373058933,2838,2351,5189,-
chr17,40406680,1.8199233716475094,1759,1583,3342,-
chr17,40406682,1.5340680668191589,1005,686,1691,-
chr17,40406683,1.6546885318071758,770,648,1418,-
chr17,40406688,2.080165289256198,838,549,1387,-
chr17,40406901,1.761750054147715,995,728,1723,-
chr17,40407617,0.6696274182344857,1372,952,2324,-
chr17,40407639,1.920656634746922,1247,859,2106,-
chr17,40408533,2.271493212669683,1003,662,1665,-
chr17,40408609,1.6231884057971016,818,620,1438,-
chr17,40411219,1.2775790874524717,2282,1663,3945,-
chr17,40411240,2.2950970899131864,1490,1150,2640,-
chr17,40412901,1.5696408048598065,1246,1336,2582,-
chr17,40412939,1.5973477998794452,999,789,1788,-
chr17,40412940,2.0125411417546246,864,800,1664,-
chr17,40412957,2.0718954248366006,950,730,1680,-
chr17,40416843,0.5549709724238026,797,688,1485,-
chr17,40417843,4.137686841487837,1637,1331,2968,-
chr17,40417844,3.7816677159196965,2624,2217,4841,-
chr17,40417845,3.7816677159196965,2624,2217,4841,-
chr17,40628218,1.3766461172474238,918,659,1577,-
chr17,40628219,1.0038461538461538,724,499,1223,-
chr17,40628899,7.6830608415032335,1333,994,2327,-
chr17,40630761,2.2012902866781845,1399,1093,2492,-
chr17,40630765,3.359235088784338,713,598,1311,-
chr17,40630771,1.9720982142857144,683,511,1194,-
chr17,40630774,1.0047242958635365,1392,1052,2444,-
chr17,40630775,1.2411223149383865,1791,1339,3130,-
chr17,40632294,1.2569159317710743,984,745,1729,-
chr17,40632346,3.3978412891456373,720,505,1225,-
chr17,40632348,3.3978412891456373,720,505,1225,-
chr17,40636070,0.4573284172783547,844,628,1472,-
chr17,40636418,2.4088382434685944,641,513,1154,-
chr17,40636513,1.041648152528245,770,550,1320,-
chr17,40647810,5.119727155486261,974,969,1943,-
chr17,40647811,5.119727155486261,974,969,1943,-
chr17,40818399,1.6764139259666988,1328,1013,2341,-
chr17,40818458,1.850181818181818,953,749,1702,-
chr17,40818463,1.7940458760370914,918,682,1600,-
chr17,40818466,1.9126236183827807,966,572,1538,-
chr17,40818473,1.3177345806390834,2124,1614,3738,-
chr17,40818475,0.8854383882454846,1379,1021,2400,-
chr17,40818480,1.9121728786677241,642,387,1029,-
chr17,40818808,1.9331807780320365,791,569,1360,-
chr17,41619537,1.3255360623781676,1495,1187,2682,-
chr17,41620549,1.3619286814358489,2262,1834,4096,-
chr17,41620554,1.3466472505374107,1941,1517,3458,-
chr17,41620700,1.5956913720367476,1128,952,2080,-
chr17,41620739,1.4638267282048403,9392,7119,16511,-
chr17,41620740,1.5109870481286674,5265,4243,9508,-
chr17,41620751,1.0385412135389254,5243,3738,8981,-
chr17,41620844,1.444699574546334,8318,5704,14022,-
chr17,41620845,1.4668460944079318,5575,4069,9644,-
chr17,41620846,1.211286164810932,2306,1630,3936,-
chr17,41620993,1.4241253276192354,3015,2186,5201,-
chr17,41621080,1.6235711229292744,7679,5903,13582,-
chr17,41621082,1.6235711229292744,7679,5903,13582,-
chr17,41621083,1.3879684347717411,1746,1417,3163,-
chr17,41621610,1.4087066779374469,3332,2365,5697,-
chr17,41621719,1.341414330730569,5748,3923,9671,-
chr17,41622367,1.5959491179817904,3873,2635,6508,-
chr17,41622368,1.4298499166203449,2660,1541,4201,-
chr17,41622371,1.3677459397951797,2403,1380,3783,-
chr17,41622467,1.5793793829715035,5255,3434,8689,-
chr17,41622503,1.7469530453360955,2675,1992,4667,-
chr17,41622991,1.0031970167904456,7019,5060,12079,-
chr17,41623004,1.2565419447820163,3214,2085,5299,-
chr17,41624108,1.334403853873946,2769,1644,4413,-
chr17,41624111,1.4788534723926368,5386,3506,8892,-
chr17,41624115,1.6823393088405696,5141,3451,8592,-
chr17,41624117,1.6823393088405696,5141,3451,8592,-
chr17,41624120,2.08046367267856,8614,5063,13677,-
chr17,41624122,2.08046367267856,8614,5063,13677,-
chr17,41624210,1.828617106314948,1063,833,1896,-
chr17,41624243,0.6233859581568476,933,794,1727,-
chr17,41624334,0.6950741806070698,1562,1200,2762,-
chr17,41624340,1.1791333065537974,2827,2243,5070,-
chr17,41624376,0.7122637073262486,1121,867,1988,-
chr17,41624475,2.200152788388082,639,475,1114,-
chr17,41624490,1.3530971157281915,1546,1016,2562,-
chr17,41624498,1.9485294117647056,1271,575,1846,-
chr17,41624569,1.6699175803007618,3411,1771,5182,-
chr17,41624570,1.5075263685880909,3300,1396,4696,-
chr17,41624572,0.8740914981911949,9109,4062,13171,-
chr17,41624574,0.862757682249883,8005,3594,11599,-
chr17,41624577,1.2079240435892293,521,495,1016,-
chr17,41754704,3.5474064737922837,567,434,1001,-
chr17,41755323,3.4851546898514365,577,437,1014,-
chr17,41802056,1.6862779522043265,683,512,1195,-
chr17,41802659,0.7662097170791368,617,428,1045,-
chr17,41803339,2.308601950979411,1017,619,1636,-
chr17,41803340,2.172110552763819,1091,596,1687,-
chr17,41803341,3.330472627355058,1783,1134,2917,-
chr17,41803342,4.14028692942946,1695,1134,2829,-
chr17,41806865,1.7107379643770269,622,544,1166,-
chr17,41807918,1.4572018497304755,881,558,1439,-
chr17,41810901,3.5882352941176467,853,594,1447,-
chr17,41811177,2.0131879040543357,650,501,1151,-
chr17,41811894,5.421812865497075,706,529,1235,-
chr17,41811895,5.423661152655034,868,603,1471,-
chr17,41825272,4.505777784838854,564,472,1036,-
chr17,41830853,3.344560432421195,949,575,1524,-
chr17,41830854,2.6622941903160497,914,534,1448,-
chr17,41830882,0.8628565952580775,730,583,1313,-
chr17,41835090,1.473872997491645,1899,1732,3631,-
chr17,41835093,1.5684921661635762,991,772,1763,-
chr17,41835108,1.58473287696053,2752,2262,5014,-
chr17,41835110,1.5872136924238611,2101,1643,3744,-
chr17,41835114,1.7715122527491214,2243,1685,3928,-
chr17,41835258,3.2165208405459564,615,435,1050,-
chr17,41867482,1.6608307453416151,1096,735,1831,-
chr17,41867529,0.6945856531913177,1075,728,1803,-
chr17,41867755,2.0577190781878363,1907,1369,3276,-
chr17,41867756,1.9415295617827264,1273,868,2141,-
chr17,41867758,0.5270419426048566,572,452,1024,-
chr17,41867787,1.2750381064209209,1160,868,2028,-
chr17,41867888,2.317991631799164,553,477,1030,-
chr17,41867893,1.6496827914353693,784,484,1268,-
chr17,41868766,1.9021995286724274,667,535,1202,-
chr17,41869494,2.5310391363022937,681,467,1148,-
chr17,41869551,1.1138916785477653,1373,1010,2383,-
chr17,41869582,1.6377516778523489,907,744,1651,-
chr17,41869585,1.8908281998631078,849,486,1335,-
chr17,41871784,0.5819719799101243,687,484,1171,-
chr17,41872090,2.299239222316145,1087,545,1632,-
chr17,41872092,2.299239222316145,1087,545,1632,-
chr17,41872093,0.43403405932588807,624,486,1110,-
chr17,41872099,1.724450469779703,655,515,1170,-
chr17,41872167,2.5405070359582256,703,526,1229,-
chr17,41873891,1.5583655238149976,905,681,1586,-
chr17,41873955,2.830654408003702,727,621,1348,-
chr17,41878159,3.8961738497235383,698,568,1266,-
chr17,41878873,2.235306496335908,713,562,1275,-
chr17,41884230,1.829046881910659,1992,1189,3181,-
chr17,41884232,1.706164108175212,3962,2531,6493,-
chr17,41884247,1.945602541195156,699,437,1136,-
chr17,41884252,1.1999707262782244,1331,891,2222,-
chr17,41886142,1.6646269251853016,1001,751,1752,-
chr17,41886159,1.2141686857448033,892,676,1568,-
chr17,41893041,1.2164862950891115,723,531,1254,-
chr17,41893092,0.9163826998689383,911,544,1455,-
chr17,41893093,0.9163826998689383,911,544,1455,-
chr17,41897775,2.337369139496097,1386,1115,2501,-
chr17,41897823,2.112867255752234,609,405,1014,-
chr17,41901763,1.431743824034884,1356,954,2310,-
chr17,41904787,1.9456487014101278,1685,1158,2843,-
chr17,41909548,1.870748299319728,624,440,1064,-
chr17,41909614,2.3576148521082443,554,453,1007,-
chr17,41909616,5.904258516376089,2169,1771,3940,-
chr17,41909617,6.305736040752088,2151,1706,3857,-
chr17,41913827,2.2794457274826794,657,432,1089,-
chr17,41976514,8.843493672375091,712,1081,1793,-
chr17,41976517,16.43124910797464,869,1059,1928,-
chr17,41976526,18.882211968612243,1613,738,2351,-
chr17,41976527,26.004698410315196,1710,653,2363,-
chr17,41976528,23.584356427630723,2203,891,3094,-
chr17,41976529,34.22212163202654,1607,579,2186,-
chr17,41976685,1.7805486284289276,611,400,1011,-
chr17,41976715,1.9016807780888385,887,692,1579,-
chr17,41977311,1.931294927447014,1029,652,1681,-
chr17,41981922,1.755714721121609,1123,771,1894,-
chr17,41981949,1.9108830237862493,950,593,1543,-
chr17,41982293,1.631578947368421,2169,1424,3593,-
chr17,41982298,2.026435185185185,1182,1079,2261,-
chr17,41982334,1.8479381160490524,2812,2056,4868,-
chr17,41982345,1.6275038741892898,1111,916,2027,-
chr17,41982383,3.334669338677353,623,498,1121,-
chr17,41988776,1.8352941176470587,647,458,1105,-
chr17,41989423,1.8263668150031789,3383,2903,6286,-
chr17,41989425,1.8716824356331698,4997,4221,9218,-
chr17,41989426,1.7484552761570369,3276,2714,5990,-
chr17,41989458,1.5307991120976694,1225,900,2125,-
chr17,41989461,1.7574791321230674,2317,1640,3957,-
chr17,41989462,1.8272601232603878,3446,2324,5770,-
chr17,41989495,1.8574040219378425,1269,1093,2362,-
chr17,41989499,3.126799580272823,1163,952,2115,-
chr17,41989511,1.850051366344771,1046,784,1830,-
chr17,42017351,2.8546437751741394,605,445,1050,-
chr17,42115792,2.879432484308343,741,538,1279,-
chr17,42115832,2.2860637852815144,620,529,1149,-
chr17,42125061,0.2596092453071127,534,954,1488,-
chr17,42125062,0.2195225279106858,765,1407,2172,-
chr17,42125064,0.2311007957559681,491,927,1418,-
chr17,42125070,11.17629050041129,1118,2941,4059,-
chr17,42125072,7.359154929577465,569,1703,2272,-
chr17,42125074,15.637482079019808,2834,3650,6484,-
chr17,42125075,21.180731215616714,3018,3267,6285,-
chr17,42125076,21.692857560101388,3204,3317,6521,-
chr17,42125077,27.371170796214635,1511,925,2436,-
chr17,42125079,7.439780200530544,1181,288,1469,-
chr17,42125085,7.774048981624936,2172,436,2608,-
chr17,42125086,9.632683491118074,3028,550,3578,-
chr17,42125087,12.84208115233859,2784,452,3236,-
chr17,42125088,21.21832403205194,2316,301,2617,-
chr17,42125089,36.97633075938956,1273,139,1412,-
chr17,42125317,8.607108745884213,1267,1009,2276,-
chr17,42125318,8.565049315835267,1648,1269,2917,-
chr17,42125323,6.440165770225921,848,482,1330,-
chr17,42125644,0.4635340216374946,607,677,1284,-
chr17,42125657,0.3938325991189428,446,680,1126,-
chr17,42125658,0.3938325991189428,446,680,1126,-
chr17,42125665,25.86181742044504,2876,2721,5597,-
chr17,42125666,24.54453017645572,3824,2965,6789,-
chr17,42125667,24.54453017645572,3824,2965,6789,-
chr17,42125668,27.281698234620976,3387,2014,5401,-
chr17,42125670,5.918922920493214,1340,307,1647,-
chr17,42125672,8.324640093366387,1471,337,1808,-
chr17,42125674,18.54945054945055,843,181,1024,-
chr17,42125676,17.19206349206349,987,213,1200,-
chr17,42126840,2.746192243696404,595,600,1195,-
chr17,42126842,2.746192243696404,595,600,1195,-
chr17,42128300,1.04512643372747,589,578,1167,-
chr17,42128301,1.04512643372747,589,578,1167,-
chr17,42128318,2.1484096612797523,786,538,1324,-
chr17,42128667,2.5124215497504103,885,504,1389,-
chr17,42128786,1.174702572916875,1080,792,1872,-
chr17,42128787,0.6546844208277587,2507,1444,3951,-
chr17,42128789,0.6395415472779369,2231,1395,3626,-
chr17,42128791,0.8062112922056258,2498,1603,4101,-
chr17,42130402,1.695487861016065,3573,3356,6929,-
chr17,42130403,1.6942559727945754,4357,3975,8332,-
chr17,42130406,1.7039961327747342,674,641,1315,-
chr17,42130439,0.977236642912528,1230,1021,2251,-
chr17,42130440,0.977236642912528,1230,1021,2251,-
chr17,42130443,0.4977252047315741,546,470,1016,-
chr17,42130449,1.8098628891750623,723,613,1336,-
chr17,42130450,1.8098628891750623,723,613,1336,-
chr17,42130452,1.6392045454545454,1153,703,1856,-
chr17,42130453,1.6392045454545454,1153,703,1856,-
chr17,42130454,1.7453860420496219,1520,1051,2571,-
chr17,42199380,2.5504273504273507,1491,974,2465,-
chr17,42199442,3.1276722090261284,686,420,1106,-
chr17,42199480,1.0849939447319168,656,585,1241,-
chr17,42199481,1.3649299560456578,1177,943,2120,-
chr17,42200252,1.5419884169884168,1064,783,1847,-
chr17,42200528,1.9652263048969618,1171,919,2090,-
chr17,42200585,1.9852923024177507,1098,813,1911,-
chr17,42200865,6.644122043147702,678,463,1141,-
chr17,42200967,0.9853943524829599,1055,631,1686,-
chr17,42200969,0.9853943524829599,1055,631,1686,-
chr17,42201124,5.071033451770924,669,500,1169,-
chr17,42201265,2.0410463939875707,613,406,1019,-
chr17,42201341,2.260236578707916,551,470,1021,-
chr17,42201514,0.3419983458408901,617,491,1108,-
chr17,42201693,1.6903057905009762,865,635,1500,-
chr17,42202351,2.1901750605497203,934,629,1563,-
chr17,42207601,2.201555146306528,741,542,1283,-
chr17,42207644,0.49088662341674383,907,746,1653,-
chr17,42207705,1.7371910789632308,654,394,1048,-
chr17,42210208,1.9219756621331423,715,507,1222,-
chr17,42210265,3.3524372614458624,927,718,1645,-
chr17,42210278,1.8318484125988208,810,612,1422,-
chr17,42210422,1.4238861244406067,905,667,1572,-
chr17,42210472,2.5863154525668923,936,669,1605,-
chr17,42212161,2.3477046269586785,627,422,1049,-
chr17,42216062,2.3093956393040216,833,592,1425,-
chr17,42217271,0.5836909871244635,611,465,1076,-
chr17,42218160,0.26753891270020297,592,428,1020,-
chr17,42218743,1.9958951967239738,950,781,1731,-
chr17,42218745,2.4800149653925296,651,552,1203,-
chr17,42223522,0.6001641073731099,639,448,1087,-
chr17,42224808,2.117565997340946,1227,1056,2283,-
chr17,42224809,2.053344389165285,968,803,1771,-
chr17,42224810,0.9018912529550829,980,647,1627,-
chr17,42224812,1.4058558908024679,1439,1015,2454,-
chr17,42224846,2.818258047655305,771,522,1293,-
chr17,42227571,2.588611859838275,590,423,1013,-
chr17,42232132,0.36786637870011657,585,737,1322,-
chr17,42232133,0.41025039456265466,633,729,1362,-
chr17,42314395,1.7780765330747188,2798,2078,4876,-
chr17,42314403,1.4444878356959523,5001,3606,8607,-
chr17,42314404,1.0902456612662852,2636,1704,4340,-
chr17,42314405,1.804790398860882,2365,1902,4267,-
chr17,42314410,1.3924469560076471,2512,1792,4304,-
chr17,42314411,1.6391329514725828,1935,1428,3363,-
chr17,42314415,0.2740615015974441,914,625,1539,-
chr17,42314421,1.6035915304207986,771,573,1344,-
chr17,42314426,0.4830065359477124,738,509,1247,-
chr17,42314430,0.4691091954022989,652,463,1115,-
chr17,42314431,0.48274687468065547,1180,946,2126,-
chr17,42314433,0.6047523904666762,1694,1385,3079,-
chr17,42314434,0.9240665566828612,1616,1300,2916,-
chr17,42315289,2.419398907103825,758,609,1367,-
chr17,42315291,2.419398907103825,758,609,1367,-
chr17,42315309,2.657263197635663,693,498,1191,-
chr17,42315468,7.359452093981747,2170,1758,3928,-
chr17,42315469,7.359452093981747,2170,1758,3928,-
chr17,42315621,3.3538461538461535,653,539,1192,-
chr17,42315623,2.1099649862843908,1142,950,2092,-
chr17,42315669,0.365597667638484,626,538,1164,-
chr17,42315670,0.365597667638484,626,538,1164,-
chr17,42315699,2.707968748427796,826,607,1433,-
chr17,42315775,2.6835210296483565,833,457,1290,-
chr17,42315778,2.03198232249811,727,592,1319,-
chr17,42315782,2.2823890057932608,1291,986,2277,-
chr17,42315784,2.1630260642366985,1988,1351,3339,-
chr17,42316831,1.409978893736292,850,627,1477,-
chr17,42322461,1.33113134869377,739,589,1328,-
chr17,42322492,2.235769697508865,780,602,1382,-
chr17,42323066,1.2844883467450385,673,535,1208,-
chr17,42329594,2.402435760171306,618,466,1084,-
chr17,42329596,2.402435760171306,618,466,1084,-
chr17,42329636,2.7503972937216354,673,459,1132,-
chr17,42337488,2.3464285714285715,1475,1311,2786,-
chr17,42337491,1.8299273398938598,2448,1772,4220,-
chr17,42337500,2.1741840850751744,2540,2019,4559,-
chr17,42337501,2.343459712685138,3705,2878,6583,-
chr17,42337503,2.231074561520209,3273,2306,5579,-
chr17,42337506,1.4912043301759135,1101,738,1839,-
chr17,42337512,0.6416020671834626,954,644,1598,-
chr17,42337518,2.4142222222222216,678,374,1052,-
chr17,42337560,2.446210268948656,608,408,1016,-
chr17,42337585,2.3130858471025246,771,547,1318,-
chr17,42338803,3.270774571490562,602,418,1020,-
chr17,42338804,1.7986241104381713,1221,845,2066,-
chr17,42339365,1.2423051672629464,677,529,1206,-
chr17,42402583,4.019511278661697,1384,1041,2425,-
chr17,42402584,4.984954356165938,1561,1195,2756,-
chr17,42402712,23.2944660928118,1357,763,2120,-
chr17,42402713,20.01044427267373,686,446,1132,-
chr17,42402776,0.37307826560790996,619,382,1001,-
chr17,42403089,0.9848363344754685,710,472,1182,-
chr17,42403090,0.9848363344754685,710,472,1182,-
chr17,42403294,3.630773732222391,1659,1294,2953,-
chr17,42403295,5.206731295820981,1811,1428,3239,-
chr17,42403296,5.206731295820981,1811,1428,3239,-
chr17,42403591,1.9448812548371281,958,655,1613,-
chr17,42403766,4.064332536873503,666,577,1243,-
chr17,42404044,6.818638630406878,1267,888,2155,-
chr17,42404045,8.09907049502322,2137,1545,3682,-
chr17,42404046,8.09907049502322,2137,1545,3682,-
chr17,42404251,1.9442949006519985,746,559,1305,-
chr17,42404328,2.6729643695722625,633,437,1070,-
chr17,42404553,3.012225433701503,590,471,1061,-
chr17,42422917,0.43241849901380874,947,771,1718,-
chr17,42422918,0.4936024844720497,882,699,1581,-
chr17,42422920,1.106753307006856,1070,905,1975,-
chr17,42573612,1.7457660355940376,952,581,1533,-
chr17,42577297,3.1205725947884044,983,584,1567,-
chr17,42797983,1.120049504950495,904,605,1509,-
chr17,42797985,1.120049504950495,904,605,1509,-
chr17,42798651,2.285765157811025,772,674,1446,-
chr17,42810251,1.787128712871287,721,504,1225,-
chr17,42810444,1.659622641509434,732,476,1208,-
chr17,42810567,0.9605390824808187,850,622,1472,-
chr17,42811684,2.197363669194655,1131,567,1698,-
chr17,42811747,2.2583458517237402,1254,697,1951,-
chr17,42811789,0.35430234537630323,1364,795,2159,-
chr17,42811790,0.3503184713375796,769,470,1239,-
chr17,42815941,1.0039651070578903,632,387,1019,-
chr17,42815942,1.0039651070578903,632,387,1019,-
chr17,42818361,2.1838539542794284,585,428,1013,-
chr17,42818568,2.630204890945142,757,355,1112,-
chr17,42818596,1.6907536764705882,1332,799,2131,-
chr17,42818597,1.6907536764705882,1332,799,2131,-
chr17,42818615,0.31423548194321227,1167,759,1926,-
chr17,42818616,0.5648496677354896,1104,796,1900,-
chr17,42818618,0.7878601329721744,710,523,1233,-
chr17,42956517,1.2291556361386482,692,471,1163,-
chr17,43014875,5.606648475992738,815,550,1365,-
chr17,43014876,5.980807570967951,712,441,1153,-
chr17,43766300,1.4849580287029513,1636,1230,2866,-
chr17,43766309,1.678467987804878,830,655,1485,-
chr17,43766310,1.4948384948384947,1071,923,1994,-
chr17,43766313,1.5260737628384689,1832,1529,3361,-
chr17,43766314,1.5260737628384689,1832,1529,3361,-
chr17,43766317,1.135112341703178,1755,1324,3079,-
chr17,43766320,0.6854785478547856,803,605,1408,-
chr17,43766361,3.3031249420074924,753,523,1276,-
chr17,43766376,2.833245515912214,748,528,1276,-
chr17,43769764,1.1676833531155584,841,519,1360,-
chr17,44011392,0.2791422121896163,686,442,1128,-
chr17,44011557,1.0848394370751124,713,589,1302,-
chr17,44011626,2.5071810165277215,3982,3021,7003,-
chr17,44011643,1.7762651141961487,1183,811,1994,-
chr17,44011650,2.1571276217561324,1035,678,1713,-
chr17,44011658,2.550993377483444,1497,905,2402,-
chr17,44011660,1.7909196680304498,3307,2220,5527,-
chr17,44011670,1.888977111553052,1396,981,2377,-
chr17,44011679,1.8065903890160184,730,436,1166,-
chr17,44011689,0.5724530831099196,656,372,1028,-
chr17,44011718,3.2027108433734943,685,414,1099,-
chr17,44011720,3.2027108433734943,685,414,1099,-
chr17,44014953,0.4240494588731632,637,447,1084,-
chr17,44210202,1.4517439269656258,611,451,1062,-
chr17,44210203,2.6169265033407574,610,448,1058,-
chr17,44319693,1.8487394957983192,593,566,1159,-
chr17,44319695,0.6124249656469226,1167,837,2004,-
chr17,44319753,1.9913101604278074,661,543,1204,-
chr17,44319756,0.7553487977788845,1079,792,1871,-
chr17,44319768,1.9251247920133112,800,600,1400,-
chr17,44319826,1.6843679745918043,1051,827,1878,-
chr17,44319897,2.121856365050557,791,550,1341,-
chr17,44319899,2.121856365050557,791,550,1341,-
chr17,44320099,1.0233990147783252,1107,811,1918,-
chr17,44320100,1.6206946863092482,2505,1934,4439,-
chr17,44320213,1.8204137587238285,540,471,1011,-
chr17,44320234,1.0632922151495316,954,830,1784,-
chr17,44320263,3.419117647058824,839,543,1382,-
chr17,44320399,2.17113172541744,635,538,1173,-
chr17,44320712,0.6090061841303023,607,533,1140,-
chr17,44320716,1.919416087192385,972,750,1722,-
chr17,44320718,1.919416087192385,972,750,1722,-
chr17,44321196,1.9720858898108813,1434,961,2395,-
chr17,44321215,2.030705255172326,1433,875,2308,-
chr17,44321227,2.564858490566038,724,370,1094,-
chr17,44321516,1.7480842911877394,583,463,1046,-
chr17,44321523,1.0906919743592436,1127,929,2056,-
chr17,44321528,1.3797440178074571,1077,598,1675,-
chr17,44321555,1.961377516242944,814,661,1475,-
chr17,44322453,2.1133133133133133,727,554,1281,-
chr17,44322475,1.6970080400685383,1237,842,2079,-
chr17,44322816,2.053755748594788,627,514,1141,-
chr17,44322840,0.6233272899939567,759,593,1352,-
chr17,44322843,2.0706080411962766,720,560,1280,-
chr17,44323340,2.2484159659849245,1425,1144,2569,-
chr17,44323341,3.1717335058214746,933,772,1705,-
chr17,44323494,1.849972943722944,546,461,1007,-
chr17,44323521,1.7235031938020933,1918,1092,3010,-
chr17,44323522,1.7235031938020933,1918,1092,3010,-
chr17,44324752,1.2045320327787783,993,787,1780,-
chr17,44683908,1.7918821507348082,894,558,1452,-
chr17,44683952,1.079891867101543,644,537,1181,-
chr17,44804436,0.3415002115088083,567,763,1330,-
chr17,44804437,0.3775621981783727,529,701,1230,-
chr17,44804452,2.713499127242934,406,672,1078,-
chr17,44851220,1.870422535211268,663,425,1088,-
chr17,44851229,1.8519430637664782,974,609,1583,-
chr17,44851313,2.2548387096774194,698,402,1100,-
chr17,44851731,2.125910509885536,680,557,1237,-
chr17,44851732,2.096657047840415,947,766,1713,-
chr17,44853317,3.4274509803921567,531,509,1040,-
chr17,44853319,3.4274509803921567,531,509,1040,-
chr17,44854653,1.1185962448978328,728,505,1233,-
chr17,44854951,2.1501618122977346,603,411,1014,-
chr17,44854989,2.871069074301683,849,755,1604,-
chr17,44854998,2.02898854063105,1047,658,1705,-
chr17,44854999,2.02898854063105,1047,658,1705,-
chr17,44857116,0.4469967406487661,639,378,1017,-
chr17,44859092,1.7764177886576906,621,386,1007,-
chr17,44859122,2.819021503455532,638,572,1210,-
chr17,44860039,2.0105214152700186,1715,1789,3504,-
chr17,44860040,2.0105214152700186,1715,1789,3504,-
chr17,44860041,2.0105214152700186,1715,1789,3504,-
chr17,44860043,0.34699186991869924,678,614,1292,-
chr17,44860457,1.0534380386899065,999,907,1906,-
chr17,44860458,1.428754120609178,1550,1452,3002,-
chr17,44860464,2.615233736515201,639,436,1075,-
chr17,44864949,1.815650236702868,651,377,1028,-
chr17,44864982,2.9317249276504302,897,541,1438,-
chr17,44867824,2.0063477669462713,707,400,1107,-
chr17,44867883,3.0,615,391,1006,-
chr17,44872489,1.7012387660918145,617,536,1153,-
chr17,44872501,1.783464566929134,603,507,1110,-
chr17,44872508,1.5251561106155216,833,589,1422,-
chr17,44875978,2.0873077930600057,1302,1071,2373,-
chr17,44876027,1.5,648,412,1060,-
chr17,44876030,1.5095123267062347,1995,1347,3342,-
chr17,44876032,1.5095123267062347,1995,1347,3342,-
chr17,44880628,3.0704053642182263,1678,1157,2835,-
chr17,44880629,0.5536319434212466,834,616,1450,-
chr17,44880630,3.0704053642182263,1678,1157,2835,-
chr17,44883154,1.7626200221381316,2244,1688,3932,-
chr17,44883155,1.7253870826463318,3286,2425,5711,-
chr17,44883157,1.9534118793616542,2137,1552,3689,-
chr17,44883701,3.901926877470356,1052,703,1755,-
chr17,44885281,1.5171957671957672,1146,755,1901,-
chr17,44886622,1.1324161325943511,1019,820,1839,-
chr17,44886658,2.425370148059224,626,440,1066,-
chr17,44899393,1.1906479872787301,1008,765,1773,-
chr17,44899394,0.8827179583116094,977,774,1751,-
chr17,45120439,1.6923522771510953,685,391,1076,-
chr17,45120445,1.0418294168482658,1012,545,1557,-
chr17,45120447,1.222018808171865,1220,654,1874,-
chr17,46721998,1.0262368815592204,739,579,1318,-
chr17,47118514,0.1057356722014796,1110,878,1988,-
chr17,47118516,0.19098497616124793,3063,2709,5772,-
chr17,47118517,0.20467146687991028,2477,2268,4745,-
chr17,47118518,0.2135204737917721,2121,1919,4040,-
chr17,47120618,1.8687943262411344,611,422,1033,-
chr17,47122456,2.07538641003208,992,761,1753,-
chr17,47122498,1.8120672601384769,915,673,1588,-
chr17,47122537,2.326668816510803,584,442,1026,-
chr17,47142002,1.682265228426396,706,393,1099,-
chr17,47142018,2.707454289732771,615,473,1088,-
chr17,47142022,2.460167085820842,693,503,1196,-
chr17,47142283,1.7400393884372463,657,442,1099,-
chr17,47154729,2.6980090377038963,605,400,1005,-
chr17,47172042,2.7520129679004235,890,585,1475,-
chr17,47172043,2.9693562093412824,1060,672,1732,-
chr17,47823539,1.6279293739967895,921,711,1632,-
chr17,47823553,0.5666263299184428,1777,1157,2934,-
chr17,47823556,1.0304584099316847,1170,824,1994,-
chr17,47823559,1.2950983492505217,1263,814,2077,-
chr17,47823560,1.0250197439779027,2292,1507,3799,-
chr17,47823561,0.9432147119420036,2714,1794,4508,-
chr17,47823609,1.767032967032967,602,454,1056,-
chr17,47824283,1.1279947163020534,795,513,1308,-
chr17,47824369,4.037068806738374,654,388,1042,-
chr17,47824370,4.037068806738374,654,388,1042,-
chr17,47827162,2.142523471655494,702,473,1175,-
chr17,48070463,3.816441341871537,1056,939,1995,-
chr17,48070464,3.4232044433247917,1705,1510,3215,-
chr17,48070492,3.6988388396558554,787,694,1481,-
chr17,48070906,0.18842433482688378,573,865,1438,-
chr17,48070963,9.823588590440062,1745,3007,4752,-
chr17,48070964,9.823588590440062,1745,3007,4752,-
chr17,48070970,5.3298633714569545,1034,1290,2324,-
chr17,48070978,9.850837861946717,2138,1414,3552,-
chr17,48070979,9.850837861946717,2138,1414,3552,-
chr17,48070980,10.810530517113577,1820,1220,3040,-
chr17,48070983,49.86152134850689,1256,252,1508,-
chr17,48070984,49.86152134850689,1256,252,1508,-
chr17,48070985,49.86152134850689,1256,252,1508,-
chr17,48071187,1.6903106029351092,1398,721,2119,-
chr17,48071222,0.5637472283813747,677,351,1028,-
chr17,48071267,1.7311320754716983,733,423,1156,-
chr17,48071281,0.31646552058675154,1164,705,1869,-
chr17,48071282,0.31646552058675154,1164,705,1869,-
chr17,48071317,0.48899005059746614,584,438,1022,-
chr17,48076085,3.0909922267946954,1351,1214,2565,-
chr17,48076086,3.0909922267946954,1351,1214,2565,-
chr17,48076087,3.0909922267946954,1351,1214,2565,-
chr17,48608032,2.006656958602038,1907,1253,3160,-
chr17,48608033,2.006656958602038,1907,1253,3160,-
chr17,48608034,2.006656958602038,1907,1253,3160,-
chr17,48608037,0.4368401892974154,719,401,1120,-
chr17,48933239,0.5142145214225506,1276,916,2192,-
chr17,48936190,4.9574738986503695,627,560,1187,-
chr17,48936191,4.9574738986503695,627,560,1187,-
chr17,48941036,0.5086569291058068,648,400,1048,-
chr17,48941037,2.2165766426253013,980,791,1771,-
chr17,49404935,2.4302246426140237,594,564,1158,-
chr17,49405188,0.9737702304073984,1969,1129,3098,-
chr17,49405190,1.1416817632850242,2874,1655,4529,-
chr17,49405191,1.0162916080637598,1884,1079,2963,-
chr17,49405196,2.0733471074380163,668,351,1019,-
chr17,49405199,2.3193104519619134,680,480,1160,-
chr17,49409093,1.7374107142857143,670,559,1229,-
chr17,49409124,0.5381412391738841,717,631,1348,-
chr17,49409135,1.762675704238408,2620,1879,4499,-
chr17,49409137,2.6905098039215685,1071,749,1820,-
chr17,49409341,0.4436756756756756,683,499,1182,-
chr17,49409382,0.6357006217120994,817,655,1472,-
chr17,49409386,2.443419434194342,684,541,1225,-
chr17,49409403,1.5816207708952268,2086,1532,3618,-
chr17,49409457,1.58273532250619,1984,1221,3205,-
chr17,49409472,2.18948618948619,775,517,1292,-
chr17,49411742,0.6479415159676799,841,677,1518,-
chr17,49411817,1.381283517215775,2361,1657,4018,-
chr17,49411822,2.159735001840265,651,571,1222,-
chr17,49411824,2.0100726073804607,1261,794,2055,-
chr17,49413251,3.2,991,619,1610,-
chr17,49413266,1.7485714285714284,854,474,1328,-
chr17,49413268,1.8713639301874596,578,441,1019,-
chr17,49413270,2.9238031177825516,915,716,1631,-
chr17,49413273,1.3615238215510503,1529,1004,2533,-
chr17,49414863,2.4932682930960173,989,541,1530,-
chr17,49414864,4.998331571754479,1228,567,1795,-
chr17,49414874,0.7407407407407407,919,321,1240,-
chr17,49414876,0.7407407407407407,919,321,1240,-
chr17,49414879,0.8564973926482182,1121,441,1562,-
chr17,50368211,0.9627727856225929,749,550,1299,-
chr17,50368213,0.8316188140504804,1077,769,1846,-
chr17,50370508,5.310989010989012,536,519,1055,-
chr17,50370509,5.310989010989012,536,519,1055,-
chr17,50370542,1.7394550529829766,786,641,1427,-
chr17,50381750,1.005641347085304,1102,762,1864,-
chr17,50381751,1.005641347085304,1102,762,1864,-
chr17,50381922,3.8033745184004246,841,578,1419,-
chr17,50381923,3.8033745184004246,841,578,1419,-
chr17,50382028,1.25679544108745,692,530,1222,-
chr17,50382068,0.9937798460516918,687,565,1252,-
chr17,50382295,0.4910411622276029,623,471,1094,-
chr17,50382515,2.9636336907307355,1152,856,2008,-
chr17,50382534,2.50391474554154,793,483,1276,-
chr17,50382535,2.50391474554154,793,483,1276,-
chr17,50382691,0.41584762724490637,1287,1803,3090,-
chr17,50382692,0.3937093801532641,954,1351,2305,-
chr17,50382693,0.42014661137027326,1399,1789,3188,-
chr17,50382722,7.654393805489303,1361,1906,3267,-
chr17,50382723,6.373241131264409,3277,3888,7165,-
chr17,50382724,6.373241131264408,3277,3888,7165,-
chr17,50382725,6.640900989631274,2813,3191,6004,-
chr17,50382878,1.6842226842226842,633,467,1100,-
chr17,50383066,1.525540892562087,763,580,1343,-
chr17,50383108,7.2126615796798195,2183,1466,3649,-
chr17,50383109,7.448706611865188,1920,1287,3207,-
chr17,50385284,1.4884754732248815,841,532,1373,-
chr17,50385285,0.8542102788087396,889,613,1502,-
chr17,50392417,1.7737226277372264,647,410,1057,-
chr17,50392418,2.3453030303030302,672,439,1111,-
chr17,50392425,1.9290540540540544,570,443,1013,-
chr17,50392786,1.5579710144927537,644,413,1057,-
chr17,50392823,1.2585945255947857,1054,700,1754,-
chr17,50392828,2.8157894736842106,641,455,1096,-
chr17,50392851,2.1833216864663405,720,476,1196,-
chr17,50392892,2.1849737101544533,1236,715,1951,-
chr17,50392894,2.1849737101544533,1236,715,1951,-
chr17,50695588,2.4901597592035194,716,616,1332,-
chr17,50695590,2.4901597592035194,716,616,1332,-
chr17,50862591,1.4383103448275862,1573,999,2572,-
chr17,50862709,1.451398048008441,1692,1114,2806,-
chr17,50863107,1.8858752515090544,807,496,1303,-
chr17,50863155,3.179824561403509,724,436,1160,-
chr17,50863185,2.422330976980243,770,612,1382,-
chr17,50863186,2.422330976980243,770,612,1382,-
chr17,50863361,1.7456862745098038,613,424,1037,-
chr17,50863414,5.777235772357724,645,409,1054,-
chr17,50863422,1.9320223738300566,1052,642,1694,-
chr17,50863446,1.700847689362866,621,476,1097,-
chr17,50863626,1.7243243243243245,824,554,1378,-
chr17,50863703,1.5338804713804717,984,593,1577,-
chr17,50863759,2.3811294509514855,1290,829,2119,-
chr17,50863940,1.9060764206226595,2247,1717,3964,-
chr17,50863943,1.4650967199327167,803,695,1498,-
chr17,50863944,0.37702287753464825,1238,976,2214,-
chr17,50863965,1.5505839089974176,3458,2554,6012,-
chr17,50863967,1.5505839089974176,3458,2554,6012,-
chr17,54964817,3.0992387423837595,690,413,1103,-
chr17,55393080,0.9910016203410528,1312,637,1949,-
chr17,55393102,2.6023255813953488,745,300,1045,-
chr17,55393104,2.6023255813953488,745,300,1045,-
chr17,57839682,0.5816566643110445,1561,1087,2648,-
chr17,57839688,1.6566507177033492,540,549,1089,-
chr17,57849313,2.066688852372793,1799,912,2711,-
chr17,57849326,0.6304032308954376,998,597,1595,-
chr17,57849353,1.865462875623232,1305,904,2209,-
chr17,57849354,1.865462875623232,1305,904,2209,-
chr17,57849377,2.5537973709488937,1283,730,2013,-
chr17,57849378,2.357546942705826,910,535,1445,-
chr17,58003610,1.567708333333333,902,671,1573,-
chr17,58003698,1.9302501259023002,792,517,1309,-
chr17,58004041,0.6798515460643829,1104,853,1957,-
chr17,58004068,1.4575866188769415,914,712,1626,-
chr17,58004248,0.5925925925925926,727,503,1230,-
chr17,58004446,1.3858993190153193,2479,1659,4138,-
chr17,58004693,3.5809598127194704,705,465,1170,-
chr17,58004746,2.2693939055698182,1098,577,1675,-
chr17,58004747,2.2693939055698182,1098,577,1675,-
chr17,58004891,2.333333333333333,703,479,1182,-
chr17,58005064,0.6775661554019891,1339,1046,2385,-
chr17,58005091,1.9678921568627448,650,509,1159,-
chr17,58005125,1.8366970219049965,596,477,1073,-
chr17,58005419,0.5647313379011899,782,516,1298,-
chr17,58005442,1.651176051318603,701,609,1310,-
chr17,58005450,2.2747068676716915,678,596,1274,-
chr17,58005536,0.3866841710427607,792,619,1411,-
chr17,58005542,2.5630907589244747,797,640,1437,-
chr17,58005911,0.49118942731277526,668,453,1121,-
chr17,58005942,1.0350171232876713,1098,729,1827,-
chr17,58005944,1.0350171232876713,1098,729,1827,-
chr17,58005955,1.938509089288536,707,474,1181,-
chr17,58346045,4.974340819789227,1865,1391,3256,-
chr17,58346046,3.6908032443746728,924,727,1651,-
chr17,58346048,2.6768558951965056,612,457,1069,-
chr17,58346052,75.02511072540607,3115,1299,4414,-
chr17,58346053,66.46440614076761,3440,1365,4805,-
chr17,58346058,39.30722891566265,1304,165,1469,-
chr17,58346059,30.46124263176118,5436,822,6258,-
chr17,58346060,33.99465469495957,5847,864,6711,-
chr17,58346061,33.53041535228408,5416,804,6220,-
chr17,58346062,60.37288135593221,1232,176,1408,-
chr17,58346161,2.554256268097951,1253,808,2061,-
chr17,58346274,2.1262257393979396,1012,806,1818,-
chr17,58346276,2.2661012456930822,683,538,1221,-
chr17,58347223,1.283877602268012,723,497,1220,-
chr17,58351455,0.4869540873460246,668,469,1137,-
chr17,58476688,1.286963301934798,2026,1712,3738,-
chr17,58476690,1.286963301934798,2026,1712,3738,-
chr17,59001708,1.8842386006057696,1052,730,1782,-
chr17,59001709,3.4351971557853913,732,475,1207,-
chr17,59001711,3.4938985228002566,1087,691,1778,-
chr17,59001712,3.5105209397344237,715,444,1159,-
chr17,59111606,1.3593332144767338,1546,993,2539,-
chr17,59111618,0.7137745974955277,1175,727,1902,-
chr17,59111667,17.134615384615387,647,415,1062,-
chr17,59111676,2.169263965475905,1247,775,2022,-
chr17,59111677,2.169263965475905,1247,775,2022,-
chr17,59111693,3.0634683286300337,777,448,1225,-
chr17,59697420,2.490980858044651,785,593,1378,-
chr17,59697578,1.9752871562826313,1134,662,1796,-
chr17,59697579,1.9752871562826313,1134,662,1796,-
chr17,59697680,3.3139842298410636,645,496,1141,-
chr17,59697819,2.3832976275499376,1125,782,1907,-
chr17,59697821,2.398428290766208,762,508,1270,-
chr17,59697935,0.5614779076506797,1572,1218,2790,-
chr17,59697950,2.077045371163018,771,628,1399,-
chr17,59697959,1.9791842093060896,992,731,1723,-
chr17,59697967,0.8509233876785456,760,477,1237,-
chr17,59697968,0.8509233876785456,760,477,1237,-
chr17,59707429,0.87396606851065,755,528,1283,-
chr17,59973706,1.1803971427612836,19667,16622,36289,-
chr17,59973707,1.1803971427612836,19667,16622,36289,-
chr17,59973708,1.2043467069045688,20152,16691,36843,-
chr17,59973713,1.2378534911157986,3245,3032,6277,-
chr17,59973718,0.7705654111760976,2630,2467,5097,-
chr17,59973721,0.5502686370960724,8294,5783,14077,-
chr17,59973723,0.7365380643321976,3792,2472,6264,-
chr17,59973724,0.7404505759412137,6352,4780,11132,-
chr17,59973726,0.7017122509552288,3496,3003,6499,-
chr17,59973727,0.6598958333333333,904,599,1503,-
chr17,60083599,22.445567110822232,1113,697,1810,-
chr17,60083600,22.445567110822232,1113,697,1810,-
chr17,60083601,22.445567110822232,1113,697,1810,-
chr17,61590555,1.1761188208779172,1421,1128,2549,-
chr17,61590578,1.1125445182030178,1274,1029,2303,-
chr17,61590581,0.9639547588987026,1502,1255,2757,-
chr17,61590582,0.9914990096655543,2683,2112,4795,-
chr17,61590583,0.5273504273504274,1233,879,2112,-
chr17,61590699,1.874134556987651,2103,2116,4219,-
chr17,61590700,1.4295085473033828,4794,3996,8790,-
chr17,61590706,1.5726921726921723,1041,813,1854,-
chr17,61590712,0.9772853721667191,1615,1233,2848,-
chr17,61590713,0.8393635307781651,2286,1749,4035,-
chr17,61590714,1.3320799992097836,1855,1259,3114,-
chr17,61590715,0.5901909150757076,1466,1115,2581,-
chr17,61590719,1.296090161037912,862,557,1419,-
chr17,61590720,1.0867645260677425,1162,793,1955,-
chr17,61591187,1.988048780487805,626,409,1035,-
chr17,61591189,2.0251994551469155,904,570,1474,-
chr17,63745542,0.35391346621293146,839,604,1443,-
chr17,63745544,0.35391346621293146,839,604,1443,-
chr17,63745618,1.917119026572151,516,593,1109,-
chr17,63745672,23.073588434596395,710,825,1535,-
chr17,63746482,2.684873949579832,567,815,1382,-
chr17,63746490,1.9221175166297118,1094,1352,2446,-
chr17,63746491,1.9221175166297118,1094,1352,2446,-
chr17,63746496,1.9267181620122797,511,560,1071,-
chr17,63751967,2.4475480384868535,879,600,1479,-
chr17,63752087,1.6182010831174949,2748,1643,4391,-
chr17,63752088,1.6182010831174949,2748,1643,4391,-
chr17,63752092,1.4068901303538175,1510,1073,2583,-
chr17,63752099,0.5147298556124825,1262,903,2165,-
chr17,63752104,1.7391304347826089,719,467,1186,-
chr17,63752342,2.063735224586288,703,422,1125,-
chr17,63761299,1.7557607139920355,709,463,1172,-
chr17,63765950,3.3201988944731196,639,532,1171,-
chr17,63766011,3.1721873460054963,868,658,1526,-
chr17,63823945,0.7158980494509172,639,515,1154,-
chr17,63823947,0.3032187039939283,530,557,1087,-
chr17,63824115,0.15044922590471785,380,725,1105,-
chr17,63824140,18.096811182346272,426,633,1059,-
chr17,63826857,1.677269187235705,841,539,1380,-
chr17,64153114,1.9988020684310228,667,424,1091,-
chr17,64500084,1.7275919189614977,4586,3334,7920,-
chr17,64500254,0.5323722993275147,1352,963,2315,-
chr17,64500281,0.742130975202523,1090,784,1874,-
chr17,64500588,2.0340435662421137,1067,812,1879,-
chr17,64500641,0.627492762015055,2083,1569,3652,-
chr17,64501489,2.8118098159509204,872,651,1523,-
chr17,64502033,1.5094887090870959,3395,2468,5863,-
chr17,64502939,1.5606149471252109,2743,1704,4447,-
chr17,64503054,1.5222533946807315,1883,1329,3212,-
chr17,64503243,1.484565548780488,1322,983,2305,-
chr17,64503280,1.34052757793765,2020,1667,3687,-
chr17,64503342,1.60330953928096,3582,2303,5885,-
chr17,64503343,1.6068439650362654,2699,1697,4396,-
chr17,64503473,1.2005932988571526,3146,2331,5477,-
chr17,64503483,1.449345542055526,1410,1261,2671,-
chr17,64503511,0.6462829736211031,1154,833,1987,-
chr17,64503513,0.518396734508759,1015,568,1583,-
chr17,64503545,0.4012137137137137,582,443,1025,-
chr17,64503553,0.5805581251927228,885,551,1436,-
chr17,64503996,1.5570874539460926,1360,954,2314,-
chr17,64504238,1.5406356655290103,1604,1171,2775,-
chr17,64504279,1.856403354384512,833,742,1575,-
chr17,64504788,2.0080283353010633,1062,725,1787,-
chr17,64504792,1.8216463414634143,955,655,1610,-
chr17,64504795,1.7036282992801572,1064,808,1872,-
chr17,64504796,1.7036282992801572,1064,808,1872,-
chr17,64504801,2.302536231884058,836,551,1387,-
chr17,64504819,3.4724781206817132,814,667,1481,-
chr17,64506185,1.9702225647470397,4283,3320,7603,-
chr17,64506186,1.9702225647470397,4283,3320,7603,-
chr17,65012403,1.121806353652464,2904,1843,4747,-
chr17,65012407,0.4624298388556943,1276,788,2064,-
chr17,65012408,1.5632894292468758,1128,704,1832,-
chr17,65012413,2.282516891891892,1034,665,1699,-
chr17,65012419,1.1984731518060547,2313,1484,3797,-
chr17,65012437,1.847715736040609,727,393,1120,-
chr17,65012438,1.7603108371647014,1462,859,2321,-
chr17,65012439,1.8669320137693632,1067,663,1730,-
chr17,65012441,2.269578313253012,684,414,1098,-
chr17,67340924,1.47383253239769,680,547,1227,-
chr17,67348579,3.109944327651894,623,418,1041,-
chr17,68267360,0.33643627199209253,1752,3200,4952,-
chr17,68267366,0.3401069140085673,738,1201,1939,-
chr17,68267396,21.18795917894857,5636,5153,10789,-
chr17,68267397,19.689503634190295,7424,5464,12888,-
chr17,68267398,20.645226300099793,8427,5606,14033,-
chr17,68267399,10.245550798091216,6956,1493,8449,-
chr17,68267400,6.10827087621723,4075,631,4706,-
chr17,68267401,8.770772238514175,2424,309,2733,-
chr17,68267402,10.874953132923569,2237,275,2512,-
chr17,68267403,12.883928571428573,1442,167,1609,-
chr17,68267655,2.0244253771834733,1080,823,1903,-
chr17,68268046,1.9816579543563162,1446,1143,2589,-
chr17,68268124,0.2391919191919192,591,449,1040,-
chr17,68268298,2.243197922864716,1507,972,2479,-
chr17,68268299,2.467924361714806,2175,1385,3560,-
chr17,68268300,2.9832775919732444,668,413,1081,-
chr17,68268405,0.4969061876247505,765,500,1265,-
chr17,68268517,1.87192118226601,607,405,1012,-
chr17,68268633,1.2393319128725766,1459,1000,2459,-
chr17,68268839,1.6887826260211198,651,477,1128,-
chr17,68268882,2.013966119229277,598,406,1004,-
chr17,68268964,0.2908703590992088,530,529,1059,-
chr17,68269031,13.384304652528007,4342,5385,9727,-
chr17,68269032,13.384304652528007,4342,5385,9727,-
chr17,68269033,13.384304652528007,4342,5385,9727,-
chr17,68269041,30.12916464589537,2530,1190,3720,-
chr17,68269042,30.12916464589537,2530,1190,3720,-
chr17,68269053,8.71111111111111,930,189,1119,-
chr17,68270878,2.2473442026927226,859,606,1465,-
chr17,68270879,2.2473442026927226,859,606,1465,-
chr17,68271572,5.0989010989010985,811,636,1447,-
chr17,68271595,2.9749063670411986,610,444,1054,-
chr17,68273953,2.2443428493848883,1474,1005,2479,-
chr17,68273955,2.2742436232008103,1374,933,2307,-
chr17,73209010,1.9788888888888894,547,479,1026,-
chr17,73209024,0.5285996055226824,803,506,1309,-
chr17,73284283,0.8218965571999527,689,439,1128,-
chr17,75039028,2.08768898488121,1073,925,1998,-
chr17,75040126,1.588307058732481,2297,1805,4102,-
chr17,75040159,1.7088239675167898,1936,1488,3424,-
chr17,75040161,1.6856154826184553,1207,932,2139,-
chr17,75042585,2.0511407135201347,787,621,1408,-
chr17,75042592,1.6444878048780491,1175,749,1924,-
chr17,75042625,0.6315487790897627,786,571,1357,-
chr17,75042627,0.5384072785663138,1296,953,2249,-
chr17,75042658,0.6767109822223821,762,583,1345,-
chr17,75147599,1.5728048191493018,13515,7807,21322,-
chr17,75147600,1.4792710704225667,16743,9682,26425,-
chr17,75147602,1.452847924253257,13747,7950,21697,-
chr17,75147603,1.6324975645322939,7393,4262,11655,-
chr17,75147604,1.5649863184576773,7890,4481,12371,-
chr17,75147611,1.5869228353185978,3444,1773,5217,-
chr17,75147614,2.952,1106,524,1630,-
chr17,75147617,1.536718508526276,5542,2554,8096,-
chr17,75147619,1.5672542720479246,6371,2859,9230,-
chr17,75147620,1.624195757215576,1778,686,2464,-
chr17,75147625,0.6787505246647668,1228,572,1800,-
chr17,75148590,1.8619619040074629,1089,776,1865,-
chr17,75154390,4.47893372883642,587,427,1014,-
chr17,75167868,4.13161743199766,1008,788,1796,-
chr17,75168249,1.6705901322154144,796,442,1238,-
chr17,75168264,1.9836003051106021,742,569,1311,-
chr17,75168266,2.4218449151058987,1152,590,1742,-
chr17,75168268,2.4218449151058987,1152,590,1742,-
chr17,75168284,2.291330970029004,789,320,1109,-
chr17,75168285,2.291330970029004,789,320,1109,-
chr17,75168286,0.41820467083487084,1255,953,2208,-
chr17,75168288,0.3820974247595407,820,585,1405,-
chr17,75174813,1.5100356927641034,1017,798,1815,-
chr17,75174814,1.408791770493898,1296,845,2141,-
chr17,75174819,3.528098114589054,837,606,1443,-
chr17,75181086,2.3952466743770664,974,712,1686,-
chr17,75182896,0.5361765435159931,635,544,1179,-
chr17,75182913,1.880252100840336,536,475,1011,-
chr17,75182931,0.6570666666666667,692,449,1141,-
chr17,75182957,4.372198963566207,617,428,1045,-
chr17,75320192,3.4161976235146967,574,491,1065,-
chr17,75320193,3.7667562404486636,823,709,1532,-
chr17,75320194,3.733353234825657,996,835,1831,-
chr17,75320199,11.450028705254537,1142,743,1885,-
chr17,75320200,18.235294117647054,712,390,1102,-
chr17,75320201,13.225135720822033,1678,1047,2725,-
chr17,75320202,19.450387576781907,890,501,1391,-
chr17,75320398,1.706180327682314,743,516,1259,-
chr17,75320400,2.4447635606398332,713,483,1196,-
chr17,75320520,2.4308507328690316,896,623,1519,-
chr17,75777906,1.5683237829745496,867,586,1453,-
chr17,75778123,2.1570381852833225,763,614,1377,-
chr17,75778595,0.7622742379977999,2013,1432,3445,-
chr17,75778602,1.889419527500923,1488,1007,2495,-
chr17,75778604,1.7953602113764768,2152,1350,3502,-
chr17,75778606,1.7953602113764768,2152,1350,3502,-
chr17,75778616,2.188919164396004,1204,733,1937,-
chr17,75778628,1.8271168831168831,976,549,1525,-
chr17,75778855,1.6064060020199105,878,716,1594,-
chr17,75778870,1.8745373979050708,1759,1288,3047,-
chr17,75778885,2.6204304245283017,612,423,1035,-
chr17,75778906,1.8587463880862407,668,408,1076,-
chr17,75779095,1.832098429746448,1122,625,1747,-
chr17,75779107,1.9952103290295713,736,685,1421,-
chr17,75779146,1.9214793826862795,1933,1642,3575,-
chr17,75779160,1.9615902964959566,922,741,1663,-
chr17,75779175,1.2148413963677478,4340,2679,7019,-
chr17,75779176,0.9242131176367152,2919,1693,4612,-
chr17,75779177,1.1542375995844312,5633,3580,9213,-
chr17,75779179,1.5990100772709468,1282,850,2132,-
chr17,75779739,1.3883485060250067,1484,1150,2634,-
chr17,75779772,0.6700910972561982,2664,2037,4701,-
chr17,75779777,0.8708105059229416,6694,5539,12233,-
chr17,75779778,0.9516829395794338,2498,2395,4893,-
chr17,75779779,0.9362381398915092,4292,3669,7961,-
chr17,75845875,2.2047144056278416,708,541,1249,-
chr17,75845899,3.2565230863123777,622,520,1142,-
chr17,75846623,1.6937856473393185,556,461,1017,-
chr17,75846646,28.866957839534486,1343,950,2293,-
chr17,75846647,28.866957839534486,1343,950,2293,-
chr17,75846698,3.063814072372413,697,374,1071,-
chr17,75848650,4.550492610837439,738,608,1346,-
chr17,75849707,0.4504062993704069,826,558,1384,-
chr17,75855259,3.469700590093085,631,489,1120,-
chr17,75874575,3.888539720275462,733,545,1278,-
chr17,76039231,2.2772674188908852,655,457,1112,-
chr17,76050490,0.3364265723965238,570,437,1007,-
chr17,76050493,0.6081591538655251,643,417,1060,-
chr17,76050510,0.49800328502310226,913,670,1583,-
chr17,76070392,1.0041164968611709,886,710,1596,-
chr17,76070393,1.0041164968611709,886,710,1596,-
chr17,76072375,0.3706265490579852,645,958,1603,-
chr17,76101729,5.0347758011572274,528,547,1075,-
chr17,76101731,2.277395414783191,608,478,1086,-
chr17,76226608,1.1786658326083255,635,604,1239,-
chr17,76680554,1.7198183267389797,748,596,1344,-
chr17,76680556,3.3532899493853936,681,460,1141,-
chr17,76734339,1.578540772532189,612,465,1077,-
chr17,76734412,1.4998042669798397,612,523,1135,-
chr17,76734438,1.2169238034165704,1123,839,1962,-
chr17,76734671,2.5952107279693486,588,434,1022,-
chr17,76734794,1.9373323797604147,1666,1189,2855,-
chr17,76734991,1.722473361317404,1134,814,1948,-
chr17,76735010,1.8606802721088436,1051,734,1785,-
chr17,76735121,1.8233049732294402,1637,1166,2803,-
chr17,76735147,1.4986961990367211,996,880,1876,-
chr17,76735156,1.9188665710186517,1162,819,1981,-
chr17,76735157,1.9188665710186517,1162,819,1981,-
chr17,76736226,1.0159395973154364,864,595,1459,-
chr17,76736228,1.0159395973154364,864,595,1459,-
chr17,76736237,0.3935447942909518,753,611,1364,-
chr17,76736256,2.0390243902439025,703,655,1358,-
chr17,76736258,2.0390243902439025,703,655,1358,-
chr17,76736319,0.3029983108108108,614,443,1057,-
chr17,76736415,2.5943686502177066,930,688,1618,-
chr17,76736417,2.5943686502177066,930,688,1618,-
chr17,76737054,2.528320719756158,632,404,1036,-
chr17,76737319,1.6913356745445862,851,568,1419,-
chr17,78174265,2.9015799015799018,658,593,1251,-
chr17,78174266,2.9015799015799018,658,593,1251,-
chr17,78174284,2.242108190794048,700,422,1122,-
chr17,78174855,1.0083501006036215,770,496,1266,-
chr17,78174856,1.0083501006036215,770,496,1266,-
chr17,78174859,2.694315060530442,699,482,1181,-
chr17,78174921,2.286241714534165,844,550,1394,-
chr17,78174927,1.08687362591791,1341,1119,2460,-
chr17,78174928,0.6277035236938032,860,822,1682,-
chr17,78174929,0.6277035236938032,860,822,1682,-
chr17,78175072,2.5912816691505216,534,487,1021,-
chr17,78175571,2.0339311967068507,1097,894,1991,-
chr17,78175572,1.760715380662708,1847,1382,3229,-
chr17,78175573,2.0339311967068507,1097,894,1991,-
chr17,78185159,1.9080576759966075,702,654,1356,-
chr17,78185161,1.9080576759966075,702,654,1356,-
chr17,78186799,2.0306698950766746,628,412,1040,-
chr17,78187046,0.4902231259659794,1831,1268,3099,-
chr17,78187050,0.719042336138332,1427,1078,2505,-
chr17,78187051,0.9032173318458272,932,750,1682,-
chr17,78797763,2.6872146118721463,748,437,1185,-
chr17,78797764,2.417250076575713,1224,678,1902,-
chr17,78853321,2.0107526881720434,917,557,1474,-
chr17,78853361,1.688622754491018,845,500,1345,-
chr17,78853365,2.5672389127324746,775,465,1240,-
chr17,78853423,3.627594936708862,622,394,1016,-
chr17,78853493,2.3181779783020597,1331,1116,2447,-
chr17,78853528,2.8571428571428568,899,629,1528,-
chr17,78853734,1.594888526373029,837,612,1449,-
chr17,78853757,2.0946533931266424,1209,834,2043,-
chr17,78853955,1.8742177722152689,598,469,1067,-
chr17,78853989,3.427052150622341,852,576,1428,-
chr17,78853990,3.427052150622341,852,576,1428,-
chr17,78854153,1.8129113924050633,681,394,1075,-
chr17,78854292,2.029364224137931,557,463,1020,-
chr17,78855569,1.6961662749706228,744,591,1335,-
chr17,78855573,1.5972954230235783,742,514,1256,-
chr17,78855633,2.322925748974049,2367,1763,4130,-
chr17,78855635,2.322925748974049,2367,1763,4130,-
chr17,78855745,2.063219318755239,1295,867,2162,-
chr17,78855835,1.3551876633815558,1878,1214,3092,-
chr17,78855836,0.9696395307036176,1379,826,2205,-
chr17,78857615,4.400347222222221,666,359,1025,-
chr17,78870913,2.0622986036519872,719,440,1159,-
chr17,78873869,2.1511627906976742,813,945,1758,-
chr17,78873877,1.8694223363286264,742,778,1520,-
chr17,78873883,2.2099334357398868,663,650,1313,-
chr17,78873892,1.7513302635165748,2063,1599,3662,-
chr17,78873894,1.7574246502802169,1474,1053,2527,-
chr17,78924976,2.5474540043290044,631,469,1100,-
chr17,78924983,0.986292656601018,767,561,1328,-
chr17,78925006,3.2254982254982254,694,406,1100,-
chr17,78925008,3.2254982254982254,694,406,1100,-
chr17,78971358,0.6304182286785378,860,775,1635,-
chr17,78971453,1.4057785987033347,3347,2438,5785,-
chr17,78971462,2.6993379579563737,1504,1222,2726,-
chr17,78971544,1.8579415918714377,2558,1772,4330,-
chr17,78971552,2.020594340653337,786,677,1463,-
chr17,78971640,2.469875758819053,2223,1735,3958,-
chr17,78971726,1.8749941417156708,31263,22796,54059,-
chr17,78971727,1.8749941417156708,31263,22796,54059,-
chr17,78971733,1.1835135361154978,26391,17830,44221,-
chr17,78971735,1.1835135361154978,26391,17830,44221,-
chr17,78971739,0.7333952373953977,10488,8179,18667,-
chr17,78971744,1.0506161813760044,19421,14176,33597,-
chr17,78971775,1.4084541006489537,16075,11433,27508,-
chr17,78971779,1.3495550549769164,6050,3448,9498,-
chr17,78971790,1.4205929062996294,3577,1888,5465,-
chr17,78971809,1.8047899327328696,7376,5011,12387,-
chr17,78971810,1.4287401548854837,5586,2974,8560,-
chr17,78971811,1.6511170393174104,12962,7985,20947,-
chr17,78971814,1.6606647583570877,5989,3508,9497,-
chr17,78971873,0.980733700731347,3774,2616,6390,-
chr17,78971888,1.5113958703707495,3372,2465,5837,-
chr17,78972054,1.4948708206686931,1547,1127,2674,-
chr17,78972120,1.7171665384944033,1569,1244,2813,-
chr17,78972122,1.554160125588697,1583,979,2562,-
chr17,78972143,2.180496493288776,2507,1717,4224,-
chr17,78972212,1.1023871727001517,4225,3378,7603,-
chr17,78972254,1.5312791783380018,1759,1385,3144,-
chr17,78972299,1.4013468968905478,2616,1879,4495,-
chr17,78972300,1.4985857950974233,934,739,1673,-
chr17,78972302,1.687489643744822,1215,709,1924,-
chr17,78972303,1.743310442813166,1226,823,2049,-
chr17,78972432,1.376228079171367,1265,994,2259,-
chr17,78972477,1.6579666753449622,1212,667,1879,-
chr17,78972560,0.5894152703403006,1010,826,1836,-
chr17,78972575,2.1216029479502536,979,834,1813,-
chr17,78972608,1.413297784391534,1120,863,1983,-
chr17,78972701,1.5742758267110997,1444,995,2439,-
chr17,78972702,0.7101936153983479,1093,892,1985,-
chr17,78973027,2.0336364367908586,1295,730,2025,-
chr17,78973038,0.967920654405614,1649,1260,2909,-
chr17,78973039,0.967920654405614,1649,1260,2909,-
chr17,78973158,0.7811616523451409,1685,906,2591,-
chr17,78973164,1.8936627282491942,1352,1077,2429,-
chr17,78973197,1.5880181714934696,798,586,1384,-
chr17,78973213,1.5687955791459725,1890,1338,3228,-
chr17,78973216,1.5692156862745097,1056,713,1769,-
chr17,78974767,2.1714372902044548,756,564,1320,-
chr17,78974780,1.8157720344599075,684,502,1186,-
chr17,78974788,1.8274155679971105,991,790,1781,-
chr17,78976006,2.243791390728477,694,603,1297,-
chr17,78976089,1.2810451438932542,1197,941,2138,-
chr17,78976092,1.9400466266377332,3207,2251,5458,-
chr17,78976095,1.3777073182104305,937,726,1663,-
chr17,78976096,1.7889957264957264,984,719,1703,-
chr17,78976114,0.5546984572230015,564,459,1023,-
chr17,78976152,1.7506686478454678,821,672,1493,-
chr17,78977190,1.3505221686273576,2440,1718,4158,-
chr17,78979916,1.6496183450441404,1643,1117,2760,-
chr17,78979922,1.7277365491651206,744,659,1403,-
chr17,78979932,2.032235182849937,572,487,1059,-
chr17,78979942,1.5354490032925234,1244,891,2135,-
chr17,78979943,1.5160947074192712,1467,1060,2527,-
chr17,78993576,1.1267031914883232,806,491,1297,-
chr17,78993635,1.5398950468648578,1021,689,1710,-
chr17,78993649,0.9442816193758252,1010,508,1518,-
chr17,78993650,0.9442816193758252,1010,508,1518,-
chr17,78997098,1.8535596114846835,913,693,1606,-
chr17,78997103,2.5187617260788,1610,1147,2757,-
chr17,78997104,2.5187617260788,1610,1147,2757,-
chr17,78997107,2.1516120777891503,1505,976,2481,-
chr17,78997108,2.1516120777891503,1505,976,2481,-
chr17,78997113,1.150648470770422,1208,737,1945,-
chr17,78997114,1.150648470770422,1208,737,1945,-
chr17,78997137,2.804685753964227,1212,638,1850,-
chr17,79833570,1.648898377044309,977,708,1685,-
chr17,79833652,1.2677190789194857,624,489,1113,-
chr17,79834895,3.9440593735696066,902,590,1492,-
chr17,79837854,2.284327821710999,619,427,1046,-
chr17,79837898,1.4749512782299667,918,428,1346,-
chr17,79837899,1.6685840283769533,1179,548,1727,-
chr17,79837900,1.6685840283769533,1179,548,1727,-
chr17,79837901,1.4154554672976172,858,387,1245,-
chr17,80135379,1.7906911142454158,827,708,1535,-
chr17,80135418,0.5895303326810175,963,875,1838,-
chr17,80135424,1.6646161732666922,837,577,1414,-
chr17,80136077,2.6751215387867253,790,497,1287,-
chr17,80136087,1.8785939964467064,1348,954,2302,-
chr17,80136244,0.3103231484974223,616,481,1097,-
chr17,80136293,0.5042719282070195,585,492,1077,-
chr17,80136321,2.7094017094017087,633,395,1028,-
chr17,80138179,1.999281178866659,595,490,1085,-
chr17,80139060,1.8099547511312217,724,492,1216,-
chr17,80139069,3.33107822410148,605,472,1077,-
chr17,80141355,0.5157330159083692,1591,1161,2752,-
chr17,80141832,1.8733031674208145,689,441,1130,-
chr17,80144236,1.826750475391273,2991,3410,6401,-
chr17,80144237,1.8504259729826087,5079,5101,10180,-
chr17,80144238,1.8426004878839275,4616,4686,9302,-
chr17,80146800,1.4941563329397916,2877,2336,5213,-
chr17,80146803,1.643760307861462,804,748,1552,-
chr17,80146804,1.6847236475590088,977,717,1694,-
chr17,80146807,0.6074732229795521,712,631,1343,-
chr17,80146814,0.471830985915493,803,567,1370,-
chr17,80146888,0.4295652173913044,873,574,1447,-
chr17,80146889,0.4295652173913044,873,574,1447,-
chr17,80146918,0.9232774968394436,614,451,1065,-
chr17,80146919,0.9232774968394436,614,451,1065,-
chr17,80146945,2.854951451865,680,486,1166,-
chr17,80467007,1.645455486745626,979,686,1665,-
chr17,80467341,1.8409300184162063,726,542,1268,-
chr17,80467478,0.4985002762648985,742,617,1359,-
chr17,80467513,0.4155361748152813,725,683,1408,-
chr17,80467563,4.082614963744566,773,714,1487,-
chr17,80467572,3.6032611815485893,1173,891,2064,-
chr17,80467579,7.570917822561184,1199,786,1985,-
chr17,80467911,0.9085382702403979,1095,845,1940,-
chr17,80467912,1.2480078846588978,1392,1120,2512,-
chr17,80468093,0.6228767795778106,975,678,1653,-
chr17,80468099,1.8775035319537936,705,572,1277,-
chr17,80468625,2.598825831702544,580,510,1090,-
chr17,80468650,1.6685912240184757,577,432,1009,-
chr17,80468733,1.916335031738857,813,550,1363,-
chr17,80468936,2.5641257206614982,622,462,1084,-
chr17,80469100,4.761502913401647,696,552,1248,-
chr17,80469102,4.761502913401647,696,552,1248,-
chr17,80469300,2.2812762346629456,873,509,1382,-
chr17,80469633,0.7660150831592839,571,477,1048,-
chr17,80470407,1.5318833438532717,775,510,1285,-
chr17,80470716,5.933368856127645,604,443,1047,-
chr17,80470861,1.576370170709794,695,635,1330,-
chr17,80470897,1.7613229416466827,785,466,1251,-
chr17,80470937,2.2910857625686516,637,525,1162,-
chr17,80470939,2.2910857625686516,637,525,1162,-
chr17,80476027,2.1827907944433775,688,498,1186,-
chr17,80476034,0.5843023255813953,602,515,1117,-
chr17,80476035,0.5843023255813953,602,515,1117,-
chr17,80476036,0.5843023255813953,602,515,1117,-
chr17,80824524,1.909090909090909,869,549,1418,-
chr17,80824841,2.900075585789872,1198,979,2177,-
chr17,80824842,2.4940991345397325,1584,1270,2854,-
chr17,80824843,2.5510354727255233,1718,1381,3099,-
chr17,80824844,2.4511180124223597,1177,919,2096,-
chr17,81510169,1.3097914280259642,7081,4655,11736,-
chr17,81510237,1.4420954339432603,7084,5105,12189,-
chr17,81510326,0.7035408029187011,59264,42480,101744,-
chr17,81510327,0.7120811083324114,36051,26802,62853,-
chr17,81510328,0.7229030427069212,37345,28018,65363,-
chr17,81510334,1.0009285800788772,10584,8354,18938,-
chr17,81510467,1.36383144326539,20271,14555,34826,-
chr17,81510622,0.9153604528668003,18766,14330,33096,-
chr17,81510623,0.9290050152366937,19905,14329,34234,-
chr17,81510700,0.8000653308553891,4516,3323,7839,-
chr17,81510735,1.6359572883039482,4879,4026,8905,-
chr17,81510750,0.7882939737429461,2862,2182,5044,-
chr17,81510756,1.2098754395375173,3690,2855,6545,-
chr17,81510833,0.5112915063932373,890,639,1529,-
chr17,81510963,2.130086680344571,23792,19341,43133,-
chr17,81510976,1.90887086185341,13374,11180,24554,-
chr17,81510996,1.251903593794063,18625,12922,31547,-
chr17,81511032,1.73866870804414,18434,14175,32609,-
chr17,81511063,1.3576002757469658,4988,3600,8588,-
chr17,81511103,0.9518488473381326,6435,4944,11379,-
chr17,81511348,1.293772670866743,5860,3491,9351,-
chr17,81511357,1.264481078050239,7275,5677,12952,-
chr17,81511370,1.2162403331350389,5545,3361,8906,-
chr17,81511492,1.4118855465884084,3395,2609,6004,-
chr17,81511622,1.290300585234848,6555,4937,11492,-
chr17,81511625,1.274534161490683,3647,2239,5886,-
chr17,81511936,1.4183463604126536,6192,3971,10163,-
chr17,81512008,0.7674968431799253,2596,1958,4554,-
chr17,81512062,0.7735585512424883,2267,1879,4146,-
chr17,81512110,1.617644579875519,4056,2409,6465,-
chr17,81512116,1.30313804191959,6609,5260,11869,-
chr17,81512119,1.3591535570894786,9690,6769,16459,-
chr17,81512343,0.8344853387957408,4624,2865,7489,-
chr17,81512348,1.3350788826442856,8396,5780,14176,-
chr17,81512349,1.255868794326241,3302,2699,6001,-
chr17,81512780,1.3853218465539665,2434,1537,3971,-
chr17,81512782,0.7772882244951481,2116,1859,3975,-
chr17,81512784,0.6444218608852754,877,737,1614,-
chr17,81512795,0.5917008366202001,1589,1453,3042,-
chr17,81512798,0.7841208772603374,3983,3739,7722,-
chr17,81512799,0.8607539450613675,684,579,1263,-
chr17,81512800,0.8195233871754797,6281,5456,11737,-
chr17,81512801,0.8999390801096558,1614,1138,2752,-
chr17,81559154,2.318386424883765,664,339,1003,-
chr17,81567468,1.1807707169303439,537,464,1001,-
chr17,81597300,1.7288760622093955,1840,1763,3603,-
chr17,81597301,1.7288760622093955,1840,1763,3603,-
chr17,81597305,1.882973694738308,1655,1381,3036,-
chr17,81600356,2.9857126528746143,705,672,1377,-
chr17,81600366,1.6595744680851066,1403,986,2389,-
chr17,81600368,1.6595744680851066,1403,986,2389,-
chr17,81600388,2.218891588910335,1302,1028,2330,-
chr17,81600397,2.7678571428571432,809,566,1375,-
chr17,81600399,2.7678571428571432,809,566,1375,-
chr17,81629757,0.7646847009735741,1013,654,1667,-
chr17,81843243,1.3835168512482823,10370,7029,17399,-
chr17,81843244,1.3717062782987293,8771,5748,14519,-
chr17,81843245,1.3717062782987293,8771,5748,14519,-
chr17,81843298,1.2365686101814342,2591,1621,4212,-
chr17,81843326,1.3746610945136166,1872,1465,3337,-
chr17,81843387,1.5914434311769736,1786,967,2753,-
chr17,81843484,1.250338894509578,2908,1866,4774,-
chr17,81843510,2.4678930926761544,1349,1004,2353,-
chr17,81843761,2.106392251815981,2147,1474,3621,-
chr17,81843831,1.3316751529042032,2577,1968,4545,-
chr17,81843921,1.9183983993111728,2559,1906,4465,-
chr17,81843964,2.0184576023391814,1174,854,2028,-
chr17,81844074,1.5205490780023008,5229,4280,9509,-
chr17,81844075,1.6075663466967816,2846,2736,5582,-
chr17,81844086,1.2811232907800716,3557,2524,6081,-
chr17,81845222,1.7253898205354519,1490,1132,2622,-
chr17,81845649,1.3523120935911632,3312,2183,5495,-
chr17,81845950,1.6582733496805266,2119,1648,3767,-
chr17,81845981,0.7201220660814527,3884,3174,7058,-
chr17,81845982,0.9259456738116907,6103,4490,10593,-
chr17,81846552,1.3616712516054685,9626,7862,17488,-
chr17,81846554,1.3692701752576433,6329,5021,11350,-
chr17,81846561,1.8414828065990856,2646,2063,4709,-
chr17,81846615,1.4137951874442132,4538,3360,7898,-
chr17,81846974,1.3256222997673521,11044,8727,19771,-
chr17,81846976,1.3309704121169426,6363,5677,12040,-
chr17,81846977,1.5228215059634511,2788,2275,5063,-
chr17,81847288,1.2559896507115136,3551,2318,5869,-
chr17,81855182,0.7877451289267886,2445,2025,4470,-
chr17,81855251,1.5411860276198217,1580,1230,2810,-
chr17,81855252,1.3873814155110542,4477,3151,7628,-
chr17,81855257,1.3453800492104255,3308,2360,5668,-
chr17,81859216,1.5287134345339677,1570,1236,2806,-
chr17,81859225,1.6801933006752279,1492,1161,2653,-
chr17,81859305,1.476686227375566,2694,1663,4357,-
chr17,81859347,1.4137349279060716,6969,4695,11664,-
chr17,81859348,1.4173124634991905,4172,2488,6660,-
chr17,81859386,1.2969028377588692,1033,770,1803,-
chr17,81860347,0.7527272727272728,1793,1299,3092,-
chr17,81860378,1.696070297179062,3155,1893,5048,-
chr17,81860380,1.713790940563803,4059,2642,6701,-
chr17,81860400,0.4473962463653185,676,581,1257,-
chr17,81860403,1.7534694866977758,628,568,1196,-
chr17,81860406,2.600979052823316,736,548,1284,-
chr17,81860409,2.0770676691729317,1104,645,1749,-
chr17,81860473,2.7041284403669725,654,544,1198,-
chr17,81860485,1.361588330632091,1083,616,1699,-
chr17,81860502,0.45423897139125646,2985,2226,5211,-
chr17,81860503,0.45423897139125646,2985,2226,5211,-
chr17,81860516,1.24843151083016,693,654,1347,-
chr17,81860518,1.2495887762155296,780,550,1330,-
chr17,81860534,1.3120822201714042,1006,696,1702,-
chr17,81868149,1.0551703346397348,624,534,1158,-
chr17,81868151,0.9082680110311718,914,773,1687,-
chr17,81868379,2.6648175080728387,707,471,1178,-
chr17,81868461,4.339638002684077,667,454,1121,-
chr17,81869558,3.118089893432686,571,433,1004,-
chr17,81869835,2.7542302800078513,1017,757,1774,-
chr17,81871319,4.41794972840359,683,555,1238,-
chr17,81887951,1.9178336056980434,1169,789,1958,-
chr17,81887954,0.4767683772538141,624,411,1035,-
chr17,81888102,2.3206153846153845,837,649,1486,-
chr17,81888134,1.1434869295525032,1453,1219,2672,-
chr17,81888135,1.1434869295525032,1453,1219,2672,-
chr17,81888252,1.8263640803922359,1669,1134,2803,-
chr17,81888289,0.52,550,474,1024,-
chr17,81888295,0.5736714975845411,524,482,1006,-
chr17,81888296,1.598260983263598,842,477,1319,-
chr17,81888323,1.9021621621621625,1172,628,1800,-
chr17,81888324,1.9350564427312773,1729,907,2636,-
chr17,81888326,1.717808219178082,1139,583,1722,-
chr17,81888549,0.5554846938775511,870,685,1555,-
chr17,81888570,1.68228934186381,1059,610,1669,-
chr17,81889204,1.6532380662815445,724,505,1229,-
chr17,81889254,1.6487936856296344,2764,2143,4907,-
chr17,81889285,2.2174068447859887,708,588,1296,-
chr17,81889300,1.6025400490691295,693,532,1225,-
chr17,81890718,0.6922535211267605,982,679,1661,-
chr17,81890737,1.182652013824147,1630,1310,2940,-
chr17,81890738,1.4163246611017375,3403,2472,5875,-
chr17,81890740,1.6503953878465811,1773,1162,2935,-
chr17,81890784,0.6502306171754887,572,470,1042,-
chr17,81890801,0.5169642857142857,578,447,1025,-
chr17,81890812,1.6933604459045966,1061,734,1795,-
chr17,81890814,1.8890415664720024,610,425,1035,-
chr17,81890815,1.8890415664720024,610,425,1035,-
chr17,81891346,1.4353626234435108,657,545,1202,-
chr17,81919103,1.598831641447998,944,680,1624,-
chr17,81919113,3.921161825726141,674,481,1155,-
chr17,81919147,2.745103686635945,705,495,1200,-
chr17,81919149,2.745103686635945,705,495,1200,-
chr17,81932478,18.013729977116707,655,436,1091,-
chr17,81932481,4.493923247082424,1970,1413,3383,-
chr17,81932494,5.815263519924276,2409,1605,4014,-
chr17,81932572,2.619704269812261,583,462,1045,-
chr17,81932577,0.6892327530625403,1068,704,1772,-
chr17,81932701,2.6677872860635694,601,408,1009,-
chr17,81933011,0.42959295929592956,780,605,1385,-
chr17,81933012,0.42959295929592956,780,605,1385,-
chr17,81933059,1.8442527995881064,596,456,1052,-
chr17,81933214,2.903835464146748,652,513,1165,-
chr17,81933216,2.903835464146748,652,513,1165,-
chr17,81933217,0.9888665325285044,775,496,1271,-
chr17,81933219,0.9888665325285044,775,496,1271,-
chr17,81934974,2.4230769230769234,979,727,1706,-
chr17,81934976,2.4230769230769234,979,727,1706,-
chr17,81935019,3.7712418300653603,576,458,1034,-
chr17,81935020,1.754400717569234,1137,990,2127,-
chr17,81935022,1.7517487642848388,2073,1661,3734,-
chr17,81935098,1.967282570318936,795,585,1380,-
chr17,81935100,1.967282570318936,795,585,1380,-
chr17,81935412,3.0763387745902957,1185,940,2125,-
chr17,81935488,0.4145389867462275,849,600,1449,-
chr17,81935502,1.8952380952380952,795,629,1424,-
chr17,81936137,1.5716319267920689,753,561,1314,-
chr17,81936174,0.6223121218747721,682,537,1219,-
chr17,81936776,0.9907929907929908,555,480,1035,-
chr17,81936777,1.5721009262797692,944,767,1711,-
chr17,81936825,3.3024967856030116,1632,1279,2911,-
chr17,81936826,3.3024967856030116,1632,1279,2911,-
chr17,82018782,1.7703703703703701,716,485,1201,-
chr17,82018902,2.1442583753394406,677,535,1212,-
chr17,82018969,3.0877270064440543,726,568,1294,-
chr17,82018970,4.405166204822449,1512,1251,2763,-
chr17,82018980,2.859806114839672,766,446,1212,-
chr17,82018982,5.84940771591766,1092,685,1777,-
chr17,82019141,3.1135386045761027,1278,891,2169,-
chr17,82019356,1.1042230521235297,590,424,1014,-
chr17,82036293,2.9237936309275483,840,422,1262,-
chr17,82036294,2.9237936309275483,840,422,1262,-
chr17,82036560,0.83125,622,444,1066,-
chr17,82036562,1.1229636882552076,829,586,1415,-
chr17,82037001,2.5408042645869053,731,608,1339,-
chr17,82037003,2.5408042645869053,731,608,1339,-
chr17,82064142,2.309416227309157,610,564,1174,-
chr17,82078485,1.7647617239415228,714,457,1171,-
chr17,82078497,1.5781038929141595,658,478,1136,-
chr17,82079441,2.2528198014609218,1061,818,1879,-
chr17,82079459,1.955232721876924,1446,1043,2489,-
chr17,82079480,1.8417266187050356,703,416,1119,-
chr17,82079487,2.8205524291321913,571,495,1066,-
chr17,82080471,1.1088314005352364,903,471,1374,-
chr17,82080472,1.1088314005352364,903,471,1374,-
chr17,82081699,1.1045214327657076,1025,523,1548,-
chr17,82081701,1.1045214327657076,1025,523,1548,-
chr17,82082356,3.0010509557589216,551,511,1062,-
chr17,82082378,0.5809030347890451,653,385,1038,-
chr17,82083546,0.44822290478279947,680,423,1103,-
chr17,82083635,2.6427503736920777,727,445,1172,-
chr17,82083637,3.0961238449537984,1074,640,1714,-
chr17,82083638,3.7425742574257437,701,403,1104,-
chr17,82083883,1.81399425748392,753,481,1234,-
chr17,82084889,6.521266073194855,693,336,1029,-
chr17,82084890,6.521266073194855,693,336,1029,-
chr17,82085269,2.1396238865061035,1045,432,1477,-
chr17,82085270,2.1396238865061035,1045,432,1477,-
chr17,82085349,0.4195299705843546,655,405,1060,-
chr17,82085846,1.5276260937533925,1339,740,2079,-
chr17,82085847,1.335472892285646,1208,631,1839,-
chr17,82085848,1.335472892285646,1208,631,1839,-
chr17,82087985,3.4742377299594867,621,429,1050,-
chr17,82089651,3.0646258503401365,953,503,1456,-
chr17,82089653,2.7334620843967135,1070,601,1671,-
chr17,82090522,3.1091506443481323,621,397,1018,-
chr17,82090940,1.5146470305940904,649,493,1142,-
chr17,82091009,1.9153879888047933,669,451,1120,-
chr17,82092920,0.7022223015462231,765,538,1303,-
chr17,82092922,1.1710864391586495,733,495,1228,-
chr17,82093738,1.559058434121993,671,513,1184,-
chr17,82251524,0.4140191349577043,579,466,1045,-
chr17,82255537,6.850320277552337,1351,1233,2584,-
chr17,82255538,8.684913261070545,2213,1826,4039,-
chr17,82255539,8.684913261070545,2213,1826,4039,-
chr17,82255540,11.2746275042106,1750,1322,3072,-
chr17,82615001,10.87650916355846,1448,1551,2999,-
chr17,82615002,9.296668070941019,1264,1300,2564,-
chr17,82615003,5.320074005550416,638,563,1201,-
chr17,82615170,5.471897753035764,920,857,1777,-
chr17,82615171,5.369141712046617,1221,1251,2472,-
chr17,82615172,5.479498356314079,1133,1125,2258,-
chr17,82615559,0.7777692300879832,643,588,1231,-
chr17,82619087,2.181959011777599,792,499,1291,-
chr17,82657240,1.3770974252651254,586,473,1059,-
chr18,224965,1.1445966514459665,1127,539,1666,-
chr18,224967,1.1445966514459665,1127,539,1666,-
chr18,1362730,0.8419301359220532,749,616,1365,-
chr18,1362731,1.5738879808411914,878,747,1625,-
chr18,2946427,1.6498310363424962,873,624,1497,-
chr18,6462190,1.5947256797662657,6750,4186,10936,-
chr18,6462303,1.2411729064712311,14129,9763,23892,-
chr18,6462304,0.6227503165206074,7078,5463,12541,-
chr18,6462312,1.1799283749169909,3901,2987,6888,-
chr18,6462315,1.6391633153754708,5355,3437,8792,-
chr18,6462318,1.2583757008443537,13854,9342,23196,-
chr18,6462319,1.2357790018360872,9619,5990,15609,-
chr18,6462323,1.4278761531508786,3901,2365,6266,-
chr18,6462330,1.5682355620031079,4409,3363,7772,-
chr18,6462333,0.7265242831564248,2422,1897,4319,-
chr18,6462334,0.6095031845077663,4205,2665,6870,-
chr18,6462341,1.6008861622358557,1385,977,2362,-
chr18,6462352,1.5726137054162206,8358,5651,14009,-
chr18,6462354,1.6195238100335354,12208,8140,20348,-
chr18,6462355,1.7008156528019778,10243,6425,16668,-
chr18,6462357,1.8657872300505431,5852,3218,9070,-
chr18,6462358,1.9530291120212928,1939,1150,3089,-
chr18,6462374,2.423968323161872,1258,887,2145,-
chr18,6462384,0.6229027529922612,1761,1179,2940,-
chr18,6462393,2.7166865445082937,927,400,1327,-
chr18,6462411,1.0579986149584486,1745,721,2466,-
chr18,6462412,0.8045054298880875,6284,3801,10085,-
chr18,6462413,0.44853173587802353,1489,840,2329,-
chr18,6462414,1.1137152551220149,1777,1454,3231,-
chr18,6462416,0.048942031533907734,834,362,1196,-
chr18,6462502,1.4090283192594188,3746,2288,6034,-
chr18,6462532,1.295509915849835,5072,2666,7738,-
chr18,6462561,1.645388886569532,2003,1408,3411,-
chr18,6462566,0.6105224698575082,1670,1126,2796,-
chr18,6462567,1.7331569664902997,1267,566,1833,-
chr18,6462568,1.7514258555133078,1004,525,1529,-
chr18,6462583,1.2838802895856458,1693,824,2517,-
chr18,6462595,0.181924882629108,929,638,1567,-
chr18,6462598,1.7711891717692554,686,320,1006,-
chr18,6462641,0.9517689988894179,856,572,1428,-
chr18,6462642,1.0977207328051264,1383,831,2214,-
chr18,6463015,1.28305410168065,1514,964,2478,-
chr18,6463018,1.4335748792270533,1186,827,2013,-
chr18,6463029,0.9841516724235969,2298,1928,4226,-
chr18,9563031,5.75125316059512,869,533,1402,-
chr18,12344153,2.859157380080039,608,437,1045,-
chr18,12353114,2.725125191194069,603,634,1237,-
chr18,12353118,1.1520881531426546,795,765,1560,-
chr18,12353120,1.2189739468220482,817,710,1527,-
chr18,12353121,2.9373116206957253,989,882,1871,-
chr18,12358817,1.2464428214653185,629,503,1132,-
chr18,12366995,1.6315789473684212,1499,1139,2638,-
chr18,12367006,2.233951325563138,1155,1141,2296,-
chr18,12367009,1.5993869527553808,1090,1046,2136,-
chr18,12367010,0.6219676549865228,1845,1483,3328,-
chr18,12367023,1.4455128205128205,819,719,1538,-
chr18,12367061,1.9051895567387256,1187,916,2103,-
chr18,12367071,2.5846560846560847,976,719,1695,-
chr18,12367109,2.8738818267419965,1038,707,1745,-
chr18,12367111,3.057361739846149,1532,1018,2550,-
chr18,12367112,3.5627530364372464,999,649,1648,-
chr18,12367306,1.288545405157831,1055,650,1705,-
chr18,12367326,8.23551016676167,1361,698,2059,-
chr18,12367328,6.407094246236338,862,372,1234,-
chr18,21006723,1.7315696132074219,1043,604,1647,-
chr18,21006743,0.6515297754824291,860,407,1267,-
chr18,21006744,1.266952568879924,910,462,1372,-
chr18,21573867,2.998718477069968,857,667,1524,-
chr18,23532053,1.95783434209612,3084,2327,5411,-
chr18,23532054,1.9416367670228316,3702,2792,6494,-
chr18,23532056,2.3152414293260755,2172,1666,3838,-
chr18,23532064,1.7221340107970784,985,669,1654,-
chr18,23532071,2.417142482282124,1513,929,2442,-
chr18,23532079,2.710969718392836,718,413,1131,-
chr18,23532096,1.4366680663034623,866,482,1348,-
chr18,26170816,1.366881051907717,806,565,1371,-
chr18,26170834,2.9814254859611227,713,462,1175,-
chr18,26170836,2.9814254859611227,713,462,1175,-
chr18,26171157,2.1295575721086166,642,538,1180,-
chr18,26171230,2.452830188679245,636,370,1006,-
chr18,32412787,1.518211459634272,3406,2035,5441,-
chr18,32412789,1.6545412948981928,1807,986,2793,-
chr18,32412803,1.5026399522079303,1626,893,2519,-
chr18,32412806,0.8055089708544195,1240,590,1830,-
chr18,32412807,0.8110806431759968,1197,647,1844,-
chr18,32412812,0.4985580168129104,1249,757,2006,-
chr18,32412814,0.4985580168129104,1249,757,2006,-
chr18,32413050,2.133290867107254,787,660,1447,-
chr18,32413061,1.088245817110386,833,558,1391,-
chr18,32413062,1.088245817110386,833,558,1391,-
chr18,32413064,1.8377483340356133,633,533,1166,-
chr18,32413070,2.035023041474654,735,464,1199,-
chr18,35990121,1.0671243082869062,1189,748,1937,-
chr18,35992322,3.622641509433962,575,476,1051,-
chr18,35992324,3.622641509433962,575,476,1051,-
chr18,36026956,1.7063839090511594,2675,2286,4961,-
chr18,36026975,1.2741082245976691,4041,3057,7098,-
chr18,36026976,1.3039031552980807,6207,4818,11025,-
chr18,36026979,1.3792400699085183,6831,5265,12096,-
chr18,36026980,1.4571853332195996,3105,2395,5500,-
chr18,36026983,1.5803981375697869,2792,2016,4808,-
chr18,36026984,1.5067448264434795,4215,3023,7238,-
chr18,36026986,0.5863730723606169,718,561,1279,-
chr18,36026987,1.4233490566037734,1277,863,2140,-
chr18,36026990,2.062574257425742,650,504,1154,-
chr18,36026992,1.6414003708147018,1074,691,1765,-
chr18,36027003,1.505794508827876,967,597,1564,-
chr18,36027010,1.5454501800720288,893,594,1487,-
chr18,36027015,0.5806749884419787,784,514,1298,-
chr18,36027016,1.758237395791981,926,686,1612,-
chr18,36027027,1.2447933548920158,1479,1006,2485,-
chr18,36027058,1.1470588235294117,896,505,1401,-
chr18,36027060,1.4094104921579234,1302,730,2032,-
chr18,36027062,0.9542899962532783,848,470,1318,-
chr18,36027069,1.0655051921846546,865,520,1385,-
chr18,36027070,2.0688741721854305,709,452,1161,-
chr18,36027071,1.523050905374325,1574,972,2546,-
chr18,36031012,1.3899600062211996,750,562,1312,-
chr18,36109002,2.3449385052034057,1376,905,2281,-
chr18,36109012,1.945068664169788,1291,800,2091,-
chr18,36109063,1.6385886402753869,1106,829,1935,-
chr18,36109205,1.7883705206220422,1149,869,2018,-
chr18,36109406,1.5968957871396896,1107,819,1926,-
chr18,36109583,4.514326647564469,958,697,1655,-
chr18,36111196,1.4978924126856683,1193,847,2040,-
chr18,36114119,2.274403470715835,698,460,1158,-
chr18,36114175,0.5335263777033753,736,513,1249,-
chr18,36114177,0.5133333333333333,692,524,1216,-
chr18,36114277,0.7286273048984914,977,766,1743,-
chr18,36114330,3.439516129032259,852,743,1595,-
chr18,36116739,1.619459905174191,981,881,1862,-
chr18,36122234,0.7128058188230108,1385,1046,2431,-
chr18,36122235,0.6331752767201033,1878,1226,3104,-
chr18,36122261,1.6469002695417791,610,529,1139,-
chr18,36123587,1.8289446825882831,767,638,1405,-
chr18,36123600,1.4357976653696498,1106,770,1876,-
chr18,36123606,1.4846050870147258,1108,746,1854,-
chr18,36123640,1.8769819916742254,1550,1162,2712,-
chr18,36126232,1.772982158028887,845,534,1379,-
chr18,36126253,2.2549019607843137,714,428,1142,-
chr18,36126287,0.4190556492411467,780,592,1372,-
chr18,36126293,1.5908412145345945,751,573,1324,-
chr18,36126328,1.8023195876288658,665,387,1052,-
chr18,36126481,2.629139891250618,850,475,1325,-
chr18,36126485,2.362594268476621,711,584,1295,-
chr18,36126592,0.6292486583184257,937,687,1624,-
chr18,36126612,0.6002935420743639,817,583,1400,-
chr18,36126629,1.2368534733222942,1398,1015,2413,-
chr18,36126836,1.4336065573770491,1112,731,1843,-
chr18,36126846,0.6745091372715682,1166,904,2070,-
chr18,36126893,1.7486235048414656,613,457,1070,-
chr18,36126941,0.559145129224652,524,502,1026,-
chr18,36126992,2.6769230769230767,611,441,1052,-
chr18,36126994,2.6769230769230767,611,441,1052,-
chr18,36129250,0.3874322390644444,782,572,1354,-
chr18,36180076,1.7575348488480111,1215,960,2175,-
chr18,36180085,1.9367747098839532,604,440,1044,-
chr18,36180132,2.151707014276847,618,536,1154,-
chr18,36180141,2.239247311827957,594,495,1089,-
chr18,36180265,2.9141891891891887,680,591,1271,-
chr18,36180336,1.5579875360997113,999,730,1729,-
chr18,36180349,1.8274111675126905,629,393,1022,-
chr18,36180388,0.5045962732919255,676,459,1135,-
chr18,36797033,2.4439241079344964,837,579,1416,-
chr18,36797037,2.7835626150311383,728,452,1180,-
chr18,36798489,3.027681471225193,696,449,1145,-
chr18,36800284,0.4204632294928168,772,574,1346,-
chr18,36818938,1.4082105901245334,706,506,1212,-
chr18,39335124,1.2958520908591291,1176,949,2125,-
chr18,39335125,1.4948722040500682,1586,1169,2755,-
chr18,39335126,1.9708787644433636,1828,1000,2828,-
chr18,39335127,2.0064581766709426,1119,610,1729,-
chr18,39335131,2.0272756287490314,787,426,1213,-
chr18,39335682,0.6887890765361121,660,604,1264,-
chr18,39335683,0.9702983496186844,547,502,1049,-
chr18,46084261,1.7158958619959783,1200,858,2058,-
chr18,46084617,1.6013636363636363,2167,1374,3541,-
chr18,46084632,1.4953310371220816,952,669,1621,-
chr18,46084637,1.7606210445889257,1672,976,2648,-
chr18,46084641,2.3954162514720534,852,580,1432,-
chr18,46086165,1.2933890249171829,1795,1178,2973,-
chr18,46086468,1.5169792694965447,1396,1012,2408,-
chr18,46087072,1.6952660482072244,2466,1886,4352,-
chr18,46087074,1.6952660482072244,2466,1886,4352,-
chr18,46087119,2.122649755285698,2938,1916,4854,-
chr18,46087351,1.348248490077653,1816,1524,3340,-
chr18,46087359,1.435069774424626,3523,2518,6041,-
chr18,46087434,1.3478758169934641,1920,1155,3075,-
chr18,46089670,0.7211506054787006,1642,1342,2984,-
chr18,46089702,1.4958534233365481,1938,1219,3157,-
chr18,46089967,1.6208361278783814,2174,1889,4063,-
chr18,46089974,1.3745134374094166,1966,1557,3523,-
chr18,46089978,0.6639192803306588,1742,1370,3112,-
chr18,46089983,1.3471712378271454,4842,3285,8127,-
chr18,46089985,1.3202507816289628,8639,6161,14800,-
chr18,46091816,1.6798846431146357,1164,948,2112,-
chr18,46095103,1.3283257256216177,931,640,1571,-
chr18,46095122,0.4563937599125456,1958,1497,3455,-
chr18,46095123,0.4563937599125456,1958,1497,3455,-
chr18,46095124,1.8603023070803502,631,418,1049,-
chr18,46098233,1.5656884545019358,1376,1023,2399,-
chr18,46098284,2.5567466664994267,1279,862,2141,-
chr18,47155470,6.093959731543625,680,595,1275,-
chr18,47155472,6.093959731543625,680,595,1275,-
chr18,47155598,1.2711959301268758,693,457,1150,-
chr18,47156210,0.6720534069981584,1326,904,2230,-
chr18,47156229,0.588038533583088,1171,807,1978,-
chr18,47157450,1.5125062304590149,2243,1521,3764,-
chr18,47157451,1.5125062304590149,2243,1521,3764,-
chr18,47157455,2.0566129032258065,932,599,1531,-
chr18,47157463,1.5886107020127642,808,581,1389,-
chr18,47157484,0.5776629745781913,1484,984,2468,-
chr18,47176311,2.022527306434596,628,405,1033,-
chr18,47841732,1.9277064220183489,617,435,1052,-
chr18,47841938,1.1408053485503977,879,599,1478,-
chr18,47845765,1.2005961043951119,769,660,1429,-
chr18,47869381,2.0959000395306466,1088,855,1943,-
chr18,47870530,2.638463801677992,972,618,1590,-
chr18,47896607,1.8675402364335565,595,412,1007,-
chr18,49481947,7.031530993114271,627,433,1060,-
chr18,49482195,1.2575170377580902,705,440,1145,-
chr18,49482312,0.631525935873762,791,517,1308,-
chr18,49490846,1.5154307964496951,5848,3650,9498,-
chr18,49490847,0.7192127871453408,3328,2609,5937,-
chr18,49490848,1.5279122933536446,9049,5322,14371,-
chr18,49490853,1.37569293055123,5408,2703,8111,-
chr18,49490854,1.376413165991446,7708,4081,11789,-
chr18,49490859,1.6493859148718364,4129,2663,6792,-
chr18,49490861,1.39458466731194,1755,998,2753,-
chr18,49490862,1.3858132497478264,1932,862,2794,-
chr18,49490864,1.6488875342883265,1622,1350,2972,-
chr18,49490865,1.4193010537548352,1636,713,2349,-
chr18,49490882,0.7387189482757531,2162,1450,3612,-
chr18,49490883,1.774137931034483,1091,927,2018,-
chr18,49490888,1.6220157874470544,716,423,1139,-
chr18,49490889,1.4493292682926828,833,655,1488,-
chr18,49490890,0.5980004650081376,642,505,1147,-
chr18,49490896,1.7340927576043117,1128,674,1802,-
chr18,49490917,2.5219713563678368,639,410,1049,-
chr18,49490919,2.254554655870445,593,455,1048,-
chr18,49491344,0.924703046238071,6685,9379,16064,-
chr18,49491345,0.924703046238071,6685,9379,16064,-
chr18,49491346,0.9820069917578446,5150,7202,12352,-
chr18,49491582,1.3245729406442026,5204,4007,9211,-
chr18,49491584,0.6525647171620327,1209,1191,2400,-
chr18,49491585,0.9555136747363661,1892,1752,3644,-
chr18,49491726,1.3234503306445753,1883,1528,3411,-
chr18,49491728,1.2394363188402675,9243,7806,17049,-
chr18,49491729,1.2249724486275342,8269,7007,15276,-
chr18,49491768,0.5056179775280899,734,622,1356,-
chr18,49491770,0.6684652123402607,958,634,1592,-
chr18,49491801,2.4222972972972974,716,480,1196,-
chr18,49491802,1.6365628209517291,702,634,1336,-
chr18,49491824,1.6927807348457449,536,522,1058,-
chr18,49491830,1.8322012181862326,1282,1018,2300,-
chr18,49491832,1.7574133763094275,822,729,1551,-
chr18,49492474,1.7619661424765833,1863,1292,3155,-
chr18,49492476,1.96219762352652,2184,1792,3976,-
chr18,49492478,1.4659350852401773,7155,5301,12456,-
chr18,49492479,1.070820304001547,4516,3209,7725,-
chr18,49492480,2.599703484062268,1502,1135,2637,-
chr18,49492514,0.5993883747107719,1337,821,2158,-
chr18,49791544,0.8307707092062271,664,483,1147,-
chr18,49791546,1.0969812709953524,972,700,1672,-
chr18,49791547,2.0098056681264227,910,665,1575,-
chr18,49792186,2.168792270113512,680,506,1186,-
chr18,49802833,4.134434995798569,644,459,1103,-
chr18,54155039,1.8348027724308882,1016,766,1782,-
chr18,54155074,1.7740353172007848,650,416,1066,-
chr18,54159803,1.470527306967985,678,530,1208,-
chr18,54164549,2.109680819030413,1899,1106,3005,-
chr18,54164551,1.5241490471224046,1575,994,2569,-
chr18,54164555,1.6802728167101455,2263,1454,3717,-
chr18,54164565,1.4034933706885018,2225,1249,3474,-
chr18,54164574,1.604380981626491,921,500,1421,-
chr18,54164576,1.6488375410069893,1155,778,1933,-
chr18,54164577,1.7912534435261709,838,439,1277,-
chr18,54164585,2.119802268101192,728,361,1089,-
chr18,54164588,1.7392151134482423,1785,1140,2925,-
chr18,54164589,1.7392151134482423,1785,1140,2925,-
chr18,54164594,2.344078220082665,1406,752,2158,-
chr18,54164606,4.123463687150838,670,357,1027,-
chr18,54406941,1.7114214172650477,999,764,1763,-
chr18,54406948,0.24384806969110287,714,516,1230,-
chr18,54407110,1.5195259513100592,938,608,1546,-
chr18,54407119,1.9656481005652848,764,616,1380,-
chr18,54407120,0.4647493555384559,1918,1399,3317,-
chr18,54407121,1.9656481005652848,764,616,1380,-
chr18,54407122,0.494149813035262,1228,968,2196,-
chr18,56603020,2.5166202719800137,612,417,1029,-
chr18,57600797,1.001409869083585,903,661,1564,-
chr18,57600798,1.001409869083585,903,661,1564,-
chr18,57601684,3.6008733624454146,588,457,1045,-
chr18,57601685,2.396577147498188,921,755,1676,-
chr18,57606702,0.4289940828402367,869,389,1258,-
chr18,57606712,2.153959459703143,1000,568,1568,-
chr18,57607300,1.6945400242064987,884,606,1490,-
chr18,57615670,3.0323234688143845,757,535,1292,-
chr18,57620584,0.9914553532895077,830,536,1366,-
chr18,57621775,0.589821347903709,710,523,1233,-
chr18,59328033,1.839244282399735,715,430,1145,-
chr18,59328115,2.0020421423930195,673,566,1239,-
chr18,59328418,1.6850086956521737,733,574,1307,-
chr18,59328485,0.6589752906976744,1673,1151,2824,-
chr18,59328488,1.4279279279279282,1584,1109,2693,-
chr18,59328660,1.902697089167344,5321,4084,9405,-
chr18,59328670,1.5242021142076778,1434,1162,2596,-
chr18,59328673,2.2001955034213103,1323,989,2312,-
chr18,59328676,1.506296517809676,1276,911,2187,-
chr18,59328908,1.9071057132630633,1152,758,1910,-
chr18,59329004,0.41420534458509145,588,473,1061,-
chr18,59329075,2.9475191815856783,685,574,1259,-
chr18,59329080,2.304705882352941,652,499,1151,-
chr18,59329304,1.6507141532183265,808,598,1406,-
chr18,59329317,1.7833384192859325,973,564,1537,-
chr18,59329350,2.0869070208728653,610,464,1074,-
chr18,59329602,1.7441408359434063,1537,1181,2718,-
chr18,59329682,2.255653266331658,683,397,1080,-
chr18,59329773,1.8163033175355447,736,421,1157,-
chr18,59329782,1.6334123014828463,715,392,1107,-
chr18,59329998,1.8348671112559485,1805,1337,3142,-
chr18,59330104,2.964285714285714,746,593,1339,-
chr18,59330188,2.1876519202722413,599,483,1082,-
chr18,59330243,1.4356389855770328,2046,1480,3526,-
chr18,59330598,1.9249042145593869,627,434,1061,-
chr18,59330647,1.9334465195246184,656,464,1120,-
chr18,59330938,3.6886956521739136,605,459,1064,-
chr18,59331533,2.002486702776558,886,678,1564,-
chr18,59333129,0.5312097120756338,898,715,1613,-
chr18,59333188,1.797423887587822,613,426,1039,-
chr18,59338879,1.7495164410058028,535,516,1051,-
chr18,59338894,0.6170318725099602,530,501,1031,-
chr18,59345956,0.7740853658536585,7616,5231,12847,-
chr18,59345957,0.7740853658536585,7616,5231,12847,-
chr18,59345959,0.7298321602598808,3369,1846,5215,-
chr18,59345965,1.538241112643127,3613,2382,5995,-
chr18,59345989,1.3716056396219594,2011,1138,3149,-
chr18,59346011,1.7785564225690274,1942,1189,3131,-
chr18,59346015,2.4458704243343576,1828,1065,2893,-
chr18,59346022,1.4147858821865995,1600,958,2558,-
chr18,59346035,1.6629920834346543,2017,1013,3030,-
chr18,59346036,1.6629920834346543,2017,1013,3030,-
chr18,59346042,4.1670644391408125,872,418,1290,-
chr18,59347530,1.879446905624916,874,572,1446,-
chr18,59347537,0.5486211901306239,797,493,1290,-
chr18,59347564,0.6117647058823529,989,764,1753,-
chr18,59353251,0.5156884459210039,634,386,1020,-
chr18,59353254,1.0086426416412286,1166,970,2136,-
chr18,59354539,1.643800528295846,603,402,1005,-
chr18,59354574,1.724702380952381,1036,713,1749,-
chr18,59355605,2.2152553660160854,1137,722,1859,-
chr18,59355637,0.44,1546,909,2455,-
chr18,59355638,0.44,1546,909,2455,-
chr18,59355646,1.5923054587688732,1890,983,2873,-
chr18,59355647,1.5923054587688732,1890,983,2873,-
chr18,59355653,1.981516290726817,824,398,1222,-
chr18,59359098,1.256130177644055,1102,718,1820,-
chr18,59359246,1.8217634566800165,964,553,1517,-
chr18,59359252,1.0451637514402357,2685,1291,3976,-
chr18,59359253,1.0451637514402357,2685,1291,3976,-
chr18,60017339,1.8246760317558126,626,496,1122,-
chr18,68278019,1.8341632236826415,1349,1226,2575,-
chr18,68278020,0.7067483660130719,1168,815,1983,-
chr18,68278026,0.6712861247253676,992,678,1670,-
chr18,68278028,1.437908496732026,670,548,1218,-
chr18,68278034,1.7174595895907374,1188,792,1980,-
chr18,68278036,1.8153133509552741,1467,1025,2492,-
chr18,68278042,2.2087184015980053,612,462,1074,-
chr18,68278047,1.1544086021505378,731,449,1180,-
chr18,68278049,0.8737982020755962,1006,612,1618,-
chr18,68278050,1.971252044894427,869,612,1481,-
chr18,68278051,0.8795073195341605,1245,763,2008,-
chr18,68278165,1.1075823920651504,742,602,1344,-
chr18,74390085,1.303251635477656,2057,1920,3977,-
chr18,74390093,1.3862089434111593,2122,1443,3565,-
chr18,74390097,1.0789047851760694,3710,3159,6869,-
chr18,74390098,0.7199352451433857,1414,1174,2588,-
chr18,74390099,1.1076992540339854,6808,4902,11710,-
chr18,74390100,1.1605561095024264,5475,4629,10104,-
chr18,74390101,1.13566924779536,9193,6976,16169,-
chr18,74390102,1.080842922968244,4731,3747,8478,-
chr18,74390105,1.4702495974235106,618,551,1169,-
chr18,74390106,1.6096142164631413,1148,728,1876,-
chr18,74390113,2.4174985550118637,1334,735,2069,-
chr18,74390115,2.1239382888221225,1236,742,1978,-
chr18,74390225,0.5478960933872897,2357,1241,3598,-
chr18,74390228,0.48047289739464893,1493,1044,2537,-
chr18,74390232,0.6450402886874697,889,715,1604,-
chr18,74390233,0.5684477654025095,755,491,1246,-
chr18,74390235,0.8890268451509042,692,454,1146,-
chr18,79973664,3.4898862506808537,619,382,1001,-
chr18,79973810,2.439041336828332,608,516,1124,-
chr19,281155,0.5105965048674884,819,470,1289,-
chr19,1009777,3.5535815580150554,614,401,1015,-
chr19,1010086,7.733258608349175,1232,978,2210,-
chr19,1010087,7.7332586083491766,1232,978,2210,-
chr19,1011183,0.841193033843671,635,529,1164,-
chr19,1014276,1.960190064155897,658,534,1192,-
chr19,1014444,1.4769230769230772,671,363,1034,-
chr19,1088305,0.7716493692189809,624,476,1100,-
chr19,1089950,2.9747560703622584,765,535,1300,-
chr19,1090929,1.697858980639815,999,684,1683,-
chr19,1090965,1.2905570099658192,661,464,1125,-
chr19,1123569,8.116199684871985,3271,3225,6496,-
chr19,1123570,8.116199684871985,3271,3225,6496,-
chr19,1123571,7.8925008129970005,2939,2896,5835,-
chr19,1123577,7.536448685910334,1033,779,1812,-
chr19,1123580,3.254534389352063,968,621,1589,-
chr19,1123586,2.7934488457888955,1100,455,1555,-
chr19,1598142,1.5265315165614266,1559,1002,2561,-
chr19,1598143,1.5027533571635592,1219,940,2159,-
chr19,1598168,1.7064334305150632,933,734,1667,-
chr19,1599439,1.6208406850025945,1445,1024,2469,-
chr19,1599482,1.6683622828784122,790,619,1409,-
chr19,1599502,2.0104068117313147,764,452,1216,-
chr19,1605398,2.0128714060495065,704,518,1222,-
chr19,1611364,1.3450549450549452,679,363,1042,-
chr19,1611365,1.3450549450549452,679,363,1042,-
chr19,1611366,1.0583015186137985,833,508,1341,-
chr19,2121755,3.349896480331263,808,482,1290,-
chr19,2121773,3.108024691358025,688,350,1038,-
chr19,2121780,0.6423320659062104,723,525,1248,-
chr19,2121801,2.5750605326876514,708,353,1061,-
chr19,2121803,2.5750605326876514,708,353,1061,-
chr19,2121848,2.3229156312350994,816,386,1202,-
chr19,2321600,1.5552699699887316,1078,850,1928,-
chr19,2328433,2.349447513812154,971,723,1694,-
chr19,2328434,1.733768674623011,1522,1069,2591,-
chr19,2328473,0.885391354278973,757,520,1277,-
chr19,2427447,1.7765333537018955,1066,740,1806,-
chr19,2427489,2.410887464119527,882,542,1424,-
chr19,2427575,0.7999056749144682,791,444,1235,-
chr19,3053049,0.5197149011325544,1070,770,1840,-
chr19,3053050,6.227515049138787,602,408,1010,-
chr19,3053206,19.774117898965297,2929,2171,5100,-
chr19,3053207,19.774117898965297,2929,2171,5100,-
chr19,3053226,4.433801351161974,1102,754,1856,-
chr19,3053481,1.6647844908714473,609,461,1070,-
chr19,3053632,1.5606459543605495,1195,940,2135,-
chr19,3053712,0.5602678571428571,1003,1035,2038,-
chr19,3053714,0.5602678571428571,1003,1035,2038,-
chr19,3053740,0.43368609255514523,2749,3870,6619,-
chr19,3053742,0.5144194328191376,2976,3838,6814,-
chr19,3053745,0.29679235493188977,764,1601,2365,-
chr19,3053755,0.5675351831402862,1097,1372,2469,-
chr19,3053756,0.5259515570934257,1595,2022,3617,-
chr19,3053758,0.3858099347682668,2193,3360,5553,-
chr19,3053759,0.43649816368532257,2388,2956,5344,-
chr19,3053760,0.4990335170559341,2044,3244,5288,-
chr19,3053761,0.2931379080612925,879,1215,2094,-
chr19,3053773,3.4950354609929084,671,939,1610,-
chr19,3053775,10.38283822109804,4208,4482,8690,-
chr19,3053776,11.736407283175643,4239,4132,8371,-
chr19,3053777,11.736407283175641,4239,4132,8371,-
chr19,3053778,11.621756487025948,1506,667,2173,-
chr19,3053780,3.4793564796345744,1669,583,2252,-
chr19,3053782,3.98978756304868,3192,1063,4255,-
chr19,3053783,4.181693026261898,3112,1014,4126,-
chr19,3053784,5.109646593455249,5240,1684,6924,-
chr19,3053785,9.804824376026186,4079,1290,5369,-
chr19,3053786,10.736152855138199,5808,1469,7277,-
chr19,3053787,15.901330780267878,4554,1067,5621,-
chr19,3053788,20.24629851592189,3681,780,4461,-
chr19,3053791,11.357660604969888,2013,249,2262,-
chr19,3053792,12.385950726675771,2093,260,2353,-
chr19,3053793,15.724867724867725,1485,188,1673,-
chr19,3053794,16.73305002133487,1699,226,1925,-
chr19,3053923,1.9128354862540449,738,412,1150,-
chr19,3055713,0.5926067073170732,932,671,1603,-
chr19,3055721,1.1453968253968254,1106,944,2050,-
chr19,3055722,1.343607154513761,1648,1399,3047,-
chr19,3057688,0.8802664044410018,5268,3513,8781,-
chr19,3057689,0.9501645728060825,3359,2331,5690,-
chr19,3057700,1.0525789284624862,2927,2112,5039,-
chr19,3057738,0.5900037769104872,807,610,1417,-
chr19,3061190,1.5968356522359168,2198,1515,3713,-
chr19,3061228,1.3040383396130217,1526,1303,2829,-
chr19,3061230,1.9089086078106985,1507,1307,2814,-
chr19,3061231,2.1583397234267583,1588,1316,2904,-
chr19,3061237,2.4772135416666665,760,511,1271,-
chr19,3062185,2.146432388632429,1131,726,1857,-
chr19,3062187,1.9796587030716724,852,585,1437,-
chr19,3062196,1.9967057123709233,911,557,1468,-
chr19,3062198,2.4176360225140714,757,409,1166,-
chr19,3062889,2.590963855421687,781,331,1112,-
chr19,3062890,2.590963855421687,781,331,1112,-
chr19,3062915,1.9541511793507853,779,328,1107,-
chr19,3062916,0.7306083487157701,777,377,1154,-
chr19,3538416,7.355703810664736,7620,13958,21578,-
chr19,3538417,7.355703810664736,7620,13958,21578,-
chr19,3538418,7.5716116813224685,6672,12801,19473,-
chr19,3538424,1.4776478033248541,3438,5176,8614,-
chr19,3538425,1.5986022214422975,4239,6046,10285,-
chr19,3538426,1.6875036443819371,4263,6095,10358,-
chr19,3538427,1.9448636829782708,3654,5242,8896,-
chr19,3538429,2.294686765800341,1727,2362,4089,-
chr19,3538435,3.216271743596768,1415,1787,3202,-
chr19,3538437,8.517348112472549,5208,5002,10210,-
chr19,3538438,11.337970885375281,5889,4722,10611,-
chr19,3538439,11.337970885375281,5889,4722,10611,-
chr19,3538440,12.067707764257113,4374,2984,7358,-
chr19,3538445,4.593534320133506,1249,352,1601,-
chr19,3538446,8.502128014249443,3643,1398,5041,-
chr19,3538447,12.649267373741543,4752,1703,6455,-
chr19,3538448,13.496838402951157,5004,1750,6754,-
chr19,3538449,16.850286884292203,3860,1277,5137,-
chr19,3538452,6.4797047970479715,1755,270,2025,-
chr19,3538453,6.52861325351451,2011,319,2330,-
chr19,3538454,6.4797047970479715,1755,270,2025,-
chr19,3538515,0.36876036102412973,1000,622,1622,-
chr19,3538517,0.3939804772234273,1452,921,2373,-
chr19,3538518,0.3667569653926335,1379,893,2272,-
chr19,3542226,2.344768898910122,696,590,1286,-
chr19,3542229,3.6903302804435016,1295,984,2279,-
chr19,3542231,3.6618901731827345,1672,1294,2966,-
chr19,3542233,2.8279480806407067,767,638,1405,-
chr19,3544257,1.6952949438202247,618,444,1062,-
chr19,3544380,1.4101025228776882,1969,1278,3247,-
chr19,3544425,1.7273608448768492,3830,3214,7044,-
chr19,3544427,1.7273608448768492,3830,3214,7044,-
chr19,3544498,1.5415204678362573,1317,1234,2551,-
chr19,3544532,2.4090270430248153,3975,3211,7186,-
chr19,3544533,2.425237594339064,2920,2313,5233,-
chr19,3544545,2.474372873738655,5265,3822,9087,-
chr19,3544546,2.904376363063001,3612,2534,6146,-
chr19,3544547,1.5148609779482263,789,595,1384,-
chr19,3544553,7.235389491535502,5800,3824,9624,-
chr19,3544554,7.2353894915355,5800,3824,9624,-
chr19,3544559,2.0700389105058368,873,513,1386,-
chr19,3544595,1.901627486437613,716,394,1110,-
chr19,3544723,1.6543765180567802,3134,2070,5204,-
chr19,3544724,1.6543765180567802,3134,2070,5204,-
chr19,3544935,0.6619975639464069,1086,820,1906,-
chr19,3546101,2.155580357142857,665,559,1224,-
chr19,3546129,1.4471388980882116,2756,2252,5008,-
chr19,3546140,0.6036673397029191,1678,1288,2966,-
chr19,3546151,1.6483776151540952,3474,2063,5537,-
chr19,3546152,1.6256920163170159,2259,1143,3402,-
chr19,3546166,1.7132525329710762,2360,1540,3900,-
chr19,3546167,0.3505711639394875,756,631,1387,-
chr19,3546307,2.3915289256198347,925,527,1452,-
chr19,3546330,1.974749855937975,991,706,1697,-
chr19,3546424,1.7441577921103948,1400,1129,2529,-
chr19,3547303,0.8658313006044286,3007,2313,5320,-
chr19,3547363,1.5845427833674652,1482,1020,2502,-
chr19,3547538,0.6430591795119169,1127,772,1899,-
chr19,3547539,2.2032042989352174,1106,772,1878,-
chr19,3547541,1.9326647564469916,993,697,1690,-
chr19,3547903,1.5467743524081554,1137,780,1917,-
chr19,3548027,1.7936842105263158,851,436,1287,-
chr19,3548173,0.6173955585807878,1160,643,1803,-
chr19,3548231,1.4134054408390693,1486,1129,2615,-
chr19,3548243,1.4827986322845046,1482,1140,2622,-
chr19,3551049,0.7083889571207348,1583,1227,2810,-
chr19,3551100,1.655721393034826,1559,1205,2764,-
chr19,3551103,1.6440689250715048,4500,2979,7479,-
chr19,3551104,1.69279145059164,2978,1836,4814,-
chr19,3551157,0.6944229579207921,1139,807,1946,-
chr19,3557186,1.7369498716968321,1511,1007,2518,-
chr19,3557189,2.4675821389097115,1506,973,2479,-
chr19,3557269,1.9656896551724137,876,724,1600,-
chr19,3557291,0.5278706921563434,1346,1061,2407,-
chr19,3557313,0.6113087500855169,850,621,1471,-
chr19,3557317,1.4573789032793119,1616,1060,2676,-
chr19,3557345,5.291981056178752,713,417,1130,-
chr19,3557365,2.248412138320395,707,326,1033,-
chr19,3557366,2.248412138320395,707,326,1033,-
chr19,3557495,5.725382434452832,891,771,1662,-
chr19,3557496,5.692653098004942,1681,1352,3033,-
chr19,3557506,0.8307628174929979,608,523,1131,-
chr19,3557531,1.335529894992342,770,436,1206,-
chr19,3558076,0.53113224858283,784,572,1356,-
chr19,3976277,0.5766561335407244,27919,37490,65409,-
chr19,3976278,0.5766561335407244,27919,37490,65409,-
chr19,3976283,0.5043643707314616,11470,16578,28048,-
chr19,3976289,11.353883609935664,66447,106290,172737,-
chr19,3976290,11.353883609935663,66447,106290,172737,-
chr19,3976294,13.782867768424843,94980,51598,146578,-
chr19,3976295,12.613930237475271,125487,57946,183433,-
chr19,3976296,12.613930237475271,125487,57946,183433,-
chr19,3976297,16.86788646003478,93193,32836,126029,-
chr19,3976301,4.220546375319274,61667,12439,74106,-
chr19,3976302,4.635311190060741,71601,13800,85401,-
chr19,3976303,5.670722587392534,25712,5736,31448,-
chr19,3976304,6.37484808224545,43410,8310,51720,-
chr19,3976399,1.4354530805203478,37053,38096,75149,-
chr19,3976401,1.394360844432553,66258,83687,149945,-
chr19,3976402,0.7170713036731786,15590,28234,43824,-
chr19,3976404,1.3688737222117495,60165,87679,147844,-
chr19,3976405,1.346340637551421,86973,138027,225000,-
chr19,3976407,1.6622289801749526,52260,99478,151738,-
chr19,3976408,1.877480965723433,50334,92529,142863,-
chr19,3976409,1.6576004640669977,75736,126999,202735,-
chr19,3976410,1.9095098475965704,48694,86061,134755,-
chr19,3976412,1.9169231145361427,47399,67642,115041,-
chr19,3976414,2.0290526048982827,22442,35442,57884,-
chr19,3976467,1.4628491088815143,8827,9212,18039,-
chr19,3976489,1.220075590494414,61208,54839,116047,-
chr19,3976490,1.3602480970356405,36916,37595,74511,-
chr19,3976491,1.2350585810564247,51577,48987,100564,-
chr19,3976504,1.5390093618207397,20368,15356,35724,-
chr19,3976561,1.2067250422536968,7402,6060,13462,-
chr19,3976572,1.3338572978750485,12708,10170,22878,-
chr19,3976573,1.3338572978750485,12708,10170,22878,-
chr19,3976595,1.3478632547213103,24823,16182,41005,-
chr19,3976596,1.3478632547213103,24823,16182,41005,-
chr19,3976599,1.4905790847903369,14207,9714,23921,-
chr19,3976677,1.5104013164357992,5787,4523,10310,-
chr19,3977255,1.3311350932194672,21873,15728,37601,-
chr19,3977256,1.2928678816917412,13358,10300,23658,-
chr19,3977309,1.3692918024820873,11754,9238,20992,-
chr19,3977318,1.238914837452194,5602,4636,10238,-
chr19,3977341,1.317447385988335,5105,4065,9170,-
chr19,3977347,1.1345623258431594,747,525,1272,-
chr19,3977349,1.1281061227236346,865,634,1499,-
chr19,3977443,1.2714211138306946,12945,9054,21999,-
chr19,3977456,1.7082079088195945,4872,3791,8663,-
chr19,3977515,1.6235116814799777,4252,3307,7559,-
chr19,3977593,1.388320613751721,7477,6020,13497,-
chr19,3977903,1.7673994371294974,17332,13829,31161,-
chr19,3977906,1.3725326439828578,72781,48072,120853,-
chr19,3977907,1.467106297444725,80306,54788,135094,-
chr19,3977909,1.632619409712045,29610,21424,51034,-
chr19,3977936,1.2285600483254586,32199,20832,53031,-
chr19,3977942,1.3598775714889275,20704,10590,31294,-
chr19,3977943,1.3843534846771406,31620,17893,49513,-
chr19,3977973,1.309950950522406,23083,15065,38148,-
chr19,3977975,1.4012029447041778,13529,9975,23504,-
chr19,3977976,0.873474688971007,7605,5065,12670,-
chr19,3978033,0.7534227842839092,6389,4796,11185,-
chr19,3978075,1.0553923562507974,10961,8936,19897,-
chr19,3978077,1.1999431267386345,7726,4413,12139,-
chr19,3978105,1.2666620702334987,5474,4439,9913,-
chr19,3978133,1.6028027823240587,5222,4135,9357,-
chr19,3978135,0.8369338056232013,5756,4516,10272,-
chr19,3978143,1.2573494761869952,10828,7220,18048,-
chr19,3978172,0.7354458097184169,827,647,1474,-
chr19,3979371,0.7909167602848314,9899,7765,17664,-
chr19,3979839,1.7180644739066329,82106,65527,147633,-
chr19,3979840,1.58092271794856,108677,86084,194761,-
chr19,3979841,1.7180644739066329,82106,65527,147633,-
chr19,3979857,0.7589578676659134,18867,14630,33497,-
chr19,3979874,1.2850726805842376,13457,10869,24326,-
chr19,3979875,1.2642438699729166,23807,13964,37771,-
chr19,3979877,1.2660827549667766,70225,44712,114937,-
chr19,3979878,1.1015181234691545,70258,48121,118379,-
chr19,3979879,0.7538083205832142,21084,17192,38276,-
chr19,3979896,1.288613770315749,19356,14268,33624,-
chr19,3979920,1.4207500254375254,8692,5039,13731,-
chr19,3979923,1.44615913723479,14917,10647,25564,-
chr19,3979935,1.2229102082397658,5993,4245,10238,-
chr19,3979982,1.2314492394039906,16643,10931,27574,-
chr19,3980057,1.2471898765051002,9823,7523,17346,-
chr19,3980066,0.6812988027868477,2136,1487,3623,-
chr19,3980558,1.274416070066461,45878,33190,79068,-
chr19,3980559,1.301262517672867,56605,39150,95755,-
chr19,3980561,1.2022268286530704,47062,33126,80188,-
chr19,3980627,1.500950962409592,9156,6661,15817,-
chr19,3980701,1.5414718629136674,14519,8821,23340,-
chr19,3980703,1.3957843382965203,55888,37620,93508,-
chr19,3980704,1.4078610242808383,42096,26721,68817,-
chr19,3980705,1.41034127289749,46703,29800,76503,-
chr19,3980706,1.1135590875599906,24269,15000,39269,-
chr19,3980707,1.353351085084469,13093,9365,22458,-
chr19,3980894,1.5177135797214538,6040,4698,10738,-
chr19,3980932,1.495375506954761,6864,5187,12051,-
chr19,3981968,1.5104950979601957,39058,29286,68344,-
chr19,3982029,1.2036601126188502,7450,6279,13729,-
chr19,3982053,0.8377108967504477,2091,1932,4023,-
chr19,3982054,0.7581569099991956,1358,1300,2658,-
chr19,3982263,0.8389232450587091,10946,7897,18843,-
chr19,3982281,1.3796769209573294,6300,5255,11555,-
chr19,3982284,1.3429164604849393,11704,9637,21341,-
chr19,3982285,1.1422140810027903,19130,15327,34457,-
chr19,3982308,1.3731986970203423,10608,8887,19495,-
chr19,3982356,1.2048213175504785,5631,4790,10421,-
chr19,3982371,2.3315250340532407,6729,4096,10825,-
chr19,3982424,0.41904928415665527,1175,867,2042,-
chr19,3982849,1.1794613074182423,22335,16117,38452,-
chr19,3982943,1.1921696025685526,6733,5761,12494,-
chr19,3982946,1.3012707039178526,15409,13094,28503,-
chr19,3982948,1.212734152341001,9217,7884,17101,-
chr19,3982952,1.3402507871623488,5228,4209,9437,-
chr19,3982967,1.354768988748675,6125,3609,9734,-
chr19,3982979,1.303438151896778,5271,3009,8280,-
chr19,3982999,0.805267072532437,3131,2341,5472,-
chr19,3983005,0.6950053194477873,10347,7556,17903,-
chr19,3983008,1.467658009004037,4468,3551,8019,-
chr19,3983015,1.376958835531436,1843,1377,3220,-
chr19,3983016,0.7291946284379376,2184,1357,3541,-
chr19,3983018,0.7824584230977484,2379,1509,3888,-
chr19,3983249,1.2808861049935578,14911,12436,27347,-
chr19,3983250,1.2808861049935578,14911,12436,27347,-
chr19,3983261,1.0344618251879332,15943,12452,28395,-
chr19,3983273,1.5731336018055495,7085,5744,12829,-
chr19,3983282,1.2399897449905,6600,5282,11882,-
chr19,3984180,0.7909038448313495,4586,4128,8714,-
chr19,3984181,0.8367806548016204,7255,5555,12810,-
chr19,3984182,1.2104581119082207,5787,4425,10212,-
chr19,3984259,1.2959486015511525,12813,8270,21083,-
chr19,3984324,0.8376121818160396,5101,4404,9505,-
chr19,3984336,1.4789464471348093,4967,4588,9555,-
chr19,3984346,1.0209924152693086,16640,11525,28165,-
chr19,3984348,1.249136468009937,15452,11246,26698,-
chr19,3985401,1.2442473257611415,29454,22533,51987,-
chr19,3985402,1.2356003088832868,22334,16884,39218,-
chr19,3985403,1.1990819890013795,15593,10732,26325,-
chr19,3985412,1.384383688600556,2389,2157,4546,-
chr19,3985415,1.361871871707067,7562,5925,13487,-
chr19,3985425,1.4058975271304042,2590,2189,4779,-
chr19,3985427,1.121521345916521,7212,5622,12834,-
chr19,3985428,1.030420466058764,2392,1973,4365,-
chr19,3985436,1.5307040811590251,2290,1656,3946,-
chr19,3985439,0.9253471559261923,3974,2584,6558,-
chr19,3985440,0.891723749446893,5113,3364,8477,-
chr19,3985441,0.9558175353535233,5458,3640,9098,-
chr19,3985442,0.861546554445029,3016,1900,4916,-
chr19,3985443,1.040155681924117,782,630,1412,-
chr19,3985448,1.7663127353540342,1049,667,1716,-
chr19,3985449,1.7663127353540342,1049,667,1716,-
chr19,3985451,1.7576746926488642,586,501,1087,-
chr19,4094489,2.1722728531568434,786,624,1410,-
chr19,4097294,0.3829595836416864,815,744,1559,-
chr19,4102400,1.2566872354826935,782,576,1358,-
chr19,4361399,0.22452606801372701,482,737,1219,-
chr19,4446560,1.7292006525285482,794,612,1406,-
chr19,4446561,1.3828975039412694,1347,863,2210,-
chr19,4446562,1.6559857629268206,1007,646,1653,-
chr19,4446563,1.811145510835913,1104,645,1749,-
chr19,4446565,1.8389434344682374,897,593,1490,-
chr19,4447616,2.882615377557574,690,514,1204,-
chr19,4657632,0.5518020410290772,2403,3049,5452,-
chr19,4657646,0.5062604062604064,1321,1715,3036,-
chr19,4657698,11.347430417876637,9870,12853,22723,-
chr19,4657699,11.347430417876637,9870,12853,22723,-
chr19,4657700,11.347430417876637,9870,12853,22723,-
chr19,4657710,26.389660806269283,6480,2856,9336,-
chr19,4657711,26.38966080626928,6480,2856,9336,-
chr19,4657716,2.9340066520645736,1954,586,2540,-
chr19,4657718,3.0400493358530682,4341,1469,5810,-
chr19,4657719,3.0417203458047815,3367,1178,4545,-
chr19,4657720,6.498495365331147,1709,456,2165,-
chr19,4657780,2.050086065431696,5008,4456,9464,-
chr19,4657782,2.42983789260385,1990,1973,3963,-
chr19,4657786,1.8825700838142518,3542,2877,6419,-
chr19,4657787,2.2102882229433103,1913,1689,3602,-
chr19,4657797,0.6191283895334373,943,866,1809,-
chr19,4657889,1.7178490103345596,1065,864,1929,-
chr19,4657911,1.278572325721846,1998,1561,3559,-
chr19,4657968,1.556702268090724,1127,640,1767,-
chr19,4658001,1.6135884257746351,1064,820,1884,-
chr19,4658063,1.8796394485683985,1417,827,2244,-
chr19,4659988,3.5548872180451125,787,664,1451,-
chr19,4660001,1.6727871939736343,1121,707,1828,-
chr19,4660717,0.5537100737100737,938,739,1677,-
chr19,4660724,2.6987341772151896,1247,789,2036,-
chr19,4664893,5.476081258191352,618,435,1053,-
chr19,4664905,1.7380077030812326,1044,671,1715,-
chr19,4668640,0.9013713623486996,2028,1411,3439,-
chr19,4668642,0.9013713623486996,2028,1411,3439,-
chr19,4668644,0.5841704718417047,706,510,1216,-
chr19,4670182,1.9885714285714289,845,704,1549,-
chr19,4670183,1.9885714285714289,845,704,1549,-
chr19,4670216,1.5888971010922233,690,368,1058,-
chr19,4670217,3.2203883495145638,748,514,1262,-
chr19,4670218,3.2203883495145638,748,514,1262,-
chr19,4838549,2.429689948253767,1550,1103,2653,-
chr19,4838550,2.429689948253767,1550,1103,2653,-
chr19,4838997,2.159288537549407,606,505,1111,-
chr19,4839048,0.523696682464455,594,421,1015,-
chr19,4839060,1.6370249136206583,642,422,1064,-
chr19,4839108,1.7171717171717167,679,431,1110,-
chr19,4839109,2.5016100178890874,607,429,1036,-
chr19,4839196,0.44089576300126965,670,500,1170,-
chr19,4839455,0.8752982370162111,669,471,1140,-
chr19,5205602,2.375279481585344,660,433,1093,-
chr19,5244385,2.211526955824069,1779,1617,3396,-
chr19,5244386,2.422331994740396,1575,1480,3055,-
chr19,5244387,2.633256040092752,2030,1843,3873,-
chr19,5244389,2.996477495107632,956,802,1758,-
chr19,5576860,1.6036617401542927,2699,1825,4524,-
chr19,5576863,0.9595771527051148,2534,2109,4643,-
chr19,5576864,1.165795099493967,4167,3289,7456,-
chr19,5576867,1.6497730835153754,2736,1766,4502,-
chr19,5576868,1.780458784139019,1531,1017,2548,-
chr19,5576870,1.3614787111622555,1261,879,2140,-
chr19,5576879,1.1768407345184346,2068,1341,3409,-
chr19,5576880,0.9744333886124932,1281,803,2084,-
chr19,5576885,2.0544993343514495,1434,791,2225,-
chr19,5576886,2.063751606458554,1433,948,2381,-
chr19,5576913,0.7811379964324703,718,351,1069,-
chr19,5600152,1.806092843326886,995,751,1746,-
chr19,5600154,1.485972850678733,820,584,1404,-
chr19,5600167,2.869030395769101,1032,702,1734,-
chr19,5678554,0.44320942187861795,699,525,1224,-
chr19,5691914,3.335445774749679,602,538,1140,-
chr19,5692083,1.0435602717503623,855,582,1437,-
chr19,5693337,2.3600577769724826,1008,726,1734,-
chr19,5693592,2.4929934836578345,1051,719,1770,-
chr19,5694774,1.809205862702822,1400,1064,2464,-
chr19,5694776,2.554341814159292,636,451,1087,-
chr19,5696102,1.2473254112035699,614,509,1123,-
chr19,5696156,1.663696096999416,599,415,1014,-
chr19,5696305,2.5138728949911338,768,679,1447,-
chr19,5696707,1.5924517087667165,686,672,1358,-
chr19,5696710,1.825005132063248,1988,1721,3709,-
chr19,5696712,1.969466423209576,1764,1642,3406,-
chr19,5696713,2.0647944647944647,1152,1052,2204,-
chr19,5699081,2.277670320223512,756,422,1178,-
chr19,5699116,2.3426,900,599,1499,-
chr19,5699118,2.3426,900,599,1499,-
chr19,5699146,2.3407579890755215,698,531,1229,-
chr19,5699203,2.755097743248242,670,435,1105,-
chr19,5705982,1.960007881960101,1687,1359,3046,-
chr19,5705984,2.0187395733971996,2446,1869,4315,-
chr19,5707705,1.3370783203977163,753,477,1230,-
chr19,5707726,3.6642458195798,689,408,1097,-
chr19,5711791,1.3747525732383217,2136,1262,3398,-
chr19,5711792,2.227369716864998,2634,2436,5070,-
chr19,5711793,1.7805017144058017,7225,5520,12745,-
chr19,5711795,1.6563897993971357,11922,7960,19882,-
chr19,5711796,1.6243966329502535,8785,5636,14421,-
chr19,5711802,1.7779283348389041,1927,1475,3402,-
chr19,5711804,1.7779283348389041,1927,1475,3402,-
chr19,5711807,1.8424657534246576,1075,583,1658,-
chr19,5711815,2.0164776898605106,1029,532,1561,-
chr19,5711819,2.3586655425749727,611,436,1047,-
chr19,5711833,1.953168044077135,708,362,1070,-
chr19,5711948,1.7679919674692,1213,1117,2330,-
chr19,5711949,2.068453645575729,2032,1544,3576,-
chr19,5711951,2.0029033634939863,1543,1093,2636,-
chr19,5713154,1.1407242693773825,1133,786,1919,-
chr19,5713155,1.1407242693773825,1133,786,1919,-
chr19,5720039,39.22839506172839,619,431,1050,-
chr19,5720040,19.90895458281335,1953,1378,3331,-
chr19,5720041,19.90895458281335,1953,1378,3331,-
chr19,5894755,2.0667569659442724,970,645,1615,-
chr19,5894817,1.765743249989788,1326,1091,2417,-
chr19,5894818,1.4695309048949974,1674,1387,3061,-
chr19,5894820,0.922513440860215,741,619,1360,-
chr19,5894851,1.9921363040629096,759,435,1194,-
chr19,5896500,1.7577753945150911,2085,1283,3368,-
chr19,5896502,1.8710064439510545,2582,1704,4286,-
chr19,5896559,2.0934823091247674,802,536,1338,-
chr19,5896973,4.2631578947368425,566,436,1002,-
chr19,5896974,0.4161255411255412,768,571,1339,-
chr19,5896981,2.3270223752151464,675,580,1255,-
chr19,5903659,1.7873027861698556,1216,661,1877,-
chr19,5903677,2.7857142857142856,611,475,1086,-
chr19,5903685,2.0887799564270146,589,458,1047,-
chr19,5903720,1.6289615678258789,1557,1006,2563,-
chr19,5903780,1.3279626256681647,1082,606,1688,-
chr19,5903782,1.0522417323863884,804,388,1192,-
chr19,5903789,0.7616106663442715,1461,1138,2599,-
chr19,5903790,0.9192749652950983,948,709,1657,-
chr19,5921259,5.511072457308147,657,467,1124,-
chr19,5924885,2.2758210114184303,619,440,1059,-
chr19,6210462,0.5973244147157191,939,597,1536,-
chr19,6210486,1.9757639620653318,749,437,1186,-
chr19,6210511,2.127659574468085,679,469,1148,-
chr19,6393068,2.040118554104839,1238,973,2211,-
chr19,6393070,2.040118554104839,1238,973,2211,-
chr19,6393080,0.5207094498931706,777,562,1339,-
chr19,6393100,0.4519848028298179,574,448,1022,-
chr19,6393106,2.406277703157092,775,551,1326,-
chr19,6393149,2.4849565756823817,762,402,1164,-
chr19,6413699,3.639993198327532,986,717,1703,-
chr19,6413713,2.5379865078111075,752,476,1228,-
chr19,6413828,0.2541247935651808,620,484,1104,-
chr19,6413909,0.23961467214062368,469,687,1156,-
chr19,6413913,0.30000736524085236,423,686,1109,-
chr19,6413937,0.28347017227937804,707,1281,1988,-
chr19,6413939,0.2653213751868461,354,668,1022,-
chr19,6413945,6.285529462473251,1022,1797,2819,-
chr19,6413946,6.426223037817076,935,1561,2496,-
chr19,6413954,10.256625859018769,1564,1888,3452,-
chr19,6413955,11.045976344040032,1914,2006,3920,-
chr19,6413956,11.809229898056625,1719,1685,3404,-
chr19,6413957,14.477721357883008,1087,763,1850,-
chr19,6416561,1.758718968012673,675,456,1131,-
chr19,6416566,1.7256087397094593,884,570,1454,-
chr19,6420120,0.4177510844177511,625,404,1029,-
chr19,6420121,0.6951498920599934,997,714,1711,-
chr19,6422381,0.37364719572143135,698,471,1169,-
chr19,6422396,1.287705651646398,642,408,1050,-
chr19,6422400,2.6351130744516977,899,610,1509,-
chr19,6678392,1.647185075119696,906,672,1578,-
chr19,6678404,1.8421953188054885,1107,1049,2156,-
chr19,6678406,1.7532757968953148,1829,1555,3384,-
chr19,6678407,2.1077483285577845,1138,1046,2184,-
chr19,6678409,2.2305746916214515,1608,1447,3055,-
chr19,6678454,2.6948358979196785,638,473,1111,-
chr19,6679465,2.5665859564164646,635,412,1047,-
chr19,6679467,1.649382094166565,1018,708,1726,-
chr19,6681998,2.2325298284697404,893,635,1528,-
chr19,6682001,0.6148473635522664,632,469,1101,-
chr19,6682010,1.7123655913978495,636,464,1100,-
chr19,6682214,2.3855113636363643,621,439,1060,-
chr19,6684417,0.5934544549527128,752,573,1325,-
chr19,6684639,1.640493827160494,603,449,1052,-
chr19,6684796,2.258493479752917,1169,751,1920,-
chr19,6684798,2.52437089027915,1480,996,2476,-
chr19,6684828,1.2512404136784734,777,525,1302,-
chr19,6685046,1.1675791691843416,767,592,1359,-
chr19,6685081,2.198573371738721,775,511,1286,-
chr19,6685114,2.2602716291217764,608,413,1021,-
chr19,6693001,0.9737124463519312,604,465,1069,-
chr19,6693003,0.9737124463519312,604,465,1069,-
chr19,6696392,2.497545372374767,664,461,1125,-
chr19,6697407,2.2412542797572295,607,490,1097,-
chr19,6697448,1.1341268188067353,631,544,1175,-
chr19,6697697,2.1738878036834177,614,460,1074,-
chr19,6702520,2.215643131896136,817,512,1329,-
chr19,6702553,0.5597904026475455,596,489,1085,-
chr19,6702576,0.8299872754381201,715,441,1156,-
chr19,6710824,0.9435988090182988,578,470,1048,-
chr19,6713495,0.4447753989900218,800,586,1386,-
chr19,6714221,1.4743682389834647,1048,784,1832,-
chr19,6714222,1.1534872298624754,670,508,1178,-
chr19,6714233,0.3166419844502036,621,583,1204,-
chr19,6714234,0.3166419844502036,621,583,1204,-
chr19,6714387,2.1556031406138474,603,466,1069,-
chr19,6714388,2.1556031406138474,603,466,1069,-
chr19,6714402,2.023016634362027,696,537,1233,-
chr19,6718287,2.8262863342892803,963,719,1682,-
chr19,6720550,2.2893270687692326,909,495,1404,-
chr19,7624408,3.213030276430277,1036,740,1776,-
chr19,7624409,3.7838769230769236,853,624,1477,-
chr19,7624410,2.7879548306148063,1110,796,1906,-
chr19,7938058,2.409688013136289,586,434,1020,-
chr19,7938059,2.409688013136289,586,434,1020,-
chr19,8302376,2.2243824488980626,695,652,1347,-
chr19,8302378,2.2243824488980626,695,652,1347,-
chr19,8302486,1.2752276040853734,1307,1071,2378,-
chr19,8302913,2.886286302293792,678,383,1061,-
chr19,8303991,2.0211869173163124,1014,741,1755,-
chr19,8311463,0.6696969696969697,1104,824,1928,-
chr19,8311477,1.6263440860215057,967,743,1710,-
chr19,8311481,1.7168752697453604,883,661,1544,-
chr19,8311543,0.6328001683678838,632,441,1073,-
chr19,8311544,1.0261535898717309,1119,666,1785,-
chr19,8311545,1.0261535898717309,1119,666,1785,-
chr19,8316585,1.9573361351190757,1206,947,2153,-
chr19,8316592,0.48571428571428565,815,559,1374,-
chr19,8316628,1.4893939936896028,1031,757,1788,-
chr19,8316643,2.453636801585504,1423,937,2360,-
chr19,8316644,2.5693552367501638,1292,830,2122,-
chr19,8320871,3.0481927710843366,689,414,1103,-
chr19,8321338,2.5286356403417383,1961,891,2852,-
chr19,8321359,2.065074714015411,2090,989,3079,-
chr19,8321360,2.084532877349349,2305,904,3209,-
chr19,8321371,2.1469939908628817,1244,565,1809,-
chr19,8321374,0.9124627411400696,2224,864,3088,-
chr19,10115096,1.4228920851491438,582,576,1158,-
chr19,10115115,1.1648006081968347,910,688,1598,-
chr19,10115117,1.3887072721325555,1152,947,2099,-
chr19,10115519,2.5659589853566382,591,447,1038,-
chr19,10115813,2.4920982703991905,667,431,1098,-
chr19,10116858,2.0267836416194847,826,575,1401,-
chr19,10116915,2.219514199326154,799,604,1403,-
chr19,10116957,2.528361166336525,2362,1575,3937,-
chr19,10116958,2.7820545718929095,1300,865,2165,-
chr19,10116982,0.5302853814793244,606,403,1009,-
chr19,10118896,2.4414955617322693,777,586,1363,-
chr19,10118928,3.125761531766753,652,382,1034,-
chr19,10119872,0.525314150427973,640,577,1217,-
chr19,10119873,0.708346796962524,1120,1024,2144,-
chr19,10119875,0.8674509803921568,552,524,1076,-
chr19,10133505,0.9471491228070176,616,455,1071,-
chr19,10133507,0.9471491228070176,616,455,1071,-
chr19,10154989,1.0771963824289406,869,515,1384,-
chr19,10154990,1.402574412246697,1168,683,1851,-
chr19,10155019,1.1945496658100319,1163,626,1789,-
chr19,10166648,1.4546365256743221,1153,591,1744,-
chr19,10166650,1.760955034958874,2228,1262,3490,-
chr19,10166676,1.786304347826087,746,399,1145,-
chr19,10177303,2.125634562908172,920,651,1571,-
chr19,10391210,1.1967352253746784,670,505,1175,-
chr19,10391375,0.9451992409867171,592,424,1016,-
chr19,10391377,0.9451992409867171,592,424,1016,-
chr19,10391485,2.4670629020091983,818,622,1440,-
chr19,10391700,1.0102663841479331,1016,716,1732,-
chr19,10395312,1.9610526315789476,620,417,1037,-
chr19,10395483,1.6253055355859096,2511,1604,4115,-
chr19,10395484,1.6849233861076125,4550,3192,7742,-
chr19,10395487,3.4145625441767904,3008,2190,5198,-
chr19,10395535,0.5922098569157392,595,407,1002,-
chr19,10395947,1.8881328751431845,1128,969,2097,-
chr19,10395971,1.7895716945996276,960,715,1675,-
chr19,10395982,0.5011775788977861,797,578,1375,-
chr19,10395986,1.614642407013052,1557,1196,2753,-
chr19,10395994,1.8632072739908496,765,556,1321,-
chr19,10396006,1.4611487920469106,1666,1151,2817,-
chr19,10492041,2.1405351287603906,746,500,1246,-
chr19,10492043,0.8870054808984131,760,539,1299,-
chr19,10572939,2.515970994979394,557,524,1081,-
chr19,10572984,21.48049200132707,1533,1062,2595,-
chr19,10572985,22.998318960804337,1360,896,2256,-
chr19,10574941,1.4017810280558847,673,417,1090,-
chr19,10832712,2.5803608447138413,588,439,1027,-
chr19,10835054,2.267053664685756,686,548,1234,-
chr19,10835078,2.226475279106858,697,527,1224,-
chr19,10835079,2.226475279106858,697,527,1224,-
chr19,10835093,1.3267242058081965,688,538,1226,-
chr19,10836116,24.310305241229614,1291,959,2250,-
chr19,10836117,24.31030524122962,1291,959,2250,-
chr19,11342938,1.2026300904977374,728,543,1271,-
chr19,11342939,1.2026300904977374,728,543,1271,-
chr19,11345333,1.7158119658119655,729,539,1268,-
chr19,11345571,1.1706939619162324,902,591,1493,-
chr19,11346190,1.3710144139116434,776,557,1333,-
chr19,11346267,1.0936305854360309,596,486,1082,-
chr19,12643464,2.2320920303605307,1297,1087,2384,-
chr19,12643472,1.4513324826365581,4110,3231,7341,-
chr19,12643473,0.8742137204626367,2961,2356,5317,-
chr19,12643474,1.1770097908384722,3426,2569,5995,-
chr19,12643475,0.9595103963326382,6603,4663,11266,-
chr19,12643476,1.1476998604513693,5424,3588,9012,-
chr19,12643477,1.2063743356020191,2217,1530,3747,-
chr19,12643478,1.2754088226960916,2677,1735,4412,-
chr19,12643732,2.2878335510356407,790,465,1255,-
chr19,12643738,2.083733589497278,684,346,1030,-
chr19,12643762,1.744342004052635,724,484,1208,-
chr19,12643764,1.25639494990468,1323,903,2226,-
chr19,12643765,0.9617976156197892,995,596,1591,-
chr19,12643934,1.0740583265013317,9424,6135,15559,-
chr19,12643936,1.1175091769602095,13916,10498,24414,-
chr19,12643937,1.26361265896801,11532,7239,18771,-
chr19,12643938,1.1043823357007783,10837,8161,18998,-
chr19,12643939,1.3583358250395112,5499,2854,8353,-
chr19,12643942,1.3677756291883143,3907,2407,6314,-
chr19,12643945,1.5699658703071673,1839,878,2717,-
chr19,12643952,1.1483034290059133,5140,3805,8945,-
chr19,12643953,1.1659576818383768,7037,4410,11447,-
chr19,12643954,1.5648319201680008,4107,1815,5922,-
chr19,12643955,0.6914703632588708,2620,1964,4584,-
chr19,12643956,0.9477368422165688,4541,1868,6409,-
chr19,12643957,0.8875211315750755,4342,2148,6490,-
chr19,12643958,0.7891417922554922,5504,3004,8508,-
chr19,12661318,2.594197996858422,1026,777,1803,-
chr19,12668148,2.1814573187358635,694,577,1271,-
chr19,12668211,2.1122112211221116,639,403,1042,-
chr19,12668317,0.5208237986270022,568,436,1004,-
chr19,12668321,1.757365822583214,760,482,1242,-
chr19,12668389,1.8538377192982456,582,479,1061,-
chr19,12668613,0.622766717713119,1097,652,1749,-
chr19,12669147,1.6136854636038973,914,612,1526,-
chr19,12669158,2.057245495104004,865,522,1387,-
chr19,12669159,1.7782404997397188,853,564,1417,-
chr19,12669172,3.7372773536895663,704,392,1096,-
chr19,12669179,2.756133609222583,665,397,1062,-
chr19,12669366,0.5170321637426901,642,359,1001,-
chr19,12669410,0.557513185868759,756,547,1303,-
chr19,12675932,3.657992991825797,960,692,1652,-
chr19,12676070,2.112930743040902,627,465,1092,-
chr19,12679855,1.2919797432694153,626,403,1029,-
chr19,12679858,1.390571702646604,605,438,1043,-
chr19,12679915,3.4824023805425086,654,530,1184,-
chr19,12681649,3.5831729556773055,877,632,1509,-
chr19,12730854,1.8238598653645584,1398,795,2193,-
chr19,12730864,2.034712950600801,634,534,1168,-
chr19,12730865,0.5466522936878668,814,758,1572,-
chr19,12730915,2.4006128430588856,973,555,1528,-
chr19,12730939,1.0814636249071394,1305,859,2164,-
chr19,12730966,1.8711796770944757,1771,1414,3185,-
chr19,12730967,1.9655818540433925,1048,1013,2061,-
chr19,12731397,1.1987301587301586,1356,1049,2405,-
chr19,12731399,1.4134498465708658,1722,1418,3140,-
chr19,12731413,2.328329297820824,600,412,1012,-
chr19,12734321,1.8522947026542822,978,733,1711,-
chr19,12734485,1.5766022380467954,1106,982,2088,-
chr19,12734487,0.8949056655850616,3858,2497,6355,-
chr19,12734488,1.4244150051231177,1717,1476,3193,-
chr19,12734489,1.1013425627112103,3707,2407,6114,-
chr19,12734490,1.2795131667089774,6245,4668,10913,-
chr19,12734491,1.5969839908519152,2179,1759,3938,-
chr19,12734492,1.5969839908519152,2179,1759,3938,-
chr19,12734503,0.4996509790954847,799,632,1431,-
chr19,12734513,1.8074181818181818,653,549,1202,-
chr19,12734556,3.9474323625575902,890,534,1424,-
chr19,12796879,0.5795398923152227,591,453,1044,-
chr19,12796955,1.6736808403001078,2239,1516,3755,-
chr19,12796964,0.5737437965260546,1056,623,1679,-
chr19,12796988,0.4955654101995565,744,549,1293,-
chr19,12797130,1.7946100152846254,2766,2182,4948,-
chr19,12797131,1.7946100152846254,2766,2182,4948,-
chr19,12799881,1.1797634179822334,2751,2214,4965,-
chr19,12800203,1.3871543264942017,1554,1238,2792,-
chr19,12800251,1.4188182720953326,1904,1324,3228,-
chr19,12800257,1.5874183006535951,1246,1031,2277,-
chr19,12800258,1.506271909951589,3259,2206,5465,-
chr19,12800260,1.5054032157359691,5633,4113,9746,-
chr19,12800280,0.5481150793650794,1104,863,1967,-
chr19,12800281,1.8997460029246465,2302,1585,3887,-
chr19,12800294,1.9908786299329857,2138,1342,3480,-
chr19,12800296,1.932928294357963,2697,1744,4441,-
chr19,12801044,1.4201165980121315,1925,1320,3245,-
chr19,12801050,1.1853920610038353,7975,6502,14477,-
chr19,12801051,1.3082664373978143,9739,7810,17549,-
chr19,12801052,1.4805153060792922,3723,3011,6734,-
chr19,12801053,0.9876186747577567,2882,2403,5285,-
chr19,12801228,0.6749301425807838,1255,820,2075,-
chr19,12801235,1.4374962658880235,1963,1610,3573,-
chr19,12801750,2.9151048951048955,1096,857,1953,-
chr19,12801772,1.96737829643992,1831,1306,3137,-
chr19,12801782,1.8081932411498078,954,600,1554,-
chr19,12801792,2.0526315789473686,647,455,1102,-
chr19,12801799,1.7478417266187052,677,416,1093,-
chr19,12801803,0.8433912275537239,954,687,1641,-
chr19,12801804,0.8433912275537239,954,687,1641,-
chr19,12875589,1.6883903355613532,1355,1620,2975,-
chr19,12875590,1.6883903355613532,1355,1620,2975,-
chr19,12875599,0.8859740100787894,1345,1641,2986,-
chr19,12875635,0.5142857142857143,575,1119,1694,-
chr19,12875636,0.5142857142857143,575,1119,1694,-
chr19,12875685,25.992781363988232,996,1223,2219,-
chr19,12875686,26.849035513733696,885,1126,2011,-
chr19,12875829,2.622613333333333,1068,749,1817,-
chr19,12875831,2.622613333333333,1068,749,1817,-
chr19,12878532,2.192304591493823,611,476,1087,-
chr19,12878546,0.6318543800740214,997,666,1663,-
chr19,12878547,0.6146479633126517,1084,673,1757,-
chr19,12878549,1.0303128023218315,709,442,1151,-
chr19,12922811,4.282425670062963,657,444,1101,-
chr19,12924217,2.4481494960183623,708,547,1255,-
chr19,12924516,2.407196375591062,587,461,1048,-
chr19,12924693,2.3902087832973358,663,462,1125,-
chr19,12924694,2.5496088321563746,891,626,1517,-
chr19,12924784,2.3978779840848805,677,376,1053,-
chr19,12924785,2.3978779840848805,677,376,1053,-
chr19,12928573,1.1137614678899084,606,544,1150,-
chr19,12928574,1.1137614678899084,606,544,1150,-
chr19,12928767,0.3905426765015806,592,583,1175,-
chr19,12928768,0.3905426765015806,592,583,1175,-
chr19,12930256,2.955839587733363,518,496,1014,-
chr19,12954292,1.0456106349865886,2061,1528,3589,-
chr19,12954298,0.4559701492537314,1221,803,2024,-
chr19,12954325,1.5254237288135593,1052,766,1818,-
chr19,12954360,1.7463137996219282,744,574,1318,-
chr19,12954366,1.9529702970297032,788,605,1393,-
chr19,12954369,2.093990876199465,1347,1303,2650,-
chr19,12954370,1.9292353760567957,3459,2933,6392,-
chr19,12954372,2.046018902445509,2495,2221,4716,-
chr19,12954373,1.862972620599739,1298,1179,2477,-
chr19,12954497,1.5451830443159922,1118,691,1809,-
chr19,12954510,0.5869123100849383,1114,642,1756,-
chr19,12956882,1.6409897292250235,1044,713,1757,-
chr19,12956911,1.8257615894039732,1450,1207,2657,-
chr19,12956913,1.777124716469171,2034,1782,3816,-
chr19,12956917,1.7845134442701225,1465,1082,2547,-
chr19,12956937,1.9477762803234504,983,847,1830,-
chr19,12956938,1.9477762803234504,983,847,1830,-
chr19,12956995,3.0411082943715364,1183,855,2038,-
chr19,12957038,4.017687464699823,917,607,1524,-
chr19,12957040,2.5493905201771434,835,647,1482,-
chr19,12957041,2.8492289545852896,725,410,1135,-
chr19,12957073,6.130678140005203,904,423,1327,-
chr19,13116180,1.0498336661696217,761,546,1307,-
chr19,14106778,2.2327354394029504,1960,1612,3572,-
chr19,14106779,2.3885751456195856,1187,1090,2277,-
chr19,14106790,1.3079156709866153,992,637,1629,-
chr19,14106794,2.0773554633732467,1903,1292,3195,-
chr19,14106795,2.049400178113049,1348,908,2256,-
chr19,14106796,2.049400178113049,1348,908,2256,-
chr19,14106802,1.3444782817211915,776,457,1233,-
chr19,14106808,2.925128205128205,1115,584,1699,-
chr19,14106809,3.0701797127699413,1756,936,2692,-
chr19,14106810,3.136865342163356,1469,754,2223,-
chr19,14106811,3.668177339901478,1431,699,2130,-
chr19,14106813,3.835164835164835,697,324,1021,-
chr19,14126227,4.288169832356521,634,446,1080,-
chr19,14409817,2.1927572976019367,640,507,1147,-
chr19,14419322,1.5928712466807382,658,772,1430,-
chr19,14419323,2.1214557593116083,721,654,1375,-
chr19,14477810,10.086496112445229,760,564,1324,-
chr19,14477811,10.440217050119367,602,410,1012,-
chr19,14480704,1.9211482558139532,621,383,1004,-
chr19,14480705,1.3283375485063986,1077,648,1725,-
chr19,14480761,3.569054613950406,724,532,1256,-
chr19,14491685,5.054905940021916,750,628,1378,-
chr19,14491686,5.662213562294904,765,654,1419,-
chr19,14514905,2.6341123327098184,706,516,1222,-
chr19,14514912,4.596114720542211,1152,861,2013,-
chr19,14515619,0.9334649265019304,627,376,1003,-
chr19,14515829,28.27303762935905,1127,1471,2598,-
chr19,14515831,22.379026534853786,2433,2678,5111,-
chr19,14515832,23.575305433749453,1415,1220,2635,-
chr19,14515835,34.9709536412162,2282,1023,3305,-
chr19,14515836,34.970953641216184,2282,1023,3305,-
chr19,14516045,0.4431779322922604,971,565,1536,-
chr19,14516046,0.4449348230912875,1212,774,1986,-
chr19,14516673,2.664447242381693,1161,823,1984,-
chr19,14516782,1.0247660979636763,587,473,1060,-
chr19,14516784,1.0247660979636763,587,473,1060,-
chr19,14516998,3.5475349323427166,634,451,1085,-
chr19,14518331,0.8528152260111023,565,484,1049,-
chr19,14518332,0.8528152260111023,565,484,1049,-
chr19,14518342,1.3044051204819278,532,497,1029,-
chr19,14518343,2.733872037655483,1159,1042,2201,-
chr19,14518344,2.733872037655483,1159,1042,2201,-
chr19,14566211,2.469070693738151,666,575,1241,-
chr19,14566244,1.9022134074025072,923,699,1622,-
chr19,14566857,10.433806146572104,678,422,1100,-
chr19,14566921,2.621165062245195,927,703,1630,-
chr19,14621707,1.4034886280739165,2481,1690,4171,-
chr19,14621715,1.5621222857094494,6245,4586,10831,-
chr19,14621716,1.6032608695652173,1238,1007,2245,-
chr19,14621729,1.7741171403962102,1176,773,1949,-
chr19,14621736,1.8830409356725142,643,503,1146,-
chr19,14621759,1.7139479905437351,724,422,1146,-
chr19,14621896,1.5396636481241917,1101,772,1873,-
chr19,14621921,1.6482334869431643,695,433,1128,-
chr19,14621965,4.66327589713258,582,433,1015,-
chr19,14622008,1.2329426545401627,599,405,1004,-
chr19,14622116,1.5606152475059296,3231,2655,5886,-
chr19,14622126,1.5919965202261852,975,835,1810,-
chr19,14622136,1.7030520256326709,783,593,1376,-
chr19,14622157,0.9687924016282223,883,736,1619,-
chr19,14622158,0.9687924016282223,883,736,1619,-
chr19,17232291,1.0544571626777663,759,464,1223,-
chr19,17232292,1.0544571626777663,759,464,1223,-
chr19,17240703,1.2824120603015077,637,397,1034,-
chr19,17240704,1.2824120603015077,637,397,1034,-
chr19,17244984,1.193146111815122,836,603,1439,-
chr19,17244988,1.8630873593182875,1111,776,1887,-
chr19,17244991,0.462921125285047,610,469,1079,-
chr19,17402981,0.4490395347471069,545,586,1131,-
chr19,17402984,4.749140302867412,1431,1800,3231,-
chr19,17402987,10.218871474971783,2661,2797,5458,-
chr19,17402988,3.401811867733655,930,894,1824,-
chr19,17403003,8.557999419279907,1240,860,2100,-
chr19,17403004,5.177694543937672,6627,4996,11623,-
chr19,17403005,5.177694543937672,6627,4996,11623,-
chr19,17403006,4.432273958174919,5387,4136,9523,-
chr19,17403019,2.195539202410777,1093,670,1763,-
chr19,17403103,0.5797979797979798,573,560,1133,-
chr19,17403143,1.9830914407545548,1993,1652,3645,-
chr19,17403154,3.9439741328630222,918,809,1727,-
chr19,17403155,4.506229968828199,2779,2085,4864,-
chr19,17403156,6.090534979423867,739,512,1251,-
chr19,17403180,3.197725284339457,730,380,1110,-
chr19,17403217,14.636779075063137,1158,834,1992,-
chr19,17403269,0.4185903354878424,1631,1025,2656,-
chr19,17403285,0.7015064102564103,1526,1039,2565,-
chr19,17403317,1.1472592055163733,3215,2399,5614,-
chr19,17403323,1.3914980584508476,1153,698,1851,-
chr19,17403703,1.6498316498316499,811,593,1404,-
chr19,17403737,1.7452982810920123,1262,689,1951,-
chr19,17404173,1.4789941972920695,1415,1033,2448,-
chr19,17404187,1.7455242966751918,727,543,1270,-
chr19,17404429,1.8776623967255364,2251,1335,3586,-
chr19,17404430,1.408428123229463,3515,2253,5768,-
chr19,17404436,2.150316726587913,784,530,1314,-
chr19,17405309,1.1757108634763633,1810,1404,3214,-
chr19,17405342,1.5415197806502154,925,850,1775,-
chr19,17405359,1.7773403324584427,716,507,1223,-
chr19,17405360,1.5235013623978202,851,733,1584,-
chr19,17405362,3.5727272727272723,654,449,1103,-
chr19,17405363,2.2671286203674867,786,675,1461,-
chr19,17405368,1.5529411764705885,951,577,1528,-
chr19,17405453,2.0740114903683677,721,537,1258,-
chr19,17405526,1.9451757782251822,784,586,1370,-
chr19,17405555,1.6129812162916124,1061,848,1909,-
chr19,17405565,1.3675336691682944,738,547,1285,-
chr19,17405576,1.0846222522659579,1276,897,2173,-
chr19,17405626,1.4714906116812092,915,526,1441,-
chr19,17405627,1.4909421663003108,842,473,1315,-
chr19,18307035,0.7600109897657805,2212,1687,3899,-
chr19,18307146,1.7733234191333511,2037,2038,4075,-
chr19,18307329,1.3438970309880482,2484,1680,4164,-
chr19,18307377,1.6134680134680135,1197,956,2153,-
chr19,18307384,1.419296905794245,3408,2536,5944,-
chr19,18307385,1.419296905794245,3408,2536,5944,-
chr19,18307419,1.7835685848715166,4899,2762,7661,-
chr19,18307420,1.8443949821655368,6664,3908,10572,-
chr19,18307428,2.6842105263157903,1583,911,2494,-
chr19,18307497,1.3854562016092304,1013,940,1953,-
chr19,18307499,0.6026140793396011,875,622,1497,-
chr19,18307527,1.6919540488791807,1830,1195,3025,-
chr19,18307532,2.816031280547409,553,464,1017,-
chr19,18307550,1.7041316526610646,627,475,1102,-
chr19,18307551,0.9319548378013716,3235,2189,5424,-
chr19,18307552,1.5908769281569886,949,730,1679,-
chr19,18307553,0.5755027546645519,2199,1362,3561,-
chr19,18309709,1.872387238723872,1149,908,2057,-
chr19,18309710,1.872387238723872,1149,908,2057,-
chr19,18309712,1.7806240775880249,888,526,1414,-
chr19,18309784,0.6502876084625134,919,788,1707,-
chr19,18312673,1.581555699202758,2201,1427,3628,-
chr19,18312687,1.2098340938055983,3953,3470,7423,-
chr19,18312689,0.9931054917797425,2826,2442,5268,-
chr19,18316035,1.5553102633887557,5555,3957,9512,-
chr19,18316036,1.4368199127585697,2646,1890,4536,-
chr19,18316048,1.8272592592592594,880,674,1554,-
chr19,18316053,0.5950986373805165,1008,893,1901,-
chr19,18316058,1.9332885229373216,766,540,1306,-
chr19,18316060,0.3278128005128753,766,572,1338,-
chr19,18316061,0.37082673238279645,789,740,1529,-
chr19,18323052,2.1005306577256686,1465,883,2348,-
chr19,18323053,0.5845641646489105,1043,943,1986,-
chr19,18323054,0.5845641646489105,1043,943,1986,-
chr19,18323075,1.5446350587498558,1364,1016,2380,-
chr19,18323076,1.542453097389944,1887,1284,3171,-
chr19,18323077,1.5446350587498558,1364,1016,2380,-
chr19,18323106,0.5618271502360708,657,378,1035,-
chr19,18531991,3.220132572837984,632,498,1130,-
chr19,18531993,3.220132572837984,632,498,1130,-
chr19,18532111,1.8672489126912353,809,504,1313,-
chr19,18532763,1.809609250398724,625,417,1042,-
chr19,18532787,0.687529383334549,1201,729,1930,-
chr19,18533327,1.0730833737782064,735,583,1318,-
chr19,18538260,2.17029890651903,1083,725,1808,-
chr19,18541696,4.24537037037037,916,458,1374,-
chr19,18541830,2.1887219116123617,903,838,1741,-
chr19,18541836,5.888865874702536,1785,1332,3117,-
chr19,18541837,4.560416698927722,1873,1339,3212,-
chr19,18541839,3.0756319588624543,1471,955,2426,-
chr19,18541990,0.9506919556870631,942,1443,2385,-
chr19,18541991,0.9082558139534884,875,1074,1949,-
chr19,18541992,1.3789938434616962,1703,2465,4168,-
chr19,18541993,1.6357091156178545,1058,1401,2459,-
chr19,18541994,1.6352941176470588,555,679,1234,-
chr19,18543498,11.225070817196801,1055,977,2032,-
chr19,18543499,9.218496795385363,2132,2157,4289,-
chr19,18543500,9.218496795385363,2132,2157,4289,-
chr19,18543501,9.173492829574215,1776,1792,3568,-
chr19,18543518,6.890610353220876,895,419,1314,-
chr19,18543519,7.49767441860465,867,300,1167,-
chr19,18543520,7.49767441860465,867,300,1167,-
chr19,18899930,0.27365334156505633,590,417,1007,-
chr19,18899943,2.184811620983472,1198,763,1961,-
chr19,18899944,2.184811620983472,1198,763,1961,-
chr19,18903388,1.6264501160092808,700,430,1130,-
chr19,18903398,1.7329700272479565,635,366,1001,-
chr19,18904840,0.8302614993954389,934,750,1684,-
chr19,18904841,0.2900188341656409,1041,827,1868,-
chr19,18907055,0.4017591618777794,662,499,1161,-
chr19,18913003,2.5756830601092897,856,609,1465,-
chr19,18913004,2.5756830601092897,856,609,1465,-
chr19,18919268,1.9626919733410604,820,492,1312,-
chr19,18919271,1.7547348484848482,762,447,1209,-
chr19,18919286,1.987878787878788,655,362,1017,-
chr19,18919347,2.326434663121798,1167,715,1882,-
chr19,18919359,1.0457680835197614,862,446,1308,-
chr19,18919361,1.0457680835197614,862,446,1308,-
chr19,18919368,2.7283958570446596,1019,604,1623,-
chr19,18919370,2.072481050696232,615,425,1040,-
chr19,19025529,0.7645493847688726,604,484,1088,-
chr19,19025530,0.7645493847688726,604,484,1088,-
chr19,19025531,0.7645493847688726,604,484,1088,-
chr19,29207385,1.6777507434441739,641,410,1051,-
chr19,29207557,2.450590832359434,1347,905,2252,-
chr19,29207624,1.5963473494764395,1164,763,1927,-
chr19,29207740,1.9587020648967552,829,564,1393,-
chr19,29207827,1.9457574140428453,2489,2017,4506,-
chr19,29207830,1.3190364950129971,2374,1877,4251,-
chr19,29207837,1.77580132285628,2237,1740,3977,-
chr19,29207858,1.5683076923076926,1698,1169,2867,-
chr19,29207864,1.6275151995742114,3309,1979,5288,-
chr19,29207870,1.8512155891457442,4383,2816,7199,-
chr19,29207871,1.8170658245931424,4133,2387,6520,-
chr19,29207892,1.618030759026106,2357,1367,3724,-
chr19,29207898,0.8829951959344108,1667,848,2515,-
chr19,29207900,0.8829951959344108,1667,848,2515,-
chr19,29207906,2.6465922444183314,1286,665,1951,-
chr19,29207908,2.6465922444183314,1286,665,1951,-
chr19,29207909,1.4601827119345296,1311,794,2105,-
chr19,29208081,0.7740729030787501,3694,2860,6554,-
chr19,29208131,0.6204710144927535,684,505,1189,-
chr19,29208136,3.042460391606166,655,599,1254,-
chr19,33387117,1.531770934171254,601,446,1047,-
chr19,33490013,0.3622887296791018,652,538,1190,-
chr19,35499983,0.3849902040301382,1525,842,2367,-
chr19,35505963,0.6059716103768967,618,453,1071,-
chr19,35510201,2.120722891566265,1353,829,2182,-
chr19,35510202,2.120722891566265,1353,829,2182,-
chr19,35510203,2.120722891566265,1353,829,2182,-
chr19,36114398,2.3751914241960184,692,652,1344,-
chr19,36114399,2.5757855523526407,985,851,1836,-
chr19,38815546,4.090236686390534,868,571,1439,-
chr19,38815948,2.0743597985642346,967,548,1515,-
chr19,38815950,1.682030935840404,1690,1165,2855,-
chr19,38815951,1.2384650947757745,723,617,1340,-
chr19,38831103,0.36970899470899465,558,503,1061,-
chr19,38831142,0.4286574352799519,711,452,1163,-
chr19,38831341,2.3170682822449247,3273,2932,6205,-
chr19,38831342,2.3170682822449247,3273,2932,6205,-
chr19,38831351,2.9897889052528237,822,678,1500,-
chr19,38831371,1.6835074083070196,716,536,1252,-
chr19,38831403,1.6885404568331397,670,491,1161,-
chr19,38831423,1.2679241007685527,1057,827,1884,-
chr19,38831749,1.2930041697001786,591,520,1111,-
chr19,38831750,1.536847661632723,815,668,1483,-
chr19,38831751,0.9867426400759736,763,674,1437,-
chr19,38836525,15.934767025422111,3789,3321,7110,-
chr19,38836526,19.556692913385827,1460,1396,2856,-
chr19,38836544,1.064297894082875,1194,921,2115,-
chr19,38836550,3.147851545681564,961,552,1513,-
chr19,38836565,1.8497536945812807,750,419,1169,-
chr19,38836758,2.0344846796657383,986,717,1703,-
chr19,38836765,1.8370300751879707,673,559,1232,-
chr19,38836773,2.2916666666666665,571,467,1038,-
chr19,38837403,2.108317214700193,762,516,1278,-
chr19,38838436,2.384868421052632,811,607,1418,-
chr19,38838439,2.1263112823806463,763,518,1281,-
chr19,38838442,1.812208448540476,2458,1409,3867,-
chr19,38838443,1.8935731684466928,1955,1185,3140,-
chr19,38838445,1.8208333333333333,1264,749,2013,-
chr19,38838463,0.6533305693753454,609,401,1010,-
chr19,38838467,0.9755169049941708,999,688,1687,-
chr19,38838469,0.9755169049941708,999,688,1687,-
chr19,38838475,1.7509850275807723,1110,516,1626,-
chr19,38838476,1.7509850275807723,1110,516,1626,-
chr19,38838596,2.0337855812716152,694,357,1051,-
chr19,38840168,1.9723865877712037,749,506,1255,-
chr19,38840198,1.8187526758955332,707,538,1245,-
chr19,38840200,0.8915824915824915,661,494,1155,-
chr19,38840207,1.079213014193226,643,425,1068,-
chr19,38844050,2.336940398317243,1685,1002,2687,-
chr19,38844052,2.336940398317243,1685,1002,2687,-
chr19,38844061,1.3849249288560481,4508,3265,7773,-
chr19,38844062,1.3462666678203985,2495,2126,4621,-
chr19,38844063,0.6953271070900594,6104,3286,9390,-
chr19,38844064,0.6953271070900594,6104,3286,9390,-
chr19,38844065,0.6953271070900594,6104,3286,9390,-
chr19,38844067,1.7022110386931768,1833,1425,3258,-
chr19,38844069,1.7022110386931768,1833,1425,3258,-
chr19,38844072,1.126764821769739,2614,1722,4336,-
chr19,38844074,1.5203518213208074,1426,1036,2462,-
chr19,38844080,0.6378896882494005,911,555,1466,-
chr19,38844081,0.5679140540756421,789,510,1299,-
chr19,38844087,1.734615384615385,655,415,1070,-
chr19,38844088,0.9236128511475479,1588,1017,2605,-
chr19,38844089,1.2249699467628368,1018,646,1664,-
chr19,38844095,1.138389451890596,673,398,1071,-
chr19,38844097,0.9155876258540127,1275,774,2049,-
chr19,38845732,2.453152906018792,853,441,1294,-
chr19,38846048,1.931397071821612,1305,808,2113,-
chr19,38846077,0.382157297508804,585,450,1035,-
chr19,38846078,0.382157297508804,585,450,1035,-
chr19,38847357,2.308759311584896,748,457,1205,-
chr19,38847375,0.5099832087900475,776,961,1737,-
chr19,38847394,0.3179670956181789,487,876,1363,-
chr19,38847395,0.39051606557368623,815,1221,2036,-
chr19,38847412,0.2880272796160646,542,1069,1611,-
chr19,38847413,0.2880272796160646,542,1069,1611,-
chr19,38847421,0.18871593460275227,539,1256,1795,-
chr19,38847422,0.1869063126426993,541,1159,1700,-
chr19,38847425,0.33109541857903585,553,1260,1813,-
chr19,38847426,0.3658256880733945,307,871,1178,-
chr19,38847430,1.9403433482998762,434,1274,1708,-
chr19,38847432,3.189649597981934,1084,2112,3196,-
chr19,38847433,4.306380145775547,764,1277,2041,-
chr19,38849938,1.2143564884378408,583,532,1115,-
chr19,39389517,2.814526639077997,797,652,1449,-
chr19,39389519,2.431226325757576,892,703,1595,-
chr19,39389520,2.415787918414114,1038,792,1830,-
chr19,39389521,5.476044865160563,793,608,1401,-
chr19,39433288,1.4731777101320984,15733,11742,27475,-
chr19,39433321,1.3027901041694279,33019,22965,55984,-
chr19,39433322,1.3027901041694279,33019,22965,55984,-
chr19,39433324,0.7843521419836975,12797,9606,22403,-
chr19,39433325,1.0879250526080744,42386,29915,72301,-
chr19,39433326,1.224221976667514,29589,20309,49898,-
chr19,39433372,1.4232212923507441,11490,9137,20627,-
chr19,39433384,1.5635760149734097,5670,3848,9518,-
chr19,39433391,1.6320029597799173,5197,3328,8525,-
chr19,39433713,1.2122658119053684,19520,14492,34012,-
chr19,39433749,1.392790009151101,7308,5715,13023,-
chr19,39435634,1.3236416147268821,6439,5190,11629,-
chr19,39435635,0.8606118758534155,4663,3475,8138,-
chr19,39435637,1.36917035478488,6272,5011,11283,-
chr19,39435664,1.400201922654844,3111,2397,5508,-
chr19,39435708,0.46539237558796276,1113,793,1906,-
chr19,39435911,1.0399208047988715,4982,3488,8470,-
chr19,39435912,1.0399208047988715,4982,3488,8470,-
chr19,39435915,1.2966216216216218,2051,1439,3490,-
chr19,39435917,1.3325508676817852,5258,3745,9003,-
chr19,39435920,0.6985058570404017,3869,3759,7628,-
chr19,39435921,0.8675051144660544,5808,5329,11137,-
chr19,39435924,0.7624316777508686,3183,2927,6110,-
chr19,39435939,0.5668269964195016,2070,2370,4440,-
chr19,39435940,0.5668269964195016,2070,2370,4440,-
chr19,39435945,1.4699916193926779,3554,2009,5563,-
chr19,39435947,1.283178936642486,5812,3796,9608,-
chr19,39435948,1.0191589517432214,1703,800,2503,-
chr19,39539235,13.93827150282873,1261,1329,2590,-
chr19,39539236,13.308028783014915,1411,1386,2797,-
chr19,39539237,13.889222785864565,1004,903,1907,-
chr19,39834711,1.96584440227704,665,526,1191,-
chr19,39834742,2.6158237241694255,715,460,1175,-
chr19,39834754,2.0714627151051626,1283,1045,2328,-
chr19,39834755,2.0714627151051626,1283,1045,2328,-
chr19,39834759,0.5313235908072236,1084,815,1899,-
chr19,39836568,1.8251946967190196,1389,1013,2402,-
chr19,39836579,3.28982128982129,583,428,1011,-
chr19,39836606,2.161344537815126,642,454,1096,-
chr19,39837730,2.0197965731591245,1303,1029,2332,-
chr19,39837739,0.5847995734574185,634,528,1162,-
chr19,39837837,3.8670568561872902,874,643,1517,-
chr19,39837838,3.8670568561872902,874,643,1517,-
chr19,39839048,0.5631080069842854,644,421,1065,-
chr19,39839191,0.5126657666957835,806,513,1319,-
chr19,39840285,0.5106048703849175,649,535,1184,-
chr19,39840443,0.360989985145431,792,1017,1809,-
chr19,39840446,2.025924325207583,2221,2867,5088,-
chr19,39840447,2.5353292109509935,1346,1844,3190,-
chr19,39840460,0.4429840574418886,1091,1493,2584,-
chr19,39840462,0.4429840574418886,1091,1493,2584,-
chr19,39840465,0.7941945453241445,1323,2100,3423,-
chr19,39840466,1.2200091423923591,2965,4430,7395,-
chr19,39840467,0.8812967562908464,2088,3253,5341,-
chr19,39840468,1.0920533123008347,3547,4964,8511,-
chr19,39840469,1.4125362377791162,2345,3611,5956,-
chr19,39840471,1.0601070934855572,1435,2036,3471,-
chr19,39840504,0.3405570959558966,1052,1509,2561,-
chr19,39840505,1.3400567279833648,1013,1417,2430,-
chr19,39840507,4.647322418049674,1288,1765,3053,-
chr19,39840508,9.344692005242463,619,871,1490,-
chr19,39840509,8.112834848310651,1131,1508,2639,-
chr19,39840510,6.406093119709183,1000,1092,2092,-
chr19,39840511,9.613696224758561,583,535,1118,-
chr19,39840698,8.937706853239003,1521,1109,2630,-
chr19,39840699,9.654754185503368,1594,1104,2698,-
chr19,39840700,9.344089627638551,1250,831,2081,-
chr19,39840710,4.018402339700975,741,408,1149,-
chr19,39840711,5.167717377716381,979,454,1433,-
chr19,39840712,5.167717377716381,979,454,1433,-
chr19,39840781,2.7099391480730217,667,434,1101,-
chr19,39840782,2.7099391480730217,667,434,1101,-
chr19,39846315,2.3179881243450926,705,408,1113,-
chr19,39846316,2.662764559635895,991,631,1622,-
chr19,40447898,2.454278376649125,1511,1329,2840,-
chr19,40447900,2.902127659574468,571,610,1181,-
chr19,40447977,0.9486058601134216,517,528,1045,-
chr19,40447979,1.3757505926847857,735,689,1424,-
chr19,41958329,1.9626540974295628,986,642,1628,-
chr19,45609493,6.51250760542321,1402,1852,3254,-
chr19,45609499,5.17523247868402,2754,3140,5894,-
chr19,45609500,5.17523247868402,2754,3140,5894,-
chr19,45609537,21.63800895308239,4146,2114,6260,-
chr19,45609538,24.110527389365295,5527,2273,7800,-
chr19,45609539,24.38542029990955,6558,2389,8947,-
chr19,45609540,43.91959378860862,6200,1511,7711,-
chr19,45609541,21.267430897556924,5156,622,5778,-
chr19,45609542,14.780518044647287,4674,510,5184,-
chr19,45609543,17.306650562478637,4566,465,5031,-
chr19,45609544,29.870499448466145,2572,251,2823,-
chr19,45609650,2.901076192958051,929,660,1589,-
chr19,45613616,0.39547700246943596,754,737,1491,-
chr19,45613649,6.4455362664430105,1052,993,2045,-
chr19,45613652,14.92377217381872,2258,1713,3971,-
chr19,45613653,13.08440994695236,2240,1770,4010,-
chr19,45613654,15.601977384510693,2635,1992,4627,-
chr19,45613655,12.056313692044752,1124,877,2001,-
chr19,45615875,1.5184553966782115,806,637,1443,-
chr19,45619142,3.1649739323372805,603,457,1060,-
chr19,45621258,0.2850669049223421,615,427,1042,-
chr19,45621631,4.715252068118652,918,845,1763,-
chr19,45621632,4.715252068118652,918,845,1763,-
chr19,45624741,2.0803089300722344,734,419,1153,-
chr19,45634452,0.34088356594338237,562,473,1035,-
chr19,45687617,1.8004722550177095,1349,1088,2437,-
chr19,45687638,1.3696835908756435,2496,1509,4005,-
chr19,45687659,1.4281021897810218,1676,1369,3045,-
chr19,45687719,1.560695334764945,4050,2499,6549,-
chr19,45688495,1.6424106424022977,6800,4919,11719,-
chr19,45688499,1.4019168179022994,1437,1092,2529,-
chr19,45688503,2.3693717277486908,1292,954,2246,-
chr19,45688518,1.4449861981786756,1671,1313,2984,-
chr19,45688555,1.5001777251184834,1100,843,1943,-
chr19,45691914,1.6348657109902784,1352,1070,2422,-
chr19,45691921,1.592826172644856,897,589,1486,-
chr19,45691922,1.6775627044711012,1160,916,2076,-
chr19,45691930,0.5688073394495413,619,544,1163,-
chr19,45691933,0.881631817489336,961,767,1728,-
chr19,45691941,0.9950835791543756,659,564,1223,-
chr19,45691943,0.9950835791543756,659,564,1223,-
chr19,46733097,3.501490757304711,733,558,1291,-
chr19,46733102,2.825910931174089,697,512,1209,-
chr19,46733106,0.27886374028349337,696,485,1181,-
chr19,46733112,1.7211923367455915,1210,700,1910,-
chr19,46774982,1.7543859649122808,649,626,1275,-
chr19,46774985,2.2635563380281694,896,709,1605,-
chr19,46774988,0.9778726708074534,915,895,1810,-
chr19,46774989,0.8574315333668661,1697,1505,3202,-
chr19,46775009,1.8628296428174027,1134,835,1969,-
chr19,46775010,1.8628296428174027,1134,835,1969,-
chr19,46775171,1.775381850853549,683,476,1159,-
chr19,46775174,1.4669302659956864,741,427,1168,-
chr19,46775175,2.5464632454923724,611,411,1022,-
chr19,46775194,1.9387253820456556,1013,629,1642,-
chr19,46775272,1.5945409429280397,755,619,1374,-
chr19,46775302,2.3185975609756095,844,655,1499,-
chr19,46775442,1.8562116937445279,635,540,1175,-
chr19,46775521,0.5029201817001947,774,602,1376,-
chr19,46775570,1.2462810423624557,1043,774,1817,-
chr19,46775722,1.8847016120422757,678,492,1170,-
chr19,46776998,1.8392461197339247,710,491,1201,-
chr19,46777001,0.5571026722925457,698,473,1171,-
chr19,46777040,1.8302277432712215,747,482,1229,-
chr19,46777262,1.4654565721806745,1422,1216,2638,-
chr19,46777265,1.7551994544834641,791,418,1209,-
chr19,46777267,2.3118367346938773,707,587,1294,-
chr19,46777306,2.2767676767676766,643,494,1137,-
chr19,46777381,2.674285714285714,701,419,1120,-
chr19,46778758,1.9951373788183198,1007,881,1888,-
chr19,46778818,1.874382207578253,860,606,1466,-
chr19,46778844,2.664538153244378,2207,1651,3858,-
chr19,46778860,2.087380095923262,732,555,1287,-
chr19,46778906,4.152229299363056,1271,784,2055,-
chr19,46782400,1.4601590515875482,2690,1689,4379,-
chr19,46782405,1.5013927576601669,1175,717,1892,-
chr19,46782414,0.5261083743842364,1067,664,1731,-
chr19,46782420,0.5068510530322253,798,562,1360,-
chr19,46782442,1.9669030732860517,831,563,1394,-
chr19,46782448,3.7041984732824416,646,523,1169,-
chr19,46782466,1.735985533453888,703,552,1255,-
chr19,46782521,2.8465220284113073,5556,4479,10035,-
chr19,46782522,2.8465220284113073,5556,4479,10035,-
chr19,46782523,2.725740151345221,3483,2677,6160,-
chr19,46784143,2.561068262921607,823,510,1333,-
chr19,46784557,0.5645581843332064,1355,983,2338,-
chr19,46784558,2.0953773478798783,620,522,1142,-
chr19,46787421,1.7233233233233236,806,554,1360,-
chr19,46787436,1.809706445606235,1308,888,2196,-
chr19,46787446,0.4692526465989854,1127,728,1855,-
chr19,46787447,1.736676292990286,629,585,1214,-
chr19,46787449,1.736676292990286,629,585,1214,-
chr19,46787702,1.6921992221787685,781,706,1487,-
chr19,46787703,2.2879841112214496,575,476,1051,-
chr19,46787734,7.891110137310164,1931,1389,3320,-
chr19,46787735,7.901269755798034,1940,1317,3257,-
chr19,46787736,8.323928262168314,1700,1097,2797,-
chr19,46788082,1.532022717343818,796,653,1449,-
chr19,46788110,1.886590584878745,1057,700,1757,-
chr19,46788148,1.7926853508248854,621,558,1179,-
chr19,46788153,1.5289772727272728,896,559,1455,-
chr19,46788155,0.66456685102056,811,660,1471,-
chr19,46788156,1.7018878557340096,603,506,1109,-
chr19,46788182,1.2219619220477032,1413,949,2362,-
chr19,46788221,2.025052503204819,1221,800,2021,-
chr19,46788260,2.116993363173329,1015,681,1696,-
chr19,46788262,2.116993363173329,1015,681,1696,-
chr19,46788273,1.2208924441835765,879,598,1477,-
chr19,46788555,3.781669463087249,948,297,1245,-
chr19,46788557,3.688282962666982,1180,423,1603,-
chr19,46788583,5.540289056630998,768,312,1080,-
chr19,46788590,10.178289760348582,776,304,1080,-
chr19,46830628,0.7589204882464958,852,621,1473,-
chr19,46830631,0.7267878605769231,674,511,1185,-
chr19,46830634,2.2323474806121415,722,537,1259,-
chr19,46838389,3.2658982511923687,746,443,1189,-
chr19,46838390,3.2658982511923687,746,443,1189,-
chr19,46838400,1.0244042492104506,891,485,1376,-
chr19,46838402,1.7722222222222224,835,455,1290,-
chr19,46839564,1.7077847956776497,915,772,1687,-
chr19,46839570,1.7242405261509552,1000,617,1617,-
chr19,46850771,7.658344470204222,2544,1893,4437,-
chr19,46850772,7.658344470204222,2544,1893,4437,-
chr19,46850773,9.450892857142858,656,503,1159,-
chr19,46850832,2.4760729839610924,817,564,1381,-
chr19,48123000,4.984471358062908,806,614,1420,-
chr19,48123001,4.766491066653859,932,754,1686,-
chr19,48382667,12.834815815674459,2572,2243,4815,-
chr19,48382668,12.92455553067873,3126,2603,5729,-
chr19,48382669,12.92455553067873,3126,2603,5729,-
chr19,48383273,2.0524272710800933,2648,1771,4419,-
chr19,48383275,2.291666666666667,1770,1195,2965,-
chr19,48384261,2.0070994655504073,946,700,1646,-
chr19,48384378,2.5150787552823664,902,547,1449,-
chr19,48384380,2.5150787552823664,902,547,1449,-
chr19,48389662,0.3160948222083593,562,457,1019,-
chr19,48389671,0.35981087271215756,1118,894,2012,-
chr19,48389673,4.660847880299253,622,400,1022,-
chr19,48389701,2.004223039024009,1191,672,1863,-
chr19,48389703,2.183089797032561,1663,1077,2740,-
chr19,48390445,0.5669056811913955,570,517,1087,-
chr19,48390521,2.205973936108869,796,597,1393,-
chr19,48390522,0.4657710989678202,721,487,1208,-
chr19,48390523,1.208134978363215,1841,1396,3237,-
chr19,48615380,1.2351161576639882,7032,5816,12848,-
chr19,48615381,1.5563622570327238,3932,3559,7491,-
chr19,48615420,1.2914240338803602,2090,1888,3978,-
chr19,48615421,1.5139469074248757,2246,1809,4055,-
chr19,48616135,1.384924244286569,3595,2140,5735,-
chr19,48616143,1.4784200099583655,4853,3561,8414,-
chr19,48616144,1.4784200099583655,4853,3561,8414,-
chr19,48616793,1.3068413313409153,3000,2598,5598,-
chr19,48616794,0.7771307727821049,2898,2426,5324,-
chr19,48616814,1.2896824371463271,4036,2518,6554,-
chr19,48616816,1.5149125736142308,6048,4705,10753,-
chr19,48616817,1.4839987357381594,12668,9328,21996,-
chr19,48617421,1.2814315186054963,16173,11986,28159,-
chr19,48617423,1.2129724741374586,6840,4400,11240,-
chr19,48617424,0.8664168715119045,1122,818,1940,-
chr19,48617809,1.3403201584039182,8972,5822,14794,-
chr19,48617812,1.4560791988028088,4391,2481,6872,-
chr19,48617815,1.339618230094298,11336,6814,18150,-
chr19,48617816,0.9831371845862944,6185,4703,10888,-
chr19,48617817,1.2197604691031325,17008,11687,28695,-
chr19,48617818,1.2477871939736347,3117,2159,5276,-
chr19,48617858,1.3639110569600974,2053,1674,3727,-
chr19,48617860,1.331466431382182,9012,6192,15204,-
chr19,48617861,1.0318551457789382,5232,3063,8295,-
chr19,48617862,1.6911821086261982,3780,3129,6909,-
chr19,48617872,1.3903437941018142,2749,2181,4930,-
chr19,48617874,1.3903437941018142,2749,2181,4930,-
chr19,48619151,1.7962653096429186,2146,1704,3850,-
chr19,48619153,1.7962653096429186,2146,1704,3850,-
chr19,48619155,1.7248338081671415,1452,857,2309,-
chr19,48619158,1.522664239902929,856,640,1496,-
chr19,48619159,1.4844807561376103,861,608,1469,-
chr19,48619165,1.657177363699103,1129,827,1956,-
chr19,48619166,1.5525925925925923,1047,569,1616,-
chr19,48619167,1.657177363699103,1129,827,1956,-
chr19,48619169,0.7528444969764301,1604,1215,2819,-
chr19,48619170,1.3703229905184318,1935,1458,3393,-
chr19,48619172,2.0685233199505286,1730,1150,2880,-
chr19,48619175,1.4165623193164163,2219,1189,3408,-
chr19,48619176,1.630190278119964,1615,869,2484,-
chr19,49447045,0.4644904271366556,1272,755,2027,-
chr19,49447849,0.2681903449606679,512,494,1006,-
chr19,49719989,2.8240816998846983,634,466,1100,-
chr19,50798453,3.1603960396039605,797,403,1200,-
chr19,50798454,3.1603960396039605,797,403,1200,-
chr19,50798455,3.1603960396039605,797,403,1200,-
chr19,50798871,0.19162491818023883,559,468,1027,-
chr19,51345215,0.3416337686000607,624,444,1068,-
chr19,51346930,1.756406869220608,830,756,1586,-
chr19,51346933,1.7145821325648412,803,693,1496,-
chr19,51346936,2.466666666666667,767,639,1406,-
chr19,51347002,2.655545832059566,2198,1563,3761,-
chr19,51347021,2.560578661844485,707,394,1101,-
chr19,51347053,1.925829383886256,601,421,1022,-
chr19,51350374,2.4878615702479343,740,483,1223,-
chr19,51353156,3.0570175438596485,696,398,1094,-
chr19,51353162,1.7563451776649743,691,393,1084,-
chr19,51353168,2.0763817503002784,1366,1004,2370,-
chr19,51353170,2.033299760795669,872,610,1482,-
chr19,51353224,1.2429962851522023,825,621,1446,-
chr19,51353286,2.2216861062933897,812,593,1405,-
chr19,51354202,1.7022792022792022,716,467,1183,-
chr19,51354302,2.215294333394461,754,573,1327,-
chr19,51354303,0.37588199513382003,726,547,1273,-
chr19,51366344,0.6064003286152895,1555,1215,2770,-
chr19,51366345,0.6038098375054897,646,593,1239,-
chr19,53224283,3.0236942675159235,773,784,1557,-
chr19,53224285,3.0236942675159235,773,784,1557,-
chr19,53224290,1.8457393400245663,856,672,1528,-
chr19,53224291,0.396986271986272,672,443,1115,-
chr19,53224548,0.4655267512410371,843,665,1508,-
chr19,55134132,1.2316632231404958,752,351,1103,-
chr19,55134134,0.9258908334211875,1113,564,1677,-
chr19,55141276,1.367684819080322,644,504,1148,-
chr19,55141280,1.5474399687984683,660,453,1113,-
chr19,55365625,14.123819129445437,815,1155,1970,-
chr19,55365634,6.309643465762895,1608,1669,3277,-
chr19,55365635,6.309643465762895,1608,1669,3277,-
chr19,55365641,10.52360410527575,1316,839,2155,-
chr19,55365642,10.52360410527575,1316,839,2155,-
chr19,55401579,1.3636349175636497,1142,919,2061,-
chr19,55401581,1.0431468422537213,1188,972,2160,-
chr19,55401650,1.6507610061867886,905,582,1487,-
chr19,55406947,0.33510243963977365,908,702,1610,-
chr19,55407629,2.0797221955083507,867,671,1538,-
chr19,55407638,3.347317229010312,563,500,1063,-
chr19,55407782,0.48036724335775877,1731,711,2442,-
chr19,55407786,1.0103092783505154,979,391,1370,-
chr19,55407787,1.0103092783505154,979,391,1370,-
chr19,58551667,1.9513030154489905,987,840,1827,-
chr19,58551730,0.5930230961053206,872,668,1540,-
chr19,58551918,0.5905934756976288,643,448,1091,-
chr19,58552102,2.4856304391823523,846,548,1394,-
chr19,58552181,1.9856378915202446,683,560,1243,-
chr19,58552299,1.6764514024787995,770,656,1426,-
chr19,58552341,1.711620791534337,1678,1235,2913,-
chr19,58552362,1.6917647058823526,718,543,1261,-
chr19,58552378,0.5223063973063974,729,593,1322,-
chr19,58552383,1.722629796839729,739,442,1181,-
chr19,58554057,0.1429546050905274,680,514,1194,-
chr19,58554087,1.3543706569174823,2117,1375,3492,-
chr19,58554089,1.1880173841059605,1601,905,2506,-
chr19,58554102,1.4970459571128074,903,806,1709,-
chr19,58555866,0.41841442953020136,664,595,1259,-
chr19,58555868,0.41841442953020136,664,595,1259,-
chr19,58555925,0.5058249527033755,634,912,1546,-
chr19,58555927,0.5058249527033755,634,912,1546,-
chr19,58555928,0.15459091702041056,408,1185,1593,-
chr19,58555930,0.15459091702041056,408,1185,1593,-
chr19,58555985,11.077087761881765,2051,2841,4892,-
chr19,58555986,12.328884259355075,2405,2935,5340,-
chr19,58555987,12.328884259355075,2405,2935,5340,-
chr19,58555988,17.618951071631624,1102,706,1808,-
chr19,58556001,34.14906410004744,952,182,1134,-
chr19,58556733,1.07105719237435,617,576,1193,-
chr19,58556734,1.07105719237435,617,576,1193,-
chr20,646734,2.21123595505618,614,444,1058,-
chr20,646972,0.7834476090014064,774,631,1405,-
chr20,646974,0.7834476090014064,774,631,1405,-
chr20,647187,5.248193626826845,721,469,1190,-
chr20,647300,2.2262996941896023,883,653,1536,-
chr20,647301,2.2262996941896023,883,653,1536,-
chr20,648212,2.1432472351476517,689,507,1196,-
chr20,648500,2.2601018090352825,1233,813,2046,-
chr20,648505,1.9881944444444444,1226,719,1945,-
chr20,648506,2.593275972093449,1780,1075,2855,-
chr20,1369664,1.3888812511761142,765,530,1295,-
chr20,1369723,6.7655472482692245,804,509,1313,-
chr20,1369833,3.262037037037037,541,479,1020,-
chr20,1369835,3.262037037037037,541,479,1020,-
chr20,2461746,1.403591660872489,2440,1828,4268,-
chr20,2461859,0.6984759671746775,992,852,1844,-
chr20,2461907,1.6183320811419986,717,604,1321,-
chr20,2461931,2.026701368806632,840,545,1385,-
chr20,2461937,2.328214885947954,1713,1285,2998,-
chr20,2463034,0.9745465250342077,2994,1967,4961,-
chr20,2463104,1.7948255888788776,580,456,1036,-
chr20,2463115,3.345814651175476,986,694,1680,-
chr20,2463116,1.5944567015995592,745,391,1136,-
chr20,2463209,3.0467926364447324,1104,648,1752,-
chr20,2463212,0.5368041582830315,673,496,1169,-
chr20,2463223,1.528412005185402,1767,1163,2930,-
chr20,2463797,2.4767080745341614,956,503,1459,-
chr20,2463828,1.5358864591769834,1047,602,1649,-
chr20,2467631,1.6994572591587516,1669,1473,3142,-
chr20,2467729,2.1729191012452915,2376,1930,4306,-
chr20,2467742,1.5825634392707564,1741,901,2642,-
chr20,2470701,1.3651347303128958,4650,3275,7925,-
chr20,2470710,1.1311346752169655,2308,1942,4250,-
chr20,2470751,2.902157799542854,6400,4349,10749,-
chr20,2470752,2.965594655712718,5648,3855,9503,-
chr20,2470765,1.5704888977528526,3768,2217,5985,-
chr20,2470766,1.4831143139748482,1311,1010,2321,-
chr20,2470767,1.493287654345019,1855,860,2715,-
chr20,2470786,1.4566789027417892,1198,653,1851,-
chr20,2470787,1.9772685754143557,738,350,1088,-
chr20,2470788,1.090506399305125,931,484,1415,-
chr20,2660802,2.4787515375153752,627,457,1084,-
chr20,3147988,2.931500644253778,607,430,1037,-
chr20,3147990,0.2885707441385014,757,485,1242,-
chr20,5100230,1.4235857870906627,615,472,1087,-
chr20,5100363,1.8690206824489608,1473,1497,2970,-
chr20,5100365,1.3966192468619243,1158,1194,2352,-
chr20,5100366,1.1470588235294117,758,758,1516,-
chr20,5100444,0.3814088598402324,605,404,1009,-
chr20,5115105,1.5147058823529411,1132,835,1967,-
chr20,5115307,1.4141156462585032,1662,1119,2781,-
chr20,5115349,1.5198537657392435,4766,3029,7795,-
chr20,5117523,1.942680119176598,1170,922,2092,-
chr20,5117643,1.3465455780003397,2003,1643,3646,-
chr20,5118808,1.7217783695812987,949,750,1699,-
chr20,5118852,1.7461734693877546,813,615,1428,-
chr20,5119694,1.3287539314184567,2108,1485,3593,-
chr20,5119710,1.5464404113052759,833,480,1313,-
chr20,5119860,2.7972222222222216,1006,431,1437,-
chr20,5119955,0.9374861683474169,5625,2227,7852,-
chr20,5119957,0.9499137176946708,11974,4679,16653,-
chr20,5941079,2.917074425744431,940,705,1645,-
chr20,5941081,3.101002028339626,1131,796,1927,-
chr20,13715077,3.0114729142499383,913,613,1526,-
chr20,13715080,2.496229973218801,1566,1024,2590,-
chr20,13715081,2.554901960784313,1302,883,2185,-
chr20,13715083,2.030217752675007,1261,811,2072,-
chr20,13715086,3.584368227634081,1499,893,2392,-
chr20,13715087,3.0351115949918346,1133,667,1800,-
chr20,13715088,2.8435817887175987,1658,983,2641,-
chr20,13717494,2.044735921650927,1102,952,2054,-
chr20,13717495,2.5392581888246633,1621,1383,3004,-
chr20,13717497,3.0880446927374305,1062,894,1956,-
chr20,13717509,1.8123707830078641,955,658,1613,-
chr20,13718972,2.8980087679778075,737,334,1071,-
chr20,17618614,1.4455062056486954,1481,1140,2621,-
chr20,17618617,1.5416181671728382,4259,3309,7568,-
chr20,17618620,1.4582848542998836,3884,3089,6973,-
chr20,17618621,1.4479517464261105,2896,2467,5363,-
chr20,17618626,1.7984810405239309,3630,2868,6498,-
chr20,17618627,1.7984810405239309,3630,2868,6498,-
chr20,17618628,1.8513535286302543,4735,3657,8392,-
chr20,17618630,1.7761899943423023,4476,3247,7723,-
chr20,17618632,1.7388233580894132,2170,1525,3695,-
chr20,17618643,0.631578947368421,607,455,1062,-
chr20,17618647,1.7469989015491434,871,586,1457,-
chr20,17618648,0.4448740546994939,651,408,1059,-
chr20,17619655,1.8894962064753484,1044,585,1629,-
chr20,17619657,2.299511002444988,626,408,1034,-
chr20,17620341,1.579604578563996,758,557,1315,-
chr20,17620346,1.8802105263157896,686,474,1160,-
chr20,17620356,1.1381074168797956,889,628,1517,-
chr20,17620357,0.926443190656248,1341,933,2274,-
chr20,17942365,2.0759534452901613,1051,800,1851,-
chr20,17942366,2.0759534452901613,1051,800,1851,-
chr20,17955398,1.4417960088691797,764,409,1173,-
chr20,21166216,0.8383957781120902,1632,1033,2665,-
chr20,21166217,0.8383957781120902,1632,1033,2665,-
chr20,21166392,1.1158471255493576,724,648,1372,-
chr20,23633786,0.5419585129310345,618,463,1081,-
chr20,23633938,2.602274059313093,1479,897,2376,-
chr20,23633939,2.4009608991392626,2772,1875,4647,-
chr20,23633940,2.19033999708157,1293,978,2271,-
chr20,23633973,1.5156096937689,646,442,1088,-
chr20,23635308,1.1990291262135924,1234,926,2160,-
chr20,23635309,1.0091217759978248,1836,1386,3222,-
chr20,23635347,1.4379908151769645,1519,1234,2753,-
chr20,23635348,1.7772151898734174,1637,1224,2861,-
chr20,23635350,1.8675536037199691,1078,789,1867,-
chr20,23635353,2.4774010852741473,978,664,1642,-
chr20,23637662,1.8805555555555553,676,575,1251,-
chr20,23637915,1.676806121819798,854,721,1575,-
chr20,24963036,1.4526280921608026,677,486,1163,-
chr20,24963076,0.4915132596065132,717,631,1348,-
chr20,28581532,1.7263953835439259,481,528,1009,-
chr20,28581534,0.47487336238730454,1190,898,2088,-
chr20,28581580,2.2896414236302474,725,541,1266,-
chr20,33372656,0.616173570019724,780,506,1286,-
chr20,33675943,17.28985180885054,1533,1227,2760,-
chr20,33675944,23.369293828246665,1071,871,1942,-
chr20,33675988,12.935633632408317,2174,1419,3593,-
chr20,33675989,12.935633632408317,2174,1419,3593,-
chr20,33676106,13.598082813474548,2020,1242,3262,-
chr20,33676107,14.083365905891172,1870,1034,2904,-
chr20,33676108,14.824370726259271,1774,1013,2787,-
chr20,33676275,1.8505537893549375,1621,1591,3212,-
chr20,33676277,1.717738454898576,2387,2316,4703,-
chr20,33676279,1.7443199890943792,1550,1491,3041,-
chr20,33676286,0.6191171697500811,544,473,1017,-
chr20,33676311,1.8331025729779622,774,641,1415,-
chr20,33676312,1.8331025729779622,774,641,1415,-
chr20,33676314,1.1381434760479434,830,621,1451,-
chr20,33676315,1.4109105576283147,635,421,1056,-
chr20,33676457,2.592500309536191,763,519,1282,-
chr20,33676458,3.233148638882197,681,505,1186,-
chr20,33752217,1.5650880070337994,1267,1206,2473,-
chr20,33752219,0.8773997903449082,7277,5543,12820,-
chr20,33752220,1.0821005860305535,6501,5027,11528,-
chr20,33752221,1.0394194756554307,1958,1779,3737,-
chr20,33752222,0.8596655471504412,3589,3051,6640,-
chr20,33752228,1.2848702622395745,1032,842,1874,-
chr20,33752229,1.3608406524466752,1052,796,1848,-
chr20,33752232,1.5342572245949664,2190,1644,3834,-
chr20,33752233,1.4747703009336754,1378,1043,2421,-
chr20,34089530,1.508400758072746,1504,1075,2579,-
chr20,34089633,0.7220233230110399,2239,1748,3987,-
chr20,34089634,2.6285948850631904,2545,1545,4090,-
chr20,34093727,1.7569965728240209,2058,1485,3543,-
chr20,34093728,1.7569965728240209,2058,1485,3543,-
chr20,34093730,1.43578125,1020,599,1619,-
chr20,34096691,1.9167938937746576,1387,934,2321,-
chr20,34098560,1.9638422296876947,1488,892,2380,-
chr20,34098582,2.510158013544018,833,442,1275,-
chr20,34098597,1.6934958547177261,836,595,1431,-
chr20,34098600,2.039897172236504,762,388,1150,-
chr20,34098604,1.9433275656005282,1378,918,2296,-
chr20,34098606,1.5937787325478796,2662,1634,4296,-
chr20,34098607,1.8954852200361183,1311,834,2145,-
chr20,34105503,1.0240774774402708,1625,1225,2850,-
chr20,34105504,1.0240774774402708,1625,1225,2850,-
chr20,34105507,0.9974728487886383,1372,980,2352,-
chr20,34105515,0.45512715735578557,1080,873,1953,-
chr20,34105533,2.0099988934636976,988,624,1612,-
chr20,34112213,0.6638127349702788,1080,610,1690,-
chr20,34280392,1.6366559485530547,1526,932,2458,-
chr20,34280673,0.5652387723030542,1428,1126,2554,-
chr20,34280697,1.4360664619830237,1115,790,1905,-
chr20,34280762,1.5245726495726497,1426,935,2361,-
chr20,34280843,2.0648301429306084,2035,1464,3499,-
chr20,34280969,1.5041831792162044,975,756,1731,-
chr20,34281046,1.4640347250930137,1573,819,2392,-
chr20,34281088,0.7069527896995708,2058,1630,3688,-
chr20,34281089,0.6124610901294194,5913,4162,10075,-
chr20,34281105,1.647490392453709,986,830,1816,-
chr20,34281127,2.488192830050165,1270,742,2012,-
chr20,34281160,1.749641281819631,802,606,1408,-
chr20,34285500,1.4103183126839938,2292,1563,3855,-
chr20,34285519,1.7949071520500093,1064,776,1840,-
chr20,34285532,1.6788534709333627,2382,1593,3975,-
chr20,34285536,1.7873194411137465,2085,1287,3372,-
chr20,34290435,1.4355785926137776,5297,3564,8861,-
chr20,34290437,1.7995951417004048,3555,2469,6024,-
chr20,34290446,0.6217096336499321,1263,879,2142,-
chr20,34290589,1.382810911899825,1504,910,2414,-
chr20,34290595,1.5306297476108797,960,741,1701,-
chr20,34290634,2.18848320062148,726,541,1267,-
chr20,34290768,2.014894151117061,1203,702,1905,-
chr20,34290780,1.9669598772207069,2722,1952,4674,-
chr20,34291480,2.0331415420023013,1261,789,2050,-
chr20,34291491,1.5217727674624226,842,695,1537,-
chr20,34291509,1.7106322519535877,1175,720,1895,-
chr20,34292378,1.7658050800044758,733,661,1394,-
chr20,34292381,0.664061428767311,834,662,1496,-
chr20,34292383,1.6157635467980298,687,601,1288,-
chr20,34292462,0.5815082230244686,762,553,1315,-
chr20,34292489,1.7173956661316208,900,711,1611,-
chr20,34292506,1.6755319148936172,890,563,1453,-
chr20,34294140,2.007746308399903,637,485,1122,-
chr20,34295420,2.3529411764705883,675,506,1181,-
chr20,34295421,0.3096774193548387,557,464,1021,-
chr20,34295423,1.9657498702646599,946,563,1509,-
chr20,34295424,0.6378916921099148,826,634,1460,-
chr20,34295447,0.5607695439739414,786,613,1399,-
chr20,34295530,2.3371670702179177,714,412,1126,-
chr20,34295545,2.1700593723494492,730,392,1122,-
chr20,34303293,2.014480408858603,945,586,1531,-
chr20,34303302,1.3036760857367982,1106,950,2056,-
chr20,34303333,2.5287572097548683,563,608,1171,-
chr20,34303342,2.016096230754449,859,563,1422,-
chr20,34303343,2.016096230754449,859,563,1422,-
chr20,34928480,12.978833638852592,2167,1650,3817,-
chr20,34928481,12.978833638852592,2167,1650,3817,-
chr20,34928482,13.972928614519041,1614,1219,2833,-
chr20,34929550,1.8070171799834334,10640,7993,18633,-
chr20,34929551,1.8070171799834334,10640,7993,18633,-
chr20,34929552,1.5155321193766382,14381,10665,25046,-
chr20,34929568,1.363840651863163,6923,4164,11087,-
chr20,34929569,1.0293123743519204,6352,3634,9986,-
chr20,34929571,1.012336560879032,6269,3673,9942,-
chr20,34929579,1.6028212141542382,3756,2152,5908,-
chr20,34929580,1.6028212141542382,3756,2152,5908,-
chr20,34929581,1.4829968190189184,2820,1649,4469,-
chr20,34929582,1.3941733945866073,4488,2899,7387,-
chr20,34929583,1.4389377333493918,1592,873,2465,-
chr20,34929586,1.526319167904562,2401,1447,3848,-
chr20,34929587,1.4751092874421685,2638,1561,4199,-
chr20,34929589,1.688179864565534,1846,1236,3082,-
chr20,34931354,0.5596465390279822,999,484,1483,-
chr20,34931356,1.9959677419354842,674,371,1045,-
chr20,34931357,0.6474645030425963,839,424,1263,-
chr20,34931363,0.3557159521726451,696,380,1076,-
chr20,34931367,1.7306812893273544,1623,1166,2789,-
chr20,34931368,2.1139367240688824,1241,907,2148,-
chr20,34935620,2.530364052752112,865,602,1467,-
chr20,34935630,2.1833912517349656,1613,1017,2630,-
chr20,34937008,1.8547944860192436,1407,1046,2453,-
chr20,34941805,1.5348628443918197,960,773,1733,-
chr20,34941806,1.0089489284085729,570,515,1085,-
chr20,34942546,0.43035001174536053,686,593,1279,-
chr20,34942548,0.4316896822363116,1071,850,1921,-
chr20,34942593,2.081151566110137,5531,3929,9460,-
chr20,34942598,1.7921740975184624,5365,4127,9492,-
chr20,34942599,1.3626140416828305,8211,6262,14473,-
chr20,34942607,1.4176791470369454,4573,3181,7754,-
chr20,34942609,1.4176791470369454,4573,3181,7754,-
chr20,34942610,0.6869756034594037,886,634,1520,-
chr20,34942623,1.4660550458715598,1597,1089,2686,-
chr20,34942946,1.9805426144149083,1313,711,2024,-
chr20,34942950,2.0404288586106767,1217,813,2030,-
chr20,34942955,1.5394269385233244,1189,995,2184,-
chr20,34942970,1.2339075461374887,1424,1005,2429,-
chr20,34942972,1.7521815008726005,1003,763,1766,-
chr20,34955755,1.834825439471923,620,458,1078,-
chr20,34955756,1.834825439471923,620,458,1078,-
chr20,35002867,1.600601899823212,729,473,1202,-
chr20,35003233,3.0692722016106386,614,550,1164,-
chr20,35006520,1.7322474948122901,737,516,1253,-
chr20,35021256,1.9026611476216604,678,478,1156,-
chr20,35279096,1.6564548304360216,774,483,1257,-
chr20,35279620,1.6926770708283314,516,538,1054,-
chr20,35279622,1.543366947405601,1451,940,2391,-
chr20,35279696,1.6541516245487364,947,553,1500,-
chr20,35279718,2.102479338842975,847,483,1330,-
chr20,35280107,0.9477694172464816,1695,1380,3075,-
chr20,35280109,1.084962838906643,2370,1886,4256,-
chr20,35280774,1.6374269005847952,869,512,1381,-
chr20,35280777,1.3420996954242255,1184,772,1956,-
chr20,35284195,3.354978354978355,681,461,1142,-
chr20,35284215,2.1804364303009596,1052,726,1778,-
chr20,35284258,0.5636743215031316,539,478,1017,-
chr20,35284761,0.589977260018,1248,999,2247,-
chr20,35626178,2.7566020313942747,648,360,1008,-
chr20,35626179,2.7566020313942747,648,360,1008,-
chr20,35626594,1.1040941881952135,1154,681,1835,-
chr20,35626595,4.979913549061506,764,559,1323,-
chr20,35626798,2.5806992595438714,653,478,1131,-
chr20,35630468,1.2147915102567064,1383,1192,2575,-
chr20,35630469,0.8103868943882885,774,754,1528,-
chr20,35630470,0.8103868943882885,774,754,1528,-
chr20,35630964,4.02046783625731,549,455,1004,-
chr20,35630965,2.694045673230802,909,660,1569,-
chr20,35631023,3.335327680141536,731,512,1243,-
chr20,35631162,2.9357551896921974,964,761,1725,-
chr20,35631163,2.9357551896921974,964,761,1725,-
chr20,35631318,2.3163146617692076,896,562,1458,-
chr20,35631348,4.345186487612419,681,437,1118,-
chr20,35631536,1.2489714446868472,834,638,1472,-
chr20,35631769,1.7141665870819072,866,655,1521,-
chr20,35632575,2.0458435023652415,798,651,1449,-
chr20,35664783,4.716000863410468,1358,1430,2788,-
chr20,35664784,4.605306603773585,796,847,1643,-
chr20,35664786,3.712727455277331,717,742,1459,-
chr20,35664789,5.17663850211199,1978,1609,3587,-
chr20,35664790,5.17663850211199,1978,1609,3587,-
chr20,35664799,2.635171973350116,1085,706,1791,-
chr20,35664800,2.6649809178795896,1788,1032,2820,-
chr20,35664801,2.793469387755102,648,384,1032,-
chr20,35664802,3.0595686840151286,864,484,1348,-
chr20,35672793,2.561247575953458,586,441,1027,-
chr20,35672794,2.561247575953458,586,441,1027,-
chr20,35681954,2.2342614181868057,904,950,1854,-
chr20,35681956,1.9889573157782965,1337,1384,2721,-
chr20,35681957,1.8491051280496327,1383,1200,2583,-
chr20,35681964,2.116046418567427,660,594,1254,-
chr20,35681965,2.45444059976932,979,866,1845,-
chr20,35681967,2.771828228865054,943,790,1733,-
chr20,35681969,3.293772279303837,615,501,1116,-
chr20,35704188,2.0767076175281036,731,576,1307,-
chr20,35704299,2.8755186721991697,769,481,1250,-
chr20,35704300,2.8755186721991697,769,481,1250,-
chr20,35704470,2.392060272384816,634,492,1126,-
chr20,35704519,2.3620738636363634,722,439,1161,-
chr20,35704525,0.4818119423472889,647,371,1018,-
chr20,35705324,0.4971084621739643,701,457,1158,-
chr20,35707135,3.39344262295082,629,426,1055,-
chr20,35707153,2.614635972300206,634,410,1044,-
chr20,35707184,1.331789356534238,959,685,1644,-
chr20,35714269,2.8704453441295548,708,455,1163,-
chr20,35714306,1.968250950570342,713,525,1238,-
chr20,35714315,1.914983164983165,636,395,1031,-
chr20,35714319,1.8533037358900488,980,682,1662,-
chr20,35714367,1.7301431127012523,666,558,1224,-
chr20,35721775,1.672992424242424,1522,959,2481,-
chr20,35721776,1.672992424242424,1522,959,2481,-
chr20,35721843,0.6251150701250879,887,625,1512,-
chr20,35721871,0.9970484762344005,868,625,1493,-
chr20,35729333,0.5162981536357419,754,534,1288,-
chr20,35729514,1.6404214602509328,1979,1406,3385,-
chr20,35729515,0.5241905296649823,658,547,1205,-
chr20,35732013,1.6500756705496915,10321,8126,18447,-
chr20,35732016,1.624434336904322,9380,5413,14793,-
chr20,35732017,1.8114894902924066,14125,9693,23818,-
chr20,35732025,1.8257731951562597,8130,6721,14851,-
chr20,35732026,1.574221989162917,14740,11338,26078,-
chr20,35732038,1.6241931510224197,3046,2254,5300,-
chr20,35732040,1.5504536956819115,2756,1445,4201,-
chr20,35732042,1.4282371418117368,5364,3790,9154,-
chr20,35732043,1.4890665384787527,12332,8118,20450,-
chr20,35732046,1.2412803577450866,10426,6351,16777,-
chr20,35732047,1.3476754497073669,11058,6694,17752,-
chr20,35732049,1.641778582755218,5596,3734,9330,-
chr20,35732121,2.0365784499054818,742,459,1201,-
chr20,35739010,1.7936969696969696,1056,824,1880,-
chr20,35739012,1.7936969696969696,1056,824,1880,-
chr20,35740578,1.8737045071101468,597,460,1057,-
chr20,35740859,1.7136842105263157,813,550,1363,-
chr20,35740875,0.7480929095354523,650,408,1058,-
chr20,35742138,0.7787756221292932,567,502,1069,-
chr20,35742140,0.7787756221292932,567,502,1069,-
chr20,35953888,0.8451343500363108,664,485,1149,-
chr20,35953890,0.8451343500363108,664,485,1149,-
chr20,35953900,1.574274032688232,899,583,1482,-
chr20,35953901,1.3667785056185757,801,568,1369,-
chr20,36045746,1.5320380854348945,1322,937,2259,-
chr20,36045777,2.174610591900312,606,427,1033,-
chr20,36045982,2.7056220718375847,692,451,1143,-
chr20,36046014,2.791208791208791,634,384,1018,-
chr20,36046421,1.598956824108954,889,594,1483,-
chr20,36046539,4.941421143847488,593,576,1169,-
chr20,36046541,8.096509098476634,1772,1440,3212,-
chr20,36046546,5.088307637941755,1871,1120,2991,-
chr20,36046547,5.885445372255867,1745,964,2709,-
chr20,36046553,5.356686257915973,705,373,1078,-
chr20,36046821,1.825134610554656,1142,1131,2273,-
chr20,36046823,1.5956880489752459,544,577,1121,-
chr20,36046830,4.599598331773211,1610,1360,2970,-
chr20,36046831,2.0839523233719124,935,826,1761,-
chr20,36046832,3.0687094522736102,1607,1159,2766,-
chr20,36046833,2.45291322445714,1500,1058,2558,-
chr20,36046839,9.166015850524364,1175,531,1706,-
chr20,36047225,2.381425593689343,1439,776,2215,-
chr20,36047227,2.5476773648648647,1402,739,2141,-
chr20,36047228,2.75939393939394,941,494,1435,-
chr20,36047263,1.6014182849446208,864,418,1282,-
chr20,36047313,0.16945529290853031,1373,694,2067,-
chr20,36047314,0.19684839349871158,4390,2636,7026,-
chr20,36047315,0.19684839349871158,4390,2636,7026,-
chr20,36047449,20.278070411734635,1737,1213,2950,-
chr20,36047450,23.121816534883394,2069,1484,3553,-
chr20,36047451,20.403097043406174,1306,989,2295,-
chr20,36047455,9.890266442546235,1073,405,1478,-
chr20,36047456,10.107282734168866,829,308,1137,-
chr20,36047680,0.4885204081632653,765,559,1324,-
chr20,36047699,2.8924103419516265,577,435,1012,-
chr20,36047700,2.8924103419516265,577,435,1012,-
chr20,36047831,3.5054622968292035,597,416,1013,-
chr20,36047934,0.40474103825019747,1783,1268,3051,-
chr20,36047935,0.45250717900791154,1168,797,1965,-
chr20,36048078,1.538768015521064,944,655,1599,-
chr20,36048079,1.8165413533834585,603,454,1057,-
chr20,36048415,0.3896940418679549,483,597,1080,-
chr20,36048418,27.505912071428398,4074,3945,8019,-
chr20,36048419,27.505912071428394,4074,3945,8019,-
chr20,36048601,1.6999554367201426,1030,679,1709,-
chr20,36048659,1.7201685274572662,653,404,1057,-
chr20,36049014,2.7739898989898992,844,494,1338,-
chr20,36049039,6.004796163069545,625,416,1041,-
chr20,36049386,2.4837209302325585,711,300,1011,-
chr20,36049555,0.6143356643356642,752,659,1411,-
chr20,36049574,0.36974831220992105,683,678,1361,-
chr20,36049595,7.583523057789341,2126,2137,4263,-
chr20,36049596,10.602989642184557,756,943,1699,-
chr20,36049597,8.867269769679325,2129,2165,4294,-
chr20,36049600,8.84454927493042,2972,1819,4791,-
chr20,36049601,10.807798663781158,3940,2180,6120,-
chr20,36049602,10.807798663781158,3940,2180,6120,-
chr20,36049603,17.608950943911136,2932,1470,4402,-
chr20,36049613,3.920388222404443,747,255,1002,-
chr20,36050143,2.304069602458741,1434,830,2264,-
chr20,36050145,2.7246051770862536,787,368,1155,-
chr20,36050587,7.1916269248661395,708,638,1346,-
chr20,36752807,1.2951341433160561,624,461,1085,-
chr20,36752833,1.4072729136697255,721,527,1248,-
chr20,36754815,2.035999003487793,933,891,1824,-
chr20,36754821,1.4896841276609702,810,708,1518,-
chr20,36754827,2.575330649798735,1377,939,2316,-
chr20,36754829,2.760873658444737,2045,1355,3400,-
chr20,36754830,2.645218188873602,1338,858,2196,-
chr20,36754834,1.6646661665416356,1267,1031,2298,-
chr20,36754835,1.651164832963805,2049,1648,3697,-
chr20,36758156,3.5868354430379745,643,394,1037,-
chr20,36758157,3.5868354430379745,643,394,1037,-
chr20,36771048,2.696055684454756,580,430,1010,-
chr20,36771049,2.696055684454756,580,430,1010,-
chr20,36771152,1.5632733782097634,640,508,1148,-
chr20,38128684,2.058725061197193,817,544,1361,-
chr20,38129165,2.470387164283223,757,585,1342,-
chr20,38129413,2.57803738317757,612,427,1039,-
chr20,38129414,2.57803738317757,612,427,1039,-
chr20,38129939,2.8058767014794626,748,503,1251,-
chr20,38129940,2.460426576152241,810,542,1352,-
chr20,38130092,6.568329539709444,1169,781,1950,-
chr20,38130094,6.568329539709443,1169,781,1950,-
chr20,38132401,2.880065496728742,599,415,1014,-
chr20,38139479,1.2610288361675208,548,485,1033,-
chr20,38139513,3.428571428571428,759,594,1353,-
chr20,38139514,3.428571428571428,759,594,1353,-
chr20,38139594,0.9150778455544641,846,542,1388,-
chr20,38139596,1.0891391486924984,633,402,1035,-
chr20,38148050,3.4884779126975825,538,487,1025,-
chr20,44197067,0.8686434395848776,867,709,1576,-
chr20,44197069,0.8686434395848776,867,709,1576,-
chr20,44197198,2.6310597767636303,569,454,1023,-
chr20,44197591,6.210635216221808,937,536,1473,-
chr20,44197593,6.210635216221808,937,536,1473,-
chr20,44197734,0.9997376016793493,634,411,1045,-
chr20,44197735,0.9997376016793493,634,411,1045,-
chr20,44202995,2.386504318090699,651,570,1221,-
chr20,44466826,0.2439024390243903,480,532,1012,-
chr20,44466827,0.2439024390243903,480,532,1012,-
chr20,44466828,0.2439024390243903,480,532,1012,-
chr20,44497744,13.140135949118747,880,850,1730,-
chr20,44497745,12.966023754414568,708,572,1280,-
chr20,44499318,1.5630770120619155,5620,3841,9461,-
chr20,44499319,1.5630770120619155,5620,3841,9461,-
chr20,44499324,1.8269454659037667,3756,3706,7462,-
chr20,44499325,1.4733215388492167,7846,6985,14831,-
chr20,44499327,1.8880304672317614,6896,6365,13261,-
chr20,44499328,1.7726107302729486,6590,5829,12419,-
chr20,44499329,1.2722307777274384,14376,11577,25953,-
chr20,44499330,1.5939699261861877,10313,8281,18594,-
chr20,44499331,1.3747539641632915,11444,9005,20449,-
chr20,44499332,1.4572149151503118,7870,6166,14036,-
chr20,44499337,1.860896600140407,1236,844,2080,-
chr20,44499338,0.618648757904463,2596,1941,4537,-
chr20,44499339,1.7573381793007965,1720,962,2682,-
chr20,44499340,0.618648757904463,2596,1941,4537,-
chr20,44499341,1.7573381793007965,1720,962,2682,-
chr20,44499367,2.351145038167939,703,392,1095,-
chr20,44499409,2.2742189551063268,769,585,1354,-
chr20,44499427,2.060606060606061,645,428,1073,-
chr20,44499435,2.5908523041607836,976,683,1659,-
chr20,44499445,1.7644323047394066,770,520,1290,-
chr20,44500018,1.7626606198034769,635,377,1012,-
chr20,44500381,0.40653547955823144,547,467,1014,-
chr20,44503925,2.572306791569087,605,426,1031,-
chr20,44503926,2.572306791569087,605,426,1031,-
chr20,44503963,0.9262333965844403,780,526,1306,-
chr20,44503964,0.9262333965844403,780,526,1306,-
chr20,44509991,2.750737628036698,562,480,1042,-
chr20,44511353,1.2013302415160705,563,475,1038,-
chr20,44512891,2.4774778261135175,811,638,1449,-
chr20,45252415,2.0342869622188253,689,481,1170,-
chr20,45253132,2.16734693877551,707,559,1266,-
chr20,45253685,2.321178389789848,732,612,1344,-
chr20,45253732,2.146822952540355,1357,907,2264,-
chr20,45254507,0.498157894736842,630,399,1029,-
chr20,45254558,1.058756595586953,534,474,1008,-
chr20,45326665,5.7430426716140985,301,769,1070,-
chr20,45326667,14.261752478676575,2355,2805,5160,-
chr20,45326668,16.587506252116068,2198,2420,4618,-
chr20,45326669,16.587506252116068,2198,2420,4618,-
chr20,45327178,6.5458578466806285,648,812,1460,-
chr20,45327183,7.966552479171381,1035,1107,2142,-
chr20,45327184,8.325983108992324,874,937,1811,-
chr20,45327197,4.036131398335968,760,641,1401,-
chr20,45327200,8.117754969139481,741,554,1295,-
chr20,46687171,2.2392433049420397,760,472,1232,-
chr20,47238782,4.059236947791163,621,497,1118,-
chr20,49113501,2.0178968649018096,663,471,1134,-
chr20,49117923,3.6504464285714286,628,447,1075,-
chr20,49118061,2.292549035463767,693,469,1162,-
chr20,49124502,5.665243836015166,1597,1323,2920,-
chr20,49124503,5.665243836015166,1597,1323,2920,-
chr20,49729659,0.37073804793133497,732,685,1417,-
chr20,50081328,0.8899742953074843,948,713,1661,-
chr20,50081349,1.0783882783882783,703,461,1164,-
chr20,50081480,1.918214598208706,949,748,1697,-
chr20,50081773,2.945675825189009,1871,1478,3349,-
chr20,50081816,1.7042445129693449,873,595,1468,-
chr20,50081819,1.6551724137931032,1103,666,1769,-
chr20,50081827,1.9542787630090397,3514,1976,5490,-
chr20,50081828,1.9000982930540005,4816,2915,7731,-
chr20,50082355,2.030708340582165,687,397,1084,-
chr20,50082662,2.48738950612278,851,648,1499,-
chr20,50082758,1.7436641221374043,1268,916,2184,-
chr20,50082760,1.7436641221374043,1268,916,2184,-
chr20,50082883,2.1281778910842006,682,522,1204,-
chr20,50084224,1.1797744897103064,657,439,1096,-
chr20,50084230,3.2201405152224827,659,426,1085,-
chr20,50084231,2.7964555835681453,966,612,1578,-
chr20,50084233,2.2577215189873416,636,394,1030,-
chr20,50096785,2.199351473283519,1299,864,2163,-
chr20,50096786,1.5575612283793108,2043,1468,3511,-
chr20,50096813,1.1285333333333334,689,624,1313,-
chr20,50096814,0.9786134505046646,1410,1345,2755,-
chr20,50096815,1.2906809342865446,1307,1022,2329,-
chr20,50096817,1.5868400783636358,1025,559,1584,-
chr20,50096819,2.113210643433912,704,415,1119,-
chr20,50128170,1.5190816383166428,686,461,1147,-
chr20,50935006,1.7875736961451247,757,440,1197,-
chr20,50935083,1.86608442503639,640,457,1097,-
chr20,50936260,0.9296729635119367,1437,856,2293,-
chr20,50936261,0.9296729635119367,1437,856,2293,-
chr20,50948644,2.7326214405360134,841,596,1437,-
chr20,50948655,0.7970234893311816,888,675,1563,-
chr20,50948656,2.3277978339350183,623,553,1176,-
chr20,50948657,0.7970234893311816,888,675,1563,-
chr20,50955210,2.714169381107492,908,613,1521,-
chr20,50955254,5.225591366422078,910,720,1630,-
chr20,50955271,0.450834748468065,984,793,1777,-
chr20,50958449,1.723291770573566,616,400,1016,-
chr20,50958531,0.951352694429355,1442,651,2093,-
chr20,51608615,1.9365360303413397,850,564,1414,-
chr20,51608616,1.9365360303413397,850,564,1414,-
chr20,51608617,0.48309330191771804,919,572,1491,-
chr20,56369630,2.2115589488636367,858,511,1369,-
chr20,56369631,2.2115589488636367,858,511,1369,-
chr20,56369824,0.40582306830907056,905,569,1474,-
chr20,56369826,0.40582306830907056,905,569,1474,-
chr20,56370646,2.4338993645171367,1148,992,2140,-
chr20,56373442,1.702851560193614,2310,1685,3995,-
chr20,56373449,1.795226719084563,5217,3765,8982,-
chr20,56373451,2.033767486734201,2107,1381,3488,-
chr20,56373455,2.672240802675585,1070,818,1888,-
chr20,56373552,2.2875816993464047,699,467,1166,-
chr20,56381505,2.442023136938391,625,530,1155,-
chr20,56383097,1.7556907820599503,614,492,1106,-
chr20,56383149,1.5955063455063454,600,428,1028,-
chr20,56386458,1.0667326406069602,873,704,1577,-
chr20,56386459,1.0667326406069602,873,704,1577,-
chr20,56386467,2.1827667984189727,766,574,1340,-
chr20,56386468,2.1827667984189727,766,574,1340,-
chr20,58995226,0.4374269005847953,475,683,1158,-
chr20,58995232,0.510236220472441,431,634,1065,-
chr20,58995239,9.899611505879596,3141,2789,5930,-
chr20,58995240,9.899611505879596,3141,2789,5930,-
chr20,58995241,7.157894736842105,902,816,1718,-
chr20,58995243,69.43942273169917,4346,616,4962,-
chr20,58995244,76.55792884730384,4526,565,5091,-
chr20,58995245,65.8842523870718,4919,592,5511,-
chr20,58995246,26.007092198581557,1929,140,2069,-
chr20,58995247,20.259740259740262,1949,139,2088,-
chr20,58995248,15.829051110239227,2251,173,2424,-
chr20,58995249,16.831977407611582,2047,188,2235,-
chr20,58995250,15.771428571428572,1034,104,1138,-
chr20,58995251,12.663949467264219,2195,255,2450,-
chr20,58995360,1.8480615288023856,811,553,1364,-
chr20,58995376,4.199352750809061,810,514,1324,-
chr20,58995413,2.621705426356589,800,644,1444,-
chr20,58995414,2.621705426356589,800,644,1444,-
chr20,58995485,1.830802328524424,628,438,1066,-
chr20,58995511,3.136645678661048,992,687,1679,-
chr20,58995671,1.6367432150313153,699,478,1177,-
chr20,58995754,1.6465654952076676,588,625,1213,-
chr20,58996659,0.5283446712018139,931,755,1686,-
chr20,58996679,5.708805183975153,4480,3263,7743,-
chr20,58996680,5.708805183975153,4480,3263,7743,-
chr20,58996783,0.5524824608742579,584,435,1019,-
chr20,58996794,0.5435576421491914,520,496,1016,-
chr20,58997616,1.7361111111111112,649,467,1116,-
chr20,58997641,4.878526377382747,1987,1555,3542,-
chr20,58997717,0.5571926190924498,622,451,1073,-
chr20,59001485,1.4117162486867234,932,626,1558,-
chr20,59006458,2.5215862236235758,716,433,1149,-
chr20,59006459,2.5215862236235758,716,433,1149,-
chr20,59028837,1.016238339376264,22016,16549,38565,-
chr20,59028840,1.0324531545368245,31516,23596,55112,-
chr20,59030389,1.242362724196816,3852,2856,6708,-
chr20,59030391,1.422580686864508,5618,4617,10235,-
chr20,59030401,1.6106680341785247,13292,9344,22636,-
chr20,59030411,1.367854183927092,4063,2413,6476,-
chr20,59030418,1.6056029331780717,10459,6096,16555,-
chr20,59030419,0.660188474297625,1873,1480,3353,-
chr20,59030420,1.609600512338336,13353,8299,21652,-
chr20,59032292,1.8463055985123313,4052,2358,6410,-
chr20,59032301,0.6042261486048468,1233,857,2090,-
chr20,59032313,0.5598349381017882,1385,726,2111,-
chr20,59032332,1.1454344624447717,914,489,1403,-
chr20,59032334,0.5155556156829847,1106,889,1995,-
chr20,59032335,0.5649642580311773,840,682,1522,-
chr20,59032342,1.611594737481643,667,438,1105,-
chr20,59033432,2.4252252252252253,672,517,1189,-
chr20,59033935,2.990191708402279,1684,1895,3579,-
chr20,59033940,11.867863227731704,1663,1700,3363,-
chr20,59033943,13.021146579984952,3976,3192,7168,-
chr20,59033944,12.17229766459029,5380,4166,9546,-
chr20,59033945,12.172297664590289,5380,4166,9546,-
chr20,59033946,15.009151106257635,2131,1603,3734,-
chr20,59033961,3.900624752218075,881,437,1318,-
chr20,59033963,1.9285714285714284,989,549,1538,-
chr20,59033964,1.9285714285714284,989,549,1538,-
chr20,59034532,2.329216896991081,678,536,1214,-
chr20,59034603,1.777168201118258,1432,880,2312,-
chr20,59034605,1.777168201118258,1432,880,2312,-
chr20,59034652,2.2146089204912736,570,441,1011,-
chr20,59034790,0.6551724137931034,797,629,1426,-
chr20,59034879,1.8759842148859398,1045,774,1819,-
chr20,59034987,1.6273118945038203,1242,976,2218,-
chr20,59035015,0.6795361284567351,1586,1120,2706,-
chr20,59035057,2.444648093841642,1025,743,1768,-
chr20,59036482,1.4191598696192926,2687,2071,4758,-
chr20,59037245,0.6598411118795013,1629,1173,2802,-
chr20,59037277,1.778684701492537,788,535,1323,-
chr20,59038580,1.6578507449469595,2208,1665,3873,-
chr20,59038597,0.6245116261427,783,642,1425,-
chr20,59038615,0.636993838028169,826,567,1393,-
chr20,59038618,2.091730066996854,1582,1158,2740,-
chr20,59042719,0.5053579894230226,2050,1622,3672,-
chr20,59042725,1.7228828174639197,702,478,1180,-
chr20,59042761,1.0725069963933294,3629,2191,5820,-
chr20,59042768,1.3001692695652047,4424,3508,7932,-
chr20,59042769,1.4634898941786474,5134,4106,9240,-
chr20,59042770,0.6381028543307086,1885,1269,3154,-
chr20,59042771,1.1231661210541868,6214,4567,10781,-
chr20,59042773,0.4680382208066368,2021,1611,3632,-
chr20,59042774,0.5498636583409844,4332,3328,7660,-
chr20,59042775,1.68562780503079,1189,870,2059,-
chr20,59042776,0.5777883472776247,4681,3387,8068,-
chr20,59042791,1.9556469980515203,1291,957,2248,-
chr20,59042794,4.7724700614436655,5923,4561,10484,-
chr20,59042795,4.63357497858731,6994,4989,11983,-
chr20,59042796,4.63357497858731,6994,4989,11983,-
chr20,59042797,12.76743081345428,3245,1747,4992,-
chr20,59042815,3.2801920768307324,827,244,1071,-
chr20,59042817,3.0825299282886167,2887,816,3703,-
chr20,59042818,3.545647219444965,2021,515,2536,-
chr20,59042819,3.618075049364773,2572,631,3203,-
chr20,62138235,1.3466160220994476,2107,1447,3554,-
chr20,62138241,1.7612078651685392,2365,1779,4144,-
chr20,62138243,1.7612078651685392,2365,1779,4144,-
chr20,62138286,0.6384163315805753,1031,792,1823,-
chr20,62139156,1.4470927187008902,1546,1287,2833,-
chr20,62139186,0.593358525727301,916,742,1658,-
chr20,62139193,1.5055014326647564,833,697,1530,-
chr20,62139809,0.6425281954887219,1242,911,2153,-
chr20,62139812,2.002252252252252,1142,863,2005,-
chr20,62139814,1.4913873295910185,860,724,1584,-
chr20,62140871,1.9616351213382548,2909,1818,4727,-
chr20,62140900,1.50231124807396,1589,1165,2754,-
chr20,62140903,2.4490212765957446,1198,939,2137,-
chr20,62140932,1.6695526695526697,1156,846,2002,-
chr20,62143223,0.6296273751032654,1573,1054,2627,-
chr20,62143224,1.8189906804993847,820,604,1424,-
chr20,62143245,2.346238938053097,1211,790,2001,-
chr20,62143250,1.8856377038195216,602,406,1008,-
chr20,62143302,1.8897185862344905,1031,830,1861,-
chr20,62143327,2.0169830169830165,672,363,1035,-
chr20,62143370,2.3793103448275863,827,463,1290,-
chr20,62143372,2.3793103448275863,827,463,1290,-
chr20,62311194,1.5732380313313175,565,471,1036,-
chr20,62312293,3.7503418895904255,842,573,1415,-
chr20,62312772,1.2733327138606556,709,478,1187,-
chr20,62313208,2.661986389416831,847,499,1346,-
chr20,62313757,1.418661475448704,789,581,1370,-
chr20,62313795,9.613636363636363,610,428,1038,-
chr20,62314426,1.3009104436733845,576,435,1011,-
chr20,62314662,1.1879912476009689,624,406,1030,-
chr20,62315967,1.5133622910991682,570,577,1147,-
chr20,62857606,1.7567567567567568,649,369,1018,-
chr20,62859426,1.226320244963903,1024,769,1793,-
chr20,62859502,1.3448298165753034,986,686,1672,-
chr20,62859503,0.9354791299235744,669,503,1172,-
chr20,63488938,1.648202812988366,677,442,1119,-
chr20,63488943,1.8165845648604266,850,419,1269,-
chr20,63489049,0.526508226691042,611,546,1157,-
chr20,63489147,2.1292418772563177,1965,1107,3072,-
chr20,63489148,1.9226481419871047,2191,1324,3515,-
chr20,63489149,2.1292418772563177,1965,1107,3072,-
chr20,63490491,1.8315717336522372,1031,671,1702,-
chr20,63490570,2.8074415036440348,562,473,1035,-
chr20,63490626,1.9902836134453783,582,475,1057,-
chr20,63490628,1.2285761371127224,638,491,1129,-
chr20,63490629,1.6391892131771069,1711,1325,3036,-
chr20,63490630,1.911835370739438,1500,1178,2678,-
chr20,63490704,3.023068669527897,965,465,1430,-
chr20,63490705,2.8779934913192133,1263,704,1967,-
chr20,63490733,1.1793927113076048,654,380,1034,-
chr20,63493276,2.4599483204134365,679,386,1065,-
chr20,63494827,1.1607996615189338,1482,814,2296,-
chr20,63494829,1.1607996615189338,1482,814,2296,-
chr20,63494877,1.092240446049198,1672,1133,2805,-
chr20,63494931,1.6501759324419425,4832,4409,9241,-
chr20,63494932,1.432116530761894,4900,2878,7778,-
chr20,63494933,1.542505762348758,11912,9174,21086,-
chr20,63494935,1.4060610892421148,6623,5733,12356,-
chr20,63494936,1.489482513872758,6168,5207,11375,-
chr20,63494938,1.4062853803307087,5938,4416,10354,-
chr20,63494941,0.6863709309851862,4479,3037,7516,-
chr20,63494964,1.5605995100158525,1273,770,2043,-
chr20,63494965,0.6473190851143608,1078,888,1966,-
chr20,63494970,1.8314539774182348,1479,1201,2680,-
chr20,63494982,2.2983012828650957,2447,1656,4103,-
chr20,63495048,4.257972741973006,830,515,1345,-
chr20,63495060,2.05761316872428,799,575,1374,-
chr20,63495061,2.356604826754572,1326,859,2185,-
chr20,63495874,2.6530612244897958,701,587,1288,-
chr20,63495880,1.8878758054632223,1411,1098,2509,-
chr20,63495881,1.528370794027585,2814,2065,4879,-
chr20,63495928,2.210176150044354,1056,606,1662,-
chr20,63495943,1.820711974110032,678,514,1192,-
chr20,63496015,1.6857329273597217,1010,626,1636,-
chr20,63497678,1.9368157647794808,687,555,1242,-
chr20,63497704,1.6677040110650068,741,481,1222,-
chr20,64073367,2.441499140054108,750,508,1258,-
chr21,14373440,1.9999775258221995,971,675,1646,-
chr21,14374278,1.166379765770915,610,450,1060,-
chr21,17594121,2.1339204545454544,962,703,1665,-
chr21,17594122,2.1339204545454544,962,703,1665,-
chr21,17594280,1.655357142857143,617,447,1064,-
chr21,17598776,2.1115270372134045,970,662,1632,-
chr21,17609134,0.4175365344467641,599,478,1077,-
chr21,17609136,0.4175365344467641,599,478,1077,-
chr21,17609138,0.5364757734466673,814,612,1426,-
chr21,17609140,0.5364757734466673,814,612,1426,-
chr21,17609144,2.5626275997875103,575,429,1004,-
chr21,25588870,4.626275510204081,557,447,1004,-
chr21,25592831,0.6559669474018751,687,433,1120,-
chr21,25606604,1.1213527041950135,648,386,1034,-
chr21,25724664,1.681818181818182,727,571,1298,-
chr21,25729791,0.5748528660943869,3153,3352,6505,-
chr21,25729792,0.5749178254934509,3993,4108,8101,-
chr21,25729793,0.6020540938742849,4738,5081,9819,-
chr21,25729796,0.43468234751527723,649,884,1533,-
chr21,25729799,0.40551839464882944,484,597,1081,-
chr21,25734872,22.17769701108615,2184,2429,4613,-
chr21,25734876,10.776209131502668,4078,3575,7653,-
chr21,25734878,7.369520090334542,6603,4943,11546,-
chr21,25734879,7.838787837110242,5063,3294,8357,-
chr21,25734880,4.534920634920635,2856,1385,4241,-
chr21,25734881,2.240396836604999,2758,1167,3925,-
chr21,25734882,2.3516880246516396,2509,1104,3613,-
chr21,25734883,2.7912735849056607,1577,635,2212,-
chr21,25880671,1.916666666666666,689,467,1156,-
chr21,25880760,1.6459770114942534,715,494,1209,-
chr21,25880916,1.4980401672390624,2588,1447,4035,-
chr21,25880917,1.4980401672390624,2588,1447,4035,-
chr21,25880931,87.17926258729447,11861,4160,16021,-
chr21,25880932,86.67131890548967,14186,4337,18523,-
chr21,25880933,86.67131890548967,14186,4337,18523,-
chr21,25880934,97.96150859124671,8087,1426,9513,-
chr21,25880936,13.698060365650935,6481,548,7029,-
chr21,25880937,10.935159607120932,4596,361,4957,-
chr21,25880938,10.209035818946177,10106,895,11001,-
chr21,25880939,9.387983980064165,6817,599,7416,-
chr21,25880941,20.644067796610173,1217,117,1334,-
chr21,25881175,0.7461360810090601,2639,1731,4370,-
chr21,25881187,0.7659881056267279,2516,1693,4209,-
chr21,25881253,1.583160800552105,1828,1448,3276,-
chr21,25881583,1.3777165058277978,2113,1514,3627,-
chr21,25881620,1.9405597162002368,1085,884,1969,-
chr21,25881646,1.953951444826226,1308,865,2173,-
chr21,25881730,1.5649085706203196,1691,1168,2859,-
chr21,25891758,0.6741130091984232,1253,760,2013,-
chr21,25891759,1.7128341232268063,1578,1355,2933,-
chr21,25891840,1.6071810055581477,2465,1644,4109,-
chr21,25897636,1.1955057485597964,2542,1858,4400,-
chr21,25897657,0.7383858065839403,1439,994,2433,-
chr21,25905037,1.4539619587656456,7960,5542,13502,-
chr21,25905039,1.3604911884852864,8850,6201,15051,-
chr21,25905046,1.7266159839630846,1649,1258,2907,-
chr21,25905050,1.4501094868911641,1484,1107,2591,-
chr21,25905053,1.5774798590130916,1411,992,2403,-
chr21,25911795,1.3252268285108462,2663,1937,4600,-
chr21,25954653,1.753523111612176,1081,886,1967,-
chr21,25954683,1.714694851687692,1142,837,1979,-
chr21,25955639,1.5940771995624319,886,710,1596,-
chr21,25975100,1.4385646687697158,1072,633,1705,-
chr21,25975101,0.6176470588235294,776,628,1404,-
chr21,25975103,1.766429059662142,602,538,1140,-
chr21,25975107,1.686205235265778,839,478,1317,-
chr21,25975137,0.5820045558086561,729,438,1167,-
chr21,25975970,1.391962810823454,1586,1020,2606,-
chr21,25975991,1.986190658011964,1356,872,2228,-
chr21,25982382,1.7789814638251393,16841,13114,29955,-
chr21,25982383,1.8276672885574305,16317,13046,29363,-
chr21,25982384,1.8276672885574305,16317,13046,29363,-
chr21,25982385,1.7669294856594235,11960,9345,21305,-
chr21,25982392,1.5234664768053263,3386,2142,5528,-
chr21,25982398,1.3696332819421821,8281,5534,13815,-
chr21,25982400,1.153019971502497,8179,6159,14338,-
chr21,25982407,0.6529864861545887,4732,3524,8256,-
chr21,25982413,0.7455037187288709,1936,1884,3820,-
chr21,25982437,1.6331700946784198,1442,1020,2462,-
chr21,25982438,1.6571401370906318,1298,1312,2610,-
chr21,25982440,1.7586022293460457,2678,1762,4440,-
chr21,25982441,1.5397350993377483,1239,1207,2446,-
chr21,25982442,1.7586022293460457,2678,1762,4440,-
chr21,25982451,1.7843971631205673,1053,704,1757,-
chr21,25982459,1.63723210168339,1982,1442,3424,-
chr21,26000043,1.7415578132559264,1316,794,2110,-
chr21,26000048,0.7003340538416192,989,726,1715,-
chr21,26000124,1.7687047967705585,1939,1292,3231,-
chr21,26000133,1.0594115187961564,1696,1165,2861,-
chr21,26000139,1.690019880715706,643,502,1145,-
chr21,26021852,1.812726683937824,1190,771,1961,-
chr21,26021853,1.812726683937824,1190,771,1961,-
chr21,26021990,2.5089678510998312,673,590,1263,-
chr21,26051053,1.956563210800499,1591,1297,2888,-
chr21,26051088,1.5255649091714665,1613,1109,2722,-
chr21,26051171,1.2874464329997732,1720,1180,2900,-
chr21,26053296,1.803135888501742,1034,860,1894,-
chr21,26089981,1.8343293492695885,649,501,1150,-
chr21,26112060,1.6725852272727273,784,639,1423,-
chr21,26112081,1.529745042492918,1079,705,1784,-
chr21,26112103,2.5979834119369007,638,472,1110,-
chr21,26112131,1.0545633085471096,1757,1496,3253,-
chr21,26112133,1.0545633085471096,1757,1496,3253,-
chr21,26112137,1.1127861038932942,1489,1226,2715,-
chr21,26112138,1.094059405940594,764,605,1369,-
chr21,26112139,1.4217878572040985,1338,994,2332,-
chr21,26170766,1.0309896431063366,1351,1011,2362,-
chr21,26838003,0.8913565426170469,593,475,1068,-
chr21,26838004,0.8913565426170469,593,475,1068,-
chr21,29056474,1.7265738350133828,2608,1771,4379,-
chr21,29056483,1.5995154818684232,1111,628,1739,-
chr21,29060583,1.7858611433388178,3656,2656,6312,-
chr21,29060585,1.7858611433388178,3656,2656,6312,-
chr21,29060599,1.3553571428571427,2207,1279,3486,-
chr21,29060615,1.8168871944382146,1472,1028,2500,-
chr21,29061402,2.002028397565923,1080,781,1861,-
chr21,29061414,1.8736264406904237,3527,2503,6030,-
chr21,29061555,1.640300256485643,28780,21193,49973,-
chr21,29061559,1.8766235573650614,12635,10680,23315,-
chr21,29061561,1.7852749537924029,24218,19790,44008,-
chr21,29061562,1.866219334527212,23138,18217,41355,-
chr21,29061563,1.6646929326094189,33458,25135,58593,-
chr21,29061564,1.4524368696683334,49087,33947,83034,-
chr21,29061565,1.5352744149349205,35712,24399,60111,-
chr21,29061566,1.3458717238482085,41600,27462,69062,-
chr21,29062155,1.2782162556318273,6903,4415,11318,-
chr21,29062175,1.5339750632971862,3000,1902,4902,-
chr21,29062236,1.4217400742920547,1354,1090,2444,-
chr21,29062240,0.8765580472506884,4885,3249,8134,-
chr21,29062242,0.6628898837103696,4921,3200,8121,-
chr21,29062395,1.3971907208658905,1413,1060,2473,-
chr21,29062545,1.835370431544491,1388,993,2381,-
chr21,29063518,1.5215640805222912,2419,1487,3906,-
chr21,29065081,1.5298421516157443,1612,1017,2629,-
chr21,29067043,1.3820538541728131,1080,806,1886,-
chr21,29067052,0.9411775200713647,2228,1424,3652,-
chr21,29067053,1.1620254227503175,3162,2026,5188,-
chr21,29067054,1.4237938596491226,881,607,1488,-
chr21,29067055,1.1561878164729362,2900,1825,4725,-
chr21,29067056,1.533346264024827,1802,1135,2937,-
chr21,29067059,2.6312518103494718,2062,1235,3297,-
chr21,29067061,2.5339412360688955,1393,798,2191,-
chr21,29067065,2.7683284457478012,1120,681,1801,-
chr21,29067066,2.537596671910333,1670,973,2643,-
chr21,29067069,3.367457820989419,735,537,1272,-
chr21,29067685,1.712378085763589,2391,1741,4132,-
chr21,29067700,2.0678822119500087,832,530,1362,-
chr21,29070335,2.5407694599656883,1110,709,1819,-
chr21,29073607,1.3283354665955753,1678,1104,2782,-
chr21,29073608,1.0353655067791792,1247,795,2042,-
chr21,29073612,1.9514778834229018,1078,655,1733,-
chr21,29073613,2.1127303613656703,1431,906,2337,-
chr21,29073629,1.2091985975562405,804,524,1328,-
chr21,32602317,1.5801940639269405,2372,1751,4123,-
chr21,32602334,1.429857888550308,3746,2458,6204,-
chr21,32602335,1.429857888550308,3746,2458,6204,-
chr21,32602336,0.4862298195631529,959,584,1543,-
chr21,32602345,1.1820843332835806,3942,2582,6524,-
chr21,32602359,1.5893251742308343,934,476,1410,-
chr21,32603170,1.9675338189386054,1303,960,2263,-
chr21,32603171,1.7826384142173617,651,417,1068,-
chr21,32603182,1.3039638904130686,1906,1164,3070,-
chr21,32603189,0.5536460159125729,1306,848,2154,-
chr21,32603192,0.4454390451832907,626,413,1039,-
chr21,32603272,1.9183008444895235,665,395,1060,-
chr21,32609903,2.0603018175908354,696,544,1240,-
chr21,32609924,2.4201906255935732,621,461,1082,-
chr21,33506005,3.0473602484472044,784,643,1427,-
chr21,33506006,3.0473602484472044,784,643,1427,-
chr21,33509819,4.066378896638458,755,580,1335,-
chr21,33511380,2.140543929899913,740,499,1239,-
chr21,33517562,2.8179555271196026,732,456,1188,-
chr21,33517592,2.067810973985815,911,594,1505,-
chr21,33517594,2.041868932038835,672,411,1083,-
chr21,33520496,1.2570358393038805,907,645,1552,-
chr21,33520499,2.3433146523673596,624,518,1142,-
chr21,33524941,3.306159420289855,802,551,1353,-
chr21,33524943,3.306159420289855,802,551,1353,-
chr21,33528552,1.881783171898705,644,450,1094,-
chr21,33539318,1.0008361204013378,664,459,1123,-
chr21,33539320,1.0008361204013378,664,459,1123,-
chr21,33582217,1.8641472953855052,702,419,1121,-
chr21,33903535,2.4345218974194243,927,848,1775,-
chr21,33903948,1.3385930251018716,2078,1365,3443,-
chr21,33903992,0.6057692307692307,1394,1239,2633,-
chr21,33903994,0.68239416463568,1673,1266,2939,-
chr21,33907431,1.5622974963181149,815,581,1396,-
chr21,33907442,0.5966097676623991,1437,911,2348,-
chr21,33909133,1.5795414269745631,1135,852,1987,-
chr21,33909172,2.2409073579870378,1865,1219,3084,-
chr21,33909173,1.573943661971831,893,709,1602,-
chr21,33912330,1.7284482758620692,801,637,1438,-
chr21,33914468,1.491709464416728,1325,869,2194,-
chr21,33914493,2.530917457578372,879,548,1427,-
chr21,37067335,1.6053480796942639,664,451,1115,-
chr21,37067337,1.4925674518630885,741,485,1226,-
chr21,39180299,1.2277647412713535,898,594,1492,-
chr21,39342892,1.5260223782360687,658,417,1075,-
chr21,39345196,0.5906219289625159,600,418,1018,-
chr21,39345197,1.6015740285292668,813,534,1347,-
chr21,39345219,1.611954687876597,626,460,1086,-
chr21,39348974,7.532235013621638,818,518,1336,-
chr21,39348975,7.203098106712566,674,414,1088,-
chr21,39348976,7.203098106712566,674,414,1088,-
chr21,43774074,2.9369324911172523,762,595,1357,-
chr21,43774104,0.5707306240284256,1027,631,1658,-
chr21,43774248,0.7800539476561931,1069,956,2025,-
chr21,43774281,1.1678037095814948,1591,1119,2710,-
chr21,43774304,1.7268159806295398,770,589,1359,-
chr21,43774672,0.5045112781954887,670,559,1229,-
chr21,43774724,1.6043557168784028,753,550,1303,-
chr21,43774727,0.9549564094284793,1364,977,2341,-
chr21,43774728,0.9549564094284793,1364,977,2341,-
chr21,43776290,0.9042510284746308,1424,734,2158,-
chr21,43776291,0.8607437405307559,1883,998,2881,-
chr21,43776292,0.9042510284746308,1424,734,2158,-
chr21,44769276,2.547514619883041,696,379,1075,-
chr21,44769278,2.547514619883041,696,379,1075,-
chr21,44806081,2.013601419278533,680,444,1124,-
chr21,44806519,2.455357142857143,626,398,1024,-
chr21,44806520,2.455357142857143,626,398,1024,-
chr21,44806659,1.8330852318163644,769,543,1312,-
chr21,44806789,1.6407272727272726,563,549,1112,-
chr21,44809096,2.0843079922027288,909,569,1478,-
chr21,44809097,2.0843079922027288,909,569,1478,-
chr21,44814067,1.9857264655864737,6335,4373,10708,-
chr21,44814075,2.2194229602669093,2413,1883,4296,-
chr21,44814078,1.149058465470897,6384,4475,10859,-
chr21,44814087,0.9964256670306528,9623,5941,15564,-
chr21,44814089,0.9600446409283994,10953,6868,17821,-
chr21,44814094,1.4424127073074309,4760,2888,7648,-
chr21,44814095,1.3194700606366851,3832,1978,5810,-
chr21,44814096,1.4797081975459134,6294,3775,10069,-
chr21,44814097,1.2524735478635414,2735,1392,4127,-
chr21,44814098,1.7602464764041792,1532,1096,2628,-
chr21,44817958,0.6669490469664882,955,697,1652,-
chr21,44818006,1.9903664921465969,703,381,1084,-
chr21,44818007,1.9903664921465969,703,381,1084,-
chr21,44850121,2.0074554941877096,852,716,1568,-
chr21,44850238,3.2996136283807522,670,437,1107,-
chr21,44850297,0.9634738186462324,942,608,1550,-
chr21,44850298,0.9634738186462324,942,608,1550,-
chr21,44850316,2.107769561682965,758,558,1316,-
chr21,44850923,2.19570905285191,1048,734,1782,-
chr21,44850924,2.19570905285191,1048,734,1782,-
chr21,44855227,0.7468509984639016,571,433,1004,-
chr21,44855228,0.7468509984639016,571,433,1004,-
chr21,44855239,1.4672198704858304,630,468,1098,-
chr22,17137707,2.583199135048932,698,479,1177,-
chr22,17137994,9.066708776585722,1550,1093,2643,-
chr22,17137995,9.489863877252832,1733,1170,2903,-
chr22,17137996,10.299603023746693,1234,805,2039,-
chr22,17148536,1.5114620616090029,605,452,1057,-
chr22,17148544,2.453574464442778,636,404,1040,-
chr22,17592276,1.9859989229940764,921,618,1539,-
chr22,17592302,1.6614778325123154,815,524,1339,-
chr22,17592309,2.0600895987534087,640,603,1243,-
chr22,17592381,2.0117231286212878,1155,815,1970,-
chr22,17592390,3.818397242567858,708,421,1129,-
chr22,17592700,0.5538413426456792,692,542,1234,-
chr22,17592725,1.6375711574952558,862,526,1388,-
chr22,17594566,2.224321768158669,1718,1235,2953,-
chr22,17598226,1.6007142857142858,1268,939,2207,-
chr22,17598234,1.4702779353374928,1126,819,1945,-
chr22,17601136,1.682673069227691,579,475,1054,-
chr22,17612875,1.9210068649885579,676,474,1150,-
chr22,17613309,2.1668719549035287,2838,2011,4849,-
chr22,17613311,2.455744575936884,1810,1351,3161,-
chr22,17613314,1.650075414781297,1093,662,1755,-
chr22,17619476,2.0218309859154933,692,496,1188,-
chr22,17619516,0.4807416772018542,712,564,1276,-
chr22,17628677,1.7868103448275858,881,579,1460,-
chr22,17628682,0.5434746188641314,810,507,1317,-
chr22,17628704,1.568027993922372,1031,586,1617,-
chr22,17628717,3.001261034047919,713,365,1078,-
chr22,17628737,5.63063063063063,749,443,1192,-
chr22,17628748,0.7176428679302913,2295,1115,3410,-
chr22,17628767,0.45720648842400996,851,483,1334,-
chr22,19176035,4.684938524590164,589,487,1076,-
chr22,19176036,4.684938524590164,589,487,1076,-
chr22,19176062,2.1910325988310886,739,444,1183,-
chr22,19176199,3.1012295088254613,829,554,1383,-
chr22,19176238,2.048589544122308,1265,832,2097,-
chr22,19176594,1.8554578836096585,666,472,1138,-
chr22,19176641,2.116264687693259,707,461,1168,-
chr22,19176872,1.8012824866170898,775,566,1341,-
chr22,19176910,2.652448021462106,640,425,1065,-
chr22,19454761,0.412879850397382,1038,689,1727,-
chr22,19454762,1.2297843843016696,1481,1092,2573,-
chr22,19454796,2.1507029097554984,868,577,1445,-
chr22,19456888,4.017779098867094,562,473,1035,-
chr22,19465271,1.727612364892114,942,759,1701,-
chr22,19880254,1.532232665919657,651,412,1063,-
chr22,20116073,1.2627307092664453,767,638,1405,-
chr22,20116077,1.2101262191623638,766,497,1263,-
chr22,20116078,1.2101262191623638,766,497,1263,-
chr22,20116079,2.152183311716385,523,513,1036,-
chr22,20116080,2.216767881241565,772,740,1512,-
chr22,20116082,2.597873900293255,745,681,1426,-
chr22,21628248,2.3256573294380485,693,505,1198,-
chr22,21628249,2.3256573294380485,693,505,1198,-
chr22,21628502,5.492508946495593,598,407,1005,-
chr22,21760792,2.2137522768845077,649,475,1124,-
chr22,21788272,1.3075994590242108,653,512,1165,-
chr22,21807689,3.638576779026217,870,533,1403,-
chr22,22547837,2.201317882299477,691,488,1179,-
chr22,22549751,3.531947261663286,596,492,1088,-
chr22,22549752,3.531947261663286,596,492,1088,-
chr22,22549825,2.725663716814159,699,564,1263,-
chr22,22549827,2.725663716814159,699,564,1263,-
chr22,22549898,0.6187664041994752,614,507,1121,-
chr22,22549928,0.5557387739413168,934,764,1698,-
chr22,22550008,1.491925147398103,969,580,1549,-
chr22,22550037,3.1748816485658584,876,683,1559,-
chr22,22550047,2.641772814517536,756,520,1276,-
chr22,22550068,0.37403486060381896,808,502,1310,-
chr22,22550088,3.5504047093451065,578,452,1030,-
chr22,22550237,2.3394265597003896,1554,1181,2735,-
chr22,22550243,1.2398461208894553,2643,1896,4539,-
chr22,22550244,1.102533278089542,3410,2326,5736,-
chr22,22550262,2.357666666666667,642,399,1041,-
chr22,22550832,2.347826086956522,620,436,1056,-
chr22,22550834,2.2162454246807326,894,631,1525,-
chr22,22556897,2.489263684176946,634,483,1117,-
chr22,22556921,0.49707602339181284,624,474,1098,-
chr22,22556923,0.49707602339181284,624,474,1098,-
chr22,23765928,2.030501542742031,2113,1514,3627,-
chr22,23765938,0.578056167400881,662,453,1115,-
chr22,23765943,2.0973333333333333,604,499,1103,-
chr22,23765962,2.6723057644110266,852,503,1355,-
chr22,23766222,1.3781864327854283,1265,840,2105,-
chr22,23766223,0.9526051819920743,950,678,1628,-
chr22,23971455,2.319859402460457,659,568,1227,-
chr22,23971578,1.4350649350649352,1559,989,2548,-
chr22,23971579,2.575039808917197,760,627,1387,-
chr22,23971587,1.7351290684624017,772,593,1365,-
chr22,23971609,1.856648014921396,1339,833,2172,-
chr22,23971617,1.8397491349480968,904,679,1583,-
chr22,23971619,0.5414485165794067,656,572,1228,-
chr22,23971620,1.5265084796327373,1382,981,2363,-
chr22,23971622,0.5164648396005949,571,522,1093,-
chr22,23973784,2.0667483159828537,749,425,1174,-
chr22,23973790,2.226138032305433,757,453,1210,-
chr22,23973792,2.671274961597542,1109,650,1759,-
chr22,23973793,2.894524959742351,718,413,1131,-
chr22,24541939,27.532569080176774,1242,878,2120,-
chr22,24541940,27.532569080176774,1242,878,2120,-
chr22,26887233,2.2242094237832877,2034,1486,3520,-
chr22,26887242,2.4437869822485205,943,1013,1956,-
chr22,26887244,1.5136895434265771,2671,2321,4992,-
chr22,26887246,2.054199670298741,1309,1308,2617,-
chr22,26887247,1.865783813201337,846,820,1666,-
chr22,26887250,1.7716299295246665,694,512,1206,-
chr22,26887253,1.1018871344282828,1015,793,1808,-
chr22,26887257,1.2433051269288202,542,489,1031,-
chr22,26887260,2.380025584795322,853,575,1428,-
chr22,26887261,2.380025584795322,853,575,1428,-
chr22,26887262,2.4462995955521407,970,674,1644,-
chr22,27666623,2.637142857142857,701,674,1375,-
chr22,27666625,2.5721685891748,837,773,1610,-
chr22,27851801,2.2441003168944342,666,524,1190,-
chr22,27851867,3.1319619681760273,816,601,1417,-
chr22,27852829,0.4331798360369789,799,601,1400,-
chr22,27852893,1.8409272581934453,657,416,1073,-
chr22,27853481,1.1286599099099095,632,443,1075,-
chr22,27853482,1.1286599099099095,632,443,1075,-
chr22,27858490,1.8201078582434511,944,648,1592,-
chr22,27858494,1.915757492059108,815,556,1371,-
chr22,27860148,2.8149653088580373,1160,791,1951,-
chr22,27860198,2.3187934617729136,752,506,1258,-
chr22,28694101,2.8706605222734263,583,433,1016,-
chr22,28694103,2.8706605222734263,583,433,1016,-
chr22,28695735,3.4176870204644523,661,383,1044,-
chr22,28699900,6.449611299428231,1916,1775,3691,-
chr22,28699901,6.525787911239404,1668,1542,3210,-
chr22,28711943,0.5416063466948445,1200,828,2028,-
chr22,28725006,2.6788090592116407,673,538,1211,-
chr22,28794910,1.5697025500892712,2917,2148,5065,-
chr22,28794911,1.2586151210880065,4403,3316,7719,-
chr22,28794919,1.3229126953869614,3469,2439,5908,-
chr22,28795034,0.7789789494393075,3770,2759,6529,-
chr22,28795169,1.6700602079912426,1906,1574,3480,-
chr22,28795215,1.6322120168465932,3220,2227,5447,-
chr22,28795218,2.2398425790190246,2626,2051,4677,-
chr22,28795237,1.8226287038569773,1158,862,2020,-
chr22,28795272,2.2118593308804657,1099,898,1997,-
chr22,28795355,1.3314046366647183,1501,1179,2680,-
chr22,28795433,1.4994024380527449,2213,1629,3842,-
chr22,28795546,1.387093860822037,12794,7519,20313,-
chr22,28795547,1.4821216949274627,7417,4450,11867,-
chr22,28795575,1.8917040631888997,7098,4228,11326,-
chr22,28795578,1.8466394187102635,3625,2201,5826,-
chr22,28795597,1.4745789458583192,2506,1531,4037,-
chr22,28795614,0.7472803347280335,1785,1194,2979,-
chr22,28795617,1.6365198711063371,1757,979,2736,-
chr22,28795624,1.4493822607412872,1964,1121,3085,-
chr22,28795634,1.7411615661744326,1465,870,2335,-
chr22,28795704,0.5885496183206106,770,654,1424,-
chr22,28795728,0.6319663512092534,1201,950,2151,-
chr22,28796092,0.5575094437931484,1069,852,1921,-
chr22,28796095,2.011630532971997,1017,655,1672,-
chr22,28796186,1.9642603550295856,771,649,1420,-
chr22,28799151,1.5475583778426873,26620,20233,46853,-
chr22,28799152,1.4983548734467143,33457,25334,58791,-
chr22,28799154,1.5975186151382532,7052,6281,13333,-
chr22,28800309,1.4287776680913225,10351,6042,16393,-
chr22,28800310,1.446224995510602,34788,22774,57562,-
chr22,28800312,1.3853494396933135,40401,26509,66910,-
chr22,28800313,1.4328572904566255,22302,14297,36599,-
chr22,28800315,1.3539276413522714,12249,8212,20461,-
chr22,28800322,1.4362151896979527,3187,1667,4854,-
chr22,28800331,1.587854183927092,2425,1206,3631,-
chr22,28800332,0.6616508538899429,2363,1549,3912,-
chr22,28800334,1.7382067015642446,2292,1456,3748,-
chr22,28800341,1.9089690002261255,3964,2169,6133,-
chr22,28800344,1.3380647937333985,3852,2287,6139,-
chr22,28800346,1.2736144261682385,9807,5303,15110,-
chr22,28800347,1.2229517752138657,4337,1922,6259,-
chr22,28800348,1.2229517752138657,4337,1922,6259,-
chr22,28800361,2.3169917162106937,2174,1157,3331,-
chr22,28800378,3.4097222222222228,981,575,1556,-
chr22,28800387,2.7214285714285715,761,335,1096,-
chr22,28800394,0.4827118644067797,711,294,1005,-
chr22,28800403,2.0186543434808653,1314,656,1970,-
chr22,28800409,3.0375434027777772,1155,565,1720,-
chr22,28800476,1.6471405384383386,810,518,1328,-
chr22,29511225,0.39196529076971404,1048,615,1663,-
chr22,29511227,0.3315144766146993,686,448,1134,-
chr22,29543490,1.6779556650246306,653,405,1058,-
chr22,29554915,1.3439207856254431,651,527,1178,-
chr22,29554939,8.192503486469041,2128,1434,3562,-
chr22,29554940,10.7218074240316,2385,1603,3988,-
chr22,29555125,1.8540836191712244,799,468,1267,-
chr22,29555339,26.566469090272562,4240,3345,7585,-
chr22,29555340,26.566469090272562,4240,3345,7585,-
chr22,29555423,1.90322889719268,763,496,1259,-
chr22,29555542,4.776400651865465,2314,1527,3841,-
chr22,29555543,5.590047481516836,2234,1480,3714,-
chr22,29555673,0.5935746766668635,873,573,1446,-
chr22,29555811,2.218599033816425,667,413,1080,-
chr22,29555959,0.4320580474934037,654,378,1032,-
chr22,29558923,0.2976843796011244,555,481,1036,-
chr22,29558924,1.082766716482129,874,712,1586,-
chr22,29558949,1.1007412398921834,593,423,1016,-
chr22,29558951,1.1007412398921834,593,423,1016,-
chr22,29560804,2.464864864864865,1139,739,1878,-
chr22,29560813,1.6976802541487805,3936,2379,6315,-
chr22,29560814,1.8778581139537758,2124,1304,3428,-
chr22,29560819,1.7709218272598557,913,496,1409,-
chr22,29561191,2.0416239754098364,838,487,1325,-
chr22,29561199,1.313818028713681,1104,694,1798,-
chr22,29561530,1.8170989902720271,1553,1042,2595,-
chr22,29561537,1.8658207771609832,691,484,1175,-
chr22,29561597,1.0467289719626167,895,641,1536,-
chr22,29561598,1.0587206477798292,1512,1058,2570,-
chr22,29561599,1.0121420622295665,2196,1599,3795,-
chr22,29561600,1.1630794701986755,842,603,1445,-
chr22,29561803,1.4470248228656906,1133,958,2091,-
chr22,29561804,0.9056603773584907,767,635,1402,-
chr22,29561810,2.0883069427527405,1142,820,1962,-
chr22,29561811,2.2193678110051174,1816,1386,3202,-
chr22,29561813,2.4267399267399266,674,566,1240,-
chr22,29570523,2.7342813088915543,569,448,1017,-
chr22,29570524,2.7342813088915543,569,448,1017,-
chr22,29581008,5.269093277044899,721,604,1325,-
chr22,29804807,0.3850987432675045,725,556,1281,-
chr22,29804809,1.8571150222650876,1045,937,1982,-
chr22,29804810,2.3570591681312245,1237,1137,2374,-
chr22,29804812,2.4426823580065298,1479,1185,2664,-
chr22,29804813,2.578318858560794,1063,805,1868,-
chr22,29804814,2.578318858560794,1063,805,1868,-
chr22,29806228,1.0755779490219324,572,481,1053,-
chr22,29806229,1.0755779490219324,572,481,1053,-
chr22,29806276,2.863290664156839,598,432,1030,-
chr22,30339203,2.137417834552896,1230,732,1962,-
chr22,30339206,1.7376464653010881,4605,3302,7907,-
chr22,30339207,1.906326867849319,2943,2308,5251,-
chr22,30339223,0.6848126232741618,1239,844,2083,-
chr22,30339228,1.5878848063555115,1065,741,1806,-
chr22,30339233,1.8064893306050855,926,621,1547,-
chr22,30339236,2.1693435754189943,653,357,1010,-
chr22,30339238,1.2629372530623992,2113,1409,3522,-
chr22,30339244,1.6505125815470645,758,443,1201,-
chr22,30340299,3.0239114908371065,653,406,1059,-
chr22,30352984,2.1206104772020478,681,506,1187,-
chr22,30576664,27.914110429447852,699,325,1024,-
chr22,30576665,17.98436769662442,1398,713,2111,-
chr22,30576666,17.98436769662442,1398,713,2111,-
chr22,30579212,5.2491393926977565,1174,999,2173,-
chr22,30579266,4.292876946025502,677,559,1236,-
chr22,30579791,2.4518494897959178,698,391,1089,-
chr22,30579886,1.5470603575639754,592,462,1054,-
chr22,30580116,2.944783478106243,605,535,1140,-
chr22,30580643,2.162320006127451,555,469,1024,-
chr22,30588103,2.9073891625615764,680,434,1114,-
chr22,30588152,0.3807141499653589,811,559,1370,-
chr22,31105672,0.992018245792721,812,601,1413,-
chr22,31619360,1.5650884999233674,5426,3814,9240,-
chr22,31619361,1.5202550175443277,4026,2860,6886,-
chr22,31619378,1.6587552742616034,1274,947,2221,-
chr22,31619380,1.6587552742616034,1274,947,2221,-
chr22,31619402,1.7708284753895354,1766,1220,2986,-
chr22,31619403,1.0072365445499776,1047,803,1850,-
chr22,31619404,3.0143540669856463,719,417,1136,-
chr22,32387674,0.48850323483126423,744,531,1275,-
chr22,32387680,1.9621920135938828,744,534,1278,-
chr22,32387722,2.027941176470588,590,509,1099,-
chr22,32388034,1.9677492618669095,721,628,1349,-
chr22,32393936,3.213431786216596,702,473,1175,-
chr22,32393949,3.214285714285714,602,468,1070,-
chr22,32393981,4.259100642398287,611,466,1077,-
chr22,32393982,3.1109125665183197,1183,820,2003,-
chr22,32395034,1.2786222268005107,976,757,1733,-
chr22,32395192,2.1582278481012658,836,473,1309,-
chr22,32396087,0.38232611999055394,2822,1812,4634,-
chr22,32399621,1.950178075881548,992,615,1607,-
chr22,32401850,0.6016731016731017,714,480,1194,-
chr22,32406754,0.74514701899058,916,668,1584,-
chr22,32408184,1.1137329931972788,844,671,1515,-
chr22,32408185,1.1137329931972788,844,671,1515,-
chr22,32408796,0.5014917088739332,555,496,1051,-
chr22,32412154,2.5804863034779935,785,721,1506,-
chr22,32412155,2.5804863034779935,785,721,1506,-
chr22,32412225,0.9472049689440992,548,482,1030,-
chr22,32412227,0.9472049689440992,548,482,1030,-
chr22,35606850,8.001977017743473,957,691,1648,-
chr22,35606851,8.00197701774347,957,691,1648,-
chr22,35740506,1.8354187084056441,486,592,1078,-
chr22,35740517,28.424635701275047,617,481,1098,-
chr22,35740742,2.740580132049326,690,420,1110,-
chr22,35742626,0.5977247295785154,640,382,1022,-
chr22,35838370,1.6938708620124552,759,564,1323,-
chr22,35838380,3.1521880415725145,1139,818,1957,-
chr22,35838381,2.5248042641058754,951,553,1504,-
chr22,35840411,7.080269614906425,607,479,1086,-
chr22,36281728,0.6244394618834079,556,445,1001,-
chr22,36281735,1.6956521739130437,635,423,1058,-
chr22,36281974,1.408749713148142,665,447,1112,-
chr22,36282308,1.9457775105377415,689,538,1227,-
chr22,36284174,0.3559168267872936,909,552,1461,-
chr22,36285192,1.253178585778055,635,542,1177,-
chr22,36285262,0.6424418604651162,1338,687,2025,-
chr22,36285263,1.2616678862019344,1356,949,2305,-
chr22,36285266,2.141888616106465,1828,1098,2926,-
chr22,36285269,2.4515824940612014,1740,1011,2751,-
chr22,36285274,0.48428933050833417,1072,724,1796,-
chr22,36285280,1.187644944341373,772,615,1387,-
chr22,36285281,0.4607658505963591,733,471,1204,-
chr22,36285282,1.070336173193302,2160,1421,3581,-
chr22,36285927,4.7368421052631575,809,341,1150,-
chr22,36285929,4.7368421052631575,809,341,1150,-
chr22,36286734,0.4151837384259259,882,575,1457,-
chr22,36286736,0.4151837384259259,882,575,1457,-
chr22,36286835,2.396694965331639,1052,628,1680,-
chr22,36286839,1.7548368926826794,1759,1014,2773,-
chr22,36286840,2.5471599791558104,1127,605,1732,-
chr22,36286841,2.5471599791558104,1127,605,1732,-
chr22,36288749,1.5541609963707557,665,510,1175,-
chr22,36288820,3.399336840749231,654,449,1103,-
chr22,36289116,2.533078393881453,827,522,1349,-
chr22,36289117,2.533078393881453,827,522,1349,-
chr22,36295608,0.9582228116710872,679,463,1142,-
chr22,36295609,0.9582228116710872,679,463,1142,-
chr22,36296972,2.7226979997281093,1055,630,1685,-
chr22,36296973,2.806244772790633,718,421,1139,-
chr22,36298978,2.022988272750017,1263,925,2188,-
chr22,36299020,2.0638090476776805,847,568,1415,-
chr22,36300950,2.4715909090909087,724,483,1207,-
chr22,36300952,2.4715909090909087,724,483,1207,-
chr22,36301012,1.3585239852398523,766,541,1307,-
chr22,36301013,1.5568071736493192,1118,712,1830,-
chr22,36301014,1.9439840929257937,992,717,1709,-
chr22,36301606,4.738693424446064,833,616,1449,-
chr22,36304105,1.2968063493551265,2606,1493,4099,-
chr22,36304106,0.4966339232400136,1966,990,2956,-
chr22,36304108,2.0074128182236293,2225,1368,3593,-
chr22,36304109,2.0074128182236293,2225,1368,3593,-
chr22,36304119,0.45668716772646717,1010,542,1552,-
chr22,36304133,2.3259259259259255,627,404,1031,-
chr22,36305084,2.1679292929292933,605,431,1036,-
chr22,36305085,2.1679292929292933,605,431,1036,-
chr22,36312106,0.4678020886504898,586,425,1011,-
chr22,36318297,4.617004961290236,646,397,1043,-
chr22,36320825,2.1802663438256658,666,412,1078,-
chr22,36349247,2.369330108888492,841,466,1307,-
chr22,36421393,1.3587324215442655,2446,2577,5023,-
chr22,36421398,0.9903499510358693,8116,7008,15124,-
chr22,36421400,1.2079780197009786,4748,4825,9573,-
chr22,36421401,0.79968156804152,9100,6912,16012,-
chr22,36421402,0.9879670734583246,7360,6172,13532,-
chr22,36421403,0.7346745312829155,2249,1879,4128,-
chr22,36421411,0.6791934944859084,1437,1174,2611,-
chr22,36421412,0.6791934944859084,1437,1174,2611,-
chr22,36467449,1.0031446540880502,637,527,1164,-
chr22,36467450,1.0031446540880502,637,527,1164,-
chr22,36467864,2.150328137817884,698,423,1121,-
chr22,36467865,1.8451927650385764,1213,847,2060,-
chr22,36480652,1.810810810810811,669,406,1075,-
chr22,36480683,0.9906143344709899,601,585,1186,-
chr22,36480685,0.9906143344709899,601,585,1186,-
chr22,36510966,2.3171194651832225,2338,1794,4132,-
chr22,36510987,2.134695905187709,751,670,1421,-
chr22,36511579,1.6849764346280482,2336,1843,4179,-
chr22,36511622,1.5560478511298184,877,731,1608,-
chr22,36511642,1.6612499999999997,885,649,1534,-
chr22,36511764,1.925220228384992,921,612,1533,-
chr22,36512517,1.407616069291823,2302,1704,4006,-
chr22,36512520,1.77239965204424,814,618,1432,-
chr22,36512526,2.6495357750968664,1970,1311,3281,-
chr22,36512576,1.9746835443037976,1133,710,1843,-
chr22,36516503,2.1835741206030157,926,795,1721,-
chr22,36516508,2.144,937,749,1686,-
chr22,36516725,1.3787992154843263,3378,2630,6008,-
chr22,36516732,1.7403817940199542,2753,2043,4796,-
chr22,36516761,1.7460955620844287,940,668,1608,-
chr22,36517372,1.9488888888888893,876,749,1625,-
chr22,36518836,2.3645156046814044,1237,768,2005,-
chr22,36519518,1.2131019818400655,1940,1477,3417,-
chr22,36520635,1.6597675235156062,1632,1020,2652,-
chr22,36523251,0.5603898364079359,1287,1182,2469,-
chr22,36523258,1.4986042616544153,1192,976,2168,-
chr22,36523262,2.3161837611545666,1167,938,2105,-
chr22,36523280,1.862219343696028,1002,771,1773,-
chr22,36523927,1.7844844188961353,2251,1897,4148,-
chr22,36523946,1.8382716625449123,937,738,1675,-
chr22,36524623,2.209871762749698,1469,1020,2489,-
chr22,36524626,2.2384635439297815,1430,932,2362,-
chr22,36524728,0.5281986531986532,1003,719,1722,-
chr22,36526037,0.8670613371531432,10395,6333,16728,-
chr22,36526039,1.0121148433068166,15018,9102,24120,-
chr22,36526040,1.5251318686769875,13953,9356,23309,-
chr22,36526041,1.5140513331359344,16170,10626,26796,-
chr22,36526042,1.7137222520287037,8698,6252,14950,-
chr22,36526043,1.5616601460083528,12668,8112,20780,-
chr22,36526044,1.515045344122408,8590,5406,13996,-
chr22,36526050,1.3933693993619087,1375,889,2264,-
chr22,36526110,3.364583333333333,815,575,1390,-
chr22,36526113,1.6840618152462232,884,597,1481,-
chr22,36526130,3.5357142857142856,714,419,1133,-
chr22,36529113,0.5642720797057591,807,456,1263,-
chr22,37181880,0.9503111935567211,800,574,1374,-
chr22,38290794,2.037869062901155,634,409,1043,-
chr22,38290923,2.0300982800982803,660,406,1066,-
chr22,38290981,2.3951612903225805,615,433,1048,-
chr22,38291122,0.7207373271889399,815,650,1465,-
chr22,38291165,1.0442216981132075,692,423,1115,-
chr22,38291166,1.4833585614965958,860,541,1401,-
chr22,38291377,13.297501178689293,1281,706,1987,-
chr22,38291378,14.824912630619059,3072,1966,5038,-
chr22,38291379,14.824912630619059,3072,1966,5038,-
chr22,38291515,1.8373917888497968,1231,842,2073,-
chr22,38291541,2.0380217785843917,606,579,1185,-
chr22,38291612,1.2281335522714834,862,608,1470,-
chr22,38291613,1.2281335522714834,862,608,1470,-
chr22,38291851,1.9531685930649667,890,771,1661,-
chr22,38291860,1.630565371024735,838,565,1403,-
chr22,38294135,1.883458646616541,667,503,1170,-
chr22,38294223,1.4241694415262753,1631,701,2332,-
chr22,38294233,2.3113101903695408,687,375,1062,-
chr22,38294246,0.2945787506517025,3281,1802,5083,-
chr22,38294247,0.2945787506517025,3281,1802,5083,-
chr22,38294371,3.4921607919261257,696,615,1311,-
chr22,38298874,1.8504894578313251,1142,829,1971,-
chr22,38298913,2.3572462020737883,1028,637,1665,-
chr22,38299936,2.1040687485517005,1824,1265,3089,-
chr22,38299959,1.9228537293053425,785,566,1351,-
chr22,38300741,1.9665914221218956,725,442,1167,-
chr22,38300776,1.6453586497890296,1417,710,2127,-
chr22,38300777,1.6453586497890296,1417,710,2127,-
chr22,38300851,1.6177267856017146,657,546,1203,-
chr22,38300870,1.6432130755431529,686,518,1204,-
chr22,38302900,1.4129870129870132,1172,965,2137,-
chr22,38302901,0.560002149492839,1757,1217,2974,-
chr22,38302918,1.7109480305526432,951,606,1557,-
chr22,38303005,1.76063829787234,661,375,1036,-
chr22,38303164,0.6159116863342216,808,628,1436,-
chr22,38314092,1.7952871870397642,635,387,1022,-
chr22,38314094,1.1730607311485701,1087,889,1976,-
chr22,38314160,1.618695645224594,5523,4281,9804,-
chr22,38314162,1.5147507489439576,8002,6089,14091,-
chr22,38314164,1.2845471699594488,11800,8659,20459,-
chr22,38314165,1.1555970815102456,12155,8378,20533,-
chr22,38314166,1.0284696541997047,15888,11201,27089,-
chr22,38314167,1.182341177610615,9403,6835,16238,-
chr22,38314168,0.6248412957521674,2649,2041,4690,-
chr22,38314169,1.662289341212519,2169,1522,3691,-
chr22,38317168,1.1530891833359673,3348,1978,5326,-
chr22,38317169,1.4919530230535014,3429,1935,5364,-
chr22,38317171,1.2315312264860798,3240,1771,5011,-
chr22,38317172,1.3329418747480648,2771,1461,4232,-
chr22,38317174,1.3434804460563006,2425,1342,3767,-
chr22,38317177,1.868956737932437,1797,1011,2808,-
chr22,38317178,1.7737364138504483,1213,744,1957,-
chr22,38317181,1.6501311552916154,786,440,1226,-
chr22,38483686,1.7836284416427182,739,468,1207,-
chr22,38483896,1.954515272244356,840,501,1341,-
chr22,38483909,2.44549367437743,1412,920,2332,-
chr22,38483919,2.1759615384615385,656,467,1123,-
chr22,38484144,0.5550780690445496,774,536,1310,-
chr22,38484432,0.6642445425558009,1237,905,2142,-
chr22,38484583,1.5976470588235294,678,577,1255,-
chr22,38484708,0.5826330532212886,675,441,1116,-
chr22,38484992,1.9563492063492067,594,489,1083,-
chr22,38485043,2.0064568200161417,677,412,1089,-
chr22,38485486,0.5069854028567948,939,1126,2065,-
chr22,38485502,0.5182195843105656,1086,1591,2677,-
chr22,38485503,0.5234087945952353,367,766,1133,-
chr22,38485506,0.5173187571921749,665,868,1533,-
chr22,38485515,0.4873792706897905,1545,1988,3533,-
chr22,38485516,0.4446016499940218,1664,2280,3944,-
chr22,38485518,0.30346829613558113,2016,3246,5262,-
chr22,38485519,0.3030887736086772,2093,3620,5713,-
chr22,38485521,2.9933208524390538,3304,5681,8985,-
chr22,38485522,4.498031812489714,3227,4980,8207,-
chr22,38485523,4.498031812489714,3227,4980,8207,-
chr22,38485526,20.915370344116358,2563,2120,4683,-
chr22,38485527,19.816715542521997,1430,836,2266,-
chr22,38485528,25.0185702988615,3951,2296,6247,-
chr22,38485529,41.43704571972824,2844,1295,4139,-
chr22,38485530,58.947692307692314,1235,199,1434,-
chr22,38485532,11.888201333274491,2844,265,3109,-
chr22,38485533,9.642880221371843,2269,237,2506,-
chr22,38485534,8.974660497048557,2346,195,2541,-
chr22,38485535,8.2734375,1058,95,1153,-
chr22,38485536,12.663060025680258,1430,137,1567,-
chr22,38485538,11.74105065056772,1331,142,1473,-
chr22,38485660,1.6715663256988957,1123,587,1710,-
chr22,38485685,0.38217244409395545,642,370,1012,-
chr22,38485813,1.9143751695574311,1038,790,1828,-
chr22,38485814,2.332020324168644,961,751,1712,-
chr22,38485939,1.5311125078566938,579,429,1008,-
chr22,38486137,0.4745939882211967,1094,642,1736,-
chr22,38486138,0.4745939882211967,1094,642,1736,-
chr22,38486166,0.36901266682198963,753,544,1297,-
chr22,38486176,1.1992251649976322,847,611,1458,-
chr22,38486258,1.1977151815672469,1354,1009,2363,-
chr22,38486296,2.157263124160824,813,680,1493,-
chr22,38486306,0.5388743404842684,1128,870,1998,-
chr22,38486308,0.8540267539394302,1981,1632,3613,-
chr22,38486309,0.5122531249093704,1038,840,1878,-
chr22,38486435,22.36182716579378,1411,1146,2557,-
chr22,38486436,17.0065085030443,801,432,1233,-
chr22,38486438,4.809266111475719,1374,760,2134,-
chr22,38487979,0.5581145401504682,726,500,1226,-
chr22,38487983,1.9427754512708026,1100,732,1832,-
chr22,38488021,2.687084245327729,1274,870,2144,-
chr22,38488736,1.6368728898230187,572,470,1042,-
chr22,38489130,0.2794158564837266,1091,679,1770,-
chr22,38492077,0.40417903066271016,933,673,1606,-
chr22,38494110,1.7240237099023707,681,477,1158,-
chr22,38494128,2.7405336449043824,902,711,1613,-
chr22,38494913,3.120375,941,799,1740,-
chr22,38494914,3.237190009778781,1640,1277,2917,-
chr22,38495033,1.6607686453576864,601,437,1038,-
chr22,38495861,1.0801799438884117,1561,1109,2670,-
chr22,38495898,1.4087707099740063,9362,4817,14179,-
chr22,38495899,1.7017215353128337,11334,6436,17770,-
chr22,38495913,1.2883283937667955,6888,4640,11528,-
chr22,38495915,1.2883283937667955,6888,4640,11528,-
chr22,38495931,0.7108641502203487,2225,1534,3759,-
chr22,38495932,1.3655511155511155,2442,1616,4058,-
chr22,38495935,1.541546156850409,4112,2787,6899,-
chr22,38498096,1.501273831129505,2595,1554,4149,-
chr22,38498128,0.6329179461543956,1312,835,2147,-
chr22,38498132,1.5682409268235018,1128,768,1896,-
chr22,38498133,0.5931706681717536,1092,742,1834,-
chr22,38498471,0.5906022845275182,699,427,1126,-
chr22,38498550,2.0916660559340574,990,718,1708,-
chr22,38501243,2.9007633587786263,721,523,1244,-
chr22,38501244,2.9007633587786263,721,523,1244,-
chr22,38501245,2.9007633587786263,721,523,1244,-
chr22,38687055,1.7062362798068584,552,469,1021,-
chr22,38700271,0.2613395855894909,580,1232,1812,-
chr22,38700277,4.75222816399287,386,747,1133,-
chr22,38700278,7.712398720312638,1061,2133,3194,-
chr22,38700279,7.712398720312637,1061,2133,3194,-
chr22,38735145,2.704376773630212,582,1017,1599,-
chr22,38735146,7.453733892252758,472,1355,1827,-
chr22,38735147,9.64908444883127,3021,4886,7907,-
chr22,38735148,11.47877313360175,2716,4358,7074,-
chr22,38735149,12.26359078295886,2553,3824,6377,-
chr22,38735155,10.55781193455133,1351,668,2019,-
chr22,38735156,10.219890831506977,1217,594,1811,-
chr22,38735157,9.932285583560175,1445,663,2108,-
chr22,38735625,4.950975079080579,573,435,1008,-
chr22,39314200,1.246968111375306,22477,15474,37951,-
chr22,39314208,1.122846889952153,1070,835,1905,-
chr22,39314698,1.1922838657011643,25164,17000,42164,-
chr22,39314776,1.1224210382550608,58647,38248,96895,-
chr22,39314777,1.1494501690811625,31244,18091,49335,-
chr22,39314786,1.0366675463394828,35467,25340,60807,-
chr22,39314821,1.4414000538762306,19978,10636,30614,-
chr22,39314822,1.3595940890291551,29757,16945,46702,-
chr22,39315511,1.3383091229384367,19525,12980,32505,-
chr22,39315529,1.3611285796250925,14340,10018,24358,-
chr22,39315530,1.258589914913466,39498,25867,65365,-
chr22,39315532,1.2037941838469657,19016,10666,29682,-
chr22,39316746,1.3959908990350456,9024,6540,15564,-
chr22,39316778,1.2563132407166722,20603,11540,32143,-
chr22,39316779,1.252521958038088,28844,16732,45576,-
chr22,39317544,1.0007082154117077,27926,21556,49482,-
chr22,39317588,0.8932688826681758,15392,9338,24730,-
chr22,39317619,1.146839093972711,45771,35202,80973,-
chr22,39317620,1.1414753059963,56099,41434,97533,-
chr22,39317623,0.8535543246837833,7976,6069,14045,-
chr22,39318449,1.369695218558166,28746,19067,47813,-
chr22,39318450,1.369695218558166,28746,19067,47813,-
chr22,39318452,0.86321607891721,6873,5293,12166,-
chr22,39318468,1.332791378369504,18374,11001,29375,-
chr22,39318470,1.3591160421223578,25006,15805,40811,-
chr22,39318472,1.5466023822741366,7177,4613,11790,-
chr22,39318484,1.3555556334547392,3613,1816,5429,-
chr22,39318491,1.5318896961729993,2811,1372,4183,-
chr22,39318503,2.8809759916492688,2082,957,3039,-
chr22,39318507,1.4576200734345668,3808,1620,5428,-
chr22,39318508,1.3814937466233883,8492,4685,13177,-
chr22,39318509,1.2205433165297386,6139,4474,10613,-
chr22,39318510,1.6637814064473868,3555,1473,5028,-
chr22,39318513,1.6788797061524334,1555,604,2159,-
chr22,39319620,1.6075349181091991,3343,2452,5795,-
chr22,39319622,1.3889241598980253,6682,4845,11527,-
chr22,39319623,1.024661492824852,1149,841,1990,-
chr22,39529369,3.4415408439798685,772,368,1140,-
chr22,39529899,1.1175166297117518,695,450,1145,-
chr22,39529900,1.1175166297117518,695,450,1145,-
chr22,39532439,0.8143737665428818,694,574,1268,-
chr22,39532453,0.5768219899637678,750,698,1448,-
chr22,39532455,3.090266279756572,635,511,1146,-
chr22,40825728,1.998086734693877,963,671,1634,-
chr22,40825730,1.998086734693877,963,671,1634,-
chr22,40826333,2.4178306092124813,1355,672,2027,-
chr22,40826334,2.4178306092124813,1355,672,2027,-
chr22,40826335,2.5265017667844525,857,565,1422,-
chr22,40826340,2.1066875524092112,1259,836,2095,-
chr22,40826583,3.518000518000518,798,593,1391,-
chr22,40826608,2.132065775950668,921,555,1476,-
chr22,40826657,1.5102745983431196,1755,1334,3089,-
chr22,40826660,1.7679697351828498,700,487,1187,-
chr22,40827159,1.6862745098039216,687,509,1196,-
chr22,40827169,3.314643808859634,1114,823,1937,-
chr22,40827189,0.4318918918918919,798,554,1352,-
chr22,40827190,0.4318918918918919,798,554,1352,-
chr22,40827203,1.3334911986126472,861,501,1362,-
chr22,40830948,1.6541124685377586,1725,1117,2842,-
chr22,40830950,1.6728553137003839,662,373,1035,-
chr22,40856502,2.211909660352134,950,531,1481,-
chr22,41245805,7.352875259849338,1312,917,2229,-
chr22,41245806,5.012373664889688,1103,783,1886,-
chr22,41245889,1.4370057133332002,554,487,1041,-
chr22,41246012,5.603969913581564,956,486,1442,-
chr22,41246014,7.298045969023879,1448,854,2302,-
chr22,41246094,1.1279508546216939,751,528,1279,-
chr22,41251053,2.761904761904762,599,449,1048,-
chr22,41251054,2.761904761904762,599,449,1048,-
chr22,41254330,0.29997233621911823,665,703,1368,-
chr22,41254383,4.881842806625952,829,1143,1972,-
chr22,41254386,5.200972500087583,582,566,1148,-
chr22,41254452,11.173742381207475,845,600,1445,-
chr22,41254467,5.354213927126391,684,355,1039,-
chr22,41256207,2.1936754873901037,666,505,1171,-
chr22,41281078,2.614373333646519,728,421,1149,-
chr22,41459868,0.4019550342130988,513,494,1007,-
chr22,41459875,0.6115011202389843,533,514,1047,-
chr22,41459882,0.5493507369559174,1191,1231,2422,-
chr22,41459883,0.5299833780846439,828,868,1696,-
chr22,41459892,6.265082587023114,862,943,1805,-
chr22,41459894,5.91648472246267,1565,1853,3418,-
chr22,41459899,12.291055021594266,2529,1711,4240,-
chr22,41459900,12.749644534991171,2682,1760,4442,-
chr22,41459901,13.138020443855236,3321,1946,5267,-
chr22,41459903,11.285886988453642,1316,475,1791,-
chr22,41460176,2.756742556917689,953,570,1523,-
chr22,41460205,0.5826604334891627,913,542,1455,-
chr22,41460212,2.000907441016334,818,493,1311,-
chr22,41460220,0.5879681647940075,660,444,1104,-
chr22,41460221,0.5992359630419332,709,535,1244,-
chr22,41460347,1.778406126348663,1368,953,2321,-
chr22,41460420,0.5062427874381116,1045,800,1845,-
chr22,41460457,2.12864557587741,688,475,1163,-
chr22,41460471,1.6319002088128696,1057,752,1809,-
chr22,41467508,2.210425204918033,522,487,1009,-
chr22,41467610,3.4625696019797902,729,372,1101,-
chr22,41467612,3.4625696019797902,729,372,1101,-
chr22,41468667,1.922751234727183,695,404,1099,-
chr22,41532105,1.811751732829237,741,528,1269,-
chr22,41532108,1.9558889993672606,697,480,1177,-
chr22,41532128,0.5372581858242206,1922,1294,3216,-
chr22,41532130,0.5028370100014534,1567,1173,2740,-
chr22,41532134,1.4233750995264636,628,486,1114,-
chr22,41586150,1.6740079365079366,766,559,1325,-
chr22,41586188,2.299559480091868,1255,784,2039,-
chr22,41586189,1.913704128440367,1334,871,2205,-
chr22,41586191,1.8600413582281892,861,546,1407,-
chr22,41604100,2.654974827898298,628,447,1075,-
chr22,41674234,3.093717773794786,703,511,1214,-
chr22,41674244,1.3495581286788412,685,464,1149,-
chr22,41674246,2.0662707468834216,919,604,1523,-
chr22,41674247,3.0943106225943477,1556,1005,2561,-
chr22,41674602,2.718309235838639,721,547,1268,-
chr22,41674999,1.4786427644771294,2944,2220,5164,-
chr22,41675015,1.5180776014109347,938,755,1693,-
chr22,41675024,2.0478855721393034,889,669,1558,-
chr22,41675189,1.4063963072865149,1375,1010,2385,-
chr22,41680337,1.7158323479174882,1483,1289,2772,-
chr22,41680349,1.4891696071906775,3649,2727,6376,-
chr22,41680353,1.7858619264158744,1343,825,2168,-
chr22,41680363,1.7714617583356538,2525,1828,4353,-
chr22,41682401,3.107028506661534,711,488,1199,-
chr22,41688806,2.083843051335085,1685,1219,2904,-
chr22,41688807,1.9685577580314424,1151,797,1948,-
chr22,41688824,0.7616677372423076,1123,779,1902,-
chr22,41688825,0.8444303529909107,704,512,1216,-
chr22,41688846,1.5813562997207127,820,496,1316,-
chr22,41688848,2.3017996426859555,743,432,1175,-
chr22,41688850,2.8175064599483197,670,343,1013,-
chr22,42086246,1.7197230538922157,900,667,1567,-
chr22,42086296,0.4493969298245614,1170,854,2024,-
chr22,42086309,1.9837851630176841,1849,1352,3201,-
chr22,42087112,0.7761771740750191,4358,2281,6639,-
chr22,42087120,0.8198859459137243,3033,1705,4738,-
chr22,42087130,0.7724677361987398,4189,2591,6780,-
chr22,42087131,1.2141669877984889,3576,2250,5826,-
chr22,42087144,1.2976823213286748,2356,1470,3826,-
chr22,42087145,0.4470645835794017,3516,2282,5798,-
chr22,42087146,0.6435273764956191,5088,3231,8319,-
chr22,42090671,2.0262799564270146,646,407,1053,-
chr22,42090693,1.976470588235294,631,394,1025,-
chr22,42107889,0.9798746288353675,659,432,1091,-
chr22,42107891,1.716903536882409,1052,821,1873,-
chr22,42108408,3.338030614776962,775,426,1201,-
chr22,42108860,0.952818091600476,897,681,1578,-
chr22,42108861,0.8818515887927277,880,622,1502,-
chr22,42628255,1.3050999672238606,2236,1349,3585,-
chr22,42628256,1.0523442537233745,3491,2704,6195,-
chr22,42628274,2.277004909983633,794,610,1404,-
chr22,42628277,1.3925465838509317,1139,689,1828,-
chr22,42630921,2.008422416585682,743,440,1183,-
chr22,42630931,2.3104943064182195,870,551,1421,-
chr22,42630932,1.5435373611511032,2740,1896,4636,-
chr22,42630934,1.6121941993147155,2949,1958,4907,-
chr22,42630975,0.8558275049694287,809,538,1347,-
chr22,42776597,1.4550842170929508,1865,915,2780,-
chr22,42776600,1.4093023984459452,1729,828,2557,-
chr22,42776603,1.7064278384061808,3385,2158,5543,-
chr22,42776611,1.4772049063784882,3675,2062,5737,-
chr22,42776613,1.1518160983401626,3316,2022,5338,-
chr22,42776615,0.9220964110429006,6111,3950,10061,-
chr22,42776616,0.6678865507776761,1824,1092,2916,-
chr22,42776617,1.060625325088135,2071,1693,3764,-
chr22,42776619,0.5942247249869042,824,367,1191,-
chr22,42776682,2.6308669704546515,704,475,1179,-
chr22,42777115,0.9051127471212415,6830,4887,11717,-
chr22,42777116,0.781634888364407,5154,4251,9405,-
chr22,42777117,0.9673609943009905,9045,6428,15473,-
chr22,42777118,0.8126580040661187,2703,2094,4797,-
chr22,42777122,0.7426459168142142,515,656,1171,-
chr22,42777123,0.7426459168142142,515,656,1171,-
chr22,42777124,0.7425959409630851,761,537,1298,-
chr22,42796805,3.2361372401955992,645,469,1114,-
chr22,42796808,2.055659779439726,782,590,1372,-
chr22,42797013,1.941162471223528,660,476,1136,-
chr22,42799129,2.311837098168534,1408,954,2362,-
chr22,42799130,2.240306581926027,1695,1125,2820,-
chr22,42799133,3.3110443275732533,677,483,1160,-
chr22,42799134,2.5605980568004125,930,633,1563,-
chr22,42870905,1.7451677748569665,890,668,1558,-
chr22,42870933,0.4464925755248336,871,650,1521,-
chr22,42870970,2.2204979698719707,1902,1293,3195,-
chr22,42870971,2.2390808013219488,2186,1499,3685,-
chr22,43179960,1.8519920243237278,614,435,1049,-
chr22,43220503,1.2779321806372912,2310,1678,3988,-
chr22,43220520,1.5654742369543813,1271,1107,2378,-
chr22,43220521,1.4363655974973448,1953,1571,3524,-
chr22,44495128,2.3962626889418015,690,402,1092,-
chr22,46685253,0.5862640880194143,797,520,1317,-
chr22,50523717,1.539849871755653,660,466,1126,-
chr22,50523718,2.382818523950071,727,672,1399,-
chr22,50523719,2.3600011593950567,1667,1329,2996,-
chr22,50523720,3.2423367035788795,907,803,1710,-
chr22,50523721,3.4176,711,599,1310,-
chr22,50754829,1.8888803067568605,2284,1120,3404,-
chr22,50754830,2.3001735106998265,1762,816,2578,-
chr22,50754898,1.9195046988974134,1022,546,1568,-
chr22,50754900,0.8046295799924769,1130,552,1682,-
chrX,6422615,1.4107113737667412,835,623,1458,-
chrX,6422624,1.4814680243803693,964,663,1627,-
chrX,13379111,1.1326484015663885,659,468,1127,-
chrX,13379348,0.6046099932568157,1778,1295,3073,-
chrX,13379349,0.8648230966822961,1742,1224,2966,-
chrX,15385093,1.908496732026144,1824,1124,2948,-
chrX,15385100,1.658056640625,1616,959,2575,-
chrX,15385103,1.3734710519162816,1466,848,2314,-
chrX,15385106,1.9263540045936132,1599,1226,2825,-
chrX,15385113,0.3192099617572988,1052,603,1655,-
chrX,15390206,2.478893720857701,2854,1629,4483,-
chrX,15390207,2.771922338382761,2029,1089,3118,-
chrX,15390209,0.5798891129032258,766,495,1261,-
chrX,15390247,0.4673135852911133,609,444,1053,-
chrX,15397506,0.5967611336032389,736,454,1190,-
chrX,15397509,1.7686098654708515,695,445,1140,-
chrX,15397512,1.9977313974591653,628,463,1091,-
chrX,15425949,2.090552090552091,723,480,1203,-
chrX,15455914,0.5445002107198958,835,606,1441,-
chrX,15456003,1.603453270757286,1095,1045,2140,-
chrX,15456004,1.7335924846128927,1573,1469,3042,-
chrX,15456006,1.6514156684389212,1020,931,1951,-
chrX,15456019,1.4227149980656872,1216,878,2094,-
chrX,15456021,1.8773678963110667,806,589,1395,-
chrX,15479817,0.47149412443872596,1107,754,1861,-
chrX,15491295,2.039345314110797,849,555,1404,-
chrX,16845036,1.4828431372549018,1572,1247,2819,-
chrX,16845089,1.6384723523898783,998,775,1773,-
chrX,16845840,0.6290516206482593,1440,1070,2510,-
chrX,16849288,1.7549903514207315,2413,1747,4160,-
chrX,16849298,1.5157150918860565,1143,768,1911,-
chrX,16852083,2.1854636591478696,1307,797,2104,-
chrX,16852797,0.574160447761194,1230,863,2093,-
chrX,16852858,1.7473227769716906,4413,3331,7744,-
chrX,16852859,1.6502907408458094,3700,2763,6463,-
chrX,16853774,1.4123654733142983,1428,941,2369,-
chrX,16858720,2.628766965723488,1062,827,1889,-
chrX,16858802,1.8806756547342325,983,716,1699,-
chrX,16862998,1.9657414465719023,952,768,1720,-
chrX,16863037,0.6615684728617681,2470,1938,4408,-
chrX,16869175,0.5247187399549984,1112,764,1876,-
chrX,16869213,2.0299047181724257,642,561,1203,-
chrX,16869219,1.9119338976229194,970,809,1779,-
chrX,16870047,2.1464352923070305,1277,940,2217,-
chrX,16870067,0.5320020222446916,618,459,1077,-
chrX,16870224,2.0142857142857142,610,636,1246,-
chrX,16870225,1.3827884128540187,1006,1080,2086,-
chrX,16870271,0.5585337583309186,513,492,1005,-
chrX,16870285,0.5299136477004556,1247,1549,2796,-
chrX,16870299,0.4801497315218488,1530,1781,3311,-
chrX,16870300,1.9964516460857344,2719,3421,6140,-
chrX,16870302,4.252376091815734,3909,4059,7968,-
chrX,16870303,10.549647004663273,3237,2936,6173,-
chrX,16870304,10.779530406647392,2334,1855,4189,-
chrX,16870305,4.808659425680703,1133,610,1743,-
chrX,16870308,16.256602128442726,894,526,1420,-
chrX,16870310,6.680673326748223,1172,863,2035,-
chrX,16870311,4.553751952489163,908,677,1585,-
chrX,20127302,0.9440534584488521,663,520,1183,-
chrX,20127303,0.9440534584488521,663,520,1183,-
chrX,20127304,2.1668494877861435,787,536,1323,-
chrX,20127313,3.79428939351539,682,433,1115,-
chrX,20127610,1.7144261006289307,670,423,1093,-
chrX,20127676,0.5595799424019364,706,555,1261,-
chrX,20186362,1.554366467514677,601,482,1083,-
chrX,23703893,3.5920909273463733,652,451,1103,-
chrX,23730539,0.4391640734329384,671,455,1126,-
chrX,23730825,3.15849304896416,762,492,1254,-
chrX,24788778,1.6016802785016475,4643,3431,8074,-
chrX,24788782,1.2899932829735412,6544,4484,11028,-
chrX,24788786,1.2942785245012356,2230,1411,3641,-
chrX,24788790,0.9915060240963854,2833,2157,4990,-
chrX,24788792,1.1735924718309578,3837,2809,6646,-
chrX,24788802,1.7254901960784312,1275,753,2028,-
chrX,24788815,1.617533718689788,875,691,1566,-
chrX,24788876,1.3508978826051996,637,454,1091,-
chrX,24788881,0.4365325077399381,657,594,1251,-
chrX,24788910,1.4448717948717948,881,647,1528,-
chrX,24788922,1.0753827311696265,1032,689,1721,-
chrX,24788923,1.5973189600904454,1774,1192,2966,-
chrX,24788925,1.0288023317435082,946,628,1574,-
chrX,24789020,1.8993288590604027,848,595,1443,-
chrX,24789025,1.3438770785363072,754,576,1330,-
chrX,25645890,1.713047253849381,16488,13194,29682,-
chrX,25645891,1.9199834347012865,13578,11629,25207,-
chrX,25645893,1.4449735004663529,16285,12739,29024,-
chrX,25645898,0.6400259607806777,3509,2441,5950,-
chrX,25645899,1.3958677007531868,16341,11878,28219,-
chrX,25645900,1.1529602927161158,10300,7410,17710,-
chrX,25645904,0.7627679005966626,12078,8558,20636,-
chrX,25645911,1.5644247351564424,3047,2213,5260,-
chrX,25645920,1.3555378159962885,3863,2619,6482,-
chrX,25645927,1.5007581565721102,1492,909,2401,-
chrX,25645928,0.4621397915389331,1205,931,2136,-
chrX,25645930,1.604082835426574,2485,1415,3900,-
chrX,25645931,1.681016335105331,3443,2011,5454,-
chrX,25645934,1.4249535376802869,1674,1011,2685,-
chrX,25645935,1.4249535376802869,1674,1011,2685,-
chrX,25645936,1.6512728783032726,1699,1106,2805,-
chrX,25645942,3.406294964028777,1283,694,1977,-
chrX,25645944,2.815653781761591,2060,1045,3105,-
chrX,25645977,2.496635722165705,1144,685,1829,-
chrX,25645992,2.8723158112202096,1338,602,1940,-
chrX,25645993,3.2607781282860153,885,316,1201,-
chrX,25645995,1.4442687747035574,782,494,1276,-
chrX,25645996,1.2384183151481194,1043,635,1678,-
chrX,25646008,1.6048077303869153,826,442,1268,-
chrX,31120713,1.5909024536484169,604,463,1067,-
chrX,31121602,1.9947374153840833,1196,812,2008,-
chrX,31121660,3.7166388657214346,712,435,1147,-
chrX,31134145,2.1162068965517244,721,599,1320,-
chrX,31134147,2.3610591076295258,1847,1389,3236,-
chrX,31134148,2.5845656192236603,798,540,1338,-
chrX,31134149,2.3216355390930907,1670,1288,2958,-
chrX,31134151,2.5297730736109596,1316,997,2313,-
chrX,31204017,2.3379106906723632,883,677,1560,-
chrX,31204018,2.0792919749385894,1429,1058,2487,-
chrX,31260980,0.9088709677419354,643,479,1122,-
chrX,31260981,0.9088709677419354,643,479,1122,-
chrX,31261000,2.514699682438952,615,470,1085,-
chrX,31261002,1.8188293916110918,936,630,1566,-
chrX,37839770,2.5722114789621537,850,622,1472,-
chrX,37840614,0.8743744719568468,960,668,1628,-
chrX,37840615,0.8743744719568468,960,668,1628,-
chrX,37840636,1.9348143779898848,614,489,1103,-
chrX,38161047,2.4965457685664942,707,578,1285,-
chrX,38161048,3.3495145631067955,674,514,1188,-
chrX,39786958,1.7162037037037037,673,479,1152,-
chrX,39786959,1.7162037037037037,673,479,1152,-
chrX,39786960,1.430487594724948,878,637,1515,-
chrX,39787040,0.5084762352204212,1038,773,1811,-
chrX,39787043,1.476244343891403,869,883,1752,-
chrX,39787054,1.7507520357575788,3592,2445,6037,-
chrX,39787055,1.6399524375743164,2585,1681,4266,-
chrX,39787056,2.0176470588235293,1007,764,1771,-
chrX,39787066,1.2877551020408162,1261,979,2240,-
chrX,39787067,1.4758116359365745,2015,1443,3458,-
chrX,39787068,1.737761624845049,3497,2278,5775,-
chrX,39787069,2.128708133971292,1482,835,2317,-
chrX,39787083,1.0444503171247357,940,472,1412,-
chrX,39787085,1.0444503171247357,940,472,1412,-
chrX,39787617,1.9839609483960945,568,477,1045,-
chrX,39787678,0.8166740285075005,563,461,1024,-
chrX,39787817,2.2201631701631697,885,659,1544,-
chrX,39787819,2.2201631701631697,885,659,1544,-
chrX,39787903,1.1668152993179626,5710,4618,10328,-
chrX,39787909,1.204606430548655,7221,5109,12330,-
chrX,39787915,1.506464124111183,4424,3824,8248,-
chrX,39787916,1.3756536440837208,8131,6839,14970,-
chrX,39787922,1.3214022099795546,5118,4220,9338,-
chrX,39787923,1.3214022099795546,5118,4220,9338,-
chrX,39787924,1.3214022099795546,5118,4220,9338,-
chrX,39787927,1.5940999138673555,1345,1031,2376,-
chrX,39787930,1.2677930461802207,2882,2073,4955,-
chrX,39787931,0.7031071655041218,1133,854,1987,-
chrX,39787933,1.3772955985113653,4743,3260,8003,-
chrX,39787934,1.3772955985113653,4743,3260,8003,-
chrX,39787935,0.6077185424519834,1471,1237,2708,-
chrX,39787939,1.1151821921831226,4994,3891,8885,-
chrX,39787941,1.1638939474763776,5884,4548,10432,-
chrX,39787942,1.7023164442989276,980,642,1622,-
chrX,39787943,1.0676793633535178,2052,1479,3531,-
chrX,39788015,0.8672190229952599,874,634,1508,-
chrX,39788113,1.0740946964803246,6256,4416,10672,-
chrX,39788114,1.049177020966115,3442,2218,5660,-
chrX,39788115,1.1954756520411305,2408,1884,4292,-
chrX,39788148,0.34501173766732146,1499,1138,2637,-
chrX,39788150,0.3149052782080305,880,762,1642,-
chrX,39788172,0.9934318555008212,604,405,1009,-
chrX,39788173,0.9934318555008212,604,405,1009,-
chrX,42098876,0.5699089902234253,1021,959,1980,-
chrX,44476374,1.2867528510579718,556,504,1060,-
chrX,46440223,1.597269624573379,863,585,1448,-
chrX,46440229,0.8093875722289491,2035,1700,3735,-
chrX,46440230,0.7524876793169477,921,860,1781,-
chrX,46440231,0.7524876793169477,921,860,1781,-
chrX,46440393,0.545982905982906,1596,1286,2882,-
chrX,46440396,1.1361987247399334,3339,2359,5698,-
chrX,46440399,1.5269953977646282,1527,1013,2540,-
chrX,46440400,1.547573839662447,862,789,1651,-
chrX,46440401,1.547573839662447,862,789,1651,-
chrX,46440414,1.6106373255447506,1020,696,1716,-
chrX,46440706,1.6993359893758302,1370,1003,2373,-
chrX,46440707,0.6013739251115687,1121,1046,2167,-
chrX,46440714,0.9465092122769255,1168,971,2139,-
chrX,46440719,1.346864735891538,824,632,1456,-
chrX,46440721,1.2855083605612148,685,483,1168,-
chrX,46725507,0.6038394531340863,1545,1094,2639,-
chrX,46725509,0.4498594189315839,639,483,1122,-
chrX,47142398,1.5131149170643037,1852,1466,3318,-
chrX,47142399,1.230934872030215,4343,3791,8134,-
chrX,47142401,1.3203111863044659,4006,3310,7316,-
chrX,47142436,1.563850935596857,1238,736,1974,-
chrX,47142438,1.4920634920634919,939,827,1766,-
chrX,47144485,1.8902263374485602,966,719,1685,-
chrX,47144489,0.6337109509097152,1135,970,2105,-
chrX,47144502,1.4227256119839238,1297,832,2129,-
chrX,47144545,2.0559305689488907,655,487,1142,-
chrX,47144687,0.3626006191950464,731,424,1155,-
chrX,47144691,1.1634143103677153,625,377,1002,-
chrX,47635906,5.833675079412521,398,646,1044,-
chrX,47635907,7.7622377622377625,449,584,1033,-
chrX,47635908,7.7622377622377625,449,584,1033,-
chrX,47651889,2.8598906661267467,564,448,1012,-
chrX,47652099,0.6454686237543764,912,631,1543,-
chrX,47652121,1.9600334798074912,645,530,1175,-
chrX,47657269,1.372391075679566,1152,891,2043,-
chrX,47657818,0.9228110599078341,1334,929,2263,-
chrX,47657819,0.9228110599078341,1334,929,2263,-
chrX,47657820,0.18111298482293425,715,592,1307,-
chrX,47657835,2.444306031350566,1543,1013,2556,-
chrX,47657836,2.444306031350566,1543,1013,2556,-
chrX,47658883,1.5241740531829169,969,583,1552,-
chrX,47658884,2.012511301151069,1971,1393,3364,-
chrX,47658886,2.5440140845070425,679,567,1246,-
chrX,48893521,2.6321244463392577,746,615,1361,-
chrX,48894124,1.7637793791502618,663,405,1068,-
chrX,48894191,1.4131944444444444,813,467,1280,-
chrX,48894192,1.4131944444444444,813,467,1280,-
chrX,48896839,2.2798737594786327,1068,796,1864,-
chrX,48896840,2.3781512605042017,848,594,1442,-
chrX,48922346,3.0568961397508647,636,476,1112,-
chrX,48922347,3.0568961397508647,636,476,1112,-
chrX,48922718,4.1563644496754995,859,668,1527,-
chrX,48922727,2.068649885583524,677,398,1075,-
chrX,48922728,2.283375856633868,788,505,1293,-
chrX,48923206,4.725,692,399,1091,-
chrX,48923207,4.725,692,399,1091,-
chrX,48934477,1.7863481841967155,1718,1749,3467,-
chrX,48934478,1.7752602297200288,1198,1392,2590,-
chrX,48934480,2.229408529043885,1293,1278,2571,-
chrX,49071986,2.0847885344788173,2709,1916,4625,-
chrX,49071992,2.041514041514042,683,350,1033,-
chrX,49071995,1.5155151195499297,840,631,1471,-
chrX,49071998,1.8807065217391306,768,559,1327,-
chrX,49072001,1.7361758241758238,680,454,1134,-
chrX,49074861,2.3934302502485103,700,651,1351,-
chrX,49078092,4.326712820064511,623,443,1066,-
chrX,49113466,9.354858124396198,981,851,1832,-
chrX,49113467,10.217291753828086,894,813,1707,-
chrX,49113479,9.430085601954548,780,644,1424,-
chrX,49123733,0.8292282570745659,1483,1281,2764,-
chrX,49123734,1.0361052001224298,956,848,1804,-
chrX,52832851,0.933029737674613,1296,1032,2328,-
chrX,52832852,0.6076228539399774,1060,766,1826,-
chrX,52833296,0.857142857142857,755,521,1276,-
chrX,52833302,1.0455750232350003,674,417,1091,-
chrX,52833303,1.0455750232350003,674,417,1091,-
chrX,52833694,0.35482369840295697,1303,880,2183,-
chrX,53198839,0.8108199492814877,653,506,1159,-
chrX,53198840,1.3456341589903495,857,649,1506,-
chrX,53198841,0.8108199492814877,653,506,1159,-
chrX,53374791,3.534478808705613,531,484,1015,-
chrX,53374792,3.534478808705613,531,484,1015,-
chrX,53379469,0.47713502116803275,633,451,1084,-
chrX,53379589,2.5332280563232,769,446,1215,-
chrX,53379591,2.5332280563232,769,446,1215,-
chrX,53382334,1.4834944098897012,836,528,1364,-
chrX,53382659,1.556756035747632,1060,587,1647,-
chrX,53383122,0.4521288209606987,752,457,1209,-
chrX,53383131,0.34835164835164834,633,419,1052,-
chrX,53383223,3.5924791188033427,682,507,1189,-
chrX,53383233,1.2872788758771634,605,422,1027,-
chrX,53394798,2.3690839283792027,1178,898,2076,-
chrX,53394835,2.6061643835616435,760,437,1197,-
chrX,53394845,1.5826508040322398,2543,1464,4007,-
chrX,53394846,1.6720370112056542,1218,641,1859,-
chrX,53394848,0.581758530183727,681,380,1061,-
chrX,53396273,2.1877087706258718,622,470,1092,-
chrX,53396559,2.9509788808386004,708,498,1206,-
chrX,53396590,1.695945945945946,752,591,1343,-
chrX,53399603,2.0957761635727743,759,530,1289,-
chrX,53399615,2.122934888241011,770,587,1357,-
chrX,53399648,1.7675587632014396,1482,899,2381,-
chrX,53403586,1.9675510645889454,699,463,1162,-
chrX,53403603,2.666602357851331,819,590,1409,-
chrX,53411832,1.4670636303602782,3221,1968,5189,-
chrX,53411833,1.937784299339692,2200,1362,3562,-
chrX,53411834,1.937784299339692,2200,1362,3562,-
chrX,53413058,2.523652453740949,2963,2259,5222,-
chrX,53413060,2.166760604685903,5789,4278,10067,-
chrX,53413061,2.0762925494193776,4282,3111,7393,-
chrX,53413062,1.8948532752290619,4812,3512,8324,-
chrX,53413073,2.3904888215233044,1146,753,1899,-
chrX,53413077,2.7537704498977504,1050,651,1701,-
chrX,53413088,1.5174740484429066,1252,934,2186,-
chrX,53413091,3.0558314522197145,780,442,1222,-
chrX,53413094,2.1108627314006294,736,408,1144,-
chrX,53413097,2.759517988124345,686,408,1094,-
chrX,53413109,2.362572150403863,1464,876,2340,-
chrX,53413132,6.938828795225662,688,382,1070,-
chrX,53413256,2.696024464831804,695,326,1021,-
chrX,53413411,2.4215037008180755,665,452,1117,-
chrX,53413413,2.4215037008180755,665,452,1117,-
chrX,53413419,2.0527744944930744,779,546,1325,-
chrX,53422567,0.32938732072960414,1442,994,2436,-
chrX,53422568,0.3729885057471264,648,434,1082,-
chrX,53431385,1.1965728800760775,543,465,1008,-
chrX,53431386,0.9840745862515056,1102,772,1874,-
chrX,53431388,0.9840745862515056,1102,772,1874,-
chrX,53431558,0.5983665759208845,717,438,1155,-
chrX,53431855,2.111935720889892,719,551,1270,-
chrX,53432024,1.7244655581947743,604,420,1024,-
chrX,53433737,0.4904494382022472,581,444,1025,-
chrX,53433755,2.005903557344325,1040,680,1720,-
chrX,53539072,4.1541353383458635,934,417,1351,-
chrX,65518132,4.525614555476027,986,909,1895,-
chrX,65518161,2.2432297626382653,596,486,1082,-
chrX,65518165,5.220201032283612,1124,857,1981,-
chrX,65524175,3.474878690438648,781,427,1208,-
chrX,65529769,7.056607141525592,1073,942,2015,-
chrX,65533644,2.4039241862797804,549,457,1006,-
chrX,71059341,2.481917288245596,659,535,1194,-
chrX,71059837,0.9341557019639349,765,632,1397,-
chrX,71059839,1.0366939552767573,769,565,1334,-
chrX,71060769,19.32333695750316,1283,513,1796,-
chrX,71060770,21.51791007289497,1524,526,2050,-
chrX,71060771,21.51791007289497,1524,526,2050,-
chrX,72272670,1.4007306296900104,31472,23888,55360,-
chrX,72273972,0.9083629170088461,4824,3675,8499,-
chrX,72273973,0.994873663583602,2837,2270,5107,-
chrX,72275104,1.2195967342570344,29320,16937,46257,-
chrX,72275617,1.267343949893911,18527,11964,30491,-
chrX,72275647,1.2093850717321242,12697,10555,23252,-
chrX,72275695,1.3396952433989475,17234,12906,30140,-
chrX,72275696,1.2877853684509284,47919,34731,82650,-
chrX,72275698,1.4137649284455611,16432,12087,28519,-
chrX,72275708,1.4970156950602784,7362,5053,12415,-
chrX,72276210,1.1916713526020055,33955,22792,56747,-
chrX,72276220,1.3027327324248754,40637,24338,64975,-
chrX,72276221,1.23790980947977,47062,29252,76314,-
chrX,72276228,2.7059904014408063,4230,2473,6703,-
chrX,72277215,0.9659387368171892,21531,11799,33330,-
chrX,72277217,0.9926336818466465,30587,16707,47294,-
chrX,72277218,1.045749956461882,21318,11729,33047,-
chrX,72277219,0.8463297991516934,5232,2864,8096,-
chrX,72277240,1.8944444444444444,791,431,1222,-
chrX,72277244,2.5774555849333467,2615,1010,3625,-
chrX,72277246,0.7581238380082451,3049,1334,4383,-
chrX,72277247,0.7764724344980357,6176,2636,8812,-
chrX,72277248,0.7581238380082451,3049,1334,4383,-
chrX,72728211,1.0024930698249819,703,506,1209,-
chrX,74583094,1.8158064516129033,865,619,1484,-
chrX,74583095,1.8158064516129033,865,619,1484,-
chrX,74583115,1.0140612076095947,612,743,1355,-
chrX,74583116,1.0140612076095947,612,743,1355,-
chrX,74583123,0.3653222806737871,624,458,1082,-
chrX,74583125,0.3653222806737871,624,458,1082,-
chrX,75053526,2.0426632690588513,669,441,1110,-
chrX,76335014,0.9617486338797814,879,914,1793,-
chrX,76335016,0.7110091743119267,1239,1307,2546,-
chrX,76335017,0.3790944732833314,1647,1449,3096,-
chrX,76335018,1.395144530511997,546,473,1019,-
chrX,76335615,1.8104866562009418,847,636,1483,-
chrX,76335647,0.5657791410389221,1208,850,2058,-
chrX,76335670,2.0426017497147204,715,477,1192,-
chrX,76335671,1.1765602322206097,1045,688,1733,-
chrX,76335673,0.8000670353611529,681,441,1122,-
chrX,76335859,1.1317154423246938,1196,913,2109,-
chrX,76335860,1.1317154423246938,1196,913,2109,-
chrX,77682829,1.9543147208121827,879,787,1666,-
chrX,77682831,1.9543147208121827,879,787,1666,-
chrX,77682832,2.599810067027055,720,538,1258,-
chrX,77682835,1.0196705188099335,714,580,1294,-
chrX,77682837,1.0196705188099335,714,580,1294,-
chrX,77682877,3.455852156057495,560,486,1046,-
chrX,77682878,3.455852156057495,560,486,1046,-
chrX,77828867,1.5664939672067384,655,406,1061,-
chrX,77829057,1.540144631176956,633,463,1096,-
chrX,77875536,1.1050855627862135,654,460,1114,-
chrX,77875537,1.1050855627862135,654,460,1114,-
chrX,80571062,2.0095045252380306,1100,697,1797,-
chrX,81115149,2.5525015069318866,682,552,1234,-
chrX,81115170,2.3329085982217865,1490,954,2444,-
chrX,81115188,2.13855791658915,1208,696,1904,-
chrX,81116230,3.223214285714286,721,351,1072,-
chrX,81121576,4.191222570532916,763,463,1226,-
chrX,87703986,1.9233798928049373,1413,1047,2460,-
chrX,87703987,1.9233798928049373,1413,1047,2460,-
chrX,87703989,0.6620331724313141,628,466,1094,-
chrX,87703990,2.106251333475571,1233,871,2104,-
chrX,87703992,2.106251333475571,1233,871,2104,-
chrX,87704003,2.4134995439343263,881,505,1386,-
chrX,87704005,1.2654135338345864,1223,671,1894,-
chrX,87704007,1.0554163185742134,757,398,1155,-
chrX,87728521,0.891665863892878,596,458,1054,-
chrX,92113480,0.6319045514803359,1209,1022,2231,-
chrX,92113482,1.3233965925191766,1566,1338,2904,-
chrX,92113483,1.3753582554517134,1665,1199,2864,-
chrX,92113488,1.4349151258357489,2377,1860,4237,-
chrX,92113489,1.4933172241939139,823,696,1519,-
chrX,92113490,1.4349151258357489,2377,1860,4237,-
chrX,92113494,1.358820189033392,1585,1332,2917,-
chrX,92113497,2.0016918429003017,807,661,1468,-
chrX,92113498,1.7207098205283324,741,521,1262,-
chrX,92113506,1.4358715374285274,1054,770,1824,-
chrX,92113700,0.552855211485225,686,633,1319,-
chrX,92113706,1.4383022170361728,1210,856,2066,-
chrX,92113707,0.6043940400493498,1083,1027,2110,-
chrX,92113709,0.6043940400493498,1083,1027,2110,-
chrX,92113712,1.4144952709908487,1231,974,2205,-
chrX,92113842,1.6482670089858793,1283,655,1938,-
chrX,92113844,1.1827609917430515,2237,1092,3329,-
chrX,92113845,1.264508909990661,2230,1156,3386,-
chrX,92113846,1.2112144022596079,1909,905,2814,-
chrX,92113847,1.1650861484632715,1279,588,1867,-
chrX,92113932,1.6868173745049895,1083,745,1828,-
chrX,92113955,1.1580974391662235,701,482,1183,-
chrX,92114433,1.4320984125576717,3779,2751,6530,-
chrX,92114445,1.515672139754022,9597,4537,14134,-
chrX,92114446,1.4728215859862908,11154,5890,17044,-
chrX,92114447,1.500252875719358,10869,5402,16271,-
chrX,92114474,0.6038762632952946,4414,2369,6783,-
chrX,92676672,1.680594972015593,1145,828,1973,-
chrX,100629808,0.3998945880549101,1283,622,1905,-
chrX,100633962,2.7593220338983047,659,589,1248,-
chrX,100633969,2.581988547631442,639,451,1090,-
chrX,101398040,0.9963503649635037,519,547,1066,-
chrX,101398041,0.9963503649635037,519,547,1066,-
chrX,101401671,1.7117860930162097,836,573,1409,-
chrX,101401674,1.7172344689378756,778,498,1276,-
chrX,101401680,0.3931696486874755,668,402,1070,-
chrX,101401762,1.7833394675499938,631,428,1059,-
chrX,101407742,2.5880230952944046,768,524,1292,-
chrX,103253396,2.831818181818182,622,494,1116,-
chrX,103253397,2.831818181818182,622,494,1116,-
chrX,103253758,2.358734023128424,2152,1642,3794,-
chrX,103253760,2.358734023128424,2152,1642,3794,-
chrX,103253791,2.387109375,1357,799,2156,-
chrX,103253793,2.1946862577366275,2012,1168,3180,-
chrX,103253794,2.26658692185008,1321,759,2080,-
chrX,103253798,0.564580265095729,696,484,1180,-
chrX,103253919,1.9662227332368416,957,654,1611,-
chrX,103675675,1.4463469096105752,1950,1554,3504,-
chrX,103675699,1.2924639719284832,1752,1368,3120,-
chrX,103675732,1.3790153709066608,1271,1004,2275,-
chrX,103676327,1.6977781528409024,3610,2282,5892,-
chrX,103676646,1.2453907838523222,3406,2365,5771,-
chrX,103676675,1.4092680540873157,1257,1038,2295,-
chrX,103676685,1.5342685830679632,1527,1290,2817,-
chrX,103676728,1.8621896810672325,1774,1371,3145,-
chrX,103676729,1.8621896810672325,1774,1371,3145,-
chrX,103678539,2.05362262365352,2921,1941,4862,-
chrX,103678628,1.4128100703443167,1271,875,2146,-
chrX,103685204,1.6920924381752909,7529,5311,12840,-
chrX,103685209,1.7534361851332396,3524,2138,5662,-
chrX,103685210,1.7534361851332396,3524,2138,5662,-
chrX,103686644,1.6346627072204472,6596,3612,10208,-
chrX,103686671,1.608465947589137,3621,1882,5503,-
chrX,103686673,1.6928279418377497,8208,4207,12415,-
chrX,103686675,1.7596687914267684,9257,4475,13732,-
chrX,103686684,1.7060820367751062,1466,706,2172,-
chrX,103686695,1.608850786058595,4547,2020,6567,-
chrX,103686698,0.9082047400408096,5645,2258,7903,-
chrX,103686699,0.9112769041906768,4592,1821,6413,-
chrX,103688043,0.47914529561811275,1073,646,1719,-
chrX,103688050,0.5869133732743546,671,613,1284,-
chrX,108084623,1.8540775802866616,1100,794,1894,-
chrX,108084628,2.876513317191284,647,412,1059,-
chrX,108088000,1.7566539923954374,615,525,1140,-
chrX,108088001,1.7217756667884547,753,475,1228,-
chrX,108088005,0.4850619699934768,675,437,1112,-
chrX,109642119,2.073740034564236,704,540,1244,-
chrX,109642133,0.5557307683502865,618,482,1100,-
chrX,109642671,0.14520393306165155,1744,1081,2825,-
chrX,109642708,1.0245668463845288,1195,782,1977,-
chrX,109642920,1.8834449760765553,756,474,1230,-
chrX,109659408,2.1102187759623368,761,470,1231,-
chrX,109659445,1.6410792271851786,975,787,1762,-
chrX,109661634,2.2472559214326986,777,576,1353,-
chrX,109661638,0.3670020120724346,683,496,1179,-
chrX,109663280,1.956333044000801,1171,880,2051,-
chrX,109663341,1.8200143988480924,631,462,1093,-
chrX,109663344,2.3186902966314733,784,467,1251,-
chrX,109663356,1.8507462686567167,712,401,1113,-
chrX,109663362,1.9568078990833837,1260,873,2133,-
chrX,109669146,1.9686586286689134,812,671,1483,-
chrX,109669150,0.5112201963534362,728,526,1254,-
chrX,109669151,2.0150375939849625,669,398,1067,-
chrX,109678280,2.2632267441860465,676,429,1105,-
chrX,109678366,2.021447673131149,1209,817,2026,-
chrX,109681365,1.879197379197379,705,406,1111,-
chrX,109682877,1.9747940577428826,1086,766,1852,-
chrX,110198358,2.487894582268735,1210,542,1752,-
chrX,111620964,0.7362265874828688,4028,2785,6813,-
chrX,111620971,1.5960758438965794,6377,4460,10837,-
chrX,111620972,1.3592943436138452,15336,9264,24600,-
chrX,111620973,1.1728523528731645,8959,4804,13763,-
chrX,111620974,1.1728523528731645,8959,4804,13763,-
chrX,111620977,1.4973109570401086,2543,1341,3884,-
chrX,111621063,0.7132038453992545,2815,1698,4513,-
chrX,111621133,1.3654656328581074,4846,3323,8169,-
chrX,111621137,0.9596433289299868,2504,1513,4017,-
chrX,111621138,1.1277519287835416,4258,2746,7004,-
chrX,111621139,1.6243178904962456,1007,634,1641,-
chrX,111621143,1.6142749937463519,1693,1252,2945,-
chrX,111621145,1.6142749937463519,1693,1252,2945,-
chrX,111621146,1.7740091463414638,797,491,1288,-
chrX,111621149,0.7720484703028873,2124,1446,3570,-
chrX,111621150,0.9577492596248769,1385,1012,2397,-
chrX,111621152,1.8776747503566331,1169,700,1869,-
chrX,111621154,1.8776747503566331,1169,700,1869,-
chrX,111621155,1.9329781749441481,911,528,1439,-
chrX,111621156,1.155953906194279,1840,1180,3020,-
chrX,111621157,0.4487192934611593,929,652,1581,-
chrX,111621160,0.5642717289520728,981,690,1671,-
chrX,111621161,0.6084783159494954,1324,951,2275,-
chrX,111621163,0.6210963493265413,807,596,1403,-
chrX,111621497,1.6824124770273392,2246,1512,3758,-
chrX,111621503,1.7253028126895718,2472,1419,3891,-
chrX,111621505,1.6909536797231328,1993,1083,3076,-
chrX,111621506,0.8270264268265601,891,569,1460,-
chrX,114776388,1.1980378509164429,681,533,1214,-
chrX,114776389,1.2214649410168088,905,706,1611,-
chrX,115719031,0.4391783650646541,899,683,1582,-
chrX,116107080,2.411715257072754,863,677,1540,-
chrX,119539727,1.8956002982848619,1301,1042,2343,-
chrX,119539729,1.5349566735482802,2657,1984,4641,-
chrX,119539730,1.6375919124846168,1655,1224,2879,-
chrX,119539740,2.27020202020202,695,431,1126,-
chrX,119539762,1.9431818181818183,854,494,1348,-
chrX,119539764,1.2866107536306952,1241,706,1947,-
chrX,119539765,0.776375505146329,1094,653,1747,-
chrX,119653021,1.3915207410187997,1541,1045,2586,-
chrX,119653022,2.0679201584927642,1356,1070,2426,-
chrX,119653023,1.4271495652594737,2030,1529,3559,-
chrX,119653035,1.3194958287031278,645,423,1068,-
chrX,119663571,2.2867132867132867,653,428,1081,-
chrX,119663572,2.2867132867132867,653,428,1081,-
chrX,119786557,1.6508651211061445,5552,4065,9617,-
chrX,119786558,1.6847516286644952,3677,3069,6746,-
chrX,119786561,1.0644012596598764,6633,5703,12336,-
chrX,119786579,1.8361837538574768,3181,2193,5374,-
chrX,119786590,1.5275453126355043,5525,3547,9072,-
chrX,119786591,1.5275453126355043,5525,3547,9072,-
chrX,119786593,1.352610610190816,3307,2509,5816,-
chrX,119786608,1.3656136274325548,2327,1640,3967,-
chrX,119786611,1.4233778165484985,3228,1737,4965,-
chrX,119786613,1.3976512161274788,5174,3046,8220,-
chrX,119786617,0.6252744839701362,1138,689,1827,-
chrX,119786621,0.5074245792315021,1857,1174,3031,-
chrX,119786623,0.5074245792315021,1857,1174,3031,-
chrX,119786629,1.8537485582468283,1665,1444,3109,-
chrX,119786630,1.216153184850768,3754,2884,6638,-
chrX,119786631,0.6544405138707875,2089,1440,3529,-
chrX,119786641,1.947763839881143,1310,970,2280,-
chrX,119786642,1.601460152531562,1773,1292,3065,-
chrX,119786643,1.9969576606011379,1738,1110,2848,-
chrX,119786644,2.94343210968598,1090,594,1684,-
chrX,119786648,1.2948858730606518,902,509,1411,-
chrX,119786652,0.4081373172282263,641,428,1069,-
chrX,119786654,0.8429058041153162,1630,933,2563,-
chrX,119791628,1.1259200111095682,790,531,1321,-
chrX,119834415,3.3986928104575167,584,458,1042,-
chrX,119834417,3.3986928104575167,584,458,1042,-
chrX,119834982,2.710254146702383,1041,706,1747,-
chrX,119837822,2.5090803709428133,998,646,1644,-
chrX,119837871,1.590922909095102,2146,1349,3495,-
chrX,119837872,1.6466297446980953,1218,672,1890,-
chrX,119838044,1.8403969198221002,1841,1143,2984,-
chrX,119838045,1.8090567327409437,1230,769,1999,-
chrX,119838412,2.685304054054054,756,369,1125,-
chrX,119838413,2.685304054054054,756,369,1125,-
chrX,119838478,1.083590534979424,765,485,1250,-
chrX,119838480,1.083590534979424,765,485,1250,-
chrX,119871239,1.6763814944005877,973,837,1810,-
chrX,119871240,1.6763814944005877,973,837,1810,-
chrX,119871243,1.5339146983714325,694,514,1208,-
chrX,119925177,2.184367554840974,562,456,1018,-
chrX,119936311,1.7826916105367379,3985,2333,6318,-
chrX,119936374,1.7384250098931542,763,360,1123,-
chrX,119936375,0.6227011494252874,1378,695,2073,-
chrX,119936388,1.553791404325212,1031,561,1592,-
chrX,119936399,1.7237053245805984,843,456,1299,-
chrX,120446418,3.8018108512643596,711,544,1255,-
chrX,120530213,2.2397901835893594,1707,1255,2962,-
chrX,120530215,2.08274808702663,2647,1892,4539,-
chrX,120530218,2.014990512333966,776,526,1302,-
chrX,120530221,1.6010014306151643,721,465,1186,-
chrX,120530229,0.5358451349256675,1048,683,1731,-
chrX,120530230,0.5358451349256675,1048,683,1731,-
chrX,120532581,5.807679791734463,660,438,1098,-
chrX,120626230,1.1061342241117522,704,533,1237,-
chrX,120626231,1.1061342241117522,704,533,1237,-
chrX,120627008,2.2353720816368727,857,627,1484,-
chrX,121203938,1.08040313549832,602,469,1071,-
chrX,121203939,1.08040313549832,602,469,1071,-
chrX,121204650,1.748533163265306,702,447,1149,-
chrX,121204652,1.4312368775627953,895,647,1542,-
chrX,123610960,3.1832587621178217,682,446,1128,-
chrX,123611467,2.5095948827292114,641,401,1042,-
chrX,123611484,2.306350714671455,1072,572,1644,-
chrX,123623183,2.0312579329701648,566,457,1023,-
chrX,124326171,0.6178921568627451,2520,2039,4559,-
chrX,124326175,1.1340429720420393,7691,6777,14468,-
chrX,124326176,1.5845569298423203,4227,4518,8745,-
chrX,124326177,1.1081720592821835,10620,9227,19847,-
chrX,124326178,1.157472548652194,7109,6243,13352,-
chrX,124326181,0.6875997780338924,4183,3698,7881,-
chrX,124326182,0.6875997780338924,4183,3698,7881,-
chrX,124326183,0.6917597203265687,5612,5023,10635,-
chrX,124326186,0.6392948923867653,548,565,1113,-
chrX,124326187,1.022331739617092,1839,1599,3438,-
chrX,124326191,1.982578397212544,568,573,1141,-
chrX,124326206,1.0555164835164834,648,499,1147,-
chrX,124326207,1.0555164835164834,648,499,1147,-
chrX,129516343,1.7111855763385777,4346,2727,7073,-
chrX,129516345,2.2561692126909514,2591,1862,4453,-
chrX,129516348,1.8471808565266508,1172,748,1920,-
chrX,129516359,1.7436879759981536,1020,618,1638,-
chrX,129516362,1.6821310410020087,1866,1091,2957,-
chrX,129516363,1.6821310410020087,1866,1091,2957,-
chrX,129516366,1.713357200698973,1960,1187,3147,-
chrX,129516367,1.713357200698973,1960,1187,3147,-
chrX,129516369,1.6633663366336635,839,403,1242,-
chrX,129516416,0.3997722812395044,711,358,1069,-
chrX,129516424,3.833630511810628,702,401,1103,-
chrX,130130011,4.279595015576324,784,641,1425,-
chrX,130130012,3.5592034445640475,1166,928,2094,-
chrX,130130014,2.6654095238095237,1146,874,2020,-
chrX,130130015,1.9669317135677,1329,936,2265,-
chrX,130133449,1.875472462203024,750,462,1212,-
chrX,130133450,2.1474895503496563,1274,755,2029,-
chrX,130136108,1.0271176339119423,810,432,1242,-
chrX,130136109,1.0271176339119423,810,432,1242,-
chrX,130139856,0.5323343368917042,1267,922,2189,-
chrX,130139861,0.5569744139441675,702,498,1200,-
chrX,130140557,2.0598529411764708,608,424,1032,-
chrX,134566222,2.1490559186637617,622,611,1233,-
chrX,134566250,2.349934863212747,699,586,1285,-
chrX,134566251,2.349934863212747,699,586,1285,-
chrX,134771141,8.3738347101335,838,578,1416,-
chrX,134887931,1.2144822665889463,687,482,1169,-
chrX,134887965,3.7970873786407764,695,500,1195,-
chrX,134888288,0.8783295334482568,1169,733,1902,-
chrX,134888289,0.8783295334482568,1169,733,1902,-
chrX,134888335,2.6329942730748273,670,414,1084,-
chrX,134888653,0.643611513770967,739,438,1177,-
chrX,134888655,0.4455352033013188,2038,1258,3296,-
chrX,134889122,2.2008080366892337,694,481,1175,-
chrX,134889133,3.054322429906542,746,427,1173,-
chrX,134889135,3.054322429906542,746,427,1173,-
chrX,134896936,2.5870464813110914,696,477,1173,-
chrX,134899111,2.433793691608913,670,533,1203,-
chrX,134899462,1.0728726065636616,696,505,1201,-
chrX,135051326,1.7425687744522713,745,490,1235,-
chrX,136246300,0.6585299373088221,905,622,1527,-
chrX,136246304,1.2695056236177167,657,571,1228,-
chrX,136246314,2.019811034021234,1044,638,1682,-
chrX,136246316,1.4616728117892832,1838,1003,2841,-
chrX,136246317,1.196196196196196,955,443,1398,-
chrX,136246318,1.196196196196196,955,443,1398,-
chrX,136869930,3.2771930130242004,604,437,1041,-
chrX,136873553,2.3771081349206344,660,503,1163,-
chrX,136873657,1.7097713097713103,770,554,1324,-
chrX,136873848,1.6902223025483465,667,502,1169,-
chrX,136873876,2.434520884520885,1042,739,1781,-
chrX,136873877,2.7490942028985508,606,459,1065,-
chrX,136874136,0.6073689673066944,615,469,1084,-
chrX,136874141,1.798886827458256,605,538,1143,-
chrX,136874383,2.537186379928315,808,619,1427,-
chrX,136874384,2.8643135997727844,1175,833,2008,-
chrX,136875372,2.564406779661017,622,412,1034,-
chrX,136875380,2.0410341518738098,1238,889,2127,-
chrX,136876597,1.0598006644518274,791,386,1177,-
chrX,136876599,1.0598006644518274,791,386,1177,-
chrX,136876602,1.180162547187356,577,468,1045,-
chrX,136879272,0.8368642632870618,1431,894,2325,-
chrX,136879382,0.9903054388896416,1114,670,1784,-
chrX,136879383,1.1682591700556717,1002,816,1818,-
chrX,136879384,0.9903054388896416,1114,670,1784,-
chrX,136879385,1.1682591700556717,1002,816,1818,-
chrX,139789374,2.856750990551661,720,385,1105,-
chrX,139789375,2.9997884296639628,1164,696,1860,-
chrX,150231785,0.4796902011071972,736,530,1266,-
chrX,150231950,1.1628044211333064,802,567,1369,-
chrX,150231952,1.0047570206149108,967,643,1610,-
chrX,150232572,1.2108940825210444,817,520,1337,-
chrX,150232573,0.9683398564013378,1150,741,1891,-
chrX,150232574,1.0240984927985886,982,605,1587,-
chrX,150232575,1.1356435643564355,665,403,1068,-
chrX,152766667,5.028412423570322,609,430,1039,-
chrX,152766946,6.520867033861828,866,658,1524,-
chrX,152767227,1.9669672281279424,790,554,1344,-
chrX,152829708,5.88144151924735,789,617,1406,-
chrX,153700654,2.42765789579078,748,482,1230,-
chrX,153700657,2.6696515003386936,638,378,1016,-
chrX,153700660,2.661521388216304,850,412,1262,-
chrX,153700662,2.661521388216304,850,412,1262,-
chrX,153704038,1.1469437133731166,1103,805,1908,-
chrX,153715610,0.97009699007983,1724,1250,2974,-
chrX,153720961,1.6119718309859157,653,567,1220,-
chrX,153723206,2.1441489361702124,694,469,1163,-
chrX,153724359,5.696391589628535,798,678,1476,-
chrX,153724381,1.0136361718166769,899,651,1550,-
chrX,153787141,1.8581279021889672,649,502,1151,-
chrX,153794335,0.3839350621215597,600,417,1017,-
chrX,153930143,4.153421074458064,868,611,1479,-
chrX,153930145,3.3331993099618575,754,645,1399,-
chrX,153932086,1.5582784184514002,643,606,1249,-
chrX,153932092,1.7653693056169837,886,664,1550,-
chrX,153932093,2.207740916271722,644,421,1065,-
chrX,153932552,1.303616605067759,639,426,1065,-
chrX,154010679,2.3597466784512746,681,554,1235,-
chrX,154010773,2.903748430829075,708,516,1224,-
chrX,154011015,1.8239949743777937,856,579,1435,-
chrX,154014209,2.2767676767676766,1126,824,1950,-
chrX,154014210,2.2767676767676766,1126,824,1950,-
chrX,154014233,0.41810344827586216,775,579,1354,-
chrX,154014235,1.1069985911880882,1656,1123,2779,-
chrX,154014237,1.066914498141264,696,537,1233,-
chrX,154014243,1.5262835530277392,709,435,1144,-
chrX,154018103,0.4016356320944795,757,560,1317,-
chrX,154018715,2.136467212422989,914,696,1610,-
chrX,154018716,2.1915175838378342,1314,963,2277,-
chrX,154018718,2.3815130480625606,846,598,1444,-
chrX,154018728,0.5033630353549872,795,496,1291,-
chrX,154018729,0.5175364520887661,1028,637,1665,-
chrX,154348594,19.44738156270114,4034,3859,7893,-
chrX,154348595,18.964890527254575,5356,4233,9589,-
chrX,154348596,18.964890527254575,5356,4233,9589,-
chrX,154348597,24.995336151532328,4003,2804,6807,-
chrX,154348601,15.91503267973856,973,152,1125,-
chrX,154348602,15.91503267973856,973,152,1125,-
chrX,154348668,0.37223099613411303,762,570,1332,-
chrX,154348973,2.4232106121869905,1707,1142,2849,-
chrX,154348974,2.283411187556167,2120,1477,3597,-
chrX,154348975,2.4232106121869905,1707,1142,2849,-
chrX,154348987,4.549808429118773,759,463,1222,-
chrX,154349499,1.2557507095136518,908,578,1486,-
chrX,154349502,2.0070425293922414,856,588,1444,-
chrX,154349543,2.6960447006520183,777,610,1387,-
chrX,154349701,1.314654300693956,672,517,1189,-
chrX,154349783,2.78081021100969,851,700,1551,-
chrX,154350059,2.553969875784801,1074,718,1792,-
chrX,154350204,1.0886132033673015,818,609,1427,-
chrX,154350206,1.0886132033673015,818,609,1427,-
chrX,154350921,1.4119915112854484,938,834,1772,-
chrX,154351625,2.502042483660131,734,458,1192,-
chrX,154352005,1.2019186948545226,802,528,1330,-
chrX,154352011,0.3424553481027391,833,709,1542,-
chrX,154352362,1.9295774647887325,684,354,1038,-
chrX,154352368,1.5031784434959723,1490,972,2462,-
chrX,154352425,1.0372869719119535,2393,1462,3855,-
chrX,154352431,1.5959707338248341,3326,2551,5877,-
chrX,154352432,1.7779904109307163,3141,2504,5645,-
chrX,154352433,1.7779904109307163,3141,2504,5645,-
chrX,154352434,1.8764155588621707,3032,2228,5260,-
chrX,154352444,1.965883087164552,629,417,1046,-
chrX,154352445,1.7051179673321235,733,474,1207,-
chrX,154352574,0.6030882200683334,1184,758,1942,-
chrX,154352629,1.7670440251572328,877,635,1512,-
chrX,154352631,1.8652598617133485,1431,984,2415,-
chrX,154352794,0.4204667157096346,1069,1014,2083,-
chrX,154352795,0.46927749253330653,735,692,1427,-
chrX,154352876,1.00093808630394,581,491,1072,-
chrX,154352878,1.00093808630394,581,491,1072,-
chrX,154353156,1.2756222791850977,604,496,1100,-
chrX,154353308,1.534949711087771,1563,1264,2827,-
chrX,154353310,1.5249745158002035,1231,762,1993,-
chrX,154353321,3.768707482993197,830,629,1459,-
chrX,154353324,2.7726122707147374,796,557,1353,-
chrX,154353327,1.8492641385019009,1882,1032,2914,-
chrX,154353328,1.7947361756251963,3301,1960,5261,-
chrX,154353330,1.7270350747207586,1419,928,2347,-
chrX,154353377,0.485918453131568,679,365,1044,-
chrX,154353428,0.8475500506348834,679,388,1067,-
chrX,154353429,0.8475500506348834,679,388,1067,-
chrX,154353935,2.744232713505607,883,674,1557,-
chrX,154354030,1.91178112786153,641,397,1038,-
chrX,154354185,1.4018190810304547,671,567,1238,-
chrX,154354239,1.8141277871463368,1235,592,1827,-
chrX,154354240,1.8141277871463368,1235,592,1827,-
chrX,154354286,1.391944742781662,595,449,1044,-
chrX,154354397,2.045389072211574,1290,771,2061,-
chrX,154354398,2.1184615384615384,728,449,1177,-
chrX,154357268,3.1783382778305547,855,597,1452,-
chrX,154357271,1.2645873236453657,743,492,1235,-
chrX,154357447,1.771722325293754,1065,587,1652,-
chrX,154357448,1.771722325293754,1065,587,1652,-
chrX,154357451,2.217946501108842,898,606,1504,-
chrX,154357495,1.9866720009006043,791,528,1319,-
chrX,154357555,1.8373020646154972,930,544,1474,-
chrX,154357565,3.722403896317417,632,468,1100,-
chrX,154358253,0.4802093657086224,1328,1008,2336,-
chrX,154358254,2.2196658684000456,1468,947,2415,-
chrX,154358264,1.8952684742158423,1034,512,1546,-
chrX,154358272,1.657706791325802,981,452,1433,-
chrX,154358329,2.0084745762711864,1263,943,2206,-
chrX,154358330,2.1653705475212432,1867,1366,3233,-
chrX,154358332,2.0762842410947213,1852,1238,3090,-
chrX,154358459,1.9533068361728136,893,679,1572,-
chrX,154359147,1.6493369794262842,620,478,1098,-
chrX,154359502,1.0005334156249799,1011,699,1710,-
chrX,154359534,3.57324136433317,807,509,1316,-
chrX,154359535,3.57324136433317,807,509,1316,-
chrX,154360003,0.844670026528581,2112,1379,3491,-
chrX,154360005,1.057763165353438,1243,896,2139,-
chrX,154360018,2.6397721879449447,926,601,1527,-
chrX,154360019,1.932469578571439,1332,947,2279,-
chrX,154360111,1.3091442297094331,727,502,1229,-
chrX,154360133,1.1588508026956208,822,601,1423,-
chrX,154360248,0.943188086045229,759,517,1276,-
chrX,154360249,1.3610044899941378,978,695,1673,-
chrX,154361432,2.415645547718925,831,589,1420,-
chrX,154361434,2.323874202702357,788,642,1430,-
chrX,154362002,0.3575766626841896,652,557,1209,-
chrX,154362004,0.3575766626841896,652,557,1209,-
chrX,154362440,2.322043868446625,932,650,1582,-
chrX,154364035,2.235100932233217,996,555,1551,-
chrX,154364037,2.260869565217391,703,367,1070,-
chrX,154364864,1.4818557827703924,903,517,1420,-
chrX,154364922,2.7396751740139207,737,430,1167,-
chrX,154364923,2.7396751740139207,737,430,1167,-
chrX,154365201,2.437902272385749,743,537,1280,-
chrX,154365420,3.009179883951925,708,465,1173,-
chrX,154366043,2.7505827505827507,589,428,1017,-
chrX,154366044,2.7505827505827507,589,428,1017,-
chrX,154366435,0.5047406082289803,626,519,1145,-
chrX,154366436,0.40155380000066904,889,702,1591,-
chrX,154366822,1.9849669065867375,1295,853,2148,-
chrX,154366823,1.5908302951150484,1193,768,1961,-
chrX,154367540,2.1822742474916392,719,415,1134,-
chrX,154367542,2.2285540726598256,989,614,1603,-
chrX,154368056,2.3386375825383245,867,640,1507,-
chrX,154368061,2.08667301093827,658,505,1163,-
chrX,154402413,0.9540314981827972,566,645,1211,-
chrX,154402414,0.9540314981827972,566,645,1211,-
chrX,154402424,6.470374089881999,620,1137,1757,-
chrX,154402426,14.226225087334692,2616,2891,5507,-
chrX,154402427,30.19609992447458,2301,2315,4616,-
chrX,154402428,14.808297476077321,1097,676,1773,-
chrX,154402430,14.355253424619418,2635,1198,3833,-
chrX,154402431,14.18815893538021,2584,1143,3727,-
chrX,154402432,16.518049776977975,1397,735,2132,-
chrX,154402435,16.04896633407341,3222,787,4009,-
chrX,154402436,16.429542629252595,3474,793,4267,-
chrX,154402437,19.425126475046063,3724,774,4498,-
chrX,154402438,17.839449314675687,1696,304,2000,-
chrX,154402439,20.90436936395835,1797,235,2032,-
chrX,154402441,9.666030534351146,1012,130,1142,-
chrX,154402442,8.996525878104825,1274,130,1404,-
chrX,154477849,2.319101551843654,576,438,1014,-
chrX,154484327,1.9127512856474984,921,743,1664,-
chrX,154484329,1.9127512856474984,921,743,1664,-
chrX,154484345,0.8271874684863357,768,418,1186,-
chrX,154484346,0.7376902513968601,1234,680,1914,-
chrX,154484349,1.4869005662470463,791,524,1315,-
chrX,154506618,10.823006729466325,877,782,1659,-
chrX,154506619,10.823006729466325,877,782,1659,-
chrX,154506620,10.823006729466325,877,782,1659,-
chrX,154506898,3.1619591536903218,630,452,1082,-
chrX,154507249,1.9380481957519584,690,491,1181,-
chrX,154508505,2.043601459256641,829,465,1294,-
chrX,154508506,2.194500279714702,972,615,1587,-
chrX,154531611,0.3620908330324289,883,841,1724,-
chrX,154531623,4.604791271898723,689,793,1482,-
chrX,154531625,8.309235376552934,1324,1287,2611,-
chrX,154531632,4.094640920701057,845,445,1290,-
chrX,154531634,3.283513901579428,773,325,1098,-
chrX,154531635,3.940285781876204,1092,407,1499,-
chrX,154531637,4.43445287795476,1075,362,1437,-
chrX,154532645,1.4739267610661853,607,527,1134,-
chrX,154532984,2.003317325566519,650,441,1091,-
chrX,154533657,0.9808559406243059,755,542,1297,-
chrX,154534059,2.0021514629948363,704,414,1118,-
chrX,154534092,1.8980032935364348,682,346,1028,-
chrX,154536162,1.65,703,447,1150,-
chrX,154536163,1.7393959959280625,698,420,1118,-
chrX,154546844,0.8644597985682791,578,555,1133,-
chrX,155545148,3.8597938144329884,623,484,1107,-
chrX,155545149,3.3455523793509334,828,625,1453,-
chrX,155545150,3.3455523793509334,828,625,1453,-
chrX,155545151,2.577587759316174,808,562,1370,-
chrY,5337896,1.889678864824496,1036,514,1550,-
chrY,5337898,1.889678864824496,1036,514,1550,-
chrY,5337985,2.2200252636068667,681,408,1089,-
chrY,5338684,1.824524509941307,1902,1207,3109,-
chrY,5338686,1.4396304948632705,1687,1337,3024,-
chrY,5338689,1.84550104626831,634,373,1007,-
chrY,5338694,1.3938070245604162,1398,788,2186,-
chrY,5338696,0.8790887019684129,1154,726,1880,-
chrY,5338710,2.040470359826607,780,580,1360,-
