chromosome,position,rsr,t_read,c_read,total_reads,strand
chr2,264959,1.4856091954022987,576,434,1010,+
chr2,264961,1.4856091954022987,576,434,1010,+
chr2,271867,1.7270358853685182,1369,814,2183,+
chr2,271868,1.8150996591197257,1816,1196,3012,+
chr2,271869,1.7171717171717171,679,461,1140,+
chr2,271890,0.6248984468339307,933,674,1607,+
chr2,271903,2.1951809764309766,672,593,1265,+
chr2,272121,1.0840304889384644,1371,977,2348,+
chr2,272123,1.329014540794146,1953,1313,3266,+
chr2,277307,2.333333333333333,763,381,1144,+
chr2,277337,1.9104034405078845,690,513,1203,+
chr2,277360,2.0334151270207848,574,432,1006,+
chr2,277366,1.953246753246753,751,615,1366,+
chr2,277396,0.48971618465960115,726,585,1311,+
chr2,277762,1.9525358559293207,1300,1009,2309,+
chr2,277777,2.131904761904762,813,599,1412,+
chr2,277786,1.4567335745127787,1018,778,1796,+
chr2,277792,0.6727825486732849,1866,1262,3128,+
chr2,277796,1.633603158814656,2613,2036,4649,+
chr2,277804,1.5558284899660049,1125,828,1953,+
chr2,277807,2.078867341343038,1667,1542,3209,+
chr2,277812,2.043663925506912,5240,4085,9325,+
chr2,277919,1.9640601071975496,1000,652,1652,+
chr2,278103,0.5916666666666667,851,479,1330,+
chr2,3575293,0.8128059134951554,823,375,1198,+
chr2,3575294,1.0685802800810753,1151,666,1817,+
chr2,3575313,1.9925515487328553,913,504,1417,+
chr2,3575314,0.5593093855620221,1936,1350,3286,+
chr2,3575316,1.5781478235465969,1167,651,1818,+
chr2,3575321,1.2732396470047531,3031,2014,5045,+
chr2,3575325,0.7175072104334904,2397,1696,4093,+
chr2,3575329,0.7618866970156803,1927,1317,3244,+
chr2,3575331,0.91609625036739,4178,3164,7342,+
chr2,3575332,1.0136650537108531,2911,2301,5212,+
chr2,3575601,0.7941922680800824,1975,1550,3525,+
chr2,3575610,1.5743368342396946,2340,1416,3756,+
chr2,3575615,1.5582262505952424,6309,3541,9850,+
chr2,3575835,1.466256933783689,8576,5108,13684,+
chr2,3575837,1.4816437649858145,8392,4397,12789,+
chr2,3575846,1.43558734226681,6262,4160,10422,+
chr2,3575849,1.4824402757736093,3528,1924,5452,+
chr2,3575867,1.5175529862301744,3811,3173,6984,+
chr2,3575868,0.8925917074409404,9542,5545,15087,+
chr2,3575870,0.8947735613135188,20317,12613,32930,+
chr2,3575871,1.3491812034363204,6899,4514,11413,+
chr2,3575872,1.0911679082496444,17746,10824,28570,+
chr2,3576485,1.1335667122461708,6429,4005,10434,+
chr2,3576487,1.0037047278184936,10342,6645,16987,+
chr2,3577723,0.6253649511140364,1091,874,1965,+
chr2,3577724,0.492860057119543,603,512,1115,+
chr2,3577729,1.5150910068351129,821,448,1269,+
chr2,3577734,1.4538536364886905,2258,1347,3605,+
chr2,3577736,1.1352959755953935,7292,3838,11130,+
chr2,3577737,1.0562252089808897,6234,3223,9457,+
chr2,3577738,1.2233995329357497,2391,1025,3416,+
chr2,3577742,2.2874423244793616,1410,890,2300,+
chr2,3577745,1.7044361731550381,3216,2158,5374,+
chr2,3577746,1.1359497435383357,3137,1685,4822,+
chr2,3577747,1.2952313842425283,10458,6495,16953,+
chr2,3577748,1.1424607751668228,8722,5483,14205,+
chr2,3577750,1.0210825659893805,7640,4823,12463,+
chr2,3577751,1.3179572598079174,4225,2918,7143,+
chr2,3577754,0.6821074964639321,1928,807,2735,+
chr2,3577755,1.3092888344465758,2462,1765,4227,+
chr2,3577758,1.4879450879450882,2690,1997,4687,+
chr2,3580107,0.7926483728262185,879,691,1570,+
chr2,3580108,1.0846602247130863,4166,3221,7387,+
chr2,3580110,1.407068316847173,16760,10597,27357,+
chr2,3580112,1.4128216246347793,17055,11435,28490,+
chr2,3580164,1.3516975786031444,31304,20277,51581,+
chr2,3580165,1.2966779568717222,39342,27129,66471,+
chr2,9432510,1.9367212130123528,1243,902,2145,+
chr2,9443582,0.46304518150953256,984,546,1530,+
chr2,9443583,0.46304518150953256,984,546,1530,+
chr2,9443644,1.7951699463327373,2006,1481,3487,+
chr2,9443645,1.7951699463327373,2006,1481,3487,+
chr2,9481392,3.0691905880576607,704,549,1253,+
chr2,10052577,1.8873649864874005,761,455,1216,+
chr2,10052589,3.579444359360658,1023,662,1685,+
chr2,10122883,2.414634146341464,593,409,1002,+
chr2,10122885,2.414634146341464,593,409,1002,+
chr2,10123760,2.3689081163180914,1267,986,2253,+
chr2,10123765,1.679802955665025,681,463,1144,+
chr2,10123794,1.7282637041673186,871,580,1451,+
chr2,10124728,0.4641304347826087,670,459,1129,+
chr2,10124830,2.305661304187646,750,478,1228,+
chr2,10124831,1.901993534482758,860,639,1499,+
chr2,10127148,0.6244129691550513,830,618,1448,+
chr2,10127160,1.7490011415525115,1750,1439,3189,+
chr2,10127161,1.3792785362949451,2701,2088,4789,+
chr2,10129244,1.5341851696690407,938,681,1619,+
chr2,10129361,1.7046925566343039,1077,823,1900,+
chr2,10129433,1.5176524530032094,992,726,1718,+
chr2,10129436,0.4088147095959596,796,575,1371,+
chr2,10129439,0.9335354102179244,2774,2077,4851,+
chr2,10129701,0.5307829375613659,1779,1284,3063,+
chr2,10129702,1.1635922052554895,2691,1856,4547,+
chr2,10131013,2.806892033742953,624,459,1083,+
chr2,10419904,2.2485799945445755,1054,772,1826,+
chr2,10419905,2.2145054945054943,686,524,1210,+
chr2,10420100,1.265784316897677,653,411,1064,+
chr2,10422991,1.2125285305460418,677,445,1122,+
chr2,10423010,3.9841616037099006,605,503,1108,+
chr2,10427227,8.839883115915072,1685,1166,2851,+
chr2,10427228,8.839883115915072,1685,1166,2851,+
chr2,10427236,4.204993405607923,995,941,1936,+
chr2,10427237,3.166418691972011,755,701,1456,+
chr2,10427269,0.4519478844169245,636,683,1319,+
chr2,10427270,0.4519478844169245,636,683,1319,+
chr2,10427319,0.4331344331344332,616,461,1077,+
chr2,11824922,2.204600219058051,628,414,1042,+
chr2,15591926,4.223217489082139,1122,1199,2321,+
chr2,15591927,4.301292281385368,2235,2375,4610,+
chr2,15591928,2.4218455459112445,2984,3152,6136,+
chr2,15591929,3.7398979591836734,642,783,1425,+
chr2,15591930,1.2026890015437985,1378,1476,2854,+
chr2,15595151,1.9186142481394983,720,639,1359,+
chr2,15595166,0.5795454545454546,560,483,1043,+
chr2,15595499,0.5969694365063446,1396,995,2391,+
chr2,15595511,0.40540540540540543,689,551,1240,+
chr2,15595517,1.5203953497792362,765,632,1397,+
chr2,15595530,1.9102005730659024,812,697,1509,+
chr2,15603200,3.1813690896259708,643,435,1078,+
chr2,15603206,2.0107003891050583,688,513,1201,+
chr2,15603815,0.47396889790398916,700,492,1192,+
chr2,15603847,0.5236928104575164,640,509,1149,+
chr2,15603874,1.723932642748015,1670,1169,2839,+
chr2,15604437,1.547057300215962,1618,1132,2750,+
chr2,15605971,2.1692918427455496,604,410,1014,+
chr2,15605973,1.9216928904428905,712,623,1335,+
chr2,15605985,1.7530936454849497,722,519,1241,+
chr2,15605987,1.913848848174592,860,570,1430,+
chr2,15605988,0.5299220305802139,784,688,1472,+
chr2,15606188,1.6355298913043481,641,511,1152,+
chr2,15606248,1.400974212034384,842,697,1539,+
chr2,15607220,1.8889464892575312,862,642,1504,+
chr2,15613269,1.6198779424585878,928,554,1482,+
chr2,15617245,1.5787037037037035,681,404,1085,+
chr2,15617301,1.823684210526316,818,569,1387,+
chr2,15617312,0.9765151670739972,2469,1678,4147,+
chr2,15617313,0.9765151670739972,2469,1678,4147,+
chr2,15618215,1.5948484970605266,2359,1579,3938,+
chr2,15620247,0.6172021943573668,828,579,1407,+
chr2,15620250,2.1983047506406472,696,533,1229,+
chr2,15620353,2.0103492884864167,1035,772,1807,+
chr2,15623456,1.990784681602472,838,696,1534,+
chr2,15627057,1.880529300567108,828,528,1356,+
chr2,15627060,1.9796534523496983,913,585,1498,+
chr2,15627103,1.8628318584070795,841,677,1518,+
chr2,15629615,1.7920708374121206,894,660,1554,+
chr2,15629639,2.3025336293587566,952,588,1540,+
chr2,15629643,1.7263044647660033,1129,844,1973,+
chr2,15629659,1.7114339399327498,3373,2460,5833,+
chr2,15629660,1.7114339399327498,3373,2460,5833,+
chr2,15630003,1.62843295638126,719,618,1337,+
chr2,15630005,1.7632835820895527,1968,1049,3017,+
chr2,15630006,1.9441867627714826,2743,1603,4346,+
chr2,15630783,0.5942100909842846,897,650,1547,+
chr2,15630800,0.46923443834963047,786,598,1384,+
chr2,15630837,2.2539715719063547,788,623,1411,+
chr2,15630869,1.6397066236515778,970,762,1732,+
chr2,15630936,2.2161527165932453,1077,680,1757,+
chr2,20447076,1.0772358381802405,1724,1433,3157,+
chr2,20447077,1.0608784295159277,4173,3379,7552,+
chr2,20447529,1.7005961084242491,863,522,1385,+
chr2,20447540,1.9564079274458075,793,726,1519,+
chr2,20447742,1.4318971738680835,1618,1214,2832,+
chr2,20447745,1.5026369454596458,1914,1409,3323,+
chr2,20447813,1.546742209631728,1039,705,1744,+
chr2,20447916,2.113786922303138,877,653,1530,+
chr2,20448032,3.5315789473684207,670,360,1030,+
chr2,20448149,1.0725453408380237,734,491,1225,+
chr2,20448150,0.8370534298370983,992,705,1697,+
chr2,20448371,0.7727709190672154,592,485,1077,+
chr2,20448373,0.7727709190672154,592,485,1077,+
chr2,20448394,1.8646780303030304,678,329,1007,+
chr2,20448400,0.6182962503324173,836,388,1224,+
chr2,20448450,2.4860113624182656,891,490,1381,+
chr2,20448515,8.088150219965323,1350,297,1647,+
chr2,20448516,13.000000000000002,1182,285,1467,+
chr2,20448518,9.260301632427144,4252,734,4986,+
chr2,20448519,13.903769184661492,4870,786,5656,+
chr2,20448520,4.994181954863426,4634,701,5335,+
chr2,20448521,5.898029452127239,3745,571,4316,+
chr2,20448524,10.690625875189859,4528,806,5334,+
chr2,20448525,10.277529942376221,7997,1526,9523,+
chr2,20448526,9.733633136468015,11277,2407,13684,+
chr2,20448527,9.325422142581893,10268,2344,12612,+
chr2,20448528,9.24712892116697,8102,1958,10060,+
chr2,20448529,8.611796982167354,2043,728,2771,+
chr2,20448531,5.673305953224817,1385,539,1924,+
chr2,20448536,35.721001690832026,7228,3811,11039,+
chr2,20448537,30.921841620570035,8820,4860,13680,+
chr2,20448538,30.921841620570035,8820,4860,13680,+
chr2,20448539,24.55621433314284,4770,2709,7479,+
chr2,20448542,0.6070811744386874,702,578,1280,+
chr2,20448564,0.6035406698564594,741,759,1500,+
chr2,20448566,1.7873768263676522,793,653,1446,+
chr2,20448588,0.28535353535353536,564,479,1043,+
chr2,20448786,1.8034850684941153,1127,775,1902,+
chr2,20448800,2.235278552872125,1238,1093,2331,+
chr2,20448801,2.5219417933784913,5981,4334,10315,+
chr2,20448802,2.6056356828599965,4743,3241,7984,+
chr2,20448806,1.5068681318681318,1096,818,1914,+
chr2,20448814,2.0182476102016333,1468,956,2424,+
chr2,20448904,1.4012515311285083,2458,1706,4164,+
chr2,20449025,0.6856883001795666,2672,1877,4549,+
chr2,26034452,2.3550832825622736,703,522,1225,+
chr2,26034648,2.941871206356394,791,681,1472,+
chr2,26034709,0.5197724039829303,869,702,1571,+
chr2,26034712,0.5497675909600898,979,733,1712,+
chr2,26034713,1.668221393034826,579,535,1114,+
chr2,26034721,0.44426494345718903,659,618,1277,+
chr2,26109838,0.5762672543788423,620,465,1085,+
chr2,26127163,1.8506060606060608,1575,1055,2630,+
chr2,26127164,1.3377366748540807,2660,1789,4449,+
chr2,26134944,2.02906162464986,1219,713,1932,+
chr2,26135078,2.070393374741201,749,551,1300,+
chr2,26135171,2.0795604395604395,746,649,1395,+
chr2,26135225,1.2012943611295541,1388,995,2383,+
chr2,26135459,3.3009136721502315,776,524,1300,+
chr2,26137003,0.6997493734335839,1046,692,1738,+
chr2,26278622,1.4834140337774468,600,439,1039,+
chr2,26278728,0.5194081281037802,614,428,1042,+
chr2,26278744,1.7496918767507001,731,524,1255,+
chr2,26279231,0.4140826935052037,811,577,1388,+
chr2,26279998,1.3780916602199185,666,501,1167,+
chr2,26280012,1.4567190265715035,819,605,1424,+
chr2,26282878,0.8211778400203703,902,742,1644,+
chr2,26282879,1.1838340528774156,1213,1004,2217,+
chr2,26284929,0.494361601057458,747,562,1309,+
chr2,26285543,1.9322344322344323,632,545,1177,+
chr2,26289950,0.5264516129032258,577,424,1001,+
chr2,26290193,2.1238476802189177,1244,923,2167,+
chr2,26290194,3.320024645717807,708,540,1248,+
chr2,26290310,1.838472834067548,625,453,1078,+
chr2,26792139,1.8764998536728128,915,713,1628,+
chr2,26792140,1.8378706594038274,1422,1100,2522,+
chr2,26792143,2.0124055049428184,536,468,1004,+
chr2,26793973,1.389753827214642,584,429,1013,+
chr2,27034107,2.3123974285266296,581,426,1007,+
chr2,27036765,4.806926529544538,600,515,1115,+
chr2,27039772,1.5070680690895941,639,385,1024,+
chr2,27040928,0.684104407553089,595,480,1075,+
chr2,27212364,0.8186177312960875,1468,866,2334,+
chr2,27212365,0.8251113157053447,2344,1669,4013,+
chr2,27212366,0.8251113157053447,2344,1669,4013,+
chr2,27212443,0.6282908550570145,777,606,1383,+
chr2,27213184,3.315315315315316,551,480,1031,+
chr2,27213186,0.6222627737226277,681,547,1228,+
chr2,27215510,1.5480856195357253,789,641,1430,+
chr2,27215633,1.5418574231523872,689,555,1244,+
chr2,27215645,1.5397563676633446,789,644,1433,+
chr2,27215650,1.6404682274247493,1307,883,2190,+
chr2,27215663,1.6041666666666663,923,767,1690,+
chr2,27215666,1.9137463697967088,1491,1032,2523,+
chr2,27216545,0.7578481163827749,3621,2574,6195,+
chr2,27216605,1.8228482962150656,1852,1050,2902,+
chr2,27216993,1.7303693142300738,1198,1026,2224,+
chr2,27217072,0.6215005599104142,739,751,1490,+
chr2,27217073,0.6263666947014297,2978,2377,5355,+
chr2,27217075,0.6263666947014297,2978,2377,5355,+
chr2,27217077,1.7547546941247731,782,634,1416,+
chr2,27217080,1.7662337662337657,1183,776,1959,+
chr2,27225139,3.1376106194690263,1012,677,1689,+
chr2,27225140,2.338847491306508,1586,1097,2683,+
chr2,27225141,1.7537866224433392,1093,602,1695,+
chr2,27225142,2.1282279719791015,2775,1834,4609,+
chr2,27225144,2.055741660186237,1792,1373,3165,+
chr2,27225145,1.9902293967714528,1873,1497,3370,+
chr2,27225147,1.8280566280566282,1271,1035,2306,+
chr2,27225149,1.7213114754098358,734,426,1160,+
chr2,27226886,2.0445532435740508,695,644,1339,+
chr2,27226887,1.7490784566874145,1040,858,1898,+
chr2,27374721,3.0888625592417065,631,421,1052,+
chr2,27374723,2.0660829489559864,1033,693,1726,+
chr2,27376369,2.965686933284793,636,445,1081,+
chr2,27376763,1.1511601697180274,1127,855,1982,+
chr2,27376764,0.3382820784729586,637,551,1188,+
chr2,27376950,2.9699588110866193,595,466,1061,+
chr2,27433380,1.8064754783711758,808,574,1382,+
chr2,27433388,2.848652354591316,1439,1059,2498,+
chr2,27433389,3.1831063673168933,1058,740,1798,+
chr2,27433694,0.6599326599326599,587,458,1045,+
chr2,27437343,2.8339552238805967,734,535,1269,+
chr2,27437344,2.8339552238805967,734,535,1269,+
chr2,27440898,2.9615174348204607,616,394,1010,+
chr2,27441291,0.7976581661929782,651,391,1042,+
chr2,27600011,4.162924067500533,989,569,1558,+
chr2,27650719,2.686544477668839,715,459,1174,+
chr2,27694786,3.8697717155806353,613,405,1018,+
chr2,27771735,1.385111755995602,1275,747,2022,+
chr2,27771736,1.347360397423363,830,448,1278,+
chr2,27772681,1.5024585624062001,971,800,1771,+
chr2,27774435,2.168933016964301,929,749,1678,+
chr2,27774437,1.115125464684015,661,537,1198,+
chr2,27774478,1.1495466032406718,702,650,1352,+
chr2,27774479,1.5375830291343389,1872,1483,3355,+
chr2,27779491,2.7295832329559144,730,592,1322,+
chr2,27779575,2.726742712294042,693,525,1218,+
chr2,27988057,3.9828753404845023,630,484,1114,+
chr2,28237227,3.791235368686643,647,511,1158,+
chr2,28902024,2.2553236348302765,562,526,1088,+
chr2,28902026,2.2553236348302765,562,526,1088,+
chr2,28912668,3.8197345809598864,608,531,1139,+
chr2,28925012,2.034438775510204,724,489,1213,+
chr2,28925014,2.034438775510204,724,489,1213,+
chr2,28929628,1.0119429590017823,810,494,1304,+
chr2,28929630,1.0119429590017823,810,494,1304,+
chr2,28946475,2.671802396674004,873,563,1436,+
chr2,28946476,2.46453113065211,1155,810,1965,+
chr2,28947131,3.018147684605757,688,469,1157,+
chr2,28947133,3.3072895216802967,1040,738,1778,+
chr2,28947135,2.8832684824902723,701,513,1214,+
chr2,28948026,0.3052597065876555,3421,2323,5744,+
chr2,28948027,0.3052597065876555,3421,2323,5744,+
chr2,28948032,2.622410752892598,934,584,1518,+
chr2,30147047,6.708342739476349,676,376,1052,+
chr2,30156681,3.14977973568282,934,453,1387,+
chr2,30156682,3.14977973568282,934,453,1387,+
chr2,30156734,1.788971873510249,1298,650,1948,+
chr2,30156736,1.788971873510249,1298,650,1948,+
chr2,30156771,1.1657102492162112,1511,980,2491,+
chr2,32290597,2.179302608207909,751,562,1313,+
chr2,32290622,1.822989949748744,690,397,1087,+
chr2,32298283,1.1056288785945283,936,672,1608,+
chr2,32298285,1.1056288785945283,936,672,1608,+
chr2,32301394,2.138449240607514,607,416,1023,+
chr2,32305553,1.1100105189340812,1205,735,1940,+
chr2,32305554,1.1100105189340812,1205,735,1940,+
chr2,32305728,2.2693865740740744,758,575,1333,+
chr2,32305998,1.73992673992674,645,441,1086,+
chr2,32916246,0.8066808476209608,844,546,1390,+
chr2,32916255,0.7804258208448518,820,710,1530,+
chr2,32916259,0.7909898423222406,5815,4300,10115,+
chr2,32916260,0.7909898423222406,5815,4300,10115,+
chr2,32916400,0.8710384057036334,7490,5256,12746,+
chr2,36396658,0.4387975924798811,682,557,1239,+
chr2,36396659,0.4387975924798811,682,557,1239,+
chr2,36477028,2.2397740190843636,603,412,1015,+
chr2,36499313,1.0427046263345194,878,561,1439,+
chr2,36499314,1.0427046263345194,878,561,1439,+
chr2,36522228,3.9136883720908067,715,577,1292,+
chr2,36548598,2.0983322503790345,691,485,1176,+
chr2,36548628,0.4070937251415469,724,496,1220,+
chr2,36548629,1.7056894083969467,772,523,1295,+
chr2,36548651,1.2708773533463515,4498,3456,7954,+
chr2,36548653,1.0496649916247909,2821,2387,5208,+
chr2,36548654,1.5394506136762127,1316,1002,2318,+
chr2,36548658,0.6644145162019253,1088,762,1850,+
chr2,36548660,1.8548027989821878,1634,1309,2943,+
chr2,36548670,1.2222222222222223,2111,1727,3838,+
chr2,36548679,1.5800574783912142,5224,4550,9774,+
chr2,36548680,1.5800574783912142,5224,4550,9774,+
chr2,36549013,55.9587482419128,2226,144,2370,+
chr2,36549014,62.23480371464753,2215,154,2369,+
chr2,36549015,50.78396757086205,2821,210,3031,+
chr2,36549016,46.58567415730337,1617,177,1794,+
chr2,36549017,67.16663689278634,2473,322,2795,+
chr2,36549018,58.39006702074611,2283,503,2786,+
chr2,36549019,21.76986067079898,1722,489,2211,+
chr2,36549021,12.964796945936708,1368,556,1924,+
chr2,36549027,10.952174305460392,2287,2182,4469,+
chr2,36549028,9.106241900851789,2113,2419,4532,+
chr2,36549029,3.7280906593406593,526,1119,1645,+
chr2,36549030,3.4262827644519596,400,976,1376,+
chr2,36549031,0.2888443721046701,768,814,1582,+
chr2,36549033,0.3681587712281913,1132,1130,2262,+
chr2,36549078,0.5357545680126325,474,571,1045,+
chr2,36549273,0.5213581599123768,594,414,1008,+
chr2,36549539,3.616737120846714,1592,1175,2767,+
chr2,36549931,0.5868897851080479,649,448,1097,+
chr2,36550351,2.224510551741673,672,436,1108,+
chr2,36550774,1.6123839009287926,839,645,1484,+
chr2,36550776,3.2522060332444083,565,442,1007,+
chr2,37097487,4.060975609756096,554,450,1004,+
chr2,37097488,4.060975609756096,554,450,1004,+
chr2,37097489,4.060975609756096,554,450,1004,+
chr2,37201057,2.9507299270073,692,547,1239,+
chr2,37201058,2.9507299270073,692,547,1239,+
chr2,37248224,2.187001979394001,1248,1158,2406,+
chr2,37248225,2.187001979394001,1248,1158,2406,+
chr2,37248230,1.5403924265543405,1447,1500,2947,+
chr2,37248232,1.5403924265543405,1447,1500,2947,+
chr2,37248234,2.383340356791684,892,677,1569,+
chr2,38481776,0.7122441520467836,1498,1063,2561,+
chr2,38481777,0.5705899215530187,6242,3905,10147,+
chr2,38481779,0.5697206079350267,3925,2556,6481,+
chr2,38481781,0.5116279069767442,813,554,1367,+
chr2,38481790,1.4932707906829665,5077,3073,8150,+
chr2,38481791,1.4041088296021746,5631,3703,9334,+
chr2,38481793,1.4877574509460731,10298,5758,16056,+
chr2,38481794,1.5150678628939498,5771,2690,8461,+
chr2,38481795,1.4760319243286821,19089,11651,30740,+
chr2,38481796,1.5310208043717943,3890,2720,6610,+
chr2,38481797,1.2052705827295849,10900,6268,17168,+
chr2,38481798,0.7886736076205065,7402,4215,11617,+
chr2,38481834,1.7137259840756756,3601,1742,5343,+
chr2,38481850,1.8478399643705463,4080,2104,6184,+
chr2,38481860,1.3423148856447777,12615,7855,20470,+
chr2,38481861,1.4039247294204305,7913,5420,13333,+
chr2,38481877,3.1661663071973902,8448,6755,15203,+
chr2,38482005,1.4091768953940496,1273,943,2216,+
chr2,38482007,2.2052937966163357,745,477,1222,+
chr2,38482010,1.8616631402041108,1305,888,2193,+
chr2,38482011,0.5896226432483875,1051,728,1779,+
chr2,38482012,1.889841827768014,926,568,1494,+
chr2,38482014,1.0828125614117832,949,770,1719,+
chr2,38482015,1.0828125614117832,949,770,1719,+
chr2,38482017,0.600421052631579,712,474,1186,+
chr2,38482018,1.3269282330860666,1413,1001,2414,+
chr2,38482019,1.281828550466019,3314,2471,5785,+
chr2,38482021,1.340494021768052,2844,2044,4888,+
chr2,38482025,1.44186127692254,1501,1060,2561,+
chr2,38482028,1.2830503279592964,1835,1482,3317,+
chr2,38482036,1.3678297623186284,1698,1332,3030,+
chr2,38482070,1.4627311522048363,2274,1849,4123,+
chr2,38482074,0.8273563674315723,10189,7847,18036,+
chr2,38482075,1.264032065572294,6663,5762,12425,+
chr2,38482076,1.0536790935766214,12591,10599,23190,+
chr2,38482115,1.312791984539107,10548,8214,18762,+
chr2,38482120,1.2524774774774776,4555,3263,7818,+
chr2,38482123,0.7714206558796991,7699,5817,13516,+
chr2,38482127,1.254623896615228,3309,2783,6092,+
chr2,38482130,1.2843330753353972,3452,2906,6358,+
chr2,38482135,0.8173202614379085,6108,4022,10130,+
chr2,38482138,0.8251043292009227,11286,8154,19440,+
chr2,38482139,1.1329673837688832,4186,3525,7711,+
chr2,38482162,0.8332408411726079,6582,5412,11994,+
chr2,38482247,1.7102563144324898,16612,9746,26358,+
chr2,38482249,1.92234161777309,12149,6106,18255,+
chr2,38482258,1.4196273797986847,24150,17220,41370,+
chr2,38482267,1.37654996026126,8659,5070,13729,+
chr2,38482272,1.4127402734463008,7133,4989,12122,+
chr2,38482274,1.0976290940212539,19425,13818,33243,+
chr2,38482431,3.236879432624113,1629,704,2333,+
chr2,38482433,3.236879432624113,1629,704,2333,+
chr2,38482438,1.85135841170324,745,347,1092,+
chr2,38482471,0.7092807092807093,1239,944,2183,+
chr2,38482472,1.374826410806716,1682,1512,3194,+
chr2,38482473,1.351372891501009,2551,2194,4745,+
chr2,38482475,0.8642278930868867,8015,5662,13677,+
chr2,38482476,1.0795420461955574,4944,3746,8690,+
chr2,38482477,0.7636474507570833,4153,2953,7106,+
chr2,38482480,0.9581637804036303,5812,3961,9773,+
chr2,38482482,1.1922780269943296,12195,9547,21742,+
chr2,38482483,1.3576485786865364,16288,13488,29776,+
chr2,38482485,1.4673365451738145,3399,3680,7079,+
chr2,38482490,1.1009412239290377,6269,5234,11503,+
chr2,38482493,1.2024934343489968,7404,6299,13703,+
chr2,38781694,2.8526403204483213,643,443,1086,+
chr2,44996673,1.917639006998511,1113,823,1936,+
chr2,44996675,1.7832167832167831,614,428,1042,+
chr2,46297885,1.0236344368140742,646,426,1072,+
chr2,46346962,4.0096787758819366,756,504,1260,+
chr2,46375780,1.09742883379247,702,395,1097,+
chr2,46375782,1.3046215067867257,967,613,1580,+
chr2,46376624,1.8773662769173054,896,584,1480,+
chr2,46376741,2.923515150680397,655,405,1060,+
chr2,46378701,2.416068403646044,767,538,1305,+
chr2,46378702,2.416068403646044,767,538,1305,+
chr2,46382022,1.644260465191092,667,582,1249,+
chr2,46382023,2.0202702636424466,560,554,1114,+
chr2,46384836,0.596624266144814,812,583,1395,+
chr2,46385232,1.0184971098265896,880,518,1398,+
chr2,46385233,1.0184971098265896,880,518,1398,+
chr2,46385488,0.5452302631578948,713,447,1160,+
chr2,46385601,4.309738002160618,643,519,1162,+
chr2,46385756,43.55884933871156,971,150,1121,+
chr2,46385758,17.60363636363636,751,274,1025,+
chr2,46385759,52.57647868724394,2288,1364,3652,+
chr2,46385760,52.57647868724394,2288,1364,3652,+
chr2,46385761,55.296921687366776,2104,1330,3434,+
chr2,46385782,0.9370796135502018,612,628,1240,+
chr2,46385783,0.9242258570840636,1005,970,1975,+
chr2,46386007,2.3841895165657614,591,461,1052,+
chr2,46386086,1.773206235669082,897,729,1626,+
chr2,46386291,2.122448979591837,662,440,1102,+
chr2,46581511,3.992815496204928,661,346,1007,+
chr2,46582365,3.4863704528919075,786,584,1370,+
chr2,46582631,2.3816610982814903,2113,1212,3325,+
chr2,46582632,2.591496232508073,1604,928,2532,+
chr2,46582651,2.277355317787466,1961,1638,3599,+
chr2,46582652,2.1160830377693456,2675,2035,4710,+
chr2,46582653,0.5988663435471946,809,517,1326,+
chr2,46582654,1.1758068816057654,1798,960,2758,+
chr2,46582655,1.7111501277236147,6604,5436,12040,+
chr2,46582656,1.6113747072077997,8402,6396,14798,+
chr2,46582657,1.7111501277236147,6604,5436,12040,+
chr2,47408415,2.848086941942015,593,464,1057,+
chr2,47783144,0.9952606635071091,739,421,1160,+
chr2,47783145,1.9312448858840032,1153,618,1771,+
chr2,47795897,2.3216462157718554,672,438,1110,+
chr2,47795927,1.7533693806323378,1021,747,1768,+
chr2,47795928,0.7990776431718061,610,453,1063,+
chr2,47795994,0.4991091724519261,676,396,1072,+
chr2,47796008,2.312959558823529,718,511,1229,+
chr2,47799415,0.3238636932787772,608,457,1065,+
chr2,47799723,0.4898081534772183,816,555,1371,+
chr2,47799724,0.4898081534772183,816,555,1371,+
chr2,47800048,1.2909142313940505,775,509,1284,+
chr2,47806805,3.97884586420672,807,573,1380,+
chr2,53794413,2.228285765176816,796,530,1326,+
chr2,53795947,1.4774486457996887,1394,891,2285,+
chr2,53801478,0.5222156202548359,564,458,1022,+
chr2,53801567,0.4935064935064936,721,538,1259,+
chr2,53813046,1.9465408805031448,618,423,1041,+
chr2,53817978,2.1386473498734886,954,612,1566,+
chr2,53818269,1.6462715105162524,737,522,1259,+
chr2,53818685,1.0518234165067175,821,520,1341,+
chr2,53818686,1.0518234165067175,821,520,1341,+
chr2,54304939,4.017025185462715,692,446,1138,+
chr2,54631291,1.067807623595715,828,494,1322,+
chr2,54631316,0.4630944888968803,908,680,1588,+
chr2,54631318,0.4630944888968803,908,680,1588,+
chr2,54631338,1.9218644067796609,781,471,1252,+
chr2,54644493,0.8449766666275205,1181,715,1896,+
chr2,54644495,1.4830025881493505,2006,1303,3309,+
chr2,54644496,1.8884350565993702,1043,778,1821,+
chr2,54668778,5.951336628837296,1077,859,1936,+
chr2,54669318,2.878571428571429,779,419,1198,+
chr2,55232681,1.162549230218403,954,489,1443,+
chr2,55232682,1.162549230218403,954,489,1443,+
chr2,55232683,1.2474690792315883,1115,600,1715,+
chr2,55232685,1.4389513749838094,1752,1347,3099,+
chr2,55232686,1.0164595160881937,2902,1905,4807,+
chr2,55232687,1.1899947033585694,3366,2232,5598,+
chr2,55232691,1.4239524909270869,1493,865,2358,+
chr2,55232698,1.168837812386404,2325,1819,4144,+
chr2,55232764,1.3642629879759682,684,603,1287,+
chr2,55233364,3.3881151346332405,1270,1076,2346,+
chr2,55233366,0.5244377162629758,2424,1733,4157,+
chr2,55234117,0.9523505673783326,1126,733,1859,+
chr2,55234119,0.721875,1616,975,2591,+
chr2,55234120,0.7943273135883157,2493,1562,4055,+
chr2,55234122,1.0940192505807664,2708,1509,4217,+
chr2,55234124,1.1115933232169957,1262,658,1920,+
chr2,55234126,1.4568691610945133,990,593,1583,+
chr2,55234133,1.4626168887375306,2324,1520,3844,+
chr2,55234134,1.2338235370618562,3126,2128,5254,+
chr2,55234136,0.7633500785656226,6326,3215,9541,+
chr2,55234137,0.8706181212589151,8053,4769,12822,+
chr2,55234138,0.8512294638855058,13846,7928,21774,+
chr2,55234139,0.9712798643611292,5164,2707,7871,+
chr2,55234140,1.0138203334334002,5860,3073,8933,+
chr2,55234141,1.5505118794668724,2093,1001,3094,+
chr2,55234142,1.3923356214017542,7613,4901,12514,+
chr2,55234148,0.7350527182220827,2286,1645,3931,+
chr2,55234157,1.3699657949906214,2812,1652,4464,+
chr2,55235443,1.159194438313838,16673,9849,26522,+
chr2,55235476,1.3679840872449174,71873,47809,119682,+
chr2,55235477,1.3663361668560423,89584,62972,152556,+
chr2,55528938,1.1694028319310483,785,442,1227,+
chr2,55528939,1.1694028319310483,785,442,1227,+
chr2,55533901,1.6878567035189596,1174,850,2024,+
chr2,55533915,1.6485936970518469,833,680,1513,+
chr2,55533932,2.133215763413145,849,640,1489,+
chr2,55533938,1.2226319337329155,1665,1292,2957,+
chr2,55533941,2.0299895926485667,2410,2155,4565,+
chr2,58251795,1.2818344308560676,1530,1062,2592,+
chr2,58251796,1.2818344308560676,1530,1062,2592,+
chr2,58251797,1.2818344308560676,1530,1062,2592,+
chr2,58251848,0.5859876543209876,862,674,1536,+
chr2,58251869,0.4642817892076052,993,673,1666,+
chr2,58251878,1.7027443614762128,2286,1805,4091,+
chr2,58252438,0.6200637284737388,752,526,1278,+
chr2,61178767,1.9777268143054738,845,556,1401,+
chr2,61178792,2.2554147635184907,784,616,1400,+
chr2,62955617,1.4581264775413711,766,458,1224,+
chr2,63588967,0.6978398056726561,1470,641,2111,+
chr2,63588970,1.9815409494562475,1252,583,1835,+
chr2,63588975,2.471266067276586,882,444,1326,+
chr2,63588976,2.1799400074990625,1236,634,1870,+
chr2,63588977,2.1799400074990625,1236,634,1870,+
chr2,63588978,1.9870472450006782,1908,928,2836,+
chr2,63588980,3.274903407393775,931,566,1497,+
chr2,63588981,1.9451002227171494,1202,594,1796,+
chr2,63588989,1.7429951690821257,879,449,1328,+
chr2,63588997,1.5823754789272029,825,521,1346,+
chr2,63589003,1.5794899739405952,2495,1506,4001,+
chr2,63589004,1.5794899739405952,2495,1506,4001,+
chr2,63589018,1.483846341265329,2468,1758,4226,+
chr2,63589019,1.483846341265329,2468,1758,4226,+
chr2,63594489,1.6992180396435717,875,610,1485,+
chr2,63594527,1.4438470203414522,4458,3221,7679,+
chr2,63594535,1.992271105826397,1116,840,1956,+
chr2,63595455,1.9473127131600605,973,772,1745,+
chr2,63597524,1.7474599582945118,837,682,1519,+
chr2,63599193,1.54418312293751,1339,1122,2461,+
chr2,63604705,1.431357358480485,1409,912,2321,+
chr2,63604797,1.3701187269280657,1542,1284,2826,+
chr2,63605316,0.6172566371681416,1115,903,2018,+
chr2,63605343,2.061736522566016,828,650,1478,+
chr2,63605355,1.1871434961141367,3340,2609,5949,+
chr2,63605940,0.4527570279979473,1190,740,1930,+
chr2,63605942,0.7048446374874707,1171,819,1990,+
chr2,63605960,1.631537102473498,802,565,1367,+
chr2,63605991,1.5925979786228457,1042,808,1850,+
chr2,63607029,1.5270843362446416,3027,1964,4991,+
chr2,63684534,1.1090273192519053,898,905,1803,+
chr2,63684535,1.1090273192519053,898,905,1803,+
chr2,63856306,5.472457627118644,573,471,1044,+
chr2,63856307,5.472457627118644,573,471,1044,+
chr2,63857908,2.122271393916572,752,633,1385,+
chr2,63883967,0.5594692781551097,758,486,1244,+
chr2,63885640,2.272503840245776,568,433,1001,+
chr2,63885657,1.8212202236266408,554,483,1037,+
chr2,63887482,2.224981467753892,666,425,1091,+
chr2,63891153,2.0175757327023836,1193,848,2041,+
chr2,63891466,1.8000606591629036,1186,801,1987,+
chr2,65205072,2.0601061007547252,620,421,1041,+
chr2,65205081,1.2081452059216868,1348,885,2233,+
chr2,65205090,2.829624853032485,769,514,1283,+
chr2,65205112,1.9644457840512206,1110,730,1840,+
chr2,65205118,1.3503445455809473,1220,867,2087,+
chr2,65205122,1.6207926938973631,2242,1611,3853,+
chr2,65205176,2.5544316530680677,1062,777,1839,+
chr2,65205337,1.3605769230769231,1131,831,1962,+
chr2,65205338,1.3605769230769231,1131,831,1962,+
chr2,65205339,1.3605769230769231,1131,831,1962,+
chr2,65205360,1.7015637423800691,641,538,1179,+
chr2,65205369,1.606421630756231,1939,1314,3253,+
chr2,65205371,1.606421630756231,1939,1314,3253,+
chr2,65205372,0.494180760138207,1086,845,1931,+
chr2,65205389,1.6894987880209555,1393,1043,2436,+
chr2,65205391,1.7259138130050018,1338,1129,2467,+
chr2,65205633,2.246126542856211,684,485,1169,+
chr2,65205634,1.6398910276137983,701,452,1153,+
chr2,65205657,1.7816889400265752,783,644,1427,+
chr2,65205673,1.490415466886055,646,441,1087,+
chr2,65205676,1.5693779904306218,737,527,1264,+
chr2,65205680,1.602508650519031,854,611,1465,+
chr2,65205683,0.6259074919810735,1763,1565,3328,+
chr2,65205702,0.5126131221719458,953,679,1632,+
chr2,65205710,0.39794177535633707,1032,672,1704,+
chr2,65205754,0.5815602836879432,737,422,1159,+
chr2,65205803,1.4899911062461515,2655,1554,4209,+
chr2,65205805,0.5355010345846881,1293,994,2287,+
chr2,65205807,1.937108547209795,3046,1917,4963,+
chr2,65205824,0.6474426051630199,6648,3631,10279,+
chr2,65205849,1.261078493818901,9506,5382,14888,+
chr2,65205852,1.329591373395962,4645,2581,7226,+
chr2,65205858,1.379363325157848,11089,6431,17520,+
chr2,65205862,1.1626115550617329,20305,12313,32618,+
chr2,65205869,1.190905785150023,16122,9764,25886,+
chr2,65205876,1.20829228614799,32511,20845,53356,+
chr2,65205878,1.5336119579216294,18644,12219,30863,+
chr2,65227845,1.431964122981518,660,604,1264,+
chr2,65239879,2.085118355799684,957,697,1654,+
chr2,65246686,1.4838630806845965,594,408,1002,+
chr2,65251055,0.9961932650073206,971,682,1653,+
chr2,65251057,0.9961932650073206,971,682,1653,+
chr2,65255546,2.1604728196657055,1040,660,1700,+
chr2,65255663,1.7860991379310343,764,463,1227,+
chr2,65265053,2.177377948462476,989,752,1741,+
chr2,65268603,2.1429705895522946,994,767,1761,+
chr2,65268678,2.7145542566960423,1207,857,2064,+
chr2,65268687,0.6126192223037417,834,608,1442,+
chr2,65269150,9.671104950014106,1776,486,2262,+
chr2,65269151,8.143675914450059,986,248,1234,+
chr2,65269156,5.9295238095238085,848,209,1057,+
chr2,65269157,10.002090253810136,1778,508,2286,+
chr2,65269160,60.217029327780374,2642,2321,4963,+
chr2,65269161,60.217029327780374,2642,2321,4963,+
chr2,65269182,2.6269941800375696,1204,1535,2739,+
chr2,65269312,19.924908424908427,1418,116,1534,+
chr2,65269313,37.608081990119544,2852,409,3261,+
chr2,65269314,36.75402807824422,5911,1276,7187,+
chr2,65269315,34.03104892003137,5917,1368,7285,+
chr2,65269316,22.87820668309217,6380,1762,8142,+
chr2,65269317,28.046842325386866,2394,796,3190,+
chr2,65269318,17.891549946625428,5502,3433,8935,+
chr2,65269319,18.477091016702218,4906,3937,8843,+
chr2,65269320,18.229788946658154,4429,3813,8242,+
chr2,65269330,11.869093541085752,1703,2538,4241,+
chr2,65269333,3.8405795750162985,1314,1976,3290,+
chr2,65269344,0.14636574842349814,440,654,1094,+
chr2,65269356,0.3636698939603504,492,722,1214,+
chr2,65269363,0.3886081422153247,1488,2294,3782,+
chr2,65269455,0.4627926421404683,737,519,1256,+
chr2,65269513,1.5679503729202524,1197,1161,2358,+
chr2,65269522,2.108540925266904,1105,842,1947,+
chr2,65269532,1.6905405405405407,1250,1035,2285,+
chr2,65269856,1.675389675389675,807,517,1324,+
chr2,65269971,1.6013585226066651,942,672,1614,+
chr2,65270089,2.749510763209393,561,510,1071,+
chr2,65270226,0.37324574499850705,624,393,1017,+
chr2,65270269,1.889466707453859,544,466,1010,+
chr2,65271009,2.5846501128668167,686,442,1128,+
chr2,65271052,1.6703252032520326,586,491,1077,+
chr2,67403693,1.1686529129820329,633,455,1088,+
chr2,68174881,4.335340079934182,551,467,1018,+
chr2,69013596,2.61042382309049,690,350,1040,+
chr2,69013604,6.134111455041703,1964,1781,3745,+
chr2,69013605,6.134111455041703,1964,1781,3745,+
chr2,69013606,6.077022672429377,1503,1359,2862,+
chr2,69013626,1.43799815545476,628,679,1307,+
chr2,69040069,0.517439082656474,721,597,1318,+
chr2,69040071,0.4736514568051683,992,846,1838,+
chr2,69040080,1.3565432180414758,680,517,1197,+
chr2,69246669,1.2573045056983834,608,421,1029,+
chr2,69247127,3.0047425255080586,693,524,1217,+
chr2,69248127,0.5055224791340944,892,703,1595,+
chr2,69248968,0.42046890355187416,598,418,1016,+
chr2,69249267,2.8228088190878884,751,453,1204,+
chr2,69895127,1.3291360082823669,783,580,1363,+
chr2,69896439,1.4546097865104017,559,458,1017,+
chr2,69905018,2.4193917414756783,595,447,1042,+
chr2,70087723,2.4993774313487878,694,493,1187,+
chr2,70087757,1.507748091632824,1685,1180,2865,+
chr2,70087759,0.4626451459120782,936,752,1688,+
chr2,70087760,0.8117236680020373,2798,1948,4746,+
chr2,70087762,0.770610944526154,2862,1961,4823,+
chr2,70087770,1.7044381491973561,1082,705,1787,+
chr2,70087833,0.5640579710144928,555,459,1014,+
chr2,70087884,2.1630564578032985,1755,1123,2878,+
chr2,70087885,1.8606829268292684,893,614,1507,+
chr2,70087947,1.5986800933037493,1123,836,1959,+
chr2,70088034,0.5721985607284477,1923,1237,3160,+
chr2,70088035,1.008413452749759,3496,2010,5506,+
chr2,70088043,1.7805255023183928,1055,646,1701,+
chr2,70088061,1.5576954304393524,4973,2826,7799,+
chr2,70088147,1.9824886418068346,1299,834,2133,+
chr2,70088225,2.144244429308164,1237,1194,2431,+
chr2,70088226,1.9240197561945929,1999,1674,3673,+
chr2,70088239,1.8517455762792925,967,614,1581,+
chr2,70088277,1.72275641025641,2724,1416,4140,+
chr2,70088295,1.4083073360616907,16133,8992,25125,+
chr2,70088296,1.3458779682563502,23069,12889,35958,+
chr2,70088297,1.3904252114799347,15837,8215,24052,+
chr2,70088298,1.570721936166577,19140,11289,30429,+
chr2,70088406,1.3251332551501234,1172,884,2056,+
chr2,70088411,1.1748137368634524,1073,775,1848,+
chr2,70088420,2.2053097345132744,622,451,1073,+
chr2,70088447,0.7495041261601,1154,841,1995,+
chr2,70088574,1.3301352553002292,1464,928,2392,+
chr2,70088761,1.2434480171519793,2372,1566,3938,+
chr2,70088767,1.4823067536739347,1523,926,2449,+
chr2,70088831,1.4608681988875967,4347,2879,7226,+
chr2,70088833,1.421914104883806,4511,3141,7652,+
chr2,70088858,2.017065444630123,3130,2450,5580,+
chr2,71070503,5.217881074550788,775,535,1310,+
chr2,71070504,5.272562443095923,887,643,1530,+
chr2,71363981,0.7775039441569567,694,420,1114,+
chr2,71426818,0.3858687126805641,638,381,1019,+
chr2,71426890,0.5501427604273983,889,640,1529,+
chr2,71431414,3.587390268048374,1185,705,1890,+
chr2,71431416,2.3281853281853286,669,369,1038,+
chr2,71433203,1.7348979787335954,862,744,1606,+
chr2,71433208,2.0601224105461395,892,707,1599,+
chr2,72891467,1.2200608654621194,813,592,1405,+
chr2,73234289,0.818969511186414,749,417,1166,+
chr2,73234313,1.5405911136186974,993,571,1564,+
chr2,73234329,0.8512237762237762,1081,714,1795,+
chr2,73234330,0.8512237762237762,1081,714,1795,+
chr2,73234337,1.6940424295263004,766,464,1230,+
chr2,73234340,1.838392549154881,626,445,1071,+
chr2,73234362,1.6209677419354838,602,443,1045,+
chr2,73234363,0.6832100931612148,883,605,1488,+
chr2,73239652,1.6489643632641537,1585,1159,2744,+
chr2,73239690,1.744137931034483,842,724,1566,+
chr2,73240439,0.670189161146141,1311,934,2245,+
chr2,73243049,1.8106548307599457,1734,1347,3081,+
chr2,73243050,0.6537862776629867,5815,3405,9220,+
chr2,73243058,1.5583053435114502,6185,3274,9459,+
chr2,73243059,1.5583053435114502,6185,3274,9459,+
chr2,73243091,1.354645658516575,7885,4874,12759,+
chr2,73243997,2.0845556514236407,754,609,1363,+
chr2,73243998,1.5554198262152257,1226,1008,2234,+
chr2,73244553,1.961186030428769,925,722,1647,+
chr2,73244561,1.6125700835929098,2972,2005,4977,+
chr2,73244602,0.5861865856822752,2849,2279,5128,+
chr2,73247819,1.579602791196994,1050,827,1877,+
chr2,73247834,1.3420479302832242,1759,1529,3288,+
chr2,73247861,2.0337308587961327,1440,1148,2588,+
chr2,73249035,1.6679874622981847,1922,1370,3292,+
chr2,73249105,1.6888936351986334,3437,2340,5777,+
chr2,73249107,1.4316487384654804,8168,5562,13730,+
chr2,73249108,1.7654664280219994,3617,2568,6185,+
chr2,73249111,1.7287941370139477,2127,1646,3773,+
chr2,73249163,0.7242265053991135,3966,2561,6527,+
chr2,73249900,1.7059133039219656,1027,796,1823,+
chr2,73251273,1.896163986972031,1725,1333,3058,+
chr2,73251274,1.7684373221500906,2949,2340,5289,+
chr2,73251299,1.5349887133182842,1059,885,1944,+
chr2,73252644,0.6473959288465064,1045,778,1823,+
chr2,73252656,2.065182829888712,865,628,1493,+
chr2,73252666,1.6687813021702835,832,598,1430,+
chr2,73252687,1.75,962,748,1710,+
chr2,73252856,1.8514555468135327,953,464,1417,+
chr2,73252859,2.937559762860967,990,497,1487,+
chr2,73252877,0.4869970069837047,522,484,1006,+
chr2,73958202,1.6387795275590549,899,634,1533,+
chr2,73958833,3.066468253968253,842,566,1408,+
chr2,73958834,3.066468253968253,842,566,1408,+
chr2,73958859,1.1632181113564848,998,723,1721,+
chr2,74198640,1.3624883100413645,794,453,1247,+
chr2,74198652,1.7238805970149256,692,401,1093,+
chr2,74198657,1.5156250000000002,872,503,1375,+
chr2,74198658,0.6857239731335572,1088,783,1871,+
chr2,74205745,1.5855307969251726,638,477,1115,+
chr2,74205772,2.124401913875598,1035,531,1566,+
chr2,74205773,1.4106974106974106,1243,961,2204,+
chr2,74205808,2.038025466596895,1015,818,1833,+
chr2,74205817,1.5811547602404583,1565,932,2497,+
chr2,74205832,1.4610344827586208,1114,869,1983,+
chr2,74205842,1.4321165620398355,1378,1172,2550,+
chr2,74207705,2.086072942082959,1968,1197,3165,+
chr2,74208706,1.6556617647058824,2046,1699,3745,+
chr2,74209958,2.080314039144935,8027,6303,14330,+
chr2,74211201,0.7246848515954584,2480,1886,4366,+
chr2,74211221,1.0763507721417682,3302,2605,5907,+
chr2,74211762,1.6557692307692309,1721,1295,3016,+
chr2,74214087,0.7014209615537811,5071,3539,8610,+
chr2,74214173,1.410055794266658,2442,2011,4453,+
chr2,74214285,1.3791679404998771,2547,1648,4195,+
chr2,74214430,1.409961685823755,2131,1598,3729,+
chr2,74214455,1.3173016864459717,2070,1600,3670,+
chr2,74214692,1.5511576727522538,3347,2296,5643,+
chr2,74214758,1.373183600644983,3467,2571,6038,+
chr2,74215103,1.6906614785992218,1579,1284,2863,+
chr2,74532889,3.3514588859416445,721,463,1184,+
chr2,74532890,3.067455672717409,757,454,1211,+
chr2,74532904,2.365386789588145,588,445,1033,+
chr2,74532942,1.703515035411587,1096,1043,2139,+
chr2,74532943,1.8798181818181818,1687,1649,3336,+
chr2,74532945,2.2070440419701933,1151,1150,2301,+
chr2,74867694,1.9501985232271641,681,397,1078,+
chr2,74886593,6.300663039617527,1124,990,2114,+
chr2,74886594,6.300663039617527,1124,990,2114,+
chr2,74890841,2.1910883380335906,857,340,1197,+
chr2,74890893,1.682801903183288,1146,679,1825,+
chr2,74890896,1.7529800478389341,2032,1355,3387,+
chr2,74890898,1.5238798486713159,2013,1544,3557,+
chr2,74890899,1.6848527447810502,2165,1734,3899,+
chr2,74890901,1.8907430454521552,2294,1922,4216,+
chr2,74890903,2.507749499571061,1565,1344,2909,+
chr2,74891435,13.214466745124167,618,452,1070,+
chr2,74891436,17.450038097434707,728,609,1337,+
chr2,74891446,1.917280681200752,781,939,1720,+
chr2,74891856,2.9844758416186985,589,440,1029,+
chr2,74891857,2.9844758416186985,589,440,1029,+
chr2,74892374,2.7302155505459065,608,454,1062,+
chr2,74959366,0.8707050302745493,1641,1270,2911,+
chr2,74969513,0.9511951103792244,769,587,1356,+
chr2,75652179,2.042083654092892,691,432,1123,+
chr2,75652201,0.5881099509908374,689,493,1182,+
chr2,75652210,1.6235504014272972,1182,766,1948,+
chr2,75652218,1.7963430012610344,2589,1829,4418,+
chr2,75652219,1.7963430012610344,2589,1829,4418,+
chr2,75652524,1.1065546517029943,4627,3028,7655,+
chr2,75652525,1.5106568099175537,2542,1617,4159,+
chr2,75652528,1.3312935522627154,2051,1134,3185,+
chr2,75652538,1.0632303806999106,2573,1722,4295,+
chr2,75652539,1.0632303806999106,2573,1722,4295,+
chr2,75652547,1.8953665334262348,2222,1627,3849,+
chr2,75652551,1.2671923534723488,11894,8720,20614,+
chr2,75652552,1.205621312251696,16278,10895,27173,+
chr2,75652553,1.205621312251696,16278,10895,27173,+
chr2,75652564,1.2899073427857772,5562,3402,8964,+
chr2,75652599,2.1629916897506924,722,474,1196,+
chr2,75655146,1.940031406021541,1081,745,1826,+
chr2,75655233,0.45720823798627,665,436,1101,+
chr2,75655259,1.7127613616727149,966,642,1608,+
chr2,75655668,2.64171974522293,552,470,1022,+
chr2,84905654,0.8005829124852324,1677,787,2464,+
chr2,84905655,1.1332047210208576,1595,1854,3449,+
chr2,84905656,1.2302496768774767,5977,3020,8997,+
chr2,84905657,1.6442452213945102,7053,3658,10711,+
chr2,84905658,1.4066016192346849,6613,4016,10629,+
chr2,84905659,1.3643184298457565,5054,3192,8246,+
chr2,84905661,1.1135966947023854,2351,1959,4310,+
chr2,84905664,1.351506837190778,1526,1531,3057,+
chr2,84905667,1.3359284987191964,2453,1418,3871,+
chr2,84905668,1.5499346649243981,1443,973,2416,+
chr2,84905670,1.7575846172098784,2746,1661,4407,+
chr2,84905671,1.352657004830918,1623,1913,3536,+
chr2,84905685,1.235790779622466,3304,3136,6440,+
chr2,84905688,1.2875775973804489,9933,6301,16234,+
chr2,84905689,1.2875775973804489,9933,6301,16234,+
chr2,84905695,0.7827748209255058,8192,7847,16039,+
chr2,84905705,1.2387005649717515,4384,4306,8690,+
chr2,84906005,1.3178084476504188,6320,4134,10454,+
chr2,84906011,1.2408148835564985,5231,4763,9994,+
chr2,84906012,1.1589718730896903,6140,5392,11532,+
chr2,84906015,1.151990340367922,15277,11776,27053,+
chr2,84906042,1.2635795430930785,16286,14286,30572,+
chr2,84906390,1.0368815563355642,12209,8449,20658,+
chr2,84906400,1.1754229244231293,17671,11184,28855,+
chr2,84906410,1.0128078480162914,31364,21254,52618,+
chr2,84906432,1.1269076109110674,27369,20103,47472,+
chr2,84906433,0.8655153506002682,16405,11066,27471,+
chr2,84906434,1.1559290964831896,40725,28046,68771,+
chr2,84906457,1.307698417986631,54118,37523,91641,+
chr2,84906582,1.479120697996881,6258,4263,10521,+
chr2,84906584,0.7360537700254826,2292,1632,3924,+
chr2,84906607,1.8385093167701865,2911,2391,5302,+
chr2,85053324,0.308861119000284,724,502,1226,+
chr2,85053326,0.308861119000284,724,502,1226,+
chr2,85539196,0.9841151621273327,629,531,1160,+
chr2,85541855,1.8823689637729093,1074,828,1902,+
chr2,85541920,0.2969841469025808,709,612,1321,+
chr2,85541936,2.1959880540348915,2394,1819,4213,+
chr2,85542199,0.4868876793666502,819,704,1523,+
chr2,85542629,2.052584670231729,657,527,1184,+
chr2,85542654,1.6505417659263815,1590,1182,2772,+
chr2,85542936,1.756283805281578,689,448,1137,+
chr2,85542940,1.2368513759005495,5319,4285,9604,+
chr2,85542942,1.1180137642466839,6714,5351,12065,+
chr2,85542943,0.5936050554998822,2709,2098,4807,+
chr2,85542947,1.531058223291587,4965,4341,9306,+
chr2,85542949,1.8638238132841976,3353,3143,6496,+
chr2,85542988,2.2581792318634424,761,443,1204,+
chr2,85543013,1.390310238325727,1391,1032,2423,+
chr2,85543038,2.162874251497006,601,500,1101,+
chr2,85543135,0.6848207499878721,1209,922,2131,+
chr2,85543151,2.0700136612021858,550,548,1098,+
chr2,85543374,11.631853785900784,674,382,1056,+
chr2,85543376,26.015452366355625,4115,3152,7267,+
chr2,85543377,28.55410905079757,4053,3211,7264,+
chr2,85543386,0.34944438148912627,700,740,1440,+
chr2,85543401,0.7080679405520169,1391,1255,2646,+
chr2,85543527,1.3940052443246844,1551,1210,2761,+
chr2,85543623,1.3222996951067127,1188,987,2175,+
chr2,85543631,2.0248306997742658,597,442,1039,+
chr2,85543758,1.5378787878787878,1362,1055,2417,+
chr2,85543837,4.179404187146533,1556,1146,2702,+
chr2,85544024,0.996719184326359,923,662,1585,+
chr2,85544295,2.956109596156343,784,452,1236,+
chr2,85544296,2.956109596156343,784,452,1236,+
chr2,85544339,7.481510934393637,671,502,1173,+
chr2,85544402,1.6875768757687581,1035,812,1847,+
chr2,85544558,3.435045317220544,757,661,1418,+
chr2,85544617,2.5957883890804165,1722,1381,3103,+
chr2,85544705,1.5645609852999605,1073,838,1911,+
chr2,85544780,1.6773590593910155,842,534,1376,+
chr2,85544784,1.0566714936259551,2534,1880,4414,+
chr2,85544788,1.5730889235569423,937,640,1577,+
chr2,85544895,2.836897590361446,965,663,1628,+
chr2,85544978,1.7512335892182938,1413,1034,2447,+
chr2,85545014,1.7301024575362045,2296,1690,3986,+
chr2,85545016,1.659671149880468,1934,1480,3414,+
chr2,85545018,0.5874652455977758,921,663,1584,+
chr2,85545019,1.4849354716264946,1180,957,2137,+
chr2,85579118,1.1077922077922078,852,549,1401,+
chr2,85579119,1.1077922077922078,852,549,1401,+
chr2,85581900,0.4800469729775551,820,505,1325,+
chr2,85595770,2.993963782696177,959,496,1455,+
chr2,85595771,2.993963782696177,959,496,1455,+
chr2,85595772,1.3550852242229527,793,532,1325,+
chr2,85596839,2.950980392156862,816,645,1461,+
chr2,85596840,2.950980392156862,816,645,1461,+
chr2,85640975,0.8884475597400487,686,530,1216,+
chr2,85644996,3.191910517056516,898,664,1562,+
chr2,85644997,2.6377850037628408,1296,955,2251,+
chr2,85644999,3.1908315565031984,583,468,1051,+
chr2,85647932,2.5324783942012816,756,632,1388,+
chr2,85647934,2.5324783942012816,756,632,1388,+
chr2,85647943,1.5305108328364143,615,558,1173,+
chr2,85647947,1.1352697608856448,1804,1534,3338,+
chr2,85647949,1.3194319271588424,3506,2785,6291,+
chr2,85647953,0.9776993648553284,2308,1624,3932,+
chr2,85647954,1.1353756514745972,3234,2485,5719,+
chr2,85647955,1.6276361290784969,1513,1138,2651,+
chr2,85647971,1.6343701095461662,1246,1277,2523,+
chr2,85649068,0.9678308823529411,647,543,1190,+
chr2,85649069,1.3509857740943267,900,696,1596,+
chr2,85649123,3.581775078875951,574,520,1094,+
chr2,86127214,1.5674504423717859,709,484,1193,+
chr2,86134293,4.264985026864277,600,583,1183,+
chr2,86210554,2.011455831845034,699,556,1255,+
chr2,86210609,1.5872335357865908,783,621,1404,+
chr2,86485813,0.39772186767300327,1444,908,2352,+
chr2,86485815,0.4630773511407902,978,598,1576,+
chr2,86485840,1.790049305244285,767,484,1251,+
chr2,87521333,3.454344417138127,691,410,1101,+
chr2,88750215,7.146560690354036,1199,2456,3655,+
chr2,88750216,7.146560690354036,1199,2456,3655,+
chr2,88750217,6.345344095687502,1331,2740,4071,+
chr2,88750219,0.7557880461106267,563,1146,1709,+
chr2,88750220,0.2624821583091236,1111,2164,3275,+
chr2,88750221,0.2955146853376724,619,1192,1811,+
chr2,88750222,0.2631298741750909,782,1271,2053,+
chr2,88750490,2.167624967624968,1707,857,2564,+
chr2,88750492,2.167624967624968,1707,857,2564,+
chr2,88750498,1.643586311608487,1586,749,2335,+
chr2,96267715,2.676202343719628,607,425,1032,+
chr2,96343281,1.6514910152189806,1393,856,2249,+
chr2,96343283,1.9993103448275864,891,579,1470,+
chr2,96344126,0.526541095890411,614,437,1051,+
chr2,96344133,1.493185367090387,1327,776,2103,+
chr2,96344154,1.0457920212607643,1319,708,2027,+
chr2,96344165,2.206122448979592,1080,734,1814,+
chr2,96344175,2.1792035398230087,1181,903,2084,+
chr2,96373600,8.74982911825017,752,265,1017,+
chr2,96373601,7.677668372268053,1016,414,1430,+
chr2,96373606,26.28193865018018,1431,1511,2942,+
chr2,96373607,26.486632321278964,1619,1899,3518,+
chr2,96373608,26.486632321278964,1619,1899,3518,+
chr2,96373617,0.24718949909360155,390,809,1199,+
chr2,97646061,0.9431800325583442,1325,878,2203,+
chr2,97646152,1.7009682931460037,1053,457,1510,+
chr2,97646173,2.7168412380840294,1214,585,1799,+
chr2,97646174,2.406677265500795,782,554,1336,+
chr2,97647070,1.5051393372666888,1192,690,1882,+
chr2,97647077,2.4084354722422487,785,583,1368,+
chr2,97647085,2.3105674048372284,1534,955,2489,+
chr2,97647128,0.6562110206178003,1153,923,2076,+
chr2,97647345,2.7659489633173844,990,791,1781,+
chr2,97647350,1.9621593768425722,3476,2402,5878,+
chr2,97647351,2.3719894561598225,1726,1359,3085,+
chr2,97647352,1.5165018799610082,1209,1001,2210,+
chr2,97647354,1.3960560911481157,1873,1303,3176,+
chr2,97647390,1.5075026536717169,2372,1445,3817,+
chr2,97648073,1.3655566633433034,1683,884,2567,+
chr2,97648076,1.9289944556451613,1800,991,2791,+
chr2,98609853,0.7529014560033763,891,676,1567,+
chr2,98609855,0.5382608695652173,618,459,1077,+
chr2,98610022,2.694244604316547,748,555,1303,+
chr2,98610023,2.694244604316547,748,555,1303,+
chr2,98610852,0.9508340649692713,721,602,1323,+
chr2,98610853,0.9508340649692713,721,602,1323,+
chr2,99186232,2.315857142857143,558,499,1057,+
chr2,99188243,0.98862326640923,1076,795,1871,+
chr2,99194833,2.7329125109162558,1200,853,2053,+
chr2,99195136,1.5547241970267234,888,587,1475,+
chr2,99196893,1.2568245406034628,918,536,1454,+
chr2,99197171,4.987879251335799,736,384,1120,+
chr2,99197190,5.935309766411945,1883,1243,3126,+
chr2,99197191,5.935309766411945,1883,1243,3126,+
chr2,99197194,17.729652762384944,710,542,1252,+
chr2,99197205,7.277177206564219,1924,1726,3650,+
chr2,99197206,7.416263208823483,2210,2062,4272,+
chr2,99197207,5.714845763527325,1217,1121,2338,+
chr2,99361423,1.4415470113410616,756,468,1224,+
chr2,99368498,2.2903846153846152,1190,675,1865,+
chr2,99368499,2.2903846153846152,1190,675,1865,+
chr2,99368510,2.0483193277310927,740,475,1215,+
chr2,99368561,2.3784753363228703,662,445,1107,+
chr2,99368577,1.1446440968413458,2702,2098,4800,+
chr2,99369395,1.5971567336420147,2767,2241,5008,+
chr2,99369396,1.2473225244211799,4489,3633,8122,+
chr2,99369399,1.7699158832261255,1518,1332,2850,+
chr2,99369404,1.4831316793550149,2470,2075,4545,+
chr2,99369405,0.36746490503715934,800,518,1318,+
chr2,99376457,7.306123770373119,1228,1267,2495,+
chr2,99376458,7.306123770373119,1228,1267,2495,+
chr2,99376548,3.535546139359698,652,353,1005,+
chr2,99376550,3.535546139359698,652,353,1005,+
chr2,99379053,1.820756585462468,633,560,1193,+
chr2,99379054,1.820756585462468,633,560,1193,+
chr2,99379055,1.820756585462468,633,560,1193,+
chr2,99396861,3.1308145709430755,563,537,1100,+
chr2,99399679,2.470253766406421,710,580,1290,+
chr2,101002273,0.8537283704718038,761,492,1253,+
chr2,101002285,1.1613241718755312,4300,2681,6981,+
chr2,101002287,0.9403305577789192,4312,2443,6755,+
chr2,101002288,0.9563902453989065,4315,2634,6949,+
chr2,101002291,1.1835013580242904,12735,10358,23093,+
chr2,101002292,1.1851815988633945,11823,10815,22638,+
chr2,101002294,1.43495378468171,4479,4536,9015,+
chr2,101002295,0.7750570161214391,3548,3133,6681,+
chr2,101002298,1.1084506193546395,10768,7249,18017,+
chr2,101002305,1.1047857435836037,13768,9303,23071,+
chr2,101002713,1.1313801125315448,8689,6286,14975,+
chr2,101002714,0.7467720403987352,6473,5943,12416,+
chr2,101002726,1.1946132440354225,7201,6173,13374,+
chr2,101002728,1.1249891161711234,39951,24729,64680,+
chr2,101002729,1.1402865954983255,73731,50309,124040,+
chr2,101002730,1.1619412536425695,71121,44609,115730,+
chr2,101002731,1.1716992434730318,110333,80700,191033,+
chr2,101002732,1.1916846673456811,88404,65094,153498,+
chr2,101004254,1.3176837603917673,56122,35770,91892,+
chr2,101004255,1.3676323942528394,46312,27874,74186,+
chr2,101005953,0.9855307036515092,980,744,1724,+
chr2,101005955,0.9415759200212848,3834,3373,7207,+
chr2,101005956,1.0054719957379066,3349,3013,6362,+
chr2,101005957,0.8502463342000409,3590,2925,6515,+
chr2,101005960,1.247485304015395,46369,32867,79236,+
chr2,101005967,0.8565401172607271,20778,15910,36688,+
chr2,101006342,1.2337241573074134,1145,867,2012,+
chr2,101006353,1.5817700473067098,11398,8613,20011,+
chr2,101270214,6.886724338273362,592,418,1010,+
chr2,101270215,6.584988231913428,718,505,1223,+
chr2,105038170,2.9761803511298073,1198,799,1997,+
chr2,105038171,2.8611005692599623,717,526,1243,+
chr2,105038201,1.9429159707475354,1060,714,1774,+
chr2,105038204,2.21923937360179,991,446,1437,+
chr2,105038205,1.5323720892069002,1097,871,1968,+
chr2,105038206,2.1248994990413754,1526,702,2228,+
chr2,105038208,2.051064385529581,1046,493,1539,+
chr2,105038211,1.8182261321964515,1788,1252,3040,+
chr2,105049175,1.832904884318766,712,388,1100,+
chr2,105049181,1.8227662896209391,2218,1420,3638,+
chr2,105049182,1.9090697566196655,2563,1652,4215,+
chr2,105049184,2.1931152836664647,1737,1142,2879,+
chr2,105049191,1.6234104046242774,958,691,1649,+
chr2,105049196,1.6506765067650675,1077,812,1889,+
chr2,105049198,0.7213628902956114,4759,3865,8624,+
chr2,105049199,0.8895842644843001,5287,4339,9626,+
chr2,105049214,2.934458788480636,2166,1748,3914,+
chr2,105080034,3.5810513939168915,590,463,1053,+
chr2,105099679,0.9650475991939408,991,701,1692,+
chr2,105099680,1.6661768610714718,1450,939,2389,+
chr2,105099683,4.180556651252244,943,668,1611,+
chr2,105099685,2.2277689781365146,1034,649,1683,+
chr2,105099708,1.8742574257425746,630,504,1134,+
chr2,105099720,1.6218294878088695,900,678,1578,+
chr2,105099734,1.970864583333333,2505,1999,4504,+
chr2,105099735,1.914943549286079,3854,3136,6990,+
chr2,105099737,1.5386449294216242,5292,4115,9407,+
chr2,105099738,1.331296302005801,3400,2780,6180,+
chr2,108497090,1.509987715123364,618,504,1122,+
chr2,112528851,2.5842918735388203,658,395,1053,+
chr2,112528867,1.2464281379268787,870,711,1581,+
chr2,112575921,3.616071428571429,809,447,1256,+
chr2,112575922,3.616071428571429,809,447,1256,+
chr2,112658828,1.843967065680106,598,413,1011,+
chr2,112663068,2.8203894551044804,617,384,1001,+
chr2,113658335,2.557522123893805,577,451,1028,+
chr2,113658358,2.609726688102894,754,621,1375,+
chr2,113890192,2.362647152604483,1154,818,1972,+
chr2,113890194,2.0965289256198347,905,604,1509,+
chr2,113913194,0.5034064164498947,634,620,1254,+
chr2,113913195,0.5034064164498947,634,620,1254,+
chr2,113913197,0.5612612612612612,622,449,1071,+
chr2,113916914,1.683193429554925,870,570,1440,+
chr2,113927370,1.8965811965811967,633,467,1100,+
chr2,113931336,1.6958424507658645,650,456,1106,+
chr2,113934358,2.325050820603112,1276,830,2106,+
chr2,113940023,1.4677206851119893,1113,791,1904,+
chr2,113940052,1.7828277414513882,593,490,1083,+
chr2,113951739,3.667560321715819,911,745,1656,+
chr2,113951746,1.8193136472466085,1111,715,1826,+
chr2,113957366,3.235146966854284,738,491,1229,+
chr2,113957400,0.5,698,465,1163,+
chr2,113957402,1.6175218224398553,1012,670,1682,+
chr2,113957490,13.308386474596153,11298,10683,21981,+
chr2,113957491,13.308386474596157,11298,10683,21981,+
chr2,113957504,0.6512713228194399,1490,1672,3162,+
chr2,113957544,1.6110974567895047,9923,10346,20269,+
chr2,113957558,0.5791491591013255,14342,13326,27668,+
chr2,113957563,0.9190572075647714,12277,11073,23350,+
chr2,113957566,1.5605823068309073,5225,4793,10018,+
chr2,113957969,2.3014141414141416,711,549,1260,+
chr2,113958020,1.9419744318181815,738,639,1377,+
chr2,117814700,0.5443708592132941,680,393,1073,+
chr2,117814703,0.9606525514845752,910,427,1337,+
chr2,117814704,1.3259699921925387,1312,661,1973,+
chr2,117814705,1.3259699921925387,1312,661,1973,+
chr2,117814706,1.3207002752600747,2128,1555,3683,+
chr2,117814707,0.9605863758920616,1378,1187,2565,+
chr2,117814722,0.52593808915648,2631,2348,4979,+
chr2,117814723,0.7283357388799697,3327,2726,6053,+
chr2,117814724,0.52593808915648,2631,2348,4979,+
chr2,117814729,1.090253568485458,2001,1371,3372,+
chr2,117814736,1.8989604821421349,1066,602,1668,+
chr2,117814753,1.4203875206674088,3335,2256,5591,+
chr2,117814755,1.1996727193542158,5179,3284,8463,+
chr2,117814759,1.4811081661475365,1962,1396,3358,+
chr2,117814763,1.036821745707417,5756,4149,9905,+
chr2,117821945,1.697372112597026,1099,577,1676,+
chr2,117824637,0.4363477214289623,996,676,1672,+
chr2,117824639,1.4098577460761443,1320,914,2234,+
chr2,117829322,1.1436750760422258,798,620,1418,+
chr2,117829324,1.1436750760422258,798,620,1418,+
chr2,117830745,2.528024495621123,1001,725,1726,+
chr2,119366976,0.7578384911386863,808,428,1236,+
chr2,119367029,2.7512730121425766,877,665,1542,+
chr2,119367030,2.7512730121425766,877,665,1542,+
chr2,119370757,2.2634920634920634,712,559,1271,+
chr2,119372256,0.6897935779816513,1202,871,2073,+
chr2,119372257,1.5187484355444305,1318,1174,2492,+
chr2,119372264,2.7980655349388077,1749,1489,3238,+
chr2,119372265,2.7980655349388077,1749,1489,3238,+
chr2,119978746,1.4150452352781804,624,489,1113,+
chr2,121755798,1.8265442757512926,826,460,1286,+
chr2,121757253,1.3414590830040056,752,526,1278,+
chr2,121758771,1.3764993966924552,1846,1157,3003,+
chr2,121761448,1.7330965535385423,2634,1628,4262,+
chr2,121761449,1.7236321151826732,3758,2398,6156,+
chr2,121761467,1.824494901633752,1527,1146,2673,+
chr2,121761474,0.6946185821817774,2377,1379,3756,+
chr2,121761476,0.486815415821501,983,696,1679,+
chr2,121761479,1.6576214636242568,6702,5342,12044,+
chr2,121761480,1.2493807104293628,11938,9064,21002,+
chr2,121761481,1.6576214636242568,6702,5342,12044,+
chr2,121763011,2.82342172389422,625,601,1226,+
chr2,121765803,2.231404958677686,809,604,1413,+
chr2,121765804,2.231404958677686,809,604,1413,+
chr2,121766881,1.58262072535267,817,598,1415,+
chr2,121766924,5.601873536299765,623,426,1049,+
chr2,121766996,2.0846131556070704,653,405,1058,+
chr2,126696031,1.0703450308075768,788,495,1283,+
chr2,126696101,1.37703073147207,645,492,1137,+
chr2,126696106,1.8121677242325505,578,475,1053,+
chr2,126696157,2.009134345137718,840,592,1432,+
chr2,126696182,1.391781785859783,1192,805,1997,+
chr2,126696187,2.744950783813343,2402,1898,4300,+
chr2,126696188,2.744950783813343,2402,1898,4300,+
chr2,126696189,2.744950783813343,2402,1898,4300,+
chr2,126696192,1.9666294777234852,2293,1736,4029,+
chr2,126696505,34.33446690856092,1105,1090,2195,+
chr2,126696506,34.33446690856092,1105,1090,2195,+
chr2,126696507,28.769194651541987,1294,1468,2762,+
chr2,126696512,0.18963675213675213,496,1455,1951,+
chr2,126696513,0.24718004950636382,831,2053,2884,+
chr2,126696514,0.25469508999516327,1213,2535,3748,+
chr2,126696515,0.3025092936802974,464,806,1270,+
chr2,126696519,0.2706312802548251,435,1021,1456,+
chr2,126696527,0.35553337241138133,435,634,1069,+
chr2,126696528,0.14603596066285252,410,784,1194,+
chr2,130182349,1.6088368023577087,1074,487,1561,+
chr2,130182350,1.6088368023577087,1074,487,1561,+
chr2,130190470,2.1998813554606063,928,723,1651,+
chr2,130190472,0.6070028011204481,590,475,1065,+
chr2,130190473,2.1253791708796763,1050,773,1823,+
chr2,130190474,2.1253791708796763,1050,773,1823,+
chr2,130190597,1.7918513782717422,1810,1347,3157,+
chr2,130190598,1.7500641472222438,3805,2705,6510,+
chr2,130190599,1.7500641472222438,3805,2705,6510,+
chr2,130190607,1.1701447284269368,1899,1140,3039,+
chr2,130190608,1.1701447284269368,1899,1140,3039,+
chr2,130190617,2.0615373270789306,1573,1126,2699,+
chr2,130190627,0.4155428571428572,605,624,1229,+
chr2,130190640,1.823323442136498,626,673,1299,+
chr2,130190651,1.9163498098859322,545,525,1070,+
chr2,130190652,0.6677428033360236,1240,943,2183,+
chr2,130294446,0.5394857949315826,627,378,1005,+
chr2,130346213,2.4547231957598945,598,464,1062,+
chr2,131146821,1.0151594014313596,742,529,1271,+
chr2,131146822,1.0151594014313596,742,529,1271,+
chr2,131149424,0.3949025192306164,718,509,1227,+
chr2,135135584,2.803281819414062,661,536,1197,+
chr2,135162616,1.0395939086294417,639,393,1032,+
chr2,135162618,1.0395939086294417,639,393,1032,+
chr2,135636090,3.162132830870249,596,816,1412,+
chr2,135636091,2.627009646302251,429,621,1050,+
chr2,135770598,1.92274951884659,805,587,1392,+
chr2,135772497,2.5831004438599376,826,552,1378,+
chr2,135772498,2.5831004438599376,826,552,1378,+
chr2,135778970,1.1115236618622168,1056,745,1801,+
chr2,135782841,1.6861464004839686,870,569,1439,+
chr2,135783641,1.2132034242247318,1130,749,1879,+
chr2,135783741,0.6131538560619263,1848,1005,2853,+
chr2,135783742,0.6507080610021787,918,679,1597,+
chr2,135783745,0.5194805194805195,1405,702,2107,+
chr2,135783796,3.1542120607641557,2854,1329,4183,+
chr2,135783839,2.158102512666204,2298,996,3294,+
chr2,135783845,0.9788594215864488,7703,3807,11510,+
chr2,135783868,1.5736042889660955,8436,3927,12363,+
chr2,135783870,1.5736042889660955,8436,3927,12363,+
chr2,135783874,1.4161061483704929,9822,5308,15130,+
chr2,135783884,1.3746421556852382,5931,3076,9007,+
chr2,135783935,2.107264086897488,775,490,1265,+
chr2,135784677,1.1348052940053186,1124,791,1915,+
chr2,135784889,1.187093738232459,1037,669,1706,+
chr2,135784894,1.9060758884175495,1101,630,1731,+
chr2,137964479,0.7679020057223982,1065,716,1781,+
chr2,137964573,2.3652482269503547,695,422,1117,+
chr2,138013953,1.1131411487741039,4597,3101,7698,+
chr2,138013954,1.0083554876438208,5746,3932,9678,+
chr2,138013955,1.2207869302403564,5067,3452,8519,+
chr2,138013998,1.9998789712556733,917,660,1577,+
chr2,142877634,2.087375034318746,1318,676,1994,+
chr2,142877635,2.7386434817477836,1477,758,2235,+
chr2,142877636,3.9963824289405685,626,386,1012,+
chr2,142877663,0.828545680090975,6835,3306,10141,+
chr2,142877664,0.786457345619635,2271,1081,3352,+
chr2,142877672,1.835548541937025,7731,4158,11889,+
chr2,142877673,1.835548541937025,7731,4158,11889,+
chr2,142877674,1.7055768298090608,6138,3393,9531,+
chr2,142877675,1.6631537084907535,2090,1221,3311,+
chr2,142877681,2.7630154879641737,1138,698,1836,+
chr2,142885352,1.651215574548908,2946,2105,5051,+
chr2,142885354,1.651215574548908,2946,2105,5051,+
chr2,142885420,1.5488723053155542,4874,3792,8666,+
chr2,142885422,1.7206632653061225,4259,3359,7618,+
chr2,142885423,1.5550205086136175,2893,2299,5192,+
chr2,142885427,0.7497398959583834,2341,1784,4125,+
chr2,142885515,1.270263941008813,3586,2381,5967,+
chr2,142918699,1.7962561795256349,1747,1411,3158,+
chr2,142954824,1.3734527855009782,4167,2738,6905,+
chr2,142965806,17.12942031497953,667,358,1025,+
chr2,142965807,17.12942031497953,667,358,1025,+
chr2,142968401,2.428660910318927,655,394,1049,+
chr2,142968402,2.456733427673281,666,375,1041,+
chr2,142968441,7.999623636436823,726,314,1040,+
chr2,142968478,1.5377994254766585,692,429,1121,+
chr2,142985106,1.3375843170320405,1553,1185,2738,+
chr2,142985156,1.318192740430825,2360,1537,3897,+
chr2,142985948,0.7804637205813081,2570,1848,4418,+
chr2,142985951,1.5742324685623656,5052,3275,8327,+
chr2,142985952,1.5742324685623656,5052,3275,8327,+
chr2,142985969,1.4373683764417466,3126,2100,5226,+
chr2,142989027,0.20586091266948536,705,360,1065,+
chr2,142989029,0.20586091266948536,705,360,1065,+
chr2,142989042,1.0188203912270302,1249,722,1971,+
chr2,142989044,1.2993243243243244,1922,1119,3041,+
chr2,142989045,1.0745472186287193,1328,772,2100,+
chr2,142989062,2.1023937469467517,741,444,1185,+
chr2,142989064,1.6947852760736195,1104,651,1755,+
chr2,142989088,3.1364491844416564,1110,796,1906,+
chr2,142989092,2.986393872203185,1161,901,2062,+
chr2,143033244,1.262179931809967,3176,2088,5264,+
chr2,143040431,0.9399034637505325,4616,3661,8277,+
chr2,143040632,1.6419967639479836,1095,901,1996,+
chr2,143040639,1.4648998340588248,1127,966,2093,+
chr2,143042063,1.1141874191436154,7705,5478,13183,+
chr2,151462265,2.757172131147541,689,487,1176,+
chr2,151462267,2.568434376457775,952,713,1665,+
chr2,151464133,1.6347638757489749,691,366,1057,+
chr2,151464149,1.883242383142847,1509,915,2424,+
chr2,151464150,0.9992966490196866,1124,632,1756,+
chr2,151464227,1.8201320880816445,1043,691,1734,+
chr2,152735011,2.1968162551950017,632,469,1101,+
chr2,152760280,2.4680625663679567,1462,1090,2552,+
chr2,152760504,3.277383530810719,649,520,1169,+
chr2,155269643,0.8525365435777166,575,449,1024,+
chr2,155269645,0.6814617302338755,712,553,1265,+
chr2,156583529,3.5210084033613436,837,517,1354,+
chr2,156583530,3.5210084033613436,837,517,1354,+
chr2,159004195,2.183541637394278,581,473,1054,+
chr2,159748429,0.8267619466884278,985,808,1793,+
chr2,159767355,2.4004776526906846,707,472,1179,+
chr2,161316451,0.5250085645769099,612,416,1028,+
chr2,161316459,2.385841836734694,644,489,1133,+
chr2,161316468,0.6179115509382828,835,496,1331,+
chr2,161367785,1.9025829324152321,899,735,1634,+
chr2,161367787,0.5510575852646493,604,481,1085,+
chr2,161371199,2.4498997995991982,814,498,1312,+
chr2,161385466,0.6388292981918481,757,501,1258,+
chr2,161385516,2.552941176470588,650,492,1142,+
chr2,161408850,2.3093434343434343,589,527,1116,+
chr2,161411556,2.1097903885480567,970,651,1621,+
chr2,164573754,1.079085350647874,834,646,1480,+
chr2,164573757,1.6666091085689618,756,564,1320,+
chr2,164573758,1.9783410138248847,635,559,1194,+
chr2,164573760,1.4896691595893017,903,685,1588,+
chr2,164573761,0.6559669749585552,3930,2919,6849,+
chr2,164573762,0.6559669749585552,3930,2919,6849,+
chr2,164573763,0.6559669749585552,3930,2919,6849,+
chr2,164573765,0.6048711502199875,1012,859,1871,+
chr2,164573770,0.6526423544465771,1243,1041,2284,+
chr2,164573779,1.8460329929300865,1409,1272,2681,+
chr2,168772577,1.9426313981449677,974,709,1683,+
chr2,168772578,1.6950507383635038,1158,819,1977,+
chr2,168772581,1.786314525810324,1053,832,1885,+
chr2,168772582,1.9735814922398711,2237,1764,4001,+
chr2,168772583,1.4670341268311782,1717,935,2652,+
chr2,168772584,1.6332033258562433,2616,1735,4351,+
chr2,169584407,5.720287836554911,846,1305,2151,+
chr2,169584409,4.207812386347769,877,1491,2368,+
chr2,169584446,0.31437908496732025,480,764,1244,+
chr2,169584448,0.31437908496732025,480,764,1244,+
chr2,169607130,1.1414891125765503,701,556,1257,+
chr2,169636545,2.860477930671479,567,456,1023,+
chr2,169636722,2.537796976241901,751,462,1213,+
chr2,169636727,1.7475728155339807,809,514,1323,+
chr2,169636989,2.2989716333413632,754,432,1186,+
chr2,169637031,2.4669738863287254,583,433,1016,+
chr2,169637221,4.073805515249801,683,477,1160,+
chr2,169751267,0.2573242418914156,576,454,1030,+
chr2,169798874,1.1462065256404739,2377,1862,4239,+
chr2,169801004,2.5228114478114483,730,659,1389,+
chr2,169805473,1.5736516357206014,808,584,1392,+
chr2,169806798,1.7569415448851775,1602,957,2559,+
chr2,169806801,1.9508506616257089,1719,1057,2776,+
chr2,169806802,1.6415816326530612,1169,783,1952,+
chr2,169806810,1.7936681669123187,3729,2493,6222,+
chr2,169807000,1.972051089406461,771,604,1375,+
chr2,169807047,1.4344517468004152,1913,1238,3151,+
chr2,169810870,1.915966386554622,607,475,1082,+
chr2,169810873,2.0160239722676847,1774,1270,3044,+
chr2,169811210,1.7966881971712798,3716,2781,6497,+
chr2,169811211,1.760786923775477,5002,3561,8563,+
chr2,169811215,2.6467920725562646,1235,915,2150,+
chr2,169811245,1.6032934131736525,764,667,1431,+
chr2,170751784,0.3894221656339936,751,648,1399,+
chr2,170751798,1.57882797731569,579,528,1107,+
chr2,170751802,1.6157616892911009,856,662,1518,+
chr2,170751804,0.6820512820512822,797,688,1485,+
chr2,170751964,1.8910913647755756,599,417,1016,+
chr2,170751965,1.3359124814848888,1351,936,2287,+
chr2,170751966,0.9086202324785612,1176,953,2129,+
chr2,170751967,1.0544897400309308,1453,1116,2569,+
chr2,170751971,1.2702083310013776,1650,1440,3090,+
chr2,170751972,0.7586324059831757,2970,2306,5276,+
chr2,170751973,0.8868363464480796,2637,1823,4460,+
chr2,170751974,2.456218274111676,710,590,1300,+
chr2,170751975,1.5412739035750054,1514,1462,2976,+
chr2,170751977,1.5412739035750054,1514,1462,2976,+
chr2,170751981,1.901920438957476,1033,890,1923,+
chr2,170751984,1.597971327531076,1278,890,2168,+
chr2,170751987,1.4736097067745195,1387,988,2375,+
chr2,170751989,1.0079232639117008,3047,2454,5501,+
chr2,170751990,1.0079232639117008,3047,2454,5501,+
chr2,170752212,1.627753718697044,584,422,1006,+
chr2,170752213,1.3315210355987055,833,617,1450,+
chr2,170752214,1.3315210355987055,833,617,1450,+
chr2,170752215,1.1023056208135,873,650,1523,+
chr2,170752258,0.58350497638952,1132,945,2077,+
chr2,170752263,1.337203288019258,1883,1461,3344,+
chr2,170752272,1.655598109517601,944,766,1710,+
chr2,170752281,3.474984247006931,810,528,1338,+
chr2,170752303,1.5369041154109508,1314,1032,2346,+
chr2,170752395,2.0018518518518515,657,377,1034,+
chr2,170752397,1.9846723044397463,750,472,1222,+
chr2,170752399,3.43980343980344,699,406,1105,+
chr2,170949721,0.5855582816183191,715,506,1221,+
chr2,170950214,0.5542350907519447,854,622,1476,+
chr2,170961695,1.7677419354838708,547,464,1011,+
chr2,170962904,2.034893395821213,680,481,1161,+
chr2,170965833,2.685206708421613,582,453,1035,+
chr2,170966437,6.82378272669221,833,639,1472,+
chr2,170966488,0.3929352146263911,718,543,1261,+
chr2,170966681,1.6247723132969036,668,426,1094,+
chr2,170966825,1.6915264995239607,614,410,1024,+
chr2,171554906,3.9639852613547597,628,533,1161,+
chr2,171687590,2.264396499432397,874,706,1580,+
chr2,171692826,0.5103272523499158,727,486,1213,+
chr2,171745840,0.3607373063440009,579,477,1056,+
chr2,171745841,0.3607373063440009,579,477,1056,+
chr2,171747938,1.919289222595381,857,541,1398,+
chr2,171946720,1.9356388211934679,1517,1137,2654,+
chr2,171946727,1.5961423444976075,914,607,1521,+
chr2,171965379,2.051006036217304,702,496,1198,+
chr2,171965429,1.4351833686675317,1280,865,2145,+
chr2,171966458,1.8172870662460567,757,633,1390,+
chr2,171976183,0.5788122443221894,891,694,1585,+
chr2,171979255,3.226857887874837,659,471,1130,+
chr2,171983184,0.5396355206388049,837,585,1422,+
chr2,171983312,1.587652591554933,1106,788,1894,+
chr2,173091029,6.063042256368284,674,495,1169,+
chr2,173221169,0.7081473214285715,657,511,1168,+
chr2,173221170,0.7081473214285715,657,511,1168,+
chr2,173221171,1.1835506412783723,973,791,1764,+
chr2,173223449,2.9087510103607057,675,448,1123,+
chr2,173224516,1.0305250305250304,632,377,1009,+
chr2,173224518,1.0305250305250304,632,377,1009,+
chr2,173225923,2.673286707998166,741,446,1187,+
chr2,173226201,13.643667372843382,1022,619,1641,+
chr2,173226202,19.520530242467654,1645,1025,2670,+
chr2,173367236,0.24582441113490366,737,466,1203,+
chr2,173367984,1.6090712742980562,595,462,1057,+
chr2,173368060,0.5802285146547442,583,426,1009,+
chr2,173368290,3.859090909090909,565,439,1004,+
chr2,173368775,0.9492550205139278,627,420,1047,+
chr2,173368776,0.9492550205139278,627,420,1047,+
chr2,173368810,3.157250249246196,701,558,1259,+
chr2,174720023,0.9547975923521774,808,686,1494,+
chr2,174720025,0.9547975923521774,808,686,1494,+
chr2,174720029,1.5985421166306697,763,462,1225,+
chr2,174720317,1.5425183647396998,1430,743,2173,+
chr2,174720318,1.5425183647396998,1430,743,2173,+
chr2,176337548,0.6037617554858934,962,579,1541,+
chr2,176337552,0.41110277569392345,1095,644,1739,+
chr2,176337553,1.9583540176834424,1801,1020,2821,+
chr2,176337555,1.4227269847360098,3124,1754,4878,+
chr2,176337557,1.6831647913402648,814,412,1226,+
chr2,176337561,1.9078871201157743,1121,690,1811,+
chr2,176337571,1.7013912935289892,3949,2362,6311,+
chr2,176337572,1.6644541084916455,2827,1798,4625,+
chr2,176337575,1.558991243711877,3571,1900,5471,+
chr2,176337578,0.6751672768589824,1336,711,2047,+
chr2,176337586,1.8177009347607238,8878,5640,14518,+
chr2,176337587,2.2909401489389567,6360,4761,11121,+
chr2,176337589,2.117140698609,6125,4337,10462,+
chr2,177219275,3.9845044697435004,624,560,1184,+
chr2,177219276,4.426638971667499,703,574,1277,+
chr2,177219277,3.8266875427138354,1127,965,2092,+
chr2,177219410,0.9435286935286936,842,701,1543,+
chr2,177219412,0.7417865653876056,1456,1257,2713,+
chr2,177219414,0.4094700026903417,760,707,1467,+
chr2,177219415,0.4094700026903417,760,707,1467,+
chr2,177219604,2.310682127025742,681,491,1172,+
chr2,177219983,3.915202258608781,663,411,1074,+
chr2,177482117,1.3327435442926323,638,460,1098,+
chr2,177521282,2.568002915451895,625,418,1043,+
chr2,181057731,2.888311911966794,924,670,1594,+
chr2,181057732,2.330065359477124,643,503,1146,+
chr2,181063056,3.720819506362404,619,419,1038,+
chr2,181063235,2.733962264150944,643,529,1172,+
chr2,181694640,0.2648139522848419,730,338,1068,+
chr2,181694642,0.2648139522848419,730,338,1068,+
chr2,181694660,1.2164632233561186,784,651,1435,+
chr2,181694670,2.0260939381774388,1441,751,2192,+
chr2,181694672,1.657883682743346,2284,1217,3501,+
chr2,181694674,1.346511561973451,3643,2357,6000,+
chr2,181694677,1.5973381730187537,942,550,1492,+
chr2,181694680,1.5628453594651486,3860,2403,6263,+
chr2,181694681,1.8260506148931597,3085,1917,5002,+
chr2,181694682,1.7641935380575746,4237,2671,6908,+
chr2,181694684,1.2514836773341604,6243,4329,10572,+
chr2,181694685,0.9985639575718804,4039,2902,6941,+
chr2,181694703,1.3866376825819435,3538,2239,5777,+
chr2,181694707,1.9689658152040248,6149,4652,10801,+
chr2,181694708,1.9689658152040248,6149,4652,10801,+
chr2,181694709,1.9689658152040248,6149,4652,10801,+
chr2,181892235,2.478991113277559,1286,920,2206,+
chr2,181898891,2.494960636479032,1235,1004,2239,+
chr2,181898892,2.8910818713450293,564,455,1019,+
chr2,181900752,1.8423645320197048,679,405,1084,+
chr2,181901777,2.0392452107659738,800,543,1343,+
chr2,181913896,2.3452143264271763,796,640,1436,+
chr2,181915498,0.47737699731055205,709,515,1224,+
chr2,181916024,1.4463273505624945,596,468,1064,+
chr2,181916305,2.159667661109969,770,582,1352,+
chr2,181928160,2.4289153299288815,780,579,1359,+
chr2,181928194,1.6432628947966372,677,488,1165,+
chr2,181929625,1.7851662404092072,697,373,1070,+
chr2,181929819,1.7196969696969695,680,431,1111,+
chr2,181929838,2.8184900945921827,657,430,1087,+
chr2,181929927,2.9090461522801103,861,680,1541,+
chr2,181930351,1.830699774266365,810,442,1252,+
chr2,182728628,2.309037679213688,602,436,1038,+
chr2,182728955,1.092585861043553,957,837,1794,+
chr2,182728959,1.630668647845468,721,672,1393,+
chr2,182728974,0.6310132748751675,828,713,1541,+
chr2,182728975,1.7140944091061263,511,617,1128,+
chr2,182743644,2.077310966919577,715,510,1225,+
chr2,182759161,1.7101526343716267,666,495,1161,+
chr2,182759170,2.2561024163492083,721,569,1290,+
chr2,182777819,1.4806655010565293,605,404,1009,+
chr2,183130455,4.558633570685296,690,379,1069,+
chr2,183130489,4.151447946994832,823,564,1387,+
chr2,183130490,4.654184620966627,649,422,1071,+
chr2,183161111,2.9475881510342417,591,420,1011,+
chr2,186502542,0.5896579523206266,639,456,1095,+
chr2,186502565,0.4723083739477182,655,487,1142,+
chr2,186504067,1.1708915951454595,1263,822,2085,+
chr2,186504102,1.7188531547675188,728,460,1188,+
chr2,186504105,1.6578978026722893,1663,1308,2971,+
chr2,186504113,1.8836161441856,613,548,1161,+
chr2,186505478,2.5735894357743097,793,489,1282,+
chr2,186505760,0.5084421790379101,683,437,1120,+
chr2,186506783,1.762334536702768,908,553,1461,+
chr2,186508552,6.461958997722096,590,438,1028,+
chr2,186508708,2.3846830985915486,601,425,1026,+
chr2,186508726,3.4493392070484576,637,453,1090,+
chr2,186508864,1.1936350144878942,2152,1541,3693,+
chr2,186508865,0.9982110912343469,1529,1104,2633,+
chr2,186508876,1.6042047531992691,701,546,1247,+
chr2,186508965,2.215232586165341,706,460,1166,+
chr2,186509013,1.6436101245842494,787,656,1443,+
chr2,186646863,2.2153411018575615,1331,678,2009,+
chr2,186664537,3.3225533213138077,582,434,1016,+
chr2,186677227,5.935080903008237,569,435,1004,+
chr2,186677228,5.935080903008237,569,435,1004,+
chr2,186677824,1.1085257857266886,607,442,1049,+
chr2,186677825,1.1085257857266886,607,442,1049,+
chr2,186680598,2.0350340136054417,578,440,1018,+
chr2,189441543,3.714372178157414,620,423,1043,+
chr2,189463873,2.013575571884779,739,585,1324,+
chr2,189465118,3.3033943099254124,720,589,1309,+
chr2,189466485,2.7814450429336763,610,407,1017,+
chr2,189923280,0.4202211143823524,594,447,1041,+
chr2,189923504,1.2260740177340386,1224,906,2130,+
chr2,189923505,1.7479527579381435,996,693,1689,+
chr2,189923506,0.4777777777777778,687,539,1226,+
chr2,189923507,1.0810951525810444,1163,824,1987,+
chr2,189923509,0.5101421488322908,1770,1243,3013,+
chr2,189923511,0.7770082142131934,1958,1364,3322,+
chr2,189923512,1.1986696230598668,900,614,1514,+
chr2,189923514,1.9824897034243594,700,534,1234,+
chr2,189923518,0.609898684634249,848,552,1400,+
chr2,189923529,2.2834541062801934,1021,689,1710,+
chr2,189923534,0.5719788155994222,1187,805,1992,+
chr2,189923551,0.5214484478334719,1841,1238,3079,+
chr2,189923554,1.3425293117064578,1860,1415,3275,+
chr2,189923555,1.3379059350503921,1592,1221,2813,+
chr2,189923635,1.1480292854227434,3434,2254,5688,+
chr2,189923673,1.6341147902741684,3450,2283,5733,+
chr2,189923674,0.2825571469221285,992,810,1802,+
chr2,189923675,1.4517246841709242,2665,1771,4436,+
chr2,189923681,1.767964214333302,2063,1500,3563,+
chr2,189923682,1.767964214333302,2063,1500,3563,+
chr2,189923687,0.6594038609008769,1757,1347,3104,+
chr2,189923851,1.1533711405166982,703,528,1231,+
chr2,189923853,1.1887057933715517,1551,1051,2602,+
chr2,189923854,1.2204322395162088,848,523,1371,+
chr2,189923925,3.513450783119347,644,489,1133,+
chr2,189923927,3.1007659777634378,1155,944,2099,+
chr2,189923928,1.831409349756348,1078,912,1990,+
chr2,189923958,0.5209742859006308,1312,1073,2385,+
chr2,189923959,0.507306867404012,1321,1105,2426,+
chr2,189923960,0.5175770291039495,1767,1431,3198,+
chr2,189923961,0.5475930963662241,1500,1180,2680,+
chr2,189923962,0.6340606424851055,1870,1370,3240,+
chr2,189924123,1.9254271659034237,693,963,1656,+
chr2,189924125,0.6636350390012137,715,1162,1877,+
chr2,189924126,0.3460579114307461,939,1496,2435,+
chr2,190683814,0.36762588626701925,643,376,1019,+
chr2,190685524,1.7814274128142742,763,410,1173,+
chr2,190921159,3.066511147626653,927,856,1783,+
chr2,190921160,2.7775327698150187,860,906,1766,+
chr2,190921162,2.305033175550169,914,875,1789,+
chr2,191276928,0.6918065877603449,753,518,1271,+
chr2,191276929,0.6918065877603449,753,518,1271,+
chr2,191276930,0.6918065877603449,753,518,1271,+
chr2,191296145,3.974816000247813,702,480,1182,+
chr2,191296185,3.404255319148936,549,469,1018,+
chr2,191390306,1.0559902398097225,1184,712,1896,+
chr2,191390309,1.1944484853937187,1071,583,1654,+
chr2,191390311,0.6402508915888415,1389,763,2152,+
chr2,191390329,2.786336805842144,1196,645,1841,+
chr2,191392127,0.3825347758887172,923,646,1569,+
chr2,191392138,0.5938107308223367,4178,2742,6920,+
chr2,191392139,0.7558546629948742,4820,3149,7969,+
chr2,191392140,0.5938107308223367,4178,2742,6920,+
chr2,191392156,1.6698473282442747,1124,654,1778,+
chr2,191392168,1.8221741221741217,880,629,1509,+
chr2,191392171,2.6551226551226548,919,692,1611,+
chr2,191408168,3.060750570184533,670,370,1040,+
chr2,191409052,2.1996041951317875,1074,830,1904,+
chr2,191411084,1.7249237546594374,616,453,1069,+
chr2,191414102,1.859934573002755,744,483,1227,+
chr2,191414586,0.3881989859651701,586,438,1024,+
chr2,191416169,1.2339950273227693,966,682,1648,+
chr2,191423943,1.8840869681205816,564,440,1004,+
chr2,191424321,1.306803554436596,1141,802,1943,+
chr2,191424439,1.4435332779413474,750,557,1307,+
chr2,191424562,1.553640349896804,783,680,1463,+
chr2,191424767,2.3430962343096238,639,477,1116,+
chr2,191678666,2.4134790528233148,799,487,1286,+
chr2,191678667,2.4134790528233148,799,487,1286,+
chr2,191678668,2.4134790528233148,799,487,1286,+
chr2,191678671,1.475418811273893,1558,931,2489,+
chr2,191678673,1.242033898305085,686,449,1135,+
chr2,191679034,2.253968253968254,1419,923,2342,+
chr2,191679035,2.119316496715657,2246,1391,3637,+
chr2,191679041,1.2712800373092363,1368,840,2208,+
chr2,195680122,2.24009900990099,904,605,1509,+
chr2,195680124,2.24009900990099,904,605,1509,+
chr2,195680883,2.3372701181522726,676,531,1207,+
chr2,195683756,0.5082191780821917,741,510,1251,+
chr2,195713450,2.0383000512032767,621,464,1085,+
chr2,195713502,1.5591731266149869,861,644,1505,+
chr2,195718289,2.278261196200108,878,584,1462,+
chr2,195734963,3.1684178192122503,745,472,1217,+
chr2,195735841,3.4928857687891535,621,474,1095,+
chr2,195735860,0.6637931034482759,531,550,1081,+
chr2,195736278,1.6201285279416735,957,648,1605,+
chr2,195737302,3.993139313136201,785,590,1375,+
chr2,195737481,0.2918953826283501,677,488,1165,+
chr2,197500345,0.8433165195460278,534,545,1079,+
chr2,197500346,0.8433165195460278,534,545,1079,+
chr2,197500347,0.8433165195460278,534,545,1079,+
chr2,197500348,1.0365853658536586,594,491,1085,+
chr2,197500349,1.0282296974349479,1444,1322,2766,+
chr2,197500350,1.0228365384615383,850,831,1681,+
chr2,197500352,0.45483993902439024,867,655,1522,+
chr2,197500354,0.45483993902439024,867,655,1522,+
chr2,197500357,0.4369971275157412,1436,1032,2468,+
chr2,197500359,1.1430156646296807,1330,1047,2377,+
chr2,197500378,0.6459323303011937,4040,2673,6713,+
chr2,197500380,0.6536816334286527,5468,3712,9180,+
chr2,197500385,1.5931377162108749,3077,1585,4662,+
chr2,197500386,1.5931377162108749,3077,1585,4662,+
chr2,197500395,1.9340656676772265,1811,1360,3171,+
chr2,197500400,2.36128734824702,1886,1110,2996,+
chr2,197500403,1.2756596912166274,1438,1197,2635,+
chr2,197500408,0.9157132875919547,6680,4180,10860,+
chr2,197500410,1.0736765563539832,6085,3682,9767,+
chr2,197500413,1.3871988439594392,2715,1573,4288,+
chr2,197501075,1.5515005827505828,1120,857,1977,+
chr2,197501107,1.481739800925277,1261,1018,2279,+
chr2,197501114,0.7618860482210045,2754,1685,4439,+
chr2,197501115,1.3767584505633708,2477,1697,4174,+
chr2,197501123,1.3781831257559412,2634,1853,4487,+
chr2,197503108,1.4659246988655719,4426,2877,7303,+
chr2,197503112,1.6934901475291446,2344,1435,3779,+
chr2,197503274,1.3585600561914355,8303,6181,14484,+
chr2,199963822,3.092630614995447,762,527,1289,+
chr2,200571444,3.030702040284205,860,528,1388,+
chr2,200571446,3.030702040284205,860,528,1388,+
chr2,200571509,1.678200692041523,775,475,1250,+
chr2,200571512,1.8696099884154973,580,456,1036,+
chr2,200572347,5.365117496813603,712,387,1099,+
chr2,200572379,0.34294871794871795,855,431,1286,+
chr2,200572381,0.34294871794871795,855,431,1286,+
chr2,200572419,2.1893017558187013,1116,789,1905,+
chr2,200572420,2.1893017558187013,1116,789,1905,+
chr2,200572431,1.639326864766525,982,581,1563,+
chr2,200572441,2.0603988603988608,903,674,1577,+
chr2,200572444,1.6637630662020906,954,737,1691,+
chr2,200811691,4.027325315760501,618,425,1043,+
chr2,200811909,0.8062094107213544,4787,2164,6951,+
chr2,200811915,1.9751537421208551,2666,1175,3841,+
chr2,200811921,1.7980093208467716,9867,5224,15091,+
chr2,200811922,1.6075714351320012,18772,9916,28688,+
chr2,200811923,1.5704466403817758,7281,3902,11183,+
chr2,200811924,1.5971410087449842,20504,11157,31661,+
chr2,200811925,1.5502953136279358,12731,7238,19969,+
chr2,200811927,1.7037891417893531,3843,2372,6215,+
chr2,200811938,0.7646355491837186,3231,1618,4849,+
chr2,200811955,1.2851627013777054,18397,12024,30421,+
chr2,200811956,1.2346260682235324,8724,5678,14402,+
chr2,200813227,1.7221884571641766,4640,3638,8278,+
chr2,200815679,1.7539720448023695,6151,4154,10305,+
chr2,200815692,1.3402274954930378,14165,9278,23443,+
chr2,200815730,1.3472609857482185,4220,3367,7587,+
chr2,200815736,0.906586979336444,16535,11310,27845,+
chr2,200816330,2.014175394054797,5439,3311,8750,+
chr2,200816334,1.384382010468967,6011,3794,9805,+
chr2,200822804,2.854879554231918,853,480,1333,+
chr2,200822808,1.6916064050429058,732,435,1167,+
chr2,200822815,1.2212369513974632,1019,452,1471,+
chr2,200822817,1.2212369513974632,1019,452,1471,+
chr2,200822830,0.33177831685015857,888,465,1353,+
chr2,200822852,1.4534534534534531,1693,944,2637,+
chr2,200822859,1.4571900144419228,2017,1178,3195,+
chr2,200822879,1.5996501690781597,11216,7032,18248,+
chr2,200822880,1.5815926233774302,9670,5596,15266,+
chr2,200822882,1.413750651072494,10219,6033,16252,+
chr2,200822883,1.4071491018915914,7034,4193,11227,+
chr2,200822895,1.2512026813880126,7465,5071,12536,+
chr2,200823148,0.7446187709554402,618,438,1056,+
chr2,200823165,1.7524271844660195,1804,1029,2833,+
chr2,200823167,1.7524271844660195,1804,1029,2833,+
chr2,200823187,1.6851654215581644,1578,936,2514,+
chr2,200823191,1.5971905179982442,1515,1004,2519,+
chr2,200823217,1.5936238902340596,3589,2300,5889,+
chr2,200823224,1.403919923803532,2947,2061,5008,+
chr2,200823506,1.2535799855653524,1841,1181,3022,+
chr2,200823512,1.1342532496404618,2036,1384,3420,+
chr2,200823526,0.4699176087373061,980,613,1593,+
chr2,200823530,1.7932692307692306,1118,703,1821,+
chr2,200823534,1.5060386473429952,1246,809,2055,+
chr2,200823536,1.5919600283452842,2704,1913,4617,+
chr2,200823537,1.3928200399763806,3445,1966,5411,+
chr2,200823538,1.3928200399763806,3445,1966,5411,+
chr2,200823548,1.6149116064565718,2100,1300,3400,+
chr2,200823566,1.7646986634523583,5950,4109,10059,+
chr2,200823578,0.8717257499941269,8730,6080,14810,+
chr2,200893262,0.2520503393665159,774,519,1293,+
chr2,200893263,0.3867157518977827,2253,1489,3742,+
chr2,200893264,0.5607815143064442,1451,958,2409,+
chr2,200893266,3.2372654155495977,629,372,1001,+
chr2,200893315,0.4215035931453842,609,401,1010,+
chr2,200897093,1.9797906892818478,632,488,1120,+
chr2,200897126,1.8493150684931507,664,510,1174,+
chr2,200903539,0.5543073485600795,686,423,1109,+
chr2,201072046,1.3706475756589651,701,438,1139,+
chr2,201078883,2.1988510007412896,790,567,1357,+
chr2,201078889,0.7070920062719683,2513,2112,4625,+
chr2,201078890,0.7070920062719683,2513,2112,4625,+
chr2,201078904,1.5796133567662567,1497,1137,2634,+
chr2,201078914,1.2783306948333981,4120,3389,7509,+
chr2,201078995,1.6320874650394097,1047,873,1920,+
chr2,201085471,1.4770013701311409,1371,785,2156,+
chr2,201085589,1.548209366391185,1123,846,1969,+
chr2,201085601,2.897427101200686,1235,794,2029,+
chr2,202265770,0.7374367402073738,1124,561,1685,+
chr2,202265882,2.18444266157368,1165,623,1788,+
chr2,202265883,2.18444266157368,1165,623,1788,+
chr2,202275117,2.5144230769230766,522,479,1001,+
chr2,202275121,1.9514018691588781,579,534,1113,+
chr2,202282410,0.5467778509253164,574,440,1014,+
chr2,202284352,2.372899524876734,1482,1009,2491,+
chr2,202284358,1.8870579991646832,1195,901,2096,+
chr2,202284411,1.8158445788738948,725,613,1338,+
chr2,202284444,3.1478957915831662,560,498,1058,+
chr2,202284447,2.4671384415161866,618,682,1300,+
chr2,202287690,1.95,740,531,1271,+
chr2,202292792,0.39943306274964574,619,397,1016,+
chr2,202292823,1.769964146023468,748,471,1219,+
chr2,202292869,2.2162673392181587,702,609,1311,+
chr2,202295684,1.6833000665335993,758,500,1258,+
chr2,202295753,1.3373748366735325,1054,772,1826,+
chr2,202295759,1.8530318602261049,600,555,1155,+
chr2,202297846,0.4806143628061436,826,656,1482,+
chr2,202297847,0.4806143628061436,826,656,1482,+
chr2,202300235,2.0337528604119,710,436,1146,+
chr2,203190691,0.60548142835021,817,422,1239,+
chr2,203190782,1.7785463978519094,976,510,1486,+
chr2,203190784,1.9974521483178527,2112,1224,3336,+
chr2,203190785,2.1732867132867133,1136,714,1850,+
chr2,203190787,0.9986330530890107,2020,1107,3127,+
chr2,203190788,1.167367348608715,2850,1478,4328,+
chr2,203190792,1.8835714219405695,1738,1049,2787,+
chr2,203190797,1.0487212924726508,2226,1031,3257,+
chr2,203190798,1.3062645370348334,3264,1560,4824,+
chr2,203190907,1.7227861637940336,3785,2145,5930,+
chr2,203191146,1.1146788990825691,728,544,1272,+
chr2,203191147,1.139637429249167,1870,1279,3149,+
chr2,203191148,0.9546757842006687,4251,2829,7080,+
chr2,203191149,1.054767251661028,2824,2240,5064,+
chr2,203191150,0.6208201008780123,1054,529,1583,+
chr2,203191151,1.1548895252137816,4472,3058,7530,+
chr2,203191152,1.021285871626996,2840,1661,4501,+
chr2,203191153,1.2553458176439538,4816,3127,7943,+
chr2,203191198,1.7476947486338559,5953,3568,9521,+
chr2,203191199,1.6221643061710973,8899,5786,14685,+
chr2,203191201,1.2613806505530611,9916,6548,16464,+
chr2,203191202,1.1059096275856133,6046,3806,9852,+
chr2,203191203,1.029376833281068,7307,4975,12282,+
chr2,203191206,2.10379711751663,1597,1055,2652,+
chr2,203191207,1.3742341180264428,2840,2214,5054,+
chr2,203191222,1.5689294861805378,3244,2138,5382,+
chr2,203191227,1.6999358033749083,4520,3479,7999,+
chr2,203191229,1.719536655523595,6911,5415,12326,+
chr2,203191230,1.3784078498636165,10947,8331,19278,+
chr2,206159892,1.3985786802030458,1007,590,1597,+
chr2,206159894,0.8452876104421915,7551,4212,11763,+
chr2,206159895,0.8430113234461678,7157,3998,11155,+
chr2,206159896,0.8107161487443176,1977,1135,3112,+
chr2,206159902,1.805129927375005,1074,580,1654,+
chr2,206159905,1.7885639986523671,3144,1824,4968,+
chr2,206159924,1.1509415225503485,16055,9600,25655,+
chr2,206159925,1.053891496780561,18732,12452,31184,+
chr2,206159926,0.9628345893589828,15456,10380,25836,+
chr2,206159995,1.410503594527986,18476,11598,30074,+
chr2,206159996,1.415656710135054,15047,9039,24086,+
chr2,206160589,1.8041811846689892,5177,2869,8046,+
chr2,206160590,1.8041811846689892,5177,2869,8046,+
chr2,206160599,1.4356976782919342,4869,2927,7796,+
chr2,206160614,0.9592301632436586,7990,4857,12847,+
chr2,206160615,0.9592301632436586,7990,4857,12847,+
chr2,206160616,0.7742867873997745,3160,2636,5796,+
chr2,206160674,1.2918079298701959,3302,2650,5952,+
chr2,206161356,1.4714265704881295,6002,4359,10361,+
chr2,206161358,1.3571602249889543,20652,13496,34148,+
chr2,206161359,1.3361298439323304,17724,11390,29114,+
chr2,206161374,0.8376971765349043,6811,4788,11599,+
chr2,206162051,0.4972368478308168,878,468,1346,+
chr2,206162065,1.7899955580497993,3288,1671,4959,+
chr2,206162066,1.7899955580497993,3288,1671,4959,+
chr2,206162084,3.9185419378835773,1289,848,2137,+
chr2,206162090,1.1095492813305519,4616,2498,7114,+
chr2,206162091,1.2100476028561713,2339,1037,3376,+
chr2,206162092,1.2511926097330792,4737,3024,7761,+
chr2,206162489,1.6768442166258082,1367,640,2007,+
chr2,206162497,1.5392727272727271,1742,874,2616,+
chr2,206162515,1.44907129070025,4514,2617,7131,+
chr2,206162516,1.3655714499352822,7108,4147,11255,+
chr2,206162518,1.389964204447484,9270,5483,14753,+
chr2,206162519,1.331462567884873,5311,3164,8475,+
chr2,206162521,1.6389748121961998,3708,2262,5970,+
chr2,206162522,1.4654992071504338,6676,4535,11211,+
chr2,206162528,1.3092644455813702,5737,4209,9946,+
chr2,206162549,1.238188720009087,9245,6231,15476,+
chr2,206162780,3.0141492123469216,2463,1710,4173,+
chr2,206162783,2.2698809253431103,1589,832,2421,+
chr2,206162790,1.642300818207159,2706,2102,4808,+
chr2,206162804,1.3146520146520149,2036,979,3015,+
chr2,206790600,2.6323558522890873,696,512,1208,+
chr2,210556601,2.8010786363705,855,544,1399,+
chr2,210556617,2.279326567507601,2196,1131,3327,+
chr2,210556618,2.0339921545389092,4581,2487,7068,+
chr2,210556619,2.0608612886401527,6312,3695,10007,+
chr2,210556620,1.4299591100779323,6113,3470,9583,+
chr2,210556621,1.4165432217340028,2957,1804,4761,+
chr2,210556622,1.083707341840595,5237,3215,8452,+
chr2,210556623,0.82937181663837,1953,1115,3068,+
chr2,210576374,1.7888225718936517,633,484,1117,+
chr2,210579748,1.7274305555555558,596,479,1075,+
chr2,210579756,1.8903487892348216,1777,1166,2943,+
chr2,210590206,1.5761940287860003,3998,2799,6797,+
chr2,210591853,3.2565232124703485,619,453,1072,+
chr2,210591858,1.4643862671765349,1451,897,2348,+
chr2,210591861,1.667732651103294,1489,943,2432,+
chr2,210592943,1.6457188626351622,1656,1134,2790,+
chr2,210594538,1.032652676713843,1681,1270,2951,+
chr2,210595500,1.4694140784867895,2181,1612,3793,+
chr2,210595506,2.6717791411042944,870,651,1521,+
chr2,210599522,2.1527118644067795,976,707,1683,+
chr2,210600561,1.8240583066548601,1316,830,2146,+
chr2,210600569,1.4423151605675877,1582,1029,2611,+
chr2,210606737,2.0067721518987343,812,631,1443,+
chr2,210608385,1.6714881504038126,1628,1078,2706,+
chr2,210608386,1.4788037166085948,925,839,1764,+
chr2,210608501,0.6995442756833788,2903,2121,5024,+
chr2,210608535,2.2080208333333333,1033,767,1800,+
chr2,210612153,0.6939481268011527,3267,2081,5348,+
chr2,210612182,1.283442053053582,11080,6584,17664,+
chr2,210612183,1.6072634698756696,6775,4133,10908,+
chr2,210612184,1.6072634698756696,6775,4133,10908,+
chr2,210612187,1.823416268536328,2448,1588,4036,+
chr2,210612279,1.3251552816490315,10759,7543,18302,+
chr2,210637715,1.4910439034761345,1144,817,1961,+
chr2,210637813,1.1889678245026385,4123,2837,6960,+
chr2,210637815,1.9084141664786824,1079,857,1936,+
chr2,210642499,2.0705088902513795,613,465,1078,+
chr2,210642518,1.5152877697841731,1010,833,1843,+
chr2,210642537,1.9447181171319101,626,521,1147,+
chr2,210642562,0.7056653191368216,1290,964,2254,+
chr2,210647874,1.4895912759498768,2671,1561,4232,+
chr2,210647897,1.807679003804912,1871,1175,3046,+
chr2,210647903,1.4180924017398802,3582,1962,5544,+
chr2,210647980,1.7426621160409554,998,878,1876,+
chr2,210647995,0.5571750987398909,947,817,1764,+
chr2,210648484,1.7256833292292542,1751,1178,2929,+
chr2,210648486,2.366183574879227,631,551,1182,+
chr2,210648489,2.2179533213644524,638,556,1194,+
chr2,210654041,2.6718127490039842,554,501,1055,+
chr2,210654043,1.5224538213862056,1122,842,1964,+
chr2,210654068,1.8740589274096104,1033,741,1774,+
chr2,210654071,1.4826254826254828,1907,1112,3019,+
chr2,210654072,1.1323778242261373,1467,1181,2648,+
chr2,210654073,1.3733416384977193,2789,2193,4982,+
chr2,210656533,2.028513238289205,663,490,1153,+
chr2,210656555,1.5353909465020574,1065,809,1874,+
chr2,210663177,1.447735082786629,1597,1066,2663,+
chr2,210675760,0.53125,818,623,1441,+
chr2,210675766,2.3689407540394973,727,556,1283,+
chr2,210675802,0.6106110201854883,813,623,1436,+
chr2,210677015,1.7393753200204813,710,566,1276,+
chr2,210677922,1.7349138753321414,2964,2095,5059,+
chr2,210677971,2.7133333333333334,776,629,1405,+
chr2,210678009,1.349764786297294,2237,1462,3699,+
chr2,210678243,2.357243037467441,904,712,1616,+
chr2,210678505,2.5199142156862746,704,575,1279,+
chr2,210678685,0.4299468791500664,924,752,1676,+
chr2,210678686,1.9308600770218227,1418,1024,2442,+
chr2,210679004,1.8711426188490412,640,544,1184,+
chr2,214847400,3.934675918091049,749,310,1059,+
chr2,214847401,3.934675918091049,749,310,1059,+
chr2,214847402,3.934675918091049,749,310,1059,+
chr2,214847434,2.7307307307307305,743,332,1075,+
chr2,214847436,2.7307307307307305,743,332,1075,+
chr2,215312532,0.3671834625322997,811,515,1326,+
chr2,215312533,0.3671834625322997,811,515,1326,+
chr2,215312541,1.812899263757008,1266,903,2169,+
chr2,215312542,1.8013256584685156,897,636,1533,+
chr2,215318203,2.3378014993481098,1170,766,1936,+
chr2,215318204,2.3378014993481098,1170,766,1936,+
chr2,215319689,0.542179802955665,586,463,1049,+
chr2,215319690,2.2323587311803053,1225,838,2063,+
chr2,215333414,0.5119549929676511,545,473,1018,+
chr2,215334973,2.2524444854818917,1085,821,1906,+
chr2,215346887,0.5627206401506236,796,606,1402,+
chr2,215346892,0.5958581607566982,974,698,1672,+
chr2,215346896,0.5416754362907789,2766,1872,4638,+
chr2,216109389,0.5978248421863875,653,516,1169,+
chr2,216109401,0.6886356509452147,742,561,1303,+
chr2,216113023,2.0420757363253856,727,464,1191,+
chr2,216113053,1.6397396860548177,1518,1197,2715,+
chr2,216113054,0.8290415015716804,1314,1142,2456,+
chr2,216116746,1.6378703703703703,2526,1619,4145,+
chr2,216116748,1.6378703703703703,2526,1619,4145,+
chr2,216116756,1.7862392703862662,1358,931,2289,+
chr2,216116761,1.7906803355079217,738,554,1292,+
chr2,216116771,1.1175522100541189,2533,1915,4448,+
chr2,216117755,1.5773699646137802,1712,1600,3312,+
chr2,216119047,1.9819246435845213,518,490,1008,+
chr2,216127553,1.0015082755120557,2062,1452,3514,+
chr2,216130883,1.5722987035304454,2166,1261,3427,+
chr2,216130887,1.7503239956135976,2340,1432,3772,+
chr2,216130936,1.4522012228547336,3103,1968,5071,+
chr2,216137166,1.794442468042811,2567,1878,4445,+
chr2,216137167,2.7741018105981614,1487,958,2445,+
chr2,216138108,0.4610474890614627,2782,1736,4518,+
chr2,216138142,1.8938109912686183,2106,1297,3403,+
chr2,216138149,1.7023959646910467,3724,2378,6102,+
chr2,216138150,0.8278519706458725,9882,7261,17143,+
chr2,216138151,1.0574268233739281,13606,9639,23245,+
chr2,216138152,0.8278519706458725,9882,7261,17143,+
chr2,216138157,0.7503875968992249,4113,2923,7036,+
chr2,216141190,1.9356995884773658,5608,4265,9873,+
chr2,216141191,1.9924244047287485,8610,6715,15325,+
chr2,216141193,2.0602597411704484,8970,7312,16282,+
chr2,216141194,2.116954022988505,6115,5103,11218,+
chr2,216141203,1.3980797086935128,9679,7993,17672,+
chr2,216148152,2.0104331625523986,653,564,1217,+
chr2,216148221,0.6269086965208208,954,686,1640,+
chr2,216148236,0.5391691151012281,2393,1763,4156,+
chr2,216160090,0.6440567518734635,905,636,1541,+
chr2,216162026,1.6318880351262348,2331,1821,4152,+
chr2,216162027,1.6318880351262348,2331,1821,4152,+
chr2,216190239,0.6698907230876538,1028,781,1809,+
chr2,216204370,2.4978991596638656,614,475,1089,+
chr2,216205819,5.3944873669377476,648,492,1140,+
chr2,216498842,1.0823616004400096,6257,5160,11417,+
chr2,216498843,1.0113764086424057,8186,6249,14435,+
chr2,216498847,1.011253923392107,5009,4352,9361,+
chr2,216498848,1.4913814811490196,8047,5688,13735,+
chr2,216498849,1.2203063294704821,8828,7103,15931,+
chr2,216498850,1.5727252855409872,9117,5833,14950,+
chr2,216498855,0.7008690450774958,6190,5530,11720,+
chr2,216498857,0.9754952039251604,6980,5880,12860,+
chr2,216499274,1.3186863543788188,4364,2945,7309,+
chr2,216499281,1.010799958165308,9025,6823,15848,+
chr2,216499282,1.2138961556578136,6003,3574,9577,+
chr2,216499285,1.5218849572362905,6449,3826,10275,+
chr2,216499299,0.9897039132344608,15044,8780,23824,+
chr2,216499300,0.8301758948043028,10768,8032,18800,+
chr2,216499301,0.8885294963313402,31699,21327,53026,+
chr2,216499318,1.414905587470338,14594,11528,26122,+
chr2,216499336,1.3723405950064045,22222,15570,37792,+
chr2,216499348,1.1901004595545408,25853,18421,44274,+
chr2,216501362,1.3564825494550719,20235,14230,34465,+
chr2,218225921,1.9341862224446253,1185,913,2098,+
chr2,218238691,1.9207153683324587,988,754,1742,+
chr2,218238747,0.4680415012168566,608,421,1029,+
chr2,218239403,1.8160319410319408,656,443,1099,+
chr2,218245524,3.3438401279117236,766,459,1225,+
chr2,218249414,5.236349173066063,747,560,1307,+
chr2,218249898,1.0315945716709076,694,523,1217,+
chr2,218249899,1.0315945716709076,694,523,1217,+
chr2,218253986,2.230714285714285,693,559,1252,+
chr2,218253987,1.482799845435097,1252,971,2223,+
chr2,218254154,3.2880294083553574,601,439,1040,+
chr2,218595850,2.1827705545755456,2030,1707,3737,+
chr2,218595851,2.182770554575545,2030,1707,3737,+
chr2,219232342,3.30779619398404,708,542,1250,+
chr2,219232344,2.732594104112102,938,805,1743,+
chr2,221961953,0.8359642243382353,945,823,1768,+
chr2,221961958,0.4901601830663616,458,574,1032,+
chr2,221961959,1.5855574935177534,771,839,1610,+
chr2,221962251,0.7565724368695992,614,618,1232,+
chr2,221962255,0.41738820118466624,834,785,1619,+
chr2,221962257,0.4418928833455613,633,579,1212,+
chr2,221962670,1.8522943155493892,850,669,1519,+
chr2,221962673,0.6305313307493541,678,515,1193,+
chr2,221962679,1.590568789499271,797,604,1401,+
chr2,221963234,2.082032967032968,742,699,1441,+
chr2,221963236,1.357176589270215,1525,1240,2765,+
chr2,222916433,1.9395445272659861,1005,721,1726,+
chr2,222916467,1.5605773961741474,892,605,1497,+
chr2,222921291,2.474378439931676,744,478,1222,+
chr2,222921293,2.474378439931676,744,478,1222,+
chr2,222921366,3.2611941863925042,738,515,1253,+
chr2,222921383,0.9997736276174309,802,569,1371,+
chr2,222921384,0.9997736276174309,802,569,1371,+
chr2,222922718,5.849959868216778,851,674,1525,+
chr2,222922753,0.2409774436090225,640,398,1038,+
chr2,222923127,1.1369164969044179,1065,692,1757,+
chr2,222924455,1.1630864409692387,845,528,1373,+
chr2,222924456,1.1630864409692387,845,528,1373,+
chr2,227328679,2.007256308991265,1302,950,2252,+
chr2,227328702,0.9208855017238249,724,500,1224,+
chr2,227328704,0.9208855017238249,724,500,1224,+
chr2,227328732,1.8811246796321424,712,602,1314,+
chr2,227330740,2.020618556701031,685,484,1169,+
chr2,227330747,1.9821557752592232,821,637,1458,+
chr2,227332458,1.5567368032484312,810,644,1454,+
chr2,227332482,1.53874213836478,940,794,1734,+
chr2,227340311,1.7330012453300123,993,802,1795,+
chr2,227347268,3.9213320177325,706,551,1257,+
chr2,227356986,2.0466106451032897,1490,1138,2628,+
chr2,227356995,1.4742617346638043,1894,1496,3390,+
chr2,227356996,1.6045112781954889,1066,664,1730,+
chr2,227554694,1.0214424951267056,785,647,1432,+
chr2,227554696,0.8335224668282147,1464,1097,2561,+
chr2,227554784,2.0462962962962963,805,557,1362,+
chr2,231062634,1.3381558499424433,2072,1001,3073,+
chr2,231062651,1.866374078363169,1687,927,2614,+
chr2,231066920,1.891186815598787,2108,838,2946,+
chr2,231066929,2.2183554817275746,920,343,1263,+
chr2,231066941,2.4203539823008846,1093,451,1544,+
chr2,231708553,1.3448121429751296,1254,863,2117,+
chr2,231708650,2.334543223761566,1061,630,1691,+
chr2,231708652,2.2446283085743737,2080,1105,3185,+
chr2,231708654,3.55030734390165,707,561,1268,+
chr2,231708667,0.5338124625680286,999,752,1751,+
chr2,231711383,1.6097671427303648,1365,695,2060,+
chr2,231711392,1.6622267759562843,941,487,1428,+
chr2,231711894,1.6336999999999997,960,624,1584,+
chr2,231711897,1.655619167492211,1991,1319,3310,+
chr2,231711965,4.638359277103097,2529,1428,3957,+
chr2,231711968,5.381621826972779,4387,2787,7174,+
chr2,231712448,3.045693571970695,3962,2963,6925,+
chr2,231712458,1.7422830246241316,4978,4000,8978,+
chr2,231712464,1.5276145710928317,1039,919,1958,+
chr2,231712846,0.40548598688133575,679,558,1237,+
chr2,231712849,3.2644032921810697,834,485,1319,+
chr2,231712851,3.192233442233442,842,517,1359,+
chr2,231712857,1.098903676332554,2140,1423,3563,+
chr2,231712872,2.16,575,479,1054,+
chr2,231712882,1.0648695652173912,1412,1149,2561,+
chr2,231712883,1.0648695652173912,1412,1149,2561,+
chr2,231712924,0.6781242110578137,1142,931,2073,+
chr2,231713049,1.883466553427391,1574,966,2540,+
chr2,231713050,0.47727272727272735,626,483,1109,+
chr2,231713052,1.995224643529728,1744,1238,2982,+
chr2,231713053,1.901754774536751,2298,1546,3844,+
chr2,231713087,1.6014094601051123,1307,727,2034,+
chr2,231713310,5.62991202346041,661,340,1001,+
chr2,231713345,1.386129525849153,1502,912,2414,+
chr2,231713370,1.941434468524252,601,455,1056,+
chr2,231713379,1.883587786259542,1469,916,2385,+
chr2,231713385,1.6050545995531185,2284,1915,4199,+
chr2,231713389,1.628811188811189,1940,1264,3204,+
chr2,231713393,2.1268965517241383,1027,811,1838,+
chr2,231713394,0.7402874986540325,3021,2007,5028,+
chr2,232382354,2.660633484162896,685,363,1048,+
chr2,232382356,2.8653470490618784,835,456,1291,+
chr2,232382375,0.4962727131542165,1161,821,1982,+
chr2,232382377,0.4962727131542165,1161,821,1982,+
chr2,232382390,3.4418604651162785,813,472,1285,+
chr2,232456123,0.7952468297681069,865,800,1665,+
chr2,232456152,0.9311732389300066,8952,5723,14675,+
chr2,232456153,0.9782909586374489,7626,4936,12562,+
chr2,232456156,2.0301948798843212,4981,2253,7234,+
chr2,232456157,2.0301948798843212,4981,2253,7234,+
chr2,232456161,1.8567612086984209,5707,2791,8498,+
chr2,232456162,1.7224981992511,7379,4296,11675,+
chr2,232456168,1.2620292887029287,6984,3584,10568,+
chr2,232456169,1.139454045043111,8671,5190,13861,+
chr2,232456197,1.0890046708490229,7514,4696,12210,+
chr2,232456285,1.8115956321325337,1962,1286,3248,+
chr2,232456310,2.1937603323301262,1326,760,2086,+
chr2,232456328,1.897470950102529,693,538,1231,+
chr2,232456344,1.6921652974154648,1810,1435,3245,+
chr2,232456345,1.6807994419676704,2823,2273,5096,+
chr2,232456347,1.6458085856844238,3109,2438,5547,+
chr2,232456357,1.3003484320557492,3731,2869,6600,+
chr2,232456407,1.303789749046405,13741,9602,23343,+
chr2,232456408,1.329403256539061,7952,6274,14226,+
chr2,232456426,1.3382158740476335,6229,3796,10025,+
chr2,232456437,1.1608930322515496,14179,9741,23920,+
chr2,232456438,1.251927693071033,5234,4220,9454,+
chr2,232456608,1.4918272062421976,4196,3048,7244,+
chr2,232456609,1.3690684699228843,3349,2793,6142,+
chr2,232456616,0.8158914139494817,5908,4459,10367,+
chr2,232456897,1.071661934451901,21205,13915,35120,+
chr2,232456898,1.0006607779064713,26114,17573,43687,+
chr2,232456899,1.3930105375483526,9493,6544,16037,+
chr2,232456900,0.7217725761163516,9700,7253,16953,+
chr2,232456901,1.3305246665902404,14262,7929,22191,+
chr2,232456902,1.3719794747667904,23416,14943,38359,+
chr2,232456970,1.534008995196452,5842,4410,10252,+
chr2,232457006,1.3091758223608978,14086,10847,24933,+
chr2,232457007,1.2156609612883222,8779,5205,13984,+
chr2,232457018,1.2679355330999904,6412,4941,11353,+
chr2,232457147,1.1929045061747,748,607,1355,+
chr2,232457151,1.3731442157366933,11038,7493,18531,+
chr2,232457281,1.3756271914439617,10360,8442,18802,+
chr2,232457284,1.578404245648792,11163,9273,20436,+
chr2,232457565,1.3550399593102216,6737,4046,10783,+
chr2,232457585,1.2480153036824486,4815,3654,8469,+
chr2,232457586,1.2256715594305263,7141,5524,12665,+
chr2,232457591,1.2242249815524089,7906,4767,12673,+
chr2,232457619,1.2767836997548692,5384,4117,9501,+
chr2,232457646,1.191850717453313,6056,4750,10806,+
chr2,232457676,1.5586737622729996,18840,15128,33968,+
chr2,232457677,1.5586737622729996,18840,15128,33968,+
chr2,232457678,1.5586737622729996,18840,15128,33968,+
chr2,232457846,0.6981249366664327,10640,8045,18685,+
chr2,232457848,1.9989088095302667,39638,32383,72021,+
chr2,232457849,1.5314671099326167,103207,78277,181484,+
chr2,232457850,1.6177430292790933,111191,92045,203236,+
chr2,232457851,1.6944661131225085,93791,72460,166251,+
chr2,232457852,1.4906476003017692,97709,76595,174304,+
chr2,232457855,0.6385950259325412,17009,12480,29489,+
chr2,232458095,1.839821926606312,4545,3113,7658,+
chr2,232458098,1.2730590904606884,6234,3378,9612,+
chr2,232458255,1.5481664363354928,10880,7071,17951,+
chr2,232458405,1.2687294309479007,12465,8730,21195,+
chr2,232458645,1.3445362776768741,10766,7337,18103,+
chr2,232458652,1.6868957612448234,4629,3652,8281,+
chr2,232458657,1.2411681894787947,11894,8307,20201,+
chr2,232458723,1.3704924355310906,4531,3933,8464,+
chr2,232458730,1.3591438752741674,13622,10513,24135,+
chr2,232458868,1.352844864679987,4697,3889,8586,+
chr2,232458904,0.7110920540436013,3252,2900,6152,+
chr2,232459079,1.3653792190529124,6393,3851,10244,+
chr2,232459136,1.421326643525853,5114,4000,9114,+
chr2,232459160,1.3578216519113249,7049,5619,12668,+
chr2,232459161,1.237517739552891,11602,7043,18645,+
chr2,232459162,1.3152415165266085,21332,15070,36402,+
chr2,232459195,1.4646277766356124,14860,10909,25769,+
chr2,232459216,1.2331162390901877,3692,3183,6875,+
chr2,232459265,0.8038007970921331,6849,5032,11881,+
chr2,232459267,1.1537389805055758,8921,5136,14057,+
chr2,232459268,1.2683231363171963,9720,8204,17924,+
chr2,232459363,1.5995215253259043,14646,9894,24540,+
chr2,232459370,1.4706743004993816,4834,3372,8206,+
chr2,232459373,1.6638784868230734,8038,4757,12795,+
chr2,232459387,1.4619898805766751,5979,4738,10717,+
chr2,232459503,1.4448321585595645,5024,4024,9048,+
chr2,232459714,1.2227457158764314,14568,9627,24195,+
chr2,232459801,1.0427587079608946,19303,15268,34571,+
chr2,232459854,1.2556409059377711,15917,10798,26715,+
chr2,232459928,1.2448101315735596,8549,4932,13481,+
chr2,232459941,1.1336674774580187,25914,18525,44439,+
chr2,232459950,1.599112495316598,6264,5337,11601,+
chr2,232460131,1.6986056850330054,2694,2283,4977,+
chr2,232460250,4.703703703703703,1142,80,1222,+
chr2,232460252,6.6125603864734295,1710,114,1824,+
chr2,232460253,10.026408450704226,1138,70,1208,+
chr2,232460255,16.099110988975674,4752,241,4993,+
chr2,232460256,15.436470140407422,3716,198,3914,+
chr2,232460257,10.766382522874665,9354,516,9870,+
chr2,232460258,14.080717091629767,8335,642,8977,+
chr2,232460259,13.503982487473646,7126,788,7914,+
chr2,232460260,11.469910644272812,9032,1125,10157,+
chr2,232460261,9.089875805912476,9302,1479,10781,+
chr2,232460263,5.771937231440513,5362,1027,6389,+
chr2,232460264,2.7526315789473683,1568,227,1795,+
chr2,232460268,3.3096948098411585,5221,1348,6569,+
chr2,232460269,4.321986349804035,11234,4028,15262,+
chr2,232460270,4.108480138074417,12106,4312,16418,+
chr2,232460271,4.27980385179062,10467,3970,14437,+
chr2,232460272,3.481781327960084,2568,771,3339,+
chr2,232460281,2.44532279314888,927,362,1289,+
chr2,232460282,3.720045857450437,3325,1702,5027,+
chr2,232460283,3.767323342757779,5636,3384,9020,+
chr2,232460284,3.581970493008083,5937,3323,9260,+
chr2,232460289,0.6705721901927966,745,565,1310,+
chr2,232460291,2.367075452088963,1167,565,1732,+
chr2,232460297,3.3863569822161175,8771,6367,15138,+
chr2,232460298,3.3863569822161175,8771,6367,15138,+
chr2,232460303,1.6570541259982254,1327,783,2110,+
chr2,232460308,4.994481197508607,15370,15034,30404,+
chr2,232460309,4.994481197508607,15370,15034,30404,+
chr2,232460310,4.994481197508607,15370,15034,30404,+
chr2,232460316,0.6520667966157909,4879,4902,9781,+
chr2,232460379,0.7158028261583963,6892,5369,12261,+
chr2,232460380,0.6806909467796071,10032,7583,17615,+
chr2,232460437,7.505515960471501,18275,7620,25895,+
chr2,232460438,6.850700916117651,12262,4613,16875,+
chr2,232460439,7.268909672602177,13301,5982,19283,+
chr2,232460442,8.176180294583638,7899,4020,11919,+
chr2,232460445,11.84549886631734,8003,4903,12906,+
chr2,232460449,5.502777886767749,8247,5615,13862,+
chr2,232460455,1.6753658304793824,13122,9773,22895,+
chr2,232460456,1.5814950899412767,8691,6234,14925,+
chr2,232460465,4.567029489418557,5229,5926,11155,+
chr2,232460466,3.6860758120918145,21502,21878,43380,+
chr2,232460467,3.6860758120918145,21502,21878,43380,+
chr2,232460468,3.0846199172830904,4636,5865,10501,+
chr2,232460471,1.6698772149106684,1669,2344,4013,+
chr2,232460475,0.6938612162592422,1762,2457,4219,+
chr2,232460504,0.6933989378432216,5696,5405,11101,+
chr2,232460527,0.9788769311756387,9851,9142,18993,+
chr2,232520358,1.7905479185634177,671,566,1237,+
chr2,232520397,0.9065465217930085,1125,952,2077,+
chr2,232520399,0.4970737417089348,818,698,1516,+
chr2,232520400,1.7374999999999998,833,479,1312,+
chr2,232520428,2.1145228215767635,587,481,1068,+
chr2,232520433,4.096014492753623,3625,2552,6177,+
chr2,232520434,4.46163146003733,9215,7643,16858,+
chr2,232520435,4.02928456288813,10340,8575,18915,+
chr2,232520436,2.601856984478936,3754,2859,6613,+
chr2,232520437,2.382743476036159,2140,1803,3943,+
chr2,232520461,0.5654716501398424,1667,1310,2977,+
chr2,232520473,0.9602879158085053,2251,2201,4452,+
chr2,232520474,0.9602879158085053,2251,2201,4452,+
chr2,232520475,0.7521635739903323,2030,1451,3481,+
chr2,232520477,0.7176014594689648,4115,3812,7927,+
chr2,232520509,0.7503745996135841,3114,2528,5642,+
chr2,232520527,1.2922875117922568,3671,2962,6633,+
chr2,232520538,1.490427110817942,2030,1515,3545,+
chr2,232520662,1.548622981956315,1417,1169,2586,+
chr2,232521320,1.492206832278176,1573,840,2413,+
chr2,232521336,0.6737133594488721,1424,1345,2769,+
chr2,232521337,1.9050363661314667,1261,1040,2301,+
chr2,232521345,1.6125412541254125,1395,1211,2606,+
chr2,232521359,1.4291459322722184,6387,5532,11919,+
chr2,232521361,1.4139842054218816,3601,3669,7270,+
chr2,232521378,0.7815776489453559,2774,2009,4783,+
chr2,232521409,1.3009671179883946,2963,1879,4842,+
chr2,232521848,1.7161561561561562,1098,924,2022,+
chr2,232521996,1.575751817188465,1381,678,2059,+
chr2,232522070,2.447055248898567,1305,636,1941,+
chr2,232522108,4.591614444330437,2553,1610,4163,+
chr2,232522118,2.03397341211226,764,676,1440,+
chr2,232522147,1.5335267135533976,2472,1727,4199,+
chr2,232522522,0.702634865734736,1426,1027,2453,+
chr2,232522586,1.3856205500488623,1837,1130,2967,+
chr2,232522703,1.5516908011684356,1776,1158,2934,+
chr2,232523072,1.5234504018496091,674,585,1259,+
chr2,232523082,1.1093819074783025,2671,1728,4399,+
chr2,232523093,1.8162153414607831,782,805,1587,+
chr2,232523185,1.7907560780122898,1288,984,2272,+
chr2,232523188,1.6322552060256978,1841,998,2839,+
chr2,232523436,1.434838709677419,1667,929,2596,+
chr2,232523439,1.5300468365483846,837,645,1482,+
chr2,232523473,1.7765151515151516,2162,1235,3397,+
chr2,232523526,2.108180643119053,9881,6579,16460,+
chr2,232523527,2.145182967504621,11001,6836,17837,+
chr2,232523529,2.098462870751245,4193,2234,6427,+
chr2,232523858,1.8323956174119043,727,613,1340,+
chr2,232523860,1.4564871777147992,1108,850,1958,+
chr2,232524111,1.7303408008613193,1228,588,1816,+
chr2,232524327,2.6745341952305943,1668,897,2565,+
chr2,232524358,1.776198077137236,1621,868,2489,+
chr2,232524761,0.6609524630714427,2502,1912,4414,+
chr2,232524762,0.8518207224351354,3306,2566,5872,+
chr2,232524764,1.3845620886215475,1515,842,2357,+
chr2,232524767,1.3864521917457062,1716,939,2655,+
chr2,232524797,1.5191047973391962,2010,1214,3224,+
chr2,232524830,1.5521519248108482,3579,2702,6281,+
chr2,232525229,0.6850441625154405,4600,3490,8090,+
chr2,232525358,2.240654205607477,684,534,1218,+
chr2,232525403,1.73560443490701,1644,931,2575,+
chr2,232525534,1.4900199600798405,1492,667,2159,+
chr2,232525538,1.5037159717196458,1714,780,2494,+
chr2,232525541,1.9486059761358037,2634,1317,3951,+
chr2,232525574,0.6155770642410117,4192,2254,6446,+
chr2,232525575,0.6126789778456397,6395,3369,9764,+
chr2,232525577,0.580490270008846,6645,3118,9763,+
chr2,232525583,0.6711271230056614,1303,637,1940,+
chr2,232525619,9.063704491998191,22037,5139,27176,+
chr2,232525620,9.397097834218412,29514,7991,37505,+
chr2,232525621,9.397097834218412,29514,7991,37505,+
chr2,232525622,10.51060960513496,22256,6559,28815,+
chr2,232525626,11.314384274191765,4889,2695,7584,+
chr2,232525627,12.26304666204246,9741,4665,14406,+
chr2,232525631,22.56238861771401,20378,20414,40792,+
chr2,232525632,17.492883609554372,27615,29434,57049,+
chr2,232525633,16.69577287611102,24369,24987,49356,+
chr2,232525634,15.740432840106983,20490,23899,44389,+
chr2,232525657,0.5273919326926617,2574,3291,5865,+
chr2,232550733,1.038826530612245,616,399,1015,+
chr2,232550734,1.038826530612245,616,399,1015,+
chr2,232566957,18.29855369252714,713,480,1193,+
chr2,233434383,0.8614676909851032,873,661,1534,+
chr2,233434384,1.4099667728834266,1061,885,1946,+
chr2,233434388,2.8241980422885713,1462,1297,2759,+
chr2,233434389,2.6268900985519616,1101,1040,2141,+
chr2,233434394,2.5127123005661347,617,669,1286,+
chr2,233449272,1.6149379783584057,632,420,1052,+
chr2,233449286,2.1387559808612444,893,417,1310,+
chr2,233449288,1.6913967869437716,1414,681,2095,+
chr2,233449289,1.1464248293339423,2903,1760,4663,+
chr2,233449290,0.8924426702338989,2481,1670,4151,+
chr2,233449303,1.612722947793355,4394,3054,7448,+
chr2,233449304,1.4130760053249207,5569,3843,9412,+
chr2,233449305,1.7968653052415766,5429,3901,9330,+
chr2,233449306,0.6172688509874327,1666,1113,2779,+
chr2,233449307,1.9885709423081328,4483,3432,7915,+
chr2,233449308,1.8668759068617224,4027,2904,6931,+
chr2,233449315,1.8010204081632657,1058,587,1645,+
chr2,236124513,0.26821223469227995,541,479,1020,+
chr2,236124514,0.2532629304091607,555,477,1032,+
chr2,236125467,3.3416194348639956,663,407,1070,+
chr2,236125477,3.866220735785953,611,413,1024,+
chr2,236125478,2.91358301191626,1078,728,1806,+
chr2,236125500,1.6807432432432432,1392,1035,2427,+
chr2,236125501,1.6807432432432432,1392,1035,2427,+
chr2,237089900,2.4629382164035083,594,461,1055,+
chr2,237097688,1.305965036430235,600,442,1042,+
chr2,237097698,2.308007934334444,732,484,1216,+
chr2,237763311,1.6709558823529411,706,475,1181,+
chr2,238848043,0.4319843111227697,681,657,1338,+
chr2,238848050,2.1207271708048054,846,692,1538,+
chr2,238848599,0.5802354686196348,568,468,1036,+
chr2,238909960,1.9745916515426496,679,434,1113,+
chr2,238909969,1.791021151144615,1459,990,2449,+
chr2,238909971,1.791021151144615,1459,990,2449,+
chr2,238909976,2.7488071263510796,744,527,1271,+
chr2,238909979,1.757097301081123,778,558,1336,+
chr2,238910070,2.346575342465753,570,437,1007,+
chr2,238910099,1.894655901576317,615,458,1073,+
chr2,238910120,1.578970433563165,1200,795,1995,+
chr2,241150481,1.5558949060699119,885,417,1302,+
chr2,241150523,1.493418393188027,1702,777,2479,+
chr2,241150524,1.8621403912543153,898,394,1292,+
chr2,241150535,3.271453289585742,922,385,1307,+
chr2,241325993,2.5890367431487245,910,683,1593,+
chr2,241325994,1.3793532338308458,1108,803,1911,+
chr2,241325996,1.0543412264723742,754,548,1302,+
chr2,241335138,1.036221512716063,723,585,1308,+
chr2,241335140,1.036221512716063,723,585,1308,+
chr2,241335148,1.75,594,509,1103,+
chr2,241335975,0.3446770258122512,670,598,1268,+
chr2,241337437,2.2440107393638997,700,537,1237,+
chr2,241337484,1.7468944099378882,899,643,1542,+
chr2,241337487,1.714814814814815,925,674,1599,+
chr2,241337713,3.875226768796614,768,450,1218,+
chr2,241342996,2.7837429467779664,559,469,1028,+
chr2,241343008,0.9717939462692723,697,472,1169,+
chr2,241343010,0.9717939462692723,697,472,1169,+
chr2,241343025,2.214539253112851,2118,1735,3853,+
chr2,241343026,2.493296549053773,1197,872,2069,+
chr2,241343027,1.2876230076535085,1911,1699,3610,+
chr2,241343061,1.613053613053613,691,527,1218,+
chr2,241343068,2.1410806756720437,2185,1552,3737,+
chr2,241343069,2.087847520779593,1713,1162,2875,+
chr2,241346183,0.9758939492442659,1009,796,1805,+
chr2,241346209,0.5293729009524859,640,442,1082,+
chr2,241348177,0.6117894520829058,794,442,1236,+
chr2,241350152,5.240102594582802,2621,1650,4271,+
chr2,241350153,4.962931034482759,908,579,1487,+
chr2,241350154,4.291273118817229,3044,1898,4942,+
chr2,241350156,3.7382567539403633,1756,1190,2946,+
chr2,241350161,16.037383177570092,935,641,1576,+
chr2,241350162,18.47402549642461,1835,1576,3411,+
chr2,241352006,1.7108753315649867,644,463,1107,+
chr2,241352052,1.8691894065028392,864,602,1466,+
chr2,241352208,1.7149359886201991,1232,854,2086,+
chr2,241352273,1.8910931174089072,691,519,1210,+
chr2,241352277,1.7236883942766297,1250,1019,2269,+
chr2,241352940,2.071393687527952,1069,704,1773,+
chr2,241353146,2.0381330685203576,732,529,1261,+
chr2,241353180,1.9174664107485604,739,520,1259,+
chr2,241353432,2.175088760042574,1091,803,1894,+
chr2,241353482,1.2676378931503745,2114,1314,3428,+
chr2,241353483,0.8700436500979476,1641,1105,2746,+
chr2,241353517,1.9505404893034424,1374,942,2316,+
chr2,241353522,1.878558283389564,1773,1300,3073,+
chr2,241353608,2.8239795918367347,696,475,1171,+
chr2,241353833,1.9963870715750418,704,538,1242,+
chr2,241353843,1.777047834232309,1577,1102,2679,+
chr2,241353893,2.0487264673311185,999,644,1643,+
chr2,241653572,2.0416006192281135,578,452,1030,+
chr2,669484,3.766632059125475,628,511,1139,-
chr2,675589,0.5601735357917571,806,460,1266,-
chr2,675590,0.5601735357917571,806,460,1266,-
chr2,675618,4.367581284694687,999,456,1455,-
chr2,1632007,1.765898076075782,1001,618,1619,-
chr2,1632015,2.097524604831494,540,478,1018,-
chr2,1632585,0.43408203125,634,511,1145,-
chr2,1632652,3.1133530193158396,921,722,1643,-
chr2,1632729,4.2267289104028505,798,627,1425,-
chr2,1632963,1.5413915465121502,745,542,1287,-
chr2,1633142,2.1399095417170027,866,666,1532,-
chr2,1633163,0.823130350508803,636,452,1088,-
chr2,1633164,0.823130350508803,636,452,1088,-
chr2,1633168,0.8900453267449404,716,497,1213,-
chr2,1633172,0.757413162250649,619,444,1063,-
chr2,1633267,2.3390049372041744,1348,1077,2425,-
chr2,1633268,1.9709618874773136,723,721,1444,-
chr2,1633392,2.0552301255230123,613,477,1090,-
chr2,1633458,1.68609022556391,850,702,1552,-
chr2,1633505,2.9025974025974017,893,703,1596,-
chr2,1633535,2.722205925491347,639,486,1125,-
chr2,1633734,1.673997084732873,561,508,1069,-
chr2,1633827,1.7071840423874085,625,557,1182,-
chr2,1633911,1.4533957655195622,2236,1708,3944,-
chr2,1633914,0.7191195613585263,1687,1254,2941,-
chr2,1633948,1.5090764013564733,1512,1113,2625,-
chr2,1633977,3.2070707070707067,634,485,1119,-
chr2,1634023,1.1496078513475099,1475,1133,2608,-
chr2,1634063,1.569265889703232,705,573,1278,-
chr2,1634107,2.2735527510579554,1076,939,2015,-
chr2,1634114,1.6167180011007536,1601,1107,2708,-
chr2,1634216,1.8035426731078903,734,482,1216,-
chr2,1634233,0.4614111318021932,891,536,1427,-
chr2,1634235,1.8173076923076923,917,519,1436,-
chr2,1634240,0.5722333441966572,722,456,1178,-
chr2,1634264,1.7258361452802524,1177,693,1870,-
chr2,1634297,3.271985674492638,714,358,1072,-
chr2,1635496,2.6634429400386845,611,516,1127,-
chr2,1638905,1.453787278965426,1171,841,2012,-
chr2,1638906,1.4943963548770298,1786,1409,3195,-
chr2,1638946,1.6216090888012984,1075,680,1755,-
chr2,1638952,2.8723877278790573,569,518,1087,-
chr2,1638953,1.6613418530351436,839,625,1464,-
chr2,1639328,2.0343750000000003,960,639,1599,-
chr2,1639373,0.5355276907001044,819,637,1456,-
chr2,1639388,1.7794202898550724,876,574,1450,-
chr2,1639399,1.6901418363534018,1146,836,1982,-
chr2,1639403,1.6056398075400449,642,420,1062,-
chr2,1639416,1.9643899415728867,887,615,1502,-
chr2,1643441,2.061514382816794,805,727,1532,-
chr2,1643465,2.9365566002329353,916,818,1734,-
chr2,1643522,1.0720424644818016,1281,967,2248,-
chr2,1643528,1.4080901177675371,799,503,1302,-
chr2,1643564,1.5643472087733001,1779,1209,2988,-
chr2,1643570,3.855787690570299,1197,769,1966,-
chr2,1643571,3.855787690570299,1197,769,1966,-
chr2,1644721,1.755304740406321,647,442,1089,-
chr2,1648242,1.3649836923277736,3969,3495,7464,-
chr2,1648244,1.479727353418968,2387,2058,4445,-
chr2,1648248,1.5551967753120666,1258,823,2081,-
chr2,1648252,1.4898837469260005,1158,993,2151,-
chr2,1648259,0.5682924010753081,1624,1635,3259,-
chr2,1648260,0.9150661728352143,2511,2183,4694,-
chr2,1648261,2.1834061135371177,559,457,1016,-
chr2,1648278,2.118542848611526,644,393,1037,-
chr2,1648306,0.5240550073179149,1220,1324,2544,-
chr2,1648307,0.548960057394253,1255,1543,2798,-
chr2,1648345,0.16235207100591711,438,1143,1581,-
chr2,1648399,4.864751410205956,2189,3464,5653,-
chr2,1648400,7.243279832888805,7162,11408,18570,-
chr2,1648401,7.313215694436809,7808,11591,19399,-
chr2,1648402,8.434759522881759,7043,10378,17421,-
chr2,1648403,14.552616184595387,2007,1447,3454,-
chr2,1648508,1.6004787415935255,738,565,1303,-
chr2,1648536,2.1545053378066807,1749,1570,3319,-
chr2,1648537,0.5656934306569343,619,547,1166,-
chr2,1648538,2.175066312997348,1079,1043,2122,-
chr2,1648568,1.7118881118881117,815,494,1309,-
chr2,1648633,1.127245508982036,752,667,1419,-
chr2,1648635,1.5284800208574787,1805,1270,3075,-
chr2,1648735,1.5546744411860933,1220,1024,2244,-
chr2,1648820,2.479252951209525,529,487,1016,-
chr2,1648889,1.0863350485991994,799,423,1222,-
chr2,1648891,1.0863350485991994,799,423,1222,-
chr2,1649423,1.7342142040401474,545,462,1007,-
chr2,1649461,3.8036449147560263,646,377,1023,-
chr2,1649534,1.2614273295766907,1061,619,1680,-
chr2,1649591,1.7427636386744194,1096,806,1902,-
chr2,1649593,1.7427636386744194,1096,806,1902,-
chr2,1653695,1.5069475140776047,1328,852,2180,-
chr2,1653724,1.8323142486566608,681,513,1194,-
chr2,1653769,1.4782339647008178,1168,807,1975,-
chr2,1654491,0.9363841576031191,1520,885,2405,-
chr2,1654492,0.9363841576031191,1520,885,2405,-
chr2,1654493,1.0589417393699312,1188,926,2114,-
chr2,1661007,1.907965811965812,871,584,1455,-
chr2,1661011,1.7714580834332934,1518,983,2501,-
chr2,1661012,1.825671764321176,1947,1310,3257,-
chr2,1661016,1.5859550396522655,1103,743,1846,-
chr2,1663675,2.0934239940387482,774,487,1261,-
chr2,1663702,1.6114922485271361,1101,720,1821,-
chr2,1663708,1.8079896718450197,893,689,1582,-
chr2,1665035,0.3702995538559592,580,522,1102,-
chr2,1666252,3.0345963756177925,920,606,1526,-
chr2,1666258,0.6230000000000001,622,474,1096,-
chr2,1666278,0.5015748031496063,636,507,1143,-
chr2,1666295,2.929457507868913,585,490,1075,-
chr2,1666305,2.1665248592534003,2009,1304,3313,-
chr2,1666306,2.2677871148459383,1103,764,1867,-
chr2,1666311,1.5951107715813595,782,475,1257,-
chr2,1666335,2.015163576390693,1028,652,1680,-
chr2,1673657,1.956292749658003,772,429,1201,-
chr2,1673716,1.7337379601530545,1094,688,1782,-
chr2,1673752,2.1530071869877694,922,720,1642,-
chr2,1673809,1.0333333333333332,867,755,1622,-
chr2,1673810,2.0813121619263657,851,520,1371,-
chr2,1673811,0.8583756589205616,1398,1238,2636,-
chr2,1680253,1.5078404583352378,2315,1586,3901,-
chr2,1680254,1.5287409774599086,2348,1635,3983,-
chr2,1680257,1.1701595243232477,993,738,1731,-
chr2,1683681,2.0347923681257014,783,647,1430,-
chr2,1683725,0.6818253206526482,1055,784,1839,-
chr2,1684114,1.0231994797178554,2917,2052,4969,-
chr2,1684129,1.980011511694836,945,658,1603,-
chr2,1693079,1.2601074561051442,3594,2306,5900,-
chr2,1693091,1.8373964576739172,4643,3831,8474,-
chr2,1693092,1.8373964576739172,4643,3831,8474,-
chr2,1693108,1.014296482370897,5195,3339,8534,-
chr2,1693111,1.1012753022037558,4193,2958,7151,-
chr2,1693117,1.3177376767142903,4154,2746,6900,-
chr2,1693118,1.6526149581393457,2542,1806,4348,-
chr2,1693123,1.7410036496350367,2326,1369,3695,-
chr2,1693124,1.4806044555226672,1055,654,1709,-
chr2,1693125,1.64508648178568,3404,1974,5378,-
chr2,1693126,1.6316972068337658,2187,1243,3430,-
chr2,1693133,1.7753303964757712,836,453,1289,-
chr2,1744285,2.441885158866291,807,582,1389,-
chr2,1744307,1.500934628589113,1227,806,2033,-
chr2,1744309,1.5919102105366056,1084,674,1758,-
chr2,1744322,2.835062578665863,693,410,1103,-
chr2,3498511,9.446106941356495,1679,1565,3244,-
chr2,3498512,7.09497124621434,1139,1033,2172,-
chr2,3498513,6.578649082842473,994,1033,2027,-
chr2,3498533,7.172118467393318,718,536,1254,-
chr2,3498534,6.299404642446194,907,658,1565,-
chr2,3498632,2.765180421344446,4486,2767,7253,-
chr2,3498633,2.6856350277402905,3169,2051,5220,-
chr2,3498642,1.9331578031531558,3343,2021,5364,-
chr2,3498659,1.5710230937943492,2375,1347,3722,-
chr2,3498660,1.5710230937943492,2375,1347,3722,-
chr2,3498667,1.553698525673615,1062,561,1623,-
chr2,3498671,1.870639534883721,857,429,1286,-
chr2,3498677,1.7114127702362998,850,441,1291,-
chr2,3498946,2.3986389942308235,849,734,1583,-
chr2,3498947,2.0277297608758285,598,533,1131,-
chr2,3513925,2.412869760405992,650,575,1225,-
chr2,3513971,1.1393735547614043,1083,709,1792,-
chr2,3513973,1.6099742684309524,2647,1898,4545,-
chr2,3519378,1.9635431375817152,693,459,1152,-
chr2,3519412,2.615930265830511,1033,564,1597,-
chr2,3545712,1.708757582115279,696,558,1254,-
chr2,3547991,4.76010349807,701,472,1173,-
chr2,9406844,0.6241432979275319,1038,690,1728,-
chr2,9408202,2.115525706868333,832,610,1442,-
chr2,9408203,2.115525706868333,832,610,1442,-
chr2,9412341,1.7561370716510902,828,641,1469,-
chr2,9412385,1.6579275905118602,663,533,1196,-
chr2,9414219,1.1119472259658447,835,775,1610,-
chr2,9418702,2.508492129246065,733,567,1300,-
chr2,9418703,2.508492129246065,733,567,1300,-
chr2,9418728,1.5285684166139577,579,526,1105,-
chr2,9423455,3.5307396760924696,566,513,1079,-
chr2,9527802,3.4670184696569923,656,378,1034,-
chr2,9527833,1.1787498490125197,803,477,1280,-
chr2,9584193,1.0141467727674625,1035,608,1643,-
chr2,9584194,1.0141467727674625,1035,608,1643,-
chr2,9584485,3.0261857707509883,874,505,1379,-
chr2,9584511,0.4262763650699784,864,533,1397,-
chr2,9584533,0.370736177578658,661,426,1087,-
chr2,9584660,2.1438129025458954,1843,1266,3109,-
chr2,9584683,1.5472097328749008,649,397,1046,-
chr2,9584885,1.5685103708359525,1084,739,1823,-
chr2,9585287,1.6168678894822381,1762,1179,2941,-
chr2,9585336,1.6244388053874683,1386,871,2257,-
chr2,9588199,1.9413810233482367,1953,1219,3172,-
chr2,9588200,1.9413810233482367,1953,1219,3172,-
chr2,9591452,1.7254670831614312,1125,892,2017,-
chr2,9630171,1.4208665072999191,1239,1032,2271,-
chr2,9630218,0.6949026338705403,1448,1002,2450,-
chr2,9630232,2.34666980465992,766,606,1372,-
chr2,9630244,2.0500527664706767,1045,736,1781,-
chr2,9630252,0.6196120689655172,597,463,1060,-
chr2,9630270,2.6443154953793253,768,516,1284,-
chr2,9630447,0.8390347861379601,846,553,1399,-
chr2,9630449,0.6887354971361433,976,618,1594,-
chr2,9630451,0.9878399702961106,625,398,1023,-
chr2,9630969,1.4618867466927767,1478,987,2465,-
chr2,9630970,1.4871619892518981,757,616,1373,-
chr2,9630978,3.916935105769326,747,388,1135,-
chr2,10441849,2.237214794639489,1259,955,2214,-
chr2,10442139,1.1131059890090655,634,434,1068,-
chr2,10443283,3.149524993736621,904,659,1563,-
chr2,10443286,2.5937817658838447,675,462,1137,-
chr2,10445036,2.406741316116884,771,522,1293,-
chr2,10445222,0.9044972382302391,627,491,1118,-
chr2,10589602,0.6109925293489861,1144,936,2080,-
chr2,10589657,1.5531793018367215,915,661,1576,-
chr2,10589669,2.1102710381017755,854,551,1405,-
chr2,10602871,0.8495291252614079,661,409,1070,-
chr2,10783554,1.9550161812297733,862,514,1376,-
chr2,10783612,0.6160114492668964,916,645,1561,-
chr2,10783847,2.0368856866329708,610,546,1156,-
chr2,10784206,0.7666992926923858,2995,2190,5185,-
chr2,10784269,0.9901534386199692,3512,2761,6273,-
chr2,10784270,0.9901534386199692,3512,2761,6273,-
chr2,10784309,1.6674338319907942,1385,868,2253,-
chr2,10784312,1.8711052384808833,933,808,1741,-
chr2,10787371,4.913461659029168,6971,5411,12382,-
chr2,10787372,4.288709461569345,3035,2318,5353,-
chr2,10787373,4.288709461569345,3035,2318,5353,-
chr2,10788729,2.0941549766199063,1182,997,2179,-
chr2,10789777,1.6195249810314305,1717,1402,3119,-
chr2,10790829,1.9314656468869509,1706,1368,3074,-
chr2,10791921,1.4106174076097988,2579,1912,4491,-
chr2,10793114,0.593857013068698,1544,1046,2590,-
chr2,10797107,1.680387261021762,1782,1512,3294,-
chr2,10797177,1.4022207438456369,5900,4241,10141,-
chr2,10797196,1.468029682063006,5505,3764,9269,-
chr2,10802620,0.3654309099662975,1055,1071,2126,-
chr2,10802625,0.5246283524904214,777,724,1501,-
chr2,10802633,0.5956093189964158,577,557,1134,-
chr2,10802635,0.4785420340975897,776,728,1504,-
chr2,10812710,2.2319267599705355,706,558,1264,-
chr2,10812714,0.3960573476702509,475,557,1032,-
chr2,10812717,0.886228235009741,1226,1476,2702,-
chr2,10812719,2.2662950166615987,2497,2642,5139,-
chr2,10812720,2.6944671501891713,3346,3525,6871,-
chr2,10812721,2.6497918559885805,2827,3139,5966,-
chr2,10812761,1.81456468456948,779,394,1173,-
chr2,10812768,4.580245957688062,1032,562,1594,-
chr2,11201082,1.4705787033298037,1468,1018,2486,-
chr2,11201099,1.922730422730423,715,480,1195,-
chr2,11201109,3.2968500797448166,718,417,1135,-
chr2,11201110,3.2968500797448166,718,417,1135,-
chr2,11201114,2.5369127516778525,713,446,1159,-
chr2,11201116,2.49942074776198,1046,632,1678,-
chr2,11201117,2.5008128644785543,932,528,1460,-
chr2,11201124,2.689500295157093,1020,609,1629,-
chr2,17683721,2.3625,566,479,1045,-
chr2,17683722,2.4280321755577527,930,693,1623,-
chr2,17683725,2.9625595238095244,700,479,1179,-
chr2,17683726,2.9625595238095244,700,479,1179,-
chr2,17683727,3.331935771632471,910,589,1499,-
chr2,17695216,2.5760792639773533,727,470,1197,-
chr2,17695247,2.2220173335792004,963,492,1455,-
chr2,17695248,2.2220173335792004,963,492,1455,-
chr2,17703212,2.4025557903482255,829,483,1312,-
chr2,17716837,2.530332681017613,861,510,1371,-
chr2,17716838,2.530332681017613,861,510,1371,-
chr2,17718212,1.7026525198938993,916,649,1565,-
chr2,17718218,1.7898080180688878,817,505,1322,-
chr2,17720955,2.6313253012048192,1455,829,2284,-
chr2,17720957,2.510021801814473,2149,1204,3353,-
chr2,17720958,2.389772727272727,1401,769,2170,-
chr2,17720959,0.3872875092387288,785,593,1378,-
chr2,20032785,0.5084276891405044,1128,1071,2199,-
chr2,20032900,0.4789054865279911,2047,2754,4801,-
chr2,20032920,28.10310573773128,12242,14625,26867,-
chr2,20032921,28.10310573773128,12242,14625,26867,-
chr2,20032922,27.434117995110928,6508,8418,14926,-
chr2,20032926,2.4534161490683233,1579,781,2360,-
chr2,20032927,3.6214221274501766,3651,1506,5157,-
chr2,20032928,4.1220963850260075,7784,3749,11533,-
chr2,20032929,3.8374940494421956,9277,4428,13705,-
chr2,20033235,1.591311207828553,2329,1744,4073,-
chr2,20033238,1.7886540600667409,803,681,1484,-
chr2,20033246,0.5977198697068403,733,613,1346,-
chr2,20034344,1.9716097855632744,767,601,1368,-
chr2,20035059,2.1149136234419417,666,537,1203,-
chr2,20037324,1.4798832526336398,2449,1802,4251,-
chr2,20037433,2.242923468623633,831,606,1437,-
chr2,20040989,1.5261689291101057,1238,883,2121,-
chr2,20040990,2.1628628628628626,696,554,1250,-
chr2,20040997,2.757366771159875,732,637,1369,-
chr2,20041001,0.4936524453694069,592,464,1056,-
chr2,20041005,0.6218181818181818,827,574,1401,-
chr2,20041006,0.5602183833116037,549,471,1020,-
chr2,20051431,1.7706170748309105,967,839,1806,-
chr2,20051610,2.689655172413793,643,666,1309,-
chr2,20051611,2.689655172413793,643,666,1309,-
chr2,20051629,3.515200868621064,1109,613,1722,-
chr2,20051630,4.7154054205012,2547,1874,4421,-
chr2,20051631,4.235487315774082,2740,2030,4770,-
chr2,20529742,1.842233216753391,918,616,1534,-
chr2,20529768,2.1141341591894736,1131,814,1945,-
chr2,24067734,1.5740147171685253,1489,1302,2791,-
chr2,24068405,1.7357363998230873,834,664,1498,-
chr2,24074173,1.4279505582137157,1213,879,2092,-
chr2,24076231,1.7293447293447293,1213,701,1914,-
chr2,24076270,0.6105798962941821,754,538,1292,-
chr2,24076321,1.819773146469519,1002,766,1768,-
chr2,24076326,1.187880481851569,654,449,1103,-
chr2,24793197,1.6864391648051673,797,571,1368,-
chr2,24819998,7.624897709639272,573,487,1060,-
chr2,24824465,1.0423310554646008,716,513,1229,-
chr2,25246225,1.8272047385646066,895,674,1569,-
chr2,25246226,0.5129393808998736,1260,823,2083,-
chr2,25246227,0.49569067183619364,1621,1048,2669,-
chr2,25741908,2.0639646561659624,613,547,1160,-
chr2,25741909,0.5556764344621863,811,694,1505,-
chr2,25741982,32.243336738534005,1066,777,1843,-
chr2,25741983,32.243336738534005,1066,777,1843,-
chr2,26028333,2.484617959553332,675,591,1266,-
chr2,26190921,9.85602101545146,1274,943,2217,-
chr2,26191266,1.8961625282167045,599,442,1041,-
chr2,26191358,1.744516422320718,613,418,1031,-
chr2,26191580,1.9176334106728536,626,430,1056,-
chr2,26192376,0.5423243031016883,726,565,1291,-
chr2,26192412,2.5941168096288485,985,672,1657,-
chr2,26193620,3.144300311217604,786,579,1365,-
chr2,26194621,0.3725367139450233,847,513,1360,-
chr2,26194623,0.3725367139450233,847,513,1360,-
chr2,26195179,1.9457013574660635,601,454,1055,-
chr2,26195182,1.7847282139775669,590,487,1077,-
chr2,26195230,2.2476269545412806,714,599,1313,-
chr2,26197768,1.0868204746003813,924,754,1678,-
chr2,26201224,0.5734204793028322,657,509,1166,-
chr2,26201299,1.9707602339181287,673,521,1194,-
chr2,26204111,0.333446289393426,655,453,1108,-
chr2,26214497,1.2466610362434518,2378,1766,4144,-
chr2,26214498,1.6188042131350682,1492,1075,2567,-
chr2,26214521,2.0093109092448125,1595,1142,2737,-
chr2,26214560,0.6147058823529412,615,475,1090,-
chr2,26215164,1.0137960871028215,1405,878,2283,-
chr2,26215165,1.0137960871028215,1405,878,2283,-
chr2,26230226,1.6379208032212926,1386,1160,2546,-
chr2,26232234,2.60261569416499,596,496,1092,-
chr2,26232246,1.0459592822199075,1361,1053,2414,-
chr2,26232252,1.827505827505828,587,428,1015,-
chr2,26232257,1.618736383442266,742,458,1200,-
chr2,26234321,2.2822916666666666,625,479,1104,-
chr2,26234353,2.0007770007770005,617,428,1045,-
chr2,26236956,1.6973359929847487,10216,7429,17645,-
chr2,26236957,1.9233489453996797,5499,4387,9886,-
chr2,26236958,1.9233489453996797,5499,4387,9886,-
chr2,26236970,1.8565384615384612,1608,1099,2707,-
chr2,26236975,1.596927966101695,1349,884,2233,-
chr2,26236982,1.6802776962941233,2408,1460,3868,-
chr2,26236984,1.6802776962941233,2408,1460,3868,-
chr2,26236986,0.5713551984738425,598,412,1010,-
chr2,26236987,0.62841796875,1187,767,1954,-
chr2,26238954,0.5613066143812261,2814,2093,4907,-
chr2,26238955,0.5712472749922143,1982,1519,3501,-
chr2,26238970,1.273124994610392,1385,991,2376,-
chr2,27070708,2.4664830119375574,1342,857,2199,-
chr2,27071351,1.706924315619968,794,620,1414,-
chr2,27071355,1.8338612150878202,771,603,1374,-
chr2,27071361,2.18118520810769,761,561,1322,-
chr2,27071433,1.7266947704226956,1023,654,1677,-
chr2,27071461,1.6896024464831805,844,435,1279,-
chr2,27071649,2.1236203090507724,739,603,1342,-
chr2,27071651,2.1236203090507724,739,603,1342,-
chr2,27309608,1.5383165249256145,977,818,1795,-
chr2,27309643,1.11703690282843,890,693,1583,-
chr2,27309713,0.5658365004154111,990,710,1700,-
chr2,27309753,3.054992266712494,612,528,1140,-
chr2,27309754,2.863962558995142,1032,837,1869,-
chr2,27309892,3.618881118881119,674,428,1102,-
chr2,27309893,3.778195488721803,1004,626,1630,-
chr2,27309895,3.5965686274509805,666,407,1073,-
chr2,27328500,0.3622493189873871,747,533,1280,-
chr2,27328563,3.5642596126152073,575,449,1024,-
chr2,27328910,2.281021788067331,1046,789,1835,-
chr2,27337518,3.275035178466848,685,447,1132,-
chr2,27342028,0.3996607010239875,821,561,1382,-
chr2,27342954,2.1638988632676743,911,698,1609,-
chr2,27342962,1.4400133156453865,582,488,1070,-
chr2,27342972,0.43427508035865336,603,513,1116,-
chr2,27342973,0.43427508035865336,603,513,1116,-
chr2,27367759,1.07989307989308,605,517,1122,-
chr2,27367760,1.07989307989308,605,517,1122,-
chr2,27381623,2.716276552563929,955,777,1732,-
chr2,27381624,2.716276552563929,955,777,1732,-
chr2,27381640,1.9567575839777862,1057,837,1894,-
chr2,27382164,1.99218045112782,620,474,1094,-
chr2,27382227,2.362839366515837,556,543,1099,-
chr2,27382506,2.251867073818693,1652,1201,2853,-
chr2,27382554,1.7517942583732058,605,527,1132,-
chr2,27382585,0.36726431625087125,814,626,1440,-
chr2,27382587,2.431983858370216,794,667,1461,-
chr2,27382588,2.431983858370216,794,667,1461,-
chr2,27382589,1.212435107351922,854,555,1409,-
chr2,27383433,2.494144120065223,1590,1063,2653,-
chr2,27383434,2.1191884685885687,1182,705,1887,-
chr2,27383996,2.014987203918259,706,520,1226,-
chr2,27384782,2.45242136154251,846,556,1402,-
chr2,27384891,1.2049110228914492,1001,721,1722,-
chr2,27384892,0.5600936833459204,876,685,1561,-
chr2,27385771,2.0065214555888877,640,450,1090,-
chr2,27386271,1.6917805248319238,1392,1304,2696,-
chr2,27386275,1.6416680308401068,2099,1675,3774,-
chr2,27387102,1.3514946041447808,1022,848,1870,-
chr2,27387106,1.6184480373920922,892,722,1614,-
chr2,27387115,0.5642653352353779,878,700,1578,-
chr2,27387123,0.6534549511122777,765,621,1386,-
chr2,27387147,0.7925956495114351,956,677,1633,-
chr2,27387148,0.9068052930056708,737,528,1265,-
chr2,27409326,2.127561619480377,784,569,1353,-
chr2,27653720,2.8895268474215845,631,494,1125,-
chr2,27653722,2.664342598534522,628,564,1192,-
chr2,27657511,0.8666458015871977,791,630,1421,-
chr2,27657513,1.5214896214896214,732,629,1361,-
chr2,27657514,2.0089590302651605,741,541,1282,-
chr2,27663347,2.340672097691863,629,488,1117,-
chr2,28869917,1.87107131551576,1654,818,2472,-
chr2,28869918,2.0976947087112623,2369,1298,3667,-
chr2,32024066,1.8369140625,797,511,1308,-
chr2,32024240,1.843136030636031,1500,1091,2591,-
chr2,32029616,0.5052779617720662,3765,2215,5980,-
chr2,32029617,0.4990947242206237,2821,1667,4488,-
chr2,32029626,0.754975558659218,1115,715,1830,-
chr2,32029642,1.2202504638237133,1275,774,2049,-
chr2,32029647,1.9679008525452146,1144,741,1885,-
chr2,32029671,2.0334841628959284,641,389,1030,-
chr2,32039320,2.1098209966134487,622,476,1098,-
chr2,32039321,2.009553582111837,1025,752,1777,-
chr2,32039756,2.996920115845397,642,520,1162,-
chr2,32039757,2.902494268296557,736,551,1287,-
chr2,33584162,2.2293219334058003,749,533,1282,-
chr2,36552828,0.9390579327378994,962,689,1651,-
chr2,36553025,1.4673093824232564,666,479,1145,-
chr2,36581402,1.915609756097561,713,614,1327,-
chr2,36581407,1.9617756795857766,677,570,1247,-
chr2,36581422,2.7727900912646675,990,610,1600,-
chr2,37147711,1.991429684456564,851,452,1303,-
chr2,37147713,1.7562886027937066,1797,914,2711,-
chr2,37147714,2.5442364532019703,806,405,1211,-
chr2,37147722,3.0580314769255184,784,376,1160,-
chr2,37147734,0.3642091542526797,761,449,1210,-
chr2,37223275,3.037632492707395,688,536,1224,-
chr2,37228109,3.941897663502878,645,445,1090,-
chr2,37277970,1.9215175097276267,1592,1284,2876,-
chr2,37277972,1.9215175097276267,1592,1284,2876,-
chr2,37277978,2.7114529914529912,1132,974,2106,-
chr2,37277979,2.7114529914529912,1132,974,2106,-
chr2,37277982,2.2182843334675795,971,763,1734,-
chr2,37277984,2.1878488621726064,1421,1095,2516,-
chr2,37277985,2.193926537903316,913,688,1601,-
chr2,38068366,2.5198921191529093,999,789,1788,-
chr2,38068616,2.4272127628851643,915,630,1545,-
chr2,38068898,0.9036777583187392,558,570,1128,-
chr2,38068899,0.9036777583187392,558,570,1128,-
chr2,38068905,1.242780172413793,606,463,1069,-
chr2,38068907,5.069182011305856,1749,1391,3140,-
chr2,38068912,6.827127152650204,1139,750,1889,-
chr2,38068913,7.452088452088453,673,406,1079,-
chr2,38069064,2.44263490520175,772,483,1255,-
chr2,38069163,1.7059468948869871,597,433,1030,-
chr2,38069307,0.5009666122732043,1125,827,1952,-
chr2,38070094,0.46493993993994,562,443,1005,-
chr2,38070229,2.200708762886598,620,387,1007,-
chr2,38295625,0.5078991341333738,1485,907,2392,-
chr2,38295654,1.5636247129812573,1330,920,2250,-
chr2,38295661,1.549079504724666,1041,681,1722,-
chr2,38295667,0.9486302785365687,3344,2517,5861,-
chr2,38295668,0.6322426575466933,3124,2399,5523,-
chr2,38295669,0.6407840808500129,2509,1990,4499,-
chr2,38295681,2.1636925279787915,1067,644,1711,-
chr2,38295992,4.7389643463497455,1014,588,1602,-
chr2,38295993,4.7389643463497455,1014,588,1602,-
chr2,38295994,4.7389643463497455,1014,588,1602,-
chr2,38299312,1.38600762458558,688,445,1133,-
chr2,38310441,2.808737956533801,661,452,1113,-
chr2,38343399,1.8425620551987505,964,822,1786,-
chr2,38343402,2.6048533140166605,898,752,1650,-
chr2,38343496,2.0404983285230807,1026,728,1754,-
chr2,38568212,2.680459127816805,1052,597,1649,-
chr2,38744415,0.5679580322769223,1184,653,1837,-
chr2,38744416,0.5045871585412748,971,548,1519,-
chr2,38745022,2.0001454016721194,723,654,1377,-
chr2,38745123,1.4772919530506503,1188,771,1959,-
chr2,38745144,1.1610783211279394,1352,983,2335,-
chr2,38746713,1.7501457725947525,620,489,1109,-
chr2,38746724,2.4832775919732444,593,459,1052,-
chr2,38746730,2.3821782178217816,1202,807,2009,-
chr2,38748066,0.6319817400644469,1045,783,1828,-
chr2,38748080,0.7178431372549019,1045,764,1809,-
chr2,38748147,1.6775211152945964,941,633,1574,-
chr2,38748594,0.4502318392581144,970,646,1616,-
chr2,38748642,1.531176006314128,969,723,1692,-
chr2,38749582,1.6965195246179965,570,495,1065,-
chr2,38749608,0.5726583017216224,784,595,1379,-
chr2,38749677,1.778593117408907,780,607,1387,-
chr2,38750172,2.4485393258426966,680,444,1124,-
chr2,38750181,1.7018918070865823,1265,863,2128,-
chr2,38751281,2.3932038834951457,679,514,1193,-
chr2,38751282,2.3932038834951457,679,514,1193,-
chr2,38751283,0.3922716627634661,669,426,1095,-
chr2,38751320,3.2528378826108013,1040,621,1661,-
chr2,38751335,2.4051185944990388,1159,616,1775,-
chr2,39035228,1.5314614941815332,860,755,1615,-
chr2,39035232,1.1207897793263646,964,629,1593,-
chr2,39035233,1.1207897793263646,964,629,1593,-
chr2,42350644,2.674008810572688,606,453,1059,-
chr2,42350646,1.873986815086999,577,486,1063,-
chr2,42350663,1.6374145182232398,2334,1680,4014,-
chr2,42350664,1.673160173160173,1545,1007,2552,-
chr2,42350844,0.3555871212121212,750,527,1277,-
chr2,42351019,2.1626840123245463,928,634,1562,-
chr2,42351134,1.6110730854057342,661,486,1147,-
chr2,42351184,2.6319607843137254,865,599,1464,-
chr2,42351225,1.6970546984572232,725,557,1282,-
chr2,42351258,2.161041681200609,1380,1037,2417,-
chr2,42351264,1.6451117109011844,654,512,1166,-
chr2,42351312,2.196048632218845,577,469,1046,-
chr2,42353286,0.9834912799497051,1723,1281,3004,-
chr2,42353288,0.9834912799497051,1723,1281,3004,-
chr2,42353338,2.0205241187384044,1024,783,1807,-
chr2,42353340,1.547570657800862,1496,1224,2720,-
chr2,43889799,0.3605604921394395,632,531,1163,-
chr2,43894576,1.8172588832487309,715,393,1108,-
chr2,43896685,0.5555149744338933,701,443,1144,-
chr2,43896696,0.7366655604972069,1664,1103,2767,-
chr2,43896697,0.9844885067555712,1038,694,1732,-
chr2,43899292,1.3571942154463503,1477,1006,2483,-
chr2,43899295,0.2978403890160183,594,436,1030,-
chr2,43918117,1.0443908722052735,1211,839,2050,-
chr2,43934203,1.6839495798319328,690,475,1165,-
chr2,43943811,2.26484926872948,812,528,1340,-
chr2,43945407,0.4668161434977579,693,445,1138,-
chr2,43946212,1.743824283383827,906,612,1518,-
chr2,43948438,3.686274509803922,563,458,1021,-
chr2,43948506,0.3507707454183855,1175,850,2025,-
chr2,43949619,1.797887323943662,665,425,1090,-
chr2,43963678,2.3745791725180454,1069,756,1825,-
chr2,43963698,1.10806953814219,1094,819,1913,-
chr2,43963700,1.10806953814219,1094,819,1913,-
chr2,43974181,1.6464418562107446,749,528,1277,-
chr2,43977185,4.1594669117647065,861,543,1404,-
chr2,43977187,4.1594669117647065,861,543,1404,-
chr2,44321242,4.467592677572318,626,459,1085,-
chr2,44338500,11.252241577104211,581,448,1029,-
chr2,45008969,1.1881767121825277,1709,981,2690,-
chr2,45008970,1.4072299651567943,1076,727,1803,-
chr2,45008971,1.4633033337558623,961,482,1443,-
chr2,45008972,1.166795069337442,698,471,1169,-
chr2,45008977,0.8471663231821492,832,512,1344,-
chr2,46902624,1.887671232876712,635,437,1072,-
chr2,46902647,1.0086206896551724,584,521,1105,-
chr2,46902648,1.0086206896551724,584,521,1105,-
chr2,46903251,1.3682803915753856,668,413,1081,-
chr2,46904919,2.33228693008589,610,397,1007,-
chr2,46905433,2.1528811690102008,678,402,1080,-
chr2,46905456,2.832532051282051,706,415,1121,-
chr2,46915773,8.11786655493804,698,796,1494,-
chr2,46915774,8.11786655493804,698,796,1494,-
chr2,47160539,1.4618299064203055,3524,2914,6438,-
chr2,47162337,1.434481366028497,1535,1002,2537,-
chr2,47162341,1.509285045851956,7821,5266,13087,-
chr2,47162343,1.5012739681507965,4250,2714,6964,-
chr2,47176463,1.4551960301837268,1338,1015,2353,-
chr2,47176497,1.6134609387182288,1356,1165,2521,-
chr2,47176499,0.6558886620649053,2000,1400,3400,-
chr2,47176510,1.4786085189644789,1954,1660,3614,-
chr2,47176511,1.4786085189644789,1954,1660,3614,-
chr2,47176514,0.9050915287817769,2818,2502,5320,-
chr2,47176515,0.920462142122066,2362,2160,4522,-
chr2,54972513,1.762853172765169,1037,761,1798,-
chr2,54972577,2.47953216374269,847,607,1454,-
chr2,54972752,1.8103059581320446,802,689,1491,-
chr2,54972758,1.4637179487179486,698,584,1282,-
chr2,54972792,1.9338842975206607,701,428,1129,-
chr2,54972797,0.45881911224830935,2138,1448,3586,-
chr2,54972864,1.7236722115656735,2810,3244,6054,-
chr2,54972867,1.6263611053650697,5212,5725,10937,-
chr2,54972868,1.448622223982845,11146,10739,21885,-
chr2,54972870,1.4039645869758977,12320,11803,24123,-
chr2,54972871,1.5722109633037176,7109,7250,14359,-
chr2,54972872,1.1290393679664197,12908,11532,24440,-
chr2,54972873,0.49780229451653757,5799,4282,10081,-
chr2,54972884,0.6545366448508592,4053,3195,7248,-
chr2,54972889,0.6648778573973276,3595,3182,6777,-
chr2,54972890,0.6648778573973276,3595,3182,6777,-
chr2,54972901,1.558490513926756,4085,3398,7483,-
chr2,54973080,8.627973692478323,7847,5967,13814,-
chr2,54973081,9.131928844064111,4644,3533,8177,-
chr2,54973122,1.8767129738639041,971,684,1655,-
chr2,54973155,1.9900497512437811,959,669,1628,-
chr2,54982621,1.5168295331161783,1269,920,2189,-
chr2,54982636,1.9497288676236044,825,626,1451,-
chr2,54987586,0.5573498964803313,672,551,1223,-
chr2,54987673,0.3599755482539925,672,568,1240,-
chr2,54987674,0.3599755482539925,672,568,1240,-
chr2,54987676,2.2121112496547934,1035,787,1822,-
chr2,54987695,1.5710036693287286,643,587,1230,-
chr2,55049759,3.96795989537925,613,431,1044,-
chr2,55049770,1.3792857600708408,745,531,1276,-
chr2,55050459,3.764546381907318,544,488,1032,-
chr2,55050485,16.289901526322787,932,598,1530,-
chr2,55050488,7.972621846528961,1053,504,1557,-
chr2,55050489,7.975003651411879,720,307,1027,-
chr2,55244122,2.9635990293074483,587,486,1073,-
chr2,55244123,2.9635990293074483,587,486,1073,-
chr2,55549557,0.356368742438504,444,689,1133,-
chr2,55549605,22.134176738960438,418,680,1098,-
chr2,55636388,2.7218680121828975,757,523,1280,-
chr2,55644703,2.076179072926936,618,404,1022,-
chr2,55646290,1.9342864309004266,722,442,1164,-
chr2,55654911,2.8802031758420994,836,563,1399,-
chr2,55672012,1.3860903108690723,1928,1403,3331,-
chr2,55672021,1.5299801714748513,1711,1173,2884,-
chr2,55672025,2.053900838497995,1586,1054,2640,-
chr2,55672045,1.6515256588072122,1298,720,2018,-
chr2,55672913,2.170955287084319,1528,1084,2612,-
chr2,55672929,1.4931104125365438,2087,1250,3337,-
chr2,55672931,1.7149811366678838,1625,912,2537,-
chr2,55672933,1.7149811366678838,1625,912,2537,-
chr2,55672949,1.7608302644794107,973,514,1487,-
chr2,55684986,1.7368702154174827,1083,684,1767,-
chr2,55685001,0.5959090137497878,825,547,1372,-
chr2,55866790,1.5569358178053831,1279,919,2198,-
chr2,55866977,1.503051255808957,4023,2949,6972,-
chr2,55866986,1.6128420995641697,992,696,1688,-
chr2,55867140,1.6628673225704091,2266,1901,4167,-
chr2,55867147,2.098319947231599,1351,780,2131,-
chr2,55870740,1.6923739979681893,2683,2049,4732,-
chr2,55870818,1.6106476170612165,1342,891,2233,-
chr2,55871100,2.5059972707031535,850,662,1512,-
chr2,55871118,1.6732438831886345,847,723,1570,-
chr2,55875057,1.5837032339885857,998,746,1744,-
chr2,55877763,1.6736919366677152,1040,866,1906,-
chr2,55877802,1.5889565364451206,988,656,1644,-
chr2,55877826,1.860360360360361,825,665,1490,-
chr2,55881675,1.9444242864054184,868,688,1556,-
chr2,55881676,1.8997879700926237,1063,617,1680,-
chr2,55917685,2.7505792558266315,960,666,1626,-
chr2,55917690,0.5803880070546737,865,629,1494,-
chr2,55917729,1.8579607415485277,704,523,1227,-
chr2,55917908,1.7497219132369295,725,557,1282,-
chr2,55918035,1.958259482453031,1162,727,1889,-
chr2,55918047,2.012748520261041,697,598,1295,-
chr2,55918050,1.7597664226438812,1387,1075,2462,-
chr2,58461487,2.067268041237113,616,484,1100,-
chr2,58461515,1.9420145413262027,1756,1318,3074,-
chr2,58461516,1.1779986446803703,893,698,1591,-
chr2,58461517,3.0205059544781907,892,616,1508,-
chr2,60735155,0.7774230835059651,946,609,1555,-
chr2,60735157,1.2677701699010568,971,615,1586,-
chr2,61478078,1.5875112410071943,806,555,1361,-
chr2,61478088,1.717566016073479,747,468,1215,-
chr2,61478115,1.630760690038548,1435,943,2378,-
chr2,61478433,0.46796094714397946,694,468,1162,-
chr2,61478537,3.575833668139815,580,468,1048,-
chr2,61478720,2.1384673266894874,1870,1426,3296,-
chr2,61478722,2.3040516735173227,852,654,1506,-
chr2,61478753,1.0101347175874429,742,557,1299,-
chr2,61478755,1.4247307420224942,1336,898,2234,-
chr2,61478877,0.9410056797267556,2243,1680,3923,-
chr2,61485950,0.9869513641755636,1247,842,2089,-
chr2,61485951,0.9869513641755636,1247,842,2089,-
chr2,61485952,2.5252483867663633,1173,750,1923,-
chr2,61485954,2.5252483867663633,1173,750,1923,-
chr2,61492046,1.4760928086142804,986,806,1792,-
chr2,61492052,2.0497972059486256,826,633,1459,-
chr2,61492085,2.0550226485478285,616,416,1032,-
chr2,61492149,1.81468110709988,727,553,1280,-
chr2,61492475,0.4815972222222223,802,575,1377,-
chr2,61492650,2.1435142248447905,1242,907,2149,-
chr2,61492993,2.0456324497420386,792,510,1302,-
chr2,61493030,2.3428571428571425,655,419,1074,-
chr2,61496984,2.6115384615384616,678,402,1080,-
chr2,61496991,0.3735676088617265,651,461,1112,-
chr2,61498791,1.9287870920197883,995,705,1700,-
chr2,61499748,2.065157699443413,772,538,1310,-
chr2,61538244,2.6277436269510694,644,419,1063,-
chr2,61868509,0.7050808572547703,2290,1553,3843,-
chr2,61868593,1.3205551883674818,1997,1359,3356,-
chr2,61872533,2.099345156889495,1853,1465,3318,-
chr2,61873025,1.4597776899081765,2244,1404,3648,-
chr2,61873026,1.3812189242887256,1801,1436,3237,-
chr2,61876199,1.5701472995090016,1498,1221,2719,-
chr2,61876223,1.6562824841504584,3691,2573,6264,-
chr2,61876971,1.3743708865660087,2099,1322,3421,-
chr2,61877004,0.6511044218406908,3125,2359,5484,-
chr2,61877005,1.4473214285714284,1620,1343,2963,-
chr2,61877402,1.4493361285814117,1036,953,1989,-
chr2,61878953,1.552173033577992,2883,2287,5170,-
chr2,61878955,1.552173033577992,2883,2287,5170,-
chr2,61878965,1.6539753639417691,1265,939,2204,-
chr2,61878977,1.4674365665426683,1761,1161,2922,-
chr2,61880378,2.335054080629302,1356,1016,2372,-
chr2,61883517,2.3007662835249043,1200,971,2171,-
chr2,61883542,0.6734578381437464,1119,991,2110,-
chr2,61885054,1.601952246318162,2009,1718,3727,-
chr2,61885057,0.6640958832725378,1415,1009,2424,-
chr2,61888397,1.5085725677830943,986,835,1821,-
chr2,61888412,0.7050301810865192,875,769,1644,-
chr2,61888424,1.5402260077584753,760,538,1298,-
chr2,61888433,1.8668770190068362,709,492,1201,-
chr2,61888439,1.7895752895752897,926,517,1443,-
chr2,61888445,1.7610773243435707,3078,1907,4985,-
chr2,61888447,1.8000000000000003,1799,949,2748,-
chr2,61888514,1.7841324860388983,1089,576,1665,-
chr2,61888561,1.779004600585529,817,796,1613,-
chr2,61888580,1.5032487309644669,870,590,1460,-
chr2,61888588,2.7555555555555555,639,599,1238,-
chr2,61888596,0.42973124300111987,920,563,1483,-
chr2,61888610,0.5804668879031503,1599,1302,2901,-
chr2,61888613,1.107829850688051,1260,1071,2331,-
chr2,61888614,1.2618550008167861,1482,1269,2751,-
chr2,61888617,1.903225245145446,726,552,1278,-
chr2,61888619,1.6095216296635386,585,513,1098,-
chr2,63622416,0.7774326084778035,861,586,1447,-
chr2,63622417,0.7774326084778035,861,586,1447,-
chr2,63920585,1.8635006634232638,910,645,1555,-
chr2,63920588,1.5819262959620377,1428,1123,2551,-
chr2,63920591,2.3049627371273713,1600,1311,2911,-
chr2,63920592,2.382056557062659,2101,1686,3787,-
chr2,63920593,2.382056557062659,2101,1686,3787,-
chr2,63920594,2.5056609064460718,1553,1213,2766,-
chr2,63920595,1.633015873015873,642,419,1061,-
chr2,63920602,1.1586368977673325,985,551,1536,-
chr2,63920604,1.1586368977673325,985,551,1536,-
chr2,64632410,1.761872133944346,738,422,1160,-
chr2,65087420,2.0402149392595925,725,520,1245,-
chr2,65088049,1.466421793694521,1238,1088,2326,-
chr2,65088358,1.7030308734939756,977,663,1640,-
chr2,65088362,1.9807824296499656,1183,751,1934,-
chr2,65088474,1.7738052917576557,943,678,1621,-
chr2,65088554,1.9173041541590006,791,448,1239,-
chr2,65088593,0.5928929167660386,677,598,1275,-
chr2,65089069,1.7862999734066127,1714,777,2491,-
chr2,65091054,1.550952276183908,4740,2737,7477,-
chr2,65091056,1.5411307277050983,5319,3089,8408,-
chr2,65091057,1.608961303462322,1579,981,2560,-
chr2,65091061,1.444186448158738,2033,1270,3303,-
chr2,65091071,1.9788949897048729,1820,1115,2935,-
chr2,65104781,1.6296378440332506,2220,1471,3691,-
chr2,65130061,1.820022083179978,644,428,1072,-
chr2,65130067,1.8920451053155452,1272,762,2034,-
chr2,65130099,3.107530898234518,940,432,1372,-
chr2,69325489,1.924580103359173,700,515,1215,-
chr2,69325502,1.5774058577405856,753,477,1230,-
chr2,69325616,2.3231138568954295,794,510,1304,-
chr2,69326154,0.9462592804111934,788,514,1302,-
chr2,69326155,0.9462592804111934,788,514,1302,-
chr2,69327019,0.6815880332632595,1187,727,1914,-
chr2,69327021,0.5894407561074227,1510,932,2442,-
chr2,69327023,0.33528526016396193,667,416,1083,-
chr2,69328343,1.5682430197303852,647,432,1079,-
chr2,69328389,0.39040928724067164,785,535,1320,-
chr2,69348226,1.5923564738045084,1798,1683,3481,-
chr2,69348228,1.6465217601197228,2661,2436,5097,-
chr2,69348230,1.6553567477876103,2568,2259,4827,-
chr2,69348231,1.725762262483429,1697,1459,3156,-
chr2,69348236,1.576809696270771,1391,1085,2476,-
chr2,69348324,1.4215789632334608,813,471,1284,-
chr2,69374016,3.160782879092738,639,496,1135,-
chr2,69374052,1.0576416665979462,760,522,1282,-
chr2,70210867,1.0719298287171237,1716,1433,3149,-
chr2,70236164,1.2595876483661987,651,462,1113,-
chr2,70236166,1.8159407607397229,674,440,1114,-
chr2,70288107,1.8781675444698405,944,693,1637,-
chr2,70288121,0.5372642373191724,1140,888,2028,-
chr2,70288134,1.8262768256619435,1333,1025,2358,-
chr2,70288136,0.538274303313298,773,490,1263,-
chr2,70288138,1.624385447394297,707,564,1271,-
chr2,70288144,1.1067251461988303,756,474,1230,-
chr2,70288145,1.1067251461988303,756,474,1230,-
chr2,70288148,2.199312714776632,639,387,1026,-
chr2,70288149,2.6256892873765785,1114,757,1871,-
chr2,70288161,1.020408163265306,639,447,1086,-
chr2,70288162,1.020408163265306,639,447,1086,-
chr2,70293700,2.100827008043503,1158,678,1836,-
chr2,70293701,1.4459284232365146,1651,963,2614,-
chr2,70293703,1.1075324675324676,1065,615,1680,-
chr2,70296180,2.9358132749817654,574,456,1030,-
chr2,70296181,2.126618086695407,852,665,1517,-
chr2,70296469,6.881883858989727,622,525,1147,-
chr2,70296748,4.0501355013550135,853,491,1344,-
chr2,70296750,4.0501355013550135,853,491,1344,-
chr2,71110099,4.827024827024828,592,545,1137,-
chr2,71110104,2.342581824223293,563,462,1025,-
chr2,71110109,2.6158207142505296,1525,1000,2525,-
chr2,71110111,2.674666666666667,1002,599,1601,-
chr2,71984368,1.5919190985742697,621,527,1148,-
chr2,71984369,0.8611287254280279,678,512,1190,-
chr2,71984371,0.49377059759642816,1051,720,1771,-
chr2,73730659,1.7472766884531592,801,526,1327,-
chr2,73730704,2.065372829417773,673,444,1117,-
chr2,73732221,1.836201079622132,621,493,1114,-
chr2,74135547,1.1557924380695963,882,732,1614,-
chr2,74145228,2.345152603231598,824,556,1380,-
chr2,74145230,2.345152603231598,824,556,1380,-
chr2,74145233,0.4904835031876776,619,550,1169,-
chr2,74145234,1.10404667514399,737,460,1197,-
chr2,74145235,0.8008956404791847,1356,1010,2366,-
chr2,74155022,1.7829808870040593,704,479,1183,-
chr2,74156579,0.5561357702349871,638,382,1020,-
chr2,74172607,1.8313543279986235,625,446,1071,-
chr2,74172680,1.7597566986168547,862,650,1512,-
chr2,74365977,1.7257973778224973,8343,5233,13576,-
chr2,74365978,2.0491261613283465,3995,2643,6638,-
chr2,74365979,2.0491261613283465,3995,2643,6638,-
chr2,74365985,1.7555205047318612,1133,633,1766,-
chr2,74366006,1.8779500652940884,3394,1674,5068,-
chr2,74366008,1.8779500652940884,3394,1674,5068,-
chr2,74366014,0.586983802375032,1870,1162,3032,-
chr2,74366015,0.586983802375032,1870,1162,3032,-
chr2,74366268,2.1283783783783785,727,480,1207,-
chr2,74366271,0.5372633596932662,943,427,1370,-
chr2,74366272,0.5372633596932662,943,427,1370,-
chr2,74366305,2.4819402825040777,743,434,1177,-
chr2,74367782,2.299054742752067,619,407,1026,-
chr2,74370203,1.6174436407792618,850,610,1460,-
chr2,74370204,1.5640923248941776,1151,658,1809,-
chr2,74370218,0.3845371752439051,1110,810,1920,-
chr2,74370222,1.8433554292929288,993,767,1760,-
chr2,74370223,2.2380690305841653,2316,1126,3442,-
chr2,74370224,2.2380690305841653,2316,1126,3442,-
chr2,74370225,2.2380690305841653,2316,1126,3442,-
chr2,74370283,1.1973039215686274,976,543,1519,-
chr2,74370284,1.1973039215686274,976,543,1519,-
chr2,74370663,3.6733193277310923,641,423,1064,-
chr2,74371090,1.7556090527156722,1021,773,1794,-
chr2,74371093,2.584285362044876,668,528,1196,-
chr2,74371095,2.512685628201487,1006,766,1772,-
chr2,74377701,3.39390142021721,624,398,1022,-
chr2,74377702,3.39390142021721,624,398,1022,-
chr2,74461176,0.26492898044173424,474,790,1264,-
chr2,74461177,1.2384470442310056,1082,1043,2125,-
chr2,74461178,0.2386991709435452,690,1191,1881,-
chr2,74461180,0.4305730276073982,1425,1799,3224,-
chr2,74461255,19.0328915376237,3462,4039,7501,-
chr2,74461256,19.856861611416942,3844,4114,7958,-
chr2,74461257,20.624733904355345,4126,4153,8279,-
chr2,74461258,44.83578104138852,1543,748,2291,-
chr2,74461259,53.584229390681,1149,247,1396,-
chr2,74461260,12.530131695150896,2845,467,3312,-
chr2,74461261,9.803774286494507,3428,547,3975,-
chr2,74461262,7.270943971728679,1629,214,1843,-
chr2,74461263,8.123791315708115,3335,523,3858,-
chr2,74461265,7.729324457029686,1334,230,1564,-
chr2,74461407,2.1517168215151417,908,650,1558,-
chr2,74461553,2.0317249240121584,929,657,1586,-
chr2,74461554,1.5984436195363938,1247,905,2152,-
chr2,74461559,1.580777637941313,644,486,1130,-
chr2,74461734,1.7170447299749567,902,675,1577,-
chr2,74462287,1.673203602870695,718,626,1344,-
chr2,74462436,1.9609872408339217,864,595,1459,-
chr2,74462495,0.36781034762362014,2661,2006,4667,-
chr2,74462496,0.3312660310512489,1919,1464,3383,-
chr2,74462503,1.2840481019994203,708,475,1183,-
chr2,74462504,1.2840481019994203,708,475,1183,-
chr2,74462556,1.4659630919468665,672,510,1182,-
chr2,74462586,2.9007149349952006,863,554,1417,-
chr2,74462835,0.6762196827240565,3075,2390,5465,-
chr2,74462836,0.7141946836730027,1802,1624,3426,-
chr2,74462837,0.7926001217522755,1885,1420,3305,-
chr2,74462838,0.9075016389348485,683,621,1304,-
chr2,74463282,1.9168178284529669,568,453,1021,-
chr2,74472146,3.3399379295408305,681,617,1298,-
chr2,74472147,3.654528267172784,1122,946,2068,-
chr2,74472586,1.6140235737611242,1886,1516,3402,-
chr2,74472588,2.1466619318181817,779,703,1482,-
chr2,74505632,3.0451692709916838,619,453,1072,-
chr2,74506773,3.7926748055691446,757,495,1252,-
chr2,74506865,1.882018250134192,745,689,1434,-
chr2,74507051,2.338600568326645,631,443,1074,-
chr2,74527014,2.1395848800108914,792,562,1354,-
chr2,74527025,2.0053255870249336,653,458,1111,-
chr2,74527026,2.0053255870249336,653,458,1111,-
chr2,74527516,2.319935691318328,739,621,1360,-
chr2,74527517,2.319935691318328,739,621,1360,-
chr2,74527526,3.182926829268293,637,491,1128,-
chr2,74527527,3.182926829268293,637,491,1128,-
chr2,74527582,2.154710075357835,878,711,1589,-
chr2,74527584,1.1059093789607095,606,525,1131,-
chr2,74528294,3.0874861310572603,784,515,1299,-
chr2,74528479,2.239707696241919,677,429,1106,-
chr2,74528882,3.395321822025025,614,500,1114,-
chr2,74529165,3.0913294940908154,727,523,1250,-
chr2,84423661,1.717046979865772,983,744,1727,-
chr2,84423726,1.1371989186890623,935,802,1737,-
chr2,84423727,1.1371989186890623,935,802,1737,-
chr2,84425481,0.5818296929408041,918,584,1502,-
chr2,84425493,1.1422135524116834,1251,968,2219,-
chr2,84431642,1.6313691064047695,891,700,1591,-
chr2,84431648,2.2803324099722992,685,569,1254,-
chr2,84441061,1.5935954791617613,845,547,1392,-
chr2,84441090,1.814282072387152,1355,965,2320,-
chr2,84441277,0.5615662265271623,722,508,1230,-
chr2,84443297,1.9369156837046744,1303,762,2065,-
chr2,84443298,1.9369156837046744,1303,762,2065,-
chr2,84449738,1.8492019066245136,853,588,1441,-
chr2,84778030,0.8779973221893131,540,502,1042,-
chr2,85320436,5.945319469290401,645,430,1075,-
chr2,85341605,0.4052312859232679,676,498,1174,-
chr2,85342252,0.36872523195087936,1135,1236,2371,-
chr2,85342253,0.4077080706179067,738,731,1469,-
chr2,85342269,0.41705160909941835,1243,1705,2948,-
chr2,85342270,0.4473610232623516,877,1115,1992,-
chr2,85342271,0.4473610232623516,877,1115,1992,-
chr2,85342296,0.5458089668615985,327,1106,1433,-
chr2,85342297,3.5385658968788976,528,1435,1963,-
chr2,85342298,0.5458089668615985,327,1106,1433,-
chr2,85342306,0.22444599292594603,573,1373,1946,-
chr2,85342316,10.434023960525794,608,1189,1797,-
chr2,85342440,4.087019606872548,760,424,1184,-
chr2,85342441,7.286748501982077,916,522,1438,-
chr2,85549964,2.2093218559731262,618,432,1050,-
chr2,85549966,2.2093218559731262,618,432,1050,-
chr2,85608361,6.743991838055293,573,738,1311,-
chr2,85608365,8.231599452183522,1082,707,1789,-
chr2,85608366,7.813229571984436,752,513,1265,-
chr2,85608367,9.062521779669215,890,553,1443,-
chr2,86144294,2.2315749380694934,759,574,1333,-
chr2,86144490,2.23757492981258,796,572,1368,-
chr2,86144492,2.23757492981258,796,572,1368,-
chr2,86144731,3.4858387799564268,499,509,1008,-
chr2,86144732,3.4858387799564268,499,509,1008,-
chr2,86147761,2.54068412684745,1480,1052,2532,-
chr2,86170801,0.22520452446831019,911,712,1623,-
chr2,86171229,2.0030565295460208,649,462,1111,-
chr2,86179553,2.684763292764052,648,451,1099,-
chr2,86181314,0.3682478706998933,577,492,1069,-
chr2,86181323,1.5134338168826222,672,633,1305,-
chr2,86605363,2.9477466977466977,606,428,1034,-
chr2,86605372,1.5757508548059336,1154,823,1977,-
chr2,86605381,1.047232063103151,884,601,1485,-
chr2,86605385,1.6273179945054943,668,415,1083,-
chr2,86605386,1.6273179945054943,668,415,1083,-
chr2,95087290,1.1718857467077686,686,492,1178,-
chr2,95087379,0.6120879120879121,556,454,1010,-
chr2,95087470,1.6777065527065524,672,431,1103,-
chr2,95087475,2.414966584103182,1507,918,2425,-
chr2,95087476,2.7780032467532463,924,559,1483,-
chr2,95087559,1.6768154046279917,918,610,1528,-
chr2,95101721,0.7242798353909465,755,566,1321,-
chr2,95108366,2.1084208270837803,2049,1435,3484,-
chr2,95108391,1.5085836909871246,2963,1863,4826,-
chr2,95108393,1.5085836909871246,2963,1863,4826,-
chr2,95108403,2.9618304172274565,1195,742,1937,-
chr2,95108405,2.460098109595597,1002,596,1598,-
chr2,95109929,1.6592980414969944,994,572,1566,-
chr2,95109951,1.6430184194890078,891,560,1451,-
chr2,95109955,0.5483554080146337,851,556,1407,-
chr2,95109973,0.5566433566433566,596,454,1050,-
chr2,95115135,2.7165662650602407,621,414,1035,-
chr2,95117941,1.8588483187512632,915,623,1538,-
chr2,96184976,1.2472119158295458,628,477,1105,-
chr2,96184979,0.34807872539831297,618,484,1102,-
chr2,96184980,0.34807872539831297,618,484,1102,-
chr2,96184997,2.5827154356816617,784,571,1355,-
chr2,96186517,2.6242026023256293,1370,980,2350,-
chr2,96193153,3.1900683121130586,589,425,1014,-
chr2,96195372,2.719580919120565,700,472,1172,-
chr2,96195399,1.0422463768115942,756,459,1215,-
chr2,96195400,1.0422463768115942,756,459,1215,-
chr2,96195519,1.4471044804074118,802,572,1374,-
chr2,96274885,4.675958188153309,609,409,1018,-
chr2,96274886,4.675958188153309,609,409,1018,-
chr2,96275062,2.815221238938053,963,564,1527,-
chr2,96275063,1.7288245593661082,1550,1166,2716,-
chr2,96275064,0.33359518198481275,587,602,1189,-
chr2,96277096,0.21026711312736307,555,452,1007,-
chr2,96277199,0.3219602977667494,691,495,1186,-
chr2,96277200,0.3219602977667494,691,495,1186,-
chr2,96278704,3.1076584022038567,607,394,1001,-
chr2,96278978,2.5663474692202466,669,429,1098,-
chr2,96278979,2.5663474692202466,669,429,1098,-
chr2,96286414,1.041212711016141,689,510,1199,-
chr2,96289069,1.2489239973036739,631,444,1075,-
chr2,96290464,2.018055386606441,557,454,1011,-
chr2,96290800,4.259121191789327,558,500,1058,-
chr2,96291434,3.5274324551093827,634,502,1136,-
chr2,96293074,1.4331704695808747,1258,1081,2339,-
chr2,96293076,1.9724137931034489,779,695,1474,-
chr2,96295635,1.2949216448686227,627,413,1040,-
chr2,96295637,1.2949216448686227,627,413,1040,-
chr2,96296950,1.2524146854678164,1370,835,2205,-
chr2,96296956,1.840858767854817,1228,742,1970,-
chr2,96296957,1.4432078669085864,1817,1086,2903,-
chr2,96297012,0.3768584356819651,582,441,1023,-
chr2,96297013,0.3768584356819651,582,441,1023,-
chr2,96297040,2.3282580458940685,716,532,1248,-
chr2,96297041,2.3282580458940685,716,532,1248,-
chr2,96301666,1.1296758104738154,603,400,1003,-
chr2,96301667,1.1296758104738154,603,400,1003,-
chr2,97656677,2.720317903023278,694,437,1131,-
chr2,97656812,9.329337782784762,1189,1206,2395,-
chr2,97656813,9.329337782784762,1189,1206,2395,-
chr2,99170554,1.4957265604873542,2268,1713,3981,-
chr2,99170557,1.6292213707081866,4165,3004,7169,-
chr2,99170558,1.6292213707081866,4165,3004,7169,-
chr2,99170561,2.0130287907250493,1965,1362,3327,-
chr2,99170564,2.1623278626674214,1833,1177,3010,-
chr2,99170567,1.5609875575585384,1694,864,2558,-
chr2,99171361,1.264031874817017,1239,595,1834,-
chr2,99174004,2.030267865329412,788,548,1336,-
chr2,99180905,2.620718422709355,642,426,1068,-
chr2,99327620,1.3792643988580793,771,683,1454,-
chr2,101037651,2.4940347071583515,656,460,1116,-
chr2,101037652,2.4940347071583515,656,460,1116,-
chr2,101276756,1.37732204107633,693,420,1113,-
chr2,105361020,1.3713628975715468,2844,2163,5007,-
chr2,105361096,1.4111846779923776,3610,2259,5869,-
chr2,105361097,1.3797924405425726,4723,3785,8508,-
chr2,105361115,1.3630060983997434,4328,3389,7717,-
chr2,105361249,0.7502039111760184,4563,3404,7967,-
chr2,105361283,0.6285152409046214,1597,1304,2901,-
chr2,105361415,1.5003232540126121,3761,2507,6268,-
chr2,105361417,0.6169538304176072,2454,1771,4225,-
chr2,105361421,0.660535651999097,4075,3319,7394,-
chr2,105361422,0.965937109347492,3503,2581,6084,-
chr2,105363369,1.5917134716106165,2445,1906,4351,-
chr2,105363371,1.5917134716106165,2445,1906,4351,-
chr2,105363425,1.4688187820983123,1308,985,2293,-
chr2,105363427,1.7032810271041368,1193,700,1893,-
chr2,105363449,1.0768604714520829,2639,1753,4392,-
chr2,105367630,1.245483557482135,3198,2380,5578,-
chr2,105367666,1.4415161140890744,1957,1655,3612,-
chr2,105367684,1.5795154497188855,5024,3669,8693,-
chr2,105367729,1.6842820730671195,1238,1069,2307,-
chr2,105367730,1.165035705963234,5723,4149,9872,-
chr2,105373576,1.8848235599990548,1944,1566,3510,-
chr2,105373675,0.7032946734433425,1932,1513,3445,-
chr2,105373687,2.9577081000373266,1342,892,2234,-
chr2,105373703,3.0972919418758256,956,756,1712,-
chr2,105386404,1.5462085308056868,1594,1265,2859,-
chr2,105386530,1.320360170367867,5699,4203,9902,-
chr2,105386532,1.3537904088753105,7260,5273,12533,-
chr2,105386533,1.303492247553824,3268,2251,5519,-
chr2,105398991,1.9736632639021743,1152,855,2007,-
chr2,105398992,1.8541959681200184,903,631,1534,-
chr2,106145290,2.02869478662457,857,786,1643,-
chr2,106145291,1.9731285988483684,513,520,1033,-
chr2,106166070,2.1420137113791964,928,715,1643,-
chr2,106166071,1.899698741804005,669,512,1181,-
chr2,109543628,1.075817674304299,1230,823,2053,-
chr2,109546087,4.349656803291473,753,468,1221,-
chr2,110641073,2.215855927474886,1804,1350,3154,-
chr2,110641078,1.9953579817961904,1915,1562,3477,-
chr2,110641079,1.9953579817961904,1915,1562,3477,-
chr2,110641080,1.9953579817961904,1915,1562,3477,-
chr2,110657099,2.3401662049861494,659,474,1133,-
chr2,110657100,2.3401662049861494,659,474,1133,-
chr2,110658626,1.0555256064690026,978,664,1642,-
chr2,110658628,1.0555256064690026,978,664,1642,-
chr2,110658653,3.279702261666189,715,498,1213,-
chr2,110658655,1.8859498446690897,1380,945,2325,-
chr2,110658734,1.9265835357728889,683,526,1209,-
chr2,110660030,2.905923344947736,694,409,1103,-
chr2,110661601,2.72371409485638,702,498,1200,-
chr2,110661608,2.466403162055336,675,428,1103,-
chr2,110661626,1.0191743548318524,921,546,1467,-
chr2,110661627,1.0191743548318524,921,546,1467,-
chr2,110674201,0.3317877382792375,919,646,1565,-
chr2,110674202,0.48320166282880045,1567,1086,2653,-
chr2,110674203,0.5483893780276511,1192,856,2048,-
chr2,110674204,0.7272033283713119,865,638,1503,-
chr2,111429465,1.7581006647673316,1267,1052,2319,-
chr2,111429466,1.7581006647673316,1267,1052,2319,-
chr2,111429557,1.6879341394391565,728,675,1403,-
chr2,111429580,3.4326097930338206,799,565,1364,-
chr2,111494898,2.169966494060311,547,468,1015,-
chr2,111494919,1.788949275362319,631,383,1014,-
chr2,111494926,1.7327002213420484,1539,1101,2640,-
chr2,112756358,1.968498479193209,671,598,1269,-
chr2,120222325,1.593820938297405,786,614,1400,-
chr2,120222341,2.7382721536685843,1303,789,2092,-
chr2,120222342,2.4729050799329126,998,564,1562,-
chr2,121730952,2.0328559058541864,1645,1147,2792,-
chr2,121730960,0.5024079540158459,692,470,1162,-
chr2,121736797,2.129074409095548,698,556,1254,-
chr2,121736807,2.855810818081734,1004,728,1732,-
chr2,121736810,0.4293806696580596,1365,1032,2397,-
chr2,121736811,0.3144376033764584,1028,816,1844,-
chr2,127048410,1.2155097649603144,2406,1858,4264,-
chr2,127048411,0.885401597176721,1586,1158,2744,-
chr2,127048413,1.3725006102852106,5623,5354,10977,-
chr2,127048414,1.375131055433612,5171,5041,10212,-
chr2,127048415,1.421708383838646,4813,4759,9572,-
chr2,127048418,2.814758092586146,878,844,1722,-
chr2,127048447,0.45326648207737785,672,580,1252,-
chr2,127048493,2.071236559139785,535,495,1030,-
chr2,127048495,2.071236559139785,535,495,1030,-
chr2,127070597,1.9417513168012526,6418,3160,9578,-
chr2,127070598,1.866033945901607,16984,10296,27280,-
chr2,127070599,1.9206072690249434,18660,11669,30329,-
chr2,127070600,1.9583063498112712,7872,3642,11514,-
chr2,127070601,2.257880960509844,3409,2870,6279,-
chr2,127070602,1.7666463954002654,3672,1614,5286,-
chr2,127070622,0.59061004784689,1184,455,1639,-
chr2,127070628,1.3190474358481128,2448,1528,3976,-
chr2,127070629,1.3190474358481128,2448,1528,3976,-
chr2,127070775,2.877803572684683,2201,1362,3563,-
chr2,127070777,2.4792645556690496,1775,978,2753,-
chr2,127070778,2.132978191522415,1889,1026,2915,-
chr2,127070792,2.14017521902378,1259,713,1972,-
chr2,127070793,2.14017521902378,1259,713,1972,-
chr2,127070799,3.340408163265306,991,489,1480,-
chr2,127070801,3.340408163265306,991,489,1480,-
chr2,127076643,0.4686758356773888,689,403,1092,-
chr2,127106907,4.15409148762153,674,491,1165,-
chr2,127481158,1.9115226337448563,928,728,1656,-
chr2,127481159,1.9115226337448563,928,728,1656,-
chr2,127486581,1.8904729790389225,685,438,1123,-
chr2,127489203,1.715724654654373,777,524,1301,-
chr2,127493363,1.94958440530378,1064,651,1715,-
chr2,127493397,0.9169840060929172,1203,605,1808,-
chr2,127493398,1.5333798422164497,2287,1298,3585,-
chr2,127498207,2.463239807504818,718,478,1196,-
chr2,127502843,0.6770917634773529,1620,814,2434,-
chr2,127502846,2.0852119737795025,3140,2197,5337,-
chr2,127502847,2.0852119737795025,3140,2197,5337,-
chr2,127502853,1.4914426737020414,2810,1740,4550,-
chr2,127502854,1.4914426737020414,2810,1740,4550,-
chr2,127504728,3.7278187154356495,619,544,1163,-
chr2,127504854,1.170036166835792,802,556,1358,-
chr2,127504856,1.8229480250559988,1188,830,2018,-
chr2,127504875,1.2336959963484277,1096,756,1852,-
chr2,127504876,0.9513297230174884,787,546,1333,-
chr2,127504934,2.4931377143267395,1135,1009,2144,-
chr2,127504978,3.0683417085427136,851,596,1447,-
chr2,127504979,3.0683417085427136,851,596,1447,-
chr2,127504980,3.0683417085427136,851,596,1447,-
chr2,127505462,2.082707215265355,658,558,1216,-
chr2,127505463,0.4678179824561403,741,569,1310,-
chr2,127505464,2.045857307249712,960,789,1749,-
chr2,127505465,1.0731338294229607,1363,1058,2421,-
chr2,127706538,0.7836767454266125,1245,951,2196,-
chr2,127706539,0.5369671203612636,957,732,1689,-
chr2,127722617,1.215745384489536,606,411,1017,-
chr2,127723346,4.849241215657491,502,511,1013,-
chr2,127724364,0.1575479237870097,535,622,1157,-
chr2,127847348,1.7971349055332317,2046,1418,3464,-
chr2,127847352,1.7305522964051965,1676,1198,2874,-
chr2,127847353,1.0936401406200065,1710,1042,2752,-
chr2,127847354,1.7305522964051965,1676,1198,2874,-
chr2,127847355,1.0936401406200065,1710,1042,2752,-
chr2,127847358,0.47331509410518446,964,679,1643,-
chr2,127847360,1.6639793614962914,644,442,1086,-
chr2,127847370,2.0182120312719776,887,614,1501,-
chr2,127864533,3.0919540229885056,806,521,1327,-
chr2,127864534,3.0919540229885056,806,521,1327,-
chr2,127864572,0.25853874912869906,679,366,1045,-
chr2,127864573,1.5440492507410541,1829,963,2792,-
chr2,127864574,2.679334916864608,845,420,1265,-
chr2,127864575,1.8647697741627842,1480,779,2259,-
chr2,127942031,4.0851111400473386,679,534,1213,-
chr2,131048489,1.3610437362358967,663,497,1160,-
chr2,131051700,7.920770951004163,958,834,1792,-
chr2,131051703,7.039727182790584,908,646,1554,-
chr2,131051856,18.62671806438984,845,686,1531,-
chr2,131484068,3.0378863443828057,582,450,1032,-
chr2,131484086,1.514993481095176,1161,648,1809,-
chr2,131484087,1.514993481095176,1161,648,1809,-
chr2,131484088,1.514993481095176,1161,648,1809,-
chr2,131492260,2.4500885922077678,649,518,1167,-
chr2,135840749,2.560934489402697,685,518,1203,-
chr2,135840879,2.2250872137115123,814,693,1507,-
chr2,135846340,0.5658520583893718,689,468,1157,-
chr2,135848087,0.5936842105263158,704,499,1203,-
chr2,135848143,1.5885072066820578,16279,12242,28521,-
chr2,135848145,1.57989370895883,26130,19019,45149,-
chr2,135848146,1.8126032195689608,11063,8915,19978,-
chr2,135848147,0.6765260545905708,1703,974,2677,-
chr2,135848148,1.6947145760631661,17103,12488,29591,-
chr2,135848149,1.7350833055699997,10085,7468,17553,-
chr2,135848150,1.7350833055699997,10085,7468,17553,-
chr2,135848168,1.1170897651222502,8098,4951,13049,-
chr2,135848169,1.3517459007005044,6821,4204,11025,-
chr2,135848179,1.87953795379538,3684,2221,5905,-
chr2,135848181,1.7793978266071266,5401,3201,8602,-
chr2,135848182,1.596281361463292,4389,2604,6993,-
chr2,135851453,2.183327731092437,1381,849,2230,-
chr2,135851474,0.5726435152374202,807,580,1387,-
chr2,135851487,1.7329192546583854,665,517,1182,-
chr2,135852885,1.5279477644716424,1185,832,2017,-
chr2,135856757,0.6458340503148983,852,592,1444,-
chr2,135856844,0.4621245421245422,663,524,1187,-
chr2,135856857,1.9395689846700737,872,642,1514,-
chr2,135856880,2.026985271397672,655,510,1165,-
chr2,135857979,1.7060437276581593,661,522,1183,-
chr2,135857994,2.0631086871834827,661,452,1113,-
chr2,135859351,0.4068904068904069,684,517,1201,-
chr2,135862622,1.7064670511719229,817,561,1378,-
chr2,135862654,1.4719257292370824,1100,854,1954,-
chr2,135862694,1.8641269841269843,733,377,1110,-
chr2,135862737,0.49995660098949746,719,561,1280,-
chr2,135865117,1.937022900763359,769,523,1292,-
chr2,135866181,1.8043154761904765,581,447,1028,-
chr2,135866224,1.1529845338689606,1366,1036,2402,-
chr2,135866259,2.1034307681148907,999,810,1809,-
chr2,135866260,2.1034307681148907,999,810,1809,-
chr2,135866665,1.344692209933116,1209,827,2036,-
chr2,135868837,1.869177253478524,726,455,1181,-
chr2,135870307,1.5342231523070642,2072,1487,3559,-
chr2,135870319,1.3936153846153847,1646,1199,2845,-
chr2,135870330,1.4792332268370612,1388,938,2326,-
chr2,135870359,1.5213414634146347,997,719,1716,-
chr2,135870360,1.5881546476556074,723,520,1243,-
chr2,135872741,0.5536895231465366,908,662,1570,-
chr2,135876422,0.7127098252707903,1215,935,2150,-
chr2,135907088,0.6304235043551867,887,690,1577,-
chr2,135907178,0.9582672167565852,1097,821,1918,-
chr2,135907180,0.9582672167565852,1097,821,1918,-
chr2,135911183,2.0747500581260168,660,505,1165,-
chr2,135912548,2.4628178474332323,615,480,1095,-
chr2,135914499,2.7958579881656807,699,519,1218,-
chr2,135914501,1.7065637065637067,662,517,1179,-
chr2,135916341,1.6783795228908862,2393,2004,4397,-
chr2,135916346,1.351896474788041,2163,1742,3905,-
chr2,135916347,0.7228428614350877,1653,1180,2833,-
chr2,135916356,2.2600185883767976,1878,1406,3284,-
chr2,135916362,1.683296847795292,3025,2042,5067,-
chr2,135922821,2.1693511705685617,6791,6499,13290,-
chr2,135922822,1.9257655066851194,13453,12015,25468,-
chr2,135922824,2.1632227121833347,6532,6022,12554,-
chr2,135922836,1.3387362096138693,2638,1879,4517,-
chr2,135922837,1.7882719109789018,2596,2016,4612,-
chr2,135922842,1.7394851574020644,2308,1732,4040,-
chr2,135922869,1.3965424632462649,3509,2337,5846,-
chr2,135922871,1.2776304992716618,8026,5663,13689,-
chr2,135922873,1.0157939857557372,2933,1783,4716,-
chr2,135922891,0.5613354037267081,1204,735,1939,-
chr2,135922893,0.6770486454110254,2294,1632,3926,-
chr2,135922894,0.6770486454110254,2294,1632,3926,-
chr2,135922895,1.718911888049158,1143,1036,2179,-
chr2,135922912,1.963064295485636,909,730,1639,-
chr2,135924428,1.4749894612585424,2633,2269,4902,-
chr2,135924431,1.5476523476523478,1290,1000,2290,-
chr2,135924442,1.832683138274816,1056,768,1824,-
chr2,135924454,1.6156939909068484,2103,1624,3727,-
chr2,135924461,2.3784852905070304,1900,1406,3306,-
chr2,135924492,1.1463964059232477,1784,1294,3078,-
chr2,135932835,2.260182275298554,1178,859,2037,-
chr2,135932837,2.1414035307966834,1771,1258,3029,-
chr2,135933964,0.7592848262482543,7589,4386,11975,-
chr2,135933965,0.7768712126106344,11982,7619,19601,-
chr2,135933969,1.2271103771411014,3758,2492,6250,-
chr2,135933970,1.4049773441770508,3031,1792,4823,-
chr2,135933985,1.3464419475655431,2156,1205,3361,-
chr2,135943393,1.5799150870858825,2362,1533,3895,-
chr2,135943423,2.376347876575979,1925,1506,3431,-
chr2,135943426,0.7525544682921554,1739,1395,3134,-
chr2,135943431,0.4844456691117784,1544,1267,2811,-
chr2,135943439,0.6809492353270878,1236,1085,2321,-
chr2,135943472,0.3608967291436971,981,906,1887,-
chr2,135961408,1.893767378163704,2342,1869,4211,-
chr2,135961410,1.8909410197408256,1486,1076,2562,-
chr2,135961459,0.529481733220051,778,534,1312,-
chr2,135979328,2.711036303944721,1418,1121,2539,-
chr2,135983423,2.2052478134110785,731,489,1220,-
chr2,135983452,2.1698821266247985,972,774,1746,-
chr2,135985422,2.7646938775510197,873,489,1362,-
chr2,135985423,2.7646938775510197,873,489,1362,-
chr2,135985481,0.5872966467892529,612,731,1343,-
chr2,135985496,5.341664006436422,457,570,1027,-
chr2,135985513,0.3409613087032442,529,557,1086,-
chr2,135985514,0.406108585047548,974,1123,2097,-
chr2,135985538,4.218007202881152,575,475,1050,-
chr2,135985539,6.143084922954442,2166,1762,3928,-
chr2,135985540,6.143084922954443,2166,1762,3928,-
chr2,135985541,8.332488780316577,1616,1147,2763,-
chr2,135985543,10.491024893940857,1630,549,2179,-
chr2,135985544,21.78754057599733,1237,370,1607,-
chr2,135985547,12.401544387157314,940,212,1152,-
chr2,136114564,2.000748502994012,593,500,1093,-
chr2,136114587,1.8679245283018868,725,529,1254,-
chr2,136114770,2.524586620555496,729,486,1215,-
chr2,136114772,2.524586620555496,729,486,1215,-
chr2,136114881,1.712293388429752,662,439,1101,-
chr2,136115036,0.5085987548450462,751,562,1313,-
chr2,136115470,2.9267791970802923,657,547,1204,-
chr2,136115472,2.9267791970802923,657,547,1204,-
chr2,136115727,1.7544541626174277,676,440,1116,-
chr2,136115793,1.75412147505423,598,460,1058,-
chr2,136115883,2.5379588877063908,1004,725,1729,-
chr2,136118148,0.9531318900539758,1470,592,2062,-
chr2,136200448,1.5009507147842198,5566,4452,10018,-
chr2,136200449,1.4248954297428174,9452,7051,16503,-
chr2,136200450,1.4069819212022785,7196,5670,12866,-
chr2,136200451,1.4426056161018723,5233,4052,9285,-
chr2,136200453,0.7041541340901657,2405,1446,3851,-
chr2,136200454,0.6837722982655531,1349,825,2174,-
chr2,136200458,0.9851235218883928,3429,2173,5602,-
chr2,136200460,0.7666131076014683,6304,4028,10332,-
chr2,136200461,0.8118405481158518,5666,3704,9370,-
chr2,136200462,0.802791579340578,7035,4738,11773,-
chr2,136200463,0.7577633319508489,6170,4248,10418,-
chr2,136200465,0.7657379128040948,2482,1715,4197,-
chr2,138288531,0.3370490189183487,638,481,1119,-
chr2,138288532,0.40460695705413563,944,709,1653,-
chr2,147938311,0.8573420712358341,587,494,1081,-
chr2,147943493,1.8959222380275005,726,443,1169,-
chr2,149068731,2.2638983050847457,721,471,1192,-
chr2,149068740,1.1439030547841451,787,465,1252,-
chr2,149068741,1.1439030547841451,787,465,1252,-
chr2,149570063,3.2107791446983014,805,568,1373,-
chr2,149571150,3.0261064425770314,843,594,1437,-
chr2,149576452,1.5797988808693535,998,648,1646,-
chr2,149576517,2.108490566037736,744,529,1273,-
chr2,149579490,0.6034843205574912,865,573,1438,-
chr2,149579530,0.5138499844382197,634,458,1092,-
chr2,149579533,2.3987756264236904,580,438,1018,-
chr2,149582214,3.2642526964560865,668,353,1021,-
chr2,149582265,2.580396093171622,822,652,1474,-
chr2,150468851,0.5165346410159688,631,481,1112,-
chr2,150469064,1.9260893546607831,775,517,1292,-
chr2,150469302,0.6453252032520326,634,491,1125,-
chr2,150469633,0.9208488013585228,1043,750,1793,-
chr2,150469634,1.0244739853860376,861,613,1474,-
chr2,150470235,0.38068012466926365,1194,1003,2197,-
chr2,150471655,0.319812155854962,1016,716,1732,-
chr2,150471730,0.887903852260416,1083,853,1936,-
chr2,150471731,0.43601559730591993,819,650,1469,-
chr2,150486756,0.4615384615384615,855,641,1496,-
chr2,150486757,0.4615384615384615,855,641,1496,-
chr2,150487350,1.5171448353054446,677,478,1155,-
chr2,151275647,2.5127386113012395,1179,973,2152,-
chr2,151275778,0.6743715000595735,1131,762,1893,-
chr2,151275787,1.7083783783783781,902,599,1501,-
chr2,151275805,1.9662319280153675,747,470,1217,-
chr2,152655720,0.6137109517442567,593,432,1025,-
chr2,152658019,1.8401818336723326,6267,4546,10813,-
chr2,152658971,1.6299763856091125,2172,1564,3736,-
chr2,152658988,1.3309796999117385,1884,1132,3016,-
chr2,152658994,1.5891989664082689,1336,859,2195,-
chr2,152659110,2.3499098326341947,3218,1782,5000,-
chr2,152659147,2.553155442609064,1506,786,2292,-
chr2,152659177,0.39233393538029293,781,452,1233,-
chr2,152659183,0.6086291309669523,584,429,1013,-
chr2,152659304,1.630307295331926,694,440,1134,-
chr2,152663671,0.7327493444073363,1584,1150,2734,-
chr2,152663673,1.5151391162029462,965,623,1588,-
chr2,152663678,1.5809203412231163,773,573,1346,-
chr2,152663687,2.3632258064516134,665,464,1129,-
chr2,152663923,0.5068791909098438,813,644,1457,-
chr2,152671369,1.7473453749315817,693,434,1127,-
chr2,152672586,2.0462478184991277,535,572,1107,-
chr2,152676523,2.0333880719753537,686,491,1177,-
chr2,157211446,1.353505601280224,1106,908,2014,-
chr2,157211447,1.157067862034928,1316,1072,2388,-
chr2,160273657,0.23424464918571708,642,1297,1939,-
chr2,160273696,0.1714143296643444,694,1810,2504,-
chr2,160273697,0.19534883720930232,503,1375,1878,-
chr2,160273698,0.19534883720930232,503,1375,1878,-
chr2,160273699,0.1823771580910529,391,1206,1597,-
chr2,160273703,8.395364980445386,452,1143,1595,-
chr2,164573712,0.6653507096572641,1614,1549,3163,-
chr2,164573713,0.70555940587332,1179,1290,2469,-
chr2,164573714,0.6966771205970965,2093,2112,4205,-
chr2,164573715,1.0932080161269102,1805,1650,3455,-
chr2,164573716,0.8847253160447796,1165,1187,2352,-
chr2,167955417,2.49787003854216,696,642,1338,-
chr2,168876140,1.7921430542186079,1115,686,1801,-
chr2,168876143,3.390825688073395,791,435,1226,-
chr2,169811851,1.950124393204887,949,691,1640,-
chr2,169819577,2.197908286403861,682,451,1133,-
chr2,169819609,1.9161899290067212,1331,896,2227,-
chr2,169819638,1.7135506003430534,665,476,1141,-
chr2,169821234,1.8940140319450665,792,608,1400,-
chr2,169821992,0.635621052631579,628,474,1102,-
chr2,169822015,1.978635522005412,603,412,1015,-
chr2,169824592,1.8868262572375016,1101,812,1913,-
chr2,169824607,2.596877613604683,689,421,1110,-
chr2,169824608,2.596877613604683,689,421,1110,-
chr2,171517272,0.6031283138918345,1429,942,2371,-
chr2,171517273,2.0590435781269556,1164,930,2094,-
chr2,171517274,0.6031283138918345,1429,942,2371,-
chr2,171517277,3.0903010033444813,769,597,1366,-
chr2,171517295,3.7311262376237626,777,403,1180,-
chr2,171517297,3.7311262376237626,777,403,1180,-
chr2,171517388,1.4849179597381037,2129,1806,3935,-
chr2,171517390,1.3699672730040338,1999,1876,3875,-
chr2,171517406,1.6072665691632666,1739,1180,2919,-
chr2,171517409,1.814128256513026,1325,997,2322,-
chr2,171517414,1.340558994252983,3796,2831,6627,-
chr2,171517415,1.340558994252983,3796,2831,6627,-
chr2,171517452,1.1837381721856541,844,741,1585,-
chr2,171517736,0.9705220033694355,4489,5214,9703,-
chr2,171517737,0.9698486291614115,5907,6237,12144,-
chr2,173918762,2.519276598211403,743,553,1296,-
chr2,173918763,2.343823592378506,804,518,1322,-
chr2,174075190,0.5084325396825397,901,615,1516,-
chr2,174075207,1.704047352985488,945,683,1628,-
chr2,174075217,1.87966379087229,657,466,1123,-
chr2,174075454,2.7923135769064285,1346,895,2241,-
chr2,174079040,0.4911887694145758,597,431,1028,-
chr2,174081977,1.7365176236143984,714,517,1231,-
chr2,174082035,0.5767338908017707,669,427,1096,-
chr2,174082038,2.174828375286041,593,436,1029,-
chr2,174123656,1.8091743119266055,985,544,1529,-
chr2,174123661,2.3573790951638065,1020,640,1660,-
chr2,174141927,3.235270700636943,773,627,1400,-
chr2,174223103,2.4189723320158105,781,505,1286,-
chr2,174229420,2.024933636708381,688,585,1273,-
chr2,174350718,1.7278151558981778,1969,1019,2988,-
chr2,174350719,1.5133145920066677,2575,1357,3932,-
chr2,174350721,1.782434586132462,2128,1065,3193,-
chr2,174350722,1.8024258630497692,1778,874,2652,-
chr2,174351630,2.587675739520651,1966,963,2929,-
chr2,174351631,2.6811097708082023,1763,828,2591,-
chr2,174351633,1.7407355032299183,1580,731,2311,-
chr2,174395617,3.884351486838546,633,422,1055,-
chr2,175179206,1.3054292733202502,3272,2067,5339,-
chr2,175179224,1.4385375852279925,6717,4884,11601,-
chr2,175180145,0.5833763685189011,1771,1503,3274,-
chr2,175180150,0.6604862286505616,1716,1205,2921,-
chr2,175180162,0.6537610888321789,1453,1054,2507,-
chr2,175180168,1.5570416209202516,1247,931,2178,-
chr2,175181395,1.5889084507042253,1139,851,1990,-
chr2,175181427,0.605332446921301,2240,1548,3788,-
chr2,175181428,2.176713034518289,844,646,1490,-
chr2,175181433,2.564002345124096,819,601,1420,-
chr2,175181701,1.5952514058337992,1154,646,1800,-
chr2,175181708,0.877201237311027,1935,1092,3027,-
chr2,175181709,0.7098909987844068,2748,1848,4596,-
chr2,176201003,1.3240667773766044,13783,11704,25487,-
chr2,176201005,1.636495345298543,4891,5072,9963,-
chr2,176201008,1.3711721172308922,4296,3374,7670,-
chr2,176201011,1.2960928455661032,3843,2467,6310,-
chr2,176201012,1.0465687298867388,3349,2839,6188,-
chr2,176201013,1.400554899406575,11345,8170,19515,-
chr2,176201014,1.2251890525105829,16776,12954,29730,-
chr2,176201015,1.332069891711354,13331,10159,23490,-
chr2,176201016,1.15610599078341,4013,3303,7316,-
chr2,176201044,1.9873263465756759,1358,745,2103,-
chr2,176201045,1.6828383314109958,1186,866,2052,-
chr2,176201114,1.1904052443384985,7190,5033,12223,-
chr2,176201115,1.2521364119776155,5524,4785,10309,-
chr2,176201186,1.0403490918244966,45942,30530,76472,-
chr2,176201187,0.9904364286371109,18952,12500,31452,-
chr2,176201209,0.6513140524145274,10408,7171,17579,-
chr2,176201210,1.2989328640437507,15200,13911,29111,-
chr2,176201211,1.0551013992840568,25608,21082,46690,-
chr2,176201220,1.2275705467857454,17057,12834,29891,-
chr2,176201221,1.2868960009164299,17659,13788,31447,-
chr2,176201223,1.4388480797118717,7765,5990,13755,-
chr2,176201224,1.2142923976608189,2805,1799,4604,-
chr2,176201226,1.4103551251008877,5409,3303,8712,-
chr2,176201227,0.9688020644704691,9879,6875,16754,-
chr2,176201228,1.2581161754557595,13421,8568,21989,-
chr2,176201229,1.107815863998014,15384,10023,25407,-
chr2,176201230,1.2645889526156202,8528,4935,13463,-
chr2,176201231,0.8910883376322123,2541,1893,4434,-
chr2,176201232,1.1922346913726485,7252,4448,11700,-
chr2,176201233,1.387079370979566,2805,1687,4492,-
chr2,176201235,1.337180044445741,3523,2044,5567,-
chr2,176201241,0.4700098328416912,716,338,1054,-
chr2,176201249,0.4833911377694879,1213,717,1930,-
chr2,176201251,0.5566252886836028,786,432,1218,-
chr2,177230637,0.49565785268657336,1371,910,2281,-
chr2,177230844,2.3398617511520743,676,433,1109,-
chr2,177231121,1.970169677066229,625,405,1030,-
chr2,177231191,0.5976824457593688,712,506,1218,-
chr2,177231267,2.1763435395756576,570,462,1032,-
chr2,177231390,1.9752596146432448,618,432,1050,-
chr2,177231531,1.520909844336683,785,477,1262,-
chr2,177231690,1.4733107703123258,707,565,1272,-
chr2,177232510,2.3365384615384617,566,467,1033,-
chr2,177232511,2.3365384615384617,566,467,1033,-
chr2,178431636,3.0482411054001743,611,454,1065,-
chr2,178447529,3.003012653143201,622,382,1004,-
chr2,178447530,3.003012653143201,622,382,1004,-
chr2,178447571,1.6029837813743946,756,511,1267,-
chr2,178450400,1.263711398271012,596,409,1005,-
chr2,178478521,3.3650403517263556,2508,2110,4618,-
chr2,178478522,3.3808032207216105,1554,1337,2891,-
chr2,179986792,2.1287234042553194,927,751,1678,-
chr2,179986793,2.1287234042553194,927,751,1678,-
chr2,179986798,1.82787972888361,1212,820,2032,-
chr2,179988625,5.09251093381566,706,395,1101,-
chr2,180872765,0.6630352460329602,6711,5862,12573,-
chr2,180872766,0.6630352460329602,6711,5862,12573,-
chr2,180872767,0.5002018105287436,2081,2213,4294,-
chr2,180872772,0.5680936995153473,540,618,1158,-
chr2,180872775,1.4476225264773734,3295,2540,5835,-
chr2,180872777,1.4767122710120792,4797,3648,8445,-
chr2,180872778,1.58640024467326,3077,2307,5384,-
chr2,180872782,0.9238254971705248,2610,1951,4561,-
chr2,180872788,1.748124936530734,1927,1241,3168,-
chr2,180872789,1.748124936530734,1927,1241,3168,-
chr2,180872794,1.783609022556391,817,474,1291,-
chr2,180872802,0.5432937181663837,639,371,1010,-
chr2,180872803,0.8004495367578531,470,628,1098,-
chr2,180872804,0.8004495367578531,470,628,1098,-
chr2,180872805,0.8004495367578531,470,628,1098,-
chr2,180873158,1.0482075658546246,1413,1154,2567,-
chr2,180873159,0.9430651757828161,7761,5352,13113,-
chr2,180873160,1.0008175492317375,4531,2775,7306,-
chr2,180873161,0.8177149859635312,3805,2665,6470,-
chr2,182201713,2.7210653785328325,954,685,1639,-
chr2,182201751,1.5979742122165759,2396,1541,3937,-
chr2,182201752,1.592955459409976,1660,1030,2690,-
chr2,182201766,2.0737786640079756,639,471,1110,-
chr2,182206043,1.7448442760942762,720,431,1151,-
chr2,182206046,1.8466485507246373,702,479,1181,-
chr2,182223889,0.5581629232316461,665,470,1135,-
chr2,182234461,2.053304430166448,1461,1063,2524,-
chr2,182234489,1.8054711246200608,593,422,1015,-
chr2,182234495,7.281191806331472,781,536,1317,-
chr2,182240289,4.427232600279893,624,521,1145,-
chr2,182426649,0.3617947747065506,636,416,1052,-
chr2,182426778,0.5897496052670778,2493,2003,4496,-
chr2,182426779,0.7931668880973178,2925,2333,5258,-
chr2,182426788,0.615603207051982,2033,1840,3873,-
chr2,182426790,0.6389250108365844,1607,1537,3144,-
chr2,182426804,0.6883278790712171,630,371,1001,-
chr2,182426809,2.2753658478380885,1080,623,1703,-
chr2,182426811,2.564402984094765,1734,1407,3141,-
chr2,182426812,1.682299736451394,1167,1206,2373,-
chr2,182426986,0.3651821871995859,682,528,1210,-
chr2,182925296,0.5561904761904762,875,559,1434,-
chr2,182928128,0.6025369978858351,702,472,1174,-
chr2,182930738,1.6952309985096867,699,487,1186,-
chr2,182930782,1.1177779622299577,860,619,1479,-
chr2,182935335,1.679136690647482,777,555,1332,-
chr2,182942149,1.2606171033469347,737,616,1353,-
chr2,182953289,1.2056249129063032,799,615,1414,-
chr2,182957504,1.7932109871656472,649,396,1045,-
chr2,182957526,1.3368352894750466,915,627,1542,-
chr2,182962263,1.9065145380934854,739,493,1232,-
chr2,182964704,2.2946258161727777,1292,904,2196,-
chr2,182964705,2.2946258161727777,1292,904,2196,-
chr2,182964711,1.768238557558946,1158,720,1878,-
chr2,182964713,1.8226136608489552,1674,1019,2693,-
chr2,182964714,1.690625,1081,639,1720,-
chr2,182967322,1.6087221095334685,720,492,1212,-
chr2,182982857,1.1983119053136602,1052,759,1811,-
chr2,182982860,2.3390681003584235,752,464,1216,-
chr2,182982861,0.5650763358778625,704,523,1227,-
chr2,182989156,0.8633858589623905,1355,921,2276,-
chr2,182989158,1.0561987457790645,1056,690,1746,-
chr2,182995809,1.979646349431234,1001,709,1710,-
chr2,183002034,1.984659635666347,689,595,1284,-
chr2,183002035,1.984659635666347,689,595,1284,-
chr2,183023823,0.5159090909090909,680,439,1119,-
chr2,183023836,3.3010960670535137,639,422,1061,-
chr2,183071936,2.2261993103147235,999,738,1737,-
chr2,183071951,2.69525443181318,579,535,1114,-
chr2,183071966,4.006704280773198,692,521,1213,-
chr2,183607692,0.42284281955651176,1852,1492,3344,-
chr2,183607711,0.6572555419556644,862,644,1506,-
chr2,183607731,0.8206752359417855,1481,1133,2614,-
chr2,183607733,0.6517402945113788,1497,1079,2576,-
chr2,183607734,0.3643892339544514,967,692,1659,-
chr2,183607761,1.5145448316062011,861,589,1450,-
chr2,183607762,1.3458958799105718,601,403,1004,-
chr2,183607836,1.6344667697063369,845,646,1491,-
chr2,183607852,1.6849427168576103,780,516,1296,-
chr2,183607893,0.3861390841725252,738,553,1291,-
chr2,183607895,0.598320124635914,802,517,1319,-
chr2,183607900,1.0627144229449703,1935,1734,3669,-
chr2,183607902,0.9284459819768178,2485,2174,4659,-
chr2,183607910,1.3474126578356185,1264,992,2256,-
chr2,183607911,1.3474126578356185,1264,992,2256,-
chr2,183607912,1.3474126578356185,1264,992,2256,-
chr2,183607917,1.6188986232790987,596,563,1159,-
chr2,183607920,0.5814967665078284,993,903,1896,-
chr2,183607921,0.5814967665078284,993,903,1896,-
chr2,183608131,1.7568093560030087,1973,1449,3422,-
chr2,183608132,1.7297849912797356,1653,1280,2933,-
chr2,183608154,0.5847331959894322,693,406,1099,-
chr2,187464345,2.181580120347671,954,640,1594,-
chr2,187464390,0.6150975015234613,849,546,1395,-
chr2,187464738,1.8055555555555558,714,431,1145,-
chr2,187464810,2.3068324717060222,634,420,1054,-
chr2,187464905,0.6154384830855419,913,713,1626,-
chr2,187465139,2.374923965816683,977,754,1731,-
chr2,187465562,1.4759937032664308,576,483,1059,-
chr2,187466088,2.0772676387032685,878,525,1403,-
chr2,187467778,1.484646257233526,2193,1460,3653,-
chr2,187467824,1.5081967213114753,1954,1524,3478,-
chr2,187478788,2.324140068174775,749,460,1209,-
chr2,187478795,1.6806990687587702,774,602,1376,-
chr2,187478796,1.9853876336084428,637,388,1025,-
chr2,187496999,1.8525732806798083,10250,10751,21001,-
chr2,187497007,1.4344601822552554,18489,19231,37720,-
chr2,187497008,1.4314375898986351,8422,7685,16107,-
chr2,187497012,1.9457216174790841,12797,13335,26132,-
chr2,187497033,3.2088310539173257,3776,3998,7774,-
chr2,187503711,1.5001768195774015,31603,17693,49296,-
chr2,187513629,0.3268655541561713,754,396,1150,-
chr2,187513636,1.9454930317013874,2710,1581,4291,-
chr2,187513637,1.9454930317013874,2710,1581,4291,-
chr2,187513643,1.0505395426919524,1024,643,1667,-
chr2,187529385,1.3349860838596517,1627,964,2591,-
chr2,187554267,0.6553827248326488,9701,5456,15157,-
chr2,187554269,0.6553827248326488,9701,5456,15157,-
chr2,187554420,2.50009998400256,1666,1315,2981,-
chr2,187554430,1.480708388106776,3079,2079,5158,-
chr2,187554434,1.2893491718253305,1618,1074,2692,-
chr2,187554437,1.2810807035747422,1365,886,2251,-
chr2,187554444,2.2082273112807465,761,523,1284,-
chr2,187554447,0.8381280041199357,1685,1087,2772,-
chr2,187554448,0.8353448552216524,2516,1616,4132,-
chr2,187554449,0.8381280041199357,1685,1087,2772,-
chr2,187554478,0.9067185218009962,634,384,1018,-
chr2,189032784,2.2706539074960133,618,417,1035,-
chr2,189032832,1.7296296296296296,1400,1079,2479,-
chr2,189033005,1.869375907111756,827,476,1303,-
chr2,189033438,0.9772123584509996,931,621,1552,-
chr2,189033440,0.9772123584509996,931,621,1552,-
chr2,189033445,2.8713408234821873,1164,737,1901,-
chr2,189033446,3.336225596529283,768,460,1228,-
chr2,189033916,0.7097057356608477,2155,1603,3758,-
chr2,189033963,2.4433970470825264,2352,1838,4190,-
chr2,189033994,1.8482949308755758,812,650,1462,-
chr2,189034144,1.725146198830409,825,531,1356,-
chr2,189034176,1.5564971751412429,835,648,1483,-
chr2,189034215,1.7574626865671645,784,535,1319,-
chr2,189035128,0.5082987245454598,1520,1180,2700,-
chr2,189036690,2.124165824064712,807,644,1451,-
chr2,189036691,1.7900677200902937,731,442,1173,-
chr2,189039330,2.593824661644275,1130,932,2062,-
chr2,189039331,0.7103703703703703,958,737,1695,-
chr2,189041660,2.2414965986394555,658,524,1182,-
chr2,189041661,2.349083695817829,835,638,1473,-
chr2,189042756,1.719317864131954,614,510,1124,-
chr2,189043242,3.3074380165289257,551,483,1034,-
chr2,189043249,0.9142382710628799,956,718,1674,-
chr2,189043254,1.0438969130557916,775,427,1202,-
chr2,189043256,1.0438969130557916,775,427,1202,-
chr2,189045214,1.9504761904761905,575,449,1024,-
chr2,189045216,2.254226139577715,796,660,1456,-
chr2,189045218,2.024429608015739,1550,1181,2731,-
chr2,189045219,2.6710310965630115,764,610,1374,-
chr2,189050668,1.4264169578876769,644,406,1050,-
chr2,189052992,0.707732351413144,863,717,1580,-
chr2,189053462,1.2287635494278393,1222,927,2149,-
chr2,189053464,1.0567388580633614,983,754,1737,-
chr2,189053924,1.4918477356354145,763,554,1317,-
chr2,189057011,0.5991541353383458,679,447,1126,-
chr2,189060744,0.5945701357466063,583,441,1024,-
chr2,189063040,2.1522251576998928,684,453,1137,-
chr2,189064024,0.9260032086020898,959,773,1732,-
chr2,189068061,1.5132987425743072,1177,878,2055,-
chr2,189080016,2.989581568492571,641,470,1111,-
chr2,189081033,2.348841722254149,1073,833,1906,-
chr2,189083998,0.5113828412367034,642,478,1120,-
chr2,189084022,1.1238532110091743,734,653,1387,-
chr2,189084023,1.1238532110091743,734,653,1387,-
chr2,189098741,3.550352292269209,678,485,1163,-
chr2,189110328,1.4476956604774112,941,761,1702,-
chr2,189110435,2.1911351784997994,1310,830,2140,-
chr2,189110436,2.544338259491692,2005,1335,3340,-
chr2,189771816,1.8719347326775,1293,1022,2315,-
chr2,189775641,0.46298491379310336,660,463,1123,-
chr2,189782531,3.1225644587970955,1033,660,1693,-
chr2,189782573,1.7335190303283277,557,448,1005,-
chr2,190249692,1.9848923175827708,649,365,1014,-
chr2,190249693,1.9848923175827708,649,365,1014,-
chr2,190296881,2.013012503370863,1078,768,1846,-
chr2,190974842,1.441343607351513,654,435,1089,-
chr2,190977006,3.2600387921996226,559,477,1036,-
chr2,190982395,0.7625352469501179,571,455,1026,-
chr2,190985653,2.5324108325064207,708,366,1074,-
chr2,190985655,3.264628278752134,808,378,1186,-
chr2,190998267,1.8835156889506435,3360,3597,6957,-
chr2,190998268,1.8127158145952194,2292,2553,4845,-
chr2,190998271,1.7575140664322784,1995,2026,4021,-
chr2,190998273,1.7549538319103852,4694,4554,9248,-
chr2,190998274,1.7220118338404227,3662,3482,7144,-
chr2,190998279,1.5042490294422723,1949,1999,3948,-
chr2,190998283,0.6827714447408845,981,1084,2065,-
chr2,190999666,1.9963235294117647,542,495,1037,-
chr2,190999685,2.563459444595393,782,654,1436,-
chr2,191013559,2.7405707729815005,734,366,1100,-
chr2,191013560,2.7405707729815005,734,366,1100,-
chr2,191013561,2.7405707729815005,734,366,1100,-
chr2,196766704,2.218722908961746,595,421,1016,-
chr2,196773056,1.660189952676862,705,564,1269,-
chr2,196793035,3.0442767598987666,782,1794,2576,-
chr2,196793036,3.0404028638890748,644,1386,2030,-
chr2,196793037,3.4574118371042983,881,1942,2823,-
chr2,197392399,1.6714864864864862,650,443,1093,-
chr2,197392411,1.6351418616226983,875,573,1448,-
chr2,197392995,2.6798816568047337,646,519,1165,-
chr2,197393057,2.3015604890604893,922,591,1513,-
chr2,197393090,3.0538872891814077,927,571,1498,-
chr2,197396149,2.5445682451253484,1217,717,1934,-
chr2,197396227,1.900452125485837,1598,1161,2759,-
chr2,197398002,1.6492445601098817,670,476,1146,-
chr2,197398027,2.3701298701298703,583,439,1022,-
chr2,197398042,1.3807322863788947,1500,1081,2581,-
chr2,197398054,1.831968761808792,1211,933,2144,-
chr2,197398108,1.8384615384615388,955,649,1604,-
chr2,197401453,1.744971264367816,1387,927,2314,-
chr2,197401756,1.3382240319199425,1736,1322,3058,-
chr2,197401852,1.4821235102925243,1151,851,2002,-
chr2,197402037,0.6024702028932764,980,757,1737,-
chr2,197402062,2.6447254612245423,930,767,1697,-
chr2,197402111,1.7651497148288977,802,525,1327,-
chr2,197402781,1.4482968575584343,891,628,1519,-
chr2,197403022,5.6756756756756745,629,443,1072,-
chr2,197403605,2.004885197850513,1367,889,2256,-
chr2,197403606,1.8607222673307218,2215,1411,3626,-
chr2,197405310,0.4606234715923929,1337,1093,2430,-
chr2,197405352,2.033849684452094,708,497,1205,-
chr2,197405411,1.887390149192724,5540,4283,9823,-
chr2,197405412,1.5265702541521957,11069,7776,18845,-
chr2,197405425,0.7255709976298211,2045,1455,3500,-
chr2,197405442,1.5837985893197344,2975,1890,4865,-
chr2,197405449,0.7224091911338052,1991,1230,3221,-
chr2,197408051,1.956498446373085,829,548,1377,-
chr2,197408064,1.7809152872444012,707,473,1180,-
chr2,197408104,2.2172588832487308,623,393,1016,-
chr2,197408488,0.539333562349708,784,567,1351,-
chr2,197416758,1.7966060856395425,1429,1075,2504,-
chr2,197416760,1.7966060856395425,1429,1075,2504,-
chr2,197416762,0.567762105569289,821,597,1418,-
chr2,197416764,1.8111888111888117,665,467,1132,-
chr2,197416769,1.7988911290322582,829,495,1324,-
chr2,197416801,1.2944328755110521,1274,878,2152,-
chr2,197416818,0.5781557329630915,788,602,1390,-
chr2,197416819,1.4958866498999928,1684,1085,2769,-
chr2,197416821,2.2401960784313726,913,628,1541,-
chr2,197418530,1.9797802197802201,562,454,1016,-
chr2,197420466,1.9766361524798468,850,562,1412,-
chr2,197420510,1.7517050691244243,883,619,1502,-
chr2,197420539,1.803892366720517,1742,1237,2979,-
chr2,197420540,1.8386566630405166,2530,1868,4398,-
chr2,197421041,0.6623376623376623,968,664,1632,-
chr2,197421108,1.6942677879562946,1250,838,2088,-
chr2,197421119,1.0484543136157245,1203,698,1901,-
chr2,197421120,1.0484543136157245,1203,698,1901,-
chr2,197423927,2.0787028602659867,814,498,1312,-
chr2,197435003,1.7040178571428573,693,419,1112,-
chr2,197435023,0.4867261904761905,628,419,1047,-
chr2,197486790,1.436342022220571,4640,3519,8159,-
chr2,197486823,1.6518727345952475,1708,954,2662,-
chr2,197486953,0.7667748634100119,3587,2569,6156,-
chr2,197486964,1.811627609168908,2020,1506,3526,-
chr2,197486968,1.4780083777608533,1799,1312,3111,-
chr2,197487018,0.6311357853342586,1794,1440,3234,-
chr2,197487020,0.6311357853342586,1794,1440,3234,-
chr2,197487021,0.6158875449493298,627,436,1063,-
chr2,197487046,0.534329947539652,2381,2524,4905,-
chr2,197487047,0.5343299475396521,2381,2524,4905,-
chr2,197487048,0.46840915751223455,1779,1896,3675,-
chr2,197487050,0.3089221824686941,920,687,1607,-
chr2,197487051,0.24492774777404758,838,662,1500,-
chr2,197487052,1.1290258650008473,2233,2559,4792,-
chr2,197487053,1.265713343045411,2212,2630,4842,-
chr2,197487054,1.8324944375622385,2126,2620,4746,-
chr2,197487055,3.081360048573164,874,1219,2093,-
chr2,197487057,3.134985783386702,526,529,1055,-
chr2,197487984,1.4163775361932045,2461,1812,4273,-
chr2,197489143,0.8141383263278563,3550,2616,6166,-
chr2,197489245,1.7378196695591306,2795,1861,4656,-
chr2,197490240,0.7630805352924748,2014,1398,3412,-
chr2,197493407,1.5590904741726923,4472,2945,7417,-
chr2,197493435,1.2484974539195297,4580,2864,7444,-
chr2,197494228,1.4150485436893203,1748,1132,2880,-
chr2,197494233,1.822441553262549,913,742,1655,-
chr2,197494238,1.6745007820537086,3225,2134,5359,-
chr2,197494240,1.5543331881297495,3544,2208,5752,-
chr2,197494241,1.5209212903385227,5643,3821,9464,-
chr2,197494243,1.5988677680058594,3026,2157,5183,-
chr2,197494244,1.7084011326765494,4755,3144,7899,-
chr2,197494246,1.3735901255586296,2978,1650,4628,-
chr2,197494247,1.2806640575039008,2634,1412,4046,-
chr2,197494248,1.2806640575039008,2634,1412,4046,-
chr2,197494249,1.2039990753582988,1893,1007,2900,-
chr2,197495336,1.8498632063215492,2858,1736,4594,-
chr2,197495337,0.7945205479452054,1333,1021,2354,-
chr2,197495338,1.8498632063215492,2858,1736,4594,-
chr2,197495344,2.2083981337480565,1135,642,1777,-
chr2,197495351,1.5370312499999998,1092,767,1859,-
chr2,197495356,1.6954761485653935,902,436,1338,-
chr2,197495361,2.272265625,830,383,1213,-
chr2,197497342,0.9768762289029146,6583,5242,11825,-
chr2,197497376,1.7688344401190752,2206,1587,3793,-
chr2,197497381,1.5364815947619064,4993,3370,8363,-
chr2,197497389,0.7474048442906575,2015,1699,3714,-
chr2,197498756,0.6371719307519492,2042,1644,3686,-
chr2,197498832,2.3133713561470213,1042,788,1830,-
chr2,197498838,1.7363040884408405,3331,1754,5085,-
chr2,197498840,1.7363040884408405,3331,1754,5085,-
chr2,197498848,0.35210981422732573,1488,1214,2702,-
chr2,197499816,2.019682923552331,1717,826,2543,-
chr2,197499817,2.173715248525695,2526,1186,3712,-
chr2,197499819,2.5036190476190474,1642,749,2391,-
chr2,197499832,2.2475385718058014,1323,540,1863,-
chr2,197499834,2.27092997680351,2759,1409,4168,-
chr2,197499835,2.357481452884984,1757,852,2609,-
chr2,197499839,0.6049370904143687,1012,488,1500,-
chr2,200853367,0.4366883116883117,537,483,1020,-
chr2,200853381,0.6138965201465202,1037,831,1868,-
chr2,200854641,2.2749636330476597,898,678,1576,-
chr2,200854661,2.190035906642729,786,556,1342,-
chr2,200854663,2.190035906642729,786,556,1342,-
chr2,200854682,0.42416186678481754,717,548,1265,-
chr2,200856901,0.5573605021606788,929,646,1575,-
chr2,200857996,2.3001167542323406,960,570,1530,-
chr2,200857997,2.3001167542323406,960,570,1530,-
chr2,200858065,1.973091510356053,852,590,1442,-
chr2,200861334,1.7553293032134902,612,448,1060,-
chr2,200861850,2.3611682435211847,1147,714,1861,-
chr2,200864605,2.2211538461538463,769,559,1328,-
chr2,200864611,2.7729003179872396,2142,1284,3426,-
chr2,200864613,2.7393480073974694,1936,1198,3134,-
chr2,200864615,2.836613331051596,1250,753,2003,-
chr2,200864621,2.422933111757374,863,331,1194,-
chr2,200864622,2.7232888769238466,2139,929,3068,-
chr2,200864623,2.7232888769238466,2139,929,3068,-
chr2,200864624,2.9571118349619976,837,306,1143,-
chr2,200864651,3.437669276312779,759,274,1033,-
chr2,200864657,0.8239763682578607,1109,397,1506,-
chr2,200871275,0.47663139841413993,1166,884,2050,-
chr2,200881431,1.9764705882352944,615,439,1054,-
chr2,200887653,2.2818207686302125,784,557,1341,-
chr2,200887654,2.321392463057356,966,627,1593,-
chr2,200958079,1.6358695652173914,644,599,1243,-
chr2,200958084,2.171761589403973,853,754,1607,-
chr2,200958085,2.171761589403973,853,754,1607,-
chr2,201639000,0.2551013835368859,617,431,1048,-
chr2,201639002,0.23255252642419877,779,537,1316,-
chr2,202206864,2.4036138249816155,714,500,1214,-
chr2,202207029,0.5587714808274498,3279,2272,5551,-
chr2,202207124,1.8316498316498315,679,593,1272,-
chr2,202207287,2.1072754946727548,1017,656,1673,-
chr2,202207292,1.8133333333333328,887,554,1441,-
chr2,202207295,1.9160896130346237,1679,981,2660,-
chr2,202207296,1.845710627400768,2479,1419,3898,-
chr2,202207298,1.8658458014174242,1628,915,2543,-
chr2,202207304,1.8729604367552262,1287,832,2119,-
chr2,202214398,2.238345864661654,686,398,1084,-
chr2,202214400,2.238345864661654,686,398,1084,-
chr2,202214406,0.2174222112692676,718,466,1184,-
chr2,202238537,1.468472719098325,597,407,1004,-
chr2,202880672,1.6967100078802209,688,422,1110,-
chr2,202880776,1.7588961510530141,691,458,1149,-
chr2,202882741,2.3296175513623916,1330,1009,2339,-
chr2,202884450,1.1369896768294787,583,428,1011,-
chr2,202884470,1.9200292947492643,903,639,1542,-
chr2,202899623,2.2174834854852588,1074,751,1825,-
chr2,202911642,2.364048650239677,605,476,1081,-
chr2,206124009,2.37534473248759,637,517,1154,-
chr2,206126558,0.35123339658444025,616,464,1080,-
chr2,206127817,0.4526822049574547,965,794,1759,-
chr2,206127874,2.253247360059808,2463,1826,4289,-
chr2,206127876,1.9588850004120182,3981,2892,6873,-
chr2,206127897,1.893553451157138,983,636,1619,-
chr2,206133001,1.7597511475793146,1349,1105,2454,-
chr2,206133004,0.5667016806722689,1078,781,1859,-
chr2,206133048,1.6296356275303645,693,493,1186,-
chr2,206142041,1.686785590032978,2167,1544,3711,-
chr2,206142752,2.123938030984508,849,521,1370,-
chr2,206145023,0.5138621022179364,608,487,1095,-
chr2,206149838,1.8796902918403808,788,583,1371,-
chr2,206152469,2.5243116578793203,833,568,1401,-
chr2,206153635,2.3021077283372366,982,487,1469,-
chr2,206153639,0.6945453161872334,3910,2227,6137,-
chr2,206153640,0.64307916955411,6601,3768,10369,-
chr2,206153641,0.64307916955411,6601,3768,10369,-
chr2,206159422,0.8930247718383311,720,471,1191,-
chr2,206159423,0.8240561109919585,1113,683,1796,-
chr2,206159424,0.6230195013609936,1196,702,1898,-
chr2,208236289,2.4609983308290753,609,491,1100,-
chr2,208242065,2.075118176428008,763,562,1325,-
chr2,208242109,2.0139344262295085,636,426,1062,-
chr2,208245350,1.3282312925170066,780,629,1409,-
chr2,208245352,1.3282312925170066,780,629,1409,-
chr2,208248497,1.7844378468782214,1158,804,1962,-
chr2,208248516,2.0941156217155856,872,605,1477,-
chr2,210433721,1.4848531211750309,1293,816,2109,-
chr2,210433792,2.8826469067723592,1639,828,2467,-
chr2,210433793,2.8826469067723592,1639,828,2467,-
chr2,210433796,3.2817725752508364,784,367,1151,-
chr2,210433802,3.898668639053255,752,337,1089,-
chr2,210433805,2.8486786018755335,1466,620,2086,-
chr2,210433806,2.8486786018755335,1466,620,2086,-
chr2,210441403,2.4664315070325014,624,444,1068,-
chr2,218269987,2.12458576469439,1009,863,1872,-
chr2,218269990,2.513387418570656,701,516,1217,-
chr2,219540377,1.537032284661155,685,555,1240,-
chr2,219568208,4.287634408602151,769,371,1140,-
chr2,219568209,3.780266835590176,1056,597,1653,-
chr2,222623720,2.754837677914601,593,480,1073,-
chr2,222623721,2.6428436831548128,1074,777,1851,-
chr2,222624344,2.2852622061482823,1010,710,1720,-
chr2,222624346,2.2852622061482823,1010,710,1720,-
chr2,222628884,1.8986767485822307,836,528,1364,-
chr2,222639683,1.5849218248018848,1775,1448,3223,-
chr2,222639687,1.4858311453342878,6386,4480,10866,-
chr2,222639688,1.4858311453342878,6386,4480,10866,-
chr2,222640874,1.500106052036199,1229,883,2112,-
chr2,222640882,0.556398583712696,1869,1317,3186,-
chr2,222640889,1.5015974440894568,939,625,1564,-
chr2,222640930,1.2694093682641963,827,489,1316,-
chr2,222642903,3.117251588912303,1171,726,1897,-
chr2,222648778,0.37237400436504836,892,645,1537,-
chr2,223975358,1.9109940750493741,1061,734,1795,-
chr2,223975375,2.4516695957820738,619,568,1187,-
chr2,223975395,1.8486328125,630,511,1141,-
chr2,223975672,2.0250019906043475,747,660,1407,-
chr2,223975877,2.3413940256045516,822,628,1450,-
chr2,223977586,2.3007856341189674,1024,659,1683,-
chr2,223977609,1.6223776223776225,927,571,1498,-
chr2,223980392,2.19391816589715,779,570,1349,-
chr2,223984776,1.5013652519031235,3227,2168,5395,-
chr2,223984826,1.6908280553600752,900,608,1508,-
chr2,223984832,1.8810971470315765,1626,1011,2637,-
chr2,223984836,3.2287562904385334,801,534,1335,-
chr2,223991850,1.9516557892192408,733,590,1323,-
chr2,223991880,1.618217054263566,667,515,1182,-
chr2,223991907,1.804270462633452,675,561,1236,-
chr2,223991968,0.6777082981240493,801,581,1382,-
chr2,223991983,1.8545871044902784,1233,904,2137,-
chr2,223991989,3.2757396449704133,691,389,1080,-
chr2,223991993,1.0782136105860114,1182,643,1825,-
chr2,223991995,0.8716276458075942,1722,1058,2780,-
chr2,223998251,1.7233603917021003,1069,795,1864,-
chr2,223998297,1.7029948608895975,619,512,1131,-
chr2,223998315,2.4568965517241383,569,463,1032,-
chr2,224001656,1.6010022464143772,1089,642,1731,-
chr2,224001677,1.6871219562632476,776,666,1442,-
chr2,224001680,1.0792008961481951,1281,820,2101,-
chr2,224001754,3.52667731629393,668,625,1293,-
chr2,224001810,0.21877498800575726,683,506,1189,-
chr2,224001835,1.8381455329725447,955,698,1653,-
chr2,230725427,0.5402019121524916,776,852,1628,-
chr2,230725430,1.3794992175273866,450,638,1088,-
chr2,230725432,3.452056993888708,2460,2507,4967,-
chr2,230725433,6.174989075569338,1075,1262,2337,-
chr2,230725434,2.8563531063531062,756,517,1273,-
chr2,230725445,1.2118704444566228,545,513,1058,-
chr2,231455088,1.3336201052016363,2640,1710,4350,-
chr2,231455168,1.4190965784594642,1870,1395,3265,-
chr2,231455196,0.6846633247527435,1122,1341,2463,-
chr2,231455201,0.6317873303167421,1116,883,1999,-
chr2,231455210,0.4647435897435897,869,1115,1984,-
chr2,231455222,0.6609682411023505,689,992,1681,-
chr2,231455229,3.4253983552281815,3038,3308,6346,-
chr2,231455230,3.789168552036199,1687,2175,3862,-
chr2,231455232,4.226089744389278,2200,2270,4470,-
chr2,231455235,3.166243679515639,2212,1850,4062,-
chr2,231455258,2.0648527786117388,1042,692,1734,-
chr2,231455259,3.037912578055308,972,825,1797,-
chr2,231455260,3.037912578055308,972,825,1797,-
chr2,231455264,6.57503481813058,736,610,1346,-
chr2,231455431,2.4771021817054972,2424,1768,4192,-
chr2,231455433,2.6032258064516127,806,619,1425,-
chr2,231455449,4.694691140372926,1002,699,1701,-
chr2,231455461,2.8785781668065558,914,599,1513,-
chr2,231455479,7.266678773655433,1568,983,2551,-
chr2,231457714,0.7932218282742431,4743,3410,8153,-
chr2,231458296,1.0344929906820672,4639,3405,8044,-
chr2,231458384,1.86176150363876,2287,1384,3671,-
chr2,231460527,1.5056126663596425,25573,22630,48203,-
chr2,231460528,1.4942258460851747,42310,36853,79163,-
chr2,231460529,1.5397551870568,33444,29310,62754,-
chr2,231460530,1.5195752520928703,24589,21313,45902,-
chr2,231460533,2.034171710642299,7190,6357,13547,-
chr2,231460534,2.034171710642299,7190,6357,13547,-
chr2,231460538,1.9016490954588336,3196,2565,5761,-
chr2,231460541,1.4513363626100702,5876,4428,10304,-
chr2,231460542,1.4513363626100702,5876,4428,10304,-
chr2,231460550,1.610406431886468,4985,3636,8621,-
chr2,231460551,1.591993542722819,7323,5269,12592,-
chr2,231460553,1.738994668026905,9647,6693,16340,-
chr2,231460554,1.7460624301472374,4580,3165,7745,-
chr2,231460557,2.1165203511572233,2175,1431,3606,-
chr2,231460726,2.0769146767617936,3457,2175,5632,-
chr2,231460807,1.5580000445617892,11991,8300,20291,-
chr2,231460823,1.3343482858930988,7647,5454,13101,-
chr2,231460824,1.3998586748943869,4013,3025,7038,-
chr2,231460856,0.9585458606251526,4443,3347,7790,-
chr2,231461573,1.780014803849001,1001,771,1772,-
chr2,231461647,0.508174139051332,1503,949,2452,-
chr2,231461648,2.0868813486060085,851,660,1511,-
chr2,231461655,2.7010408455551245,1804,1423,3227,-
chr2,231461723,2.4954407294832825,820,657,1477,-
chr2,231461731,2.628834355828221,856,651,1507,-
chr2,231461893,1.5492102492102493,1918,1109,3027,-
chr2,231461944,1.7366945703095005,922,897,1819,-
chr2,231461948,1.6210843373493977,896,829,1725,-
chr2,231461968,1.9603985956216439,882,806,1688,-
chr2,231462000,1.5159897665494084,1496,1061,2557,-
chr2,231463307,0.6850746268656717,1025,759,1784,-
chr2,231463313,1.716705970667145,1644,1081,2725,-
chr2,231464345,1.7233201581027666,653,505,1158,-
chr2,231464464,1.9471306471306473,861,454,1315,-
chr2,231464465,1.9471306471306473,861,454,1315,-
chr2,232479911,2.937692489931296,991,803,1794,-
chr2,232479948,1.7588448231803027,3412,2493,5905,-
chr2,232479949,1.9590738722887582,5238,3927,9165,-
chr2,232479950,1.815225364907305,6159,4636,10795,-
chr2,232479968,2.2103277060575968,717,529,1246,-
chr2,232479969,1.9898201394447779,1840,1311,3151,-
chr2,232479970,2.279865295994328,676,402,1078,-
chr2,232480183,2.4077134986225897,689,604,1293,-
chr2,232480231,1.7746815286624202,742,627,1369,-
chr2,232480241,2.2911815328541048,729,580,1309,-
chr2,232480440,1.4229549902152645,816,729,1545,-
chr2,232480733,1.4546965918536992,1649,1202,2851,-
chr2,232480755,0.6726396216117883,1304,955,2259,-
chr2,232480757,1.5454141880493653,2900,1608,4508,-
chr2,232480758,1.6437001756441632,4224,2322,6546,-
chr2,232480760,1.8048322147651008,2738,1489,4227,-
chr2,232480771,1.1502055336727788,4581,2859,7440,-
chr2,232480772,1.0748869625650264,3891,2292,6183,-
chr2,232480780,1.574277726001864,617,434,1051,-
chr2,232481515,2.203592814371257,1103,834,1937,-
chr2,232481533,1.8323785803237858,1050,802,1852,-
chr2,232481622,1.8842883115359803,1443,1155,2598,-
chr2,232481623,1.8105558511592064,1985,1623,3608,-
chr2,232481823,1.568693009118541,793,657,1450,-
chr2,232482560,1.9822425764514697,1176,966,2142,-
chr2,232482561,0.6281755196304849,951,865,1816,-
chr2,232482925,1.596156400832485,2420,2052,4472,-
chr2,232482926,1.596156400832485,2420,2052,4472,-
chr2,232482937,1.4570093457943925,1558,1069,2627,-
chr2,232482938,1.4709581945985943,1135,900,2035,-
chr2,232483115,0.6088092904452167,1661,1160,2821,-
chr2,232483134,1.6763697478991595,1038,849,1887,-
chr2,232483171,1.5036357680969537,1092,709,1801,-
chr2,232483174,1.814917982048901,1465,1076,2541,-
chr2,232483175,1.4529177080274849,2053,1558,3611,-
chr2,232483441,2.0445244410761654,980,608,1588,-
chr2,232483489,0.5609767025089606,658,557,1215,-
chr2,232483494,2.1475333177460842,834,610,1444,-
chr2,232484063,1.8543153526970957,1540,963,2503,-
chr2,232484064,0.6907712590639419,997,819,1816,-
chr2,232484065,1.8543153526970957,1540,963,2503,-
chr2,232484089,2.1117841409691627,766,453,1219,-
chr2,232484162,1.6140061213161485,4118,2948,7066,-
chr2,232484164,1.6140061213161485,4118,2948,7066,-
chr2,232484177,1.8480456026058638,1620,1227,2847,-
chr2,232484179,1.8480456026058638,1620,1227,2847,-
chr2,232484208,2.32078119518185,734,502,1236,-
chr2,232484211,1.7283875349222892,1635,985,2620,-
chr2,232484513,1.5095922459893047,960,747,1707,-
chr2,232484564,0.6205225203924813,904,768,1672,-
chr2,232484575,1.85625,890,783,1673,-
chr2,232484813,1.1402302637309945,1917,1665,3582,-
chr2,232484876,1.4708257621643448,929,761,1690,-
chr2,232484881,0.5612522361359571,1161,859,2020,-
chr2,232485013,1.375426039536469,1152,977,2129,-
chr2,232485023,1.3894849785407726,1294,931,2225,-
chr2,232485040,1.7218867736572594,1855,1572,3427,-
chr2,232485066,1.8676309162523408,1032,910,1942,-
chr2,232485071,1.4877087256748274,1287,884,2171,-
chr2,232485217,1.8480573041024528,1187,812,1999,-
chr2,232485266,1.635322733744661,744,601,1345,-
chr2,232485889,0.5998509687034278,804,670,1474,-
chr2,232485938,2.032882414151925,813,619,1432,-
chr2,232485940,2.1275673765528658,1287,1060,2347,-
chr2,232485955,0.4063592287743827,635,542,1177,-
chr2,232485956,0.44377898671162774,1139,845,1984,-
chr2,232485988,3.3299913728321586,612,494,1106,-
chr2,232486078,1.896484829673314,751,525,1276,-
chr2,232486079,1.896484829673314,751,525,1276,-
chr2,232486289,2.5423728813559316,767,471,1238,-
chr2,232486298,1.981380337636544,693,423,1116,-
chr2,232487038,0.8028578251870719,876,570,1446,-
chr2,232487040,0.8028578251870719,876,570,1446,-
chr2,232487072,1.5833088124639925,717,546,1263,-
chr2,233840663,1.4809751651856915,1039,692,1731,-
chr2,233840665,1.1045526018377476,1834,865,2699,-
chr2,233840667,1.1045526018377476,1834,865,2699,-
chr2,233840675,1.8825746799431007,1556,702,2258,-
chr2,233840676,1.8340606492183942,2293,1163,3456,-
chr2,233840694,0.4682454059098796,775,505,1280,-
chr2,233841712,2.1889000872211604,1031,864,1895,-
chr2,235882435,1.5266720549605983,656,706,1362,-
chr2,235882437,1.5266720549605983,656,706,1362,-
chr2,239961069,3.836538461538462,797,428,1225,-
chr2,239990134,1.4882908554422574,951,667,1618,-
chr2,240011682,2.194643413266895,782,506,1288,-
chr2,240011683,2.194643413266895,782,506,1288,-
chr2,240022188,2.45842988038665,1414,978,2392,-
chr2,240022189,2.075832213763249,817,608,1425,-
chr2,240022274,2.9119376428300914,878,655,1533,-
chr2,240130952,2.578214971209213,596,520,1116,-
chr2,240133961,0.4301865460712267,760,548,1308,-
chr2,240133963,0.6696989148304738,1576,1196,2772,-
chr2,241096399,1.9565525414721865,2755,1953,4708,-
chr2,241096400,2.1252818440970938,2434,1767,4201,-
chr2,241096416,3.792088963963964,868,443,1311,-
chr2,241096417,3.792088963963964,868,443,1311,-
chr2,241096424,2.122706791116833,712,477,1189,-
chr2,241096425,2.197428181880994,864,608,1472,-
chr2,241229384,2.2865153787091135,1073,729,1802,-
chr2,241229505,1.2937121195139514,1175,891,2066,-
chr2,241229506,0.9735413056036973,765,576,1341,-
chr2,241229507,2.4493554327808478,664,361,1025,-
chr2,241229528,0.3605279698302954,716,429,1145,-
chr2,241229630,2.8062322682548224,705,505,1210,-
chr2,241229660,2.9172219635199363,1297,838,2135,-
chr2,241229662,2.846905537459284,987,613,1600,-
chr2,241229917,1.0231617647058824,505,543,1048,-
chr2,241229919,1.9877671337271137,1099,978,2077,-
chr2,241229921,2.970183486238533,594,435,1029,-
chr2,241230909,0.8833677030456851,890,787,1677,-
chr2,241230910,0.8833677030456851,890,787,1677,-
chr2,241235188,1.9788345244639918,625,427,1052,-
chr2,241236648,1.6534810126582278,626,473,1099,-
chr2,241236704,0.5968523002421308,608,412,1020,-
chr2,241236708,3.868720473117001,854,633,1487,-
chr2,241236715,1.9618051577112192,811,559,1370,-
chr2,241238675,0.5906199460916443,995,699,1694,-
chr2,241238735,1.8450536735874525,972,661,1633,-
chr2,241238760,1.9595735340945275,1469,1043,2512,-
chr2,241239676,1.814231535643119,1151,661,1812,-
chr2,241239678,1.814231535643119,1151,661,1812,-
chr2,241239816,0.36479398075375236,702,590,1292,-
chr2,241239913,1.1925566273156052,949,735,1684,-
chr2,241240044,2.409328750700195,804,682,1486,-
chr2,241240045,1.5396825396825398,678,440,1118,-
chr2,241240083,0.5583823432234191,649,408,1057,-
chr2,241242673,5.714252336448598,660,534,1194,-
chr2,241242674,5.714252336448598,660,534,1194,-
chr2,241246867,2.3266255989048594,606,486,1092,-
chr2,241247107,0.9976063585880167,3590,2489,6079,-
chr2,241247129,2.886783165148905,950,716,1666,-
chr2,241248019,3.1247235736399825,941,713,1654,-
chr2,241248286,2.8252740167633785,625,516,1141,-
chr2,241253462,1.4512143348206092,3628,2786,6414,-
chr2,241253463,1.6483067112431895,5306,4037,9343,-
chr2,241253465,1.5843296871025183,5237,3930,9167,-
chr2,241253466,1.5672123547688606,5338,3700,9038,-
chr2,241253468,0.6538759820615706,807,630,1437,-
chr2,241253469,1.4118216171917684,1746,1155,2901,-
chr2,241253471,1.4507658643326042,1546,913,2459,-
chr2,241253479,0.7306872232245367,1385,870,2255,-
chr2,241253481,0.6443356909402184,1241,750,1991,-
chr2,241255072,1.7041755130927103,895,627,1522,-
chr2,241255091,0.4909049044439328,819,504,1323,-
chr2,241255093,1.0409343312409465,1626,1089,2715,-
chr2,241255094,1.0409343312409465,1626,1089,2715,-
chr2,241255105,1.9614705882352939,740,509,1249,-
chr2,241255494,1.6766222292604196,1580,1097,2677,-
chr2,241255561,1.6631892697466468,991,670,1661,-
chr2,241255563,0.8791719812925171,1526,1175,2701,-
chr2,241255565,0.8791719812925171,1526,1175,2701,-
chr2,241255574,0.5397116324535679,630,495,1125,-
chr2,241255576,2.04253358925144,738,520,1258,-
chr2,241255579,1.6918604651162792,678,472,1150,-
chr2,241256202,1.8204415234243343,744,515,1259,-
chr2,241256238,1.9876956043644871,1043,761,1804,-
chr2,241256365,2.2826368642695174,828,881,1709,-
chr2,241256367,0.50364269876465,635,461,1096,-
chr2,241256368,1.480643754886043,1480,1445,2925,-
chr2,241256369,1.480643754886043,1480,1445,2925,-
chr2,241256372,1.6697761194029848,715,535,1250,-
chr2,241256375,1.66352719566753,627,547,1174,-
chr2,241256376,2.1518866117602,641,453,1094,-
chr2,241256639,1.931863018660007,2788,2065,4853,-
chr2,241256640,1.931863018660007,2788,2065,4853,-
chr2,241256652,0.4002339469309856,590,438,1028,-
chr2,241256740,3.0201183431952656,985,844,1829,-
chr2,241256752,0.5813270008464216,988,685,1673,-
chr2,241262781,1.4945883054085642,7677,5143,12820,-
chr2,241262795,2.5027153949206995,2285,1476,3761,-
chr2,241262841,1.5644974525243167,1831,1015,2846,-
chr2,241262879,1.6569463788300836,1214,717,1931,-
chr2,241262885,1.9470443349753692,1053,637,1690,-
chr2,241262891,0.4590022353180248,694,517,1211,-
chr2,241262898,1.5604352678571427,716,511,1227,-
chr2,241262901,1.8094569288389517,772,444,1216,-
chr2,241262917,2.125227963525836,911,704,1615,-
chr2,241262918,2.3280515768272627,1477,1095,2572,-
chr2,241264467,2.5841970655539104,661,390,1051,-
chr2,241268489,1.745254133496632,1139,709,1848,-
chr2,241268491,1.373845074433153,1631,1034,2665,-
chr2,241675829,0.4870741920999522,716,504,1220,-
chr2,241675909,0.29497607655502395,684,417,1101,-
